,iteration,visit,item_id_list,visitor_id,reward,total_reward,fraction_relevant,percentage_overlap_rating,percentage_overlap_like
0,0,0,[273 286 215  22 301],450,4,4,4.0,0.0,20.0
1,0,1,[286 215  22 301 273],655,1,5,2.5,0.0,20.0
2,0,2,[273 286 215  22 301],344,2,7,2.3333333333333335,0.0,20.0
3,0,3,[195  11  70 204  22],269,0,7,1.75,0.0,0.0
4,0,4,[153 435 423 275 182],18,5,12,2.4,0.0,20.0
5,0,5,[423 275 435 153 182],450,5,17,2.8333333333333335,0.0,20.0
6,0,6,[ 11 313 196 117 546],593,4,21,3.0,0.0,0.0
7,0,7,[182 275 435 196 153],629,5,26,3.25,0.0,20.0
8,0,8,[ 28 143 161  79 588],23,2,28,3.111111111111111,0.0,0.0
9,0,9,[ 50  64  22 405 546],344,2,30,3.0,20.0,20.0
10,0,10,[ 50  79 275  64 588],389,5,35,3.1818181818181817,20.0,40.0
11,0,11,[ 50  79 275  64 588],18,5,40,3.3333333333333335,20.0,40.0
12,0,12,[ 50  79 275  64 588],457,5,45,3.4615384615384617,20.0,40.0
13,0,13,[ 50  79 275  64 588],450,5,50,3.5714285714285716,20.0,40.0
14,0,14,[ 50  79 275  64 588],450,5,55,3.6666666666666665,20.0,40.0
15,0,15,[405 210 195 546 196],450,4,59,3.6875,0.0,0.0
16,0,16,[ 79 275  50 588 435],716,5,64,3.764705882352941,0.0,40.0
17,0,17,[ 79 275  50 588 435],716,5,69,3.8333333333333335,0.0,40.0
18,0,18,[176  22 228 118 125],796,5,74,3.8947368421052633,0.0,0.0
19,0,19,[125  79 118  50 228],280,1,75,3.75,0.0,20.0
20,0,20,[ 82  12 234 405 161],256,5,80,3.8095238095238093,0.0,0.0
21,0,21,[174 197  79 238 187],18,5,85,3.8636363636363638,0.0,0.0
22,0,22,[ 12 471 196 143 238],174,5,90,3.9130434782608696,0.0,0.0
23,0,23,[423  12 153  79 471],280,4,94,3.9166666666666665,0.0,0.0
24,0,24,[117 100 568 181  79],256,5,99,3.96,0.0,20.0
25,0,25,[588 194 282 546 173],450,5,104,4.0,0.0,0.0
26,0,26,[100  15 403  12  71],796,4,108,4.0,0.0,20.0
27,0,27,[423 182 313  12 435],655,2,110,3.9285714285714284,0.0,0.0
28,0,28,[ 64 176 121  98 183],796,5,115,3.9655172413793105,20.0,0.0
29,0,29,[313 173 181  82 183],796,4,119,3.966666666666667,0.0,0.0
30,0,30,[ 15 271 275 508 385],655,1,120,3.870967741935484,0.0,20.0
31,0,31,[ 64 357 186 143 318],655,4,124,3.875,40.0,0.0
32,0,32,[175 301 183 597  71],344,3,127,3.8484848484848486,0.0,0.0
33,0,33,[173 197 183 194 318],796,4,131,3.8529411764705883,20.0,0.0
34,0,34,[302 121  98 211  89],655,3,134,3.8285714285714287,0.0,0.0
35,0,35,[127 271  50 265 515],655,3,137,3.8055555555555554,0.0,40.0
36,0,36,[127 187 181 176  89],655,3,140,3.7837837837837838,0.0,20.0
37,0,37,[127 175  89 234 182],18,3,143,3.763157894736842,0.0,20.0
38,0,38,[427  82 216   8 125],577,5,148,3.7948717948717947,20.0,0.0
39,0,39,[508   8 282  97 269],535,4,152,3.8,0.0,0.0
40,0,40,[385 111  96 588 258],450,5,157,3.8292682926829267,0.0,0.0
41,0,41,[125 196  69 210  97],457,5,162,3.857142857142857,0.0,0.0
42,0,42,[234 200 313 168 273],436,2,164,3.813953488372093,0.0,0.0
43,0,43,[117 294 174 496  95],796,4,168,3.8181818181818183,20.0,0.0
44,0,44,[127  97  96 182 515],72,5,173,3.8444444444444446,0.0,20.0
45,0,45,[238 258  95 403 187],796,4,177,3.847826086956522,0.0,0.0
46,0,46,[144 118 176  96 357],796,5,182,3.872340425531915,0.0,0.0
47,0,47,[286 268 174 100 215],535,3,185,3.8541666666666665,0.0,40.0
48,0,48,[ 25 403 183  89 427],5,2,187,3.816326530612245,20.0,0.0
49,0,49,[282  64 117 196 127],796,5,192,3.84,20.0,20.0
50,0,50,[127  97  96 182 515],72,5,197,3.8627450980392157,0.0,20.0
51,0,51,[ 50 423 202 210 238],389,4,201,3.8653846153846154,0.0,20.0
52,0,52,[508 403  50 182 180],280,1,202,3.811320754716981,0.0,20.0
53,0,53,[ 12  88 238 234  50],655,1,203,3.759259259259259,0.0,20.0
54,0,54,[655 403 273   9   8],655,1,204,3.709090909090909,0.0,0.0
55,0,55,[135 127 265 357  70],655,3,207,3.6964285714285716,0.0,20.0
56,0,56,[173  69 257  79 282],457,4,211,3.7017543859649122,0.0,0.0
57,0,57,[200 385 204 475 144],655,1,212,3.6551724137931036,0.0,0.0
58,0,58,[127 183  96 515 173],908,4,216,3.6610169491525424,0.0,20.0
59,0,59,[403  98  82 153 235],330,5,221,3.683333333333333,0.0,0.0
60,0,60,[195  70  11   9 174],535,5,226,3.7049180327868854,0.0,0.0
61,0,61,[186 328 118 302 187],655,2,228,3.6774193548387095,0.0,0.0
62,0,62,[ 56  97  71 405 200],593,4,232,3.6825396825396823,0.0,0.0
63,0,63,[127 183  96 515 194],716,3,235,3.671875,0.0,20.0
64,0,64,[210 196 471 237 435],716,4,239,3.6769230769230767,0.0,0.0
65,0,65,[127 135 194  64 357],401,2,241,3.6515151515151514,20.0,20.0
66,0,66,[195 288 234  70 385],280,3,244,3.6417910447761193,0.0,0.0
67,0,67,[302 174 194 357 180],450,5,249,3.661764705882353,0.0,0.0
68,0,68,[265 194 215  50 196],450,5,254,3.681159420289855,0.0,20.0
69,0,69,[302 174 194 357 180],450,5,259,3.7,0.0,0.0
70,0,70,[ 28  82 185 161  79],450,4,263,3.704225352112676,0.0,0.0
71,0,71,[655 435 173 176  82],269,1,264,3.6666666666666665,0.0,0.0
72,0,72,[185 357 333 323 483],796,4,268,3.671232876712329,0.0,0.0
73,0,73,[302 196 235 153 269],450,4,272,3.675675675675676,0.0,0.0
74,0,74,[328 144  22 483 210],450,3,275,3.6666666666666665,0.0,0.0
75,0,75,[118 742 196 313 265],655,1,276,3.6315789473684212,0.0,0.0
76,0,76,[234 288  98 176 282],292,4,280,3.6363636363636362,0.0,0.0
77,0,77,[302 496 194 357 180],535,3,283,3.628205128205128,20.0,0.0
78,0,78,[ 69 496 194 187 175],269,4,287,3.632911392405063,20.0,0.0
79,0,79,[269 496 180 187 175],18,5,292,3.65,20.0,0.0
80,0,80,[196  97 200 655 282],504,5,297,3.6666666666666665,0.0,0.0
81,0,81,[496  56 180 174 187],450,5,302,3.682926829268293,20.0,0.0
82,0,82,[496  56 180 174 187],716,3,305,3.674698795180723,20.0,0.0
83,0,83,[ 56 174 313 111  97],577,4,309,3.6785714285714284,0.0,0.0
84,0,84,[ 25 496 195 603 191],18,2,311,3.6588235294117646,40.0,0.0
85,0,85,[258 174 313 111  97],450,5,316,3.6744186046511627,0.0,0.0
86,0,86,[313 100 196 405 265],655,1,317,3.6436781609195403,0.0,20.0
87,0,87,[ 69  15 172 181 275],18,2,319,3.625,0.0,20.0
88,0,88,[202 300 111 191 313],655,2,321,3.606741573033708,0.0,0.0
89,0,89,[ 50   1 238 385   9],786,5,326,3.6222222222222222,0.0,20.0
90,0,90,[ 97 323 333 195  88],796,3,329,3.6153846153846154,0.0,0.0
91,0,91,[174 235 132  97 258],450,4,333,3.619565217391304,0.0,0.0
92,0,92,[185 269   1 194 515],535,3,336,3.6129032258064515,0.0,0.0
93,0,93,[496  70 265 286 111],450,5,341,3.627659574468085,20.0,20.0
94,0,94,[195  25 508   9 471],655,0,341,3.5894736842105264,0.0,0.0
95,0,95,[174 132 313 153 318],280,3,344,3.5833333333333335,20.0,0.0
96,0,96,[258 175 153 318 194],878,3,347,3.577319587628866,20.0,0.0
97,0,97,[191 153 194 318 496],796,5,352,3.5918367346938775,40.0,0.0
98,0,98,[179  11 333  15 268],655,1,353,3.5656565656565657,0.0,0.0
99,0,99,[191 153 194 318 496],269,4,357,3.57,40.0,0.0
100,0,100,[ 69 200 125 215 216],18,1,358,3.5445544554455446,0.0,0.0
101,0,101,[191 568 194 318 496],450,5,363,3.5588235294117645,40.0,0.0
102,0,102,[191 568 194 318 496],450,5,368,3.5728155339805827,40.0,0.0
103,0,103,[191 568 194 318 496],716,5,373,3.5865384615384617,40.0,0.0
104,0,104,[191 568 194 318 496],577,4,377,3.5904761904761906,40.0,0.0
105,0,105,[496 269 194 318 132],535,5,382,3.6037735849056602,40.0,0.0
106,0,106,[234 191 210 185 135],18,2,384,3.588785046728972,0.0,0.0
107,0,107,[496 194 275 588 179],389,5,389,3.6018518518518516,20.0,20.0
108,0,108,[496 237   9   8 175],269,3,392,3.596330275229358,20.0,0.0
109,0,109,[111  22 265 153 269],878,3,395,3.590909090909091,0.0,0.0
110,0,110,[286 405 100 127 245],733,2,397,3.5765765765765765,0.0,60.0
111,0,111,[318  98 496 132 216],236,4,401,3.580357142857143,40.0,0.0
112,0,112,[238 300 100 302 483],535,3,404,3.575221238938053,0.0,20.0
113,0,113,[496  12  89  98 121],796,5,409,3.587719298245614,20.0,0.0
114,0,114,[265 216   9 471  89],457,5,414,3.6,0.0,0.0
115,0,115,[  9 118 174 385 117],280,3,417,3.5948275862068964,0.0,0.0
116,0,116,[174 234 144 125  12],280,1,418,3.572649572649573,0.0,0.0
117,0,117,[ 95 204  70 216 357],716,5,423,3.5847457627118646,0.0,0.0
118,0,118,[194  28 222 204  11],716,5,428,3.596638655462185,0.0,0.0
119,0,119,[191   9 118 288 144],655,1,429,3.575,0.0,0.0
120,0,120,[132 186 195 191 143],151,3,432,3.5702479338842976,0.0,0.0
121,0,121,[546 197 282 300 121],716,3,435,3.5655737704918034,0.0,0.0
122,0,122,[ 98 318 275 588 179],878,4,439,3.569105691056911,20.0,20.0
123,0,123,[ 98 318 275 179 117],655,4,443,3.5725806451612905,20.0,20.0
124,0,124,[ 82 258 153 161 211],655,0,443,3.544,0.0,0.0
125,0,125,[216 275 179 132  95],786,5,448,3.5555555555555554,0.0,20.0
126,0,126,[151 195 275  25 144],535,4,452,3.559055118110236,0.0,20.0
127,0,127,[  9 196 172  88 186],796,3,455,3.5546875,0.0,0.0
128,0,128,[ 70 197 195 100 196],535,5,460,3.565891472868217,0.0,20.0
129,0,129,[427 318 423 181 196],151,5,465,3.576923076923077,40.0,0.0
130,0,130,[318  98 222 194 132],236,4,469,3.5801526717557253,20.0,0.0
131,0,131,[318  79 222 132 216],236,5,474,3.590909090909091,20.0,0.0
132,0,132,[318  79 222 132 216],693,4,478,3.593984962406015,20.0,0.0
133,0,133,[173  70 161 181 100],457,5,483,3.6044776119402986,0.0,20.0
134,0,134,[144 210 427 195 515],807,4,487,3.6074074074074076,20.0,0.0
135,0,135,[235 161 742 210  82],457,4,491,3.610294117647059,0.0,0.0
136,0,136,[215 238 174   4  95],796,4,495,3.613138686131387,0.0,0.0
137,0,137,[132 322 121 318 568],450,4,499,3.6159420289855073,20.0,0.0
138,0,138,[269  95 151 318 216],796,4,503,3.618705035971223,20.0,0.0
139,0,139,[234 568  98 286 222],280,2,505,3.607142857142857,0.0,20.0
140,0,140,[185 111 588 471  71],389,4,509,3.6099290780141846,0.0,0.0
141,0,141,[ 56 318 143  69  22],655,2,511,3.5985915492957745,20.0,0.0
142,0,142,[132 318 275 179   4],655,3,514,3.5944055944055946,20.0,20.0
143,0,143,[118 257  50 385 172],330,5,519,3.6041666666666665,0.0,20.0
144,0,144,[318  95 216  98  79],450,4,523,3.606896551724138,20.0,0.0
145,0,145,[100 748 216 121 588],450,4,527,3.6095890410958904,0.0,20.0
146,0,146,[318 216 275 179 322],593,3,530,3.6054421768707483,20.0,20.0
147,0,147,[  1 197 427 294 282],796,2,532,3.5945945945945947,20.0,0.0
148,0,148,[405  28 197 423 546],786,4,536,3.597315436241611,0.0,0.0
149,0,149,[202 195 168 174  25],450,4,540,3.6,0.0,0.0
150,0,150,[ 56  69   4 215 181],457,5,545,3.609271523178808,0.0,0.0
151,0,151,[127 181 300 385 257],655,1,546,3.5921052631578947,0.0,20.0
152,0,152,[  8 282  25 276  11],457,5,551,3.6013071895424837,0.0,0.0
153,0,153,[588 125 100  64  69],457,5,556,3.6103896103896105,20.0,20.0
154,0,154,[748 318 179 151  79],450,5,561,3.6193548387096772,20.0,0.0
155,0,155,[195 322  69  96 333],796,4,565,3.621794871794872,0.0,0.0
156,0,156,[191 173 357 313 174],450,5,570,3.6305732484076434,0.0,0.0
157,0,157,[228 204 318 471  89],807,5,575,3.6392405063291138,20.0,0.0
158,0,158,[405 471 176  96  12],280,2,577,3.6289308176100628,0.0,0.0
159,0,159,[289  70 423 655  50],786,5,582,3.6375,0.0,20.0
160,0,160,[173 153  64 210 186],269,1,583,3.62111801242236,20.0,0.0
161,0,161,[ 82 742 197   8 111],457,4,587,3.623456790123457,0.0,0.0
162,0,162,[471   4 546 405 161],450,4,591,3.625766871165644,0.0,0.0
163,0,163,[ 56 172 245  12 282],280,2,593,3.6158536585365852,0.0,0.0
164,0,164,[483  64   1 403  15],457,5,598,3.624242424242424,20.0,0.0
165,0,165,[222  25 196 265 210],151,5,603,3.6325301204819276,0.0,0.0
166,0,166,[483 357 135 234 222],655,3,606,3.62874251497006,0.0,0.0
167,0,167,[210 153 471 151  64],535,5,611,3.636904761904762,20.0,0.0
168,0,168,[423 471 161 271 234],655,0,611,3.6153846153846154,0.0,0.0
169,0,169,[ 50  11 483 471   9],457,5,616,3.623529411764706,0.0,20.0
170,0,170,[ 96 748  22 294  88],256,4,620,3.625730994152047,0.0,0.0
171,0,171,[423 194 186 286 318],796,3,623,3.622093023255814,20.0,20.0
172,0,172,[ 79 121 496 300 603],535,3,626,3.6184971098265897,40.0,0.0
173,0,173,[357  88 403 237 196],504,2,628,3.6091954022988504,0.0,0.0
174,0,174,[ 15 508 195 282  12],655,0,628,3.5885714285714285,0.0,0.0
175,0,175,[ 98 289 276 318 216],655,4,632,3.590909090909091,20.0,0.0
176,0,176,[197 403  98 222  89],655,2,634,3.5819209039548023,0.0,0.0
177,0,177,[ 12 546 228 174 210],256,4,638,3.5842696629213484,0.0,0.0
178,0,178,[228  12 333 273 508],655,1,639,3.569832402234637,0.0,0.0
179,0,179,[  7  96 153 180 117],280,5,644,3.577777777777778,0.0,0.0
180,0,180,[748 471  88 282 121],256,4,648,3.5801104972375692,0.0,0.0
181,0,181,[328 322 173  28 234],450,4,652,3.5824175824175826,0.0,0.0
182,0,182,[748 496  96 313 121],796,5,657,3.5901639344262297,20.0,0.0
183,0,183,[245 185 172  22 748],450,5,662,3.597826086956522,0.0,0.0
184,0,184,[100 180 385 144 151],796,3,665,3.5945945945945947,0.0,20.0
185,0,185,[286 546 174   4  56],450,4,669,3.596774193548387,0.0,20.0
186,0,186,[  7  98 276 216 318],786,4,673,3.5989304812834226,20.0,0.0
187,0,187,[  1 181 135 176  79],151,4,677,3.601063829787234,0.0,0.0
188,0,188,[  7 179 151  98 318],269,4,681,3.6031746031746033,20.0,0.0
189,0,189,[151  98 216 318 748],450,5,686,3.610526315789474,20.0,0.0
190,0,190,[151  98 216 318 748],151,4,690,3.612565445026178,20.0,0.0
191,0,191,[234 471  79 168  28],577,3,693,3.609375,0.0,0.0
192,0,192,[215 121 174 195 100],655,0,693,3.5906735751295336,0.0,20.0
193,0,193,[ 98 216 318 179 151],236,3,696,3.5876288659793816,20.0,0.0
194,0,194,[ 98 216 318 194  79],503,5,701,3.594871794871795,20.0,0.0
195,0,195,[ 98 216 318 194  79],577,5,706,3.6020408163265305,20.0,0.0
196,0,196,[ 98 216 318 194  79],796,5,711,3.6091370558375635,20.0,0.0
197,0,197,[ 98 216 318 194  79],450,5,716,3.6161616161616164,20.0,0.0
198,0,198,[ 98 216 318 194  79],11,3,719,3.613065326633166,20.0,0.0
199,0,199,[318 194  79  98 216],450,5,724,3.62,20.0,0.0
200,0,200,[318 194  79  98 216],450,5,729,3.626865671641791,20.0,0.0
201,0,201,[ 50 357 197 204 181],18,3,732,3.623762376237624,0.0,20.0
202,0,202,[318 194  79  98 216],503,5,737,3.6305418719211824,20.0,0.0
203,0,203,[ 69  25 435  22 405],716,5,742,3.6372549019607843,0.0,0.0
204,0,204,[318 194  79  98 216],716,5,747,3.6439024390243904,20.0,0.0
205,0,205,[216 313 144 187   8],796,5,752,3.650485436893204,0.0,0.0
206,0,206,[ 22 483 385 328 234],796,4,756,3.652173913043478,0.0,0.0
207,0,207,[215  64 132  25 655],457,5,761,3.6586538461538463,20.0,0.0
208,0,208,[318 194  79  98 216],18,4,765,3.660287081339713,20.0,0.0
209,0,209,[603 196  71 211 174],401,4,769,3.6619047619047618,20.0,0.0
210,0,210,[ 64 275 483   7 234],450,3,772,3.6587677725118484,20.0,20.0
211,0,211,[405 181 125 210 127],280,1,773,3.6462264150943398,0.0,20.0
212,0,212,[318  79  98 216 496],908,4,777,3.647887323943662,40.0,0.0
213,0,213,[318  79  98 496 275],716,5,782,3.6542056074766354,40.0,20.0
214,0,214,[222 195 173  12   8],457,5,787,3.66046511627907,0.0,0.0
215,0,215,[318  79  98 496 275],796,5,792,3.6666666666666665,40.0,20.0
216,0,216,[318  79  98 496 275],18,5,797,3.672811059907834,40.0,20.0
217,0,217,[300 127 117 197  50],450,5,802,3.6788990825688073,0.0,40.0
218,0,218,[318  79  98 496 275],503,5,807,3.684931506849315,40.0,20.0
219,0,219,[318  79  98 496 275],236,3,810,3.6818181818181817,40.0,20.0
220,0,220,[318  79  98 194  64],151,5,815,3.6877828054298645,40.0,0.0
221,0,221,[215 161 197 151  97],450,5,820,3.6936936936936937,0.0,0.0
222,0,222,[318  79  98  64 194],236,4,824,3.695067264573991,40.0,0.0
223,0,223,[318  79  98  64 588],716,5,829,3.700892857142857,40.0,0.0
224,0,224,[318  79  98  64 588],450,5,834,3.7066666666666666,40.0,0.0
225,0,225,[  7 186  97  88 423],885,4,838,3.7079646017699117,0.0,0.0
226,0,226,[318  79  98  64 588],450,5,843,3.7136563876651985,40.0,0.0
227,0,227,[318  79  98  64 588],577,5,848,3.719298245614035,40.0,0.0
228,0,228,[318  79  98  64 588],577,5,853,3.7248908296943233,40.0,0.0
229,0,229,[273  12  95  70 210],450,2,855,3.717391304347826,0.0,0.0
230,0,230,[  8 258 127 742 238],457,5,860,3.722943722943723,0.0,20.0
231,0,231,[423 234 161 313 294],577,4,864,3.7241379310344827,0.0,0.0
232,0,232,[125  97 238 132   1],655,0,864,3.708154506437768,0.0,0.0
233,0,233,[318  79  98  64 588],18,5,869,3.713675213675214,40.0,0.0
234,0,234,[222  70  79 181 215],457,5,874,3.7191489361702126,0.0,0.0
235,0,235,[318  79  98  64 588],18,5,879,3.7245762711864407,40.0,0.0
236,0,236,[318  79  98  64 588],18,5,884,3.729957805907173,40.0,0.0
237,0,237,[318  79  98  64 588],450,5,889,3.735294117647059,40.0,0.0
238,0,238,[180 100   7 200  70],786,5,894,3.7405857740585775,0.0,20.0
239,0,239,[318  79  98  64 588],716,5,899,3.745833333333333,40.0,0.0
240,0,240,[318  79  98  64 588],716,5,904,3.7510373443983402,40.0,0.0
241,0,241,[ 12 204 268 196 471],344,3,907,3.7479338842975207,0.0,0.0
242,0,242,[318  79  98  64 588],796,5,912,3.753086419753086,40.0,0.0
243,0,243,[300  98 568   4 357],450,4,916,3.7540983606557377,0.0,0.0
244,0,244,[127  28 268 435 135],655,2,918,3.746938775510204,0.0,20.0
245,0,245,[318  79  98  64 588],716,5,923,3.752032520325203,40.0,0.0
246,0,246,[111  12 323 195 180],796,3,926,3.748987854251012,0.0,0.0
247,0,247,[ 96  82 174  98 118],72,3,929,3.745967741935484,0.0,0.0
248,0,248,[318  79  98  64 588],450,5,934,3.751004016064257,40.0,0.0
249,0,249,[318  79  98  64 588],577,5,939,3.756,40.0,0.0
250,0,250,[318  79  98  64 588],18,5,944,3.760956175298805,40.0,0.0
251,0,251,[ 22 185 117 597 234],457,4,948,3.761904761904762,0.0,0.0
252,0,252,[117 475 597 121 288],463,0,948,3.7470355731225298,0.0,0.0
253,0,253,[294 118 302 215 125],450,4,952,3.748031496062992,0.0,0.0
254,0,254,[318  79  98  64 588],796,5,957,3.7529411764705882,40.0,0.0
255,0,255,[318  79  98  64 588],18,5,962,3.7578125,40.0,0.0
256,0,256,[318  79  98  64 588],450,5,967,3.762645914396887,40.0,0.0
257,0,257,[318  79  98  64 588],457,5,972,3.7674418604651163,40.0,0.0
258,0,258,[318  79  98  64 588],450,5,977,3.772200772200772,40.0,0.0
259,0,259,[194  56 273 216 135],236,2,979,3.7653846153846153,0.0,0.0
260,0,260,[318  79  98  64 588],796,5,984,3.7701149425287355,40.0,0.0
261,0,261,[ 89 117  96 111   9],796,4,988,3.7709923664122136,0.0,0.0
262,0,262,[144  22 300 202 191],716,4,992,3.7718631178707223,0.0,0.0
263,0,263,[318  79  98  64 588],577,5,997,3.7765151515151514,40.0,0.0
264,0,264,[174 185 483 135  25],151,5,1002,3.781132075471698,0.0,0.0
265,0,265,[176 181 237 144 161],716,2,1004,3.774436090225564,0.0,0.0
266,0,266,[318  79  98  64 588],796,5,1009,3.7790262172284645,40.0,0.0
267,0,267,[357 597 210 546 471],593,1,1010,3.7686567164179103,0.0,0.0
268,0,268,[276 179  64 172  96],655,4,1014,3.7695167286245352,20.0,0.0
269,0,269,[318  79  98  64 588],450,5,1019,3.774074074074074,40.0,0.0
270,0,270,[238 185 275 271 194],796,4,1023,3.774907749077491,0.0,20.0
271,0,271,[318  79  98  64 588],577,5,1028,3.7794117647058822,40.0,0.0
272,0,272,[318  79  98  64 588],577,5,1033,3.7838827838827838,40.0,0.0
273,0,273,[ 69  56 357 235 234],457,4,1037,3.7846715328467155,0.0,0.0
274,0,274,[ 70 271 135 143 655],655,2,1039,3.7781818181818183,0.0,0.0
275,0,275,[318  79  98  64 588],577,5,1044,3.782608695652174,40.0,0.0
276,0,276,[318  79  98  64 588],457,5,1049,3.7870036101083033,40.0,0.0
277,0,277,[405 191 318 194 204],457,5,1054,3.79136690647482,20.0,0.0
278,0,278,[111  96 182 210  12],457,4,1058,3.792114695340502,0.0,0.0
279,0,279,[ 96 269 183 275 655],450,5,1063,3.7964285714285713,0.0,20.0
280,0,280,[318  79  98  64 588],450,5,1068,3.800711743772242,40.0,0.0
281,0,281,[234 191   1 176 313],450,4,1072,3.801418439716312,0.0,0.0
282,0,282,[318  79  98  64 588],577,5,1077,3.8056537102473498,40.0,0.0
283,0,283,[294 427  96 282   1],716,3,1080,3.8028169014084505,20.0,0.0
284,0,284,[318  79  98  64 588],716,5,1085,3.807017543859649,40.0,0.0
285,0,285,[318  79  98  64 588],796,5,1090,3.8111888111888113,40.0,0.0
286,0,286,[ 12 200 276 151  89],457,5,1095,3.8153310104529616,0.0,0.0
287,0,287,[210 161 508 100 196],655,0,1095,3.8020833333333335,0.0,20.0
288,0,288,[196 238  50 151 135],389,3,1098,3.7993079584775087,0.0,20.0
289,0,289,[318  79  98  64 588],796,5,1103,3.803448275862069,40.0,0.0
290,0,290,[194 197 202 423 655],639,1,1104,3.7938144329896906,0.0,0.0
291,0,291,[318  79  98  64 588],716,5,1109,3.797945205479452,40.0,0.0
292,0,292,[204  28 483   1 143],796,3,1112,3.795221843003413,0.0,0.0
293,0,293,[603 211  22   7 202],269,2,1114,3.7891156462585034,20.0,0.0
294,0,294,[318  79  98  64 588],716,5,1119,3.7932203389830508,40.0,0.0
295,0,295,[117 273 204 222 187],655,2,1121,3.7871621621621623,0.0,0.0
296,0,296,[111 183 182 496 200],269,3,1124,3.7845117845117846,20.0,0.0
297,0,297,[216   8 125 322 483],280,4,1128,3.785234899328859,0.0,0.0
298,0,298,[588 172 357   1 127],450,5,1133,3.789297658862876,0.0,20.0
299,0,299,[423 268 302  71 215],535,3,1136,3.7866666666666666,0.0,0.0
300,0,300,[197 161 194 144 265],796,4,1140,3.787375415282392,0.0,0.0
301,0,301,[318  79  98  64 588],716,5,1145,3.7913907284768213,40.0,0.0
302,0,302,[132 228 385 237 318],716,4,1149,3.792079207920792,20.0,0.0
303,0,303,[405  12  25 121  70],655,0,1149,3.7796052631578947,0.0,0.0
304,0,304,[211 151 111 194 175],269,4,1153,3.780327868852459,0.0,0.0
305,0,305,[318  79  98  64 588],18,5,1158,3.784313725490196,40.0,0.0
306,0,306,[ 89 161 238 180  56],796,3,1161,3.781758957654723,0.0,0.0
307,0,307,[  8   9 196 195 313],796,4,1165,3.7824675324675323,0.0,0.0
308,0,308,[322  88 176 195 121],786,3,1168,3.779935275080906,0.0,0.0
309,0,309,[748 202 173  89 100],796,4,1172,3.7806451612903227,0.0,20.0
310,0,310,[748 568 234 269 174],796,3,1175,3.7781350482315115,0.0,0.0
311,0,311,[318  79  98  64 588],796,5,1180,3.782051282051282,40.0,0.0
312,0,312,[258 385 202   4  25],655,0,1180,3.769968051118211,0.0,0.0
313,0,313,[202 210 215 151 546],151,3,1183,3.767515923566879,0.0,0.0
314,0,314,[318  79  98  64 588],450,5,1188,3.7714285714285714,40.0,0.0
315,0,315,[318  79  98  64 588],450,5,1193,3.7753164556962027,40.0,0.0
316,0,316,[318  79  98  64 588],18,5,1198,3.779179810725552,40.0,0.0
317,0,317,[185 603 546  98 174],503,4,1202,3.779874213836478,20.0,0.0
318,0,318,[318  79  98  64 588],796,5,1207,3.7836990595611284,40.0,0.0
319,0,319,[196 132   9 328  22],629,4,1211,3.784375,0.0,0.0
320,0,320,[318  79  98  64 588],577,5,1216,3.7881619937694704,40.0,0.0
321,0,321,[  4 135 286 185 111],655,2,1218,3.782608695652174,0.0,20.0
322,0,322,[318  79  98  64 588],577,5,1223,3.7863777089783284,40.0,0.0
323,0,323,[318  79  98  64 588],577,5,1228,3.7901234567901234,40.0,0.0
324,0,324,[318  79  98  64 588],716,5,1233,3.793846153846154,40.0,0.0
325,0,325,[318  79  98  64 588],450,5,1238,3.7975460122699385,40.0,0.0
326,0,326,[318  79  98  64 588],796,5,1243,3.801223241590214,40.0,0.0
327,0,327,[282   9 294 127 186],796,2,1245,3.7957317073170733,0.0,20.0
328,0,328,[318  79  98  64 588],450,5,1250,3.7993920972644375,40.0,0.0
329,0,329,[423 568   4  25 742],593,4,1254,3.8,0.0,0.0
330,0,330,[357 286 427 211 515],18,5,1259,3.8036253776435047,20.0,20.0
331,0,331,[  7  11  96 135 318],457,5,1264,3.8072289156626504,20.0,0.0
332,0,332,[286 508 748  25 546],722,4,1268,3.8078078078078077,0.0,20.0
333,0,333,[234 300  50 268  97],655,1,1269,3.7994011976047903,0.0,20.0
334,0,334,[318  79  98  64 588],716,5,1274,3.8029850746268656,40.0,0.0
335,0,335,[ 69 153 333  88  12],655,0,1274,3.7916666666666665,0.0,0.0
336,0,336,[483 237 195 435  64],18,3,1277,3.7893175074183976,20.0,0.0
337,0,337,[496 508 268 210 135],535,3,1280,3.78698224852071,20.0,0.0
338,0,338,[179 508   7 135 427],655,3,1283,3.784660766961652,20.0,0.0
339,0,339,[318  79  98  64 588],457,5,1288,3.788235294117647,40.0,0.0
340,0,340,[ 89 210 471 235 175],344,3,1291,3.7859237536656893,0.0,0.0
341,0,341,[318  79  98  64 588],450,5,1296,3.789473684210526,40.0,0.0
342,0,342,[204 288   4 179 300],655,1,1297,3.7813411078717203,0.0,0.0
343,0,343,[318  79  98  64 588],450,5,1302,3.7848837209302326,40.0,0.0
344,0,344,[318  79  98  64 588],18,5,1307,3.7884057971014493,40.0,0.0
345,0,345,[200 237 176   8 427],269,2,1309,3.7832369942196533,20.0,0.0
346,0,346,[318  79  98  64 588],796,5,1314,3.786743515850144,40.0,0.0
347,0,347,[318  79  98  64 588],18,5,1319,3.7902298850574714,40.0,0.0
348,0,348,[318  79  98  64 588],450,5,1324,3.793696275071633,40.0,0.0
349,0,349,[216 288  71 322 508],280,4,1328,3.7942857142857145,0.0,0.0
350,0,350,[  9 302  88 427 603],269,3,1331,3.792022792022792,40.0,0.0
351,0,351,[318  79  98  64 588],577,5,1336,3.7954545454545454,40.0,0.0
352,0,352,[318  79  98  64 588],716,5,1341,3.7988668555240794,40.0,0.0
353,0,353,[318  79  98  64 588],450,5,1346,3.8022598870056497,40.0,0.0
354,0,354,[318  79  98  64 588],457,5,1351,3.8056338028169012,40.0,0.0
355,0,355,[132 195  97 197 151],450,5,1356,3.808988764044944,0.0,0.0
356,0,356,[318  79  98  64 588],457,5,1361,3.8123249299719886,40.0,0.0
357,0,357,[318  79  98  64 588],457,5,1366,3.815642458100559,40.0,0.0
358,0,358,[269   4 471 183 237],344,3,1369,3.8133704735376046,0.0,0.0
359,0,359,[191   8  71 546 655],577,4,1373,3.813888888888889,0.0,0.0
360,0,360,[195 228 197 282 144],655,0,1373,3.8033240997229916,0.0,0.0
361,0,361,[185  98  95  28 100],330,5,1378,3.8066298342541436,0.0,20.0
362,0,362,[318  98  79  64 588],457,5,1383,3.809917355371901,40.0,0.0
363,0,363,[ 69 168 183  56  64],151,4,1387,3.8104395604395602,20.0,0.0
364,0,364,[318  98  79  64 588],457,5,1392,3.813698630136986,40.0,0.0
365,0,365,[ 82 181 151   7 385],450,4,1396,3.814207650273224,0.0,0.0
366,0,366,[318  98  79  64 588],450,5,1401,3.8174386920980927,40.0,0.0
367,0,367,[318  98  79  64 588],457,5,1406,3.8206521739130435,40.0,0.0
368,0,368,[318  98  79  64 588],457,5,1411,3.823848238482385,40.0,0.0
369,0,369,[202 216 215 568 161],450,5,1416,3.827027027027027,0.0,0.0
370,0,370,[318  98  79  64 588],18,5,1421,3.830188679245283,40.0,0.0
371,0,371,[204 179 168 187 302],535,3,1424,3.827956989247312,0.0,0.0
372,0,372,[182  64 180  71 202],18,4,1428,3.8284182305630026,20.0,0.0
373,0,373,[318  98  79  64 588],796,5,1433,3.8315508021390374,40.0,0.0
374,0,374,[318  98  79  64 588],796,5,1438,3.8346666666666667,40.0,0.0
375,0,375,[237 127 508 302 194],401,1,1439,3.827127659574468,0.0,20.0
376,0,376,[ 98 194 265 125  56],450,5,1444,3.830238726790451,0.0,0.0
377,0,377,[318  98  79  64 588],450,5,1449,3.8333333333333335,40.0,0.0
378,0,378,[ 79 191 222 357 237],344,4,1453,3.8337730870712403,0.0,0.0
379,0,379,[127 546 153 294 742],504,3,1456,3.831578947368421,0.0,20.0
380,0,380,[318  79  98  64 588],457,5,1461,3.8346456692913384,40.0,0.0
381,0,381,[318  79  98  64 588],796,5,1466,3.837696335078534,40.0,0.0
382,0,382,[318  79  98  64 588],577,5,1471,3.8407310704960835,40.0,0.0
383,0,383,[405 294 215 423 204],280,1,1472,3.8333333333333335,0.0,0.0
384,0,384,[318  79  98  64 588],450,5,1477,3.8363636363636364,40.0,0.0
385,0,385,[318  79  98  64 588],716,5,1482,3.839378238341969,40.0,0.0
386,0,386,[118 258 302  82  50],655,2,1484,3.834625322997416,0.0,20.0
387,0,387,[318  79  98  64 588],450,5,1489,3.8376288659793816,40.0,0.0
388,0,388,[742  89 111 151  88],344,3,1492,3.83547557840617,0.0,0.0
389,0,389,[318  79  98  64 588],457,5,1497,3.8384615384615386,40.0,0.0
390,0,390,[135  11 191 127 200],450,3,1500,3.836317135549872,0.0,20.0
391,0,391,[  1 196 588 405 153],401,1,1501,3.829081632653061,0.0,0.0
392,0,392,[318  98  79  64 588],18,5,1506,3.83206106870229,40.0,0.0
393,0,393,[318  98  79  64 588],796,5,1511,3.83502538071066,40.0,0.0
394,0,394,[318  98  79  64 588],457,5,1516,3.837974683544304,40.0,0.0
395,0,395,[ 50   1  28  96 275],450,5,1521,3.840909090909091,0.0,40.0
396,0,396,[318  98  79  64 588],716,5,1526,3.8438287153652393,40.0,0.0
397,0,397,[100 204 588  64 118],330,5,1531,3.8467336683417086,20.0,20.0
398,0,398,[318  98  79  64 588],796,5,1536,3.8496240601503757,40.0,0.0
399,0,399,[318  98  79  64 588],457,5,1541,3.8525,40.0,0.0
400,0,400,[318  98  79  64 588],796,5,1546,3.855361596009975,40.0,0.0
401,0,401,[125 202  50 271 435],655,1,1547,3.8482587064676617,0.0,20.0
402,0,402,[179 322  98 289 181],786,4,1551,3.8486352357320097,0.0,0.0
403,0,403,[ 64 125 385 204 172],796,5,1556,3.8514851485148514,20.0,0.0
404,0,404,[318  98  79  64 588],796,5,1561,3.854320987654321,40.0,0.0
405,0,405,[318  98  79  64 588],577,5,1566,3.857142857142857,40.0,0.0
406,0,406,[183  88  70  11 403],280,2,1568,3.8525798525798525,0.0,0.0
407,0,407,[ 96 234 483  50 265],457,5,1573,3.855392156862745,0.0,20.0
408,0,408,[183 318 435 111 228],716,4,1577,3.8557457212713935,20.0,0.0
409,0,409,[318  98  79  64 588],450,5,1582,3.8585365853658535,40.0,0.0
410,0,410,[318  98  79  64 588],577,5,1587,3.8613138686131387,40.0,0.0
411,0,411,[ 88 748 121 258 191],151,3,1590,3.8592233009708736,0.0,0.0
412,0,412,[318  98  79  64 588],796,5,1595,3.861985472154964,40.0,0.0
413,0,413,[318  98  79  64 588],716,5,1600,3.864734299516908,40.0,0.0
414,0,414,[318  98  79  64 588],716,5,1605,3.8674698795180724,40.0,0.0
415,0,415,[265 210  56 197 471],457,5,1610,3.8701923076923075,0.0,0.0
416,0,416,[318  98  79  64 588],457,5,1615,3.8729016786570742,40.0,0.0
417,0,417,[318  98  79  64 588],796,5,1620,3.875598086124402,40.0,0.0
418,0,418,[318  98  79  64 588],457,5,1625,3.8782816229116945,40.0,0.0
419,0,419,[385 210 172 318 276],457,5,1630,3.880952380952381,20.0,0.0
420,0,420,[228 313 300 742  12],450,5,1635,3.883610451306413,0.0,0.0
421,0,421,[318  98  79  64 588],796,5,1640,3.8862559241706163,40.0,0.0
422,0,422,[174 228 195 405 117],457,5,1645,3.888888888888889,0.0,0.0
423,0,423,[318  98  79  64 588],577,5,1650,3.891509433962264,40.0,0.0
424,0,424,[318  98  79  64 588],716,5,1655,3.8941176470588235,40.0,0.0
425,0,425,[ 89 508  96   9 187],655,2,1657,3.8896713615023475,0.0,0.0
426,0,426,[318  98  79  64 588],716,5,1662,3.892271662763466,40.0,0.0
427,0,427,[318  98  79  64 588],796,5,1667,3.8948598130841123,40.0,0.0
428,0,428,[318  98  79  64 588],450,5,1672,3.8974358974358974,40.0,0.0
429,0,429,[546  12 195  97 204],344,3,1675,3.895348837209302,0.0,0.0
430,0,430,[ 69  97  15  50 423],593,5,1680,3.897911832946636,0.0,20.0
431,0,431,[318  98  79  64 588],457,5,1685,3.900462962962963,40.0,0.0
432,0,432,[200 546 127 216  95],786,5,1690,3.903002309468822,0.0,20.0
433,0,433,[318  98  79  64 588],457,5,1695,3.9055299539170507,40.0,0.0
434,0,434,[  1 204 191 118  69],796,4,1699,3.905747126436782,0.0,0.0
435,0,435,[211 151 282  25 143],450,4,1703,3.9059633027522938,0.0,0.0
436,0,436,[ 11 174 187 191 427],450,5,1708,3.908466819221968,20.0,0.0
437,0,437,[318  98  79  64 588],716,5,1713,3.910958904109589,40.0,0.0
438,0,438,[202 546  79 385 173],457,4,1717,3.9111617312072893,0.0,0.0
439,0,439,[318  98  79  64 588],18,5,1722,3.9136363636363636,40.0,0.0
440,0,440,[210 185 483  97 496],18,4,1726,3.9138321995464853,20.0,0.0
441,0,441,[318  98  79  64 588],18,5,1731,3.916289592760181,40.0,0.0
442,0,442,[  1 234 748 111 323],796,2,1733,3.9119638826185104,0.0,0.0
443,0,443,[318  98  79  64 588],450,5,1738,3.9144144144144146,40.0,0.0
444,0,444,[318  98  79  64 588],457,5,1743,3.9168539325842695,40.0,0.0
445,0,445,[318  98  79  64 588],796,5,1748,3.9192825112107625,40.0,0.0
446,0,446,[546 194  71 173 318],796,5,1753,3.9217002237136467,20.0,0.0
447,0,447,[423 127 197 245 357],450,5,1758,3.924107142857143,0.0,20.0
448,0,448,[144 282  82 202 405],450,4,1762,3.9242761692650334,0.0,0.0
449,0,449,[603 180 127 294 161],716,3,1765,3.922222222222222,20.0,20.0
450,0,450,[318  98  79  64 588],577,5,1770,3.9246119733924614,40.0,0.0
451,0,451,[271 286  96 333  95],796,4,1774,3.924778761061947,0.0,20.0
452,0,452,[742 238  98 100 322],450,5,1779,3.9271523178807946,0.0,20.0
453,0,453,[318  98  79  64 588],457,5,1784,3.9295154185022025,40.0,0.0
454,0,454,[318  98  79  64 588],457,5,1789,3.9318681318681317,40.0,0.0
455,0,455,[318  98  79  64 588],450,5,1794,3.9342105263157894,40.0,0.0
456,0,456,[333 118 127 257 427],655,2,1796,3.9299781181619258,20.0,20.0
457,0,457,[318  98  79  64 588],18,5,1801,3.932314410480349,40.0,0.0
458,0,458,[ 70 423  28 143  97],716,5,1806,3.934640522875817,0.0,0.0
459,0,459,[318  98  79  64 588],18,5,1811,3.9369565217391305,40.0,0.0
460,0,460,[174 294 597 211 275],796,3,1814,3.934924078091106,0.0,20.0
461,0,461,[204 318  98   4 588],457,5,1819,3.9372294372294374,20.0,0.0
462,0,462,[318  98  79  64 588],796,5,1824,3.939524838012959,40.0,0.0
463,0,463,[222 143 151   7 385],457,5,1829,3.9418103448275863,0.0,0.0
464,0,464,[ 69 118 181 168   4],504,3,1832,3.9397849462365593,0.0,0.0
465,0,465,[100 175   8 191  69],344,4,1836,3.939914163090129,0.0,20.0
466,0,466,[483 185 275 302  98],389,5,1841,3.942184154175589,0.0,20.0
467,0,467,[ 22 235  82 161 196],269,0,1841,3.9337606837606836,0.0,0.0
468,0,468,[ 11  98 483  82 568],655,2,1843,3.929637526652452,0.0,0.0
469,0,469,[276   9 265 258 268],535,2,1845,3.925531914893617,0.0,0.0
470,0,470,[483  98 238 191  64],796,4,1849,3.9256900212314223,20.0,0.0
471,0,471,[318  98  79  64 588],577,5,1854,3.9279661016949152,40.0,0.0
472,0,472,[318  98  79  64 588],450,5,1859,3.9302325581395348,40.0,0.0
473,0,473,[125  88 258 288 302],450,4,1863,3.930379746835443,0.0,0.0
474,0,474,[ 64 153  22 269 603],796,4,1867,3.9305263157894736,40.0,0.0
475,0,475,[318  98  79  64 588],450,5,1872,3.9327731092436973,40.0,0.0
476,0,476,[655 234 179 173 127],450,4,1876,3.9329140461215935,0.0,20.0
477,0,477,[318  98  79  64 588],796,5,1881,3.935146443514644,40.0,0.0
478,0,478,[194 161 603  28 568],798,3,1884,3.933194154488518,20.0,0.0
479,0,479,[546  88 222  79  64],457,4,1888,3.933333333333333,20.0,0.0
480,0,480,[182 100 202 216 161],450,5,1893,3.9355509355509355,0.0,20.0
481,0,481,[153  82 210 202  25],389,2,1895,3.9315352697095434,0.0,0.0
482,0,482,[318  98  79  64 588],18,5,1900,3.9337474120082816,40.0,0.0
483,0,483,[ 98  15 597 181 234],796,4,1904,3.9338842975206614,0.0,0.0
484,0,484,[228  98 405   4  71],450,3,1907,3.9319587628865977,0.0,0.0
485,0,485,[318  98  79  64 588],716,5,1912,3.934156378600823,40.0,0.0
486,0,486,[194  79 215 318 196],450,5,1917,3.9363449691991788,20.0,0.0
487,0,487,[323  12 742   1  82],256,5,1922,3.9385245901639343,0.0,0.0
488,0,488,[121 405 546 313 300],796,5,1927,3.9406952965235176,0.0,0.0
489,0,489,[318  98  79  64 588],716,5,1932,3.942857142857143,40.0,0.0
490,0,490,[318  98  79  64 588],18,5,1937,3.945010183299389,40.0,0.0
491,0,491,[196 143 161 111 186],885,4,1941,3.9451219512195124,0.0,0.0
492,0,492,[ 82  22 200 121  64],457,5,1946,3.947261663286004,20.0,0.0
493,0,493,[471  82  64 427 357],655,3,1949,3.945344129554656,40.0,0.0
494,0,494,[318  98  79  64 588],577,5,1954,3.9474747474747476,40.0,0.0
495,0,495,[318  98  79  64 588],796,5,1959,3.9495967741935485,40.0,0.0
496,0,496,[ 12 483 286 403 185],18,3,1962,3.947686116700201,0.0,20.0
497,0,497,[318  98  79  64 588],716,5,1967,3.9497991967871484,40.0,0.0
498,0,498,[300 318 385 546  95],450,4,1971,3.9498997995991982,20.0,0.0
499,0,499,[ 50  79 237 275 195],535,4,1975,3.95,0.0,40.0
500,0,500,[286  98 471 268 603],655,2,1977,3.946107784431138,20.0,20.0
501,0,501,[318  98  64  79 588],796,5,1982,3.948207171314741,40.0,0.0
502,0,502,[200 151 117 194  79],450,4,1986,3.94831013916501,0.0,0.0
503,0,503,[ 98 275 228 175 202],151,5,1991,3.9503968253968256,0.0,20.0
504,0,504,[ 88 151 132  50 200],330,5,1996,3.9524752475247524,0.0,20.0
505,0,505,[318  98  64  79 588],457,5,2001,3.9545454545454546,40.0,0.0
506,0,506,[318  98  64  79 588],450,5,2006,3.9566074950690333,40.0,0.0
507,0,507,[100  82 269 179   1],655,1,2007,3.9507874015748032,0.0,20.0
508,0,508,[215  50   4 197  98],655,2,2009,3.9469548133595285,0.0,20.0
509,0,509,[265  95 111 125 258],798,3,2012,3.9450980392156865,0.0,0.0
510,0,510,[318  98  64  79 588],577,5,2017,3.9471624266144816,40.0,0.0
511,0,511,[ 88 423 357 302 435],655,2,2019,3.943359375,0.0,0.0
512,0,512,[ 70 186 483 200   9],151,4,2023,3.943469785575049,0.0,0.0
513,0,513,[471 423 210 182 405],593,1,2024,3.937743190661479,0.0,0.0
514,0,514,[318  98  64  79 588],450,5,2029,3.9398058252427184,40.0,0.0
515,0,515,[318  98  64  79 588],450,5,2034,3.941860465116279,40.0,0.0
516,0,516,[ 56  82 294 216 215],23,2,2036,3.9381044487427466,0.0,0.0
517,0,517,[328   4 265 515 176],655,1,2037,3.9324324324324325,0.0,0.0
518,0,518,[  8 275 286 210 216],796,3,2040,3.930635838150289,0.0,40.0
519,0,519,[318  98  64  79 588],796,5,2045,3.9326923076923075,40.0,0.0
520,0,520,[405 174 301 187 427],796,4,2049,3.9328214971209214,20.0,0.0
521,0,521,[318  98  64  79 588],796,5,2054,3.9348659003831417,40.0,0.0
522,0,522,[323  11 182   4 322],280,2,2056,3.931166347992352,0.0,0.0
523,0,523,[276 286 423 357 118],655,2,2058,3.927480916030534,0.0,20.0
524,0,524,[ 22 228 204 210  70],716,5,2063,3.9295238095238094,0.0,0.0
525,0,525,[546 121 191  97  70],457,4,2067,3.929657794676806,0.0,0.0
526,0,526,[186 435 357 144 237],450,4,2071,3.9297912713472485,0.0,0.0
527,0,527,[202  82 186   8 655],577,5,2076,3.9318181818181817,0.0,0.0
528,0,528,[318  98  64  79 588],577,5,2081,3.9338374291115312,40.0,0.0
529,0,529,[435  50 471 271 286],655,1,2082,3.9283018867924526,0.0,40.0
530,0,530,[318 180 403  70 237],280,3,2085,3.926553672316384,20.0,0.0
531,0,531,[186 172 144 151 323],796,3,2088,3.924812030075188,0.0,0.0
532,0,532,[  7  12 237 405 313],344,2,2090,3.921200750469043,0.0,0.0
533,0,533,[318  98  64  79 588],716,5,2095,3.9232209737827715,40.0,0.0
534,0,534,[318  98  64  79 588],716,5,2100,3.925233644859813,40.0,0.0
535,0,535,[318  98  64  79 588],577,5,2105,3.9272388059701493,40.0,0.0
536,0,536,[235 200 194  15 196],450,2,2107,3.9236499068901303,0.0,0.0
537,0,537,[318  98  64  79 588],577,5,2112,3.925650557620818,40.0,0.0
538,0,538,[655  69 153 200 195],716,4,2116,3.9257884972170687,0.0,0.0
539,0,539,[172 181  50  56 143],655,3,2119,3.924074074074074,0.0,20.0
540,0,540,[748 153  98 200 423],280,4,2123,3.924214417744917,0.0,0.0
541,0,541,[121 186 471 196 172],786,4,2127,3.9243542435424352,0.0,0.0
542,0,542,[181 182  88  89 323],796,4,2131,3.9244935543278086,0.0,0.0
543,0,543,[318  98  64  79 588],577,5,2136,3.926470588235294,40.0,0.0
544,0,544,[215 195 191 435 168],450,5,2141,3.928440366972477,0.0,0.0
545,0,545,[318  98  64  79 588],450,5,2146,3.93040293040293,40.0,0.0
546,0,546,[ 79 471 322 200 235],280,4,2150,3.930530164533821,0.0,0.0
547,0,547,[318  98  64  79 588],457,5,2155,3.9324817518248176,40.0,0.0
548,0,548,[269 197 301  56 195],535,4,2159,3.9326047358834244,0.0,0.0
549,0,549,[318  98  64  79 588],796,5,2164,3.9345454545454546,40.0,0.0
550,0,550,[318  98  64  79 588],457,5,2169,3.9364791288566243,40.0,0.0
551,0,551,[210 222 204  12 197],457,5,2174,3.9384057971014492,0.0,0.0
552,0,552,[210 153  25  71 302],389,2,2176,3.934900542495479,0.0,0.0
553,0,553,[318  98  64  79 588],457,5,2181,3.936823104693141,40.0,0.0
554,0,554,[318  98  64  79 588],577,5,2186,3.938738738738739,40.0,0.0
555,0,555,[655 211 153 237 195],655,0,2186,3.931654676258993,0.0,0.0
556,0,556,[111  15 144 475 508],296,3,2189,3.9299820466786355,0.0,0.0
557,0,557,[318  98  64  79 588],450,5,2194,3.931899641577061,40.0,0.0
558,0,558,[546 471 276 405 144],593,1,2195,3.926654740608229,0.0,0.0
559,0,559,[180 168 603 135 191],269,4,2199,3.9267857142857143,20.0,0.0
560,0,560,[496  69 546 111 200],280,5,2204,3.928698752228164,20.0,0.0
561,0,561,[318  98  64  79 588],450,5,2209,3.9306049822064058,40.0,0.0
562,0,562,[ 1 95 88 11 22],450,4,2213,3.930728241563055,0.0,0.0
563,0,563,[318  98  64  79 588],796,5,2218,3.9326241134751774,40.0,0.0
564,0,564,[427 185 182 121 161],796,5,2223,3.9345132743362834,20.0,0.0
565,0,565,[318  98  64  79 588],716,5,2228,3.9363957597173145,40.0,0.0
566,0,566,[ 89 118 302 483 496],450,3,2231,3.9347442680776012,20.0,0.0
567,0,567,[ 97 216  15  28 385],577,4,2235,3.9348591549295775,0.0,0.0
568,0,568,[318  98  64  79 588],577,5,2240,3.936731107205624,40.0,0.0
569,0,569,[318  98  64  79 588],716,5,2245,3.93859649122807,40.0,0.0
570,0,570,[168   4 204 588  82],389,5,2250,3.9404553415061296,0.0,0.0
571,0,571,[318  98  64  79 588],577,5,2255,3.9423076923076925,40.0,0.0
572,0,572,[118 127 273 276 603],655,4,2259,3.9424083769633507,20.0,20.0
573,0,573,[318  98  64  79 588],716,5,2264,3.9442508710801394,40.0,0.0
574,0,574,[318  98  64  79 588],450,5,2269,3.946086956521739,40.0,0.0
575,0,575,[121 385 423 238 210],655,0,2269,3.939236111111111,0.0,0.0
576,0,576,[234 238 496 423 276],269,4,2273,3.9393414211438476,20.0,0.0
577,0,577,[385  96  82 237 132],577,5,2278,3.9411764705882355,0.0,0.0
578,0,578,[288 228 111 216  28],655,1,2279,3.936096718480138,0.0,0.0
579,0,579,[121 235  11 385 204],457,4,2283,3.9362068965517243,0.0,0.0
580,0,580,[234 216 200 191 435],655,3,2286,3.9345955249569706,0.0,0.0
581,0,581,[161 289 655  12  15],655,0,2286,3.9278350515463916,0.0,0.0
582,0,582,[318  98  64  79 588],18,5,2291,3.9296740994854202,40.0,0.0
583,0,583,[318  98  64  79 588],18,5,2296,3.9315068493150687,40.0,0.0
584,0,584,[194 191 318 222  22],450,4,2300,3.9316239316239314,20.0,0.0
585,0,585,[151 173 202 210 100],269,2,2302,3.9283276450511946,0.0,20.0
586,0,586,[318  98  64  79 588],18,5,2307,3.93015332197615,40.0,0.0
587,0,587,[196  96 568 313 191],577,4,2311,3.9302721088435373,0.0,0.0
588,0,588,[318  98  64  79 588],457,5,2316,3.932088285229202,40.0,0.0
589,0,589,[318  98  64  79 588],577,5,2321,3.9338983050847456,40.0,0.0
590,0,590,[318  98  64  79 588],18,5,2326,3.9357021996615904,40.0,0.0
591,0,591,[ 50 328 322 195  11],450,5,2331,3.9375,0.0,20.0
592,0,592,[318  98  64  79 588],716,5,2336,3.93929173693086,40.0,0.0
593,0,593,[286 515 197 185 121],655,2,2338,3.936026936026936,0.0,20.0
594,0,594,[237 185 174  25 313],835,5,2343,3.9378151260504204,0.0,0.0
595,0,595,[318  98  64  79 588],796,5,2348,3.9395973154362416,40.0,0.0
596,0,596,[318  98  64  79 588],450,5,2353,3.9413735343383585,40.0,0.0
597,0,597,[318  98  64  79 588],577,5,2358,3.94314381270903,40.0,0.0
598,0,598,[318  98  64  79 588],577,5,2363,3.944908180300501,40.0,0.0
599,0,599,[318  98  64  79 588],716,5,2368,3.9466666666666668,40.0,0.0
600,0,600,[ 69 204  70 294 135],655,1,2369,3.9417637271214643,0.0,0.0
601,0,601,[318  98  64  79 588],796,5,2374,3.9435215946843853,40.0,0.0
602,0,602,[318  98  64  79 588],457,5,2379,3.945273631840796,40.0,0.0
603,0,603,[318  98  64  79 588],716,5,2384,3.947019867549669,40.0,0.0
604,0,604,[318  98  64  79 588],18,5,2389,3.9487603305785126,40.0,0.0
605,0,605,[ 79 237 216 127 100],450,5,2394,3.9504950495049505,0.0,40.0
606,0,606,[405 200 282 742 423],457,5,2399,3.952224052718287,0.0,0.0
607,0,607,[282 168   7 301 603],450,5,2404,3.9539473684210527,20.0,0.0
608,0,608,[546 210  25 471 151],256,5,2409,3.955665024630542,0.0,0.0
609,0,609,[  8 385  95 238 191],796,4,2413,3.955737704918033,0.0,0.0
610,0,610,[288 603  98  82 176],655,2,2415,3.9525368248772503,20.0,0.0
611,0,611,[318  98  64  79 588],18,5,2420,3.954248366013072,40.0,0.0
612,0,612,[318  98  64  79 588],716,5,2425,3.9559543230016314,40.0,0.0
613,0,613,[318  98  64  79 588],450,5,2430,3.957654723127036,40.0,0.0
614,0,614,[427 172 183 173 588],316,1,2431,3.9528455284552844,20.0,0.0
615,0,615,[318  98  64  79 588],796,5,2436,3.9545454545454546,40.0,0.0
616,0,616,[318  98  64  79 588],457,5,2441,3.9562398703403567,40.0,0.0
617,0,617,[117 172  97 183 508],655,2,2443,3.953074433656958,0.0,0.0
618,0,618,[187 211  12 196 144],450,5,2448,3.9547657512116317,0.0,0.0
619,0,619,[204  12 405  88  71],796,5,2453,3.956451612903226,0.0,0.0
620,0,620,[318  98  64  79 588],796,5,2458,3.9581320450885666,40.0,0.0
621,0,621,[228 118 172 135  98],330,4,2462,3.9581993569131835,0.0,0.0
622,0,622,[216 228 742 144 210],280,2,2464,3.955056179775281,0.0,0.0
623,0,623,[496  82 318 100  70],18,4,2468,3.9551282051282053,40.0,20.0
624,0,624,[318  98  64  79 588],457,5,2473,3.9568,40.0,0.0
625,0,625,[195 427 237 496 181],450,5,2478,3.9584664536741214,40.0,0.0
626,0,626,[515  96   9 405 276],292,4,2482,3.958532695374801,0.0,0.0
627,0,627,[282 175  97 127  64],716,3,2485,3.9570063694267517,20.0,20.0
628,0,628,[318  98  64  79 588],18,5,2490,3.958664546899841,40.0,0.0
629,0,629,[318  98  64  79 588],716,5,2495,3.9603174603174605,40.0,0.0
630,0,630,[275 216  88 282  79],236,3,2498,3.958795562599049,0.0,20.0
631,0,631,[318  98  64  79 588],457,5,2503,3.9604430379746836,40.0,0.0
632,0,632,[135 194 515 180 197],535,3,2506,3.9589257503949447,0.0,0.0
633,0,633,[ 56 153 168 172 603],716,5,2511,3.9605678233438484,20.0,0.0
634,0,634,[216 180  69 174 405],835,4,2515,3.9606299212598426,0.0,0.0
635,0,635,[121 168 228 234 258],796,4,2519,3.960691823899371,0.0,0.0
636,0,636,[318  98  64  79 588],450,5,2524,3.9623233908948197,40.0,0.0
637,0,637,[318  98  64  79 588],716,5,2529,3.9639498432601883,40.0,0.0
638,0,638,[318  98  64  79 588],577,5,2534,3.9655712050078247,40.0,0.0
639,0,639,[318  98  64  79 588],577,5,2539,3.9671875,40.0,0.0
640,0,640,[318  98  64  79 588],457,5,2544,3.968798751950078,40.0,0.0
641,0,641,[318  98  64  79 588],716,5,2549,3.970404984423676,40.0,0.0
642,0,642,[318  98  64  79 588],457,5,2554,3.9720062208398135,40.0,0.0
643,0,643,[318  98  64  79 588],457,5,2559,3.9736024844720497,40.0,0.0
644,0,644,[318  98  64  79 588],716,5,2564,3.975193798449612,40.0,0.0
645,0,645,[318  98  64  79 588],18,5,2569,3.976780185758514,40.0,0.0
646,0,646,[318  98  64  79 588],457,5,2574,3.978361669242658,40.0,0.0
647,0,647,[318  98  64  79 588],577,5,2579,3.9799382716049383,40.0,0.0
648,0,648,[405 496  79 186 180],716,3,2582,3.978428351309707,20.0,0.0
649,0,649,[318  98  64  79 588],577,5,2587,3.98,40.0,0.0
650,0,650,[318  98  64  79 588],457,5,2592,3.9815668202764978,40.0,0.0
651,0,651,[318  98  64  79 588],716,5,2597,3.983128834355828,40.0,0.0
652,0,652,[313 161   1 265 496],280,4,2601,3.9831546707503827,20.0,0.0
653,0,653,[318  98  64  79 588],450,5,2606,3.984709480122324,40.0,0.0
654,0,654,[  1  97 286 568 328],450,5,2611,3.9862595419847326,0.0,20.0
655,0,655,[  4 121 210 127   1],457,5,2616,3.9878048780487805,0.0,20.0
656,0,656,[282 403 176 483 153],450,4,2620,3.9878234398782344,0.0,0.0
657,0,657,[125 182 161 323 265],796,4,2624,3.987841945288754,0.0,0.0
658,0,658,[318  98  64  79 588],18,5,2629,3.98937784522003,40.0,0.0
659,0,659,[318  98  64  79 588],450,5,2634,3.9909090909090907,40.0,0.0
660,0,660,[318  98  64  79 588],577,5,2639,3.9924357034795763,40.0,0.0
661,0,661,[143 132 275 385 222],457,5,2644,3.9939577039274923,0.0,20.0
662,0,662,[187 127 181 161 603],796,5,2649,3.995475113122172,20.0,20.0
663,0,663,[257 181 286 265 183],796,4,2653,3.9954819277108435,0.0,20.0
664,0,664,[318  98  64  79 588],577,5,2658,3.9969924812030073,40.0,0.0
665,0,665,[318  98  64  79 588],457,5,2663,3.9984984984984986,40.0,0.0
666,0,666,[182  64 168  79   8],457,5,2668,4.0,20.0,0.0
667,0,667,[168 215 471 143 197],457,5,2673,4.001497005988024,0.0,0.0
668,0,668,[194 181 215 588 111],796,5,2678,4.002989536621824,0.0,0.0
669,0,669,[197   4  15 143 237],450,3,2681,4.001492537313433,0.0,0.0
670,0,670,[175 197   1 515 216],18,5,2686,4.002980625931445,0.0,0.0
671,0,671,[176 153 222 748 161],450,4,2690,4.002976190476191,0.0,0.0
672,0,672,[318  98  64  79 588],450,5,2695,4.00445765230312,40.0,0.0
673,0,673,[282 222 100 289 265],655,0,2695,3.9985163204747773,0.0,20.0
674,0,674,[ 15 282 181  11  98],655,1,2696,3.994074074074074,0.0,0.0
675,0,675,[ 15 333 423 197 597],174,3,2699,3.992603550295858,0.0,0.0
676,0,676,[191 238  69 546 195],450,5,2704,3.9940915805022157,0.0,0.0
677,0,677,[172   7 597   8   1],344,3,2707,3.9926253687315634,0.0,0.0
678,0,678,[  7  97 228  25   8],655,0,2707,3.9867452135493373,0.0,0.0
679,0,679,[313 191 127 273 202],655,4,2711,3.986764705882353,0.0,20.0
680,0,680,[276 168   1  56 403],18,3,2714,3.9853157121879588,0.0,0.0
681,0,681,[ 56 151 258 222  79],296,4,2718,3.9853372434017595,0.0,0.0
682,0,682,[179 294 175 282 200],655,2,2720,3.9824304538799415,0.0,0.0
683,0,683,[318  98  64  79 588],450,5,2725,3.9839181286549707,40.0,0.0
684,0,684,[318  98  64  79 588],450,5,2730,3.9854014598540144,40.0,0.0
685,0,685,[ 88   7 175 151 238],269,3,2733,3.9839650145772594,0.0,0.0
686,0,686,[195 568   7 357 597],269,1,2734,3.97962154294032,0.0,0.0
687,0,687,[ 11 194 153 175 655],716,4,2738,3.979651162790698,0.0,0.0
688,0,688,[318  98  64  79 588],457,5,2743,3.981132075471698,40.0,0.0
689,0,689,[318  98  64  79 588],796,5,2748,3.982608695652174,40.0,0.0
690,0,690,[ 28 313 273 405  11],450,4,2752,3.9826338639652676,0.0,0.0
691,0,691,[357 210  11 302 144],655,2,2754,3.979768786127168,0.0,0.0
692,0,692,[ 22 211 135 288 181],655,1,2755,3.9754689754689756,0.0,0.0
693,0,693,[143 132 237 515 111],655,2,2757,3.972622478386167,0.0,0.0
694,0,694,[294 427  50 258 181],796,4,2761,3.972661870503597,20.0,20.0
695,0,695,[269  98 204 603 121],796,4,2765,3.9727011494252875,20.0,0.0
696,0,696,[318  98  64  79 588],577,5,2770,3.9741750358680057,40.0,0.0
697,0,697,[318  98  64  79 588],796,5,2775,3.975644699140401,40.0,0.0
698,0,698,[161 196  70  82 180],716,3,2778,3.9742489270386265,0.0,0.0
699,0,699,[173 180   1  70 215],716,4,2782,3.974285714285714,0.0,0.0
700,0,700,[ 79   9 215 194 228],11,3,2785,3.9728958630527815,0.0,0.0
701,0,701,[118 271  89 200 257],796,5,2790,3.9743589743589745,0.0,0.0
702,0,702,[ 50 172 276   9 132],629,5,2795,3.9758179231863444,0.0,20.0
703,0,703,[318  98  64  79 588],577,5,2800,3.977272727272727,40.0,0.0
704,0,704,[318  98  64  79 588],796,5,2805,3.978723404255319,40.0,0.0
705,0,705,[318  98  64  79 588],577,5,2810,3.9801699716713883,40.0,0.0
706,0,706,[ 28 204 475 427  79],389,5,2815,3.9816124469589815,20.0,0.0
707,0,707,[127 111 546  15 294],450,4,2819,3.981638418079096,0.0,20.0
708,0,708,[ 50 176  97  28 289],655,1,2820,3.9774330042313117,0.0,20.0
709,0,709,[318  98  64  79 588],457,5,2825,3.9788732394366195,40.0,0.0
710,0,710,[  1 121 275  15  71],786,3,2828,3.9774964838255977,0.0,20.0
711,0,711,[318  98  64  79 588],577,5,2833,3.978932584269663,40.0,0.0
712,0,712,[322 655 215 111  15],796,3,2836,3.9775596072931276,0.0,0.0
713,0,713,[318  98  64  79 588],716,5,2841,3.9789915966386555,40.0,0.0
714,0,714,[655 127 202 181 197],796,3,2844,3.9776223776223776,0.0,20.0
715,0,715,[168 273 546 286 135],450,3,2847,3.9762569832402233,0.0,20.0
716,0,716,[318  98  64  79 588],796,5,2852,3.9776847977684797,40.0,0.0
717,0,717,[588  95 286 202  50],796,4,2856,3.977715877437326,0.0,40.0
718,0,718,[318  98  64  79 588],716,5,2861,3.9791376912378302,40.0,0.0
719,0,719,[ 12 118 678 323  98],256,5,2866,3.9805555555555556,0.0,0.0
720,0,720,[ 97 238 182 234 197],18,4,2870,3.9805825242718447,0.0,0.0
721,0,721,[234 597 173 237 603],796,4,2874,3.9806094182825484,20.0,0.0
722,0,722,[385 257 118 568 144],716,2,2876,3.9778699861687414,0.0,0.0
723,0,723,[275 546 100 238 215],450,5,2881,3.979281767955801,0.0,40.0
724,0,724,[275 234 603 125 257],655,2,2883,3.976551724137931,20.0,20.0
725,0,725,[180 204 222 215   9],457,5,2888,3.9779614325068873,0.0,0.0
726,0,726,[ 69 196 179  79 180],457,5,2893,3.9793672627235215,0.0,0.0
727,0,727,[ 95 111  56  12 125],280,4,2897,3.9793956043956045,0.0,0.0
728,0,728,[111 294  71 176 222],236,2,2899,3.9766803840877913,0.0,0.0
729,0,729,[269 202 143 313 197],796,3,2902,3.9753424657534246,0.0,0.0
730,0,730,[161 191 200 117 173],457,5,2907,3.9767441860465116,0.0,0.0
731,0,731,[435  25 197 182 153],450,4,2911,3.976775956284153,0.0,0.0
732,0,732,[161   1 655 357 228],457,5,2916,3.9781718963165074,0.0,0.0
733,0,733,[172 200 100 265   1],457,5,2921,3.9795640326975477,0.0,20.0
734,0,734,[117 237 435  50 143],655,2,2923,3.9768707482993197,0.0,20.0
735,0,735,[ 96  79 265  28 333],655,1,2924,3.972826086956522,0.0,0.0
736,0,736,[204 427  69 117 111],655,1,2925,3.9687924016282223,20.0,0.0
737,0,737,[186 117 245 483 237],796,3,2928,3.967479674796748,0.0,0.0
738,0,738,[357 195 181 174  82],716,4,2932,3.9675236806495264,0.0,0.0
739,0,739,[196 132  71 234 153],504,3,2935,3.9662162162162162,0.0,0.0
740,0,740,[588  50 286   7 211],786,5,2940,3.967611336032389,0.0,40.0
741,0,741,[132 172 275 183 301],344,5,2945,3.9690026954177897,0.0,20.0
742,0,742,[172   9 197   7  97],535,4,2949,3.969044414535666,0.0,0.0
743,0,743,[403 427   4 172  50],796,5,2954,3.9704301075268815,20.0,20.0
744,0,744,[357 195  12  15 318],655,2,2956,3.967785234899329,20.0,0.0
745,0,745,[118   1 333 174 427],796,4,2960,3.967828418230563,20.0,0.0
746,0,746,[228 132 222 405 173],151,4,2964,3.967871485943775,0.0,0.0
747,0,747,[748 405 423 161 265],796,5,2969,3.9692513368983957,0.0,0.0
748,0,748,[265 161 121 180 173],786,4,2973,3.9692923898531376,0.0,0.0
749,0,749,[318 588 204 174  64],457,5,2978,3.970666666666667,40.0,0.0
750,0,750,[228 568 135 322 508],280,2,2980,3.9680426098535286,0.0,0.0
751,0,751,[282 187 268  50 172],296,5,2985,3.9694148936170213,0.0,20.0
752,0,752,[  4 202  69 204 194],151,5,2990,3.9707835325365206,0.0,0.0
753,0,753,[471  69 423 655 265],457,5,2995,3.9721485411140582,0.0,0.0
754,0,754,[ 28 200 135 185   9],457,5,3000,3.9735099337748343,0.0,0.0
755,0,755,[357 289   8 172 655],655,2,3002,3.9708994708994707,0.0,0.0
756,0,756,[ 50  96 194 187  28],716,3,3005,3.9696169088507265,0.0,20.0
757,0,757,[187  95 135 118  56],716,2,3007,3.967018469656992,0.0,0.0
758,0,758,[328 121  71  56  11],450,3,3010,3.9657444005270093,0.0,0.0
759,0,759,[322 111 185 603 215],151,3,3013,3.9644736842105264,20.0,0.0
760,0,760,[153 151 265 180 302],450,5,3018,3.9658344283837055,0.0,0.0
761,0,761,[175 179 265 195  25],457,5,3023,3.9671916010498687,0.0,0.0
762,0,762,[  9 151 588   8 603],756,4,3027,3.967234600262123,20.0,0.0
763,0,763,[276 174 197   8 357],457,5,3032,3.968586387434555,0.0,0.0
764,0,764,[121 275 742 173 196],796,4,3036,3.9686274509803923,0.0,20.0
765,0,765,[234 257  97 282 423],504,4,3040,3.968668407310705,0.0,0.0
766,0,766,[286 216  12 100 427],503,3,3043,3.967405475880052,20.0,40.0
767,0,767,[135  96 655 269  88],655,1,3044,3.9635416666666665,0.0,0.0
768,0,768,[423  50   8 546 135],280,4,3048,3.963589076723017,0.0,20.0
769,0,769,[216  71  79 144 127],796,5,3053,3.964935064935065,0.0,20.0
770,0,770,[174 127  89  12 568],655,2,3055,3.9623865110246435,0.0,20.0
771,0,771,[200 180 195 186 427],269,2,3057,3.959844559585492,20.0,0.0
772,0,772,[144 269 215   9 483],655,1,3058,3.9560155239327295,0.0,0.0
773,0,773,[245 186 742 196  69],796,2,3060,3.953488372093023,0.0,0.0
774,0,774,[271 179 405 161  96],655,1,3061,3.9496774193548387,0.0,0.0
775,0,775,[257 211 202 215   8],796,4,3065,3.9497422680412373,0.0,0.0
776,0,776,[197 655 496 187 182],535,3,3068,3.9485199485199485,20.0,0.0
777,0,777,[202 328 100 678 237],401,3,3071,3.9473007712082264,0.0,20.0
778,0,778,[318  98  64  79 588],450,5,3076,3.9486521181001284,40.0,0.0
779,0,779,[222 168  11 179  22],450,4,3080,3.948717948717949,0.0,0.0
780,0,780,[211  28  50 423  96],655,1,3081,3.9449423815621,0.0,20.0
781,0,781,[318  98  64  79 588],457,5,3086,3.946291560102302,40.0,0.0
782,0,782,[ 98 294  70  28 215],23,1,3087,3.942528735632184,0.0,0.0
783,0,783,[117 322 265  82 132],280,4,3091,3.9426020408163267,0.0,0.0
784,0,784,[245 322 301 597 100],450,5,3096,3.9439490445859873,0.0,20.0
785,0,785,[603  69 186 234 215],18,1,3097,3.940203562340967,20.0,0.0
786,0,786,[111 144 204 173 276],457,4,3101,3.940279542566709,0.0,0.0
787,0,787,[135 435  89 302 471],450,4,3105,3.9403553299492384,0.0,0.0
788,0,788,[235 100 237  25 187],450,3,3108,3.9391634980988592,0.0,20.0
789,0,789,[318  98  64  79 588],796,5,3113,3.940506329113924,40.0,0.0
790,0,790,[168 111  95 181 179],577,4,3117,3.940581542351454,0.0,0.0
791,0,791,[228 282 322 176 300],796,4,3121,3.9406565656565657,0.0,0.0
792,0,792,[318  98  64  79 588],457,5,3126,3.9419924337957126,40.0,0.0
793,0,793,[318  98  64  79 588],716,5,3131,3.943324937027708,40.0,0.0
794,0,794,[318  98  64  79 588],796,5,3136,3.9446540880503145,40.0,0.0
795,0,795,[318  98  64  79 588],716,5,3141,3.9459798994974875,40.0,0.0
796,0,796,[318  98  64  79 588],457,5,3146,3.9473023839397743,40.0,0.0
797,0,797,[318  98  64  79 588],18,5,3151,3.9486215538847116,40.0,0.0
798,0,798,[318  98  64  79 588],577,5,3156,3.9499374217772214,40.0,0.0
799,0,799,[301 496  98   7 127],450,5,3161,3.95125,20.0,20.0
800,0,800,[318  98  64  79 588],457,5,3166,3.9525593008739075,40.0,0.0
801,0,801,[318  98  64  79 588],577,5,3171,3.953865336658354,40.0,0.0
802,0,802,[318  98  64  79 588],457,5,3176,3.955168119551681,40.0,0.0
803,0,803,[318  98  64  79 588],457,5,3181,3.9564676616915424,40.0,0.0
804,0,804,[318  98  64  79 588],18,5,3186,3.9577639751552796,40.0,0.0
805,0,805,[132 187 191  64 144],655,3,3189,3.956575682382134,20.0,0.0
806,0,806,[211  56 265   4  95],796,4,3193,3.956629491945477,0.0,0.0
807,0,807,[176 182  64 118 121],457,5,3198,3.957920792079208,20.0,0.0
808,0,808,[318  98  64  79 588],796,5,3203,3.9592088998763906,40.0,0.0
809,0,809,[318  98  64  79 588],457,5,3208,3.960493827160494,40.0,0.0
810,0,810,[318  98  64  79 588],450,5,3213,3.961775585696671,40.0,0.0
811,0,811,[271 568 211 135 423],655,1,3214,3.958128078817734,0.0,0.0
812,0,812,[318  98  64  79 588],18,5,3219,3.959409594095941,40.0,0.0
813,0,813,[ 97  96 423 265 173],450,5,3224,3.960687960687961,0.0,0.0
814,0,814,[318  98  64  79 588],457,5,3229,3.9619631901840493,40.0,0.0
815,0,815,[318  98  64  79 588],457,5,3234,3.963235294117647,40.0,0.0
816,0,816,[191 182 405 300 234],796,4,3238,3.96328029375765,0.0,0.0
817,0,817,[318  98  64  79 588],457,5,3243,3.9645476772616135,40.0,0.0
818,0,818,[194 385  11 191 144],716,3,3246,3.9633699633699635,0.0,0.0
819,0,819,[258 168 176 216 322],504,4,3250,3.9634146341463414,0.0,0.0
820,0,820,[318  98  64  79 588],18,5,3255,3.964677222898904,40.0,0.0
821,0,821,[117 300 195  98 258],655,1,3256,3.9610705596107056,0.0,0.0
822,0,822,[475 183  15 127 655],655,2,3258,3.9586877278250303,0.0,20.0
823,0,823,[187 234 423 135 195],72,5,3263,3.9599514563106797,0.0,0.0
824,0,824,[318  98  64  79 588],457,5,3268,3.9612121212121214,40.0,0.0
825,0,825,[117 588 228 597 183],796,5,3273,3.9624697336561745,0.0,0.0
826,0,826,[125 127 483 180  71],796,4,3277,3.962515114873035,0.0,20.0
827,0,827,[318  98  64  79 588],577,5,3282,3.963768115942029,40.0,0.0
828,0,828,[318  98  64  79 588],450,5,3287,3.965018094089264,40.0,0.0
829,0,829,[483 174 195 275 185],655,3,3290,3.963855421686747,0.0,20.0
830,0,830,[196 282 423 546 357],504,5,3295,3.965102286401925,0.0,0.0
831,0,831,[483 191  98 210   1],457,5,3300,3.9663461538461537,0.0,0.0
832,0,832,[318  98  64  79 588],450,5,3305,3.9675870348139255,40.0,0.0
833,0,833,[153 427 143 186 603],18,4,3309,3.9676258992805757,40.0,0.0
834,0,834,[318  98  64  79 588],18,5,3314,3.968862275449102,40.0,0.0
835,0,835,[118 117   4  64 216],457,5,3319,3.9700956937799043,20.0,0.0
836,0,836,[ 89 318 153 161 301],796,4,3323,3.970131421744325,20.0,0.0
837,0,837,[318  98  64  79 588],796,5,3328,3.971360381861575,40.0,0.0
838,0,838,[  8 238 588 257 181],457,4,3332,3.971394517282479,0.0,0.0
839,0,839,[235 427 742  11 135],450,3,3335,3.9702380952380953,20.0,0.0
840,0,840,[318  98  64  79 588],796,5,3340,3.971462544589774,40.0,0.0
841,0,841,[ 50 405 211 118 127],450,4,3344,3.9714964370546317,0.0,40.0
842,0,842,[318  98  64  79 588],450,5,3349,3.9727164887307236,40.0,0.0
843,0,843,[ 69 275 210  88 121],330,5,3354,3.9739336492890995,0.0,20.0
844,0,844,[318  98  64  79 588],457,5,3359,3.9751479289940828,40.0,0.0
845,0,845,[318  98  64  79 588],796,5,3364,3.976359338061466,40.0,0.0
846,0,846,[271 210 153 132 191],655,1,3365,3.9728453364817002,0.0,0.0
847,0,847,[318  98  64  79 588],18,5,3370,3.974056603773585,40.0,0.0
848,0,848,[ 56 385 194 181 322],504,2,3372,3.9717314487632507,0.0,0.0
849,0,849,[269 222 322 385 181],450,4,3376,3.971764705882353,0.0,0.0
850,0,850,[234 257  82  22  79],716,5,3381,3.972972972972973,0.0,0.0
851,0,851,[238  25 100 216 132],330,5,3386,3.9741784037558685,0.0,20.0
852,0,852,[496  97  12 117  22],450,5,3391,3.975381008206331,20.0,0.0
853,0,853,[403  96 200  82 111],796,4,3395,3.9754098360655736,0.0,0.0
854,0,854,[238 180   9  28 200],18,3,3398,3.9742690058479533,0.0,0.0
855,0,855,[238  28   9 405 357],11,3,3401,3.9731308411214954,0.0,0.0
856,0,856,[215 282 153   7  50],450,5,3406,3.9743290548424737,0.0,20.0
857,0,857,[318  98  64  79 588],716,5,3411,3.9755244755244754,40.0,0.0
858,0,858,[286 588 125  70 185],401,2,3413,3.973224679860303,0.0,20.0
859,0,859,[289 286 475   8   1],655,0,3413,3.968604651162791,0.0,20.0
860,0,860,[289 153 257 427   7],296,4,3417,3.9686411149825784,20.0,0.0
861,0,861,[ 50 196  56 300 182],655,2,3419,3.9663573085846866,0.0,20.0
862,0,862,[318  98  64  79 588],577,5,3424,3.9675550405561992,40.0,0.0
863,0,863,[423  69 269 496   9],796,3,3427,3.966435185185185,20.0,0.0
864,0,864,[403 427 515 222 186],807,5,3432,3.967630057803468,20.0,0.0
865,0,865,[318  98  64  79 588],716,5,3437,3.968822170900693,40.0,0.0
866,0,866,[ 50 322 121 235 282],450,3,3440,3.9677047289504035,0.0,20.0
867,0,867,[318  98  64  79 588],716,5,3445,3.96889400921659,40.0,0.0
868,0,868,[318  98  64  79 588],18,5,3450,3.9700805523590335,40.0,0.0
869,0,869,[318  98  64  79 588],796,5,3455,3.971264367816092,40.0,0.0
870,0,870,[318  98  64  79 588],457,5,3460,3.9724454649827785,40.0,0.0
871,0,871,[191 322 185  69 174],450,5,3465,3.9736238532110093,0.0,0.0
872,0,872,[202 191 238 496 197],786,4,3469,3.9736540664375717,20.0,0.0
873,0,873,[318  98  64  79 588],450,5,3474,3.9748283752860414,40.0,0.0
874,0,874,[286 191  69  98 172],236,4,3478,3.9748571428571426,0.0,20.0
875,0,875,[318  98  64  79 588],716,5,3483,3.9760273972602738,40.0,0.0
876,0,876,[  7 237 181   9 286],277,3,3486,3.974914481185861,0.0,20.0
877,0,877,[318  98  64  79 588],796,5,3491,3.9760820045558085,40.0,0.0
878,0,878,[191 318 121 302 202],401,3,3494,3.974971558589306,20.0,0.0
879,0,879,[318  98  64  79 588],577,5,3499,3.9761363636363636,40.0,0.0
880,0,880,[ 82 174 204   8 427],655,1,3500,3.9727582292849033,20.0,0.0
881,0,881,[132  70 100  64 168],450,5,3505,3.973922902494331,20.0,20.0
882,0,882,[318  98  64  79 588],457,5,3510,3.9750849377123445,40.0,0.0
883,0,883,[318  98  64  79 588],577,5,3515,3.976244343891403,40.0,0.0
884,0,884,[111 151   9 275 185],151,5,3520,3.977401129943503,0.0,20.0
885,0,885,[168  50 588 427 385],716,4,3524,3.9774266365688487,20.0,20.0
886,0,886,[174  98  71 143 357],796,5,3529,3.9785794813979707,0.0,0.0
887,0,887,[318  98  64  79 588],18,5,3534,3.97972972972973,40.0,0.0
888,0,888,[121 237 117 182  89],796,5,3539,3.980877390326209,0.0,0.0
889,0,889,[258 268  25 357 288],344,3,3542,3.979775280898876,0.0,0.0
890,0,890,[181 483 183 143 597],796,5,3547,3.980920314253648,0.0,0.0
891,0,891,[318  98  64  79 588],796,5,3552,3.9820627802690582,40.0,0.0
892,0,892,[197  82  97 172 186],796,1,3553,3.978723404255319,0.0,0.0
893,0,893,[318  98  64  79 588],577,5,3558,3.9798657718120807,40.0,0.0
894,0,894,[302 200 483 234 179],655,4,3562,3.9798882681564245,0.0,0.0
895,0,895,[180 301 234 603 748],796,2,3564,3.9776785714285716,20.0,0.0
896,0,896,[318  98  64  79 588],796,5,3569,3.978818283166109,40.0,0.0
897,0,897,[294 117 143 144 588],796,4,3573,3.9788418708240534,0.0,0.0
898,0,898,[195 181 194 423 286],18,2,3575,3.9766407119021134,0.0,20.0
899,0,899,[318  98  64  79 588],577,5,3580,3.977777777777778,40.0,0.0
900,0,900,[318  98  64  79 588],796,5,3585,3.9789123196448393,40.0,0.0
901,0,901,[318  98  64  79 588],457,5,3590,3.9800443458980044,40.0,0.0
902,0,902,[222 118 286 275 288],450,2,3592,3.9778516057585827,0.0,40.0
903,0,903,[318  98  64  79 588],450,5,3597,3.978982300884956,40.0,0.0
904,0,904,[318  98  64  79 588],716,5,3602,3.980110497237569,40.0,0.0
905,0,905,[ 70 515 135 143  64],269,3,3605,3.979028697571744,20.0,0.0
906,0,906,[318  98  64  79 588],450,5,3610,3.980154355016538,40.0,0.0
907,0,907,[210  64  89 181 313],344,3,3613,3.9790748898678414,20.0,0.0
908,0,908,[174 118 265   1 185],457,5,3618,3.98019801980198,0.0,0.0
909,0,909,[318  98  64  79 588],18,5,3623,3.9813186813186814,40.0,0.0
910,0,910,[318  98  64  79 588],577,5,3628,3.982436882546652,40.0,0.0
911,0,911,[318  98  64  79 588],18,5,3633,3.9835526315789473,40.0,0.0
912,0,912,[181 423  71 127 174],796,5,3638,3.9846659364731654,0.0,20.0
913,0,913,[245 111  25 191 185],450,4,3642,3.984682713347921,0.0,0.0
914,0,914,[423 197 125 357 258],450,5,3647,3.985792349726776,0.0,0.0
915,0,915,[318  98  64  79 588],716,5,3652,3.986899563318777,40.0,0.0
916,0,916,[318  98  64  79 588],796,5,3657,3.9880043620501637,40.0,0.0
917,0,917,[318  98  64  79 588],457,5,3662,3.9891067538126364,40.0,0.0
918,0,918,[318  98  64  79 588],796,5,3667,3.990206746463547,40.0,0.0
919,0,919,[ 50 496 288 655 179],450,4,3671,3.990217391304348,20.0,20.0
920,0,920,[318  98  64  79 588],577,5,3676,3.991313789359392,40.0,0.0
921,0,921,[328 475 215 143  98],655,2,3678,3.9891540130151846,0.0,0.0
922,0,922,[318  98  64  79 588],450,5,3683,3.990249187432286,40.0,0.0
923,0,923,[234 197 153 210  70],280,2,3685,3.988095238095238,0.0,0.0
924,0,924,[ 79  69  71 151 181],450,4,3689,3.9881081081081082,0.0,0.0
925,0,925,[318  98  64  79 588],450,5,3694,3.9892008639308854,40.0,0.0
926,0,926,[318  98  64  79 588],18,5,3699,3.9902912621359223,40.0,0.0
927,0,927,[318  98  64  79 588],796,5,3704,3.9913793103448274,40.0,0.0
928,0,928,[245 222 132  56 286],450,4,3708,3.991388589881593,0.0,20.0
929,0,929,[318  98  64  79 588],577,5,3713,3.99247311827957,40.0,0.0
930,0,930,[238 187 144 269 268],655,1,3714,3.9892588614393127,0.0,0.0
931,0,931,[475 300 135 237 176],655,1,3715,3.986051502145923,0.0,0.0
932,0,932,[588 313 748 271   8],796,5,3720,3.987138263665595,0.0,0.0
933,0,933,[423 222 143   9  28],457,5,3725,3.9882226980728053,0.0,0.0
934,0,934,[185 234 286  22  12],18,3,3728,3.9871657754010696,0.0,20.0
935,0,935,[318  98  64  79 588],796,5,3733,3.9882478632478633,40.0,0.0
936,0,936,[423  95  97  69 168],716,5,3738,3.9893276414087513,0.0,0.0
937,0,937,[100 127  28 234 196],457,5,3743,3.990405117270789,0.0,40.0
938,0,938,[318  98  64  79 588],457,5,3748,3.9914802981895634,40.0,0.0
939,0,939,[742 588 132 176  12],796,4,3752,3.991489361702128,0.0,0.0
940,0,940,[318  98  64  79 588],796,5,3757,3.9925611052072263,40.0,0.0
941,0,941,[357 196  71 302 328],401,3,3760,3.991507430997877,0.0,0.0
942,0,942,[318  98  64  79 588],716,5,3765,3.992576882290562,40.0,0.0
943,0,943,[318  98  64  79 588],577,5,3770,3.9936440677966103,40.0,0.0
944,0,944,[282 483   7 194 204],535,4,3774,3.9936507936507937,0.0,0.0
945,0,945,[301 216 186 215 258],796,3,3777,3.992600422832981,0.0,0.0
946,0,946,[318  98  64  79 588],18,5,3782,3.9936642027455123,40.0,0.0
947,0,947,[318  98  64  79 588],796,5,3787,3.9947257383966246,40.0,0.0
948,0,948,[210 100 238 427   7],450,4,3791,3.994731296101159,20.0,20.0
949,0,949,[318  98  64  79 588],796,5,3796,3.9957894736842103,40.0,0.0
950,0,950,[318  98  64  79 588],450,5,3801,3.996845425867508,40.0,0.0
951,0,951,[ 25 258 211  70 427],450,4,3805,3.9968487394957983,20.0,0.0
952,0,952,[118 100 603 228 588],450,4,3809,3.9968520461699897,20.0,20.0
953,0,953,[318  98  64  79 588],450,5,3814,3.9979035639413,40.0,0.0
954,0,954,[168 196  28 143 204],389,3,3817,3.9968586387434555,0.0,0.0
955,0,955,[318  98  64  79 588],796,5,3822,3.997907949790795,40.0,0.0
956,0,956,[318  98  64  79 588],457,5,3827,3.998955067920585,40.0,0.0
957,0,957,[318  98  64  79 588],457,5,3832,4.0,40.0,0.0
958,0,958,[300  28 318   4 200],151,4,3836,4.0,20.0,0.0
959,0,959,[435   9 403 655 276],269,3,3839,3.9989583333333334,0.0,0.0
960,0,960,[318  98  64  79 588],18,5,3844,4.0,40.0,0.0
961,0,961,[318  98  64  79 588],457,5,3849,4.001039501039501,40.0,0.0
962,0,962,[318  98  64  79 588],18,5,3854,4.0020768431983385,40.0,0.0
963,0,963,[ 69 282 238 405  15],457,5,3859,4.003112033195021,0.0,0.0
964,0,964,[496 275  98 328 186],450,4,3863,4.003108808290156,20.0,20.0
965,0,965,[ 28  88 121  95  98],716,5,3868,4.004140786749482,0.0,0.0
966,0,966,[318  98  64  79 588],577,5,3873,4.005170630816959,40.0,0.0
967,0,967,[121 100 125 546 196],504,5,3878,4.006198347107438,0.0,20.0
968,0,968,[  1 153 202 234 237],18,2,3880,4.004127966976264,0.0,0.0
969,0,969,[318  98  64  79 588],457,5,3885,4.005154639175258,40.0,0.0
970,0,970,[318  98  64  79 588],457,5,3890,4.006179196704428,40.0,0.0
971,0,971,[180 483  88 323 215],796,3,3893,4.005144032921811,0.0,0.0
972,0,972,[ 56 180 183 237 125],796,4,3897,4.00513874614594,0.0,0.0
973,0,973,[196 181  98 405  96],457,5,3902,4.006160164271047,0.0,0.0
974,0,974,[385 357 100 257 151],23,2,3904,4.004102564102564,0.0,20.0
975,0,975,[318  98  64  79 588],450,5,3909,4.005122950819672,40.0,0.0
976,0,976,[161 125 234 144  50],280,1,3910,4.0020470829068575,0.0,20.0
977,0,977,[211 135 216 174  79],18,4,3914,4.002044989775051,0.0,0.0
978,0,978,[245 435  89   9 173],756,1,3915,3.998978549540347,0.0,0.0
979,0,979,[318  98  64  79 588],577,5,3920,4.0,40.0,0.0
980,0,980,[318  98  64  79 588],457,5,3925,4.001019367991845,40.0,0.0
981,0,981,[204 313 117 176 405],577,4,3929,4.0010183299389,0.0,0.0
982,0,982,[ 15  82 294 210  28],577,3,3932,4.0,0.0,0.0
983,0,983,[ 64   1 496 172 194],18,3,3935,3.9989837398373984,40.0,0.0
984,0,984,[508 238  56  28 175],11,3,3938,3.997969543147208,0.0,0.0
985,0,985,[318  98  64  79 588],450,5,3943,3.9989858012170387,40.0,0.0
986,0,986,[403 385  70 174 100],655,0,3943,3.994934143870314,0.0,20.0
987,0,987,[318  98  64  79 588],457,5,3948,3.9959514170040484,40.0,0.0
988,0,988,[235 173 100 238   7],457,4,3952,3.995955510616785,0.0,20.0
989,0,989,[318  98  64  79 588],796,5,3957,3.996969696969697,40.0,0.0
990,0,990,[111 237 427 294 194],65,5,3962,3.997981836528759,20.0,0.0
991,0,991,[318  98  64  79 588],796,5,3967,3.998991935483871,40.0,0.0
992,0,992,[237  12 197  79  22],655,1,3968,3.995971802618328,0.0,0.0
993,0,993,[318  98  64  79 588],450,5,3973,3.9969818913480886,40.0,0.0
994,0,994,[318  98  64  79 588],457,5,3978,3.9979899497487437,40.0,0.0
995,0,995,[318  98  64  79 588],457,5,3983,3.998995983935743,40.0,0.0
996,0,996,[318  98  64  79 588],716,5,3988,4.0,40.0,0.0
997,0,997,[318  50  82 135 655],885,2,3990,3.997995991983968,20.0,20.0
998,0,998,[318  98  64  79 588],716,5,3995,3.998998998998999,40.0,0.0
999,0,999,[423  95 176 174 385],786,5,4000,4.0,0.0,0.0
1000,0,1000,[318  98  64  79 588],716,5,4005,4.000999000999001,40.0,0.0
1001,0,1001,[318  98  64  79 588],450,5,4010,4.001996007984032,40.0,0.0
1002,0,1002,[318  98  64  79 588],716,5,4015,4.002991026919243,40.0,0.0
1003,0,1003,[318  98  64  79 588],577,5,4020,4.00398406374502,40.0,0.0
1004,0,1004,[655 172 117  69 173],796,4,4024,4.0039800995024875,0.0,0.0
1005,0,1005,[216  97 183 176 127],796,4,4028,4.003976143141153,0.0,20.0
1006,0,1006,[180 172 181 196 144],716,3,4031,4.002979145978153,0.0,0.0
1007,0,1007,[318  98  64  79 588],457,5,4036,4.003968253968254,40.0,0.0
1008,0,1008,[318  98  64  79 588],577,5,4041,4.004955401387512,40.0,0.0
1009,0,1009,[318  98  64  79 588],450,5,4046,4.005940594059406,40.0,0.0
1010,0,1010,[318  98  64  79 588],577,5,4051,4.006923837784372,40.0,0.0
1011,0,1011,[294 204 211  12 191],450,5,4056,4.007905138339921,0.0,0.0
1012,0,1012,[ 71 210  89 275 423],786,5,4061,4.00888450148075,0.0,20.0
1013,0,1013,[318  98  64  79 588],577,5,4066,4.009861932938856,40.0,0.0
1014,0,1014,[234 318  79  56   4],593,4,4070,4.009852216748769,20.0,0.0
1015,0,1015,[318  98  64  79 588],577,5,4075,4.0108267716535435,40.0,0.0
1016,0,1016,[603 118 125 215 176],796,5,4080,4.011799410029498,20.0,0.0
1017,0,1017,[318 202 269 191 403],796,4,4084,4.011787819253438,20.0,0.0
1018,0,1018,[318  98  64  79 588],18,5,4089,4.012757605495584,40.0,0.0
1019,0,1019,[ 88 423 216   7 100],450,5,4094,4.013725490196078,0.0,20.0
1020,0,1020,[132 222  12 475 202],655,0,4094,4.009794319294809,0.0,0.0
1021,0,1021,[300 127 258  69 183],655,2,4096,4.007827788649706,0.0,20.0
1022,0,1022,[318  98  64  79 588],450,5,4101,4.008797653958944,40.0,0.0
1023,0,1023,[210  70  64 603  12],655,2,4103,4.0068359375,40.0,0.0
1024,0,1024,[168 215  88 121  79],716,5,4108,4.0078048780487805,0.0,0.0
1025,0,1025,[318  98  64  79 588],18,5,4113,4.008771929824562,40.0,0.0
1026,0,1026,[318  98  64  79 588],716,5,4118,4.009737098344694,40.0,0.0
1027,0,1027,[318  98  64  79 588],577,5,4123,4.010700389105058,40.0,0.0
1028,0,1028,[318  98  64  79 588],457,5,4128,4.011661807580175,40.0,0.0
1029,0,1029,[318  98  64  79 588],716,5,4133,4.012621359223301,40.0,0.0
1030,0,1030,[174  15  97 294 186],450,3,4136,4.011639185257032,0.0,0.0
1031,0,1031,[ 11 282 508 173 196],401,1,4137,4.008720930232558,0.0,0.0
1032,0,1032,[318  98  64  79 588],450,5,4142,4.009680542110358,40.0,0.0
1033,0,1033,[ 96 161 475 144   8],655,0,4142,4.005802707930368,0.0,0.0
1034,0,1034,[153  28 238 111 194],18,2,4144,4.003864734299517,0.0,0.0
1035,0,1035,[318  98  64  79 588],450,5,4149,4.004826254826255,40.0,0.0
1036,0,1036,[318  98  64  79 588],18,5,4154,4.005785920925748,40.0,0.0
1037,0,1037,[588  22 210  79  56],457,5,4159,4.006743737957611,0.0,0.0
1038,0,1038,[245 195 215 135 235],280,2,4161,4.004812319538018,0.0,0.0
1039,0,1039,[235 302 175 678  25],344,3,4164,4.003846153846154,0.0,0.0
1040,0,1040,[318  98  64  79 588],450,5,4169,4.004803073967339,40.0,0.0
1041,0,1041,[318 182   8  69 435],269,2,4171,4.002879078694818,20.0,0.0
1042,0,1042,[183 197 194 135  97],835,5,4176,4.003835091083413,0.0,0.0
1043,0,1043,[318  98  64  79 588],18,5,4181,4.004789272030651,40.0,0.0
1044,0,1044,[318  98  64  79 588],577,5,4186,4.005741626794259,40.0,0.0
1045,0,1045,[318  98  64  79 588],577,5,4191,4.006692160611855,40.0,0.0
1046,0,1046,[318  98  64  79 588],796,5,4196,4.007640878701051,40.0,0.0
1047,0,1047,[195 202 403 322 282],280,1,4197,4.004770992366412,0.0,0.0
1048,0,1048,[318  98  64  79 588],18,5,4202,4.005719733079123,40.0,0.0
1049,0,1049,[318  98  64  79 588],450,5,4207,4.006666666666667,40.0,0.0
1050,0,1050,[318  98  64  79 588],450,5,4212,4.007611798287345,40.0,0.0
1051,0,1051,[187 153 300  95 216],450,4,4216,4.007604562737643,0.0,0.0
1052,0,1052,[235 258 597 546  64],457,2,4218,4.005698005698005,20.0,0.0
1053,0,1053,[132 405  56  96 603],796,5,4223,4.006641366223909,20.0,0.0
1054,0,1054,[210 216  56 427   9],236,4,4227,4.006635071090048,20.0,0.0
1055,0,1055,[318  98  64  79 588],577,5,4232,4.007575757575758,40.0,0.0
1056,0,1056,[318  98  64  79 588],450,5,4237,4.008514664143803,40.0,0.0
1057,0,1057,[318  98  64  79 588],450,5,4242,4.00945179584121,40.0,0.0
1058,0,1058,[127 357  97 176 289],786,5,4247,4.01038715769594,0.0,20.0
1059,0,1059,[ 71 216 127 302 196],344,4,4251,4.010377358490566,0.0,20.0
1060,0,1060,[318  98  64  79 588],796,5,4256,4.011310084825636,40.0,0.0
1061,0,1061,[318  98  64  79 588],18,5,4261,4.012241054613936,40.0,0.0
1062,0,1062,[597  98  15  97 202],256,4,4265,4.012229539040452,0.0,0.0
1063,0,1063,[423 228  25 405  50],577,3,4268,4.011278195488722,0.0,20.0
1064,0,1064,[318  98  64  79 588],450,5,4273,4.012206572769953,40.0,0.0
1065,0,1065,[318  98  64  79 588],450,5,4278,4.01313320825516,40.0,0.0
1066,0,1066,[318  98  64  79 588],450,5,4283,4.014058106841612,40.0,0.0
1067,0,1067,[235  50 135 194  11],457,4,4287,4.014044943820225,0.0,20.0
1068,0,1068,[318  98  64  79 588],577,5,4292,4.014967259120674,40.0,0.0
1069,0,1069,[318  98  64  79 588],18,5,4297,4.01588785046729,40.0,0.0
1070,0,1070,[ 79 176  64 678 215],344,3,4300,4.014939309056956,20.0,0.0
1071,0,1071,[183 237 195  97 186],655,1,4301,4.012126865671642,0.0,0.0
1072,0,1072,[318  98  64  79 588],716,5,4306,4.01304753028891,40.0,0.0
1073,0,1073,[318  98  64  79 588],18,5,4311,4.0139664804469275,40.0,0.0
1074,0,1074,[318  98  64  79 588],450,5,4316,4.014883720930232,40.0,0.0
1075,0,1075,[204 174 211  89  70],269,1,4317,4.012081784386617,0.0,0.0
1076,0,1076,[318  98  64  79 588],18,5,4322,4.012999071494893,40.0,0.0
1077,0,1077,[318  98  64  79 588],716,5,4327,4.013914656771799,40.0,0.0
1078,0,1078,[318  98  64  79 588],457,5,4332,4.014828544949027,40.0,0.0
1079,0,1079,[318  98  64  79 588],18,5,4337,4.015740740740741,40.0,0.0
1080,0,1080,[318  98  64  79 588],796,5,4342,4.016651248843663,40.0,0.0
1081,0,1081,[318  98  64  79 588],577,5,4347,4.017560073937154,40.0,0.0
1082,0,1082,[318  98  64  79 588],716,5,4352,4.018467220683287,40.0,0.0
1083,0,1083,[  9  88 603 215 435],655,1,4353,4.015682656826568,20.0,0.0
1084,0,1084,[318  98  64  79 588],457,5,4358,4.016589861751152,40.0,0.0
1085,0,1085,[318  98  64  79 588],457,5,4363,4.017495395948434,40.0,0.0
1086,0,1086,[222 204 471 186  71],786,5,4368,4.018399264029439,0.0,0.0
1087,0,1087,[118 427 191  98  22],796,5,4373,4.0193014705882355,20.0,0.0
1088,0,1088,[318  98  64  79 588],457,5,4378,4.02020202020202,40.0,0.0
1089,0,1089,[318  98  64  79 588],457,5,4383,4.021100917431193,40.0,0.0
1090,0,1090,[318  98  64  79 588],457,5,4388,4.021998166819432,40.0,0.0
1091,0,1091,[ 12 265 294 117 135],655,1,4389,4.019230769230769,0.0,0.0
1092,0,1092,[318  98  64  79 588],577,5,4394,4.020128087831656,40.0,0.0
1093,0,1093,[318  98  64  79 588],18,5,4399,4.021023765996343,40.0,0.0
1094,0,1094,[318  98  64  79 588],716,5,4404,4.021917808219178,40.0,0.0
1095,0,1095,[ 82 269  12 475 179],655,1,4405,4.019160583941606,0.0,0.0
1096,0,1096,[318  98  64  79 588],577,5,4410,4.020054694621695,40.0,0.0
1097,0,1097,[257 195 238 118 125],457,4,4414,4.020036429872495,0.0,0.0
1098,0,1098,[ 64 180 204 405 111],450,5,4419,4.020928116469518,20.0,0.0
1099,0,1099,[318  98  64  79 588],577,5,4424,4.0218181818181815,40.0,0.0
1100,0,1100,[135 185 269  25 168],450,3,4427,4.020890099909174,0.0,0.0
1101,0,1101,[318  98  64  79 588],796,5,4432,4.021778584392014,40.0,0.0
1102,0,1102,[318  98  64  79 588],577,5,4437,4.0226654578422485,40.0,0.0
1103,0,1103,[ 50   4  82 121 265],786,4,4441,4.0226449275362315,0.0,20.0
1104,0,1104,[127 210  95 742  12],796,3,4444,4.021719457013575,0.0,20.0
1105,0,1105,[258  96 222 318 313],796,5,4449,4.022603978300181,20.0,0.0
1106,0,1106,[322 144 496 173 195],450,5,4454,4.023486901535682,20.0,0.0
1107,0,1107,[216 294  97 172  56],236,3,4457,4.022563176895307,0.0,0.0
1108,0,1108,[318 483  98  22 403],280,4,4461,4.022542831379622,20.0,0.0
1109,0,1109,[191 195   7 423 655],693,2,4463,4.02072072072072,0.0,0.0
1110,0,1110,[318  98  64  79 588],457,5,4468,4.0216021602160215,40.0,0.0
1111,0,1111,[318  98  64  79 588],457,5,4473,4.02248201438849,40.0,0.0
1112,0,1112,[318  98  64  79 588],716,5,4478,4.023360287511231,40.0,0.0
1113,0,1113,[318  98  64  79 588],18,5,4483,4.024236983842011,40.0,0.0
1114,0,1114,[318  98  64  79 588],450,5,4488,4.025112107623318,40.0,0.0
1115,0,1115,[318  98  64  79 588],577,5,4493,4.025985663082437,40.0,0.0
1116,0,1116,[173 435 100  69 234],316,1,4494,4.023276633840645,0.0,20.0
1117,0,1117,[318  98  64  79 588],18,5,4499,4.024150268336315,40.0,0.0
1118,0,1118,[328 289 435 603 143],655,2,4501,4.022341376228776,20.0,0.0
1119,0,1119,[318  98  64  79 588],577,5,4506,4.023214285714285,40.0,0.0
1120,0,1120,[153 135 181 471   4],450,3,4509,4.022301516503123,0.0,0.0
1121,0,1121,[318  98  64  79 588],18,5,4514,4.023172905525847,40.0,0.0
1122,0,1122,[496 318 182 121 202],450,4,4518,4.023152270703473,40.0,0.0
1123,0,1123,[318  98  64  79 588],457,5,4523,4.024021352313167,40.0,0.0
1124,0,1124,[210 153   1 100 294],280,2,4525,4.022222222222222,0.0,20.0
1125,0,1125,[318  98  64  79 588],716,5,4530,4.023090586145648,40.0,0.0
1126,0,1126,[179 216  97 118 100],457,5,4535,4.023957409050577,0.0,20.0
1127,0,1127,[318  98  64  79 588],716,5,4540,4.024822695035461,40.0,0.0
1128,0,1128,[ 25 172 238   9 568],593,3,4543,4.023914968999114,0.0,0.0
1129,0,1129,[318  98  64  79 588],796,5,4548,4.024778761061947,40.0,0.0
1130,0,1130,[318  98  64  79 588],18,5,4553,4.0256410256410255,40.0,0.0
1131,0,1131,[318  98  64  79 588],577,5,4558,4.0265017667844525,40.0,0.0
1132,0,1132,[318  98  64  79 588],450,5,4563,4.027360988526037,40.0,0.0
1133,0,1133,[238 202 176  15 211],269,2,4565,4.025573192239859,0.0,0.0
1134,0,1134,[318  98  64  79 588],457,5,4570,4.026431718061674,40.0,0.0
1135,0,1135,[318  98  64  79 588],457,5,4575,4.027288732394366,40.0,0.0
1136,0,1136,[318  98  64  79 588],18,5,4580,4.028144239226034,40.0,0.0
1137,0,1137,[118 143 195 215 132],151,2,4582,4.026362038664323,0.0,0.0
1138,0,1138,[ 64 508 300 268 186],655,1,4583,4.023705004389815,20.0,0.0
1139,0,1139,[318  98  64  79 588],457,5,4588,4.024561403508772,40.0,0.0
1140,0,1140,[742  88 228 234  28],577,2,4590,4.022787028921998,0.0,0.0
1141,0,1141,[111  56 568 200 202],655,1,4591,4.020140105078809,0.0,0.0
1142,0,1142,[143 174 427 135 181],151,5,4596,4.020997375328084,20.0,0.0
1143,0,1143,[174 275 568 496 172],450,5,4601,4.021853146853147,20.0,20.0
1144,0,1144,[318  98  64  79 588],450,5,4606,4.022707423580786,40.0,0.0
1145,0,1145,[ 89 187 143  82 216],450,4,4610,4.022687609075043,0.0,0.0
1146,0,1146,[318  98  64  79 588],716,5,4615,4.023539668700959,40.0,0.0
1147,0,1147,[318  98  64  79 588],577,5,4620,4.024390243902439,40.0,0.0
1148,0,1148,[403   8 483 742   9],655,1,4621,4.021758050478677,0.0,0.0
1149,0,1149,[318  98  64  79 588],457,5,4626,4.022608695652174,40.0,0.0
1150,0,1150,[318  98  64  79 588],796,5,4631,4.023457862728063,40.0,0.0
1151,0,1151,[318  98  64  79 588],716,5,4636,4.024305555555555,40.0,0.0
1152,0,1152,[210 132 322 100 173],344,4,4640,4.024284475281873,0.0,20.0
1153,0,1153,[318  98  64  79 588],450,5,4645,4.025129982668977,40.0,0.0
1154,0,1154,[318  98  64  79 588],796,5,4650,4.025974025974026,40.0,0.0
1155,0,1155,[179 204  69 655  50],885,2,4652,4.024221453287197,0.0,20.0
1156,0,1156,[ 28 294 215 435 194],716,5,4657,4.025064822817632,0.0,0.0
1157,0,1157,[ 28 182 132 183  50],796,4,4661,4.025043177892919,0.0,20.0
1158,0,1158,[318  98  64  79 588],18,5,4666,4.0258843830888695,40.0,0.0
1159,0,1159,[265 245 568 174 196],796,4,4670,4.025862068965517,0.0,0.0
1160,0,1160,[318  98  64  79 588],18,5,4675,4.026701119724375,40.0,0.0
1161,0,1161,[318  98  64  79 588],796,5,4680,4.027538726333907,40.0,0.0
1162,0,1162,[318  98  64  79 588],18,5,4685,4.028374892519347,40.0,0.0
1163,0,1163,[173 328 508 515 471],401,3,4688,4.027491408934708,0.0,0.0
1164,0,1164,[483 185  97  12 111],450,4,4692,4.0274678111587985,0.0,0.0
1165,0,1165,[385 322 265 234 173],450,4,4696,4.027444253859348,0.0,0.0
1166,0,1166,[245  50 357 194 132],504,3,4699,4.02656383890317,0.0,20.0
1167,0,1167,[202 194  28 168  69],716,5,4704,4.027397260273973,0.0,0.0
1168,0,1168,[318  98  64  79 588],716,5,4709,4.028229255774166,40.0,0.0
1169,0,1169,[318  98  64  79 588],716,5,4714,4.029059829059829,40.0,0.0
1170,0,1170,[318  98  64  79 588],18,5,4719,4.029888983774551,40.0,0.0
1171,0,1171,[191 117 435 405 181],450,5,4724,4.030716723549488,0.0,0.0
1172,0,1172,[318  98  64  79 588],796,5,4729,4.03154305200341,40.0,0.0
1173,0,1173,[318  98  64  79 588],796,5,4734,4.03236797274276,40.0,0.0
1174,0,1174,[748 174  97  71  15],796,4,4738,4.032340425531915,0.0,0.0
1175,0,1175,[318  98  64  79 588],577,5,4743,4.033163265306122,40.0,0.0
1176,0,1176,[318  98  64  79 588],450,5,4748,4.0339847068819035,40.0,0.0
1177,0,1177,[568   8 210 174 111],280,2,4750,4.032258064516129,0.0,0.0
1178,0,1178,[318  98  64  79 588],450,5,4755,4.033078880407125,40.0,0.0
1179,0,1179,[301 176 168 237 655],450,5,4760,4.033898305084746,0.0,0.0
1180,0,1180,[181 117 275   9 222],655,1,4761,4.031329381879763,0.0,20.0
1181,0,1181,[318  98  64  79 588],796,5,4766,4.032148900169204,40.0,0.0
1182,0,1182,[318  98  64  79 588],577,5,4771,4.032967032967033,40.0,0.0
1183,0,1183,[202  64 180 195 111],457,4,4775,4.0329391891891895,20.0,0.0
1184,0,1184,[318  98  64  79 588],577,5,4780,4.033755274261603,40.0,0.0
1185,0,1185,[318  98  64  79 588],577,5,4785,4.034569983136594,40.0,0.0
1186,0,1186,[185 546 742 405 483],450,4,4789,4.034540859309183,0.0,0.0
1187,0,1187,[ 96 111  88 153 313],655,1,4790,4.031986531986532,0.0,0.0
1188,0,1188,[318  98  64  79 588],716,5,4795,4.032800672834314,40.0,0.0
1189,0,1189,[318 234 546 127 275],716,4,4799,4.032773109243697,20.0,40.0
1190,0,1190,[483 202 655  96 185],796,4,4803,4.0327455919395465,0.0,0.0
1191,0,1191,[405   4 238 210 546],716,3,4806,4.031879194630872,0.0,0.0
1192,0,1192,[318  98  64  79 588],18,5,4811,4.032690695725063,40.0,0.0
1193,0,1193,[ 71 222  96 216 286],280,4,4815,4.032663316582915,0.0,20.0
1194,0,1194,[318  98  64  79 588],716,5,4820,4.03347280334728,40.0,0.0
1195,0,1195,[215 508 175  12  69],11,1,4821,4.030936454849498,0.0,0.0
1196,0,1196,[318  98  64  79 588],577,5,4826,4.031746031746032,40.0,0.0
1197,0,1197,[333 121   7 276 515],655,2,4828,4.030050083472454,0.0,0.0
1198,0,1198,[385 289 211 603 117],655,1,4829,4.027522935779817,20.0,0.0
1199,0,1199,[318  98  64  79 588],716,5,4834,4.028333333333333,40.0,0.0
1200,0,1200,[132  15  69  88 234],577,2,4836,4.0266444629475435,0.0,0.0
1201,0,1201,[187 748 742  50 237],796,4,4840,4.026622296173045,0.0,20.0
1202,0,1202,[183 180 222  71 100],450,3,4843,4.025768911055694,0.0,20.0
1203,0,1203,[245 265 483  11  96],280,4,4847,4.025747508305648,0.0,0.0
1204,0,1204,[168 194 313 222 235],807,4,4851,4.025726141078838,0.0,0.0
1205,0,1205,[423 235 186  95  70],716,3,4854,4.024875621890548,0.0,0.0
1206,0,1206,[318  98  64  79 588],796,5,4859,4.0256835128417565,40.0,0.0
1207,0,1207,[183 568  64 423   8],655,2,4861,4.0240066225165565,20.0,0.0
1208,0,1208,[143  12  97 181 655],457,5,4866,4.024813895781637,0.0,0.0
1209,0,1209,[318  98  64  79 588],716,5,4871,4.025619834710744,40.0,0.0
1210,0,1210,[117 403 100 151  56],457,5,4876,4.026424442609414,0.0,20.0
1211,0,1211,[ 96 568 483 183 143],457,5,4881,4.0272277227722775,0.0,0.0
1212,0,1212,[318  98  64  79 588],577,5,4886,4.0280296784831,40.0,0.0
1213,0,1213,[423 153 238 271 183],655,1,4887,4.025535420098847,0.0,0.0
1214,0,1214,[176 173  97 222  56],151,4,4891,4.025514403292181,0.0,0.0
1215,0,1215,[318  98  64  79 588],457,5,4896,4.026315789473684,40.0,0.0
1216,0,1216,[318  98  64  79 588],716,5,4901,4.027115858668858,40.0,0.0
1217,0,1217,[318  98  64  79 588],577,5,4906,4.027914614121511,40.0,0.0
1218,0,1218,[211 100 234 118 111],450,3,4909,4.027071369975389,0.0,20.0
1219,0,1219,[172 196  56 210 276],457,5,4914,4.027868852459016,0.0,0.0
1220,0,1220,[318  98  64  79 588],450,5,4919,4.028665028665029,40.0,0.0
1221,0,1221,[237   9 423  28  96],796,3,4922,4.027823240589198,0.0,0.0
1222,0,1222,[100  56 200 265 175],151,3,4925,4.026982829108749,0.0,20.0
1223,0,1223,[318  98  64  79 588],450,5,4930,4.027777777777778,40.0,0.0
1224,0,1224,[318  98  64  79 588],716,5,4935,4.0285714285714285,40.0,0.0
1225,0,1225,[318  98  64  79 588],457,5,4940,4.029363784665579,40.0,0.0
1226,0,1226,[318  98  64  79 588],716,5,4945,4.030154849225754,40.0,0.0
1227,0,1227,[318  98  64  79 588],716,5,4950,4.030944625407166,40.0,0.0
1228,0,1228,[318  98  64  79 588],457,5,4955,4.03173311635476,40.0,0.0
1229,0,1229,[ 71 204  11  70 302],450,4,4959,4.03170731707317,0.0,0.0
1230,0,1230,[318  98  64  79 588],796,5,4964,4.032493907392364,40.0,0.0
1231,0,1231,[216 174 200   1 318],655,3,4967,4.0316558441558445,20.0,0.0
1232,0,1232,[187 222 294 100 151],236,1,4968,4.029197080291971,0.0,20.0
1233,0,1233,[318  98  64  79 588],457,5,4973,4.02998379254457,40.0,0.0
1234,0,1234,[318  98  64  79 588],577,5,4978,4.030769230769231,40.0,0.0
1235,0,1235,[318  98  64  79 588],796,5,4983,4.031553398058253,40.0,0.0
1236,0,1236,[655  56 174 144 282],655,0,4983,4.028294260307195,0.0,0.0
1237,0,1237,[318  98  64  79 588],796,5,4988,4.02907915993538,40.0,0.0
1238,0,1238,[195 187  79 318 427],693,4,4992,4.0290556900726395,40.0,0.0
1239,0,1239,[546 237  79  71  69],450,4,4996,4.029032258064516,0.0,0.0
1240,0,1240,[ 50 125 597 288 269],344,3,4999,4.028203062046736,0.0,20.0
1241,0,1241,[294 238 161 144 471],450,5,5004,4.028985507246377,0.0,0.0
1242,0,1242,[200 268   9  89 483],269,4,5008,4.028962188254224,0.0,0.0
1243,0,1243,[228 204  50 546 176],151,3,5011,4.028135048231511,0.0,20.0
1244,0,1244,[318  98  64  79 588],796,5,5016,4.028915662650602,40.0,0.0
1245,0,1245,[258  64  89  28 333],796,4,5020,4.028892455858748,20.0,0.0
1246,0,1246,[186 197 210 125 222],450,2,5022,4.027265437048918,0.0,0.0
1247,0,1247,[318  98  64  79 588],18,5,5027,4.028044871794871,40.0,0.0
1248,0,1248,[318  98  64  79 588],457,5,5032,4.028823058446758,40.0,0.0
1249,0,1249,[ 70  79  82 245   4],450,3,5035,4.028,0.0,0.0
1250,0,1250,[318  98  64  79 588],450,5,5040,4.028776978417266,40.0,0.0
1251,0,1251,[318  98  64  79 588],577,5,5045,4.029552715654952,40.0,0.0
1252,0,1252,[318  98  64  79 588],450,5,5050,4.030327214684757,40.0,0.0
1253,0,1253,[318  98  64  79 588],796,5,5055,4.0311004784688995,40.0,0.0
1254,0,1254,[318  98  64  79 588],577,5,5060,4.031872509960159,40.0,0.0
1255,0,1255,[ 79 117   9 222  69],280,4,5064,4.031847133757962,0.0,0.0
1256,0,1256,[318  98  64  79 588],796,5,5069,4.032617342879873,40.0,0.0
1257,0,1257,[235 176 300 117 111],716,3,5072,4.031796502384737,0.0,0.0
1258,0,1258,[ 71  82   7 174 288],280,3,5075,4.03097696584591,0.0,0.0
1259,0,1259,[318  98  64  79 588],796,5,5080,4.031746031746032,40.0,0.0
1260,0,1260,[ 15 318 483 423   4],796,5,5085,4.0325138778747025,20.0,0.0
1261,0,1261,[318  98  64  79 588],796,5,5090,4.033280507131537,40.0,0.0
1262,0,1262,[202  96 302 289  28],655,1,5091,4.0308788598574825,0.0,0.0
1263,0,1263,[ 50 423 275 181   1],716,5,5096,4.031645569620253,0.0,40.0
1264,0,1264,[318  98  64  79 588],18,5,5101,4.032411067193676,40.0,0.0
1265,0,1265,[318  98  64  79 588],457,5,5106,4.033175355450237,40.0,0.0
1266,0,1266,[318  98  64  79 588],577,5,5111,4.033938437253354,40.0,0.0
1267,0,1267,[318  98  64  79 588],796,5,5116,4.034700315457413,40.0,0.0
1268,0,1268,[275 151 210 179  50],457,5,5121,4.035460992907802,0.0,40.0
1269,0,1269,[  8 568 276 200 179],655,3,5124,4.034645669291338,0.0,0.0
1270,0,1270,[318  98  64  79 588],716,5,5129,4.035405192761605,40.0,0.0
1271,0,1271,[ 71 269 357 195  98],344,4,5133,4.035377358490566,0.0,0.0
1272,0,1272,[318  98  64  79 588],796,5,5138,4.036135113904163,40.0,0.0
1273,0,1273,[318  98  64  79 588],577,5,5143,4.036891679748822,40.0,0.0
1274,0,1274,[194 197  69 195 403],796,4,5147,4.036862745098039,0.0,0.0
1275,0,1275,[318  98  64  79 588],18,5,5152,4.037617554858934,40.0,0.0
1276,0,1276,[273 121 257  28  70],655,1,5153,4.035238841033673,0.0,0.0
1277,0,1277,[ 69 202 405 174 183],796,5,5158,4.035993740219093,0.0,0.0
1278,0,1278,[135 176 183 357 235],450,3,5161,4.035183737294761,0.0,0.0
1279,0,1279,[151 121 202  70 568],330,5,5166,4.0359375,0.0,0.0
1280,0,1280,[318  98  64  79 588],716,5,5171,4.036690085870414,40.0,0.0
1281,0,1281,[ 22  28 215 173  69],716,5,5176,4.0374414976599065,0.0,0.0
1282,0,1282,[132 100 179  22 234],18,4,5180,4.037412314886984,0.0,20.0
1283,0,1283,[132 289 183 258 176],655,1,5181,4.035046728971962,0.0,0.0
1284,0,1284,[117 748 258 597 423],807,4,5185,4.035019455252918,0.0,0.0
1285,0,1285,[191 603  98 210  56],716,5,5190,4.035769828926905,20.0,0.0
1286,0,1286,[ 28 238 357   9 234],18,3,5193,4.034965034965035,0.0,0.0
1287,0,1287,[318  98  64  79 588],577,5,5198,4.035714285714286,40.0,0.0
1288,0,1288,[195 121 268 179  89],655,2,5200,4.034134988363072,0.0,0.0
1289,0,1289,[275 197 187 100  64],629,5,5205,4.034883720930233,20.0,40.0
1290,0,1290,[318 153  11  71 471],450,4,5209,4.034856700232378,20.0,0.0
1291,0,1291,[318  98  64  79 588],18,5,5214,4.035603715170279,40.0,0.0
1292,0,1292,[318  98  64  79 588],796,5,5219,4.036349574632637,40.0,0.0
1293,0,1293,[215  97 597  70 191],344,1,5220,4.034003091190108,0.0,0.0
1294,0,1294,[318  98  64  79 588],457,5,5225,4.0347490347490345,40.0,0.0
1295,0,1295,[ 96 268 475  22 176],655,0,5225,4.031635802469136,0.0,0.0
1296,0,1296,[318  98  64  79 588],796,5,5230,4.032382420971473,40.0,0.0
1297,0,1297,[132 135   7  56 211],321,5,5235,4.033127889060093,0.0,0.0
1298,0,1298,[328   7 196  12 135],151,4,5239,4.033102386451116,0.0,0.0
1299,0,1299,[318  98  64  79 588],18,5,5244,4.033846153846154,40.0,0.0
1300,0,1300,[318  98  64  79 588],796,5,5249,4.034588777863182,40.0,0.0
1301,0,1301,[318  98  64  79 588],457,5,5254,4.035330261136712,40.0,0.0
1302,0,1302,[318  98  64  79 588],577,5,5259,4.03607060629317,40.0,0.0
1303,0,1303,[  1 333 265 144 200],655,1,5260,4.033742331288344,0.0,0.0
1304,0,1304,[318  98  64  79 588],18,5,5265,4.0344827586206895,40.0,0.0
1305,0,1305,[ 11  88 191 118 200],716,4,5269,4.034456355283308,0.0,0.0
1306,0,1306,[318  98  64  79 588],716,5,5274,4.035195103289977,40.0,0.0
1307,0,1307,[238  22 282 196 100],450,5,5279,4.0359327217125385,0.0,20.0
1308,0,1308,[318  98  64  79 588],457,5,5284,4.036669213139802,40.0,0.0
1309,0,1309,[318  98  64  79 588],796,5,5289,4.037404580152672,40.0,0.0
1310,0,1310,[ 97 215 222   8 405],655,0,5289,4.034324942791762,0.0,0.0
1311,0,1311,[234 197 132  56 111],629,5,5294,4.035060975609756,0.0,0.0
1312,0,1312,[318  98  64  79 588],457,5,5299,4.0357958872810356,40.0,0.0
1313,0,1313,[318  98  64  79 588],18,5,5304,4.036529680365297,40.0,0.0
1314,0,1314,[318  98  64  79 588],457,5,5309,4.037262357414448,40.0,0.0
1315,0,1315,[318  98  64  79 588],450,5,5314,4.037993920972644,40.0,0.0
1316,0,1316,[ 79 515   4 435 300],716,4,5318,4.037965072133637,0.0,0.0
1317,0,1317,[318  98  64  79 588],457,5,5323,4.038694992412746,40.0,0.0
1318,0,1318,[301  96 182 313 125],655,2,5325,4.037149355572403,0.0,0.0
1319,0,1319,[318  98  64  79 588],577,5,5330,4.037878787878788,40.0,0.0
1320,0,1320,[318  98  64  79 588],18,5,5335,4.038607115821348,40.0,0.0
1321,0,1321,[328 282   7  98 357],655,2,5337,4.037065052950076,0.0,0.0
1322,0,1322,[603  64 211 185 125],18,2,5339,4.035525321239607,40.0,0.0
1323,0,1323,[  8 194 179 265 210],535,4,5343,4.035498489425982,0.0,0.0
1324,0,1324,[318  98  64  79 588],450,5,5348,4.036226415094339,40.0,0.0
1325,0,1325,[ 64 237  71 179 357],450,4,5352,4.036199095022624,20.0,0.0
1326,0,1326,[318  98  64  79 588],457,5,5357,4.036925395629239,40.0,0.0
1327,0,1327,[318  98  64  79 588],716,5,5362,4.037650602409639,40.0,0.0
1328,0,1328,[318  98  64  79 588],18,5,5367,4.038374717832957,40.0,0.0
1329,0,1329,[187 435 222  28  97],72,4,5371,4.038345864661654,0.0,0.0
1330,0,1330,[423 322 742 235 182],280,4,5375,4.03831705484598,0.0,0.0
1331,0,1331,[318  98  64  79 588],457,5,5380,4.039039039039039,40.0,0.0
1332,0,1332,[318  98  64  79 588],450,5,5385,4.039759939984997,40.0,0.0
1333,0,1333,[318  98  64  79 588],796,5,5390,4.04047976011994,40.0,0.0
1334,0,1334,[427 185  25 186 194],503,5,5395,4.0411985018726595,20.0,0.0
1335,0,1335,[318  98  64  79 588],796,5,5400,4.041916167664671,40.0,0.0
1336,0,1336,[ 69 322 245 174 132],796,3,5403,4.0411368735976065,0.0,0.0
1337,0,1337,[176 135 318 302 286],450,4,5407,4.041106128550075,20.0,20.0
1338,0,1338,[318  98  64  79 588],450,5,5412,4.0418222554144885,40.0,0.0
1339,0,1339,[275 143  56 174  89],18,4,5416,4.04179104477612,0.0,20.0
1340,0,1340,[318  98  64  79 588],796,5,5421,4.042505592841163,40.0,0.0
1341,0,1341,[ 15 435 216 196 111],389,1,5422,4.040238450074516,0.0,0.0
1342,0,1342,[318  98  64  79 588],716,5,5427,4.0409530900967985,40.0,0.0
1343,0,1343,[222  69   8 235 174],457,4,5431,4.040922619047619,0.0,0.0
1344,0,1344,[318  98  64  79 588],577,5,5436,4.041635687732342,40.0,0.0
1345,0,1345,[318  98  64  79 588],716,5,5441,4.042347696879643,40.0,0.0
1346,0,1346,[318  98  64  79 588],796,5,5446,4.043058648849295,40.0,0.0
1347,0,1347,[258  50 144  82 238],457,5,5451,4.043768545994065,0.0,20.0
1348,0,1348,[153 288 161 211  15],450,3,5454,4.04299481097109,0.0,0.0
1349,0,1349,[318  98  64  79 588],796,5,5459,4.043703703703704,40.0,0.0
1350,0,1350,[515 187 258 405 483],655,3,5462,4.042931162102146,0.0,0.0
1351,0,1351,[318  98  64  79 588],716,5,5467,4.043639053254438,40.0,0.0
1352,0,1352,[318  98  64  79 588],796,5,5472,4.044345898004434,40.0,0.0
1353,0,1353,[318  98  64  79 588],457,5,5477,4.045051698670606,40.0,0.0
1354,0,1354,[318  98  64  79 588],716,5,5482,4.0457564575645755,40.0,0.0
1355,0,1355,[ 11 328 100 258 435],450,5,5487,4.04646017699115,0.0,20.0
1356,0,1356,[318  98  64  79 588],716,5,5492,4.047162859248342,40.0,0.0
1357,0,1357,[127  64 288 222 125],344,4,5496,4.047128129602356,20.0,20.0
1358,0,1358,[318  98  64  79 588],577,5,5501,4.047829286239883,40.0,0.0
1359,0,1359,[318  98  64  79 588],796,5,5506,4.048529411764706,40.0,0.0
1360,0,1360,[300 143 186 403 294],655,1,5507,4.046289493019838,0.0,0.0
1361,0,1361,[125 143 210 385 588],450,4,5511,4.046255506607929,0.0,0.0
1362,0,1362,[173  97  82 121 181],457,5,5516,4.046955245781365,0.0,0.0
1363,0,1363,[318  98  64  79 588],450,5,5521,4.047653958944282,40.0,0.0
1364,0,1364,[125 100 234 265 245],256,5,5526,4.048351648351648,0.0,20.0
1365,0,1365,[318  98  64  79 588],577,5,5531,4.04904831625183,40.0,0.0
1366,0,1366,[318  98  64  79 588],450,5,5536,4.049743964886613,40.0,0.0
1367,0,1367,[318  98  64  79 588],716,5,5541,4.050438596491228,40.0,0.0
1368,0,1368,[200 210  50  98 161],593,4,5545,4.050401753104456,0.0,20.0
1369,0,1369,[318  98  64  79 588],457,5,5550,4.0510948905109485,40.0,0.0
1370,0,1370,[258 496 385 742 357],450,5,5555,4.051787016776076,20.0,0.0
1371,0,1371,[318  98  64  79 588],18,5,5560,4.052478134110787,40.0,0.0
1372,0,1372,[300 275 180 204 216],716,4,5564,4.052439912600145,0.0,20.0
1373,0,1373,[ 82 161 496 423 288],450,3,5567,4.051673944687045,20.0,0.0
1374,0,1374,[318  98  64  79 588],18,5,5572,4.052363636363636,40.0,0.0
1375,0,1375,[  1 568 245 357 678],344,2,5574,4.050872093023256,0.0,0.0
1376,0,1376,[318  98  64  79 588],716,5,5579,4.051561365286855,40.0,0.0
1377,0,1377,[318  98  64  79 588],450,5,5584,4.052249637155297,40.0,0.0
1378,0,1378,[318  98  64  79 588],457,5,5589,4.052936910804931,40.0,0.0
1379,0,1379,[318  98  64  79 588],577,5,5594,4.053623188405797,40.0,0.0
1380,0,1380,[318  98  64  79 588],796,5,5599,4.054308472121651,40.0,0.0
1381,0,1381,[318  98  64  79 588],450,5,5604,4.054992764109985,40.0,0.0
1382,0,1382,[318  98  64  79 588],716,5,5609,4.055676066522054,40.0,0.0
1383,0,1383,[318  98  64  79 588],577,5,5614,4.05635838150289,40.0,0.0
1384,0,1384,[180  56   7 597  79],450,5,5619,4.057039711191336,0.0,0.0
1385,0,1385,[318  98  64  79 588],18,5,5624,4.057720057720058,40.0,0.0
1386,0,1386,[ 79  71 175 276 496],344,4,5628,4.057678442682048,20.0,0.0
1387,0,1387,[405 385 294  56 357],716,4,5632,4.057636887608069,0.0,0.0
1388,0,1388,[216 197 483 200 276],269,4,5636,4.0575953923686106,0.0,0.0
1389,0,1389,[117 174  12 427 175],655,1,5637,4.055395683453237,20.0,0.0
1390,0,1390,[ 70 237  88 322 597],344,0,5637,4.052480230050324,0.0,0.0
1391,0,1391,[197 191  69 471 216],65,4,5641,4.052442528735632,0.0,0.0
1392,0,1392,[318  98  64  79 588],796,5,5646,4.053122756640344,40.0,0.0
1393,0,1393,[318  98  64  79 588],450,5,5651,4.053802008608321,40.0,0.0
1394,0,1394,[300  69  97 597 118],796,4,5655,4.053763440860215,0.0,0.0
1395,0,1395,[471 183  22 215 269],344,2,5657,4.052292263610315,0.0,0.0
1396,0,1396,[318  69  96 143  22],796,5,5662,4.0529706513958486,20.0,0.0
1397,0,1397,[318  98  64  79 588],796,5,5667,4.053648068669528,40.0,0.0
1398,0,1398,[318  98  64  79 588],716,5,5672,4.054324517512509,40.0,0.0
1399,0,1399,[ 98 222 546  79 174],151,4,5676,4.054285714285714,0.0,0.0
1400,0,1400,[318  98  64  79 588],796,5,5681,4.05496074232691,40.0,0.0
1401,0,1401,[118 405 172  97  95],344,2,5683,4.053495007132668,0.0,0.0
1402,0,1402,[127 313  12 196 125],655,2,5685,4.052031361368496,0.0,20.0
1403,0,1403,[405   7 515 288 135],292,2,5687,4.050569800569801,0.0,0.0
1404,0,1404,[  8 183 153 161 655],23,2,5689,4.049110320284697,0.0,0.0
1405,0,1405,[127 238  88 196 276],18,3,5692,4.048364153627311,0.0,20.0
1406,0,1406,[318 215 245  82 151],450,4,5696,4.048329779673063,20.0,0.0
1407,0,1407,[318  98  64  79 588],450,5,5701,4.049005681818182,40.0,0.0
1408,0,1408,[318  98  64  79 588],716,5,5706,4.049680624556423,40.0,0.0
1409,0,1409,[  1 202  64 483 111],389,4,5710,4.049645390070922,20.0,0.0
1410,0,1410,[318  98  64  79 588],450,5,5715,4.050318922749823,40.0,0.0
1411,0,1411,[318  98  64  79 588],796,5,5720,4.050991501416431,40.0,0.0
1412,0,1412,[172 183 294 111 257],716,4,5724,4.050955414012739,0.0,0.0
1413,0,1413,[196 176 275 200  25],151,3,5727,4.0502121640735504,0.0,20.0
1414,0,1414,[318  98  64  79 588],457,5,5732,4.050883392226148,40.0,0.0
1415,0,1415,[318  98  64  79 588],18,5,5737,4.051553672316384,40.0,0.0
1416,0,1416,[322 195  22   9 588],344,3,5740,4.050811573747353,0.0,0.0
1417,0,1417,[127   9 427 182 216],796,4,5744,4.050775740479549,20.0,20.0
1418,0,1418,[318  98  64  79 588],716,5,5749,4.051444679351656,40.0,0.0
1419,0,1419,[318  98  64  79 588],796,5,5754,4.052112676056338,40.0,0.0
1420,0,1420,[ 64  98 153 222 216],796,5,5759,4.052779732582688,20.0,0.0
1421,0,1421,[496 313 238 318 222],796,4,5763,4.052742616033755,40.0,0.0
1422,0,1422,[318  98  64  79 588],716,5,5768,4.0534082923401265,40.0,0.0
1423,0,1423,[269 357  71  25 597],450,3,5771,4.052668539325842,0.0,0.0
1424,0,1424,[318  98  64  79 588],457,5,5776,4.053333333333334,40.0,0.0
1425,0,1425,[111 405 235 328   1],938,2,5778,4.051893408134642,0.0,0.0
1426,0,1426,[238 216 403 405 385],450,5,5783,4.052557813594954,0.0,0.0
1427,0,1427,[127 234 144 161  97],716,3,5786,4.051820728291316,0.0,20.0
1428,0,1428,[ 56 403   1 151  71],18,3,5789,4.051084674597621,0.0,0.0
1429,0,1429,[172  71 161 238 195],796,4,5793,4.051048951048951,0.0,0.0
1430,0,1430,[318  98  64  79 588],796,5,5798,4.051712089447938,40.0,0.0
1431,0,1431,[118 143  22 173  69],457,5,5803,4.052374301675978,0.0,0.0
1432,0,1432,[318  98  64  79 588],796,5,5808,4.0530355896720165,40.0,0.0
1433,0,1433,[318  98  64  79 588],457,5,5813,4.053695955369595,40.0,0.0
1434,0,1434,[318  98  64  79 588],577,5,5818,4.054355400696864,40.0,0.0
1435,0,1435,[318  98  64  79 588],716,5,5823,4.055013927576602,40.0,0.0
1436,0,1436,[318  98  64  79 588],716,5,5828,4.055671537926235,40.0,0.0
1437,0,1437,[ 88 121  69 423 173],11,2,5830,4.054242002781641,0.0,0.0
1438,0,1438,[318  98  64  79 588],796,5,5835,4.054899235580264,40.0,0.0
1439,0,1439,[269  25 237 483 215],450,3,5838,4.054166666666666,0.0,0.0
1440,0,1440,[318  98  64  79 588],577,5,5843,4.054823039555864,40.0,0.0
1441,0,1441,[215  25 118 328 603],151,2,5845,4.053398058252427,20.0,0.0
1442,0,1442,[318  98  64  79 588],796,5,5850,4.054054054054054,40.0,0.0
1443,0,1443,[318  98  64  79 588],716,5,5855,4.054709141274238,40.0,0.0
1444,0,1444,[318  98  64  79 588],18,5,5860,4.055363321799308,40.0,0.0
1445,0,1445,[318  98  64  79 588],450,5,5865,4.056016597510373,40.0,0.0
1446,0,1446,[ 88 742 258  70 216],344,1,5866,4.053904630269523,0.0,0.0
1447,0,1447,[288 125 161 135 318],457,5,5871,4.054558011049724,20.0,0.0
1448,0,1448,[655 161 168 276 202],504,3,5874,4.053830227743271,0.0,0.0
1449,0,1449,[301 328 173  79  97],796,3,5877,4.053103448275862,0.0,0.0
1450,0,1450,[318  98  64  79 588],450,5,5882,4.053756030323915,40.0,0.0
1451,0,1451,[655 216  96 127 313],280,3,5885,4.053030303030303,0.0,20.0
1452,0,1452,[318  98  64  79 588],716,5,5890,4.053682037164487,40.0,0.0
1453,0,1453,[275 385 257 168 210],330,4,5894,4.053645116918845,0.0,20.0
1454,0,1454,[318  98  64  79 588],577,5,5899,4.054295532646048,40.0,0.0
1455,0,1455,[ 96 195  69 294 118],457,4,5903,4.054258241758242,0.0,0.0
1456,0,1456,[427 210  95 515 204],18,4,5907,4.054221002059025,20.0,0.0
1457,0,1457,[318  98  64  79 588],450,5,5912,4.054869684499314,40.0,0.0
1458,0,1458,[318  98  64  79 588],577,5,5917,4.055517477724469,40.0,0.0
1459,0,1459,[357  70  15 318  98],72,5,5922,4.056164383561644,20.0,0.0
1460,0,1460,[181 357 196 423 172],796,5,5927,4.0568104038329915,0.0,0.0
1461,0,1461,[318  98  64  79 588],796,5,5932,4.057455540355678,40.0,0.0
1462,0,1462,[238 385 294 597 269],23,3,5935,4.056732740943267,0.0,0.0
1463,0,1463,[435  11 186 288  50],450,3,5938,4.056010928961749,0.0,20.0
1464,0,1464,[175 483 546 204 237],457,4,5942,4.055972696245734,0.0,0.0
1465,0,1465,[318  98  64  79 588],577,5,5947,4.0566166439290585,40.0,0.0
1466,0,1466,[318  98  64  79 588],796,5,5952,4.0572597137014315,40.0,0.0
1467,0,1467,[294  98 197 144  97],716,4,5956,4.0572207084468666,0.0,0.0
1468,0,1468,[ 70 200 117 211 655],655,1,5957,4.055139550714772,0.0,0.0
1469,0,1469,[318  98  64  79 588],796,5,5962,4.05578231292517,40.0,0.0
1470,0,1470,[ 70  88 200 144 318],655,2,5964,4.0543847722637665,20.0,0.0
1471,0,1471,[183 195 286 127  56],236,3,5967,4.053668478260869,0.0,40.0
1472,0,1472,[318 210 194  71 132],577,4,5971,4.053632043448744,20.0,0.0
1473,0,1473,[405 181 294 127 153],280,2,5973,4.052238805970149,0.0,20.0
1474,0,1474,[318  98  64  79 588],450,5,5978,4.052881355932203,40.0,0.0
1475,0,1475,[196 121 197 257  69],655,0,5978,4.0501355013550135,0.0,0.0
1476,0,1476,[318  98  64  79 588],577,5,5983,4.050778605280975,40.0,0.0
1477,0,1477,[186 175 496  25 282],716,2,5985,4.049391069012179,20.0,0.0
1478,0,1478,[143 294  56  98  64],236,4,5989,4.049357674104124,20.0,0.0
1479,0,1479,[ 97 301 204 153  11],655,0,5989,4.046621621621622,0.0,0.0
1480,0,1480,[318  98  64  79 588],577,5,5994,4.047265361242403,40.0,0.0
1481,0,1481,[318  98  64  79 588],457,5,5999,4.0479082321187585,40.0,0.0
1482,0,1482,[191  82 121 237 275],457,5,6004,4.048550236008092,0.0,20.0
1483,0,1483,[235 182  97 173 202],450,4,6008,4.048517520215634,0.0,0.0
1484,0,1484,[196  79   1 655 294],577,5,6013,4.049158249158249,0.0,0.0
1485,0,1485,[ 56  97  69 210  82],151,4,6017,4.049125168236878,0.0,0.0
1486,0,1486,[132 323 655 174  22],280,2,6019,4.047747141896436,0.0,0.0
1487,0,1487,[174 258 111 403  71],796,5,6024,4.048387096774194,0.0,0.0
1488,0,1488,[318  98  64  79 588],577,5,6029,4.049026192075218,40.0,0.0
1489,0,1489,[269 200 603 423 211],18,3,6032,4.048322147651007,20.0,0.0
1490,0,1490,[144 483 655 174 143],693,3,6035,4.0476190476190474,0.0,0.0
1491,0,1491,[318  98  64  79 588],577,5,6040,4.048257372654155,40.0,0.0
1492,0,1492,[318  98  64  79 588],457,5,6045,4.048894842598794,40.0,0.0
1493,0,1493,[117 196 483 300 143],796,5,6050,4.049531459170013,0.0,0.0
1494,0,1494,[318  98  64  79 588],796,5,6055,4.050167224080267,40.0,0.0
1495,0,1495,[318  98  64  79 588],716,5,6060,4.050802139037433,40.0,0.0
1496,0,1496,[318  98  64  79 588],716,5,6065,4.051436205744823,40.0,0.0
1497,0,1497,[318  98  64  79 588],716,5,6070,4.052069425901202,40.0,0.0
1498,0,1498,[318  98  64  79 588],457,5,6075,4.052701801200801,40.0,0.0
1499,0,1499,[403 179 357  22 191],450,5,6080,4.053333333333334,0.0,0.0
1500,0,1500,[187 196 202 742 568],655,1,6081,4.051299133910726,0.0,0.0
1501,0,1501,[  9 483  15 423  69],18,4,6085,4.051264980026631,0.0,0.0
1502,0,1502,[235 135 194 111 282],457,3,6088,4.050565535595475,0.0,0.0
1503,0,1503,[318  98  64  79 588],577,5,6093,4.051196808510638,40.0,0.0
1504,0,1504,[ 22 200  96 268 182],655,2,6095,4.04983388704319,0.0,0.0
1505,0,1505,[318  98  64  79 588],716,5,6100,4.050464807436919,40.0,0.0
1506,0,1506,[  1 301 276 268 471],535,2,6102,4.0491041804910415,0.0,0.0
1507,0,1507,[318  98  64  79 588],450,5,6107,4.04973474801061,40.0,0.0
1508,0,1508,[318  98  64  79 588],457,5,6112,4.050364479787939,40.0,0.0
1509,0,1509,[ 69 135  11  79 173],716,4,6116,4.050331125827815,0.0,0.0
1510,0,1510,[300 216 237 173 200],450,4,6120,4.050297816015884,0.0,0.0
1511,0,1511,[318  98  64  79 588],796,5,6125,4.050925925925926,40.0,0.0
1512,0,1512,[318  98  64  79 588],457,5,6130,4.051553205551883,40.0,0.0
1513,0,1513,[318  98  64  79 588],450,5,6135,4.05217965653897,40.0,0.0
1514,0,1514,[ 97  88 196 237 385],344,1,6136,4.0501650165016505,0.0,0.0
1515,0,1515,[318  98  64  79 588],18,5,6141,4.050791556728232,40.0,0.0
1516,0,1516,[403 173 197  96 269],450,5,6146,4.051417270929466,0.0,0.0
1517,0,1517,[318  98  64  79 588],450,5,6151,4.0520421607378125,40.0,0.0
1518,0,1518,[318  98  64  79 588],716,5,6156,4.052666227781435,40.0,0.0
1519,0,1519,[161 127 276 172  22],655,3,6159,4.051973684210527,0.0,20.0
1520,0,1520,[318  98  64  79 588],716,5,6164,4.052596975673898,40.0,0.0
1521,0,1521,[127 200 143 403 197],269,3,6167,4.051905387647832,0.0,20.0
1522,0,1522,[318  98  64  79 588],716,5,6172,4.05252790544977,40.0,0.0
1523,0,1523,[508 257 172 655 268],655,1,6173,4.050524934383202,0.0,0.0
1524,0,1524,[318  98  64  79 588],450,5,6178,4.051147540983607,40.0,0.0
1525,0,1525,[318  98  64  79 588],716,5,6183,4.051769331585845,40.0,0.0
1526,0,1526,[318  98  64  79 588],716,5,6188,4.0523903077930585,40.0,0.0
1527,0,1527,[161  88  97  79 471],457,5,6193,4.053010471204188,0.0,0.0
1528,0,1528,[216  11 200 423 276],593,4,6197,4.05297580117724,0.0,0.0
1529,0,1529,[318  98  64  79 588],716,5,6202,4.05359477124183,40.0,0.0
1530,0,1530,[ 70 187 235 588 191],716,3,6205,4.052906596995427,0.0,0.0
1531,0,1531,[173 302 127 179  88],269,2,6207,4.051566579634465,0.0,20.0
1532,0,1532,[318  98  64  79 588],577,5,6212,4.05218525766471,40.0,0.0
1533,0,1533,[318  98  64  79 588],450,5,6217,4.052803129074316,40.0,0.0
1534,0,1534,[435 117  89 121 144],807,4,6221,4.052768729641694,0.0,0.0
1535,0,1535,[588 181 275 385 301],796,4,6225,4.052734375,0.0,20.0
1536,0,1536,[183 194  15 125  89],457,5,6230,4.053350683148992,0.0,0.0
1537,0,1537,[318  98  64  79 588],577,5,6235,4.053966189856957,40.0,0.0
1538,0,1538,[172  82  79 258 187],450,4,6239,4.053931124106563,0.0,0.0
1539,0,1539,[318  98  64  79 588],716,5,6244,4.054545454545455,40.0,0.0
1540,0,1540,[173 121 153  98 282],535,3,6247,4.053861129136924,0.0,0.0
1541,0,1541,[ 79  96 234  69  88],693,2,6249,4.052529182879377,0.0,0.0
1542,0,1542,[318  64  98  79 588],457,5,6254,4.053143227478937,40.0,0.0
1543,0,1543,[  4 125 271 238 333],655,0,6254,4.050518134715026,0.0,0.0
1544,0,1544,[ 69  11  98 132 318],457,5,6259,4.051132686084142,20.0,0.0
1545,0,1545,[ 88 435 135 275  50],655,3,6262,4.0504527813712805,0.0,40.0
1546,0,1546,[179 100 237 286  82],655,1,6263,4.048480930833872,0.0,40.0
1547,0,1547,[195 172 405 168 403],450,5,6268,4.0490956072351425,0.0,0.0
1548,0,1548,[483 100 186 258 135],151,4,6272,4.0490639122014205,0.0,20.0
1549,0,1549,[318 127 161 328 568],655,2,6274,4.047741935483871,20.0,20.0
1550,0,1550,[238 258   9  98 176],655,1,6275,4.045776918117344,0.0,0.0
1551,0,1551,[655 427   4 196 385],450,4,6279,4.045747422680412,20.0,0.0
1552,0,1552,[117 100  11 245  22],344,1,6280,4.043786220218931,0.0,20.0
1553,0,1553,[318  64  98  79 588],450,5,6285,4.044401544401544,40.0,0.0
1554,0,1554,[144 282 210 496 135],716,2,6287,4.043086816720257,20.0,0.0
1555,0,1555,[ 64 191  11   9 286],655,2,6289,4.041773778920309,20.0,20.0
1556,0,1556,[125 403  88 197   9],796,3,6292,4.041104688503532,0.0,0.0
1557,0,1557,[182 196 435 222 313],450,4,6296,4.041078305519897,0.0,0.0
1558,0,1558,[318  64  98  79 588],18,5,6301,4.04169339320077,40.0,0.0
1559,0,1559,[100 228 275 181  56],450,5,6306,4.042307692307692,0.0,40.0
1560,0,1560,[318  64  98  79 588],796,5,6311,4.0429212043561815,40.0,0.0
1561,0,1561,[318  64  98  79 588],796,5,6316,4.043533930857874,40.0,0.0
1562,0,1562,[357  71 168 204 435],535,4,6320,4.043506078055023,0.0,0.0
1563,0,1563,[603 210 234 288 286],655,1,6321,4.041560102301791,20.0,20.0
1564,0,1564,[318  64  98  79 588],577,5,6326,4.0421725239616615,40.0,0.0
1565,0,1565,[318  64  98  79 588],716,5,6331,4.042784163473819,40.0,0.0
1566,0,1566,[483 515  15 742 117],655,2,6333,4.0414805360561585,0.0,0.0
1567,0,1567,[318  64  98  79 588],18,5,6338,4.042091836734694,40.0,0.0
1568,0,1568,[588   1 200  69  56],796,4,6342,4.042065009560229,0.0,0.0
1569,0,1569,[318  64  98  79 588],450,5,6347,4.042675159235669,40.0,0.0
1570,0,1570,[318  64  98  79 588],796,5,6352,4.0432845321451305,40.0,0.0
1571,0,1571,[173  71  69 318 546],593,4,6356,4.043256997455471,20.0,0.0
1572,0,1572,[228 186 211 196  28],786,5,6361,4.043865225683407,0.0,0.0
1573,0,1573,[222 238  79 318   1],716,5,6366,4.044472681067345,20.0,0.0
1574,0,1574,[ 12 202 323 269 282],796,3,6369,4.043809523809524,0.0,0.0
1575,0,1575,[655  50 435 215 288],655,1,6370,4.041878172588833,0.0,20.0
1576,0,1576,[318  64  98  79 588],450,5,6375,4.042485732403297,40.0,0.0
1577,0,1577,[257 144 275 194 172],401,3,6378,4.0418250950570345,0.0,20.0
1578,0,1578,[318  64  98  79 588],450,5,6383,4.042431918936035,40.0,0.0
1579,0,1579,[318  64  98  79 588],450,5,6388,4.0430379746835445,40.0,0.0
1580,0,1580,[168 111 403 258  71],798,3,6391,4.042378241619228,0.0,0.0
1581,0,1581,[318  64  98  79 588],716,5,6396,4.042983565107459,40.0,0.0
1582,0,1582,[318  64  98  79 588],716,5,6401,4.04358812381554,40.0,0.0
1583,0,1583,[318  64  98  79 588],18,5,6406,4.04419191919192,40.0,0.0
1584,0,1584,[216  12 173   1 127],450,5,6411,4.0447949526813884,0.0,20.0
1585,0,1585,[318  64  98  79 588],716,5,6416,4.045397225725095,40.0,0.0
1586,0,1586,[318  64  98  79 588],450,5,6421,4.045998739760554,40.0,0.0
1587,0,1587,[215   8  79  82 276],457,5,6426,4.0465994962216625,0.0,0.0
1588,0,1588,[ 11 127 194 200 183],269,3,6429,4.045940843297672,0.0,20.0
1589,0,1589,[235 151 508 258  50],463,4,6433,4.045911949685535,0.0,20.0
1590,0,1590,[ 28 328 385  12 180],450,5,6438,4.046511627906977,0.0,0.0
1591,0,1591,[318  64  98  79 588],796,5,6443,4.047110552763819,40.0,0.0
1592,0,1592,[318  64  98  79 588],18,5,6448,4.047708725674827,40.0,0.0
1593,0,1593,[172 257  56 143 153],23,3,6451,4.047051442910916,0.0,0.0
1594,0,1594,[546 172 288  70   7],280,4,6455,4.047021943573668,0.0,0.0
1595,0,1595,[318  64  98  79 588],450,5,6460,4.0476190476190474,40.0,0.0
1596,0,1596,[ 97 257 127 238 475],655,1,6461,4.045710707576706,0.0,20.0
1597,0,1597,[318  64  98  79 588],457,5,6466,4.04630788485607,40.0,0.0
1598,0,1598,[357 238 111 195 202],151,4,6470,4.046278924327705,0.0,0.0
1599,0,1599,[318  64  98  79 588],577,5,6475,4.046875,40.0,0.0
1600,0,1600,[186 289 496 179 187],786,5,6480,4.047470331043098,20.0,0.0
1601,0,1601,[318  64  98  79 588],450,5,6485,4.048064918851436,40.0,0.0
1602,0,1602,[318  64  98  79 588],457,5,6490,4.04865876481597,40.0,0.0
1603,0,1603,[318  64  98  79 588],796,5,6495,4.0492518703241895,40.0,0.0
1604,0,1604,[318  64  98  79 588],18,5,6500,4.049844236760125,40.0,0.0
1605,0,1605,[200 423 186 183  64],457,5,6505,4.050435865504359,20.0,0.0
1606,0,1606,[318  64  98  79 588],716,5,6510,4.051026757934038,40.0,0.0
1607,0,1607,[318  64  98  79 588],796,5,6515,4.051616915422885,40.0,0.0
1608,0,1608,[318  64  98  79 588],18,5,6520,4.052206339341206,40.0,0.0
1609,0,1609,[318  64  98  79 588],457,5,6525,4.052795031055901,40.0,0.0
1610,0,1610,[318  64  98  79 588],796,5,6530,4.053382991930478,40.0,0.0
1611,0,1611,[318  64  98  79 588],457,5,6535,4.053970223325062,40.0,0.0
1612,0,1612,[ 70 151 210 187 174],18,4,6539,4.053936763794172,0.0,0.0
1613,0,1613,[228 222  22 515 144],807,5,6544,4.0545229244114,0.0,0.0
1614,0,1614,[318  64  98  79 588],18,5,6549,4.0551083591331265,40.0,0.0
1615,0,1615,[318  64  98  79 588],716,5,6554,4.055693069306931,40.0,0.0
1616,0,1616,[173 245 174 100 204],593,4,6558,4.055658627087198,0.0,20.0
1617,0,1617,[318  64  98  79 588],450,5,6563,4.056242274412855,40.0,0.0
1618,0,1618,[318  64  98  79 588],716,5,6568,4.056825200741199,40.0,0.0
1619,0,1619,[302 204 222 385 181],344,3,6571,4.056172839506173,0.0,0.0
1620,0,1620,[318  64  98  79 588],18,5,6576,4.056755089450956,40.0,0.0
1621,0,1621,[186 183 176 655 161],796,3,6579,4.056103575832306,0.0,0.0
1622,0,1622,[127 748 427 237 187],796,5,6584,4.056685150955022,20.0,20.0
1623,0,1623,[568 258  69 238 127],457,5,6589,4.057266009852217,0.0,20.0
1624,0,1624,[568 143 357 191  97],655,3,6592,4.056615384615385,0.0,0.0
1625,0,1625,[318  64  98  79 588],457,5,6597,4.057195571955719,40.0,0.0
1626,0,1626,[265 597 237  64 186],796,4,6601,4.057160417947142,20.0,0.0
1627,0,1627,[318  64  98  79 588],457,5,6606,4.057739557739557,40.0,0.0
1628,0,1628,[173   8  50 300 176],756,4,6610,4.057704112952732,0.0,20.0
1629,0,1629,[318  64  98  79 588],457,5,6615,4.058282208588957,40.0,0.0
1630,0,1630,[655   4  69  50  15],786,4,6619,4.058246474555488,0.0,20.0
1631,0,1631,[435 237 174 153 333],655,0,6619,4.0557598039215685,0.0,0.0
1632,0,1632,[318  64  98  79 588],18,5,6624,4.056338028169014,40.0,0.0
1633,0,1633,[ 79 216 357 265 300],716,5,6629,4.056915544675642,0.0,0.0
1634,0,1634,[237   7 475 111 357],296,4,6633,4.056880733944954,0.0,0.0
1635,0,1635,[318  64  98  79 588],796,5,6638,4.057457212713937,40.0,0.0
1636,0,1636,[118  64 127 508  22],344,3,6641,4.056811240073305,20.0,20.0
1637,0,1637,[237 174 568 173  25],885,5,6646,4.057387057387057,0.0,0.0
1638,0,1638,[  4 258 135  22 161],450,3,6649,4.056741915802318,0.0,0.0
1639,0,1639,[403  98 210 483 180],693,1,6650,4.054878048780488,0.0,0.0
1640,0,1640,[588 132 318 228 180],786,5,6655,4.0554539914686165,20.0,0.0
1641,0,1641,[318  64  98  79 588],577,5,6660,4.056029232643118,40.0,0.0
1642,0,1642,[515 204 268 176 302],655,2,6662,4.054777845404748,0.0,0.0
1643,0,1643,[318  64  98  79 588],796,5,6667,4.055352798053528,40.0,0.0
1644,0,1644,[318  64  98  79 588],450,5,6672,4.055927051671732,40.0,0.0
1645,0,1645,[121 300  25   8 333],655,0,6672,4.053462940461725,0.0,0.0
1646,0,1646,[118 588 427 282 202],796,5,6677,4.054037644201578,20.0,0.0
1647,0,1647,[318  64  98  79 588],577,5,6682,4.054611650485437,40.0,0.0
1648,0,1648,[313 172  11   4 118],577,3,6685,4.05397210430564,0.0,0.0
1649,0,1649,[183 187  56 318 328],796,5,6690,4.054545454545455,20.0,0.0
1650,0,1650,[318  64  98  79 588],577,5,6695,4.05511811023622,40.0,0.0
1651,0,1651,[286  64 172 132 195],450,5,6700,4.0556900726392255,20.0,20.0
1652,0,1652,[  4 143 238 121 234],593,4,6704,4.055656382335148,0.0,0.0
1653,0,1653,[318  64  98  79 588],577,5,6709,4.056227327690447,40.0,0.0
1654,0,1654,[318  64  98  79 588],450,5,6714,4.056797583081571,40.0,0.0
1655,0,1655,[318  64  98  79 588],796,5,6719,4.057367149758454,40.0,0.0
1656,0,1656,[318  64  98  79 588],18,5,6724,4.057936028968014,40.0,0.0
1657,0,1657,[318  64  98  79 588],457,5,6729,4.058504221954162,40.0,0.0
1658,0,1658,[568 483 508 181 216],655,2,6731,4.057263411693792,0.0,0.0
1659,0,1659,[ 95 186 234  22 423],716,4,6735,4.057228915662651,0.0,0.0
1660,0,1660,[187 117 196  25 197],72,5,6740,4.057796508127634,0.0,0.0
1661,0,1661,[318  64  98  79 588],457,5,6745,4.058363417569193,40.0,0.0
1662,0,1662,[ 71 237 135 286  22],18,3,6748,4.057726999398677,0.0,20.0
1663,0,1663,[ 50 471 216  98 202],174,5,6753,4.058293269230769,0.0,20.0
1664,0,1664,[238 210 282   4 181],716,3,6756,4.057657657657658,0.0,0.0
1665,0,1665,[496 180 423 183 275],796,4,6760,4.057623049219688,20.0,20.0
1666,0,1666,[  9 742  64 385 161],457,5,6765,4.0581883623275345,20.0,0.0
1667,0,1667,[318  64  98  79 588],796,5,6770,4.0587529976019185,40.0,0.0
1668,0,1668,[322 286 496 302 100],704,4,6774,4.058717795086879,20.0,40.0
1669,0,1669,[282 318 257 302 294],401,1,6775,4.0568862275449105,20.0,0.0
1670,0,1670,[195 125   7 302  64],450,5,6780,4.057450628366248,20.0,0.0
1671,0,1671,[125 385  97 742 265],577,5,6785,4.0580143540669855,0.0,0.0
1672,0,1672,[318  64  98  79 588],577,5,6790,4.058577405857741,40.0,0.0
1673,0,1673,[194 186  95 144 275],716,3,6793,4.0579450418160095,0.0,20.0
1674,0,1674,[318  64  98  79 588],18,5,6798,4.058507462686567,40.0,0.0
1675,0,1675,[  8 238 173 181 234],457,5,6803,4.059069212410501,0.0,0.0
1676,0,1676,[318  64  98  79 588],716,5,6808,4.059630292188432,40.0,0.0
1677,0,1677,[435   8  69 237 508],11,4,6812,4.059594755661502,0.0,0.0
1678,0,1678,[318  64  98  79 588],18,5,6817,4.060154854079809,40.0,0.0
1679,0,1679,[318  64  98  79 588],577,5,6822,4.060714285714286,40.0,0.0
1680,0,1680,[318  64  98  79 588],457,5,6827,4.061273051754908,40.0,0.0
1681,0,1681,[318  64  98  79 588],450,5,6832,4.061831153388823,40.0,0.0
1682,0,1682,[ 56  69 238 288 302],450,4,6836,4.0617944147355916,0.0,0.0
1683,0,1683,[197 181 172 173  82],269,1,6837,4.059976247030879,0.0,0.0
1684,0,1684,[318  64  98  79 588],716,5,6842,4.06053412462908,40.0,0.0
1685,0,1685,[216  88  89 117 496],796,5,6847,4.061091340450771,20.0,0.0
1686,0,1686,[275 333 210 222  96],655,1,6848,4.0592768227623,0.0,20.0
1687,0,1687,[215  88 546 204 174],504,3,6851,4.0586492890995265,0.0,0.0
1688,0,1688,[318  64  98  79 588],450,5,6856,4.059206631142688,40.0,0.0
1689,0,1689,[318  64  98  79 588],457,5,6861,4.0597633136094675,40.0,0.0
1690,0,1690,[100 111 238 191 235],269,3,6864,4.059136605558841,0.0,20.0
1691,0,1691,[265  82 300 228  79],450,4,6868,4.0591016548463354,0.0,0.0
1692,0,1692,[322 603 143 245  97],450,5,6873,4.05965741287655,20.0,0.0
1693,0,1693,[313  22  79 603  88],796,5,6878,4.0602125147579695,20.0,0.0
1694,0,1694,[174 405 588  98  12],457,5,6883,4.060766961651917,0.0,0.0
1695,0,1695,[318  64  98  79 588],716,5,6888,4.061320754716981,40.0,0.0
1696,0,1696,[318  64  98  79 588],796,5,6893,4.061873895109016,40.0,0.0
1697,0,1697,[168 427 172 237 153],535,4,6897,4.061837455830389,20.0,0.0
1698,0,1698,[318  64  98  79 588],18,5,6902,4.062389640965273,40.0,0.0
1699,0,1699,[318  64  98  79 588],716,5,6907,4.062941176470588,40.0,0.0
1700,0,1700,[496 275  97 282 318],535,4,6911,4.062904174015285,40.0,20.0
1701,0,1701,[125 118 588  88 183],796,5,6916,4.063454759106933,0.0,0.0
1702,0,1702,[245 125 181 173 597],593,3,6919,4.06283029947152,0.0,0.0
1703,0,1703,[ 15 294 435 289 132],655,0,6919,4.060446009389671,0.0,0.0
1704,0,1704,[318  64  98  79 588],716,5,6924,4.06099706744868,40.0,0.0
1705,0,1705,[655 234 427 181 175],655,1,6925,4.059202813599062,20.0,0.0
1706,0,1706,[318  64  98  79 588],796,5,6930,4.059753954305799,40.0,0.0
1707,0,1707,[ 25  88 405 111   4],577,3,6933,4.059133489461359,0.0,0.0
1708,0,1708,[125 403 357 151 197],504,4,6937,4.059098888238736,0.0,0.0
1709,0,1709,[222  50 273 176 357],796,4,6941,4.05906432748538,0.0,20.0
1710,0,1710,[318  64  98  79 588],796,5,6946,4.059614260666277,40.0,0.0
1711,0,1711,[483   9 742 301 183],796,2,6948,4.058411214953271,0.0,0.0
1712,0,1712,[471 216 655 258   4],457,5,6953,4.058960887332166,0.0,0.0
1713,0,1713,[318  64  98  79 588],18,5,6958,4.05950991831972,40.0,0.0
1714,0,1714,[742 204 385 237 245],593,4,6962,4.059475218658892,0.0,0.0
1715,0,1715,[179 588 180 175   7],457,5,6967,4.06002331002331,0.0,0.0
1716,0,1716,[318  64  98  79 588],577,5,6972,4.0605707629586485,40.0,0.0
1717,0,1717,[318  64  98  79 588],457,5,6977,4.0611175785797435,40.0,0.0
1718,0,1718,[318  64  98  79 588],457,5,6982,4.061663757998836,40.0,0.0
1719,0,1719,[318  64  98  79 588],796,5,6987,4.062209302325582,40.0,0.0
1720,0,1720,[318  64  98  79 588],716,5,6992,4.062754212667054,40.0,0.0
1721,0,1721,[318  64  98  79 588],457,5,6997,4.0632984901277585,40.0,0.0
1722,0,1722,[318  64  98  79 588],577,5,7002,4.063842135809634,40.0,0.0
1723,0,1723,[318  64  98  79 588],796,5,7007,4.064385150812065,40.0,0.0
1724,0,1724,[132 118 197 211 202],655,0,7007,4.062028985507246,0.0,0.0
1725,0,1725,[318  64  98  79 588],577,5,7012,4.0625724217844725,40.0,0.0
1726,0,1726,[318  64  98  79 588],577,5,7017,4.063115228720324,40.0,0.0
1727,0,1727,[121  98 405 196 301],655,1,7018,4.061342592592593,0.0,0.0
1728,0,1728,[174 183 405  25  98],503,4,7022,4.0613071139386925,0.0,0.0
1729,0,1729,[318  64  98  79 588],18,5,7027,4.061849710982659,40.0,0.0
1730,0,1730,[ 25 182  88 135  98],655,3,7030,4.061236279607163,0.0,0.0
1731,0,1731,[318  64  98  79 588],18,5,7035,4.061778290993072,40.0,0.0
1732,0,1732,[318  64  98  79 588],450,5,7040,4.062319676860935,40.0,0.0
1733,0,1733,[318  64  98  79 588],716,5,7045,4.062860438292964,40.0,0.0
1734,0,1734,[ 70 175 357   1 423],655,1,7046,4.061095100864553,0.0,0.0
1735,0,1735,[318  64  98  79 588],796,5,7051,4.061635944700461,40.0,0.0
1736,0,1736,[  4 143 121 357 748],796,5,7056,4.062176165803109,0.0,0.0
1737,0,1737,[200 197 176 153 180],269,2,7058,4.060989643268124,0.0,0.0
1738,0,1738,[508 182 483  96 475],269,4,7062,4.06095457159287,0.0,0.0
1739,0,1739,[318  64  98  79 588],18,5,7067,4.061494252873564,40.0,0.0
1740,0,1740,[318  64  98  79 588],18,5,7072,4.062033314187249,40.0,0.0
1741,0,1741,[318  64  98  79 588],716,5,7077,4.062571756601607,40.0,0.0
1742,0,1742,[318  64  98  79 588],716,5,7082,4.0631095811818705,40.0,0.0
1743,0,1743,[ 69 322 588 276 423],280,5,7087,4.063646788990826,0.0,0.0
1744,0,1744,[144  79 269 176 135],655,2,7089,4.062464183381088,0.0,0.0
1745,0,1745,[200 655  88 508 313],655,2,7091,4.061282932416953,0.0,0.0
1746,0,1746,[288 121 385 111  69],593,5,7096,4.061820263308529,0.0,0.0
1747,0,1747,[ 25 427 237 300 181],716,5,7101,4.062356979405035,20.0,0.0
1748,0,1748,[125 286 258  70 181],344,0,7101,4.060034305317324,0.0,20.0
1749,0,1749,[288  11 172 273 100],655,2,7103,4.058857142857143,0.0,20.0
1750,0,1750,[269 405 153 182 435],450,5,7108,4.059394631639063,0.0,0.0
1751,0,1751,[318  64  98  79 588],450,5,7113,4.059931506849315,40.0,0.0
1752,0,1752,[318  64  98  79 588],796,5,7118,4.060467769537935,40.0,0.0
1753,0,1753,[179 151  69 568 435],269,2,7120,4.059293044469784,0.0,0.0
1754,0,1754,[318  64  98  79 588],577,5,7125,4.05982905982906,40.0,0.0
1755,0,1755,[318  64  98  79 588],450,5,7130,4.060364464692483,40.0,0.0
1756,0,1756,[161  64 121 423  89],457,5,7135,4.060899260102447,20.0,0.0
1757,0,1757,[ 15 357 237 385 288],450,3,7138,4.060295790671217,0.0,0.0
1758,0,1758,[300 588 182 257  82],389,3,7141,4.059693007390563,0.0,0.0
1759,0,1759,[275 127 301 258 237],344,3,7144,4.0590909090909095,0.0,40.0
1760,0,1760,[196 175 222 423 118],457,5,7149,4.059625212947189,0.0,0.0
1761,0,1761,[405 174 271   1  22],796,4,7153,4.0595913734392735,0.0,0.0
1762,0,1762,[ 50 568  82 132  79],716,5,7158,4.060124787294384,0.0,20.0
1763,0,1763,[318  64  98  79 588],457,5,7163,4.0606575963718825,40.0,0.0
1764,0,1764,[318  64  98  79 588],716,5,7168,4.061189801699717,40.0,0.0
1765,0,1765,[318  64  98  79 588],450,5,7173,4.061721404303511,40.0,0.0
1766,0,1766,[228 151 222 385   9],796,4,7177,4.061686474250141,0.0,0.0
1767,0,1767,[238 185 194 202 508],269,4,7181,4.0616515837104075,0.0,0.0
1768,0,1768,[318  64  98  79 588],796,5,7186,4.062182023742227,40.0,0.0
1769,0,1769,[125 294 186 100 181],577,5,7191,4.062711864406779,0.0,20.0
1770,0,1770,[318  64  98  79 588],716,5,7196,4.063241106719367,40.0,0.0
1771,0,1771,[318  64  98  79 588],577,5,7201,4.063769751693003,40.0,0.0
1772,0,1772,[200 135 302 132 168],450,3,7204,4.063169768753525,0.0,0.0
1773,0,1773,[318  64  98  79 588],796,5,7209,4.0636978579481395,40.0,0.0
1774,0,1774,[385   9 655 282 161],280,3,7212,4.063098591549296,0.0,0.0
1775,0,1775,[318  64  98  79 588],577,5,7217,4.063626126126126,40.0,0.0
1776,0,1776,[318  64  98  79 588],577,5,7222,4.064153066966798,40.0,0.0
1777,0,1777,[153   8 435  22 195],18,4,7226,4.0641169853768275,0.0,0.0
1778,0,1778,[318  64  98  79 588],18,5,7231,4.064643057897696,40.0,0.0
1779,0,1779,[318  64  98  79 588],457,5,7236,4.0651685393258425,40.0,0.0
1780,0,1780,[179   1  69 286 181],593,4,7240,4.065131948343627,0.0,20.0
1781,0,1781,[318  64  98  79 588],450,5,7245,4.065656565656566,40.0,0.0
1782,0,1782,[183 186 121 168  12],503,3,7248,4.065058889512058,0.0,0.0
1783,0,1783,[  8 135  98  88 127],389,3,7251,4.064461883408072,0.0,20.0
1784,0,1784,[318  64  98  79 588],450,5,7256,4.064985994397759,40.0,0.0
1785,0,1785,[318  64  98  79 588],796,5,7261,4.065509518477044,40.0,0.0
1786,0,1786,[318  64  98  79 588],18,5,7266,4.066032456631225,40.0,0.0
1787,0,1787,[318  64  98  79 588],716,5,7271,4.0665548098434,40.0,0.0
1788,0,1788,[313  82 238 258  95],796,3,7274,4.065958636109558,0.0,0.0
1789,0,1789,[403  88 222 282  95],450,3,7277,4.0653631284916205,0.0,0.0
1790,0,1790,[318  64  98  79 588],457,5,7282,4.065884980457845,40.0,0.0
1791,0,1791,[275  28 603 211 194],716,5,7287,4.06640625,20.0,20.0
1792,0,1792,[318  64  98  79 588],457,5,7292,4.066926938092582,40.0,0.0
1793,0,1793,[ 56 151   7 471 276],256,3,7295,4.0663322185061315,0.0,0.0
1794,0,1794,[151 172 132 143 153],151,4,7299,4.066295264623956,0.0,0.0
1795,0,1795,[302  11 200 127  22],269,2,7301,4.065144766146993,0.0,20.0
1796,0,1796,[318  64  98  79 588],18,5,7306,4.065664997217585,40.0,0.0
1797,0,1797,[318 181 180 210 405],269,1,7307,4.063959955506118,20.0,0.0
1798,0,1798,[294  22 174 127 181],450,5,7312,4.064480266814897,0.0,20.0
1799,0,1799,[202 313 435 603 300],655,2,7314,4.0633333333333335,20.0,0.0
1800,0,1800,[742   8 258 328 173],796,4,7318,4.06329816768462,0.0,0.0
1801,0,1801,[318  64  98  79 588],577,5,7323,4.063817980022198,40.0,0.0
1802,0,1802,[125 186   8 405  64],655,1,7324,4.062118691070438,20.0,0.0
1803,0,1803,[ 25 186 288 204 173],450,2,7326,4.060975609756097,0.0,0.0
1804,0,1804,[318  64  98  79 588],577,5,7331,4.061495844875346,40.0,0.0
1805,0,1805,[100 282   1 265 185],535,2,7333,4.060354374307862,0.0,20.0
1806,0,1806,[748 183 385 168 322],796,4,7337,4.060320973990039,0.0,0.0
1807,0,1807,[318  64  98  79 588],18,5,7342,4.060840707964601,40.0,0.0
1808,0,1808,[234 153   8 286  88],655,0,7342,4.058595909342178,0.0,20.0
1809,0,1809,[318  64  98  79 588],577,5,7347,4.059116022099447,40.0,0.0
1810,0,1810,[196  22  82 182 172],457,5,7352,4.059635560463832,0.0,0.0
1811,0,1811,[ 56 127 222  11 151],296,4,7356,4.059602649006623,0.0,20.0
1812,0,1812,[100 118 294 300 121],450,3,7359,4.059018201875345,0.0,20.0
1813,0,1813,[318  64  98  79 588],796,5,7364,4.059536934950386,40.0,0.0
1814,0,1814,[202 183  82   1  50],280,1,7365,4.0578512396694215,0.0,20.0
1815,0,1815,[318  64  98  79 588],450,5,7370,4.058370044052864,40.0,0.0
1816,0,1816,[318  64  98  79 588],450,5,7375,4.058888277380297,40.0,0.0
1817,0,1817,[186 144 435  11 475],655,0,7375,4.056655665566557,0.0,0.0
1818,0,1818,[  9  96 118 288 385],280,4,7379,4.056624518966465,0.0,0.0
1819,0,1819,[ 82  69  56   8 483],389,5,7384,4.057142857142857,0.0,0.0
1820,0,1820,[318  64  98  79 588],716,5,7389,4.057660626029654,40.0,0.0
1821,0,1821,[210  50 405   9 121],457,5,7394,4.058177826564215,0.0,20.0
1822,0,1822,[318  64  98  79 588],18,5,7399,4.058694459681843,40.0,0.0
1823,0,1823,[318  64  98  79 588],796,5,7404,4.059210526315789,40.0,0.0
1824,0,1824,[318  64  98  79 588],450,5,7409,4.05972602739726,40.0,0.0
1825,0,1825,[318  64  98  79 588],457,5,7414,4.0602409638554215,40.0,0.0
1826,0,1826,[318  64  98  79 588],796,5,7419,4.060755336617405,40.0,0.0
1827,0,1827,[318  64  98  79 588],577,5,7424,4.061269146608315,40.0,0.0
1828,0,1828,[318  64  98  79 588],796,5,7429,4.06178239475123,40.0,0.0
1829,0,1829,[ 11 603 183 186 235],269,1,7430,4.060109289617486,20.0,0.0
1830,0,1830,[318  64  98  79 588],450,5,7435,4.060622610595303,40.0,0.0
1831,0,1831,[127 186 235 200 195],269,2,7437,4.059497816593886,0.0,20.0
1832,0,1832,[318  64  98  79 588],18,5,7442,4.060010911074741,40.0,0.0
1833,0,1833,[111 172 655  64 168],269,3,7445,4.059432933478735,20.0,0.0
1834,0,1834,[318  64  98  79 588],796,5,7450,4.059945504087193,40.0,0.0
1835,0,1835,[742  15 323 168 173],796,3,7453,4.059368191721133,0.0,0.0
1836,0,1836,[  8  82 202   9 197],280,2,7455,4.058247142079478,0.0,0.0
1837,0,1837,[318  64  98  79 588],450,5,7460,4.058759521218716,40.0,0.0
1838,0,1838,[318  64  98  79 588],450,5,7465,4.059271343121262,40.0,0.0
1839,0,1839,[318  64  98  79 588],18,5,7470,4.059782608695652,40.0,0.0
1840,0,1840,[197  22 143 187 435],655,2,7472,4.058663769690385,0.0,0.0
1841,0,1841,[318  64  98  79 588],450,5,7477,4.059174809989142,40.0,0.0
1842,0,1842,[603 597  98 161 245],450,5,7482,4.0596852957135106,20.0,0.0
1843,0,1843,[204 200 187   1 197],835,3,7485,4.059110629067245,0.0,0.0
1844,0,1844,[ 69 211 161  95 655],450,4,7489,4.059078590785908,0.0,0.0
1845,0,1845,[269 275 173   8 172],344,5,7494,4.059588299024918,0.0,20.0
1846,0,1846,[318  64  98  79 588],796,5,7499,4.060097455332972,40.0,0.0
1847,0,1847,[318  64  98  79 588],450,5,7504,4.0606060606060606,40.0,0.0
1848,0,1848,[318  64  98  79 588],457,5,7509,4.061114115738237,40.0,0.0
1849,0,1849,[318  64  98  79 588],457,5,7514,4.061621621621621,40.0,0.0
1850,0,1850,[318  64  98  79 588],577,5,7519,4.062128579146408,40.0,0.0
1851,0,1851,[318  64  98  79 588],577,5,7524,4.0626349892008635,40.0,0.0
1852,0,1852,[257 568 127 135 143],716,4,7528,4.062601187263897,0.0,20.0
1853,0,1853,[ 82 121  11 168 181],269,1,7529,4.060949298813377,0.0,0.0
1854,0,1854,[318  64  98  79 588],450,5,7534,4.061455525606469,40.0,0.0
1855,0,1855,[318  64  98  79 588],716,5,7539,4.061961206896552,40.0,0.0
1856,0,1856,[172 423 228   7  79],577,3,7542,4.061389337641357,0.0,0.0
1857,0,1857,[143 181 127 275 187],796,5,7547,4.0618945102260495,0.0,40.0
1858,0,1858,[322 202 483 174  15],796,4,7551,4.06186121570737,0.0,0.0
1859,0,1859,[313 211 179  50 215],450,5,7556,4.06236559139785,0.0,20.0
1860,0,1860,[294 427  95 196 195],796,4,7560,4.062332079527136,20.0,0.0
1861,0,1861,[172 117 235 127 196],716,4,7564,4.062298603651987,0.0,20.0
1862,0,1862,[318  64  98  79 588],18,5,7569,4.06280193236715,40.0,0.0
1863,0,1863,[318  64  98  79 588],716,5,7574,4.063304721030043,40.0,0.0
1864,0,1864,[ 98  97 257 181 127],504,4,7578,4.063270777479893,0.0,20.0
1865,0,1865,[ 25 194 483 168   1],450,3,7581,4.062700964630225,0.0,0.0
1866,0,1866,[257  97 288 210 475],655,0,7581,4.060524906266738,0.0,0.0
1867,0,1867,[275 117  12 100 258],629,5,7586,4.0610278372591,0.0,40.0
1868,0,1868,[151 496  50 174 117],807,5,7591,4.061530230069556,20.0,20.0
1869,0,1869,[318  64  98  79 588],450,5,7596,4.062032085561498,40.0,0.0
1870,0,1870,[318  64  98  79 588],18,5,7601,4.062533404596472,40.0,0.0
1871,0,1871,[471  82 186 286 196],655,0,7601,4.060363247863248,0.0,20.0
1872,0,1872,[191 121 185 258  69],450,4,7605,4.060331019754405,0.0,0.0
1873,0,1873,[318  64  98  79 588],450,5,7610,4.060832443970117,40.0,0.0
1874,0,1874,[318  64  98  79 588],716,5,7615,4.061333333333334,40.0,0.0
1875,0,1875,[318  64  98  79 588],18,5,7620,4.061833688699361,40.0,0.0
1876,0,1876,[294 143 202  89 125],457,4,7624,4.0618007458710705,0.0,0.0
1877,0,1877,[ 82 132  28  70 187],18,3,7627,4.061235356762514,0.0,0.0
1878,0,1878,[318  64  98  79 588],18,5,7632,4.0617349654071315,40.0,0.0
1879,0,1879,[318  64  98  79 588],18,5,7637,4.062234042553191,40.0,0.0
1880,0,1880,[318  64  98  79 588],18,5,7642,4.0627325890483785,40.0,0.0
1881,0,1881,[ 64 100 121 483 117],450,3,7645,4.062167906482466,20.0,20.0
1882,0,1882,[318  64  98  79 588],577,5,7650,4.062665958576739,40.0,0.0
1883,0,1883,[318  64  98  79 588],577,5,7655,4.063163481953291,40.0,0.0
1884,0,1884,[318  64  98  79 588],577,5,7660,4.063660477453581,40.0,0.0
1885,0,1885,[318  64  98  79 588],716,5,7665,4.0641569459172855,40.0,0.0
1886,0,1886,[172 210 257  25  98],330,5,7670,4.0646528881823,0.0,0.0
1887,0,1887,[318  64  98  79 588],796,5,7675,4.065148305084746,40.0,0.0
1888,0,1888,[ 82 143 215 172 200],577,3,7678,4.064584436209635,0.0,0.0
1889,0,1889,[  7   1 181  50 546],786,5,7683,4.065079365079365,0.0,20.0
1890,0,1890,[318  64  98  79 588],796,5,7688,4.065573770491803,40.0,0.0
1891,0,1891,[405 174 168  15 161],330,4,7692,4.06553911205074,0.0,0.0
1892,0,1892,[269  82  50 132  98],796,3,7695,4.064976228209192,0.0,20.0
1893,0,1893,[118   4 301 222 276],344,4,7699,4.064941921858501,0.0,0.0
1894,0,1894,[435 132 235  25 173],450,3,7702,4.064379947229551,0.0,0.0
1895,0,1895,[301 211 182   4 427],796,3,7705,4.063818565400844,20.0,0.0
1896,0,1896,[195  82 202 127  50],716,4,7709,4.063784923563522,0.0,40.0
1897,0,1897,[655 228 202 385 427],23,3,7712,4.063224446786091,20.0,0.0
1898,0,1898,[ 97 175 181 603 179],18,3,7715,4.062664560294892,20.0,0.0
1899,0,1899,[ 97 238 132 118 234],655,0,7715,4.060526315789474,0.0,0.0
1900,0,1900,[318  64  98  79 588],457,5,7720,4.061020515518148,40.0,0.0
1901,0,1901,[275 288 271 121 143],655,2,7722,4.05993690851735,0.0,20.0
1902,0,1902,[423 258 435 187 186],450,4,7726,4.059905412506569,0.0,0.0
1903,0,1903,[318  64  98  79 588],457,5,7731,4.0603991596638656,40.0,0.0
1904,0,1904,[200 423 275 168 234],151,4,7735,4.060367454068241,0.0,20.0
1905,0,1905,[318  64  98  79 588],716,5,7740,4.060860440713536,40.0,0.0
1906,0,1906,[288  88 176 301  70],655,0,7740,4.058730991085475,0.0,0.0
1907,0,1907,[268 172 471 483 282],535,2,7742,4.0576519916142555,0.0,0.0
1908,0,1908,[121 265 423 318 403],450,4,7746,4.057621791513881,20.0,0.0
1909,0,1909,[318  64  98  79 588],457,5,7751,4.058115183246073,40.0,0.0
1910,0,1910,[ 28 603 235 228 748],450,4,7755,4.058084772370487,20.0,0.0
1911,0,1911,[ 89 216 357 185 195],23,4,7759,4.058054393305439,0.0,0.0
1912,0,1912,[323 121 185 276  50],504,3,7762,4.057501306847883,0.0,20.0
1913,0,1913,[200 173   4 237 322],786,4,7766,4.057471264367816,0.0,0.0
1914,0,1914,[318  64  98  79 588],716,5,7771,4.0579634464751955,40.0,0.0
1915,0,1915,[318  64  98  79 588],457,5,7776,4.058455114822547,40.0,0.0
1916,0,1916,[318  64  98  79 588],796,5,7781,4.058946270213876,40.0,0.0
1917,0,1917,[427 238 194 204 258],796,4,7785,4.058915537017727,20.0,0.0
1918,0,1918,[302 161 204 179 125],655,2,7787,4.0578426263679,0.0,0.0
1919,0,1919,[258 597 748  89 257],796,5,7792,4.058333333333334,0.0,0.0
1920,0,1920,[318  64  98  79 588],716,5,7797,4.0588235294117645,40.0,0.0
1921,0,1921,[568 196 333 143 182],655,2,7799,4.057752341311134,0.0,0.0
1922,0,1922,[ 96 117 121  98 546],344,2,7801,4.056682267290691,0.0,0.0
1923,0,1923,[318  64  98  79 588],577,5,7806,4.057172557172557,40.0,0.0
1924,0,1924,[176 132 294 328 257],655,0,7806,4.0550649350649355,0.0,0.0
1925,0,1925,[318  64  98  79 588],716,5,7811,4.055555555555555,40.0,0.0
1926,0,1926,[216  64 265 238 135],151,5,7816,4.056045666839647,20.0,0.0
1927,0,1927,[318  64  98  79 588],716,5,7821,4.056535269709544,40.0,0.0
1928,0,1928,[318  64  98  79 588],716,5,7826,4.057024364955936,40.0,0.0
1929,0,1929,[172   1 135 173 216],457,5,7831,4.057512953367875,0.0,0.0
1930,0,1930,[427 405  79 357  22],11,4,7835,4.0574831693423095,20.0,0.0
1931,0,1931,[318  64  98  79 588],18,5,7840,4.057971014492754,40.0,0.0
1932,0,1932,[125 238 282 483  56],296,5,7845,4.058458354888774,0.0,0.0
1933,0,1933,[318  64  98  79 588],716,5,7850,4.05894519131334,40.0,0.0
1934,0,1934,[318  64  98  79 588],796,5,7855,4.059431524547803,40.0,0.0
1935,0,1935,[187  12 127  89  97],655,3,7858,4.058884297520661,0.0,20.0
1936,0,1936,[483 191 496 181 121],716,5,7863,4.059370160041301,20.0,0.0
1937,0,1937,[568 245 200  79 423],450,4,7867,4.059339525283797,0.0,0.0
1938,0,1938,[318  64  98  79 588],457,5,7872,4.059824651882414,40.0,0.0
1939,0,1939,[318  64  98  79 588],450,5,7877,4.060309278350515,40.0,0.0
1940,0,1940,[318  64  98  79 588],716,5,7882,4.060793405461102,40.0,0.0
1941,0,1941,[ 98 117  28  64 357],457,5,7887,4.061277033985582,20.0,0.0
1942,0,1942,[  8 301 185 151 174],796,4,7891,4.061245496654657,0.0,0.0
1943,0,1943,[318  64  98  79 588],18,5,7896,4.061728395061729,40.0,0.0
1944,0,1944,[318  64  98  79 588],796,5,7901,4.062210796915167,40.0,0.0
1945,0,1945,[318  64  98  79 588],577,5,7906,4.062692702980473,40.0,0.0
1946,0,1946,[318  64  98  79 588],577,5,7911,4.063174114021572,40.0,0.0
1947,0,1947,[318  64  98  79 588],577,5,7916,4.063655030800821,40.0,0.0
1948,0,1948,[318  64  98  79 588],796,5,7921,4.064135454079015,40.0,0.0
1949,0,1949,[318  64  98  79 588],716,5,7926,4.064615384615385,40.0,0.0
1950,0,1950,[ 71 288 597  69  56],450,3,7929,4.064069707842132,0.0,0.0
1951,0,1951,[235  22 269  71  95],450,2,7931,4.063012295081967,0.0,0.0
1952,0,1952,[318  64  98  79 588],796,5,7936,4.063492063492063,40.0,0.0
1953,0,1953,[318  64  98  79 588],796,5,7941,4.063971340839304,40.0,0.0
1954,0,1954,[475 301 211 194 191],389,5,7946,4.064450127877238,0.0,0.0
1955,0,1955,[427 588 200 195 168],330,3,7949,4.063905930470348,20.0,0.0
1956,0,1956,[318  64  98  79 588],457,5,7954,4.064384261624936,40.0,0.0
1957,0,1957,[357 127  89 211 313],450,5,7959,4.064862104187947,0.0,20.0
1958,0,1958,[257 196 234 143 144],796,4,7963,4.06482899438489,0.0,0.0
1959,0,1959,[318  64  98  79 588],716,5,7968,4.0653061224489795,40.0,0.0
1960,0,1960,[496  22 100 182 323],280,2,7970,4.06425293217746,20.0,20.0
1961,0,1961,[ 69 172 144 282 222],655,1,7971,4.062691131498471,0.0,0.0
1962,0,1962,[222   1 117 228   4],457,5,7976,4.0631686194600105,0.0,0.0
1963,0,1963,[496  95   7 403 117],450,4,7980,4.063136456211812,20.0,0.0
1964,0,1964,[318  64  98  79 588],577,5,7985,4.0636132315521625,40.0,0.0
1965,0,1965,[ 15   4 211 194   9],796,3,7988,4.063072227873856,0.0,0.0
1966,0,1966,[318  64  98  79 588],716,5,7993,4.063548551093035,40.0,0.0
1967,0,1967,[  1 245  88  50 322],796,2,7995,4.0625,0.0,20.0
1968,0,1968,[318  64  98  79 588],450,5,8000,4.062976130015236,40.0,0.0
1969,0,1969,[111  15   4 603 234],450,2,8002,4.061928934010152,20.0,0.0
1970,0,1970,[405 151 125  82 153],450,4,8006,4.061897513952308,0.0,0.0
1971,0,1971,[111 181 168 435 191],716,5,8011,4.06237322515213,0.0,0.0
1972,0,1972,[ 98 216  70 181  25],655,2,8013,4.061327927014698,0.0,0.0
1973,0,1973,[195 151  98 121  88],457,5,8018,4.061803444782168,0.0,0.0
1974,0,1974,[318  64  98  79 588],450,5,8023,4.062278481012658,40.0,0.0
1975,0,1975,[  4 118  11 132 471],344,2,8025,4.061234817813765,0.0,0.0
1976,0,1976,[318  64  98  79 588],796,5,8030,4.061709661102681,40.0,0.0
1977,0,1977,[318  64  98  79 588],457,5,8035,4.062184024266936,40.0,0.0
1978,0,1978,[318  64  98  79 588],457,5,8040,4.062657908034361,40.0,0.0
1979,0,1979,[179  25 202 185 288],457,5,8045,4.063131313131313,0.0,0.0
1980,0,1980,[153 275 237 268 172],655,2,8047,4.062089853609288,0.0,20.0
1981,0,1981,[174 216 191 282 515],401,4,8051,4.062058526740666,0.0,0.0
1982,0,1982,[216 144 182 294  50],280,1,8052,4.0605143721633885,0.0,20.0
1983,0,1983,[318  64  98  79 588],577,5,8057,4.060987903225806,40.0,0.0
1984,0,1984,[318  64  98  79 588],18,5,8062,4.061460957178841,40.0,0.0
1985,0,1985,[405 204  79 186 211],796,3,8065,4.0609264853977844,0.0,0.0
1986,0,1986,[318 144 435 269 191],450,5,8070,4.061399094111726,20.0,0.0
1987,0,1987,[ 50  28 195 161  79],716,3,8073,4.060865191146881,0.0,20.0
1988,0,1988,[318  64  98  79 588],18,5,8078,4.061337355455002,40.0,0.0
1989,0,1989,[655 195 265 385  71],786,5,8083,4.061809045226131,0.0,0.0
1990,0,1990,[328 268   9 238   7],629,3,8086,4.061275740833752,0.0,0.0
1991,0,1991,[168 191 471 197 276],401,4,8090,4.061244979919679,0.0,0.0
1992,0,1992,[111 135 216 496  11],269,2,8092,4.060210737581535,20.0,0.0
1993,0,1993,[318  64  98  79 588],457,5,8097,4.060682046138416,40.0,0.0
1994,0,1994,[318  64  98  79 588],450,5,8102,4.061152882205514,40.0,0.0
1995,0,1995,[318  64  98  79 588],716,5,8107,4.061623246492986,40.0,0.0
1996,0,1996,[546 322 191 181 151],796,4,8111,4.061592388582874,0.0,0.0
1997,0,1997,[215 515   9  70 655],655,1,8112,4.06006006006006,0.0,0.0
1998,0,1998,[181  71 286 568 742],280,3,8115,4.059529764882441,0.0,20.0
1999,0,1999,[318  64  98  79 588],457,5,8120,4.06,40.0,0.0
2000,0,2000,[286 100 289 655 301],655,0,8120,4.057971014492754,0.0,40.0
2001,0,2001,[ 97 273 118 202  82],796,2,8122,4.056943056943057,0.0,0.0
2002,0,2002,[318  64  98  79 588],457,5,8127,4.057413879181228,40.0,0.0
2003,0,2003,[318  64  98  79 588],457,5,8132,4.057884231536926,40.0,0.0
2004,0,2004,[318  64  98  79 588],450,5,8137,4.058354114713217,40.0,0.0
2005,0,2005,[318  64  98  79 588],450,5,8142,4.0588235294117645,40.0,0.0
2006,0,2006,[186 222  28 132 603],151,5,8147,4.0592924763328355,20.0,0.0
2007,0,2007,[318  64  98  79 588],796,5,8152,4.059760956175299,40.0,0.0
2008,0,2008,[121 172 228 161 603],330,5,8157,4.060228969636635,20.0,0.0
2009,0,2009,[318  64  98  79 588],450,5,8162,4.060696517412936,40.0,0.0
2010,0,2010,[318  64  98  79 588],450,5,8167,4.061163600198906,40.0,0.0
2011,0,2011,[318  64  98  79 588],796,5,8172,4.061630218687872,40.0,0.0
2012,0,2012,[318  64  98  79 588],577,5,8177,4.062096373571784,40.0,0.0
2013,0,2013,[318  64  98  79 588],450,5,8182,4.062562065541211,40.0,0.0
2014,0,2014,[318  64  98  79 588],577,5,8187,4.06302729528536,40.0,0.0
2015,0,2015,[ 89 423 238 151  98],450,5,8192,4.063492063492063,0.0,0.0
2016,0,2016,[ 11 151 301 275 286],450,5,8197,4.0639563708477935,0.0,40.0
2017,0,2017,[228 117 742 603   4],655,1,8198,4.062438057482656,20.0,0.0
2018,0,2018,[204 172  98 200  79],236,2,8200,4.061416542842991,0.0,0.0
2019,0,2019,[ 79  97 191  64 318],151,4,8204,4.061386138613861,40.0,0.0
2020,0,2020,[318  64  98  79 588],577,5,8209,4.061850569025235,40.0,0.0
2021,0,2021,[132  70 185  64 275],457,5,8214,4.062314540059347,20.0,20.0
2022,0,2022,[318  64  98  79 588],457,5,8219,4.062778052397429,40.0,0.0
2023,0,2023,[222 176 245 135  79],756,2,8221,4.061758893280633,0.0,0.0
2024,0,2024,[323 257 176 282 100],504,4,8225,4.061728395061729,0.0,20.0
2025,0,2025,[228 183 210 179 357],786,5,8230,4.062191510365252,0.0,0.0
2026,0,2026,[182 403 143 215  15],796,5,8235,4.06265416872225,0.0,0.0
2027,0,2027,[197 265  71 288 237],280,3,8238,4.062130177514793,0.0,0.0
2028,0,2028,[ 98 435 222 655 143],236,4,8242,4.06209955643174,0.0,0.0
2029,0,2029,[318  64  98  79 588],18,5,8247,4.06256157635468,40.0,0.0
2030,0,2030,[318  64  98  79 588],796,5,8252,4.063023141309699,40.0,0.0
2031,0,2031,[173 471 483 323  69],280,2,8254,4.062007874015748,0.0,0.0
2032,0,2032,[318  64  98  79 588],450,5,8259,4.062469257255287,40.0,0.0
2033,0,2033,[ 79 269  50  82 271],796,3,8262,4.061946902654867,0.0,20.0
2034,0,2034,[ 97  79 496 588 328],450,5,8267,4.062407862407863,20.0,0.0
2035,0,2035,[318  64  98  79 588],716,5,8272,4.06286836935167,40.0,0.0
2036,0,2036,[318  64  98  79 588],450,5,8277,4.063328424153166,40.0,0.0
2037,0,2037,[318  64  98  79 588],716,5,8282,4.063788027477919,40.0,0.0
2038,0,2038,[318  64  98  79 588],18,5,8287,4.064247179990192,40.0,0.0
2039,0,2039,[216 496  64 318   9],707,2,8289,4.063235294117647,60.0,0.0
2040,0,2040,[318  98  79  64 588],796,5,8294,4.063694267515924,40.0,0.0
2041,0,2041,[144 197 427  69 180],450,5,8299,4.064152791380999,20.0,0.0
2042,0,2042,[ 71 143 195 288 194],450,3,8302,4.063631913852178,0.0,0.0
2043,0,2043,[318  98  79  64 588],18,5,8307,4.064090019569472,40.0,0.0
2044,0,2044,[ 69 202 180  79 175],18,3,8310,4.06356968215159,0.0,0.0
2045,0,2045,[318  98  79  64 588],18,5,8315,4.064027370478984,40.0,0.0
2046,0,2046,[318  98  79  64 588],457,5,8320,4.064484611626771,40.0,0.0
2047,0,2047,[318  98  79  64 588],716,5,8325,4.06494140625,40.0,0.0
2048,0,2048,[318  98  79  64 588],716,5,8330,4.06539775500244,40.0,0.0
2049,0,2049,[318  98  79  64 588],577,5,8335,4.065853658536585,40.0,0.0
2050,0,2050,[318  98  79  64 588],450,5,8340,4.066309117503657,40.0,0.0
2051,0,2051,[328 471 111 237  56],65,4,8344,4.0662768031189085,0.0,0.0
2052,0,2052,[318  98  79  64 588],796,5,8349,4.06673161227472,40.0,0.0
2053,0,2053,[318  98  79  64 588],577,5,8354,4.067185978578384,40.0,0.0
2054,0,2054,[403 423  50  28 172],807,5,8359,4.067639902676399,0.0,20.0
2055,0,2055,[318  98  79  64 588],577,5,8364,4.0680933852140075,40.0,0.0
2056,0,2056,[ 69 183 301 196  25],593,4,8368,4.0680602819640255,0.0,0.0
2057,0,2057,[655  79 161 234  89],450,4,8372,4.068027210884353,0.0,0.0
2058,0,2058,[ 98 655 172 204  97],457,5,8377,4.06847984458475,0.0,0.0
2059,0,2059,[318  98  79  64 588],796,5,8382,4.0689320388349515,40.0,0.0
2060,0,2060,[318  98  79  64 588],796,5,8387,4.069383794274624,40.0,0.0
2061,0,2061,[301  96 210 748  56],796,3,8390,4.06886517943744,0.0,0.0
2062,0,2062,[318  98  79  64 588],716,5,8395,4.069316529326224,40.0,0.0
2063,0,2063,[318  98  79  64 588],577,5,8400,4.069767441860465,40.0,0.0
2064,0,2064,[385 118   4  98  50],450,3,8403,4.069249394673124,0.0,20.0
2065,0,2065,[318  98  79  64 588],716,5,8408,4.069699903194579,40.0,0.0
2066,0,2066,[318  98  79  64 588],796,5,8413,4.070149975810353,40.0,0.0
2067,0,2067,[ 71   9 237 215 132],796,4,8417,4.070116054158607,0.0,0.0
2068,0,2068,[200  97 546 215 385],716,3,8420,4.069598840019333,0.0,0.0
2069,0,2069,[204 202 588 275  70],330,5,8425,4.070048309178744,0.0,20.0
2070,0,2070,[318  98  79  64 588],18,5,8430,4.0704973442781265,40.0,0.0
2071,0,2071,[318  98  79  64 588],450,5,8435,4.070945945945946,40.0,0.0
2072,0,2072,[318  98  79  64 588],796,5,8440,4.071394114809455,40.0,0.0
2073,0,2073,[496 121 125 655 195],450,4,8444,4.071359691417551,20.0,0.0
2074,0,2074,[186 234 111  70 132],786,4,8448,4.071325301204819,0.0,0.0
2075,0,2075,[318  98  79  64 588],577,5,8453,4.071772639691715,40.0,0.0
2076,0,2076,[  1  82 182  15  12],256,5,8458,4.07221954742417,0.0,0.0
2077,0,2077,[318  98  79  64 588],450,5,8463,4.072666025024062,40.0,0.0
2078,0,2078,[ 89 269 318 125 265],796,4,8467,4.072631072631073,20.0,0.0
2079,0,2079,[318  98  79  64 588],18,5,8472,4.073076923076923,40.0,0.0
2080,0,2080,[234 423 202  12 216],577,4,8476,4.0730418068236425,0.0,0.0
2081,0,2081,[318  98  79  64 588],457,5,8481,4.073487031700288,40.0,0.0
2082,0,2082,[318  98  79  64 588],577,5,8486,4.073931829092655,40.0,0.0
2083,0,2083,[228 202 655 200 234],655,1,8487,4.072456813819578,0.0,0.0
2084,0,2084,[318  98  79  64 588],716,5,8492,4.072901678657074,40.0,0.0
2085,0,2085,[211 678 144 151 603],401,3,8495,4.0723873441994245,20.0,0.0
2086,0,2086,[318  98  79  64 588],18,5,8500,4.072831816003833,40.0,0.0
2087,0,2087,[187 176 405 475  82],655,1,8501,4.071360153256705,0.0,0.0
2088,0,2088,[318  98  79  64 588],18,5,8506,4.071804691239827,40.0,0.0
2089,0,2089,[ 15   9 568 322  22],256,5,8511,4.072248803827751,0.0,0.0
2090,0,2090,[588 258  79 174 175],344,4,8515,4.07221425155428,0.0,0.0
2091,0,2091,[318  98  79  64 588],450,5,8520,4.072657743785851,40.0,0.0
2092,0,2092,[153 161 385 328 237],450,5,8525,4.073100812231247,0.0,0.0
2093,0,2093,[ 82 257  96 234 216],655,1,8526,4.07163323782235,0.0,0.0
2094,0,2094,[318  98  79  64 588],796,5,8531,4.072076372315036,40.0,0.0
2095,0,2095,[318  98  79  64 588],457,5,8536,4.072519083969466,40.0,0.0
2096,0,2096,[318 176  89 132 118],450,4,8540,4.072484501669051,20.0,0.0
2097,0,2097,[546 181  64 235 357],344,2,8542,4.071496663489037,20.0,0.0
2098,0,2098,[318  98  79  64 588],18,5,8547,4.071939018580276,40.0,0.0
2099,0,2099,[597 179  50 210  28],457,4,8551,4.0719047619047615,0.0,20.0
2100,0,2100,[191 282  88 195 483],796,5,8556,4.072346501665874,0.0,0.0
2101,0,2101,[318  98  79  64 588],457,5,8561,4.07278782112274,40.0,0.0
2102,0,2102,[318  98  79  64 588],577,5,8566,4.0732287208749405,40.0,0.0
2103,0,2103,[271 185 257  50 204],796,5,8571,4.073669201520913,0.0,20.0
2104,0,2104,[318  98  79  64 588],457,5,8576,4.074109263657958,40.0,0.0
2105,0,2105,[318  98  79  64 588],450,5,8581,4.0745489078822414,40.0,0.0
2106,0,2106,[318  98  79  64 588],18,5,8586,4.074988134788799,40.0,0.0
2107,0,2107,[318  98  79  64 588],457,5,8591,4.075426944971537,40.0,0.0
2108,0,2108,[588 117 186  50 118],457,5,8596,4.075865339023234,0.0,20.0
2109,0,2109,[318  98  79  64 588],457,5,8601,4.076303317535545,40.0,0.0
2110,0,2110,[  1 100 748 197 210],450,4,8605,4.0762671719564185,0.0,20.0
2111,0,2111,[318  98  79  64 588],796,5,8610,4.076704545454546,40.0,0.0
2112,0,2112,[318  98  79  64 588],18,5,8615,4.077141504969238,40.0,0.0
2113,0,2113,[515  50   1 197 301],655,2,8617,4.076158940397351,0.0,20.0
2114,0,2114,[318  98  79  64 588],577,5,8622,4.076595744680851,40.0,0.0
2115,0,2115,[161 202 275 276 196],786,4,8626,4.0765595463138,0.0,20.0
2116,0,2116,[318  98  79  64 588],450,5,8631,4.076995748700992,40.0,0.0
2117,0,2117,[318  98  79  64 588],450,5,8636,4.077431539187913,40.0,0.0
2118,0,2118,[318  98  79  64 588],577,5,8641,4.077866918357716,40.0,0.0
2119,0,2119,[318  98  79  64 588],18,5,8646,4.0783018867924525,40.0,0.0
2120,0,2120,[318  98  79  64 588],716,5,8651,4.078736445073079,40.0,0.0
2121,0,2121,[318  98  79  64 588],457,5,8656,4.079170593779454,40.0,0.0
2122,0,2122,[318  98  79  64 588],716,5,8661,4.079604333490344,40.0,0.0
2123,0,2123,[132 143   8   1  82],23,3,8664,4.0790960451977405,0.0,0.0
2124,0,2124,[318  98  79  64 588],457,5,8669,4.079529411764706,40.0,0.0
2125,0,2125,[318  98  79  64 588],457,5,8674,4.079962370649106,40.0,0.0
2126,0,2126,[318  98  79  64 588],457,5,8679,4.080394922425952,40.0,0.0
2127,0,2127,[318  98  79  64 588],716,5,8684,4.080827067669173,40.0,0.0
2128,0,2128,[181  56 118  98 405],450,4,8688,4.080789102865195,0.0,0.0
2129,0,2129,[318  98  79  64 588],18,5,8693,4.081220657276996,40.0,0.0
2130,0,2130,[179 161 118 216 257],504,3,8696,4.080713280150165,0.0,0.0
2131,0,2131,[318  98  79  64 588],450,5,8701,4.081144465290807,40.0,0.0
2132,0,2132,[ 11 427 187 211 143],269,3,8704,4.080637599624941,20.0,0.0
2133,0,2133,[ 88 238 195 323 265],796,3,8707,4.080131208997188,0.0,0.0
2134,0,2134,[318  98  79  64 588],450,5,8712,4.08056206088993,40.0,0.0
2135,0,2135,[597 100  25 300 546],450,4,8716,4.080524344569288,0.0,20.0
2136,0,2136,[568  22  97 471 183],655,1,8717,4.079082826392138,0.0,0.0
2137,0,2137,[ 69 151 195 222 215],457,5,8722,4.079513564078578,0.0,0.0
2138,0,2138,[ 88  97 302 121 144],401,3,8725,4.0790088826554465,0.0,0.0
2139,0,2139,[748 182 187 258 202],796,5,8730,4.079439252336448,0.0,0.0
2140,0,2140,[318  98  79  64 588],796,5,8735,4.079869219990659,40.0,0.0
2141,0,2141,[597 300   1 546 471],450,5,8740,4.080298786181139,0.0,0.0
2142,0,2142,[318  98  79  64 588],716,5,8745,4.080727951469902,40.0,0.0
2143,0,2143,[318  98  79  64 588],450,5,8750,4.081156716417911,40.0,0.0
2144,0,2144,[235 191  28 100 546],457,3,8753,4.080652680652681,0.0,20.0
2145,0,2145,[276  12 196  64  50],344,5,8758,4.081081081081081,20.0,20.0
2146,0,2146,[302 125 173 568 294],450,5,8763,4.081509082440615,0.0,0.0
2147,0,2147,[318  98  79  64 588],716,5,8768,4.081936685288641,40.0,0.0
2148,0,2148,[173 186  95 245   4],796,3,8771,4.0814332247557,0.0,0.0
2149,0,2149,[568 237 405  70 282],457,5,8776,4.081860465116279,0.0,0.0
2150,0,2150,[318  98  79  64 588],457,5,8781,4.0822873082287305,40.0,0.0
2151,0,2151,[318  98  79  64 588],450,5,8786,4.08271375464684,40.0,0.0
2152,0,2152,[318  98  79  64 588],18,5,8791,4.083139804923363,40.0,0.0
2153,0,2153,[185 237 168  70 322],401,2,8793,4.082172701949861,0.0,0.0
2154,0,2154,[197 172  56 318 161],693,2,8795,4.081206496519721,20.0,0.0
2155,0,2155,[237 117  96   7 655],72,3,8798,4.080705009276437,0.0,0.0
2156,0,2156,[302 286 597 132 202],450,5,8803,4.081131200741771,0.0,20.0
2157,0,2157,[185 742 143  22 180],457,5,8808,4.081556997219648,0.0,0.0
2158,0,2158,[318  98  79  64 588],716,5,8813,4.081982399258917,40.0,0.0
2159,0,2159,[403 183  22 181 655],577,5,8818,4.082407407407407,0.0,0.0
2160,0,2160,[318  98  79  64 588],457,5,8823,4.082832022211939,40.0,0.0
2161,0,2161,[318  98  79  64 588],577,5,8828,4.083256244218316,40.0,0.0
2162,0,2162,[318  98  79  64 588],577,5,8833,4.083680073971336,40.0,0.0
2163,0,2163,[ 50 127  88 161 257],457,4,8837,4.083641404805915,0.0,40.0
2164,0,2164,[ 50 117  71 322 275],796,4,8841,4.083602771362586,0.0,40.0
2165,0,2165,[269 168 245 318  71],796,3,8844,4.083102493074792,20.0,0.0
2166,0,2166,[182 678 245 546 597],256,5,8849,4.083525611444393,0.0,0.0
2167,0,2167,[318  98  79  64 588],577,5,8854,4.083948339483395,40.0,0.0
2168,0,2168,[318  98  79  64 588],796,5,8859,4.084370677731673,40.0,0.0
2169,0,2169,[318  98  79  64 588],716,5,8864,4.0847926267281105,40.0,0.0
2170,0,2170,[655 288 143  88  96],693,2,8866,4.083832335329341,0.0,0.0
2171,0,2171,[318  98  79  64 588],457,5,8871,4.084254143646409,40.0,0.0
2172,0,2172,[117 125 132 301 405],344,2,8873,4.083294983893235,0.0,0.0
2173,0,2173,[ 95 200 121 132 161],450,2,8875,4.082336706531739,0.0,0.0
2174,0,2174,[318  98  79  64 588],450,5,8880,4.082758620689655,40.0,0.0
2175,0,2175,[318  98  79  64 588],796,5,8885,4.083180147058823,40.0,0.0
2176,0,2176,[318  98  79  64 588],796,5,8890,4.083601286173633,40.0,0.0
2177,0,2177,[318  98  79  64 588],450,5,8895,4.084022038567493,40.0,0.0
2178,0,2178,[318  98  79  64 588],577,5,8900,4.084442404772831,40.0,0.0
2179,0,2179,[121  50  79 276 228],344,4,8904,4.084403669724771,0.0,20.0
2180,0,2180,[318 385   8 196 228],655,1,8905,4.082989454378725,20.0,0.0
2181,0,2181,[318  71 118 216 294],796,4,8909,4.082951420714941,20.0,0.0
2182,0,2182,[182 195 238  70 191],655,2,8911,4.081997251488777,0.0,0.0
2183,0,2183,[405 194 185 181 174],401,3,8914,4.081501831501831,0.0,0.0
2184,0,2184,[515 222   4 423 238],716,4,8918,4.081464530892449,0.0,0.0
2185,0,2185,[132 100 423  28 655],577,5,8923,4.08188472095151,0.0,20.0
2186,0,2186,[318  98  79  64 588],577,5,8928,4.082304526748971,40.0,0.0
2187,0,2187,[403 275   1  22 175],655,1,8929,4.080895795246801,0.0,20.0
2188,0,2188,[318  98  79  64 588],457,5,8934,4.081315669255368,40.0,0.0
2189,0,2189,[ 95  71 182 127 117],796,5,8939,4.0817351598173515,0.0,20.0
2190,0,2190,[318  98  79  64 588],457,5,8944,4.082154267457782,40.0,0.0
2191,0,2191,[318  98  79  64 588],450,5,8949,4.0825729927007295,40.0,0.0
2192,0,2192,[748 121 196  15 173],798,4,8953,4.082535339717282,0.0,0.0
2193,0,2193,[118 176 234 568  50],655,1,8954,4.081130355515041,0.0,20.0
2194,0,2194,[318  98  79  64 588],577,5,8959,4.081548974943052,40.0,0.0
2195,0,2195,[318  98  79  64 588],577,5,8964,4.081967213114754,40.0,0.0
2196,0,2196,[318  98  79  64 588],577,5,8969,4.082385070550751,40.0,0.0
2197,0,2197,[118  64  70 121 191],457,5,8974,4.082802547770701,20.0,0.0
2198,0,2198,[238 271 100  12 245],796,2,8976,4.081855388813097,0.0,20.0
2199,0,2199,[300 117  69 423  79],807,5,8981,4.082272727272727,0.0,0.0
2200,0,2200,[273 385 153 168 144],796,4,8985,4.082235347569287,0.0,0.0
2201,0,2201,[318  98  79  64 588],18,5,8990,4.082652134423252,40.0,0.0
2202,0,2202,[238 427 496   8 568],389,4,8994,4.082614616432138,40.0,0.0
2203,0,2203,[678 318 143 234 121],504,4,8998,4.082577132486389,20.0,0.0
2204,0,2204,[318  98  79  64 588],796,5,9003,4.0829931972789115,40.0,0.0
2205,0,2205,[196 191 483  22 234],716,5,9008,4.083408884859474,0.0,0.0
2206,0,2206,[176 195 174 168  28],796,4,9012,4.083371091980063,0.0,0.0
2207,0,2207,[318  98  79  64 588],796,5,9017,4.083786231884058,40.0,0.0
2208,0,2208,[318  98  79  64 588],716,5,9022,4.084200995925758,40.0,0.0
2209,0,2209,[318  98  79  64 588],450,5,9027,4.084615384615384,40.0,0.0
2210,0,2210,[ 28  11 143 234 216],457,5,9032,4.085029398462234,0.0,0.0
2211,0,2211,[318  98  79  64 588],796,5,9037,4.0854430379746836,40.0,0.0
2212,0,2212,[318  98  79  64 588],450,5,9042,4.08585630366019,40.0,0.0
2213,0,2213,[318  98  79  64 588],577,5,9047,4.0862691960252935,40.0,0.0
2214,0,2214,[318  98  79  64 588],450,5,9052,4.0866817155756205,40.0,0.0
2215,0,2215,[318  98  79  64 588],577,5,9057,4.087093862815885,40.0,0.0
2216,0,2216,[318  98  79  64 588],18,5,9062,4.087505638249887,40.0,0.0
2217,0,2217,[603 403 125   4 423],796,5,9067,4.087917042380523,20.0,0.0
2218,0,2218,[318  98  79  64 588],450,5,9072,4.0883280757097795,40.0,0.0
2219,0,2219,[318  98  79  64 588],796,5,9077,4.088738738738739,40.0,0.0
2220,0,2220,[ 82 318 185   9 515],655,3,9080,4.088248536695183,20.0,0.0
2221,0,2221,[318  98  79  64 588],716,5,9085,4.088658865886589,40.0,0.0
2222,0,2222,[ 64 144 175 204 275],716,3,9088,4.08816914080072,20.0,20.0
2223,0,2223,[318  98  79  64 588],577,5,9093,4.088579136690647,40.0,0.0
2224,0,2224,[318  98  79  64 588],450,5,9098,4.088988764044943,40.0,0.0
2225,0,2225,[318  98  79  64 588],457,5,9103,4.089398023360287,40.0,0.0
2226,0,2226,[318  98  79  64 588],716,5,9108,4.089806915132465,40.0,0.0
2227,0,2227,[ 98 568 237   8  71],593,4,9112,4.089766606822262,0.0,0.0
2228,0,2228,[318  98  79  64 588],796,5,9117,4.090174966352625,40.0,0.0
2229,0,2229,[508  98 300  56 222],693,2,9119,4.089237668161435,0.0,0.0
2230,0,2230,[318  98  79  64 588],457,5,9124,4.089645898700135,40.0,0.0
2231,0,2231,[328 269 182 423 181],655,1,9125,4.08826164874552,0.0,0.0
2232,0,2232,[318  98  79  64 588],796,5,9130,4.088669950738916,40.0,0.0
2233,0,2233,[127 475 168 427 194],269,5,9135,4.089077887197852,20.0,20.0
2234,0,2234,[ 70  96 195 423 289],655,0,9135,4.087248322147651,0.0,0.0
2235,0,2235,[127   1 275  50 210],389,4,9139,4.087209302325581,0.0,60.0
2236,0,2236,[471 234 257  71 427],389,4,9143,4.0871703173893605,20.0,0.0
2237,0,2237,[318  98  79  64 588],450,5,9148,4.087578194816801,40.0,0.0
2238,0,2238,[176 204   1 318 181],280,2,9150,4.086645824028584,20.0,0.0
2239,0,2239,[265 515 275 200 181],716,5,9155,4.087053571428571,0.0,20.0
2240,0,2240,[318  98  79  64 588],796,5,9160,4.087460954930834,40.0,0.0
2241,0,2241,[195 483 301 603 117],450,4,9164,4.087421944692239,20.0,0.0
2242,0,2242,[ 15 427 258 588 742],796,4,9168,4.087382969237628,20.0,0.0
2243,0,2243,[318  98  79  64 588],457,5,9173,4.087789661319073,40.0,0.0
2244,0,2244,[127 403 200 678 323],280,2,9175,4.086859688195991,0.0,20.0
2245,0,2245,[318  98  79  64 588],716,5,9180,4.08726625111309,40.0,0.0
2246,0,2246,[318  98  79  64 588],716,5,9185,4.087672452158434,40.0,0.0
2247,0,2247,[318  98  79  64 588],577,5,9190,4.088078291814947,40.0,0.0
2248,0,2248,[204 143 183 173 471],716,3,9193,4.087594486438417,0.0,0.0
2249,0,2249,[118 427  64 318  71],577,4,9197,4.087555555555555,60.0,0.0
2250,0,2250,[318  98  79  64 588],18,5,9202,4.087960906263882,40.0,0.0
2251,0,2251,[318  98  79  64 588],796,5,9207,4.088365896980462,40.0,0.0
2252,0,2252,[318  98  79  64 588],796,5,9212,4.088770528184643,40.0,0.0
2253,0,2253,[ 69 258 172  15  50],655,2,9214,4.087843833185448,0.0,20.0
2254,0,2254,[318  98  79  64 588],796,5,9219,4.0882483370288245,40.0,0.0
2255,0,2255,[318  98  79  64 588],577,5,9224,4.088652482269503,40.0,0.0
2256,0,2256,[318  98  79  64 588],796,5,9229,4.089056269384138,40.0,0.0
2257,0,2257,[172 180  96 161 118],457,5,9234,4.089459698848539,0.0,0.0
2258,0,2258,[183   4   1 405 216],344,3,9237,4.088977423638778,0.0,0.0
2259,0,2259,[288 286 117 294 302],733,2,9239,4.088053097345132,0.0,20.0
2260,0,2260,[318  98  79  64 588],457,5,9244,4.088456435205662,40.0,0.0
2261,0,2261,[403 471 483 132 678],807,4,9248,4.08841732979664,0.0,0.0
2262,0,2262,[318  98  79  64 588],716,5,9253,4.08882015024304,40.0,0.0
2263,0,2263,[ 64 427 172 135 405],72,3,9256,4.088339222614841,40.0,0.0
2264,0,2264,[  9 748 161  11 151],256,5,9261,4.088741721854305,0.0,0.0
2265,0,2265,[318  98  79  64 588],796,5,9266,4.089143865842895,40.0,0.0
2266,0,2266,[318  98  79  64 588],716,5,9271,4.089545655050728,40.0,0.0
2267,0,2267,[318  98  79  64 588],716,5,9276,4.08994708994709,40.0,0.0
2268,0,2268,[174  88 121 742 185],796,4,9280,4.089907448215072,0.0,0.0
2269,0,2269,[111   9 195 568 269],655,0,9280,4.0881057268722465,0.0,0.0
2270,0,2270,[318  98  79  64 588],18,5,9285,4.088507265521796,40.0,0.0
2271,0,2271,[ 11  22 176 197 357],716,4,9289,4.088468309859155,0.0,0.0
2272,0,2272,[403 228  12 183 196],577,4,9293,4.088429388473383,0.0,0.0
2273,0,2273,[  1 195  98  88 423],457,5,9298,4.088830255057168,0.0,0.0
2274,0,2274,[ 50 176 118 282 748],280,0,9298,4.087032967032967,0.0,20.0
2275,0,2275,[180  79 603 125 197],18,3,9301,4.086555360281195,20.0,0.0
2276,0,2276,[318  98  79  64 588],457,5,9306,4.086956521739131,40.0,0.0
2277,0,2277,[269 471   9 405 174],344,3,9309,4.086479367866549,0.0,0.0
2278,0,2278,[111 194 265 100 496],450,5,9314,4.086880210618692,20.0,20.0
2279,0,2279,[475 153 176 175 655],269,3,9317,4.08640350877193,0.0,0.0
2280,0,2280,[269 423 237 179  28],639,1,9318,4.085050416483998,0.0,0.0
2281,0,2281,[181 211 153 597 742],593,4,9322,4.085013146362839,0.0,0.0
2282,0,2282,[318  98  79  64 588],18,5,9327,4.085413929040736,40.0,0.0
2283,0,2283,[318  98  79  64 588],577,5,9332,4.085814360770578,40.0,0.0
2284,0,2284,[318  98  79  64 588],716,5,9337,4.086214442013129,40.0,0.0
2285,0,2285,[318  98  79  64 588],716,5,9342,4.086614173228346,40.0,0.0
2286,0,2286,[174 176  82 132 282],280,1,9343,4.085264538696983,0.0,0.0
2287,0,2287,[ 79 273 135 118 100],655,3,9346,4.08479020979021,0.0,20.0
2288,0,2288,[318  98  79  64 588],450,5,9351,4.08519003931848,40.0,0.0
2289,0,2289,[ 69 234 294 175 181],457,4,9355,4.085152838427947,0.0,0.0
2290,0,2290,[127 100 427 174 211],796,3,9358,4.084679179397643,20.0,40.0
2291,0,2291,[ 97 357 435   8 200],655,2,9360,4.0837696335078535,0.0,0.0
2292,0,2292,[318  98  79  64 588],457,5,9365,4.084169210641082,40.0,0.0
2293,0,2293,[318  98  79  64 588],577,5,9370,4.084568439407149,40.0,0.0
2294,0,2294,[318  98  79  64 588],457,5,9375,4.084967320261438,40.0,0.0
2295,0,2295,[234 483 318 100 427],18,4,9379,4.08493031358885,40.0,20.0
2296,0,2296,[318  98  79  64 588],457,5,9384,4.085328689595124,40.0,0.0
2297,0,2297,[318  98  79  64 588],450,5,9389,4.085726718885987,40.0,0.0
2298,0,2298,[318  98  79  64 588],457,5,9394,4.086124401913875,40.0,0.0
2299,0,2299,[318  98  79  64 588],18,5,9399,4.0865217391304345,40.0,0.0
2300,0,2300,[173 144 603 265 546],796,5,9404,4.086918730986528,20.0,0.0
2301,0,2301,[  9  79 546  89 568],256,5,9409,4.087315377932232,0.0,0.0
2302,0,2302,[318  98  79  64 588],457,5,9414,4.087711680416848,40.0,0.0
2303,0,2303,[258 597 161 483  56],23,3,9417,4.087239583333333,0.0,0.0
2304,0,2304,[121 182 132 183 100],655,2,9419,4.086334056399132,0.0,20.0
2305,0,2305,[496  70 204 228 186],450,4,9423,4.086296617519515,20.0,0.0
2306,0,2306,[318  98  79  64 588],796,5,9428,4.086692674469007,40.0,0.0
2307,0,2307,[ 50 211 195 197  98],450,5,9433,4.087088388214904,0.0,20.0
2308,0,2308,[ 11 143  98  88 182],655,3,9436,4.086617583369424,0.0,0.0
2309,0,2309,[200 385 216  89 202],796,5,9441,4.087012987012987,0.0,0.0
2310,0,2310,[313 496 195  71  82],280,2,9443,4.086109909130247,20.0,0.0
2311,0,2311,[265 301 258 186 385],796,3,9446,4.085640138408304,0.0,0.0
2312,0,2312,[  1 194 127 258 245],450,5,9451,4.086035451794206,0.0,20.0
2313,0,2313,[210 276 235 237 143],457,4,9455,4.08599827139153,0.0,0.0
2314,0,2314,[204 357  96 168 234],796,4,9459,4.085961123110152,0.0,0.0
2315,0,2315,[238 273 127 271 161],655,2,9461,4.085060449050086,0.0,20.0
2316,0,2316,[318  98  79  64 588],796,5,9466,4.085455330168321,40.0,0.0
2317,0,2317,[318  98  79  64 588],716,5,9471,4.085849870578085,40.0,0.0
2318,0,2318,[318  98  79  64 588],796,5,9476,4.086244070720138,40.0,0.0
2319,0,2319,[588 118   4 117 245],344,2,9478,4.085344827586207,0.0,0.0
2320,0,2320,[ 15  22 197 143 357],18,5,9483,4.085738905644119,0.0,0.0
2321,0,2321,[176 202 181  97 318],457,5,9488,4.086132644272179,20.0,0.0
2322,0,2322,[300 289 273 204 181],655,1,9489,4.084804132587172,0.0,0.0
2323,0,2323,[508 483 313 135 258],655,3,9492,4.0843373493975905,0.0,0.0
2324,0,2324,[318  98  79  64 588],450,5,9497,4.084731182795699,40.0,0.0
2325,0,2325,[318  98  79  64 588],18,5,9502,4.085124677558039,40.0,0.0
2326,0,2326,[318  98  79  64 588],796,5,9507,4.085517834121186,40.0,0.0
2327,0,2327,[143 276 186 301  98],655,3,9510,4.085051546391752,0.0,0.0
2328,0,2328,[197 301 174   8  56],655,0,9510,4.083297552597681,0.0,0.0
2329,0,2329,[ 22  82 117 211 183],655,1,9511,4.081974248927039,0.0,0.0
2330,0,2330,[ 96 403 483 196 405],796,5,9516,4.082368082368083,0.0,0.0
2331,0,2331,[318  98  79  64 588],796,5,9521,4.082761578044597,40.0,0.0
2332,0,2332,[322 496  50 300  28],450,5,9526,4.083154736390913,20.0,20.0
2333,0,2333,[ 82 195 135 194 385],716,2,9528,4.082262210796915,0.0,0.0
2334,0,2334,[322 286 234 204 186],786,3,9531,4.081798715203426,0.0,20.0
2335,0,2335,[121 471 300 276 273],518,3,9534,4.0813356164383565,0.0,0.0
2336,0,2336,[144 135   4 282  97],655,1,9535,4.080017115960633,0.0,0.0
2337,0,2337,[403 546 275 742   9],457,4,9539,4.079982891360137,0.0,20.0
2338,0,2338,[546 195 222  89 385],450,4,9543,4.0799486960239415,0.0,0.0
2339,0,2339,[318  98  79  64 588],716,5,9548,4.08034188034188,40.0,0.0
2340,0,2340,[318  98  79  64 588],18,5,9553,4.080734728748398,40.0,0.0
2341,0,2341,[ 28 234  82  98 196],786,4,9557,4.08070025619129,0.0,0.0
2342,0,2342,[603  15 153 195   8],731,2,9559,4.07981220657277,20.0,0.0
2343,0,2343,[234 588 483 197 181],18,3,9562,4.079351535836177,0.0,0.0
2344,0,2344,[172 161 238 313 100],655,2,9564,4.078464818763326,0.0,20.0
2345,0,2345,[318  98  79  64 588],450,5,9569,4.0788576300085255,40.0,0.0
2346,0,2346,[196 435 202 182 204],629,5,9574,4.079250106518961,0.0,0.0
2347,0,2347,[ 95   7 318 111 118],280,4,9578,4.079216354344123,20.0,0.0
2348,0,2348,[181 655 322   1 172],786,4,9582,4.079182630906769,0.0,0.0
2349,0,2349,[385 471 237  11 282],280,2,9584,4.078297872340426,0.0,0.0
2350,0,2350,[183 204 237 111 294],716,4,9588,4.078264568268822,0.0,0.0
2351,0,2351,[318  98  79  64 588],450,5,9593,4.078656462585034,40.0,0.0
2352,0,2352,[318  98  79  64 588],18,5,9598,4.079048023799405,40.0,0.0
2353,0,2353,[196 265 435 176 257],655,0,9598,4.07731520815633,0.0,0.0
2354,0,2354,[318  98  79  64 588],716,5,9603,4.077707006369427,40.0,0.0
2355,0,2355,[588  28 237  12 194],18,2,9605,4.076825127334465,0.0,0.0
2356,0,2356,[405   7  88  98  70],344,2,9607,4.075943996605855,0.0,0.0
2357,0,2357,[318  98  79  64 588],18,5,9612,4.076335877862595,40.0,0.0
2358,0,2358,[276  98 483 173   7],280,4,9616,4.076303518440017,0.0,0.0
2359,0,2359,[ 15 125  98 172 173],796,5,9621,4.0766949152542376,0.0,0.0
2360,0,2360,[427 195 111 403 423],18,2,9623,4.0758153324862345,20.0,0.0
2361,0,2361,[182 496  50 385  96],280,3,9626,4.075359864521592,20.0,20.0
2362,0,2362,[ 28 143 202 125 117],796,4,9630,4.075327972915785,0.0,0.0
2363,0,2363,[318  98  79  64 588],450,5,9635,4.075719120135364,40.0,0.0
2364,0,2364,[216 183  79 678 245],344,3,9638,4.075264270613108,0.0,0.0
2365,0,2365,[318  98  79  64 588],18,5,9643,4.075655114116652,40.0,0.0
2366,0,2366,[318  98  79  64 588],18,5,9648,4.076045627376426,40.0,0.0
2367,0,2367,[194  79 100 222 405],151,3,9651,4.075591216216216,0.0,20.0
2368,0,2368,[186 176 215 302  15],655,1,9652,4.074292950612072,0.0,0.0
2369,0,2369,[ 64 275   1  11 405],457,5,9657,4.074683544303798,20.0,20.0
2370,0,2370,[318  98  79  64 588],18,5,9662,4.075073808519612,40.0,0.0
2371,0,2371,[427 357 176 294 121],796,4,9666,4.075042158516021,20.0,0.0
2372,0,2372,[288 568 234 385   1],593,3,9669,4.0745891276864725,0.0,0.0
2373,0,2373,[318  98  79  64 588],18,5,9674,4.074978938500421,40.0,0.0
2374,0,2374,[ 96 168 118 515 153],716,3,9677,4.074526315789473,0.0,0.0
2375,0,2375,[318  98  79  64 588],577,5,9682,4.074915824915825,40.0,0.0
2376,0,2376,[318  98  79  64 588],18,5,9687,4.075305006310475,40.0,0.0
2377,0,2377,[318  98  79  64 588],450,5,9692,4.075693860386879,40.0,0.0
2378,0,2378,[318  82  56 742 276],280,4,9696,4.075662042875158,20.0,0.0
2379,0,2379,[318  98  79  64 588],796,5,9701,4.076050420168067,40.0,0.0
2380,0,2380,[318  98  79  64 588],457,5,9706,4.076438471230575,40.0,0.0
2381,0,2381,[135   9 182 118 127],655,3,9709,4.075986565910999,0.0,20.0
2382,0,2382,[318  98  79  64 588],450,5,9714,4.076374318086446,40.0,0.0
2383,0,2383,[173 172 300 185 153],389,2,9716,4.075503355704698,0.0,0.0
2384,0,2384,[318  98  79  64 588],716,5,9721,4.075890985324947,40.0,0.0
2385,0,2385,[318  98  79  64 588],577,5,9726,4.076278290025146,40.0,0.0
2386,0,2386,[318  98  79  64 588],577,5,9731,4.076665270213657,40.0,0.0
2387,0,2387,[427 234 655 546 328],796,3,9734,4.076214405360134,20.0,0.0
2388,0,2388,[318  98  79  64 588],577,5,9739,4.076601088321474,40.0,0.0
2389,0,2389,[318  98  79  64 588],450,5,9744,4.076987447698745,40.0,0.0
2390,0,2390,[ 11 118 423 286 194],450,4,9748,4.0769552488498535,0.0,20.0
2391,0,2391,[318  98  79  64 588],457,5,9753,4.077341137123746,40.0,0.0
2392,0,2392,[318  98  79  64 588],18,5,9758,4.07772670288341,40.0,0.0
2393,0,2393,[318  98  79  64 588],796,5,9763,4.078111946532999,40.0,0.0
2394,0,2394,[318  98  79  64 588],796,5,9768,4.078496868475992,40.0,0.0
2395,0,2395,[318  98  79  64 588],577,5,9773,4.078881469115192,40.0,0.0
2396,0,2396,[318  98  79  64 588],457,5,9778,4.079265748852732,40.0,0.0
2397,0,2397,[318  98  79  64 588],796,5,9783,4.079649708090075,40.0,0.0
2398,0,2398,[318  98  79  64 588],577,5,9788,4.080033347228012,40.0,0.0
2399,0,2399,[318  98  79  64 588],450,5,9793,4.080416666666666,40.0,0.0
2400,0,2400,[200 100 210 161 258],457,5,9798,4.080799666805498,0.0,20.0
2401,0,2401,[265 100 215  15 322],796,3,9801,4.080349708576186,0.0,20.0
2402,0,2402,[176  15  79 125  97],151,4,9805,4.080316271327507,0.0,0.0
2403,0,2403,[ 50 271 483 173 210],796,4,9809,4.080282861896839,0.0,20.0
2404,0,2404,[125  15 151 186  69],18,2,9811,4.079417879417879,0.0,0.0
2405,0,2405,[318  98  79  64 588],716,5,9816,4.079800498753118,40.0,0.0
2406,0,2406,[234 182 322 210 276],256,4,9820,4.079767345243041,0.0,0.0
2407,0,2407,[ 88 200 197 294 127],716,5,9825,4.08014950166113,0.0,20.0
2408,0,2408,[318  98  79  64 588],577,5,9830,4.080531340805313,40.0,0.0
2409,0,2409,[ 50 181 174 300  82],885,3,9833,4.080082987551867,0.0,20.0
2410,0,2410,[318  98  79  64 588],450,5,9838,4.080464537536292,40.0,0.0
2411,0,2411,[318  98  79  64 588],716,5,9843,4.080845771144278,40.0,0.0
2412,0,2412,[182 181  56  69 216],796,5,9848,4.081226688769167,0.0,0.0
2413,0,2413,[118 174 185 215 121],450,3,9851,4.080778790389395,0.0,0.0
2414,0,2414,[318  98  79  64 588],450,5,9856,4.081159420289855,40.0,0.0
2415,0,2415,[117 423 235  15 546],457,3,9859,4.080711920529802,0.0,0.0
2416,0,2416,[318  98  79  64 588],577,5,9864,4.081092263136119,40.0,0.0
2417,0,2417,[318  98  79  64 588],577,5,9869,4.08147229114971,40.0,0.0
2418,0,2418,[318  98  79  64 588],18,5,9874,4.081852004960727,40.0,0.0
2419,0,2419,[318  98  79  64 588],450,5,9879,4.082231404958677,40.0,0.0
2420,0,2420,[655 302  97 202  11],401,2,9881,4.081371334159439,0.0,0.0
2421,0,2421,[ 97  96 179 678 211],504,4,9885,4.081337737407101,0.0,0.0
2422,0,2422,[318  98  79  64 588],796,5,9890,4.08171687990095,40.0,0.0
2423,0,2423,[  9 180 588 202 210],796,2,9892,4.080858085808581,0.0,0.0
2424,0,2424,[496  82 435 197 238],450,4,9896,4.0808247422680415,20.0,0.0
2425,0,2425,[385  98 194 286 222],450,4,9900,4.080791426215994,0.0,20.0
2426,0,2426,[318  98  79  64 588],716,5,9905,4.081170168932839,40.0,0.0
2427,0,2427,[318  98  79  64 588],577,5,9910,4.08154859967051,40.0,0.0
2428,0,2428,[318  98  79  64 588],457,5,9915,4.0819267188143264,40.0,0.0
2429,0,2429,[257   1 294 333 215],655,0,9915,4.080246913580247,0.0,0.0
2430,0,2430,[318  98  79  64 588],716,5,9920,4.0806252570958454,40.0,0.0
2431,0,2431,[318  98  79  64 588],457,5,9925,4.081003289473684,40.0,0.0
2432,0,2432,[ 64 588 282 182   7],450,5,9930,4.0813810110974105,20.0,0.0
2433,0,2433,[318  98  79  64 588],796,5,9935,4.081758422350041,40.0,0.0
2434,0,2434,[318  98  79  64 588],457,5,9940,4.082135523613963,40.0,0.0
2435,0,2435,[318  98  79  64 588],457,5,9945,4.082512315270936,40.0,0.0
2436,0,2436,[257   8 748 118 132],796,5,9950,4.0828887977020925,0.0,0.0
2437,0,2437,[405 204 318 748 237],450,5,9955,4.0832649712879405,20.0,0.0
2438,0,2438,[127 546 181 186 196],716,3,9958,4.082820828208282,0.0,20.0
2439,0,2439,[151 186 257 300 235],716,3,9961,4.0823770491803275,0.0,0.0
2440,0,2440,[318  98  79  64 588],457,5,9966,4.082752970094224,40.0,0.0
2441,0,2441,[121 127 496  71 275],786,4,9970,4.082719082719083,20.0,40.0
2442,0,2442,[318  98  79  64 588],450,5,9975,4.083094555873926,40.0,0.0
2443,0,2443,[258 282 100 405 197],655,0,9975,4.081423895253683,0.0,20.0
2444,0,2444,[423 176 172 135 655],457,5,9980,4.081799591002045,0.0,0.0
2445,0,2445,[318  98  79  64 588],457,5,9985,4.082174979558463,40.0,0.0
2446,0,2446,[318  98  79  64 588],796,5,9990,4.082550061299551,40.0,0.0
2447,0,2447,[318  98  79  64 588],796,5,9995,4.082924836601308,40.0,0.0
2448,0,2448,[318  98  79  64 588],450,5,10000,4.083299305839118,40.0,0.0
2449,0,2449,[318  98  79  64 588],18,5,10005,4.083673469387755,40.0,0.0
2450,0,2450,[318  98  79  64 588],796,5,10010,4.084047327621379,40.0,0.0
2451,0,2451,[186 216 269 385 125],796,3,10013,4.083605220228385,0.0,0.0
2452,0,2452,[ 82 435  71  15 210],18,4,10017,4.083571137382797,0.0,0.0
2453,0,2453,[318  98  79  64 588],450,5,10022,4.083944580277099,40.0,0.0
2454,0,2454,[318  98  79  64 588],18,5,10027,4.0843177189409365,40.0,0.0
2455,0,2455,[318  98  79  64 588],450,5,10032,4.084690553745928,40.0,0.0
2456,0,2456,[ 12  50  56 228 508],693,2,10034,4.083842083842084,0.0,20.0
2457,0,2457,[318  98  79  64 588],18,5,10039,4.084214808787633,40.0,0.0
2458,0,2458,[ 98 245 111 603 588],796,4,10043,4.084180561203741,20.0,0.0
2459,0,2459,[ 64 742 127 435 175],655,2,10045,4.083333333333333,20.0,20.0
2460,0,2460,[258 197 180   4 111],457,4,10049,4.083299471759448,0.0,0.0
2461,0,2461,[234 173 179 168 288],264,5,10054,4.083671811535337,0.0,0.0
2462,0,2462,[318  98  79  64 588],577,5,10059,4.0840438489646775,40.0,0.0
2463,0,2463,[318  98  79  64 588],577,5,10064,4.084415584415584,40.0,0.0
2464,0,2464,[318  98  79  64 588],577,5,10069,4.084787018255578,40.0,0.0
2465,0,2465,[318  98  79  64 588],450,5,10074,4.085158150851582,40.0,0.0
2466,0,2466,[385  50 183  97 200],457,5,10079,4.085528982569923,0.0,20.0
2467,0,2467,[ 12  82 435 211 216],18,4,10083,4.0854943273906,0.0,0.0
2468,0,2468,[ 96 210 405 118 655],72,3,10086,4.085054678007291,0.0,0.0
2469,0,2469,[318  98  79  64 588],796,5,10091,4.085425101214575,40.0,0.0
2470,0,2470,[318  98  79  64 588],796,5,10096,4.085795224605423,40.0,0.0
2471,0,2471,[318  98  79  64 588],796,5,10101,4.086165048543689,40.0,0.0
2472,0,2472,[318  98  79  64 588],450,5,10106,4.08653457339264,40.0,0.0
2473,0,2473,[238  96 111 257 215],716,4,10110,4.0864995957962815,0.0,0.0
2474,0,2474,[211   8  56 132 125],796,4,10114,4.086464646464647,0.0,0.0
2475,0,2475,[318  98  79  64 588],796,5,10119,4.086833602584814,40.0,0.0
2476,0,2476,[200 216 118   1 191],577,3,10122,4.08639483245862,0.0,0.0
2477,0,2477,[318  98  79  64 588],457,5,10127,4.086763518966909,40.0,0.0
2478,0,2478,[318  98  79  64 588],18,5,10132,4.08713190802743,40.0,0.0
2479,0,2479,[318  98  79  64 588],18,5,10137,4.0875,40.0,0.0
2480,0,2480,[318  98  79  64 588],450,5,10142,4.087867795243853,40.0,0.0
2481,0,2481,[318  98  79  64 588],796,5,10147,4.088235294117647,40.0,0.0
2482,0,2482,[202 174  11 357 294],401,3,10150,4.087797019734192,0.0,0.0
2483,0,2483,[318  98  79  64 588],457,5,10155,4.088164251207729,40.0,0.0
2484,0,2484,[195 742   9 403 135],655,1,10156,4.086921529175051,0.0,0.0
2485,0,2485,[318  98  79  64 588],457,5,10161,4.0872888173773125,40.0,0.0
2486,0,2486,[318  98  79  64 588],457,5,10166,4.087655810213108,40.0,0.0
2487,0,2487,[197 100  96 475 276],655,1,10167,4.086414790996785,0.0,20.0
2488,0,2488,[200 182  71 183   9],280,3,10170,4.085978304539976,0.0,0.0
2489,0,2489,[  8 180 302  15 237],269,0,10170,4.0843373493975905,0.0,0.0
2490,0,2490,[597  56 143 173 202],23,2,10172,4.083500602167804,0.0,0.0
2491,0,2491,[ 69  95 121 194 318],796,5,10177,4.083868378812199,20.0,0.0
2492,0,2492,[211 471 132 161  71],807,5,10182,4.084235860409145,0.0,0.0
2493,0,2493,[318  98  79  64 588],457,5,10187,4.084603047313553,40.0,0.0
2494,0,2494,[318  98  79  64 588],796,5,10192,4.08496993987976,40.0,0.0
2495,0,2495,[300  96 186 176 655],450,4,10196,4.084935897435898,0.0,0.0
2496,0,2496,[318  98  79  64 588],18,5,10201,4.085302362835402,40.0,0.0
2497,0,2497,[318  98  79  64 588],457,5,10206,4.085668534827862,40.0,0.0
2498,0,2498,[318  98  79  64 588],457,5,10211,4.086034413765506,40.0,0.0
2499,0,2499,[318  98  79  64 588],577,5,10216,4.0864,40.0,0.0
2500,0,2500,[318  98  79  64 588],716,5,10221,4.086765293882447,40.0,0.0
2501,0,2501,[318  98  79  64 588],457,5,10226,4.087130295763389,40.0,0.0
2502,0,2502,[403 117 135 748 202],450,4,10230,4.087095485417499,0.0,0.0
2503,0,2503,[195 655 300 118 313],450,4,10234,4.0870607028754,0.0,0.0
2504,0,2504,[301   1 300 546 275],15,3,10237,4.086626746506986,0.0,20.0
2505,0,2505,[318  98  79  64 588],796,5,10242,4.086991221069433,40.0,0.0
2506,0,2506,[228 748  89   1 245],796,3,10245,4.086557638611887,0.0,0.0
2507,0,2507,[603 176   7 210 153],655,1,10246,4.085326953748006,20.0,0.0
2508,0,2508,[318  98  79  64 588],457,5,10251,4.085691510561977,40.0,0.0
2509,0,2509,[318  98  79  64 588],457,5,10256,4.08605577689243,40.0,0.0
2510,0,2510,[318  98  79  64 588],457,5,10261,4.08641975308642,40.0,0.0
2511,0,2511,[318  98  79  64 588],18,5,10266,4.086783439490445,40.0,0.0
2512,0,2512,[318  98  79  64 588],457,5,10271,4.087146836450458,40.0,0.0
2513,0,2513,[318  98  79  64 588],796,5,10276,4.087509944311853,40.0,0.0
2514,0,2514,[597  12 228 271 172],796,5,10281,4.087872763419483,0.0,0.0
2515,0,2515,[ 69 125  56  28 168],18,1,10282,4.08664546899841,0.0,0.0
2516,0,2516,[318  98  79  64 588],577,5,10287,4.087008343265793,40.0,0.0
2517,0,2517,[318  98  79  64 588],450,5,10292,4.0873709293089755,40.0,0.0
2518,0,2518,[318  98  79  64 588],450,5,10297,4.087733227471219,40.0,0.0
2519,0,2519,[318  98  79  64 588],18,5,10302,4.088095238095238,40.0,0.0
2520,0,2520,[318  98  79  64 588],450,5,10307,4.088456961523205,40.0,0.0
2521,0,2521,[187 125 496 318 289],786,5,10312,4.088818398096748,40.0,0.0
2522,0,2522,[132 257 127  15 286],389,2,10314,4.087990487514864,0.0,40.0
2523,0,2523,[318  98  79  64 588],716,5,10319,4.088351822503962,40.0,0.0
2524,0,2524,[168 435 405  64 121],450,4,10323,4.088316831683168,20.0,0.0
2525,0,2525,[318  98  79  64 588],450,5,10328,4.08867775138559,40.0,0.0
2526,0,2526,[ 89 427 202 235 125],450,4,10332,4.088642659279778,20.0,0.0
2527,0,2527,[318  98  79  64 588],716,5,10337,4.089003164556962,40.0,0.0
2528,0,2528,[427 215 194  71 302],450,4,10341,4.088967971530249,20.0,0.0
2529,0,2529,[183 172 300 405 301],450,5,10346,4.089328063241107,0.0,0.0
2530,0,2530,[  9 111  97 135 181],151,5,10351,4.089687870406954,0.0,0.0
2531,0,2531,[318  98  79  64 588],577,5,10356,4.090047393364929,40.0,0.0
2532,0,2532,[318  98  79  64 588],457,5,10361,4.090406632451638,40.0,0.0
2533,0,2533,[318  98  79  64 588],716,5,10366,4.0907655880031575,40.0,0.0
2534,0,2534,[318  98  79  64 588],796,5,10371,4.09112426035503,40.0,0.0
2535,0,2535,[182  89 568 186 127],655,3,10374,4.090694006309148,0.0,20.0
2536,0,2536,[194 238 200   8 197],796,3,10377,4.09026409144659,0.0,0.0
2537,0,2537,[318  98  79  64 588],796,5,10382,4.090622537431048,40.0,0.0
2538,0,2538,[197 187 183 405 318],835,4,10386,4.090586845214651,20.0,0.0
2539,0,2539,[  9 258 288  97 313],655,1,10387,4.089370078740157,0.0,0.0
2540,0,2540,[318  98  79  64 588],450,5,10392,4.089728453364817,40.0,0.0
2541,0,2541,[318  98  79  64 588],796,5,10397,4.09008654602675,40.0,0.0
2542,0,2542,[  4  96 173 194  95],577,5,10402,4.090444357058592,0.0,0.0
2543,0,2543,[427 471 200 237  12],577,3,10405,4.09001572327044,20.0,0.0
2544,0,2544,[318  98  79  64 588],450,5,10410,4.090373280943026,40.0,0.0
2545,0,2545,[328 125 313 200 181],450,4,10414,4.0903377847604085,0.0,0.0
2546,0,2546,[265 435 357 132 269],655,1,10415,4.089124460149195,0.0,0.0
2547,0,2547,[127 202 117 135   9],401,1,10416,4.087912087912088,0.0,20.0
2548,0,2548,[318  98  79  64 588],577,5,10421,4.088269909768536,40.0,0.0
2549,0,2549,[  4 194  88 168 127],389,4,10425,4.088235294117647,0.0,20.0
2550,0,2550,[403 132 127 237 546],504,3,10428,4.08780870246962,0.0,20.0
2551,0,2551,[318  98  79  64 588],716,5,10433,4.088166144200627,40.0,0.0
2552,0,2552,[100 194 238   7 288],264,5,10438,4.08852330591461,0.0,20.0
2553,0,2553,[318  98  79  64 588],716,5,10443,4.088880187940486,40.0,0.0
2554,0,2554,[ 79 269  64 216 403],18,4,10447,4.088845401174169,20.0,0.0
2555,0,2555,[175 588 176 265 172],716,3,10450,4.088419405320813,0.0,0.0
2556,0,2556,[318  12 181 427 286],503,3,10453,4.087993742667188,40.0,20.0
2557,0,2557,[318  98  79  64 588],796,5,10458,4.08835027365129,40.0,0.0
2558,0,2558,[546 125 318  98 471],457,4,10462,4.088315748339195,20.0,0.0
2559,0,2559,[318  98  79  64 588],716,5,10467,4.088671875,40.0,0.0
2560,0,2560,[318  98  79  64 588],577,5,10472,4.08902772354549,40.0,0.0
2561,0,2561,[318  98  79  64 588],450,5,10477,4.089383294301327,40.0,0.0
2562,0,2562,[187 211 603 181 186],389,4,10481,4.0893484198205226,20.0,0.0
2563,0,2563,[318  98  79  64 588],457,5,10486,4.089703588143526,40.0,0.0
2564,0,2564,[318  98  79  64 588],796,5,10491,4.090058479532164,40.0,0.0
2565,0,2565,[655  82 216 143  15],174,4,10495,4.090023382696804,0.0,0.0
2566,0,2566,[318  98  79  64 588],450,5,10500,4.090377873003506,40.0,0.0
2567,0,2567,[318  98  79  64 588],18,5,10505,4.090732087227415,40.0,0.0
2568,0,2568,[318  98  79  64 588],457,5,10510,4.09108602569093,40.0,0.0
2569,0,2569,[194 357 423 176 405],716,4,10514,4.091050583657587,0.0,0.0
2570,0,2570,[237   9 172 182 471],72,3,10517,4.090626215480357,0.0,0.0
2571,0,2571,[118 258   1 265  56],655,0,10517,4.089035769828927,0.0,0.0
2572,0,2572,[318  98  79  64 588],796,5,10522,4.089389817333852,40.0,0.0
2573,0,2573,[181 228 204  89  69],786,5,10527,4.089743589743589,0.0,0.0
2574,0,2574,[187 144 182  50 318],796,5,10532,4.09009708737864,20.0,20.0
2575,0,2575,[191 200  88 132  98],450,4,10536,4.090062111801243,0.0,0.0
2576,0,2576,[222   7 301 294 135],655,1,10537,4.088863019014358,0.0,0.0
2577,0,2577,[471 568 186  69  79],655,1,10538,4.08766485647789,0.0,0.0
2578,0,2578,[318  98  79  64 588],18,5,10543,4.088018611865064,40.0,0.0
2579,0,2579,[275 183 215 197 174],457,5,10548,4.088372093023255,0.0,20.0
2580,0,2580,[181 194  79   7 187],535,3,10551,4.087950406819062,0.0,0.0
2581,0,2581,[151 546   7 294 216],23,2,10553,4.087141750580945,0.0,0.0
2582,0,2582,[301 132  79 435 235],450,4,10557,4.087108013937282,0.0,0.0
2583,0,2583,[427 118   9 121 322],151,3,10560,4.086687306501548,20.0,0.0
2584,0,2584,[235 269 496 204 423],450,4,10564,4.0866537717601545,20.0,0.0
2585,0,2585,[318  98  64  79 588],18,5,10569,4.087006960556844,40.0,0.0
2586,0,2586,[333 144 269 202 215],796,4,10573,4.086973328179359,0.0,0.0
2587,0,2587,[318  98  64  79 588],716,5,10578,4.087326120556415,40.0,0.0
2588,0,2588,[ 15  79 496 180 186],450,3,10581,4.086906141367323,20.0,0.0
2589,0,2589,[318  98  64  79 588],577,5,10586,4.087258687258688,40.0,0.0
2590,0,2590,[  4 228 237 597   1],796,4,10590,4.087225009648784,0.0,0.0
2591,0,2591,[318  98  64  79 588],450,5,10595,4.087577160493828,40.0,0.0
2592,0,2592,[ 25 121 385 235 269],450,2,10597,4.086772078673351,0.0,0.0
2593,0,2593,[318  98  64  79 588],450,5,10602,4.087124132613724,40.0,0.0
2594,0,2594,[204 117  56  64 222],236,3,10605,4.086705202312139,20.0,0.0
2595,0,2595,[ 11 118  96 275 168],450,4,10609,4.086671802773497,0.0,20.0
2596,0,2596,[318  98  64  79 588],716,5,10614,4.08702348864074,40.0,0.0
2597,0,2597,[ 15 496 597 483 161],796,5,10619,4.087374903772132,20.0,0.0
2598,0,2598,[318  98  64  79 588],796,5,10624,4.087726048480184,40.0,0.0
2599,0,2599,[318  98  64  79 588],796,5,10629,4.088076923076923,40.0,0.0
2600,0,2600,[318  98  64  79 588],457,5,10634,4.088427527873895,40.0,0.0
2601,0,2601,[318  98  64  79 588],457,5,10639,4.088777863182168,40.0,0.0
2602,0,2602,[318  98  64  79 588],796,5,10644,4.0891279293123315,40.0,0.0
2603,0,2603,[ 15 496 216 385 228],796,5,10649,4.089477726574501,20.0,0.0
2604,0,2604,[318  98  64  79 588],716,5,10654,4.089827255278311,40.0,0.0
2605,0,2605,[185  79   1  11 125],655,2,10656,4.089025326170376,0.0,0.0
2606,0,2606,[318  98  64  79 588],716,5,10661,4.089374760260836,40.0,0.0
2607,0,2607,[ 70  98 153 235 100],330,5,10666,4.089723926380368,0.0,20.0
2608,0,2608,[176  11  70 288 183],450,4,10670,4.089689536220774,0.0,0.0
2609,0,2609,[318  98  64  79 588],796,5,10675,4.090038314176245,40.0,0.0
2610,0,2610,[ 25 215 742  95 300],450,3,10678,4.089620834929146,0.0,0.0
2611,0,2611,[ 64  88 144 168 302],450,5,10683,4.089969372128637,20.0,0.0
2612,0,2612,[318  98  64  79 588],796,5,10688,4.090317642556449,40.0,0.0
2613,0,2613,[496 181 117 174 234],577,4,10692,4.090283091048202,20.0,0.0
2614,0,2614,[333  64 176 191 471],655,2,10694,4.089483747609942,20.0,0.0
2615,0,2615,[318  98  64  79 588],450,5,10699,4.089831804281346,40.0,0.0
2616,0,2616,[318  98  64  79 588],457,5,10704,4.090179594956057,40.0,0.0
2617,0,2617,[204 294 234 265 357],716,5,10709,4.090527119938884,0.0,0.0
2618,0,2618,[318  98  64  79 588],796,5,10714,4.090874379534173,40.0,0.0
2619,0,2619,[318  98  64  79 588],716,5,10719,4.091221374045801,40.0,0.0
2620,0,2620,[197 202  56 200 183],450,4,10723,4.091186570011446,0.0,0.0
2621,0,2621,[328  88 357 300 200],151,3,10726,4.090770404271549,0.0,0.0
2622,0,2622,[100 471 357 234 318],786,4,10730,4.090735798703775,20.0,20.0
2623,0,2623,[318  98  64  79 588],18,5,10735,4.0910823170731705,40.0,0.0
2624,0,2624,[161 423 132 515  70],269,3,10738,4.0906666666666665,0.0,0.0
2625,0,2625,[111  89  71 228 180],786,5,10743,4.091012947448591,0.0,0.0
2626,0,2626,[144  28   4 275 118],450,3,10746,4.0905976398934145,0.0,20.0
2627,0,2627,[318  98  64  79 588],716,5,10751,4.090943683409437,40.0,0.0
2628,0,2628,[318  98  64  79 588],716,5,10756,4.091289463674401,40.0,0.0
2629,0,2629,[275 483 435 121 161],655,2,10758,4.090494296577947,0.0,20.0
2630,0,2630,[318  98  64  79 588],796,5,10763,4.090839984796656,40.0,0.0
2631,0,2631,[318  98  64  79 588],450,5,10768,4.091185410334346,40.0,0.0
2632,0,2632,[568 176 191 161 228],693,1,10769,4.090011393847322,0.0,0.0
2633,0,2633,[318  98  64  79 588],716,5,10774,4.090356871678056,40.0,0.0
2634,0,2634,[318  98  64  79 588],716,5,10779,4.090702087286528,40.0,0.0
2635,0,2635,[318  98  64  79 588],18,5,10784,4.091047040971168,40.0,0.0
2636,0,2636,[318  98  64  79 588],18,5,10789,4.091391733029958,40.0,0.0
2637,0,2637,[318  98  64  79 588],796,5,10794,4.091736163760425,40.0,0.0
2638,0,2638,[237 328  88   9 300],655,0,10794,4.090185676392573,0.0,0.0
2639,0,2639,[318  98  64  79 588],457,5,10799,4.090530303030303,40.0,0.0
2640,0,2640,[508 196 228  12 603],655,1,10800,4.089360090874669,20.0,0.0
2641,0,2641,[318  98  64  79 588],577,5,10805,4.089704769114308,40.0,0.0
2642,0,2642,[100  25 182 186 200],655,2,10807,4.088914112750662,0.0,20.0
2643,0,2643,[196 135 144 748 588],450,4,10811,4.088880484114977,0.0,0.0
2644,0,2644,[318  98  64  79 588],577,5,10816,4.089224952741021,40.0,0.0
2645,0,2645,[ 79  96 200  88 282],457,5,10821,4.0895691609977325,0.0,0.0
2646,0,2646,[318  98  64  79 588],796,5,10826,4.089913109180204,40.0,0.0
2647,0,2647,[318  98  64  79 588],457,5,10831,4.0902567975830815,40.0,0.0
2648,0,2648,[318  98  64  79 588],450,5,10836,4.090600226500566,40.0,0.0
2649,0,2649,[318  98  64  79 588],716,5,10841,4.0909433962264155,40.0,0.0
2650,0,2650,[318  98  64  79 588],577,5,10846,4.091286307053942,40.0,0.0
2651,0,2651,[183  88 357 132  69],786,5,10851,4.091628959276018,0.0,0.0
2652,0,2652,[228 423 546  98  25],151,4,10855,4.091594421409725,0.0,0.0
2653,0,2653,[318  98  64  79 588],457,5,10860,4.091936699321779,40.0,0.0
2654,0,2654,[172 568  70 245  69],450,5,10865,4.092278719397363,0.0,0.0
2655,0,2655,[318  98  64  79 588],716,5,10870,4.092620481927711,40.0,0.0
2656,0,2656,[318  98  64  79 588],716,5,10875,4.092961987203613,40.0,0.0
2657,0,2657,[318  98  64  79 588],716,5,10880,4.0933032355154255,40.0,0.0
2658,0,2658,[318  98  64  79 588],450,5,10885,4.093644227153065,40.0,0.0
2659,0,2659,[ 71 313 403 385 216],450,4,10889,4.093609022556391,0.0,0.0
2660,0,2660,[ 95  15  12 313 597],796,5,10894,4.093949642991356,0.0,0.0
2661,0,2661,[ 98  79  88 265 186],655,2,10896,4.093163035311796,0.0,0.0
2662,0,2662,[385 515  82 135  50],716,3,10899,4.092752534735261,0.0,20.0
2663,0,2663,[ 88 238  50 172 168],151,5,10904,4.093093093093093,0.0,20.0
2664,0,2664,[100  82 483 282 603],655,2,10906,4.092307692307692,20.0,20.0
2665,0,2665,[328 294 111 301 286],450,5,10911,4.09264816204051,0.0,20.0
2666,0,2666,[187  50 216 405 125],655,3,10914,4.092238470191226,0.0,20.0
2667,0,2667,[265 286  50 153 182],629,5,10919,4.092578710644678,0.0,40.0
2668,0,2668,[318  98  64  79 588],796,5,10924,4.0929186961408766,40.0,0.0
2669,0,2669,[318  98  64  79 588],18,5,10929,4.093258426966292,40.0,0.0
2670,0,2670,[ 15 117 121  98 215],152,4,10933,4.093223511793336,0.0,0.0
2671,0,2671,[318  64  98  79 588],18,5,10938,4.093562874251497,40.0,0.0
2672,0,2672,[318  64  98  79 588],457,5,10943,4.093901982790872,40.0,0.0
2673,0,2673,[197 100  71 588 403],756,2,10945,4.093118922961855,0.0,20.0
2674,0,2674,[546 385 322 294 180],280,4,10949,4.0930841121495325,0.0,0.0
2675,0,2675,[318  64  98  79 588],716,5,10954,4.093423019431988,40.0,0.0
2676,0,2676,[318  64  98  79 588],457,5,10959,4.093761673515129,40.0,0.0
2677,0,2677,[257 215 357 132 186],716,4,10963,4.0937266616878265,0.0,0.0
2678,0,2678,[234 135 357 175  82],151,4,10967,4.093691675998507,0.0,0.0
2679,0,2679,[234 210 265 235 118],457,4,10971,4.09365671641791,0.0,0.0
2680,0,2680,[318  64  98  79 588],716,5,10976,4.093994778067885,40.0,0.0
2681,0,2681,[186  28  25  12 183],457,5,10981,4.094332587621178,0.0,0.0
2682,0,2682,[ 97 237 234  25 143],577,3,10984,4.093924711144242,0.0,0.0
2683,0,2683,[318  64  98  79 588],457,5,10989,4.094262295081967,40.0,0.0
2684,0,2684,[318  64  98  79 588],716,5,10994,4.094599627560521,40.0,0.0
2685,0,2685,[318  64  98  79 588],796,5,10999,4.094936708860759,40.0,0.0
2686,0,2686,[318  64  98  79 588],457,5,11004,4.095273539263118,40.0,0.0
2687,0,2687,[471   4 117  88  89],786,5,11009,4.095610119047619,0.0,0.0
2688,0,2688,[ 71 185  50 191 118],450,3,11012,4.0952026775753065,0.0,20.0
2689,0,2689,[318  64  98  79 588],716,5,11017,4.095539033457249,40.0,0.0
2690,0,2690,[405 111 313  22 175],344,2,11019,4.0947603121516165,0.0,0.0
2691,0,2691,[357  28   8 742 237],796,3,11022,4.094353640416047,0.0,0.0
2692,0,2692,[318  64  98  79 588],796,5,11027,4.094689936873375,40.0,0.0
2693,0,2693,[318  64  98  79 588],450,5,11032,4.095025983667409,40.0,0.0
2694,0,2694,[318  64  98  79 588],457,5,11037,4.0953617810760665,40.0,0.0
2695,0,2695,[216  15 515 568  28],655,2,11039,4.0945845697329375,0.0,0.0
2696,0,2696,[318  64  98  79 588],577,5,11044,4.094920281794587,40.0,0.0
2697,0,2697,[181 183 275 118  88],344,2,11046,4.0941438102298,0.0,20.0
2698,0,2698,[173  64 238 168 175],151,5,11051,4.094479436828455,20.0,0.0
2699,0,2699,[153 265 275   8 182],655,2,11053,4.093703703703704,0.0,20.0
2700,0,2700,[318  64  98  79 588],796,5,11058,4.0940392447241765,40.0,0.0
2701,0,2701,[597 403 125 118   8],457,4,11062,4.0940044411547,0.0,0.0
2702,0,2702,[597 200 273 748 238],450,3,11065,4.093599704032556,0.0,0.0
2703,0,2703,[318 181 288  95 328],450,3,11068,4.09319526627219,20.0,0.0
2704,0,2704,[318  64  98  79 588],716,5,11073,4.0935304990757855,40.0,0.0
2705,0,2705,[318  64  98  79 588],716,5,11078,4.093865484109386,40.0,0.0
2706,0,2706,[202 125 176 235 121],450,3,11081,4.093461396379756,0.0,0.0
2707,0,2707,[318  64  98  79 588],450,5,11086,4.093796159527327,40.0,0.0
2708,0,2708,[294 423 176 275 403],457,4,11090,4.093761535622001,0.0,20.0
2709,0,2709,[222 483 496 655 597],450,3,11093,4.093357933579336,20.0,0.0
2710,0,2710,[318  64  98  79 588],450,5,11098,4.093692364441166,40.0,0.0
2711,0,2711,[197 216 210 655 286],639,1,11099,4.092551622418879,0.0,20.0
2712,0,2712,[313 196 132   7 357],344,4,11103,4.092517508293402,0.0,0.0
2713,0,2713,[318  64  98  79 588],457,5,11108,4.092851879145173,40.0,0.0
2714,0,2714,[318  64  98  79 588],18,5,11113,4.0931860036832415,40.0,0.0
2715,0,2715,[215 191 176 100 118],457,5,11118,4.093519882179676,0.0,20.0
2716,0,2716,[318  64  98  79 588],716,5,11123,4.093853514906146,40.0,0.0
2717,0,2717,[318  64  98  79 588],450,5,11128,4.094186902133922,40.0,0.0
2718,0,2718,[197 202  11 117 286],401,2,11130,4.093416697315189,0.0,20.0
2719,0,2719,[508 603 144 197 151],535,4,11134,4.093382352941177,20.0,0.0
2720,0,2720,[318  64  98  79 588],457,5,11139,4.093715545755237,40.0,0.0
2721,0,2721,[228 275  95 237 180],796,4,11143,4.093681116825864,0.0,20.0
2722,0,2722,[318  64  98  79 588],457,5,11148,4.094013955196474,40.0,0.0
2723,0,2723,[ 97 357  79 182 257],796,4,11152,4.093979441997063,0.0,0.0
2724,0,2724,[318  64  98  79 588],577,5,11157,4.094311926605505,40.0,0.0
2725,0,2725,[318  64  98  79 588],796,5,11162,4.094644167278063,40.0,0.0
2726,0,2726,[318  64  98  79 588],450,5,11167,4.094976164283095,40.0,0.0
2727,0,2727,[ 22 118 121 181  97],796,4,11171,4.094941348973607,0.0,0.0
2728,0,2728,[187  25 211 180 471],693,1,11172,4.0938072554049105,0.0,0.0
2729,0,2729,[197 187 318 191  25],18,4,11176,4.093772893772893,20.0,0.0
2730,0,2730,[172  88   1 186 318],716,4,11180,4.0937385573050165,20.0,0.0
2731,0,2731,[318  64  98  79 588],450,5,11185,4.09407027818448,40.0,0.0
2732,0,2732,[176 742 322 143  15],796,3,11188,4.093669959751189,0.0,0.0
2733,0,2733,[294 322 125 174 385],450,5,11193,4.094001463057791,0.0,0.0
2734,0,2734,[276 318 196   4 144],655,2,11195,4.093235831809872,20.0,0.0
2735,0,2735,[318  64  98  79 588],796,5,11200,4.093567251461988,40.0,0.0
2736,0,2736,[ 88  64  69 204 172],716,5,11205,4.093898428936792,20.0,0.0
2737,0,2737,[ 22  70  89 200 603],450,4,11209,4.093864134404675,20.0,0.0
2738,0,2738,[318  64  98  79 588],577,5,11214,4.094194961664841,40.0,0.0
2739,0,2739,[215 228  22   7  50],457,5,11219,4.094525547445255,0.0,20.0
2740,0,2740,[318  64  98  79 588],716,5,11224,4.094855892010215,40.0,0.0
2741,0,2741,[318  64  98  79 588],796,5,11229,4.095185995623632,40.0,0.0
2742,0,2742,[318  64  98  79 588],577,5,11234,4.095515858549034,40.0,0.0
2743,0,2743,[318  64  98  79 588],457,5,11239,4.095845481049563,40.0,0.0
2744,0,2744,[318  64  98  79 588],716,5,11244,4.096174863387978,40.0,0.0
2745,0,2745,[318  64  98  79 588],716,5,11249,4.096504005826657,40.0,0.0
2746,0,2746,[318  64  98  79 588],577,5,11254,4.096832908627594,40.0,0.0
2747,0,2747,[288   8 405 423 588],457,5,11259,4.097161572052402,0.0,0.0
2748,0,2748,[176 168 328  96 144],450,5,11264,4.097489996362314,0.0,0.0
2749,0,2749,[257  79 423  50  98],796,5,11269,4.097818181818182,0.0,20.0
2750,0,2750,[276 181 202 568 143],457,5,11274,4.0981461286804794,0.0,0.0
2751,0,2751,[318  64  98  79 588],577,5,11279,4.098473837209302,40.0,0.0
2752,0,2752,[318  64  98  79 588],457,5,11284,4.098801307664366,40.0,0.0
2753,0,2753,[318  64  98  79 588],18,5,11289,4.099128540305011,40.0,0.0
2754,0,2754,[318  64  98  79 588],450,5,11294,4.0994555353902,40.0,0.0
2755,0,2755,[471   9 357  89 318],457,5,11299,4.09978229317852,20.0,0.0
2756,0,2756,[194 202 195 423 183],796,5,11304,4.100108813928183,0.0,0.0
2757,0,2757,[655 258 597 174 143],450,5,11309,4.1004350978970265,0.0,0.0
2758,0,2758,[ 56  96 183 742 748],450,5,11314,4.100761145342515,0.0,0.0
2759,0,2759,[318  64  98  79 588],796,5,11319,4.101086956521739,40.0,0.0
2760,0,2760,[318  64  98  79 588],796,5,11324,4.101412531691416,40.0,0.0
2761,0,2761,[176   4 357 181 222],716,3,11327,4.101013758146271,0.0,0.0
2762,0,2762,[318  64  98  79 588],716,5,11332,4.101339124140427,40.0,0.0
2763,0,2763,[ 95 181 132 186   1],796,3,11335,4.100940665701882,0.0,0.0
2764,0,2764,[301 195 265  70   4],450,4,11339,4.100904159132007,0.0,0.0
2765,0,2765,[282  64 357 496 322],796,4,11343,4.100867678958785,40.0,0.0
2766,0,2766,[  1 216  15 196 185],389,2,11345,4.100108420672208,0.0,0.0
2767,0,2767,[318  64  98  79 588],457,5,11350,4.10043352601156,40.0,0.0
2768,0,2768,[655 180 111 181 405],796,3,11353,4.100036114120621,0.0,0.0
2769,0,2769,[318  64  98  79 588],18,5,11358,4.100361010830325,40.0,0.0
2770,0,2770,[  7 200 211 228 111],151,4,11362,4.1003247924936845,0.0,0.0
2771,0,2771,[  4 597  50 568 234],450,3,11365,4.09992784992785,0.0,20.0
2772,0,2772,[216 245 228 742 180],450,5,11370,4.100252434186801,0.0,0.0
2773,0,2773,[318  64  98  79 588],796,5,11375,4.100576784426821,40.0,0.0
2774,0,2774,[318  64  98  79 588],450,5,11380,4.100900900900901,40.0,0.0
2775,0,2775,[435 117 182 405 196],450,5,11385,4.101224783861672,0.0,0.0
2776,0,2776,[318  64  98  79 588],796,5,11390,4.101548433561397,40.0,0.0
2777,0,2777,[318  64  98  79 588],18,5,11395,4.10187185025198,40.0,0.0
2778,0,2778,[ 95 202 322 483 318],450,3,11398,4.101475350845628,20.0,0.0
2779,0,2779,[  4 603 196 471  11],450,4,11402,4.101438848920863,20.0,0.0
2780,0,2780,[318  64  98  79 588],457,5,11407,4.101761956130888,40.0,0.0
2781,0,2781,[318  64  98  79 588],577,5,11412,4.102084831056794,40.0,0.0
2782,0,2782,[357 655 185 568 161],269,3,11415,4.101688825008983,0.0,0.0
2783,0,2783,[508 216 135 237 228],655,2,11417,4.100933908045977,0.0,0.0
2784,0,2784,[318  64  98  79 588],450,5,11422,4.101256732495512,40.0,0.0
2785,0,2785,[318  64  98  79 588],577,5,11427,4.101579325197416,40.0,0.0
2786,0,2786,[318  64  98  79 588],716,5,11432,4.101901686401148,40.0,0.0
2787,0,2787,[228  79 483  88 144],450,4,11436,4.1018651362984215,0.0,0.0
2788,0,2788,[161  50 187 237 127],786,5,11441,4.102187163858013,0.0,40.0
2789,0,2789,[222 121 117 300   8],756,3,11444,4.101792114695341,0.0,0.0
2790,0,2790,[185 181 117  98 483],796,5,11449,4.102113937656754,0.0,0.0
2791,0,2791,[318  64  98  79 588],457,5,11454,4.10243553008596,40.0,0.0
2792,0,2792,[318  64  98  79 588],457,5,11459,4.102756892230577,40.0,0.0
2793,0,2793,[318  64  98  79 588],457,5,11464,4.103078024337867,40.0,0.0
2794,0,2794,[318  64  98  79 588],796,5,11469,4.103398926654741,40.0,0.0
2795,0,2795,[ 25 655 204 588 173],716,5,11474,4.1037195994277536,0.0,0.0
2796,0,2796,[318  64  98  79 588],18,5,11479,4.104040042903111,40.0,0.0
2797,0,2797,[  4  12 118 125 194],457,5,11484,4.104360257326662,0.0,0.0
2798,0,2798,[318  64  98  79 588],457,5,11489,4.104680242943909,40.0,0.0
2799,0,2799,[318  64  98  79 588],577,5,11494,4.105,40.0,0.0
2800,0,2800,[318  64  98  79 588],18,5,11499,4.105319528739736,40.0,0.0
2801,0,2801,[186 483  22  98 748],796,4,11503,4.105281941470379,0.0,0.0
2802,0,2802,[318  64  98  79 588],450,5,11508,4.105601141633963,40.0,0.0
2803,0,2803,[318  64  98  79 588],796,5,11513,4.105920114122682,40.0,0.0
2804,0,2804,[ 50  22  64 197 427],716,5,11518,4.106238859180036,40.0,20.0
2805,0,2805,[318  64  98  79 588],18,5,11523,4.10655737704918,40.0,0.0
2806,0,2806,[423 655 176 179  70],504,2,11525,4.105806911293196,0.0,0.0
2807,0,2807,[318  64  98  79 588],577,5,11530,4.106125356125356,40.0,0.0
2808,0,2808,[318  64  98  79 588],18,5,11535,4.106443574225703,40.0,0.0
2809,0,2809,[ 79 483 435  12 546],450,4,11539,4.106405693950178,0.0,0.0
2810,0,2810,[318  64  98  79 588],18,5,11544,4.106723585912487,40.0,0.0
2811,0,2811,[318  64  98  79 588],796,5,11549,4.107041251778094,40.0,0.0
2812,0,2812,[  9  98  12 318 588],18,5,11554,4.107358691788127,20.0,0.0
2813,0,2813,[357 423 588 183 258],23,2,11556,4.106609808102346,0.0,0.0
2814,0,2814,[318  64  98  79 588],450,5,11561,4.106927175843695,40.0,0.0
2815,0,2815,[318  64  98  79 588],450,5,11566,4.107244318181818,40.0,0.0
2816,0,2816,[318  64  98  79 588],18,5,11571,4.107561235356762,40.0,0.0
2817,0,2817,[318  64  98  79 588],450,5,11576,4.107877927608233,40.0,0.0
2818,0,2818,[318  64  98  79 588],716,5,11581,4.108194395175595,40.0,0.0
2819,0,2819,[318  64  98  79 588],450,5,11586,4.108510638297872,40.0,0.0
2820,0,2820,[318  64  98  79 588],716,5,11591,4.108826657213754,40.0,0.0
2821,0,2821,[318  64  98  79 588],18,5,11596,4.109142452161588,40.0,0.0
2822,0,2822,[ 22 182 174 200 302],269,2,11598,4.108395324123273,0.0,0.0
2823,0,2823,[318  64  98  79 588],18,5,11603,4.10871104815864,40.0,0.0
2824,0,2824,[318  64  98  79 588],457,5,11608,4.109026548672566,40.0,0.0
2825,0,2825,[302 435 125 132 289],655,1,11609,4.107926397735315,0.0,0.0
2826,0,2826,[318  64  98  79 588],716,5,11614,4.108241952599929,40.0,0.0
2827,0,2827,[318  64  98  79 588],577,5,11619,4.108557284299859,40.0,0.0
2828,0,2828,[318  64  98  79 588],18,5,11624,4.108872393071757,40.0,0.0
2829,0,2829,[588  95  69 222  70],344,3,11627,4.108480565371025,0.0,0.0
2830,0,2830,[132 234 237 180 173],796,3,11630,4.108089014482515,0.0,0.0
2831,0,2831,[211 143 200 196 742],450,4,11634,4.108050847457627,0.0,0.0
2832,0,2832,[269 322 161  97 471],450,5,11639,4.108365690081186,0.0,0.0
2833,0,2833,[265   4 125  82  15],655,0,11639,4.106916019760057,0.0,0.0
2834,0,2834,[318  64  98  79 588],450,5,11644,4.107231040564374,40.0,0.0
2835,0,2835,[176 423 111 132 125],655,0,11644,4.105782792665726,0.0,0.0
2836,0,2836,[318  64  98  79 588],716,5,11649,4.10609799083539,40.0,0.0
2837,0,2837,[427 197 191 173 135],450,4,11653,4.106060606060606,20.0,0.0
2838,0,2838,[135 186 196 200 603],655,3,11656,4.1056710109193375,20.0,0.0
2839,0,2839,[117 546 483  96 265],796,5,11661,4.105985915492957,0.0,0.0
2840,0,2840,[228 403 423 568  64],655,1,11662,4.10489264343541,20.0,0.0
2841,0,2841,[318  64  98  79 588],716,5,11667,4.105207600281492,40.0,0.0
2842,0,2842,[ 89 678 275 597 196],344,3,11670,4.104818853323954,0.0,20.0
2843,0,2843,[196 427 318 186  97],835,5,11675,4.105133614627285,40.0,0.0
2844,0,2844,[117 173 403 483 181],807,4,11679,4.105096660808436,0.0,0.0
2845,0,2845,[483 282 211  70  15],655,1,11680,4.104005621925509,0.0,0.0
2846,0,2846,[318  64  98  79 588],457,5,11685,4.104320337197049,40.0,0.0
2847,0,2847,[318  64  98  79 588],716,5,11690,4.104634831460674,40.0,0.0
2848,0,2848,[318  64  98  79 588],450,5,11695,4.104949104949105,40.0,0.0
2849,0,2849,[318  64  98  79 588],18,5,11700,4.105263157894737,40.0,0.0
2850,0,2850,[318  64  98  79 588],457,5,11705,4.105576990529639,40.0,0.0
2851,0,2851,[ 12 125 195 161  28],655,0,11705,4.104137447405329,0.0,0.0
2852,0,2852,[318  64  98  79 588],796,5,11710,4.104451454609183,40.0,0.0
2853,0,2853,[318  64  98  79 588],457,5,11715,4.104765241765943,40.0,0.0
2854,0,2854,[318  64  98  79 588],796,5,11720,4.10507880910683,40.0,0.0
2855,0,2855,[211 269  12  56  25],264,5,11725,4.105392156862745,0.0,0.0
2856,0,2856,[435 603  97 271 568],655,1,11726,4.104305215260763,20.0,0.0
2857,0,2857,[ 71 655   1  89 435],450,4,11730,4.1042687193841845,0.0,0.0
2858,0,2858,[318  64  98  79 588],716,5,11735,4.104582021685904,40.0,0.0
2859,0,2859,[222  97 318 471 483],450,3,11738,4.104195804195804,20.0,0.0
2860,0,2860,[318  64  98  79 588],716,5,11743,4.104508912967494,40.0,0.0
2861,0,2861,[318  64  98  79 588],450,5,11748,4.10482180293501,40.0,0.0
2862,0,2862,[588  69 210  70 282],401,2,11750,4.104086622424031,0.0,0.0
2863,0,2863,[127 182 302 202 174],389,5,11755,4.1043994413407825,0.0,20.0
2864,0,2864,[318  64  98  79 588],577,5,11760,4.104712041884817,40.0,0.0
2865,0,2865,[ 96 135 181 121  88],693,2,11762,4.103977669225401,0.0,0.0
2866,0,2866,[318  64  98  79 588],18,5,11767,4.104290198814091,40.0,0.0
2867,0,2867,[597 228  22 289 151],807,5,11772,4.104602510460251,0.0,0.0
2868,0,2868,[  4 197 742 222  28],796,2,11774,4.103868943882886,0.0,0.0
2869,0,2869,[187 216  15  97 546],786,4,11778,4.103832752613241,0.0,0.0
2870,0,2870,[318  64  98  79 588],450,5,11783,4.104144897248346,40.0,0.0
2871,0,2871,[ 82 216  22 186 173],450,3,11786,4.103760445682451,0.0,0.0
2872,0,2872,[121 300 117 405  98],796,5,11791,4.104072398190045,0.0,0.0
2873,0,2873,[235   8  82 313 289],807,4,11795,4.104036186499652,0.0,0.0
2874,0,2874,[174   1 286 294 655],655,0,11795,4.102608695652174,0.0,20.0
2875,0,2875,[508 191 183  98  25],655,3,11798,4.102225312934632,0.0,0.0
2876,0,2876,[318  64  98  79 588],796,5,11803,4.102537365311088,40.0,0.0
2877,0,2877,[ 96 405 174 194 258],457,5,11808,4.102849200833912,0.0,0.0
2878,0,2878,[153  12 144 118 245],796,4,11812,4.102813476901702,0.0,0.0
2879,0,2879,[ 28 257 597 216   4],457,3,11815,4.102430555555555,0.0,0.0
2880,0,2880,[318  64  98  79 588],450,5,11820,4.102742103436307,40.0,0.0
2881,0,2881,[318  64  98  79 588],577,5,11825,4.103053435114504,40.0,0.0
2882,0,2882,[318  64  98  79 588],18,5,11830,4.103364550815123,40.0,0.0
2883,0,2883,[318  64  98  79 588],457,5,11835,4.10367545076283,40.0,0.0
2884,0,2884,[269 125 546 403 210],796,3,11838,4.103292894280763,0.0,0.0
2885,0,2885,[515 210 222  64  28],716,5,11843,4.103603603603603,20.0,0.0
2886,0,2886,[318  64  98  79 588],450,5,11848,4.103914097679252,40.0,0.0
2887,0,2887,[180 179  12 655  98],450,5,11853,4.104224376731302,0.0,0.0
2888,0,2888,[318  64  98  79 588],577,5,11858,4.1045344409830395,40.0,0.0
2889,0,2889,[385  22  15 318 172],450,4,11862,4.104498269896194,20.0,0.0
2890,0,2890,[385 180 168 423 276],457,5,11867,4.1048080249048775,0.0,0.0
2891,0,2891,[357  11 328 179 196],655,2,11869,4.104080221300138,0.0,0.0
2892,0,2892,[235 202  96  50 100],450,4,11873,4.104044244728655,0.0,40.0
2893,0,2893,[181 100 121   1 471],655,0,11873,4.10262612301313,0.0,20.0
2894,0,2894,[318  64  98  79 588],18,5,11878,4.10293609671848,40.0,0.0
2895,0,2895,[153 117 515  71 276],401,2,11880,4.102209944751381,0.0,0.0
2896,0,2896,[318  64  98  79 588],457,5,11885,4.102519848118743,40.0,0.0
2897,0,2897,[318  64  98  79 588],457,5,11890,4.102829537612147,40.0,0.0
2898,0,2898,[176 496 385 228 135],716,2,11892,4.102104173853053,20.0,0.0
2899,0,2899,[ 50   7 180 235 197],280,3,11895,4.1017241379310345,0.0,20.0
2900,0,2900,[125 151  97 202   7],151,5,11900,4.102033781454671,0.0,0.0
2901,0,2901,[ 95  69 181 568 200],280,3,11903,4.1016540317022745,0.0,0.0
2902,0,2902,[294  56  98   7 435],655,1,11904,4.100585601102308,0.0,0.0
2903,0,2903,[318  64  98  79 588],577,5,11909,4.100895316804408,40.0,0.0
2904,0,2904,[318  64  98  79 588],457,5,11914,4.1012048192771084,40.0,0.0
2905,0,2905,[318  64  98  79 588],577,5,11919,4.1015141087405365,40.0,0.0
2906,0,2906,[300 194 405  22 176],11,2,11921,4.10079119367045,0.0,0.0
2907,0,2907,[318  64  98  79 588],716,5,11926,4.101100412654746,40.0,0.0
2908,0,2908,[318  64  98  79 588],457,5,11931,4.101409419044345,40.0,0.0
2909,0,2909,[228  69 588  95 216],330,5,11936,4.101718213058419,0.0,0.0
2910,0,2910,[318  64  98  79 588],18,5,11941,4.102026794915837,40.0,0.0
2911,0,2911,[318  64  98  79 588],716,5,11946,4.102335164835165,40.0,0.0
2912,0,2912,[318  64  98  79 588],716,5,11951,4.102643323034672,40.0,0.0
2913,0,2913,[257 210  71  95 185],330,5,11956,4.102951269732326,0.0,0.0
2914,0,2914,[318  64  98  79 588],577,5,11961,4.103259005145798,40.0,0.0
2915,0,2915,[318  64  98  79 588],716,5,11966,4.103566529492455,40.0,0.0
2916,0,2916,[318  64  98  79 588],457,5,11971,4.103873842989373,40.0,0.0
2917,0,2917,[318  64  98  79 588],716,5,11976,4.104180945853324,40.0,0.0
2918,0,2918,[318  64  98  79 588],796,5,11981,4.104487838300788,40.0,0.0
2919,0,2919,[ 22 172 210 153 403],450,4,11985,4.10445205479452,0.0,0.0
2920,0,2920,[318  64  98  79 588],457,5,11990,4.104758644299897,40.0,0.0
2921,0,2921,[111 127 568   4 515],655,2,11992,4.1040383299110195,0.0,20.0
2922,0,2922,[318  64  98  79 588],577,5,11997,4.1043448511802945,40.0,0.0
2923,0,2923,[603 181 423 238   9],655,1,11998,4.10328317373461,20.0,0.0
2924,0,2924,[318  64  98  79 588],796,5,12003,4.103589743589744,40.0,0.0
2925,0,2925,[435  25 313  98  28],450,4,12007,4.103554340396446,0.0,0.0
2926,0,2926,[318  64  98  79 588],450,5,12012,4.103860608131193,40.0,0.0
2927,0,2927,[318  64  98  79 588],457,5,12017,4.104166666666667,40.0,0.0
2928,0,2928,[318  64  98  79 588],450,5,12022,4.104472516217139,40.0,0.0
2929,0,2929,[318  64  98  79 588],577,5,12027,4.104778156996587,40.0,0.0
2930,0,2930,[187 200 211 173   4],796,4,12031,4.104742408734221,0.0,0.0
2931,0,2931,[318  64  98  79 588],18,5,12036,4.105047748976808,40.0,0.0
2932,0,2932,[318  64  98  79 588],450,5,12041,4.105352881009206,40.0,0.0
2933,0,2933,[427 215 196  56 135],18,2,12043,4.104635310156783,20.0,0.0
2934,0,2934,[176  12  70 117 268],344,2,12045,4.103918228279387,0.0,0.0
2935,0,2935,[318  64  98  79 588],716,5,12050,4.104223433242507,40.0,0.0
2936,0,2936,[318  64  98  79 588],796,5,12055,4.104528430371127,40.0,0.0
2937,0,2937,[403 276 100 257 168],457,4,12059,4.104492852280463,0.0,20.0
2938,0,2938,[ 70 172 182 276   1],280,3,12062,4.104117046614495,0.0,0.0
2939,0,2939,[318  64  98  79 588],18,5,12067,4.104421768707483,40.0,0.0
2940,0,2940,[318  64  98  79 588],796,5,12072,4.104726283577015,40.0,0.0
2941,0,2941,[200 204 471 357  79],655,3,12075,4.104350781781101,0.0,0.0
2942,0,2942,[196 323 204 153 222],23,2,12077,4.103635745837581,0.0,0.0
2943,0,2943,[318  64  98  79 588],18,5,12082,4.103940217391305,40.0,0.0
2944,0,2944,[318  64  98  79 588],18,5,12087,4.104244482173175,40.0,0.0
2945,0,2945,[118  28 204 238 300],389,3,12090,4.103869653767821,0.0,0.0
2946,0,2946,[237 318 197 496 216],280,3,12093,4.10349507974211,40.0,0.0
2947,0,2947,[ 28 174  96 176 202],23,2,12095,4.102781546811397,0.0,0.0
2948,0,2948,[127 655  88 282 168],504,4,12099,4.102746693794507,0.0,20.0
2949,0,2949,[ 64 185 132 121 179],655,3,12102,4.102372881355932,20.0,0.0
2950,0,2950,[318  64  98  79 588],457,5,12107,4.102677058624195,40.0,0.0
2951,0,2951,[ 12 276   4 471 273],655,2,12109,4.101964769647696,0.0,0.0
2952,0,2952,[318  64  98  79 588],796,5,12114,4.102268879105994,40.0,0.0
2953,0,2953,[111 182 237 202 195],18,1,12115,4.101218686526743,0.0,0.0
2954,0,2954,[318  64  98  79 588],796,5,12120,4.101522842639594,40.0,0.0
2955,0,2955,[318  64  98  79 588],796,5,12125,4.101826792963464,40.0,0.0
2956,0,2956,[318  64  98  79 588],450,5,12130,4.1021305377071355,40.0,0.0
2957,0,2957,[318  64  98  79 588],577,5,12135,4.102434077079107,40.0,0.0
2958,0,2958,[318  64  98  79 588],716,5,12140,4.102737411287597,40.0,0.0
2959,0,2959,[318  64  98  79 588],577,5,12145,4.10304054054054,40.0,0.0
2960,0,2960,[318  64  98  79 588],796,5,12150,4.103343465045593,40.0,0.0
2961,0,2961,[238 568 194  98 183],457,5,12155,4.1036461850101285,0.0,0.0
2962,0,2962,[318  64  98  79 588],457,5,12160,4.103948700641242,40.0,0.0
2963,0,2963,[200   4  69 153  64],716,4,12164,4.10391363022942,20.0,0.0
2964,0,2964,[202  64 216 185 269],796,4,12168,4.103878583473862,20.0,0.0
2965,0,2965,[318  64  98  79 588],457,5,12173,4.104180714767363,40.0,0.0
2966,0,2966,[318  64  98  79 588],457,5,12178,4.104482642399731,40.0,0.0
2967,0,2967,[655 180 427  98 423],716,4,12182,4.1044474393531,20.0,0.0
2968,0,2968,[318  64  98  79 588],716,5,12187,4.10474907376221,40.0,0.0
2969,0,2969,[216 385 328 100 588],450,5,12192,4.105050505050505,0.0,20.0
2970,0,2970,[318  64  98  79 588],457,5,12197,4.10535173342309,40.0,0.0
2971,0,2971,[194 742 210 186 322],796,1,12198,4.104306864064603,0.0,0.0
2972,0,2972,[318  64  98  79 588],18,5,12203,4.104608139926,40.0,0.0
2973,0,2973,[318 211 276 175 289],655,2,12205,4.10390047074647,20.0,0.0
2974,0,2974,[318  64  98  79 588],577,5,12210,4.1042016806722685,40.0,0.0
2975,0,2975,[318  64  98  79 588],796,5,12215,4.104502688172043,40.0,0.0
2976,0,2976,[318  64  98  79 588],796,5,12220,4.104803493449782,40.0,0.0
2977,0,2977,[318  64  98  79 588],716,5,12225,4.1051040967092005,40.0,0.0
2978,0,2978,[318  64  98  79 588],716,5,12230,4.105404498153743,40.0,0.0
2979,0,2979,[318  64  98  79 588],457,5,12235,4.105704697986577,40.0,0.0
2980,0,2980,[ 50 197 181 210 427],450,4,12239,4.105669238510567,20.0,20.0
2981,0,2981,[318  64  98  79 588],450,5,12244,4.10596914822267,40.0,0.0
2982,0,2982,[318  64  98  79 588],18,5,12249,4.106268856855515,40.0,0.0
2983,0,2983,[318  64  98  79 588],796,5,12254,4.10656836461126,40.0,0.0
2984,0,2984,[ 69  11 268 496 211],269,3,12257,4.106197654941374,20.0,0.0
2985,0,2985,[222  22 194  15 197],796,4,12261,4.106162089752177,0.0,0.0
2986,0,2986,[318  64  98  79 588],796,5,12266,4.106461332440576,40.0,0.0
2987,0,2987,[174  79 200 423  11],457,5,12271,4.106760374832664,0.0,0.0
2988,0,2988,[210 483 204   9  12],151,5,12276,4.107059217129475,0.0,0.0
2989,0,2989,[ 15 172 323 742  11],20,3,12279,4.106688963210702,0.0,0.0
2990,0,2990,[318  64  98  79 588],716,5,12284,4.1069876295553325,40.0,0.0
2991,0,2991,[ 96 183 196 187 195],504,3,12287,4.106617647058823,0.0,0.0
2992,0,2992,[318  64  98  79 588],450,5,12292,4.106916137654527,40.0,0.0
2993,0,2993,[318  64  98  79 588],716,5,12297,4.1072144288577155,40.0,0.0
2994,0,2994,[318  64  98  79 588],577,5,12302,4.107512520868114,40.0,0.0
2995,0,2995,[318  64  98  79 588],18,5,12307,4.10781041388518,40.0,0.0
2996,0,2996,[ 88 302 245 181 143],450,5,12312,4.108108108108108,0.0,0.0
2997,0,2997,[ 70 427   7 237  79],655,2,12314,4.107404936624416,20.0,0.0
2998,0,2998,[328   7  69 194 151],450,5,12319,4.107702567522508,0.0,0.0
2999,0,2999,[318  64  98  79 588],577,5,12324,4.108,40.0,0.0
3000,0,3000,[318  64  98  79 588],577,5,12329,4.108297234255248,40.0,0.0
3001,0,3001,[318  64  98  79 588],716,5,12334,4.108594270486343,40.0,0.0
3002,0,3002,[318  64  98  79 588],796,5,12339,4.108891108891109,40.0,0.0
3003,0,3003,[318  64  98  79 588],457,5,12344,4.10918774966711,40.0,0.0
3004,0,3004,[318  64  98  79 588],796,5,12349,4.109484193011648,40.0,0.0
3005,0,3005,[318  64  98  79 588],577,5,12354,4.1097804391217565,40.0,0.0
3006,0,3006,[172 237 568 132 515],655,2,12356,4.109078816095777,0.0,0.0
3007,0,3007,[183  98 200 546  88],593,4,12360,4.10904255319149,0.0,0.0
3008,0,3008,[222  82 151  64 161],457,5,12365,4.109338650714523,20.0,0.0
3009,0,3009,[318  64  98  79 588],716,5,12370,4.1096345514950166,40.0,0.0
3010,0,3010,[161 471 168  22  88],450,5,12375,4.109930255728994,0.0,0.0
3011,0,3011,[318  64  98  79 588],796,5,12380,4.110225763612218,40.0,0.0
3012,0,3012,[318  64  98  79 588],457,5,12385,4.110521075340192,40.0,0.0
3013,0,3013,[182 568   4 423  12],450,4,12389,4.1104844061048444,0.0,0.0
3014,0,3014,[318  64  98  79 588],796,5,12394,4.110779436152571,40.0,0.0
3015,0,3015,[ 22 196 179 202 508],655,1,12395,4.10974801061008,0.0,0.0
3016,0,3016,[318  64  98  79 588],716,5,12400,4.110043089161419,40.0,0.0
3017,0,3017,[ 22   1 161 172  70],280,4,12404,4.1100066269052355,0.0,0.0
3018,0,3018,[211  95 483 275 153],389,3,12407,4.109638953295793,0.0,20.0
3019,0,3019,[ 69 215 238 322   7],450,5,12412,4.109933774834437,0.0,0.0
3020,0,3020,[ 98 187 222 135 282],655,3,12415,4.109566368752069,0.0,0.0
3021,0,3021,[180 176 273 200  89],450,3,12418,4.109199205823957,0.0,0.0
3022,0,3022,[318  64  98  79 588],577,5,12423,4.109493880251406,40.0,0.0
3023,0,3023,[176  50 245 174 161],280,1,12424,4.108465608465608,0.0,20.0
3024,0,3024,[318  64  98  79 588],18,5,12429,4.108760330578512,40.0,0.0
3025,0,3025,[318  64  98  79 588],18,5,12434,4.109054857898215,40.0,0.0
3026,0,3026,[508 216 111 222 286],280,3,12437,4.108688470432772,0.0,20.0
3027,0,3027,[318  64  98  79 588],577,5,12442,4.1089828269484805,40.0,0.0
3028,0,3028,[ 50 215 228 237  22],655,1,12443,4.107956421261142,0.0,20.0
3029,0,3029,[318  64  98  79 588],18,5,12448,4.108250825082508,40.0,0.0
3030,0,3030,[318  64  98  79 588],18,5,12453,4.108545034642033,40.0,0.0
3031,0,3031,[183 121   9 271 196],796,4,12457,4.108509234828496,0.0,0.0
3032,0,3032,[238  69 211   8 196],655,0,12457,4.107154632377184,0.0,0.0
3033,0,3033,[269 185  12 204 655],264,5,12462,4.107448912326961,0.0,0.0
3034,0,3034,[318  64  98  79 588],577,5,12467,4.1077429983525535,40.0,0.0
3035,0,3035,[191 483   1 228 275],716,5,12472,4.108036890645586,0.0,20.0
3036,0,3036,[275 174 153 183 100],655,2,12474,4.107342772472835,0.0,40.0
3037,0,3037,[603 435 172 385  69],716,4,12478,4.107307439104674,20.0,0.0
3038,0,3038,[471  98 546  50 318],457,4,12482,4.107272128989799,20.0,20.0
3039,0,3039,[318  64  98  79 588],577,5,12487,4.107565789473684,40.0,0.0
3040,0,3040,[161 211 204 182  69],593,4,12491,4.107530417625781,0.0,0.0
3041,0,3041,[265  25  79 423 385],577,5,12496,4.107823800131492,0.0,0.0
3042,0,3042,[318  64  98  79 588],796,5,12501,4.108116989812685,40.0,0.0
3043,0,3043,[588  50 195 127   1],344,4,12505,4.108081471747701,0.0,40.0
3044,0,3044,[294   4 191  95 546],450,3,12508,4.107717569786535,0.0,0.0
3045,0,3045,[403 655 195   8  82],269,1,12509,4.106697307944846,0.0,0.0
3046,0,3046,[ 88 228  50 118   9],457,5,12514,4.106990482441746,0.0,20.0
3047,0,3047,[318  64  98  79 588],457,5,12519,4.107283464566929,40.0,0.0
3048,0,3048,[196 289 282 175  25],655,0,12519,4.105936372581174,0.0,0.0
3049,0,3049,[183 172 282 181   8],280,1,12520,4.104918032786885,0.0,0.0
3050,0,3050,[318  64  98  79 588],457,5,12525,4.105211406096362,40.0,0.0
3051,0,3051,[318  64  98  79 588],716,5,12530,4.105504587155964,40.0,0.0
3052,0,3052,[ 64 210  25 328  97],655,1,12531,4.104487389452997,20.0,0.0
3053,0,3053,[568  89   8 597  95],796,5,12536,4.104780615586116,0.0,0.0
3054,0,3054,[318  64  98  79 588],18,5,12541,4.105073649754501,40.0,0.0
3055,0,3055,[276 265  70 405 100],457,5,12546,4.105366492146596,0.0,20.0
3056,0,3056,[204 216 496 568  50],344,5,12551,4.105659142950605,20.0,20.0
3057,0,3057,[318  64  98  79 588],796,5,12556,4.10595160235448,40.0,0.0
3058,0,3058,[318  64  98  79 588],796,5,12561,4.10624387054593,40.0,0.0
3059,0,3059,[318  64  98  79 588],18,5,12566,4.106535947712418,40.0,0.0
3060,0,3060,[238 135 385 172  28],450,4,12570,4.106501143417184,0.0,0.0
3061,0,3061,[318  64  98  79 588],450,5,12575,4.106792945787067,40.0,0.0
3062,0,3062,[318  64  98  79 588],18,5,12580,4.107084557623245,40.0,0.0
3063,0,3063,[180  71 127  82 111],280,4,12584,4.107049608355092,0.0,20.0
3064,0,3064,[318  64  98  79 588],18,5,12589,4.107340946166395,40.0,0.0
3065,0,3065,[318  64  98  79 588],457,5,12594,4.107632093933463,40.0,0.0
3066,0,3066,[121 435 471 197 289],655,0,12594,4.106292794261494,0.0,0.0
3067,0,3067,[318  64  98  79 588],796,5,12599,4.10658409387223,40.0,0.0
3068,0,3068,[318  64  98  79 588],577,5,12604,4.106875203649397,40.0,0.0
3069,0,3069,[603 742 187 100 143],450,5,12609,4.1071661237785015,20.0,20.0
3070,0,3070,[168  64 191  15 237],65,5,12614,4.1074568544448065,20.0,0.0
3071,0,3071,[318  64  98  79 588],716,5,12619,4.107747395833333,40.0,0.0
3072,0,3072,[318  64  98  79 588],716,5,12624,4.108037748128864,40.0,0.0
3073,0,3073,[318  64  98  79 588],450,5,12629,4.10832791151594,40.0,0.0
3074,0,3074,[318  64  98  79 588],716,5,12634,4.108617886178862,40.0,0.0
3075,0,3075,[318  64  98  79 588],577,5,12639,4.10890767230169,40.0,0.0
3076,0,3076,[168  69 186 546 237],450,4,12643,4.108872278193045,0.0,0.0
3077,0,3077,[234  25 125 127 118],450,2,12645,4.108187134502924,0.0,20.0
3078,0,3078,[282  28 168 603 151],716,4,12649,4.1081519974017535,20.0,0.0
3079,0,3079,[  9  82 238  98 655],457,5,12654,4.108441558441559,0.0,0.0
3080,0,3080,[318  64  98  79 588],716,5,12659,4.108730931515741,40.0,0.0
3081,0,3081,[100 323 161 132  79],796,3,12662,4.108371187540558,0.0,20.0
3082,0,3082,[588 174 483  88 211],716,5,12667,4.108660395718456,0.0,0.0
3083,0,3083,[ 15  22 161 210 471],457,5,12672,4.108949416342412,0.0,0.0
3084,0,3084,[318  64  98  79 588],450,5,12677,4.109238249594814,40.0,0.0
3085,0,3085,[318  64  98  79 588],457,5,12682,4.109526895657809,40.0,0.0
3086,0,3086,[318  64  98  79 588],577,5,12687,4.109815354713314,40.0,0.0
3087,0,3087,[322 180  95 127  50],796,3,12690,4.109455958549223,0.0,40.0
3088,0,3088,[318  64  98  79 588],450,5,12695,4.10974425380382,40.0,0.0
3089,0,3089,[318  64  98  79 588],18,5,12700,4.110032362459547,40.0,0.0
3090,0,3090,[318  64  98  79 588],18,5,12705,4.110320284697509,40.0,0.0
3091,0,3091,[ 70  56 100 222  79],280,3,12708,4.109961190168176,0.0,20.0
3092,0,3092,[318  64  98  79 588],18,5,12713,4.11024894924022,40.0,0.0
3093,0,3093,[318  64  98  79 588],457,5,12718,4.110536522301228,40.0,0.0
3094,0,3094,[191 216   7 234 257],23,2,12720,4.109854604200323,0.0,0.0
3095,0,3095,[ 22 135 182 228  28],457,5,12725,4.110142118863049,0.0,0.0
3096,0,3096,[496 132 183 117 153],450,5,12730,4.110429447852761,20.0,0.0
3097,0,3097,[210 127  25 183 228],693,2,12732,4.109748224661072,0.0,20.0
3098,0,3098,[237  64 118 174   1],796,4,12736,4.1097128105840595,20.0,0.0
3099,0,3099,[435 216 191 238  69],65,3,12739,4.109354838709677,0.0,0.0
3100,0,3100,[423 385   1 143  97],593,4,12743,4.109319574330861,0.0,0.0
3101,0,3101,[282  56  12 742 222],256,3,12746,4.108961960025789,0.0,0.0
3102,0,3102,[318  64  98  79 588],716,5,12751,4.109249113760876,40.0,0.0
3103,0,3103,[318  64  98  79 588],450,5,12756,4.109536082474227,40.0,0.0
3104,0,3104,[318  64  98  79 588],457,5,12761,4.109822866344605,40.0,0.0
3105,0,3105,[318  64  98  79 588],457,5,12766,4.110109465550547,40.0,0.0
3106,0,3106,[318 100 132 187 182],503,4,12770,4.110074026392018,20.0,20.0
3107,0,3107,[323 100  22 187 471],256,4,12774,4.11003861003861,0.0,20.0
3108,0,3108,[742 202 496 181  96],450,5,12779,4.110324863300097,20.0,0.0
3109,0,3109,[318  64  98  79 588],577,5,12784,4.110610932475884,40.0,0.0
3110,0,3110,[143 125 257 678 288],504,5,12789,4.110896817743491,0.0,0.0
3111,0,3111,[318  64  98  79 588],577,5,12794,4.111182519280206,40.0,0.0
3112,0,3112,[300 117 172 176  15],450,4,12798,4.111146803726309,0.0,0.0
3113,0,3113,[318  64  98  79 588],796,5,12803,4.111432241490045,40.0,0.0
3114,0,3114,[318 288 228  96 257],457,4,12807,4.11139646869984,20.0,0.0
3115,0,3115,[318  64  98  79 588],577,5,12812,4.111681643132221,40.0,0.0
3116,0,3116,[ 82 301 282 153 100],450,4,12816,4.111645813282002,0.0,20.0
3117,0,3117,[318  64  98  79 588],716,5,12821,4.111930724823605,40.0,0.0
3118,0,3118,[195 286 328  15  64],450,4,12825,4.111894838089131,20.0,20.0
3119,0,3119,[127   1 301 275 172],902,3,12828,4.111538461538461,0.0,40.0
3120,0,3120,[168   8 265 176 125],796,5,12833,4.111823133611022,0.0,0.0
3121,0,3121,[318  64  98  79 588],796,5,12838,4.112107623318385,40.0,0.0
3122,0,3122,[318  64  98  79 588],796,5,12843,4.112391930835735,40.0,0.0
3123,0,3123,[ 12 655 100  95 471],577,4,12847,4.11235595390525,0.0,20.0
3124,0,3124,[ 88  11 568 204  96],457,5,12852,4.11264,0.0,0.0
3125,0,3125,[318  64  98  79 588],796,5,12857,4.112923864363403,40.0,0.0
3126,0,3126,[202 655  98  50 181],796,4,12861,4.112887751838823,0.0,20.0
3127,0,3127,[ 50 210  88 125  11],593,4,12865,4.1128516624040925,0.0,20.0
3128,0,3128,[  1   9 195 191 475],655,1,12866,4.111856823266219,0.0,0.0
3129,0,3129,[ 79 143 151 286 176],236,3,12869,4.111501597444089,0.0,20.0
3130,0,3130,[318  64  98  79 588],796,5,12874,4.1117853720855955,40.0,0.0
3131,0,3131,[318  64  98  79 588],450,5,12879,4.112068965517241,40.0,0.0
3132,0,3132,[111 222 204 546 132],344,4,12883,4.1120331950207465,0.0,0.0
3133,0,3133,[471 144 385  88  56],655,0,12883,4.110721123165284,0.0,0.0
3134,0,3134,[357  82 427 265  64],716,5,12888,4.111004784688995,40.0,0.0
3135,0,3135,[268 678  11 496  69],344,1,12889,4.110012755102041,20.0,0.0
3136,0,3136,[176  96  82 117 183],577,5,12894,4.110296461587504,0.0,0.0
3137,0,3137,[ 50 603 568  28 258],796,4,12898,4.110261312938177,20.0,20.0
3138,0,3138,[161 275 185 180 235],450,4,12902,4.110226186683657,0.0,20.0
3139,0,3139,[318  64  98  79 588],716,5,12907,4.110509554140127,40.0,0.0
3140,0,3140,[211 228 300 132 216],796,4,12911,4.1104743712193565,0.0,0.0
3141,0,3141,[318  64  98  79 588],450,5,12916,4.110757479312539,40.0,0.0
3142,0,3142,[318  64  98  79 588],450,5,12921,4.111040407254216,40.0,0.0
3143,0,3143,[ 71  79 200 234 183],593,4,12925,4.111005089058525,0.0,0.0
3144,0,3144,[318  64  98  79 588],716,5,12930,4.111287758346582,40.0,0.0
3145,0,3145,[318  64  98  79 588],18,5,12935,4.1115702479338845,40.0,0.0
3146,0,3146,[318  64  98  79 588],457,5,12940,4.111852557991738,40.0,0.0
3147,0,3147,[318  64  98  79 588],796,5,12945,4.112134688691232,40.0,0.0
3148,0,3148,[318  64  98  79 588],450,5,12950,4.112416640203239,40.0,0.0
3149,0,3149,[ 82  28 197 357 117],450,4,12954,4.112380952380953,0.0,0.0
3150,0,3150,[235 322 202 748 678],256,3,12957,4.112027927642019,0.0,0.0
3151,0,3151,[357 385  88 275 191],716,4,12961,4.111992385786802,0.0,20.0
3152,0,3152,[216  70  79 186  98],450,4,12965,4.111956866476372,0.0,0.0
3153,0,3153,[357 194 471 196 496],716,4,12969,4.111921369689283,20.0,0.0
3154,0,3154,[475  97 175 238  50],655,1,12970,4.110935023771791,0.0,20.0
3155,0,3155,[228 423 265  22  69],450,5,12975,4.111216730038023,0.0,0.0
3156,0,3156,[318  64  98  79 588],450,5,12980,4.111498257839721,40.0,0.0
3157,0,3157,[ 50   1 118  98 276],344,3,12983,4.111146295123496,0.0,20.0
3158,0,3158,[100 405 127 228 271],796,4,12987,4.111111111111111,0.0,40.0
3159,0,3159,[318  64  98  79 588],450,5,12992,4.111392405063291,40.0,0.0
3160,0,3160,[471 181 210   4  64],389,4,12996,4.1113571654539705,20.0,0.0
3161,0,3161,[282   4  64 357 471],535,2,12998,4.110689437065148,20.0,0.0
3162,0,3162,[318  64  98  79 588],716,5,13003,4.110970597533987,40.0,0.0
3163,0,3163,[508 132  82 182 176],655,1,13004,4.109987357774968,0.0,0.0
3164,0,3164,[357  89 132  56 273],796,4,13008,4.109952606635071,0.0,0.0
3165,0,3165,[318  64  98  79 588],577,5,13013,4.110233733417561,40.0,0.0
3166,0,3166,[235 173 194 742 186],264,4,13017,4.110198926428797,0.0,0.0
3167,0,3167,[132 385 318  70 195],504,4,13021,4.110164141414141,20.0,0.0
3168,0,3168,[127   8 403 182 175],18,4,13025,4.110129378352792,0.0,20.0
3169,0,3169,[200 195 204 423 483],796,5,13030,4.110410094637224,0.0,0.0
3170,0,3170,[ 56 182 202  11 258],629,4,13034,4.11037527593819,0.0,0.0
3171,0,3171,[318  64  98  79 588],450,5,13039,4.110655737704918,40.0,0.0
3172,0,3172,[318  64  98  79 588],18,5,13044,4.110936022691459,40.0,0.0
3173,0,3173,[318  64  98  79 588],796,5,13049,4.111216131064903,40.0,0.0
3174,0,3174,[185 237 403 423   8],457,5,13054,4.111496062992126,0.0,0.0
3175,0,3175,[211  79  22 185  97],18,4,13058,4.111460957178841,0.0,0.0
3176,0,3176,[318  64  98  79 588],796,5,13063,4.111740635819956,40.0,0.0
3177,0,3177,[318  64  98  79 588],716,5,13068,4.112020138451856,40.0,0.0
3178,0,3178,[318  64  98  79 588],577,5,13073,4.112299465240642,40.0,0.0
3179,0,3179,[318  64  98  79 588],457,5,13078,4.112578616352201,40.0,0.0
3180,0,3180,[ 98 182 210  79 194],450,4,13082,4.112543225400818,0.0,0.0
3181,0,3181,[318  64  98  79 588],450,5,13087,4.112822124450031,40.0,0.0
3182,0,3182,[269 200 222 132 258],655,1,13088,4.111844172164624,0.0,0.0
3183,0,3183,[318  64  98  79 588],796,5,13093,4.112123115577889,40.0,0.0
3184,0,3184,[318  64  98  79 588],716,5,13098,4.112401883830455,40.0,0.0
3185,0,3185,[197 216 117  96 187],655,2,13100,4.111738857501569,0.0,0.0
3186,0,3186,[185 328  71 245 216],450,4,13104,4.111703796673988,0.0,0.0
3187,0,3187,[318  64  98  79 588],450,5,13109,4.11198243412798,40.0,0.0
3188,0,3188,[318  64  98  79 588],450,5,13114,4.112260896832863,40.0,0.0
3189,0,3189,[ 28 483 121  69 185],716,5,13119,4.112539184952978,0.0,0.0
3190,0,3190,[318  64  98  79 588],457,5,13124,4.11281729865246,40.0,0.0
3191,0,3191,[318  64  98  79 588],577,5,13129,4.113095238095238,40.0,0.0
3192,0,3192,[318  64  98  79 588],18,5,13134,4.113373003445036,40.0,0.0
3193,0,3193,[301 403  50 132 318],450,5,13139,4.113650594865373,20.0,20.0
3194,0,3194,[318  64  98  79 588],450,5,13144,4.113928012519562,40.0,0.0
3195,0,3195,[194 153 301   7 655],151,4,13148,4.113892365456821,0.0,0.0
3196,0,3196,[483  97 183 216   4],796,4,13152,4.113856740694401,0.0,0.0
3197,0,3197,[357 222  15  97 588],450,3,13155,4.113508442776736,0.0,0.0
3198,0,3198,[  7 385  64 288 275],344,4,13159,4.1134729603000935,20.0,20.0
3199,0,3199,[111 210  69 202 185],716,5,13164,4.11375,0.0,0.0
3200,0,3200,[318  64  98  79 588],457,5,13169,4.114026866604187,40.0,0.0
3201,0,3201,[318  64  98  79 588],457,5,13174,4.114303560274828,40.0,0.0
3202,0,3202,[318  64  98  79 588],450,5,13179,4.1145800811739,40.0,0.0
3203,0,3203,[318  64  98  79 588],716,5,13184,4.114856429463171,40.0,0.0
3204,0,3204,[204 237 168 179 211],269,3,13187,4.114508580343213,0.0,0.0
3205,0,3205,[742   1 258 748 204],450,5,13192,4.114784778540237,0.0,0.0
3206,0,3206,[318  64  98  79 588],796,5,13197,4.115060804490177,40.0,0.0
3207,0,3207,[195 333 286 357 118],796,4,13201,4.1150249376558605,0.0,20.0
3208,0,3208,[125 405 200 603   9],151,3,13204,4.114677469616703,20.0,0.0
3209,0,3209,[318  64  98  79 588],796,5,13209,4.114953271028037,40.0,0.0
3210,0,3210,[289 172 318 200 515],655,4,13213,4.114917471192775,20.0,0.0
3211,0,3211,[318  64  98  79 588],18,5,13218,4.11519302615193,40.0,0.0
3212,0,3212,[318  64  98  79 588],450,5,13223,4.1154684095860565,40.0,0.0
3213,0,3213,[211 403 405 742   1],796,2,13225,4.114810205351587,0.0,0.0
3214,0,3214,[318  64  98  79 588],796,5,13230,4.115085536547434,40.0,0.0
3215,0,3215,[302 597 222  79 179],450,4,13234,4.115049751243781,0.0,0.0
3216,0,3216,[318  64  98  79 588],577,5,13239,4.115324836804477,40.0,0.0
3217,0,3217,[318  64  98  79 588],18,5,13244,4.115599751398384,40.0,0.0
3218,0,3218,[405 179 655 173  97],577,3,13247,4.115253184218702,0.0,0.0
3219,0,3219,[238 496 210 183 588],786,5,13252,4.115527950310559,20.0,0.0
3220,0,3220,[318  64  98  79 588],18,5,13257,4.115802545793232,40.0,0.0
3221,0,3221,[117  71 655   4 742],450,3,13260,4.115456238361267,0.0,0.0
3222,0,3222,[318  64  98  79 588],450,5,13265,4.115730685696556,40.0,0.0
3223,0,3223,[318  64  98  79 588],716,5,13270,4.116004962779156,40.0,0.0
3224,0,3224,[318  64  98  79 588],18,5,13275,4.116279069767442,40.0,0.0
3225,0,3225,[357 210 176 211  50],269,2,13277,4.115623062616243,0.0,20.0
3226,0,3226,[172  70 185 273 121],450,3,13280,4.115277347381469,0.0,0.0
3227,0,3227,[318  64  98  79 588],796,5,13285,4.115551425030979,40.0,0.0
3228,0,3228,[318  64  98  79 588],796,5,13290,4.115825332920409,40.0,0.0
3229,0,3229,[318  64  98  79 588],796,5,13295,4.11609907120743,40.0,0.0
3230,0,3230,[318  64  98  79 588],450,5,13300,4.11637264004952,40.0,0.0
3231,0,3231,[  7 191  97 211 186],450,4,13304,4.116336633663367,0.0,0.0
3232,0,3232,[318  64  98  79 588],716,5,13309,4.1166099597896695,40.0,0.0
3233,0,3233,[318  64  98  79 588],450,5,13314,4.116883116883117,40.0,0.0
3234,0,3234,[ 15 678  50  82  98],20,3,13317,4.116537867078826,0.0,20.0
3235,0,3235,[176 483 185  64 125],796,5,13322,4.116810877626699,20.0,0.0
3236,0,3236,[211 172 168  69 313],450,5,13327,4.117083719493358,0.0,0.0
3237,0,3237,[318  64  79  98 588],450,5,13332,4.117356392835084,40.0,0.0
3238,0,3238,[127 187 194 568 161],389,3,13335,4.1170114232787896,0.0,20.0
3239,0,3239,[215 202 273 234 333],796,3,13338,4.116666666666666,0.0,0.0
3240,0,3240,[318  64  79  98 588],716,5,13343,4.116939216291268,40.0,0.0
3241,0,3241,[318  64  79  98 588],457,5,13348,4.117211597779149,40.0,0.0
3242,0,3242,[301  97  82 211 286],151,4,13352,4.117175454825778,0.0,20.0
3243,0,3243,[496 100 258 435 118],450,4,13356,4.117139334155364,20.0,20.0
3244,0,3244,[186 603 588 197   7],450,4,13360,4.117103235747304,20.0,0.0
3245,0,3245,[200  11 222 423  22],450,3,13363,4.1167590881084415,0.0,0.0
3246,0,3246,[318  64  79  98 588],577,5,13368,4.117031105635972,40.0,0.0
3247,0,3247,[742  79 161 117 181],256,5,13373,4.117302955665025,0.0,0.0
3248,0,3248,[ 79 174 135 228 118],655,2,13375,4.116651277316097,0.0,0.0
3249,0,3249,[318  64  79  98 588],716,5,13380,4.116923076923077,40.0,0.0
3250,0,3250,[318  64  79  98 588],457,5,13385,4.117194709320209,40.0,0.0
3251,0,3251,[318  64  79  98 588],716,5,13390,4.117466174661747,40.0,0.0
3252,0,3252,[318  64  79  98 588],457,5,13395,4.117737473101752,40.0,0.0
3253,0,3253,[ 70 385 211 742 483],450,4,13399,4.117701290719115,0.0,0.0
3254,0,3254,[318  64  79  98 588],577,5,13404,4.117972350230414,40.0,0.0
3255,0,3255,[  9 180 427  56 215],11,3,13407,4.117628992628993,20.0,0.0
3256,0,3256,[318  64  79  98 588],457,5,13412,4.117899907890697,40.0,0.0
3257,0,3257,[318  64  79  98 588],18,5,13417,4.11817065684469,40.0,0.0
3258,0,3258,[204  70  56  82 742],174,4,13421,4.118134397054311,0.0,0.0
3259,0,3259,[318  64  79  98 588],577,5,13426,4.11840490797546,40.0,0.0
3260,0,3260,[173 111   8 655 144],457,4,13430,4.11836859858939,0.0,0.0
3261,0,3261,[318  64  79  98 588],577,5,13435,4.118638871857756,40.0,0.0
3262,0,3262,[318  64  79  98 588],796,5,13440,4.118908979466749,40.0,0.0
3263,0,3263,[318  64  79  98 588],450,5,13445,4.119178921568627,40.0,0.0
3264,0,3264,[  1  12 385 185 210],457,5,13450,4.119448698315467,0.0,0.0
3265,0,3265,[ 25 655  70 423 143],504,4,13454,4.119412124923453,0.0,0.0
3266,0,3266,[318  64  79  98 588],577,5,13459,4.119681665136211,40.0,0.0
3267,0,3267,[318  64  79  98 588],577,5,13464,4.119951040391677,40.0,0.0
3268,0,3268,[318  64  79  98 588],450,5,13469,4.1202202508412356,40.0,0.0
3269,0,3269,[423  95 318 300   7],450,4,13473,4.120183486238532,20.0,0.0
3270,0,3270,[294 216 172 181 117],401,1,13474,4.119229593396515,0.0,0.0
3271,0,3271,[ 70 496 216 483 174],450,4,13478,4.11919315403423,20.0,0.0
3272,0,3272,[195 132 100 289 588],786,5,13483,4.1194622670333025,0.0,20.0
3273,0,3273,[318  64  79  98 588],577,5,13488,4.119731215638363,40.0,0.0
3274,0,3274,[318  64  79  98 588],457,5,13493,4.12,40.0,0.0
3275,0,3275,[161 204 588 294 153],450,5,13498,4.12026862026862,0.0,0.0
3276,0,3276,[ 15 568 483 471   9],457,5,13503,4.120537076594446,0.0,0.0
3277,0,3277,[ 71 210  88   8  95],756,2,13505,4.119890176937157,0.0,0.0
3278,0,3278,[318  64  79  98 588],796,5,13510,4.1201585849344315,40.0,0.0
3279,0,3279,[275 153 197  88  70],716,5,13515,4.120426829268292,0.0,20.0
3280,0,3280,[273 357 174 168 228],450,4,13519,4.120390124961902,0.0,0.0
3281,0,3281,[318  64  79  98 588],18,5,13524,4.120658135283364,40.0,0.0
3282,0,3282,[318  64  79  98 588],450,5,13529,4.120925982333231,40.0,0.0
3283,0,3283,[117   1 191 196 222],796,4,13533,4.120889159561511,0.0,0.0
3284,0,3284,[318  64  79  98 588],796,5,13538,4.121156773211568,40.0,0.0
3285,0,3285,[318  64  79  98 588],457,5,13543,4.121424223980523,40.0,0.0
3286,0,3286,[318  64  79  98 588],577,5,13548,4.121691512017037,40.0,0.0
3287,0,3287,[173 132  88 748 153],280,2,13550,4.121046228710462,0.0,0.0
3288,0,3288,[318  64  79  98 588],716,5,13555,4.121313469139556,40.0,0.0
3289,0,3289,[215 151 172 235  82],457,4,13559,4.121276595744681,0.0,0.0
3290,0,3290,[ 79 202 294 144 257],796,4,13563,4.121239744758432,0.0,0.0
3291,0,3291,[318  64  79  98 588],450,5,13568,4.121506682867557,40.0,0.0
3292,0,3292,[318  64  79  98 588],450,5,13573,4.12177345885211,40.0,0.0
3293,0,3293,[318  64  79  98 588],457,5,13578,4.122040072859745,40.0,0.0
3294,0,3294,[215 172 204 235   4],457,4,13582,4.122003034901366,0.0,0.0
3295,0,3295,[318  64  79  98 588],716,5,13587,4.122269417475728,40.0,0.0
3296,0,3296,[318  64  79  98 588],18,5,13592,4.122535638459206,40.0,0.0
3297,0,3297,[318  64  79  98 588],450,5,13597,4.122801697998787,40.0,0.0
3298,0,3298,[318  64  79  98 588],18,5,13602,4.1230675962412855,40.0,0.0
3299,0,3299,[318  64  79  98 588],796,5,13607,4.123333333333333,40.0,0.0
3300,0,3300,[748  98 174  50 405],450,5,13612,4.123598909421387,0.0,20.0
3301,0,3301,[318  64  79  98 588],18,5,13617,4.123864324651726,40.0,0.0
3302,0,3302,[318  64  79  98 588],716,5,13622,4.124129579170451,40.0,0.0
3303,0,3303,[191 132  69 181 603],389,5,13627,4.124394673123486,20.0,0.0
3304,0,3304,[655  82 333 269 234],796,1,13628,4.1234493192133135,0.0,0.0
3305,0,3305,[318  64  79  98 588],450,5,13633,4.123714458560194,40.0,0.0
3306,0,3306,[318  64  79  98 588],577,5,13638,4.123979437556698,40.0,0.0
3307,0,3307,[318  64  79  98 588],577,5,13643,4.124244256348247,40.0,0.0
3308,0,3308,[318  64  79  98 588],18,5,13648,4.124508915080084,40.0,0.0
3309,0,3309,[286 144 300  71 603],535,2,13650,4.123867069486405,20.0,20.0
3310,0,3310,[318  64  79  98 588],577,5,13655,4.1241316822712175,40.0,0.0
3311,0,3311,[ 95 111  71 471 151],344,3,13658,4.123792270531401,0.0,0.0
3312,0,3312,[ 15 282 483   8 403],796,5,13663,4.124056746151524,0.0,0.0
3313,0,3313,[427 742  15  22 597],11,3,13666,4.123717561858781,20.0,0.0
3314,0,3314,[318  64  79  98 588],18,5,13671,4.123981900452488,40.0,0.0
3315,0,3315,[318  64  79  98 588],18,5,13676,4.124246079613993,40.0,0.0
3316,0,3316,[186 202 173  25 318],151,5,13681,4.124510099487488,20.0,0.0
3317,0,3317,[100 121 125 385 257],457,4,13685,4.124472573839663,0.0,20.0
3318,0,3318,[318  64  79  98 588],577,5,13690,4.124736366375414,40.0,0.0
3319,0,3319,[515 204 181 191 202],18,2,13692,4.124096385542169,0.0,0.0
3320,0,3320,[318  64  79  98 588],716,5,13697,4.124360132490214,40.0,0.0
3321,0,3321,[483  64 215 200 125],18,2,13699,4.123720650210717,20.0,0.0
3322,0,3322,[318  64  79  98 588],450,5,13704,4.123984351489618,40.0,0.0
3323,0,3323,[181 117 174 496 211],716,5,13709,4.1242478941034895,20.0,0.0
3324,0,3324,[318  64  79  98 588],18,5,13714,4.124511278195489,40.0,0.0
3325,0,3325,[318  64  79  98 588],796,5,13719,4.124774503908599,40.0,0.0
3326,0,3326,[318  64  79  98 588],577,5,13724,4.125037571385633,40.0,0.0
3327,0,3327,[100 135 182 204  69],389,4,13728,4.125,0.0,20.0
3328,0,3328,[318  64  79  98 588],796,5,13733,4.1252628416942025,40.0,0.0
3329,0,3329,[318  64  79  98 588],796,5,13738,4.125525525525526,40.0,0.0
3330,0,3330,[318  64  79  98 588],796,5,13743,4.125788051636145,40.0,0.0
3331,0,3331,[ 95 603 427 179  89],18,3,13746,4.125450180072029,40.0,0.0
3332,0,3332,[318  64  79  98 588],457,5,13751,4.125712571257126,40.0,0.0
3333,0,3333,[318  64  79  98 588],796,5,13756,4.125974805038992,40.0,0.0
3334,0,3334,[234 173 496 182 111],269,2,13758,4.1253373313343324,20.0,0.0
3335,0,3335,[ 15 173 318 135 185],457,5,13763,4.125599520383693,20.0,0.0
3336,0,3336,[318  64  79  98 588],457,5,13768,4.125861552292478,40.0,0.0
3337,0,3337,[318  64  79  98 588],18,5,13773,4.126123427201917,40.0,0.0
3338,0,3338,[318  64  79  98 588],577,5,13778,4.12638514525307,40.0,0.0
3339,0,3339,[257 282  22 515 268],655,1,13779,4.1254491017964074,0.0,0.0
3340,0,3340,[318  64  79  98 588],457,5,13784,4.125710865010476,40.0,0.0
3341,0,3341,[ 70 471 301 286 197],450,5,13789,4.125972471573908,0.0,20.0
3342,0,3342,[318  64  79  98 588],18,5,13794,4.126233921627281,40.0,0.0
3343,0,3343,[318  64  79  98 588],457,5,13799,4.126495215311005,40.0,0.0
3344,0,3344,[289 403 300  50 588],807,5,13804,4.126756352765321,0.0,20.0
3345,0,3345,[318  64  79  98 588],577,5,13809,4.127017334130305,40.0,0.0
3346,0,3346,[318  64  79  98 588],577,5,13814,4.127278159545862,40.0,0.0
3347,0,3347,[ 97 185 111 173  56],65,3,13817,4.126941457586619,0.0,0.0
3348,0,3348,[  4 161 125  88 276],457,5,13822,4.127202149895491,0.0,0.0
3349,0,3349,[322  56 194 286 118],450,4,13826,4.1271641791044775,0.0,20.0
3350,0,3350,[318  64  79  98 588],716,5,13831,4.1274246493584,40.0,0.0
3351,0,3351,[187 515  97 435 471],655,2,13833,4.126789976133652,0.0,0.0
3352,0,3352,[318  64  79  98 588],577,5,13838,4.127050402624516,40.0,0.0
3353,0,3353,[318  64  79  98 588],450,5,13843,4.1273106738223015,40.0,0.0
3354,0,3354,[ 12 121  71   4 127],450,2,13845,4.126676602086438,0.0,20.0
3355,0,3355,[228 234 265 275  98],716,5,13850,4.126936829558999,0.0,20.0
3356,0,3356,[318  64  79  98 588],716,5,13855,4.12719690199583,40.0,0.0
3357,0,3357,[318  64  79  98 588],577,5,13860,4.127456819535438,40.0,0.0
3358,0,3358,[318  64  79  98 588],18,5,13865,4.1277165823161655,40.0,0.0
3359,0,3359,[318  64  79  98 588],796,5,13870,4.127976190476191,40.0,0.0
3360,0,3360,[318  64  79  98 588],577,5,13875,4.128235644153526,40.0,0.0
3361,0,3361,[318  64  79  98 588],577,5,13880,4.12849494348602,40.0,0.0
3362,0,3362,[318  64  79  98 588],450,5,13885,4.128754088611359,40.0,0.0
3363,0,3363,[185 121 191 655  22],655,2,13887,4.128121284185493,0.0,0.0
3364,0,3364,[180 405   1   4 357],450,4,13891,4.128083209509659,0.0,0.0
3365,0,3365,[176 475 435 187 127],269,3,13894,4.127748068924539,0.0,20.0
3366,0,3366,[ 97 427 275 211 405],151,4,13898,4.127710127710127,20.0,20.0
3367,0,3367,[100 135 173  97 175],11,4,13902,4.127672209026128,0.0,20.0
3368,0,3368,[318  64  79  98 588],18,5,13907,4.127931136835857,40.0,0.0
3369,0,3369,[318  64  79  98 588],450,5,13912,4.128189910979229,40.0,0.0
3370,0,3370,[ 15 234  56 300 546],151,4,13916,4.128151883714032,0.0,0.0
3371,0,3371,[211  25  79   7 132],655,1,13917,4.127224199288256,0.0,0.0
3372,0,3372,[269 215  64 423   8],18,4,13921,4.127186480877557,20.0,0.0
3373,0,3373,[127 117 357 202 258],796,5,13926,4.127445168938945,0.0,20.0
3374,0,3374,[318  64  79  98 588],450,5,13931,4.127703703703704,40.0,0.0
3375,0,3375,[318  64  79  98 588],577,5,13936,4.127962085308057,40.0,0.0
3376,0,3376,[318  64  79  98 588],457,5,13941,4.128220313888066,40.0,0.0
3377,0,3377,[318  64  79  98 588],457,5,13946,4.128478389579633,40.0,0.0
3378,0,3378,[318  64  79  98 588],457,5,13951,4.128736312518496,40.0,0.0
3379,0,3379,[318  64  79  98 588],18,5,13956,4.1289940828402365,40.0,0.0
3380,0,3380,[269 300 200 268 197],629,4,13960,4.128955930198166,0.0,0.0
3381,0,3381,[318  64  79  98 588],716,5,13965,4.129213483146067,40.0,0.0
3382,0,3382,[282 143 121 176 161],693,2,13967,4.128584096955365,0.0,0.0
3383,0,3383,[318  64  79  98 588],796,5,13972,4.128841607565012,40.0,0.0
3384,0,3384,[196 294 211 180 135],338,3,13975,4.128508124076809,0.0,0.0
3385,0,3385,[275 294  50 269 655],450,5,13980,4.128765505020674,0.0,40.0
3386,0,3386,[173 125 196  71 678],401,1,13981,4.1278417478594625,0.0,0.0
3387,0,3387,[318  64  79  98 588],457,5,13986,4.128099173553719,40.0,0.0
3388,0,3388,[ 88 202 237  70 222],450,4,13990,4.128061375036884,0.0,0.0
3389,0,3389,[318  64  79  98 588],450,5,13995,4.128318584070796,40.0,0.0
3390,0,3390,[125 144 403 269  15],655,0,13995,4.127101150103214,0.0,0.0
3391,0,3391,[318  64  79  98 588],577,5,14000,4.127358490566038,40.0,0.0
3392,0,3392,[318  64  79  98 588],716,5,14005,4.127615679339817,40.0,0.0
3393,0,3393,[117  28  69 238 222],786,5,14010,4.127872716558633,0.0,0.0
3394,0,3394,[111 318 168  50  96],450,5,14015,4.128129602356407,20.0,20.0
3395,0,3395,[318  64  79  98 588],18,5,14020,4.128386336866902,40.0,0.0
3396,0,3396,[318  64  79  98 588],716,5,14025,4.128642920223727,40.0,0.0
3397,0,3397,[181  71 313  28 235],450,3,14028,4.1283107710417895,0.0,0.0
3398,0,3398,[121 202 228 211 111],716,5,14033,4.128567225654605,0.0,0.0
3399,0,3399,[  1  69 191 216 471],716,4,14037,4.128529411764706,0.0,0.0
3400,0,3400,[ 88 301  12 211 302],450,5,14042,4.128785651279036,0.0,0.0
3401,0,3401,[269 117 125 603  22],450,5,14047,4.129041740152851,20.0,0.0
3402,0,3402,[318  64  79  98 588],457,5,14052,4.129297678518954,40.0,0.0
3403,0,3403,[333 748 271 151 117],796,5,14057,4.1295534665099884,0.0,0.0
3404,0,3404,[318  64  79  98 588],716,5,14062,4.1298091042584435,40.0,0.0
3405,0,3405,[173 282 181  64 546],457,4,14066,4.129770992366412,20.0,0.0
3406,0,3406,[ 98 678 118 222 546],280,2,14068,4.129145876137364,0.0,0.0
3407,0,3407,[179   4  82 176 483],389,5,14073,4.129401408450704,0.0,0.0
3408,0,3408,[748 294 186 655 273],450,3,14076,4.129070108536228,0.0,0.0
3409,0,3409,[475 161 515 603 210],269,3,14079,4.1287390029325515,20.0,0.0
3410,0,3410,[125 268 427 288 286],655,1,14080,4.127821753151569,20.0,20.0
3411,0,3411,[318  64  79  98 588],18,5,14085,4.128077373974208,40.0,0.0
3412,0,3412,[100 273 176 427 144],450,4,14089,4.1280398476413716,20.0,20.0
3413,0,3413,[179 568 204  69  88],450,5,14094,4.1282952548330405,0.0,0.0
3414,0,3414,[318  64  79  98 588],457,5,14099,4.128550512445095,40.0,0.0
3415,0,3415,[318  64  79  98 588],716,5,14104,4.128805620608899,40.0,0.0
3416,0,3416,[ 50 258 423 179 215],65,3,14107,4.128475270705297,0.0,20.0
3417,0,3417,[318  64  79  98 588],577,5,14112,4.128730251609128,40.0,0.0
3418,0,3418,[183 215   8 269  79],655,2,14114,4.128107633811056,0.0,0.0
3419,0,3419,[268 269 405 286 237],344,1,14115,4.12719298245614,0.0,20.0
3420,0,3420,[182   8 200 196  79],796,5,14120,4.127448114586378,0.0,0.0
3421,0,3421,[117 276 185 245 300],504,4,14124,4.127410870835768,0.0,0.0
3422,0,3422,[318  64  79  98 588],577,5,14129,4.127665790242477,40.0,0.0
3423,0,3423,[185  97 195 403  69],457,5,14134,4.127920560747664,0.0,0.0
3424,0,3424,[318  64  79  98 588],577,5,14139,4.128175182481752,40.0,0.0
3425,0,3425,[318  64  79  98 588],716,5,14144,4.128429655575014,40.0,0.0
3426,0,3426,[318  64  79  98 588],457,5,14149,4.1286839801575725,40.0,0.0
3427,0,3427,[423 435  98 200 195],236,3,14152,4.128354725787632,0.0,0.0
3428,0,3428,[237 197  11 235 228],330,5,14157,4.1286089238845145,0.0,0.0
3429,0,3429,[204 318 143  95  88],18,3,14160,4.128279883381924,20.0,0.0
3430,0,3430,[210 143 301 257 282],796,3,14163,4.127951034683766,0.0,0.0
3431,0,3431,[318  64  79  98 588],457,5,14168,4.128205128205129,40.0,0.0
3432,0,3432,[228  79 215 173 179],577,3,14171,4.127876492863384,0.0,0.0
3433,0,3433,[ 88 357 237 185  50],457,5,14176,4.128130460104834,0.0,20.0
3434,0,3434,[318  64  79  98 588],716,5,14181,4.128384279475982,40.0,0.0
3435,0,3435,[181 234 235 202 742],450,3,14184,4.128055878928987,0.0,0.0
3436,0,3436,[  8 100  70 405 186],655,0,14184,4.126854815245854,0.0,20.0
3437,0,3437,[ 50  79 179 405 568],885,3,14187,4.12652705061082,0.0,20.0
3438,0,3438,[ 25  79 385 174 357],450,4,14191,4.126490258796162,0.0,0.0
3439,0,3439,[318  64  79  98 588],457,5,14196,4.126744186046512,40.0,0.0
3440,0,3440,[196  50 597 483 385],23,3,14199,4.126416739319965,0.0,20.0
3441,0,3441,[318  64  79  98 588],450,5,14204,4.126670540383498,40.0,0.0
3442,0,3442,[ 25 121 144 269 322],450,3,14207,4.126343305257043,0.0,0.0
3443,0,3443,[144  50 237 174  98],280,1,14208,4.125435540069686,0.0,20.0
3444,0,3444,[318  64  79  98 588],577,5,14213,4.125689404934688,40.0,0.0
3445,0,3445,[742 234 289  79 282],655,1,14214,4.124782356355195,0.0,0.0
3446,0,3446,[318  64  79  98 588],716,5,14219,4.125036263417464,40.0,0.0
3447,0,3447,[318  64  79  98 588],18,5,14224,4.125290023201856,40.0,0.0
3448,0,3448,[174 385 210 196 742],457,5,14229,4.1255436358364745,0.0,0.0
3449,0,3449,[318  64  79  98 588],450,5,14234,4.125797101449275,40.0,0.0
3450,0,3450,[ 97 475 143  69  88],655,1,14235,4.124891335844683,0.0,0.0
3451,0,3451,[318  64  79  98 588],450,5,14240,4.125144843568946,40.0,0.0
3452,0,3452,[318  64  79  98 588],796,5,14245,4.12539820445989,40.0,0.0
3453,0,3453,[ 64 176 748 275 265],450,5,14250,4.125651418645049,20.0,20.0
3454,0,3454,[195 186 313 423 282],450,4,14254,4.12561505065123,0.0,0.0
3455,0,3455,[318  64  79  98 588],577,5,14259,4.125868055555555,40.0,0.0
3456,0,3456,[318  64  79  98 588],457,5,14264,4.126120914087359,40.0,0.0
3457,0,3457,[286 427 100 176 237],655,1,14265,4.1252168883747835,20.0,40.0
3458,0,3458,[200  11   8 195 742],655,1,14266,4.124313385371495,0.0,0.0
3459,0,3459,[318  64  79  98 588],450,5,14271,4.124566473988439,40.0,0.0
3460,0,3460,[135 238 172 496   8],269,3,14274,4.124241548685351,20.0,0.0
3461,0,3461,[215 276 268  79 271],655,2,14276,4.123627960716349,0.0,0.0
3462,0,3462,[318  64  79  98 588],577,5,14281,4.123881028010396,40.0,0.0
3463,0,3463,[  1 742 173  98 135],280,4,14285,4.123845265588915,0.0,0.0
3464,0,3464,[318  64  79  98 588],450,5,14290,4.124098124098124,40.0,0.0
3465,0,3465,[318  64  79  98 588],457,5,14295,4.1243508366993655,40.0,0.0
3466,0,3466,[318  64  79  98 588],457,5,14300,4.1246034035188925,40.0,0.0
3467,0,3467,[318  64  79  98 588],450,5,14305,4.124855824682815,40.0,0.0
3468,0,3468,[318  64  79  98 588],716,5,14310,4.125108100317094,40.0,0.0
3469,0,3469,[318  64  79  98 588],457,5,14315,4.1253602305475505,40.0,0.0
3470,0,3470,[118 100 180  64 182],72,4,14319,4.125324114088159,20.0,20.0
3471,0,3471,[318  64  79  98 588],457,5,14324,4.125576036866359,40.0,0.0
3472,0,3472,[182 322  50 228 143],796,4,14328,4.125539879067089,0.0,20.0
3473,0,3473,[318  64  79  98 588],796,5,14333,4.125791594703512,40.0,0.0
3474,0,3474,[318  64  79  98 588],450,5,14338,4.1260431654676255,40.0,0.0
3475,0,3475,[237 286 196  95 210],18,3,14341,4.125719217491369,0.0,20.0
3476,0,3476,[318  64  79  98 588],450,5,14346,4.125970664365832,40.0,0.0
3477,0,3477,[161  22  97 294 173],450,5,14351,4.126221966647498,0.0,0.0
3478,0,3478,[318  64  79  98 588],450,5,14356,4.126473124461052,40.0,0.0
3479,0,3479,[318  64  79  98 588],716,5,14361,4.126724137931035,40.0,0.0
3480,0,3480,[117 427 200  88 191],796,5,14366,4.126975007181844,20.0,0.0
3481,0,3481,[318  64  79  98 588],18,5,14371,4.127225732337737,40.0,0.0
3482,0,3482,[ 50 265  70 423 216],280,4,14375,4.127189204708585,0.0,20.0
3483,0,3483,[318 125 568 273   7],450,4,14379,4.127152698048221,20.0,0.0
3484,0,3484,[176 288 211 186 655],655,0,14379,4.12596843615495,0.0,0.0
3485,0,3485,[318  64  79  98 588],716,5,14384,4.126219162363741,40.0,0.0
3486,0,3486,[318  64  79  98 588],796,5,14389,4.126469744766275,40.0,0.0
3487,0,3487,[603  98  56 191  79],151,4,14393,4.126433486238532,20.0,0.0
3488,0,3488,[318  64  79  98 588],457,5,14398,4.126683863571224,40.0,0.0
3489,0,3489,[318  64  79  98 588],796,5,14403,4.126934097421204,40.0,0.0
3490,0,3490,[318  64  79  98 588],716,5,14408,4.127184187911773,40.0,0.0
3491,0,3491,[ 11   1 597 117 269],174,3,14411,4.126861397479955,0.0,0.0
3492,0,3492,[318  64  79  98 588],450,5,14416,4.12711136558832,40.0,0.0
3493,0,3493,[183 204 257   8 403],796,5,14421,4.127361190612478,0.0,0.0
3494,0,3494,[318  64  79  98 588],457,5,14426,4.12761087267525,40.0,0.0
3495,0,3495,[ 82  28 427 200 132],796,3,14429,4.127288329519451,20.0,0.0
3496,0,3496,[318  64  79  98 588],577,5,14434,4.127537889619674,40.0,0.0
3497,0,3497,[183  28 179 161  15],577,3,14437,4.127215551743854,0.0,0.0
3498,0,3498,[234 655 603 197 215],151,4,14441,4.1271791940554445,20.0,0.0
3499,0,3499,[318  64  79  98 588],716,5,14446,4.127428571428571,40.0,0.0
3500,0,3500,[318  64  79  98 588],450,5,14451,4.127677806341046,40.0,0.0
3501,0,3501,[318  64  79  98 588],577,5,14456,4.127926898914906,40.0,0.0
3502,0,3502,[318  64  79  98 588],450,5,14461,4.128175849272052,40.0,0.0
3503,0,3503,[237 300 187  25 678],504,3,14464,4.127853881278539,0.0,0.0
3504,0,3504,[313 200  97 181 357],450,4,14468,4.127817403708987,0.0,0.0
3505,0,3505,[405  82 603  70  12],450,4,14472,4.127780946948089,20.0,0.0
3506,0,3506,[318  64  79  98 588],18,5,14477,4.128029654975763,40.0,0.0
3507,0,3507,[318  64  79  98 588],716,5,14482,4.1282782212086655,40.0,0.0
3508,0,3508,[ 82 143 125 276 423],655,2,14484,4.127671701339413,0.0,0.0
3509,0,3509,[318  64  79  98 588],796,5,14489,4.127920227920228,40.0,0.0
3510,0,3510,[318  64  79  98 588],18,5,14494,4.128168612930789,40.0,0.0
3511,0,3511,[318  64  79  98 588],450,5,14499,4.128416856492027,40.0,0.0
3512,0,3512,[318  64  79  98 588],716,5,14504,4.128664958724737,40.0,0.0
3513,0,3513,[265 228  22 300  64],655,1,14505,4.127774615822425,20.0,0.0
3514,0,3514,[  1   8 258 173 191],796,4,14509,4.12773826458037,0.0,0.0
3515,0,3515,[318  64  79  98 588],577,5,14514,4.1279863481228665,40.0,0.0
3516,0,3516,[318  64  79  98 588],18,5,14519,4.12823429058857,40.0,0.0
3517,0,3517,[194   4  88 237 238],504,1,14520,4.127345082433201,0.0,0.0
3518,0,3518,[294 195  98 323  71],23,2,14522,4.126740551292981,0.0,0.0
3519,0,3519,[318  64  79  98 588],18,5,14527,4.126988636363636,40.0,0.0
3520,0,3520,[117 191 186 483 143],450,3,14530,4.126668560068162,0.0,0.0
3521,0,3521,[  1 191 238 132 588],786,5,14535,4.1269165247018735,0.0,0.0
3522,0,3522,[197 202 275 269 300],450,5,14540,4.127164348566563,0.0,20.0
3523,0,3523,[318  64  79  98 588],457,5,14545,4.1274120317820655,40.0,0.0
3524,0,3524,[318  64  79  98 588],716,5,14550,4.127659574468085,40.0,0.0
3525,0,3525,[318  64  79  98 588],577,5,14555,4.127906976744186,40.0,0.0
3526,0,3526,[318  64  79  98 588],716,5,14560,4.128154238729799,40.0,0.0
3527,0,3527,[318 168  70 216 435],716,5,14565,4.128401360544218,20.0,0.0
3528,0,3528,[515 427 132 210 271],655,2,14567,4.127798243128365,20.0,0.0
3529,0,3529,[111   9 175 176 117],344,4,14571,4.127762039660056,0.0,0.0
3530,0,3530,[176 276 323 183 385],280,2,14573,4.127159444916455,0.0,0.0
3531,0,3531,[318  64  79  98 588],18,5,14578,4.127406568516421,40.0,0.0
3532,0,3532,[ 11  71 742 294 191],450,4,14582,4.127370506651571,0.0,0.0
3533,0,3533,[423 187 546  69 286],796,4,14586,4.127334465195246,0.0,20.0
3534,0,3534,[318  64  79  98 588],18,5,14591,4.127581329561528,40.0,0.0
3535,0,3535,[143 471  56 168  96],450,5,14596,4.127828054298643,0.0,0.0
3536,0,3536,[127 176 215 546 655],693,2,14598,4.127226463104326,0.0,20.0
3537,0,3537,[234 235 276 546 228],256,2,14600,4.126625211984172,0.0,0.0
3538,0,3538,[301 313  64 181 172],655,3,14603,4.126306866346425,20.0,0.0
3539,0,3539,[318  64  79  98 588],457,5,14608,4.126553672316384,40.0,0.0
3540,0,3540,[289 271 237 187 403],655,1,14609,4.125670714487433,0.0,0.0
3541,0,3541,[  4  96 275 176 174],457,5,14614,4.125917560700169,0.0,20.0
3542,0,3542,[210 228  11   1 125],344,2,14616,4.1253175275190515,0.0,0.0
3543,0,3543,[ 96 195 588  56 179],450,5,14621,4.125564334085778,0.0,0.0
3544,0,3544,[318  64  79  98 588],577,5,14626,4.125811001410438,40.0,0.0
3545,0,3545,[265 204 182 210  22],280,2,14628,4.125211505922166,0.0,0.0
3546,0,3546,[269  79 202 238 328],655,1,14629,4.124330420073301,0.0,0.0
3547,0,3547,[318  64  79  98 588],18,5,14634,4.124577226606539,40.0,0.0
3548,0,3548,[257 135  69 276 196],457,4,14638,4.124542124542124,0.0,0.0
3549,0,3549,[197 483 132   8 302],269,3,14641,4.124225352112676,0.0,0.0
3550,0,3550,[318  64  79  98 588],450,5,14646,4.124471979724022,40.0,0.0
3551,0,3551,[282 117 135 195 435],655,1,14647,4.123592342342342,0.0,0.0
3552,0,3552,[318  64  79  98 588],18,5,14652,4.123839009287925,40.0,0.0
3553,0,3553,[237 117 245 125 151],256,5,14657,4.124085537422622,0.0,0.0
3554,0,3554,[ 89   4 174 275 185],655,3,14660,4.123769338959212,0.0,20.0
3555,0,3555,[318  64  79  98 588],796,5,14665,4.124015748031496,40.0,0.0
3556,0,3556,[ 25 268 185  97 427],503,5,14670,4.124262018554962,20.0,0.0
3557,0,3557,[173 125  56 245  98],450,5,14675,4.124508150646431,0.0,0.0
3558,0,3558,[508  71 678 288 313],344,2,14677,4.12391121101433,0.0,0.0
3559,0,3559,[318  64  79  98 588],716,5,14682,4.124157303370787,40.0,0.0
3560,0,3560,[318  64  79  98 588],457,5,14687,4.1244032575119345,40.0,0.0
3561,0,3561,[318  64  79  98 588],716,5,14692,4.124649073554183,40.0,0.0
3562,0,3562,[ 98 265 435 258 515],535,2,14694,4.1240527645242775,0.0,0.0
3563,0,3563,[318  64  79  98 588],457,5,14699,4.124298540965207,40.0,0.0
3564,0,3564,[318  64  79  98 588],577,5,14704,4.1245441795231415,40.0,0.0
3565,0,3565,[318  64  79  98 588],577,5,14709,4.124789680314078,40.0,0.0
3566,0,3566,[318  64  79  98 588],577,5,14714,4.125035043453883,40.0,0.0
3567,0,3567,[175 125 194 196 135],18,1,14715,4.124159192825112,0.0,0.0
3568,0,3568,[385 222 483 143   1],796,4,14719,4.124124404595125,0.0,0.0
3569,0,3569,[ 64 100 275 423 385],796,4,14723,4.124089635854341,20.0,40.0
3570,0,3570,[318  64  79  98 588],716,5,14728,4.124334920190423,40.0,0.0
3571,0,3571,[318  64  79  98 588],716,5,14733,4.12458006718925,40.0,0.0
3572,0,3572,[318  64  79  98 588],18,5,14738,4.124825076966135,40.0,0.0
3573,0,3573,[588 125 181 603 275],401,2,14740,4.1242305540011195,20.0,20.0
3574,0,3574,[318  64  79  98 588],577,5,14745,4.124475524475525,40.0,0.0
3575,0,3575,[318  64  79  98 588],796,5,14750,4.124720357941834,40.0,0.0
3576,0,3576,[328 302 135 435  96],655,2,14752,4.124126362873917,0.0,0.0
3577,0,3577,[318  64  79  98 588],716,5,14757,4.124371157070989,40.0,0.0
3578,0,3578,[318  64  79  98 588],457,5,14762,4.124615814473317,40.0,0.0
3579,0,3579,[318  64  79  98 588],796,5,14767,4.124860335195531,40.0,0.0
3580,0,3580,[546 258 515 271 405],807,3,14770,4.124546216140743,0.0,0.0
3581,0,3581,[265 385 185  50 234],450,4,14774,4.124511446119486,0.0,20.0
3582,0,3582,[153 168 294 265 186],716,4,14778,4.124476695506559,0.0,0.0
3583,0,3583,[423 194 568 197 597],796,4,14782,4.124441964285714,0.0,0.0
3584,0,3584,[318  64  79  98 588],716,5,14787,4.124686192468619,40.0,0.0
3585,0,3585,[471 174 132 423  50],457,5,14792,4.124930284439487,0.0,20.0
3586,0,3586,[318  64  79  98 588],457,5,14797,4.125174240312239,40.0,0.0
3587,0,3587,[318  64  79  98 588],577,5,14802,4.125418060200669,40.0,0.0
3588,0,3588,[357 258 588 423 597],450,5,14807,4.125661744218445,0.0,0.0
3589,0,3589,[318  64  79  98 588],457,5,14812,4.125905292479109,40.0,0.0
3590,0,3590,[318  64  79  98 588],18,5,14817,4.126148705096074,40.0,0.0
3591,0,3591,[597 228 655 194 282],450,5,14822,4.1263919821826285,0.0,0.0
3592,0,3592,[313  79 403 496  11],280,3,14825,4.126078485944893,20.0,0.0
3593,0,3593,[483   4 197 328   8],796,4,14829,4.126043405676127,0.0,0.0
3594,0,3594,[318  64  79  98 588],716,5,14834,4.126286509040334,40.0,0.0
3595,0,3595,[318  64  79  98 588],577,5,14839,4.126529477196885,40.0,0.0
3596,0,3596,[318  64  79  98 588],796,5,14844,4.1267723102585485,40.0,0.0
3597,0,3597,[318  64  79  98 588],577,5,14849,4.127015008337966,40.0,0.0
3598,0,3598,[ 11  12 143 210 328],655,1,14850,4.126146151708808,0.0,0.0
3599,0,3599,[318  64  79  98 588],577,5,14855,4.126388888888889,40.0,0.0
3600,0,3600,[318  64  79  98 588],450,5,14860,4.12663149125243,40.0,0.0
3601,0,3601,[318  64  79  98 588],450,5,14865,4.126873958911716,40.0,0.0
3602,0,3602,[ 56 161  97 216  22],450,5,14870,4.127116291978907,0.0,0.0
3603,0,3603,[515 238  70 423 127],655,2,14872,4.126526082130965,0.0,20.0
3604,0,3604,[228  96 742 187 588],450,5,14877,4.126768377253814,0.0,0.0
3605,0,3605,[234  79 483 294 204],23,2,14879,4.126178591236828,0.0,0.0
3606,0,3606,[273 197 568 271 191],655,2,14881,4.125589132242861,0.0,0.0
3607,0,3607,[215  82 204 191 125],450,4,14885,4.125554323725056,0.0,0.0
3608,0,3608,[318  64  79  98 588],457,5,14890,4.125796619562205,40.0,0.0
3609,0,3609,[ 28  22 161 181 222],655,0,14890,4.124653739612189,0.0,0.0
3610,0,3610,[318  64  79  98 588],450,5,14895,4.124896150650789,40.0,0.0
3611,0,3611,[ 89 179  56 181 597],450,5,14900,4.125138427464009,0.0,0.0
3612,0,3612,[318  64  79  98 588],457,5,14905,4.1253805701632995,40.0,0.0
3613,0,3613,[318  64  79  98 588],796,5,14910,4.125622578859989,40.0,0.0
3614,0,3614,[318  64  79  98 588],450,5,14915,4.125864453665284,40.0,0.0
3615,0,3615,[603 196 174 191 173],23,3,14918,4.125553097345133,20.0,0.0
3616,0,3616,[196 385  28  69 234],796,3,14921,4.1252419131877245,0.0,0.0
3617,0,3617,[318  64  79  98 588],796,5,14926,4.1254836926478715,40.0,0.0
3618,0,3618,[ 89  88 515 125 385],655,2,14928,4.124896380215529,0.0,0.0
3619,0,3619,[318  64  79  98 588],577,5,14933,4.125138121546962,40.0,0.0
3620,0,3620,[174 276 175  82 186],655,1,14934,4.1242750621375315,0.0,0.0
3621,0,3621,[237 245 403  88 273],450,4,14938,4.124240750966317,0.0,0.0
3622,0,3622,[318  64  79  98 588],450,5,14943,4.124482473088601,40.0,0.0
3623,0,3623,[237 357  98 204 180],835,4,14947,4.124448123620309,0.0,0.0
3624,0,3624,[204  79   8 173 742],344,4,14951,4.124413793103448,0.0,0.0
3625,0,3625,[318  64  79  98 588],577,5,14956,4.12465526751241,40.0,0.0
3626,0,3626,[ 95  88 357  98 323],23,2,14958,4.124069478908188,0.0,0.0
3627,0,3627,[318  64  79  98 588],457,5,14963,4.124310915104741,40.0,0.0
3628,0,3628,[471  98  69   9 216],593,3,14966,4.12400110223202,0.0,0.0
3629,0,3629,[191 161 471 196 357],457,5,14971,4.124242424242424,0.0,0.0
3630,0,3630,[118 237 269 323 655],796,2,14973,4.123657394657119,0.0,0.0
3631,0,3631,[  4  98 182 234 228],280,1,14974,4.122797356828194,0.0,0.0
3632,0,3632,[318  64  79  98 588],796,5,14979,4.123038810900082,40.0,0.0
3633,0,3633,[471 135 483 185  71],535,4,14983,4.123004953219593,0.0,0.0
3634,0,3634,[144 265 183 186 237],716,2,14985,4.12242090784044,0.0,0.0
3635,0,3635,[318  64  79  98 588],450,5,14990,4.122662266226623,40.0,0.0
3636,0,3636,[186 187 174 748  69],450,4,14994,4.122628540005499,0.0,0.0
3637,0,3637,[318  64  79  98 588],450,5,14999,4.122869708631116,40.0,0.0
3638,0,3638,[176 403  22   9 228],796,4,15003,4.122835943940643,0.0,0.0
3639,0,3639,[125 151 265   4 546],457,4,15007,4.122802197802198,0.0,0.0
3640,0,3640,[265 127 176 603 568],655,2,15009,4.122219170557539,20.0,20.0
3641,0,3641,[318  64  79  98 588],457,5,15014,4.122460186710598,40.0,0.0
3642,0,3642,[196 210   7   4  98],629,3,15017,4.122152072467746,0.0,0.0
3643,0,3643,[318  64  79  98 588],18,5,15022,4.122392974753018,40.0,0.0
3644,0,3644,[210  22 275 197 423],18,5,15027,4.122633744855967,0.0,20.0
3645,0,3645,[318  64  79  98 588],716,5,15032,4.122874382885354,40.0,0.0
3646,0,3646,[318  64  79  98 588],716,5,15037,4.1231148889498215,40.0,0.0
3647,0,3647,[318  64  79  98 588],577,5,15042,4.123355263157895,40.0,0.0
3648,0,3648,[748 144 118 127  69],796,5,15047,4.123595505617978,0.0,20.0
3649,0,3649,[318  64  79  98 588],450,5,15052,4.123835616438356,40.0,0.0
3650,0,3650,[318  64  79  98 588],577,5,15057,4.124075595727198,40.0,0.0
3651,0,3651,[318  64  79  98 588],716,5,15062,4.124315443592552,40.0,0.0
3652,0,3652,[318  64  79  98 588],450,5,15067,4.124555160142349,40.0,0.0
3653,0,3653,[313 265 153 111 100],236,2,15069,4.123973727422003,0.0,20.0
3654,0,3654,[588  88  70  95 195],786,5,15074,4.12421340629275,0.0,0.0
3655,0,3655,[ 70 276 180  11 294],280,4,15078,4.12417943107221,0.0,0.0
3656,0,3656,[ 96  88 172 655 153],655,1,15079,4.123325129887887,0.0,0.0
3657,0,3657,[143 300  88 238 200],655,2,15081,4.122744669218152,0.0,0.0
3658,0,3658,[318  64  79  98 588],457,5,15086,4.122984421973217,40.0,0.0
3659,0,3659,[294 237 172 173 196],796,4,15090,4.122950819672131,0.0,0.0
3660,0,3660,[318  64  79  98 588],716,5,15095,4.123190385140672,40.0,0.0
3661,0,3661,[597 568 235  15 210],269,0,15095,4.12206444565811,0.0,0.0
3662,0,3662,[318  64  79  98 588],457,5,15100,4.122304122304122,40.0,0.0
3663,0,3663,[222 187 282 125  89],796,5,15105,4.122543668122271,0.0,0.0
3664,0,3664,[483 215 180  22 328],796,4,15109,4.122510231923601,0.0,0.0
3665,0,3665,[294 173 191 603 588],716,5,15114,4.122749590834697,20.0,0.0
3666,0,3666,[ 11 135  69 318 496],450,4,15118,4.122716116716662,40.0,0.0
3667,0,3667,[357 195 237 275 333],796,5,15123,4.122955288985823,0.0,20.0
3668,0,3668,[117  22  97   8 313],152,5,15128,4.123194330880349,0.0,0.0
3669,0,3669,[118 357  25  82 117],450,2,15130,4.122615803814714,0.0,0.0
3670,0,3670,[ 69 568  22 228  96],716,4,15134,4.122582402615091,0.0,0.0
3671,0,3671,[318  64  79  98 588],457,5,15139,4.1228213507625275,40.0,0.0
3672,0,3672,[318  64  79  98 588],457,5,15144,4.123060168799347,40.0,0.0
3673,0,3673,[318  64  79  98 588],716,5,15149,4.1232988568317905,40.0,0.0
3674,0,3674,[318  64  79  98 588],450,5,15154,4.123537414965987,40.0,0.0
3675,0,3675,[143  79 333  50 222],655,3,15157,4.12323177366703,0.0,20.0
3676,0,3676,[234 271 265 475 294],629,4,15161,4.123198259450639,0.0,0.0
3677,0,3677,[202 191 328   7 385],655,1,15162,4.122349102773247,0.0,0.0
3678,0,3678,[385  98 185 118 111],151,3,15165,4.122044033704811,0.0,0.0
3679,0,3679,[318  64  79  98 588],796,5,15170,4.122282608695652,40.0,0.0
3680,0,3680,[204 405  88 742  97],577,3,15173,4.121977723444716,0.0,0.0
3681,0,3681,[318  64  79  98 588],18,5,15178,4.1222161868549705,40.0,0.0
3682,0,3682,[132   8 125 546  64],796,5,15183,4.12245452077111,20.0,0.0
3683,0,3683,[  4 588 603  82 655],450,3,15186,4.12214983713355,20.0,0.0
3684,0,3684,[318  64  79  98 588],577,5,15191,4.122388059701493,40.0,0.0
3685,0,3685,[318  64  79  98 588],450,5,15196,4.122626153011394,40.0,0.0
3686,0,3686,[318  64  79  98 588],716,5,15201,4.1228641171684295,40.0,0.0
3687,0,3687,[  1  96 268 210 597],344,2,15203,4.122288503253796,0.0,0.0
3688,0,3688,[318  64  79  98 588],577,5,15208,4.122526429926809,40.0,0.0
3689,0,3689,[234 238  50 235 588],716,4,15212,4.122493224932249,0.0,20.0
3690,0,3690,[318  64  79  98 588],796,5,15217,4.1227309672175565,40.0,0.0
3691,0,3691,[194  79 173  64 216],457,5,15222,4.122968580715059,20.0,0.0
3692,0,3692,[318  64  79  98 588],450,5,15227,4.12320606552938,40.0,0.0
3693,0,3693,[318  64  79  98 588],796,5,15232,4.123443421765025,40.0,0.0
3694,0,3694,[273 318 111 423 194],236,3,15235,4.123139377537212,20.0,0.0
3695,0,3695,[173 211 265 385 135],716,3,15238,4.1228354978354975,0.0,0.0
3696,0,3696,[318  64  79  98 588],450,5,15243,4.123072761698674,40.0,0.0
3697,0,3697,[313  88 100  12 286],707,2,15245,4.122498647917793,0.0,40.0
3698,0,3698,[435 301 197 483 153],535,5,15250,4.122735874560692,0.0,0.0
3699,0,3699,[179 357   1 195 118],450,4,15254,4.122702702702703,0.0,0.0
3700,0,3700,[385 322  22  71  69],344,0,15254,4.12158875979465,0.0,0.0
3701,0,3701,[153 235 186 181 179],450,3,15257,4.121285791464073,0.0,0.0
3702,0,3702,[318  64  79  98 588],450,5,15262,4.121523089386984,40.0,0.0
3703,0,3703,[204 238 655 125 288],655,0,15262,4.120410367170626,0.0,0.0
3704,0,3704,[318  64  79  98 588],450,5,15267,4.1206477732793525,40.0,0.0
3705,0,3705,[318  64  79  98 588],457,5,15272,4.120885051268214,40.0,0.0
3706,0,3706,[ 11 125 423 237 183],577,4,15276,4.1208524413272185,0.0,0.0
3707,0,3707,[471 181 403 200 197],655,1,15277,4.120010787486516,0.0,0.0
3708,0,3708,[318  64  79  98 588],577,5,15282,4.120248045295228,40.0,0.0
3709,0,3709,[ 64  56 182 100 204],269,4,15286,4.1202156334231805,20.0,20.0
3710,0,3710,[194  11 210 568  22],577,2,15288,4.1196443007275665,0.0,0.0
3711,0,3711,[655   1 161 265 117],457,5,15293,4.119881465517241,0.0,0.0
3712,0,3712,[318  64  79  98 588],457,5,15298,4.120118502558578,40.0,0.0
3713,0,3713,[318  64  79  98 588],457,5,15303,4.120355411954765,40.0,0.0
3714,0,3714,[318  64  79  98 588],577,5,15308,4.120592193808883,40.0,0.0
3715,0,3715,[318  64  79  98 588],457,5,15313,4.120828848223897,40.0,0.0
3716,0,3716,[234 678  98 176 276],280,2,15315,4.120258272800646,0.0,0.0
3717,0,3717,[ 97 118 276  11 282],457,5,15320,4.120494889725659,0.0,0.0
3718,0,3718,[322  22 202 100 385],344,2,15322,4.119924710943802,0.0,20.0
3719,0,3719,[ 95 197 269 385 143],796,3,15325,4.119623655913978,0.0,0.0
3720,0,3720,[405   7  70 183 180],786,5,15330,4.1198602526202635,0.0,0.0
3721,0,3721,[318  64  79  98 588],450,5,15335,4.12009672219237,40.0,0.0
3722,0,3722,[294   8 183 471 179],655,2,15337,4.119527262959979,0.0,0.0
3723,0,3723,[174  64 655 228 183],796,4,15341,4.119495166487647,20.0,0.0
3724,0,3724,[318  64  79  98 588],716,5,15346,4.1197315436241615,40.0,0.0
3725,0,3725,[471  64 302 423 258],655,2,15348,4.119162640901771,20.0,0.0
3726,0,3726,[318  64  79  98 588],716,5,15353,4.119398980413201,40.0,0.0
3727,0,3727,[318  64  79  98 588],450,5,15358,4.119635193133047,40.0,0.0
3728,0,3728,[118  28  88  97 238],330,5,15363,4.1198712791633145,0.0,0.0
3729,0,3729,[ 82 180 237 748 195],796,3,15366,4.119571045576407,0.0,0.0
3730,0,3730,[318  64  79  98 588],577,5,15371,4.119807022246047,40.0,0.0
3731,0,3731,[318  64  79  98 588],577,5,15376,4.120042872454448,40.0,0.0
3732,0,3732,[ 96 405 204 222  56],72,3,15379,4.119742834181624,0.0,0.0
3733,0,3733,[318  64  79  98 588],716,5,15384,4.119978575254419,40.0,0.0
3734,0,3734,[588 174  15 276 265],786,3,15387,4.119678714859438,0.0,0.0
3735,0,3735,[318  64  79  98 588],796,5,15392,4.119914346895075,40.0,0.0
3736,0,3736,[318  64  79  98 588],450,5,15397,4.12014985282312,40.0,0.0
3737,0,3737,[318  64  79  98 588],796,5,15402,4.120385232744783,40.0,0.0
3738,0,3738,[508 323   8 210 183],280,1,15403,4.1195506820005345,0.0,0.0
3739,0,3739,[318  64  79  98 588],577,5,15408,4.119786096256685,40.0,0.0
3740,0,3740,[742 132 265 181  69],457,5,15413,4.120021384656509,0.0,0.0
3741,0,3741,[546 173 265   1  97],796,3,15416,4.119722073757349,0.0,0.0
3742,0,3742,[ 98 118 258 403 357],796,5,15421,4.119957253539941,0.0,0.0
3743,0,3743,[318  64  79  98 588],716,5,15426,4.1201923076923075,40.0,0.0
3744,0,3744,[318  64  79  98 588],18,5,15431,4.120427236315087,40.0,0.0
3745,0,3745,[143  70 175 427  97],18,5,15436,4.12066203950881,20.0,0.0
3746,0,3746,[515 385 742 179   7],655,2,15438,4.120096076861489,0.0,0.0
3747,0,3747,[318  64  79  98 588],457,5,15443,4.120330843116329,40.0,0.0
3748,0,3748,[313 191   7 288 742],693,2,15445,4.1197652707388634,0.0,0.0
3749,0,3749,[228 121 179 405 100],655,1,15446,4.118933333333334,0.0,20.0
3750,0,3750,[ 56 100 322 180 423],504,4,15450,4.118901626233004,0.0,20.0
3751,0,3751,[286 196 603 180 173],796,3,15453,4.11860341151386,20.0,20.0
3752,0,3752,[318  64  79  98 588],18,5,15458,4.118838262723155,40.0,0.0
3753,0,3753,[ 11 100  98 597  12],344,3,15461,4.118540223761321,0.0,20.0
3754,0,3754,[405 135  88 568 288],655,1,15462,4.117709720372837,0.0,0.0
3755,0,3755,[183 515 237 179 176],269,2,15464,4.1171458998935035,0.0,0.0
3756,0,3756,[318  64  79  98 588],716,5,15469,4.117380889007187,40.0,0.0
3757,0,3757,[ 25 222 187 196  50],716,4,15473,4.117349654071314,0.0,20.0
3758,0,3758,[318  64  79  98 588],577,5,15478,4.117584463953179,40.0,0.0
3759,0,3759,[318  64  79  98 588],18,5,15483,4.11781914893617,40.0,0.0
3760,0,3760,[748  98 427 181 204],450,5,15488,4.1180537091199145,20.0,0.0
3761,0,3761,[318  64  79  98 588],457,5,15493,4.118288144603934,40.0,0.0
3762,0,3762,[318  64  79  98 588],796,5,15498,4.118522455487643,40.0,0.0
3763,0,3763,[161 282 186 176  64],693,1,15499,4.11769394261424,20.0,0.0
3764,0,3764,[153 191  95 118 168],389,2,15501,4.117131474103585,0.0,0.0
3765,0,3765,[202   9 483  28 273],796,2,15503,4.116569304301646,0.0,0.0
3766,0,3766,[318  79  64  98 588],796,5,15508,4.11680382267056,40.0,0.0
3767,0,3767,[318  79  64  98 588],796,5,15513,4.11703821656051,40.0,0.0
3768,0,3768,[318  79  64  98 588],796,5,15518,4.117272486070576,40.0,0.0
3769,0,3769,[  1 196 127   4  71],450,3,15521,4.116976127320955,0.0,20.0
3770,0,3770,[318  79  64  98 588],457,5,15526,4.117210289047998,40.0,0.0
3771,0,3771,[318  79  64  98 588],716,5,15531,4.117444326617179,40.0,0.0
3772,0,3772,[603 211  25 265 235],716,4,15535,4.117413199045852,20.0,0.0
3773,0,3773,[318  79  64  98 588],457,5,15540,4.117647058823529,40.0,0.0
3774,0,3774,[357 143 173  28 183],151,4,15544,4.117615894039735,0.0,0.0
3775,0,3775,[210 568 161 181 403],655,0,15544,4.116525423728813,0.0,0.0
3776,0,3776,[172 132 508   4 204],344,5,15549,4.116759332803812,0.0,0.0
3777,0,3777,[318  79  64  98 588],18,5,15554,4.116993118051879,40.0,0.0
3778,0,3778,[357 183 187 483 182],450,4,15558,4.116962159301402,0.0,0.0
3779,0,3779,[318  79  64  98 588],716,5,15563,4.117195767195767,40.0,0.0
3780,0,3780,[318  79  64  98 588],716,5,15568,4.117429251520762,40.0,0.0
3781,0,3781,[186  97 143 742  64],450,4,15572,4.117398202009519,20.0,0.0
3782,0,3782,[196  11 405  97 121],655,0,15572,4.116309807031456,0.0,0.0
3783,0,3783,[318  79  64  98 588],18,5,15577,4.11654334038055,40.0,0.0
3784,0,3784,[318  79  64  98 588],716,5,15582,4.116776750330251,40.0,0.0
3785,0,3785,[174 496 357 228 405],796,5,15587,4.117010036978341,20.0,0.0
3786,0,3786,[ 28 185 132 180  15],457,5,15592,4.117243200422498,0.0,0.0
3787,0,3787,[318  79  64  98 588],18,5,15597,4.117476240760296,40.0,0.0
3788,0,3788,[318  79  64  98 588],796,5,15602,4.117709158089205,40.0,0.0
3789,0,3789,[ 22  97 427 286 143],655,2,15604,4.117150395778364,20.0,20.0
3790,0,3790,[  4 183 234 191 546],786,4,15608,4.117119493537325,0.0,0.0
3791,0,3791,[435  22 111 301 265],450,5,15613,4.1173523206751055,0.0,0.0
3792,0,3792,[318  79  64  98 588],457,5,15618,4.117585025046138,40.0,0.0
3793,0,3793,[318  79  64  98 588],577,5,15623,4.117817606747496,40.0,0.0
3794,0,3794,[204 235 483  15 127],269,2,15625,4.117259552042161,0.0,20.0
3795,0,3795,[ 97 196   9 132  70],504,4,15629,4.11722866174921,0.0,0.0
3796,0,3796,[318  79  64  98 588],796,5,15634,4.11746115354227,40.0,0.0
3797,0,3797,[127 282 300  98 423],796,5,15639,4.1176935229067935,0.0,20.0
3798,0,3798,[172 202 282 196  82],450,4,15643,4.117662542774414,0.0,0.0
3799,0,3799,[ 22 748 172 194 132],807,5,15648,4.117894736842105,0.0,0.0
3800,0,3800,[318  79  64  98 588],577,5,15653,4.1181268087345435,40.0,0.0
3801,0,3801,[318  79  64  98 588],577,5,15658,4.1183587585481325,40.0,0.0
3802,0,3802,[318  79  64  98 588],577,5,15663,4.118590586379175,40.0,0.0
3803,0,3803,[318  79  64  98 588],450,5,15668,4.11882229232387,40.0,0.0
3804,0,3804,[ 50  25 237 118 185],450,3,15671,4.118528252299606,0.0,20.0
3805,0,3805,[318  79  64  98 588],450,5,15676,4.118759852863899,40.0,0.0
3806,0,3806,[ 50 257 742 423 603],796,4,15680,4.11872865773575,20.0,20.0
3807,0,3807,[196  50 179 483 748],450,4,15684,4.118697478991597,0.0,20.0
3808,0,3808,[328 210 135 282 215],450,3,15687,4.118403780519821,0.0,0.0
3809,0,3809,[318  79  64  98 588],577,5,15692,4.118635170603675,40.0,0.0
3810,0,3810,[318  79  64  98 588],457,5,15697,4.118866439254789,40.0,0.0
3811,0,3811,[318  79  64  98 588],796,5,15702,4.1190975865687305,40.0,0.0
3812,0,3812,[318  79  64  98 588],450,5,15707,4.119328612640965,40.0,0.0
3813,0,3813,[ 79 121 423  56 603],655,2,15709,4.1187729417933925,20.0,0.0
3814,0,3814,[318  79  64  98 588],716,5,15714,4.119003931847969,40.0,0.0
3815,0,3815,[318  79  64  98 588],716,5,15719,4.119234800838575,40.0,0.0
3816,0,3816,[318  79  64  98 588],716,5,15724,4.1194655488603615,40.0,0.0
3817,0,3817,[385 200 655 100 161],280,3,15727,4.119172341540073,0.0,20.0
3818,0,3818,[318  79  64  98 588],18,5,15732,4.119402985074627,40.0,0.0
3819,0,3819,[318  79  64  98 588],18,5,15737,4.119633507853403,40.0,0.0
3820,0,3820,[179 258 195  98 210],450,4,15741,4.119602198377388,0.0,0.0
3821,0,3821,[318  79  64  98 588],457,5,15746,4.119832548403977,40.0,0.0
3822,0,3822,[328 271 268 245 301],629,2,15748,4.119278053884384,0.0,0.0
3823,0,3823,[318  79  64  98 588],457,5,15753,4.119508368200837,40.0,0.0
3824,0,3824,[318  79  64  98 588],450,5,15758,4.119738562091503,40.0,0.0
3825,0,3825,[318  79  64  98 588],18,5,15763,4.11996863565081,40.0,0.0
3826,0,3826,[ 88 496 286 186 568],796,3,15766,4.119675986412333,20.0,20.0
3827,0,3827,[318  79  64  98 588],18,5,15771,4.119905956112853,40.0,0.0
3828,0,3828,[318  79  64  98 588],450,5,15776,4.120135805693392,40.0,0.0
3829,0,3829,[471 186  97 215 118],693,2,15778,4.119582245430809,0.0,0.0
3830,0,3830,[183 238 117 423 211],593,5,15783,4.119812059514487,0.0,0.0
3831,0,3831,[161 172 588 118 237],280,2,15785,4.119258872651357,0.0,0.0
3832,0,3832,[318  79  64  98 588],450,5,15790,4.119488651187059,40.0,0.0
3833,0,3833,[234 111 182 323 322],280,2,15792,4.118935837245696,0.0,0.0
3834,0,3834,[153 333 423 258 271],655,0,15792,4.1178617992177315,0.0,0.0
3835,0,3835,[385 234 215 568 153],280,2,15794,4.1173096976016685,0.0,0.0
3836,0,3836,[318  79  64  98 588],716,5,15799,4.117539744592129,40.0,0.0
3837,0,3837,[181  82 471 182 200],450,3,15802,4.117248566961959,0.0,0.0
3838,0,3838,[  7 100 173  82  56],151,3,15805,4.116957541026309,0.0,20.0
3839,0,3839,[  1  50 100 300 257],701,4,15809,4.116927083333334,0.0,40.0
3840,0,3840,[318  79  64  98 588],457,5,15814,4.117156990367092,40.0,0.0
3841,0,3841,[318  79  64  98 588],457,5,15819,4.117386777719937,40.0,0.0
3842,0,3842,[318  79  64  98 588],18,5,15824,4.117616445485298,40.0,0.0
3843,0,3843,[318  79  64  98 588],577,5,15829,4.117845993756504,40.0,0.0
3844,0,3844,[ 28 197 742 288 161],450,4,15833,4.117815344603381,0.0,0.0
3845,0,3845,[318  79  64  98 588],716,5,15838,4.118044721788872,40.0,0.0
3846,0,3846,[318  79  64  98 588],716,5,15843,4.118273979724461,40.0,0.0
3847,0,3847,[318  79  64  98 588],577,5,15848,4.118503118503119,40.0,0.0
3848,0,3848,[ 97 748  12 173  15],796,4,15852,4.1184723304754485,0.0,0.0
3849,0,3849,[318  79  64  98 588],716,5,15857,4.118701298701299,40.0,0.0
3850,0,3850,[318  79  64  98 588],716,5,15862,4.1189301480135025,40.0,0.0
3851,0,3851,[194 238 211  56 185],11,3,15865,4.1186396677050885,0.0,0.0
3852,0,3852,[ 89 588   4  71 185],18,2,15867,4.1180898001557225,0.0,0.0
3853,0,3853,[ 96 258 117   7  69],344,2,15869,4.117540217955371,0.0,0.0
3854,0,3854,[318  79  64  98 588],450,5,15874,4.117769130998703,40.0,0.0
3855,0,3855,[ 70 144 216 200 183],450,4,15878,4.117738589211618,0.0,0.0
3856,0,3856,[318  79  64  98 588],577,5,15883,4.117967332123412,40.0,0.0
3857,0,3857,[471 161  88  22 288],457,5,15888,4.118195956454121,0.0,0.0
3858,0,3858,[100  88  69   4 286],786,5,15893,4.118424462295931,0.0,40.0
3859,0,3859,[385   1 211  96 405],655,0,15893,4.117357512953368,0.0,0.0
3860,0,3860,[318  79  64  98 588],716,5,15898,4.117586117586118,40.0,0.0
3861,0,3861,[318  79  64  98 588],796,5,15903,4.117814603832211,40.0,0.0
3862,0,3862,[269  96   7 211 333],655,0,15903,4.116748640952627,0.0,0.0
3863,0,3863,[168 125 132 181   7],292,3,15906,4.116459627329193,0.0,0.0
3864,0,3864,[118   8 197 180  98],280,3,15909,4.116170763260026,0.0,0.0
3865,0,3865,[ 70 275 508 215 186],655,1,15910,4.115364718054837,0.0,20.0
3866,0,3866,[  7 132  79 238 235],450,4,15914,4.115334884923714,0.0,0.0
3867,0,3867,[318  79  64  98 588],577,5,15919,4.115563598759048,40.0,0.0
3868,0,3868,[318  79  64  98 588],18,5,15924,4.115792194365469,40.0,0.0
3869,0,3869,[318  79  64  98 588],796,5,15929,4.116020671834625,40.0,0.0
3870,0,3870,[181 168 655 748  15],450,4,15933,4.115990700077499,0.0,0.0
3871,0,3871,[318  79  64  98 588],716,5,15938,4.116219008264463,40.0,0.0
3872,0,3872,[127 257 117 216 276],401,2,15940,4.115672605215595,0.0,20.0
3873,0,3873,[  4 257 118 180 235],716,1,15941,4.114868353123387,0.0,0.0
3874,0,3874,[318  79  64  98 588],716,5,15946,4.115096774193549,40.0,0.0
3875,0,3875,[318  79  64  98 588],796,5,15951,4.115325077399381,40.0,0.0
3876,0,3876,[318  79  64  98 588],577,5,15956,4.115553262832087,40.0,0.0
3877,0,3877,[258 546 403 210 195],504,4,15960,4.115523465703971,0.0,0.0
3878,0,3878,[318  79  64  98 588],716,5,15965,4.1157514823408095,40.0,0.0
3879,0,3879,[318  79  64  98 588],577,5,15970,4.115979381443299,40.0,0.0
3880,0,3880,[318  79  64  98 588],450,5,15975,4.116207163102294,40.0,0.0
3881,0,3881,[546 172 603 301 238],450,5,15980,4.116434827408552,20.0,0.0
3882,0,3882,[  1   8 111 257 301],389,3,15983,4.11614730878187,0.0,0.0
3883,0,3883,[318  79  64  98 588],457,5,15988,4.116374871266736,40.0,0.0
3884,0,3884,[318  79  64  98 588],577,5,15993,4.116602316602316,40.0,0.0
3885,0,3885,[318  79  64  98 588],796,5,15998,4.116829644879053,40.0,0.0
3886,0,3886,[ 25 588 655 144 257],457,4,16002,4.116799588371495,0.0,0.0
3887,0,3887,[318  79  64  98 588],577,5,16007,4.117026748971194,40.0,0.0
3888,0,3888,[357 294 471 313  82],655,2,16009,4.116482386217537,0.0,0.0
3889,0,3889,[318  79  64  98 588],450,5,16014,4.116709511568123,40.0,0.0
3890,0,3890,[318  79  64  98 588],716,5,16019,4.116936520174762,40.0,0.0
3891,0,3891,[318  79  64  98 588],18,5,16024,4.117163412127441,40.0,0.0
3892,0,3892,[194 183 655 238 269],450,5,16029,4.117390187516055,0.0,0.0
3893,0,3893,[318  79  64  98 588],457,5,16034,4.117616846430406,40.0,0.0
3894,0,3894,[161 471 174  12 568],693,3,16037,4.117329910141207,0.0,0.0
3895,0,3895,[318  79  64  98 588],577,5,16042,4.117556468172484,40.0,0.0
3896,0,3896,[238 318 405 357 151],151,4,16046,4.1175263022838084,20.0,0.0
3897,0,3897,[655 282  79 289 210],236,3,16049,4.117239610056439,0.0,0.0
3898,0,3898,[ 64 655 111 483 423],450,4,16053,4.1172095409079255,20.0,0.0
3899,0,3899,[ 15 288  69  28 196],450,3,16056,4.116923076923077,0.0,0.0
3900,0,3900,[ 22 204 234 194 195],807,3,16059,4.1166367598051785,0.0,0.0
3901,0,3901,[132 143 202 200 111],716,5,16064,4.116863147104049,0.0,0.0
3902,0,3902,[ 70 200  56 195 234],504,2,16066,4.116320778888035,0.0,0.0
3903,0,3903,[318  79  64  98 588],577,5,16071,4.116547131147541,40.0,0.0
3904,0,3904,[318  79  64  98 588],796,5,16076,4.116773367477593,40.0,0.0
3905,0,3905,[655 183 187 483 173],269,3,16079,4.116487455197133,0.0,0.0
3906,0,3906,[211 257 228 117 301],296,4,16083,4.116457640133095,0.0,0.0
3907,0,3907,[318  79  64  98 588],457,5,16088,4.116683725690891,40.0,0.0
3908,0,3908,[318  79  64  98 588],450,5,16093,4.116909695574316,40.0,0.0
3909,0,3909,[  1 111 125 273 258],450,4,16097,4.11687979539642,0.0,0.0
3910,0,3910,[515 100 185 328 204],655,2,16099,4.116338532344669,0.0,20.0
3911,0,3911,[483 216   7 237  71],280,4,16103,4.1163087934560325,0.0,0.0
3912,0,3912,[ 97 238 197  28 111],450,5,16108,4.116534628162535,0.0,0.0
3913,0,3913,[  7 174 678 216  11],344,3,16111,4.116249361267246,0.0,0.0
3914,0,3914,[202 179 655  22 185],457,5,16116,4.11647509578544,0.0,0.0
3915,0,3915,[318  79  64  98 588],577,5,16121,4.116700715015321,40.0,0.0
3916,0,3916,[318  79  64  98 588],716,5,16126,4.116926219045188,40.0,0.0
3917,0,3917,[318  79  64  98 588],18,5,16131,4.117151607963247,40.0,0.0
3918,0,3918,[ 50  97 597 245 196],344,2,16133,4.116611380454198,0.0,20.0
3919,0,3919,[216 471  64 117  22],716,4,16137,4.1165816326530615,20.0,0.0
3920,0,3920,[318  79  64  98 588],796,5,16142,4.116806937005866,40.0,0.0
3921,0,3921,[318  79  64  98 588],796,5,16147,4.117032126466088,40.0,0.0
3922,0,3922,[ 98 202  11  25 237],716,5,16152,4.117257201121591,0.0,0.0
3923,0,3923,[318  79  64  98 588],457,5,16157,4.117482161060143,40.0,0.0
3924,0,3924,[318  79  64  98 588],450,5,16162,4.117707006369427,40.0,0.0
3925,0,3925,[151 127 471 257 597],457,3,16165,4.117422312786551,0.0,20.0
3926,0,3926,[318  79  64  98 588],18,5,16170,4.117647058823529,40.0,0.0
3927,0,3927,[276 127 202 180  56],280,4,16174,4.117617107942974,0.0,20.0
3928,0,3928,[144  98 238   4 273],796,3,16177,4.117332654619496,0.0,0.0
3929,0,3929,[318  79  64  98 588],457,5,16182,4.117557251908397,40.0,0.0
3930,0,3930,[181 173 215 273 742],796,3,16185,4.117272958534724,0.0,0.0
3931,0,3931,[435 258 151 588  11],450,5,16190,4.117497456765005,0.0,0.0
3932,0,3932,[ 28 195 294 125 483],457,4,16194,4.117467581998475,0.0,0.0
3933,0,3933,[318  79  64  98 588],457,5,16199,4.117691916624301,40.0,0.0
3934,0,3934,[318  79  64  98 588],18,5,16204,4.1179161372299875,40.0,0.0
3935,0,3935,[318  79  64  98 588],577,5,16209,4.118140243902439,40.0,0.0
3936,0,3936,[318  79  64  98 588],716,5,16214,4.118364236728474,40.0,0.0
3937,0,3937,[216 215 186 185 100],796,3,16217,4.118080243778568,0.0,20.0
3938,0,3938,[597 100 258   4 172],450,4,16221,4.118050266565118,0.0,20.0
3939,0,3939,[742   8  64 118 508],655,1,16222,4.117258883248731,20.0,0.0
3940,0,3940,[100 194 195  25 282],504,4,16226,4.1172291296625225,0.0,20.0
3941,0,3941,[265 471 435 196 403],655,0,16226,4.116184677828514,0.0,0.0
3942,0,3942,[318  79  64  98 588],796,5,16231,4.1164088257671825,40.0,0.0
3943,0,3943,[318  79  64  98 588],18,5,16236,4.116632860040568,40.0,0.0
3944,0,3944,[182  22 161 132  50],796,5,16241,4.116856780735108,0.0,20.0
3945,0,3945,[318  79  64  98 588],716,5,16246,4.117080587937152,40.0,0.0
3946,0,3946,[318  79  64  98 588],457,5,16251,4.117304281732962,40.0,0.0
3947,0,3947,[603 427 185 211 202],796,4,16255,4.117274569402229,40.0,0.0
3948,0,3948,[318  79  64  98 588],577,5,16260,4.117498100785009,40.0,0.0
3949,0,3949,[318  79  64  98 588],457,5,16265,4.1177215189873415,40.0,0.0
3950,0,3950,[275  98  95 403 151],796,5,16270,4.117944824095166,0.0,20.0
3951,0,3951,[318  79  64  98 588],577,5,16275,4.118168016194332,40.0,0.0
3952,0,3952,[ 96 405   1 265 174],807,4,16279,4.1181381229445995,0.0,0.0
3953,0,3953,[318  79  64  98 588],577,5,16284,4.118361153262519,40.0,0.0
3954,0,3954,[268 211 121 423 100],535,4,16288,4.118331226295828,0.0,20.0
3955,0,3955,[318  79  64  98 588],457,5,16293,4.118554095045501,40.0,0.0
3956,0,3956,[318  79  64  98 588],450,5,16298,4.118776851149861,40.0,0.0
3957,0,3957,[318  79  64  98 588],450,5,16303,4.11899949469429,40.0,0.0
3958,0,3958,[ 82 496 174  64 168],577,5,16308,4.119222025764082,40.0,0.0
3959,0,3959,[282 234 258 180 191],457,5,16313,4.1194444444444445,0.0,0.0
3960,0,3960,[318  79  64  98 588],716,5,16318,4.1196667508205,40.0,0.0
3961,0,3961,[ 96 294  70 385   1],457,4,16322,4.119636547198384,0.0,0.0
3962,0,3962,[318  79  64  98 588],457,5,16327,4.119858692909412,40.0,0.0
3963,0,3963,[202 265 603 204 180],716,4,16331,4.119828456104944,20.0,0.0
3964,0,3964,[423 111  69 127  71],280,5,16336,4.120050441361917,0.0,20.0
3965,0,3965,[318  79  64  98 588],716,5,16341,4.120272314674735,40.0,0.0
3966,0,3966,[  7 405 313   1  82],655,1,16342,4.11948575749937,0.0,0.0
3967,0,3967,[318  79  64  98 588],716,5,16347,4.119707661290323,40.0,0.0
3968,0,3968,[  4 153   8  56 216],593,4,16351,4.119677500629882,0.0,0.0
3969,0,3969,[237 301 403  22 118],450,4,16355,4.119647355163728,0.0,0.0
3970,0,3970,[318  79  64  98 588],716,5,16360,4.119869050616973,40.0,0.0
3971,0,3971,[200 211   1 282  50],593,4,16364,4.119838872104733,0.0,20.0
3972,0,3972,[318  79  64  98 588],18,5,16369,4.120060407752328,40.0,0.0
3973,0,3973,[ 12 423 186 357 127],450,4,16373,4.120030196275793,0.0,20.0
3974,0,3974,[318  79  64  98 588],796,5,16378,4.120251572327044,40.0,0.0
3975,0,3975,[318  79  64  98 588],450,5,16383,4.120472837022133,40.0,0.0
3976,0,3976,[318  79  64  98 588],457,5,16388,4.1206939904450595,40.0,0.0
3977,0,3977,[318  79  64  98 588],450,5,16393,4.120915032679738,40.0,0.0
3978,0,3978,[151  69 182 168 100],457,5,16398,4.121135963810002,0.0,20.0
3979,0,3979,[ 64 143   1  89   4],18,3,16401,4.120854271356784,20.0,0.0
3980,0,3980,[318  79  64  98 588],577,5,16406,4.121075106757096,40.0,0.0
3981,0,3981,[318  79  64  98 588],577,5,16411,4.121295831240583,40.0,0.0
3982,0,3982,[111 187 168 282 172],450,5,16416,4.121516444890786,0.0,0.0
3983,0,3983,[318  79  64  98 588],450,5,16421,4.121736947791165,40.0,0.0
3984,0,3984,[ 70 161 475 197 300],655,0,16421,4.120702634880803,0.0,0.0
3985,0,3985,[238 423 597 276 185],457,4,16425,4.120672353236327,0.0,0.0
3986,0,3986,[318  79  64  98 588],716,5,16430,4.120892901931277,40.0,0.0
3987,0,3987,[ 25 483 125 276  98],457,5,16435,4.12111334002006,0.0,0.0
3988,0,3988,[318  79  64  98 588],450,5,16440,4.121333667585861,40.0,0.0
3989,0,3989,[ 50  96 234 172  71],796,4,16444,4.121303258145363,0.0,20.0
3990,0,3990,[195 228 216 508 118],344,4,16448,4.121272863943874,0.0,0.0
3991,0,3991,[258  22 204 176 185],450,5,16453,4.121492985971944,0.0,0.0
3992,0,3992,[216 294 742 174 151],577,5,16458,4.121712997746056,0.0,0.0
3993,0,3993,[265 322 204 423 286],796,3,16461,4.1214321482223335,0.0,20.0
3994,0,3994,[153   4  15 179  79],450,3,16464,4.1211514392991235,0.0,0.0
3995,0,3995,[121  12 194   1  95],577,5,16469,4.121371371371372,0.0,0.0
3996,0,3996,[318  79  64  98 588],18,5,16474,4.121591193395046,40.0,0.0
3997,0,3997,[318  79  64  98 588],457,5,16479,4.121810905452726,40.0,0.0
3998,0,3998,[318  79  64  98 588],796,5,16484,4.122030507626906,40.0,0.0
3999,0,3999,[173 237 151 238 111],796,4,16488,4.122,0.0,0.0
4000,0,4000,[318  79  64  98 588],716,5,16493,4.1222194451387155,40.0,0.0
4001,0,4001,[173 195 121  25  88],344,3,16496,4.121939030484757,0.0,0.0
4002,0,4002,[318  79  64  98 588],450,5,16501,4.122158381214089,40.0,0.0
4003,0,4003,[318  79  64  98 588],796,5,16506,4.1223776223776225,40.0,0.0
4004,0,4004,[ 71 288 195 173  22],450,3,16509,4.122097378277154,0.0,0.0
4005,0,4005,[427 222 215 282 300],655,1,16510,4.121318022965552,20.0,0.0
4006,0,4006,[318  79  64  98 588],716,5,16515,4.121537309708011,40.0,0.0
4007,0,4007,[318  79  64  98 588],457,5,16520,4.121756487025948,40.0,0.0
4008,0,4008,[ 25 186 132 475  96],655,0,16520,4.120728361187329,0.0,0.0
4009,0,4009,[168 191 423 405 496],796,5,16525,4.120947630922693,20.0,0.0
4010,0,4010,[ 28 318  25 125 496],577,5,16530,4.121166791323859,40.0,0.0
4011,0,4011,[318  79  64  98 588],18,5,16535,4.121385842472582,40.0,0.0
4012,0,4012,[318  79  64  98 588],796,5,16540,4.121604784450536,40.0,0.0
4013,0,4013,[385 588 210 301 282],450,4,16544,4.121574489287494,0.0,0.0
4014,0,4014,[  1 515  89 187 182],655,4,16548,4.121544209215442,0.0,0.0
4015,0,4015,[269 235 176  71  88],450,3,16551,4.121264940239044,0.0,0.0
4016,0,4016,[202 403 215 111  82],18,0,16551,4.1202389843166545,0.0,0.0
4017,0,4017,[318  79  64  98 588],577,5,16556,4.12045793927327,40.0,0.0
4018,0,4018,[318  79  64  98 588],716,5,16561,4.120676785269968,40.0,0.0
4019,0,4019,[318  79  64  98 588],457,5,16566,4.12089552238806,40.0,0.0
4020,0,4020,[318  79  64  98 588],796,5,16571,4.121114150708779,40.0,0.0
4021,0,4021,[318  79  64  98 588],457,5,16576,4.121332670313277,40.0,0.0
4022,0,4022,[318  79  64  98 588],457,5,16581,4.121551081282625,40.0,0.0
4023,0,4023,[385 238 300 196 210],450,4,16585,4.121520874751491,0.0,0.0
4024,0,4024,[318  79  64  98 588],18,5,16590,4.121739130434783,40.0,0.0
4025,0,4025,[200 118 294 111 238],716,4,16594,4.1217088922006955,0.0,0.0
4026,0,4026,[318  79  64  98 588],577,5,16599,4.12192699279861,40.0,0.0
4027,0,4027,[ 82 191  89 333 385],655,2,16601,4.121400198609732,0.0,0.0
4028,0,4028,[318  79  64  98 588],716,5,16606,4.121618267560189,40.0,0.0
4029,0,4029,[318  79  64  98 588],796,5,16611,4.121836228287841,40.0,0.0
4030,0,4030,[135 191 405 328  50],655,3,16614,4.121557926072935,0.0,20.0
4031,0,4031,[475 144 294  22 194],296,4,16618,4.121527777777778,0.0,0.0
4032,0,4032,[318  79  64  98 588],796,5,16623,4.121745598809819,40.0,0.0
4033,0,4033,[183 568 318  64 187],450,5,16628,4.1219633118492816,40.0,0.0
4034,0,4034,[294 117 748 204   7],450,5,16633,4.122180916976456,0.0,0.0
4035,0,4035,[183 302 185 194 427],269,3,16636,4.121902874132805,20.0,0.0
4036,0,4036,[ 88 333 286 185 204],236,2,16638,4.121377260341838,0.0,20.0
4037,0,4037,[318  79  64  98 588],450,5,16643,4.121594848935116,40.0,0.0
4038,0,4038,[568 655 313 194 197],796,3,16646,4.121317157712305,0.0,0.0
4039,0,4039,[318  79  64  98 588],716,5,16651,4.121534653465346,40.0,0.0
4040,0,4040,[318  79  64  98 588],716,5,16656,4.121752041573868,40.0,0.0
4041,0,4041,[216  12 210 742 235],280,4,16660,4.121721919841662,0.0,0.0
4042,0,4042,[175 222  89 210 313],344,4,16664,4.121691813010141,0.0,0.0
4043,0,4043,[ 22 597 237 202 185],457,4,16668,4.121661721068249,0.0,0.0
4044,0,4044,[118 655  97 173 204],593,4,16672,4.121631644004944,0.0,0.0
4045,0,4045,[ 88 508 385 222 403],655,0,16672,4.120612951062778,0.0,0.0
4046,0,4046,[318  79  64  98 588],457,5,16677,4.120830244625648,40.0,0.0
4047,0,4047,[ 98  95 144 568  15],796,5,16682,4.121047430830039,0.0,0.0
4048,0,4048,[318  79  64  98 588],450,5,16687,4.121264509755495,40.0,0.0
4049,0,4049,[176  96 748 471 185],450,5,16692,4.1214814814814815,0.0,0.0
4050,0,4050,[318  79  64  98 588],577,5,16697,4.121698346087386,40.0,0.0
4051,0,4051,[ 64 186   8 168 655],269,3,16700,4.12142152023692,20.0,0.0
4052,0,4052,[318  79  64  98 588],796,5,16705,4.121638292622748,40.0,0.0
4053,0,4053,[173 125 403 588 168],457,5,16710,4.121854958066107,0.0,0.0
4054,0,4054,[245 286 117 204 237],796,3,16713,4.121578298397041,0.0,20.0
4055,0,4055,[318  79  64  98 588],450,5,16718,4.121794871794871,40.0,0.0
4056,0,4056,[318  79  64  98 588],450,5,16723,4.122011338427409,40.0,0.0
4057,0,4057,[135 175 179  98  97],18,4,16727,4.121981271562346,0.0,0.0
4058,0,4058,[200 286  98 195  79],450,4,16731,4.121951219512195,0.0,20.0
4059,0,4059,[202 237  95  96 483],450,3,16734,4.12167487684729,0.0,0.0
4060,0,4060,[318  79  64  98 588],577,5,16739,4.121891159812854,40.0,0.0
4061,0,4061,[  8 161 181 185 237],269,1,16740,4.121122599704579,0.0,0.0
4062,0,4062,[385 405 202 121  89],786,4,16744,4.121092788579867,0.0,0.0
4063,0,4063,[423 111 318 125   9],655,1,16745,4.1203248031496065,20.0,0.0
4064,0,4064,[ 56 471 153  88   9],593,3,16748,4.120049200492005,0.0,0.0
4065,0,4065,[ 71 187 245 318 196],796,4,16752,4.120019675356616,20.0,0.0
4066,0,4066,[182   9  69 655 187],72,5,16757,4.1202360462257195,0.0,0.0
4067,0,4067,[222  71 197 161 423],756,0,16757,4.119223205506391,0.0,0.0
4068,0,4068,[181 100 153 427  71],18,4,16761,4.119193905136397,20.0,20.0
4069,0,4069,[318  79  64  98 588],716,5,16766,4.11941031941032,40.0,0.0
4070,0,4070,[117 194  69 546   9],504,4,16770,4.119380987472366,0.0,0.0
4071,0,4071,[655 153 211 435 322],151,3,16773,4.119106090373281,0.0,0.0
4072,0,4072,[318  79  64  98 588],716,5,16778,4.119322366805794,40.0,0.0
4073,0,4073,[318  79  64  98 588],796,5,16783,4.11953853706431,40.0,0.0
4074,0,4074,[204 186 245  22 318],796,3,16786,4.119263803680981,20.0,0.0
4075,0,4075,[257 135 483  79 275],389,3,16789,4.118989205103042,0.0,20.0
4076,0,4076,[ 64 237 210 179 100],577,3,16792,4.118714741231297,20.0,20.0
4077,0,4077,[ 98 748  70 172 496],450,5,16797,4.1189308484551255,20.0,0.0
4078,0,4078,[318  79  64  98 588],450,5,16802,4.119146849718068,40.0,0.0
4079,0,4079,[245  22  98 100 403],796,3,16805,4.118872549019608,0.0,20.0
4080,0,4080,[318  79  64  98 588],716,5,16810,4.1190884587111,40.0,0.0
4081,0,4081,[318  79  64  98 588],716,5,16815,4.119304262616365,40.0,0.0
4082,0,4082,[318  79  64  98 588],450,5,16820,4.119519960813127,40.0,0.0
4083,0,4083,[748 100 288 515 153],292,3,16823,4.1192458374143,0.0,20.0
4084,0,4084,[318  79  64  98 588],18,5,16828,4.119461444308445,40.0,0.0
4085,0,4085,[318  79  64  98 588],450,5,16833,4.119676945668135,40.0,0.0
4086,0,4086,[318  79  64  98 588],716,5,16838,4.119892341570834,40.0,0.0
4087,0,4087,[195  96  82 318 235],807,2,16840,4.119373776908024,20.0,0.0
4088,0,4088,[318  79  64  98 588],18,5,16845,4.1195891415994135,40.0,0.0
4089,0,4089,[100 121 258 282 238],504,4,16849,4.119559902200489,0.0,20.0
4090,0,4090,[318  79  64  98 588],796,5,16854,4.1197751161085305,40.0,0.0
4091,0,4091,[318  79  64  98 588],457,5,16859,4.119990224828935,40.0,0.0
4092,0,4092,[318  79  64  98 588],457,5,16864,4.120205228438798,40.0,0.0
4093,0,4093,[318  79  64  98 588],716,5,16869,4.120420127015144,40.0,0.0
4094,0,4094,[179 121 471 302 143],655,3,16872,4.12014652014652,0.0,0.0
4095,0,4095,[318  79  64  98 588],18,5,16877,4.120361328125,40.0,0.0
4096,0,4096,[318  79  64  98 588],577,5,16882,4.120576031242372,40.0,0.0
4097,0,4097,[ 25 174 121  96 185],457,5,16887,4.120790629575403,0.0,0.0
4098,0,4098,[302 385 301 742 288],655,1,16888,4.1200292754330325,0.0,0.0
4099,0,4099,[318  79  64  98 588],450,5,16893,4.120243902439024,40.0,0.0
4100,0,4100,[125  70 186   9   7],457,5,16898,4.120458424774445,0.0,0.0
4101,0,4101,[318  79  64  98 588],457,5,16903,4.120672842515846,40.0,0.0
4102,0,4102,[318  79  64  98 588],577,5,16908,4.120887155739703,40.0,0.0
4103,0,4103,[588 168 282   4 403],457,5,16913,4.121101364522417,0.0,0.0
4104,0,4104,[318  79  64  98 588],450,5,16918,4.121315468940317,40.0,0.0
4105,0,4105,[318  79  64  98 588],796,5,16923,4.121529469069654,40.0,0.0
4106,0,4106,[191 111  64 168 135],151,4,16927,4.121499878256635,20.0,0.0
4107,0,4107,[ 69 265 187  12 179],655,2,16929,4.120983446932814,0.0,0.0
4108,0,4108,[118  89 176 258 238],796,4,16933,4.120954003407155,0.0,0.0
4109,0,4109,[318  79  64  98 588],457,5,16938,4.121167883211679,40.0,0.0
4110,0,4110,[318  79  64  98 588],716,5,16943,4.121381658963756,40.0,0.0
4111,0,4111,[318  79  64  98 588],716,5,16948,4.121595330739299,40.0,0.0
4112,0,4112,[318  79  64  98 588],577,5,16953,4.12180889861415,40.0,0.0
4113,0,4113,[318  79  64  98 588],796,5,16958,4.122022362664074,40.0,0.0
4114,0,4114,[318  79  64  98 588],796,5,16963,4.1222357229647635,40.0,0.0
4115,0,4115,[318  79  64  98 588],796,5,16968,4.122448979591836,40.0,0.0
4116,0,4116,[748 151 427 275 302],151,3,16971,4.1221763419965995,20.0,20.0
4117,0,4117,[318  79  64  98 588],577,5,16976,4.122389509470617,40.0,0.0
4118,0,4118,[200  71 176 748   8],796,5,16981,4.1226025734401555,0.0,0.0
4119,0,4119,[318  79  64  98 588],577,5,16986,4.1228155339805825,40.0,0.0
4120,0,4120,[181 180 183 195 191],269,1,16987,4.122057752972579,0.0,0.0
4121,0,4121,[318  79  64  98 588],716,5,16992,4.122270742358078,40.0,0.0
4122,0,4122,[ 82 318 197 117 161],504,5,16997,4.122483628425903,20.0,0.0
4123,0,4123,[318  79  64  98 588],577,5,17002,4.122696411251212,40.0,0.0
4124,0,4124,[318  79  64  98 588],450,5,17007,4.122909090909091,40.0,0.0
4125,0,4125,[176 202 357 210  82],450,3,17010,4.122636936500243,0.0,0.0
4126,0,4126,[318  79  64  98 588],450,5,17015,4.122849527501817,40.0,0.0
4127,0,4127,[323   4  82   7  11],256,5,17020,4.123062015503876,0.0,0.0
4128,0,4128,[333 100 216 200 237],236,2,17022,4.1225478324049405,0.0,20.0
4129,0,4129,[ 11 748  25 286 597],450,4,17026,4.122518159806296,0.0,20.0
4130,0,4130,[127 508 427 185 258],655,3,17029,4.122246429435972,20.0,20.0
4131,0,4131,[ 28 234 144 151  15],450,3,17032,4.1219748305905135,0.0,0.0
4132,0,4132,[318  79  64  98 588],450,5,17037,4.1221872731671905,40.0,0.0
4133,0,4133,[318  79  64  98 588],577,5,17042,4.12239961296565,40.0,0.0
4134,0,4134,[168 748  70 318 215],450,5,17047,4.122611850060459,20.0,0.0
4135,0,4135,[127 313 275 187  88],236,2,17049,4.122098646034816,0.0,40.0
4136,0,4136,[318  79  64  98 588],796,5,17054,4.12231085327532,40.0,0.0
4137,0,4137,[318  79  64  98 588],18,5,17059,4.122522957950701,40.0,0.0
4138,0,4138,[257 187  70 211 117],504,3,17062,4.122251751630829,0.0,0.0
4139,0,4139,[318  79  64  98 588],716,5,17067,4.122463768115942,40.0,0.0
4140,0,4140,[211 185 174  95 385],23,5,17072,4.122675682202367,0.0,0.0
4141,0,4141,[403  89 237 588 228],457,5,17077,4.122887493964268,0.0,0.0
4142,0,4142,[273 132 176 405  70],450,4,17081,4.122857832488535,0.0,0.0
4143,0,4143,[318  79  64  98 588],457,5,17086,4.123069498069498,40.0,0.0
4144,0,4144,[ 12 655  22 496 172],280,3,17089,4.122798552472859,20.0,0.0
4145,0,4145,[  4 196 197 257 322],504,5,17094,4.12301013024602,0.0,0.0
4146,0,4146,[318  79  64  98 588],18,5,17099,4.123221605980227,40.0,0.0
4147,0,4147,[ 70 275 276  12  56],457,5,17104,4.123432979749277,0.0,20.0
4148,0,4148,[318  79  64  98 588],457,5,17109,4.123644251626898,40.0,0.0
4149,0,4149,[318  79  64  98 588],796,5,17114,4.123855421686747,40.0,0.0
4150,0,4150,[237 204  89 121  50],786,4,17118,4.123825584196579,0.0,20.0
4151,0,4151,[318  79  64  98 588],457,5,17123,4.124036608863198,40.0,0.0
4152,0,4152,[318  79  64  98 588],716,5,17128,4.124247531904647,40.0,0.0
4153,0,4153,[294 286 111 258  79],796,3,17131,4.123976889744824,0.0,20.0
4154,0,4154,[318  79  64  98 588],457,5,17136,4.124187725631769,40.0,0.0
4155,0,4155,[182 597 318  28 195],450,5,17141,4.124398460057748,20.0,0.0
4156,0,4156,[318  79  64  98 588],18,5,17146,4.124609093095983,40.0,0.0
4157,0,4157,[257 121  25 423 276],457,4,17150,4.124579124579125,0.0,0.0
4158,0,4158,[318  79  64  98 588],716,5,17155,4.124789612887714,40.0,0.0
4159,0,4159,[318  79  64  98 588],716,5,17160,4.125,40.0,0.0
4160,0,4160,[318  79  64  98 588],18,5,17165,4.125210285988945,40.0,0.0
4161,0,4161,[318  79  64  98 588],577,5,17170,4.1254204709274385,40.0,0.0
4162,0,4162,[318  79  64  98 588],18,5,17175,4.125630554888302,40.0,0.0
4163,0,4163,[318  79  64  98 588],457,5,17180,4.125840537944284,40.0,0.0
4164,0,4164,[483 357  15 265 204],457,5,17185,4.126050420168068,0.0,0.0
4165,0,4165,[318  79  64  98 588],18,5,17190,4.126260201632261,40.0,0.0
4166,0,4166,[  8 215  50 286  25],535,4,17194,4.126229901607871,0.0,40.0
4167,0,4167,[318  79  64  98 588],577,5,17199,4.126439539347409,40.0,0.0
4168,0,4168,[318  79  64  98 588],450,5,17204,4.12664907651715,40.0,0.0
4169,0,4169,[318  79  64  98 588],450,5,17209,4.126858513189449,40.0,0.0
4170,0,4170,[271  50  12  70 143],655,2,17211,4.126348597458643,0.0,20.0
4171,0,4171,[144 568 210 282  11],450,4,17215,4.126318312559923,0.0,0.0
4172,0,4172,[318  79  64  98 588],18,5,17220,4.126527677929547,40.0,0.0
4173,0,4173,[318  79  64  98 588],716,5,17225,4.126736942980354,40.0,0.0
4174,0,4174,[318  79  64  98 588],450,5,17230,4.126946107784431,40.0,0.0
4175,0,4175,[318  79  64  98 588],18,5,17235,4.127155172413793,40.0,0.0
4176,0,4176,[ 96 111 180   7  69],450,5,17240,4.127364136940388,0.0,0.0
4177,0,4177,[ 50 121 204 161 182],457,5,17245,4.127573001436094,0.0,20.0
4178,0,4178,[  1 196  71 182  64],535,3,17248,4.127303182579564,20.0,0.0
4179,0,4179,[268  70 180 210  64],535,4,17252,4.127272727272727,20.0,0.0
4180,0,4180,[318  79  64  98 588],796,5,17257,4.127481463764649,40.0,0.0
4181,0,4181,[318  79  64  98 588],450,5,17262,4.127690100430416,40.0,0.0
4182,0,4182,[318  79  64  98 588],457,5,17267,4.12789863734162,40.0,0.0
4183,0,4183,[318  79  64  98 588],796,5,17272,4.128107074569789,40.0,0.0
4184,0,4184,[318  79  64  98 588],716,5,17277,4.12831541218638,40.0,0.0
4185,0,4185,[435 211 508  96  70],655,0,17277,4.127329192546584,0.0,0.0
4186,0,4186,[318  79  64  98 588],716,5,17282,4.1275376164318125,40.0,0.0
4187,0,4187,[ 88  95 211 546 318],450,4,17286,4.1275071633237825,20.0,0.0
4188,0,4188,[318  79  64  98 588],577,5,17291,4.127715445213655,40.0,0.0
4189,0,4189,[318  79  64  98 588],450,5,17296,4.1279236276849645,40.0,0.0
4190,0,4190,[ 11  89 173 496 435],269,1,17297,4.127177284657599,20.0,0.0
4191,0,4191,[357  96 546 183 483],796,5,17302,4.127385496183206,0.0,0.0
4192,0,4192,[183 222  70 185   1],450,4,17306,4.127355115668972,0.0,0.0
4193,0,4193,[318  79  64  98 588],450,5,17311,4.127563185503099,40.0,0.0
4194,0,4194,[318  79  64  98 588],457,5,17316,4.12777115613826,40.0,0.0
4195,0,4195,[294 286 275 301  28],450,5,17321,4.1279790276453765,0.0,40.0
4196,0,4196,[318 471 655  11 196],593,3,17324,4.127710269239933,20.0,0.0
4197,0,4197,[273  15  25 288 275],938,4,17328,4.1276798475464505,0.0,20.0
4198,0,4198,[318  79  64  98 588],450,5,17333,4.127887592283877,40.0,0.0
4199,0,4199,[318  79  64  98 588],18,5,17338,4.128095238095238,40.0,0.0
4200,0,4200,[318  79  64  98 588],457,5,17343,4.128302785051178,40.0,0.0
4201,0,4201,[405  96 403 237 245],796,4,17347,4.128272251308901,0.0,0.0
4202,0,4202,[318  79  64  98 588],716,5,17352,4.12847965738758,40.0,0.0
4203,0,4203,[222 235 161 168 121],457,4,17356,4.1284490960989535,0.0,0.0
4204,0,4204,[318  79  64  98 588],18,5,17361,4.128656361474436,40.0,0.0
4205,0,4205,[318  79  64  98 588],18,5,17366,4.128863528292915,40.0,0.0
4206,0,4206,[153 202  97  11  95],450,4,17370,4.1288328975517,0.0,0.0
4207,0,4207,[172 237  22 238 289],655,1,17371,4.128089353612167,0.0,0.0
4208,0,4208,[117 191 132 118 288],693,2,17373,4.127583749109052,0.0,0.0
4209,0,4209,[318  79  64  98 588],796,5,17378,4.1277909738717335,40.0,0.0
4210,0,4210,[176 186 117 405   4],655,0,17378,4.126810733792448,0.0,0.0
4211,0,4211,[318  79  64  98 588],18,5,17383,4.127018043684711,40.0,0.0
4212,0,4212,[168 179  96 258  64],457,5,17388,4.127225255162592,20.0,0.0
4213,0,4213,[ 11 117  64 597 182],450,5,17393,4.127432368296156,20.0,0.0
4214,0,4214,[318  79  64  98 588],796,5,17398,4.1276393831553975,40.0,0.0
4215,0,4215,[318  79  64  98 588],577,5,17403,4.127846299810247,40.0,0.0
4216,0,4216,[318  79  64  98 588],716,5,17408,4.128053118330567,40.0,0.0
4217,0,4217,[183 286   1 268 234],655,1,17409,4.127311522048364,0.0,20.0
4218,0,4218,[318  79  64  98 588],457,5,17414,4.1275183692818205,40.0,0.0
4219,0,4219,[183 286 143 181 568],450,5,17419,4.127725118483412,0.0,20.0
4220,0,4220,[318  79  64  98 588],796,5,17424,4.127931769722815,40.0,0.0
4221,0,4221,[318  79  64  98 588],18,5,17429,4.128138323069635,40.0,0.0
4222,0,4222,[ 22 151  12 125 186],18,3,17432,4.127871181624438,0.0,0.0
4223,0,4223,[318  79  64  98 588],457,5,17437,4.128077651515151,40.0,0.0
4224,0,4224,[318  79  64  98 588],577,5,17442,4.128284023668639,40.0,0.0
4225,0,4225,[238 135 100 161 176],450,4,17446,4.128253667770942,0.0,20.0
4226,0,4226,[210   4  88 318 216],151,5,17451,4.128459900638751,20.0,0.0
4227,0,4227,[ 96  15  69 117 100],450,4,17455,4.128429517502365,0.0,20.0
4228,0,4228,[318  79  64  98 588],18,5,17460,4.128635611255616,40.0,0.0
4229,0,4229,[161 546  50 183 275],716,2,17462,4.128132387706856,0.0,40.0
4230,0,4230,[385 427 215 318 238],151,3,17465,4.127865752777121,40.0,0.0
4231,0,4231,[282 168 515 180 186],535,3,17468,4.1275992438563325,0.0,0.0
4232,0,4232,[318  79  64  98 588],796,5,17473,4.127805339003071,40.0,0.0
4233,0,4233,[ 70   4 211 588 237],450,4,17477,4.1277751535191305,0.0,0.0
4234,0,4234,[318  79  64  98 588],457,5,17482,4.127981109799292,40.0,0.0
4235,0,4235,[210 471 238  98 275],457,5,17487,4.128186968838527,0.0,20.0
4236,0,4236,[318  79  64  98 588],716,5,17492,4.128392730705688,40.0,0.0
4237,0,4237,[ 79  96 215 235   8],457,4,17496,4.128362435110901,0.0,0.0
4238,0,4238,[318  79  64  98 588],450,5,17501,4.1285680585043645,40.0,0.0
4239,0,4239,[318  79  64  98 588],18,5,17506,4.128773584905661,40.0,0.0
4240,0,4240,[318  79  64  98 588],457,5,17511,4.1289790143834,40.0,0.0
4241,0,4241,[318  79  64  98 588],18,5,17516,4.129184347006129,40.0,0.0
4242,0,4242,[144 286 127 228  98],296,5,17521,4.129389582842329,0.0,40.0
4243,0,4243,[318  79  64  98 588],450,5,17526,4.129594721960415,40.0,0.0
4244,0,4244,[172 234 216 496 186],18,3,17529,4.129328621908127,20.0,0.0
4245,0,4245,[273 185 144 215  64],450,4,17533,4.129298162976919,20.0,0.0
4246,0,4246,[318  79  64  98 588],577,5,17538,4.129503178714387,40.0,0.0
4247,0,4247,[318  79  64  98 588],18,5,17543,4.129708097928437,40.0,0.0
4248,0,4248,[318  79  64  98 588],716,5,17548,4.129912920687221,40.0,0.0
4249,0,4249,[318  79  64  98 588],796,5,17553,4.130117647058824,40.0,0.0
4250,0,4250,[318  79  64  98 588],577,5,17558,4.130322277111268,40.0,0.0
4251,0,4251,[ 89 187 111  88 289],786,5,17563,4.130526810912512,0.0,0.0
4252,0,4252,[318  79  64  98 588],796,5,17568,4.1307312485304495,40.0,0.0
4253,0,4253,[318  79  64  98 588],796,5,17573,4.1309355900329106,40.0,0.0
4254,0,4254,[117 655 427 275 185],450,5,17578,4.131139835487661,20.0,20.0
4255,0,4255,[ 12 197 222 427 313],450,4,17582,4.131109022556391,20.0,0.0
4256,0,4256,[318  79  64  98 588],796,5,17587,4.1313131313131315,40.0,0.0
4257,0,4257,[318  79  64  98 588],577,5,17592,4.1315171441991545,40.0,0.0
4258,0,4258,[127 144 191 294 100],655,2,17594,4.131016670579949,0.0,40.0
4259,0,4259,[318  79  64  98 588],450,5,17599,4.131220657276995,40.0,0.0
4260,0,4260,[318  79  64  98 588],796,5,17604,4.131424548228115,40.0,0.0
4261,0,4261,[ 22  98  82 211 183],450,4,17608,4.13139371187236,0.0,0.0
4262,0,4262,[318  79  64  98 588],796,5,17613,4.131597466572836,40.0,0.0
4263,0,4263,[153  56 286 328 185],236,4,17617,4.131566604127579,0.0,20.0
4264,0,4264,[100  64 568  22 161],269,2,17619,4.131066822977726,20.0,20.0
4265,0,4265,[318  79  64  98 588],716,5,17624,4.131270511017346,40.0,0.0
4266,0,4266,[318  79  64  98 588],18,5,17629,4.131474103585657,40.0,0.0
4267,0,4267,[318  79  64  98 588],577,5,17634,4.131677600749765,40.0,0.0
4268,0,4268,[318  79  64  98 588],716,5,17639,4.131881002576716,40.0,0.0
4269,0,4269,[194  97 215 168 181],457,5,17644,4.132084309133489,0.0,0.0
4270,0,4270,[ 70  15 275 269 475],655,1,17645,4.131350971669399,0.0,20.0
4271,0,4271,[318  79  64  98 588],18,5,17650,4.1315543071161045,40.0,0.0
4272,0,4272,[318  79  64  98 588],457,5,17655,4.131757547390592,40.0,0.0
4273,0,4273,[318  79  64  98 588],18,5,17660,4.131960692559663,40.0,0.0
4274,0,4274,[118 265 288 235 318],457,4,17664,4.131929824561404,20.0,0.0
4275,0,4275,[318  79  64  98 588],716,5,17669,4.132132834424696,40.0,0.0
4276,0,4276,[318  79  64  98 588],796,5,17674,4.132335749357026,40.0,0.0
4277,0,4277,[318  79  64  98 588],796,5,17679,4.132538569424965,40.0,0.0
4278,0,4278,[117 496  56  25   1],450,4,17683,4.132507595232531,20.0,0.0
4279,0,4279,[568 168 111  88 202],269,1,17684,4.131775700934579,0.0,0.0
4280,0,4280,[187 568 121 423 135],693,2,17686,4.131277738846064,0.0,0.0
4281,0,4281,[318  79  64  98 588],457,5,17691,4.13148061653433,40.0,0.0
4282,0,4282,[318  79  64  98 588],18,5,17696,4.131683399486342,40.0,0.0
4283,0,4283,[655 748 234  88 257],796,3,17699,4.131419234360411,0.0,0.0
4284,0,4284,[153 328 269 161 181],450,5,17704,4.131621936989498,0.0,0.0
4285,0,4285,[318  79  64  98 588],577,5,17709,4.131824545030331,40.0,0.0
4286,0,4286,[318  79  64  98 588],577,5,17714,4.132027058549102,40.0,0.0
4287,0,4287,[301 182 135 318 269],655,3,17717,4.131763059701493,20.0,0.0
4288,0,4288,[318  79  64  98 588],716,5,17722,4.13196549312194,40.0,0.0
4289,0,4289,[135 238 118 182 168],450,3,17725,4.131701631701632,0.0,0.0
4290,0,4290,[318  79  64  98 588],577,5,17730,4.131903985085062,40.0,0.0
4291,0,4291,[144  12 118 257 185],457,4,17734,4.131873252562908,0.0,0.0
4292,0,4292,[117  79 288 237 568],457,5,17739,4.132075471698113,0.0,0.0
4293,0,4293,[175 118 200 515 186],655,2,17741,4.131578947368421,0.0,0.0
4294,0,4294,[318  79  64  98 588],796,5,17746,4.131781140861467,40.0,0.0
4295,0,4295,[318  79  64  98 588],457,5,17751,4.131983240223463,40.0,0.0
4296,0,4296,[168 125 357 234 235],450,3,17754,4.131719804514778,0.0,0.0
4297,0,4297,[588 168  95 357 655],796,4,17758,4.13168915774779,0.0,0.0
4298,0,4298,[496 588  22 427 121],577,5,17763,4.131891137473831,40.0,0.0
4299,0,4299,[269 175  64 185   9],655,2,17765,4.131395348837209,20.0,0.0
4300,0,4300,[471   9 302 196 135],535,3,17768,4.131132294815159,0.0,0.0
4301,0,4301,[135 132 357 183   1],835,4,17772,4.131101813110181,0.0,0.0
4302,0,4302,[318  79  64  98 588],716,5,17777,4.131303741575645,40.0,0.0
4303,0,4303,[318  79  64  98 588],457,5,17782,4.131505576208179,40.0,0.0
4304,0,4304,[215 318  69 191 222],224,5,17787,4.131707317073171,20.0,0.0
4305,0,4305,[125   7 328 435 127],655,1,17788,4.130980027868091,0.0,20.0
4306,0,4306,[269 276   8  69  98],18,4,17792,4.130949616902717,0.0,0.0
4307,0,4307,[100   8 222 238  79],655,1,17793,4.130222841225627,0.0,20.0
4308,0,4308,[ 88 181 427 186 182],450,4,17797,4.13019262009747,20.0,0.0
4309,0,4309,[318  79  64  98 588],450,5,17802,4.1303944315545245,40.0,0.0
4310,0,4310,[318  79  64  98 588],577,5,17807,4.130596149385293,40.0,0.0
4311,0,4311,[195   8 153   9 197],535,5,17812,4.130797773654916,0.0,0.0
4312,0,4312,[318  79  64  98 588],796,5,17817,4.130999304428472,40.0,0.0
4313,0,4313,[318  88 427  56   1],18,4,17821,4.130968938340287,40.0,0.0
4314,0,4314,[318  79  64  98 588],18,5,17826,4.13117033603708,40.0,0.0
4315,0,4315,[318  79  64  98 588],450,5,17831,4.131371640407785,40.0,0.0
4316,0,4316,[318  79  64  98 588],796,5,17836,4.131572851517257,40.0,0.0
4317,0,4317,[318  79  64  98 588],18,5,17841,4.1317739694302915,40.0,0.0
4318,0,4318,[ 15  12 496  89 237],450,4,17845,4.131743459134059,20.0,0.0
4319,0,4319,[597 174 121 216 117],256,5,17850,4.131944444444445,0.0,0.0
4320,0,4320,[ 97 117 100 286 471],786,5,17855,4.13214533672761,0.0,40.0
4321,0,4321,[318  79  64  98 588],716,5,17860,4.132346136048126,40.0,0.0
4322,0,4322,[194 197 245 200 187],450,4,17864,4.132315521628499,0.0,0.0
4323,0,4323,[318  79  64  98 588],716,5,17869,4.1325161887141535,40.0,0.0
4324,0,4324,[276  96 187 742 210],256,3,17872,4.132254335260115,0.0,0.0
4325,0,4325,[318  79  64  98 588],577,5,17877,4.132454923717059,40.0,0.0
4326,0,4326,[318  79  64  98 588],18,5,17882,4.132655419459209,40.0,0.0
4327,0,4327,[161  82 175 742 216],457,5,17887,4.132855822550832,0.0,0.0
4328,0,4328,[318  79  64  98 588],577,5,17892,4.133056133056133,40.0,0.0
4329,0,4329,[196 385  12 405 301],796,4,17896,4.133025404157044,0.0,0.0
4330,0,4330,[318  79  64  98 588],450,5,17901,4.133225583006234,40.0,0.0
4331,0,4331,[655 301 111 357 200],629,4,17905,4.133194829178208,0.0,0.0
4332,0,4332,[210 435 234  89 483],450,2,17907,4.132702515578122,0.0,0.0
4333,0,4333,[ 88  82 182 100  89],256,5,17912,4.132902630364559,0.0,20.0
4334,0,4334,[318  79  64  98 588],457,5,17917,4.133102652825836,40.0,0.0
4335,0,4335,[121 182 423  82  79],72,3,17920,4.132841328413284,0.0,0.0
4336,0,4336,[318  79  64  98 588],716,5,17925,4.133041272769195,40.0,0.0
4337,0,4337,[546 496 111   1  50],344,3,17928,4.132780082987552,20.0,20.0
4338,0,4338,[318  79  64  98 588],450,5,17933,4.132979949297073,40.0,0.0
4339,0,4339,[318  79  64  98 588],716,5,17938,4.1331797235023044,40.0,0.0
4340,0,4340,[318  79  64  98 588],796,5,17943,4.133379405666897,40.0,0.0
4341,0,4341,[318  79  64  98 588],796,5,17948,4.133578995854445,40.0,0.0
4342,0,4342,[ 64  98  28 181 153],796,4,17952,4.133548238544785,20.0,0.0
4343,0,4343,[318  79  64  98 588],18,5,17957,4.133747697974218,40.0,0.0
4344,0,4344,[ 82 197 588   8 237],280,2,17959,4.133256616800921,0.0,0.0
4345,0,4345,[ 15 235  69 173 215],457,4,17963,4.133225954901058,0.0,0.0
4346,0,4346,[  1 211  89 322 153],796,2,17965,4.1327352196917415,0.0,0.0
4347,0,4347,[ 56 597 318 423 121],457,4,17969,4.132704691812328,20.0,0.0
4348,0,4348,[144 300 748  28 197],450,5,17974,4.13290411588871,0.0,0.0
4349,0,4349,[ 97   7 185 475 471],655,1,17975,4.132183908045977,0.0,0.0
4350,0,4350,[318  79  64  98 588],577,5,17980,4.1323833601470925,40.0,0.0
4351,0,4351,[118 100  82 302 153],655,1,17981,4.131663602941177,0.0,20.0
4352,0,4352,[216 215 175 268  88],344,2,17983,4.131173903055364,0.0,0.0
4353,0,4353,[173 195 185 161  25],716,3,17986,4.130914101975195,0.0,0.0
4354,0,4354,[318  79  64  98 588],716,5,17991,4.131113662456946,40.0,0.0
4355,0,4355,[ 88   4 289  98 172],655,2,17993,4.130624426078971,0.0,0.0
4356,0,4356,[318  79  64  98 588],716,5,17998,4.130823961441359,40.0,0.0
4357,0,4357,[318  79  64  98 588],450,5,18003,4.131023405231757,40.0,0.0
4358,0,4358,[318  79  64  98 588],18,5,18008,4.131222757513191,40.0,0.0
4359,0,4359,[318  79  64  98 588],577,5,18013,4.131422018348624,40.0,0.0
4360,0,4360,[172 197 427 515 588],316,3,18016,4.131162577390507,20.0,0.0
4361,0,4361,[289 161  12 143   9],655,1,18017,4.130444750114626,0.0,0.0
4362,0,4362,[144 181 276 427 435],655,2,18019,4.129956451982581,20.0,0.0
4363,0,4363,[318  79  64  98 588],18,5,18024,4.130155820348304,40.0,0.0
4364,0,4364,[318  79  64  98 588],577,5,18029,4.130355097365407,40.0,0.0
4365,0,4365,[318  79  64  98 588],716,5,18034,4.130554283096656,40.0,0.0
4366,0,4366,[318  79  64  98 588],18,5,18039,4.130753377604763,40.0,0.0
4367,0,4367,[179  56  25  97 117],593,4,18043,4.130723443223443,0.0,0.0
4368,0,4368,[176 265   1 187  70],450,5,18048,4.130922407873656,0.0,0.0
4369,0,4369,[318  79  64  98 588],716,5,18053,4.131121281464531,40.0,0.0
4370,0,4370,[210  28 202 196 435],716,5,18058,4.131320064058568,0.0,0.0
4371,0,4371,[318  79  64  98 588],796,5,18063,4.131518755718207,40.0,0.0
4372,0,4372,[318  79  64  98 588],716,5,18068,4.131717356505831,40.0,0.0
4373,0,4373,[318  79  64  98 588],457,5,18073,4.131915866483768,40.0,0.0
4374,0,4374,[318  79  64  98 588],796,5,18078,4.132114285714286,40.0,0.0
4375,0,4375,[318  79  64  98 588],796,5,18083,4.132312614259598,40.0,0.0
4376,0,4376,[271 121 144   7  82],655,0,18083,4.131368517249258,0.0,0.0
4377,0,4377,[318  79  64  98 588],450,5,18088,4.131566925536775,40.0,0.0
4378,0,4378,[202 333 197   4 183],655,1,18089,4.130851792646723,0.0,0.0
4379,0,4379,[568 403 333 273 200],655,2,18091,4.130365296803653,0.0,0.0
4380,0,4380,[323 483 181 151 202],796,4,18095,4.130335539831089,0.0,0.0
4381,0,4381,[318  79  64  98 588],450,5,18100,4.130534002738475,40.0,0.0
4382,0,4382,[168 127 143 405 111],457,4,18104,4.130504220853297,0.0,20.0
4383,0,4383,[118 215  15  64 328],655,1,18105,4.129790145985401,20.0,0.0
4384,0,4384,[ 98 322 300 234 238],504,3,18108,4.1295324971493725,0.0,0.0
4385,0,4385,[318  79  64  98 588],716,5,18113,4.129730962152303,40.0,0.0
4386,0,4386,[  7  98 182 328 245],450,5,18118,4.129929336676544,0.0,0.0
4387,0,4387,[328  11 475 174 265],292,4,18122,4.129899726526891,0.0,0.0
4388,0,4388,[237 483 197 216 202],655,2,18124,4.129414445203919,0.0,0.0
4389,0,4389,[318  79  64  98 588],577,5,18129,4.129612756264237,40.0,0.0
4390,0,4390,[318  79  64  98 588],450,5,18134,4.129810976998406,40.0,0.0
4391,0,4391,[118  98 268 385 275],655,2,18136,4.129326047358834,0.0,20.0
4392,0,4392,[318  79  64  98 588],796,5,18141,4.129524243114045,40.0,0.0
4393,0,4393,[318  79  64  98 588],457,5,18146,4.12972234865726,40.0,0.0
4394,0,4394,[318  79  64  98 588],450,5,18151,4.129920364050057,40.0,0.0
4395,0,4395,[127 405  11 597 273],344,2,18153,4.12943585077343,0.0,20.0
4396,0,4396,[318  79  64  98 588],18,5,18158,4.1296338412554014,40.0,0.0
4397,0,4397,[  9  69 144 258  15],796,4,18162,4.129604365620737,0.0,0.0
4398,0,4398,[328 211 294  88 322],796,2,18164,4.129120254603319,0.0,0.0
4399,0,4399,[318  79  64  98 588],796,5,18169,4.129318181818181,40.0,0.0
4400,0,4400,[318  79  64  98 588],457,5,18174,4.129516019086571,40.0,0.0
4401,0,4401,[318  79  64  98 588],716,5,18179,4.129713766469786,40.0,0.0
4402,0,4402,[318  79  64  98 588],18,5,18184,4.129911424029071,40.0,0.0
4403,0,4403,[282 403  82 301 153],655,0,18184,4.1289736603088105,0.0,0.0
4404,0,4404,[183 197  70 275 132],450,5,18189,4.129171396140749,0.0,20.0
4405,0,4405,[318  79  64  98 588],796,5,18194,4.129369042215161,40.0,0.0
4406,0,4406,[318  79  64  98 588],457,5,18199,4.129566598593147,40.0,0.0
4407,0,4407,[318  79  64  98 588],18,5,18204,4.1297640653357535,40.0,0.0
4408,0,4408,[318  79  64  98 588],796,5,18209,4.129961442503969,40.0,0.0
4409,0,4409,[318  79  64  98 588],18,5,18214,4.130158730158731,40.0,0.0
4410,0,4410,[ 89 215  25 271 471],72,3,18217,4.129902516436182,0.0,0.0
4411,0,4411,[275 196  50 216  96],457,5,18222,4.130099728014506,0.0,40.0
4412,0,4412,[127  82 151  95 385],716,4,18226,4.130070246997508,0.0,20.0
4413,0,4413,[318  79  64  98 588],450,5,18231,4.130267331218849,40.0,0.0
4414,0,4414,[475 257 427 234  64],655,2,18233,4.129784824462061,40.0,0.0
4415,0,4415,[  7 318  50 403  12],693,3,18236,4.129528985507246,20.0,20.0
4416,0,4416,[318  79  64  98 588],716,5,18241,4.129726058410686,40.0,0.0
4417,0,4417,[318  79  64  98 588],716,5,18246,4.129923042100498,40.0,0.0
4418,0,4418,[ 79 210 202 568 204],389,3,18249,4.129667345553292,0.0,0.0
4419,0,4419,[318  79  64  98 588],796,5,18254,4.129864253393666,40.0,0.0
4420,0,4420,[200 202 173 176 174],716,4,18258,4.129834878986655,0.0,0.0
4421,0,4421,[276  98 117 234 143],457,5,18263,4.130031659882406,0.0,0.0
4422,0,4422,[318  79  64  98 588],577,5,18268,4.130228351797423,40.0,0.0
4423,0,4423,[268  82 318 143 603],269,3,18271,4.12997287522604,40.0,0.0
4424,0,4424,[318  79  64  98 588],450,5,18276,4.1301694915254235,40.0,0.0
4425,0,4425,[ 88 185 597 357 181],269,2,18278,4.129688206055129,0.0,0.0
4426,0,4426,[ 56 471 655  95 237],716,4,18282,4.1296589112265645,0.0,0.0
4427,0,4427,[  7 405 181 238 496],786,5,18287,4.129855465221319,20.0,0.0
4428,0,4428,[655 275  25 300 195],450,4,18291,4.129826145856852,0.0,20.0
4429,0,4429,[176 191  56  22  28],655,1,18292,4.129119638826185,0.0,0.0
4430,0,4430,[318  79  64  98 588],18,5,18297,4.129316181448883,40.0,0.0
4431,0,4431,[318  79  64  98 588],716,5,18302,4.129512635379061,40.0,0.0
4432,0,4432,[143 238 423 118 286],151,4,18306,4.129483419806,0.0,20.0
4433,0,4433,[318  79  64  98 588],716,5,18311,4.129679747406405,40.0,0.0
4434,0,4434,[117  22 173 186 210],457,5,18316,4.1298759864712515,0.0,0.0
4435,0,4435,[318  79  64  98 588],457,5,18321,4.130072137060415,40.0,0.0
4436,0,4436,[318  79  64  98 588],716,5,18326,4.130268199233717,40.0,0.0
4437,0,4437,[186  15 194 471 294],457,4,18330,4.130238846327174,0.0,0.0
4438,0,4438,[318  79  64  98 588],18,5,18335,4.130434782608695,40.0,0.0
4439,0,4439,[318  79  64  98 588],457,5,18340,4.13063063063063,40.0,0.0
4440,0,4440,[318  79  64  98 588],796,5,18345,4.130826390452601,40.0,0.0
4441,0,4441,[318  79  64  98 588],716,5,18350,4.131022062134174,40.0,0.0
4442,0,4442,[318  79  64  98 588],18,5,18355,4.131217645734864,40.0,0.0
4443,0,4443,[655 211 423 172 403],269,3,18358,4.130963096309631,0.0,0.0
4444,0,4444,[403  71 323 271 222],796,4,18362,4.130933633295838,0.0,0.0
4445,0,4445,[318  79  64  98 588],457,5,18367,4.131129104813315,40.0,0.0
4446,0,4446,[318  79  64  98 588],716,5,18372,4.131324488419159,40.0,0.0
4447,0,4447,[318  79  64  98 588],577,5,18377,4.131519784172662,40.0,0.0
4448,0,4448,[173 328  22 132 127],450,5,18382,4.131714992133063,0.0,20.0
4449,0,4449,[318  79  64  98 588],796,5,18387,4.1319101123595505,40.0,0.0
4450,0,4450,[318  79  64  98 588],450,5,18392,4.132105144911256,40.0,0.0
4451,0,4451,[176 288 179 568 175],457,5,18397,4.132300089847259,0.0,0.0
4452,0,4452,[318  79  64  98 588],450,5,18402,4.132494947226589,40.0,0.0
4453,0,4453,[181 179 215 176 318],655,2,18404,4.132016165244724,20.0,0.0
4454,0,4454,[174  79 328  69 211],655,1,18405,4.1313131313131315,0.0,0.0
4455,0,4455,[318  79  64  98 588],716,5,18410,4.131508078994614,40.0,0.0
4456,0,4456,[318  79  64  98 588],716,5,18415,4.131702939196769,40.0,0.0
4457,0,4457,[318  79  64  98 588],577,5,18420,4.131897711978466,40.0,0.0
4458,0,4458,[318  79  64  98 588],796,5,18425,4.1320923973985195,40.0,0.0
4459,0,4459,[286  70 173   8 121],535,4,18429,4.132062780269059,0.0,20.0
4460,0,4460,[237 403 222 200 211],450,3,18432,4.131809011432415,0.0,0.0
4461,0,4461,[228  56 237 194 546],457,4,18436,4.131779471089198,0.0,0.0
4462,0,4462,[318  79  64  98 588],577,5,18441,4.131974008514452,40.0,0.0
4463,0,4463,[318  79  64  98 588],450,5,18446,4.132168458781362,40.0,0.0
4464,0,4464,[318  79  64  98 588],796,5,18451,4.1323628219484885,40.0,0.0
4465,0,4465,[318  79  64  98 588],577,5,18456,4.132557098074339,40.0,0.0
4466,0,4466,[318  79  64  98 588],457,5,18461,4.1327512872173715,40.0,0.0
4467,0,4467,[118 258 588 202  71],344,2,18463,4.132273948075201,0.0,0.0
4468,0,4468,[318  79  64  98 588],18,5,18468,4.132468113671963,40.0,0.0
4469,0,4469,[ 22 222 237  56 265],280,3,18471,4.132214765100671,0.0,0.0
4470,0,4470,[318  79  64  98 588],796,5,18476,4.1324088570789534,40.0,0.0
4471,0,4471,[318  79  64  98 588],796,5,18481,4.132602862254025,40.0,0.0
4472,0,4472,[ 96  82 176 173 180],269,0,18481,4.131678962664878,0.0,0.0
4473,0,4473,[435  22 313 328 603],450,5,18486,4.131873044255699,20.0,0.0
4474,0,4474,[  8  96  25 173 597],344,4,18490,4.131843575418994,0.0,0.0
4475,0,4475,[135  70 161 215 168],716,3,18493,4.131590705987489,0.0,0.0
4476,0,4476,[318  79  64  98 588],796,5,18498,4.131784677239223,40.0,0.0
4477,0,4477,[318  79  64  98 588],450,5,18503,4.131978561857973,40.0,0.0
4478,0,4478,[318  79  64  98 588],457,5,18508,4.132172359901764,40.0,0.0
4479,0,4479,[ 70 235  22 568 302],269,0,18508,4.13125,0.0,0.0
4480,0,4480,[318  79  64  98 588],18,5,18513,4.131443874135238,40.0,0.0
4481,0,4481,[222 179   4 228 118],450,2,18515,4.130968317715306,0.0,0.0
4482,0,4482,[191 603 742 258  71],796,4,18519,4.130939103279054,20.0,0.0
4483,0,4483,[100 118 655  56 222],655,0,18519,4.130017841213203,0.0,20.0
4484,0,4484,[515 483 294 100 228],296,4,18523,4.129988851727982,0.0,20.0
4485,0,4485,[318  79  64  98 588],457,5,18528,4.130182790905038,40.0,0.0
4486,0,4486,[423 288 118 202  64],655,1,18529,4.129485179407176,20.0,0.0
4487,0,4487,[275   7 655  98 257],23,3,18532,4.1292335115864525,0.0,20.0
4488,0,4488,[174 471 515 748 357],401,4,18536,4.12920472265538,0.0,0.0
4489,0,4489,[423 210 427 286 357],655,2,18538,4.128730512249443,20.0,20.0
4490,0,4490,[318  79  64  98 588],450,5,18543,4.1289245156980625,40.0,0.0
4491,0,4491,[197 300 180 546 313],693,1,18544,4.128227960819234,0.0,0.0
4492,0,4492,[174 195 211 302 271],655,1,18545,4.127531716002671,0.0,0.0
4493,0,4493,[289 385 265 269 328],655,0,18545,4.126613262127281,0.0,0.0
4494,0,4494,[161 173 187 234 748],450,4,18549,4.126585094549499,0.0,0.0
4495,0,4495,[318  79  64  98 588],577,5,18554,4.126779359430605,40.0,0.0
4496,0,4496,[318  79  64  98 588],457,5,18559,4.126973537914165,40.0,0.0
4497,0,4497,[318  79  64  98 588],577,5,18564,4.127167630057803,40.0,0.0
4498,0,4498,[168  64  95  88   7],577,3,18567,4.126917092687264,20.0,0.0
4499,0,4499,[ 12 144  50 100 181],352,5,18572,4.127111111111111,0.0,40.0
4500,0,4500,[172 273  82  56  15],655,2,18574,4.1266385247722726,0.0,0.0
4501,0,4501,[275 288  22 121  95],450,2,18576,4.126166148378498,0.0,20.0
4502,0,4502,[318  79  64  98 588],18,5,18581,4.126360204308239,40.0,0.0
4503,0,4503,[568 427 172 181 121],577,4,18585,4.12633214920071,20.0,0.0
4504,0,4504,[385 471 483 748 117],807,5,18590,4.126526082130965,0.0,0.0
4505,0,4505,[318  79  64  98 588],457,5,18595,4.126719928983578,40.0,0.0
4506,0,4506,[323 127 173 204 186],796,3,18598,4.1264699356556465,0.0,20.0
4507,0,4507,[216   8 301 151 603],389,4,18602,4.126441881100266,20.0,0.0
4508,0,4508,[318  79  64  98 588],577,5,18607,4.126635617653582,40.0,0.0
4509,0,4509,[318  79  64  98 588],450,5,18612,4.126829268292683,40.0,0.0
4510,0,4510,[318  79  64  98 588],716,5,18617,4.127022833074706,40.0,0.0
4511,0,4511,[180 100 275  56 200],450,4,18621,4.126994680851064,0.0,40.0
4512,0,4512,[322  70 301  15 111],450,4,18625,4.126966541103479,0.0,0.0
4513,0,4513,[ 79 172  12 196 257],457,4,18629,4.12693841382366,0.0,0.0
4514,0,4514,[318  79  64  98 588],716,5,18634,4.127131782945736,40.0,0.0
4515,0,4515,[318  79  64  98 588],577,5,18639,4.127325066430469,40.0,0.0
4516,0,4516,[318  79  64  98 588],18,5,18644,4.127518264334736,40.0,0.0
4517,0,4517,[286 181 405  89 144],655,1,18645,4.126826029216468,0.0,20.0
4518,0,4518,[318  79  64  98 588],716,5,18650,4.127019252046913,40.0,0.0
4519,0,4519,[318  79  64  98 588],716,5,18655,4.127212389380531,40.0,0.0
4520,0,4520,[318  79  64  98 588],457,5,18660,4.127405441274054,40.0,0.0
4521,0,4521,[318  79  64  98 588],457,5,18665,4.127598407784166,40.0,0.0
4522,0,4522,[318  79  64  98 588],457,5,18670,4.127791288967499,40.0,0.0
4523,0,4523,[257 588 144 196 211],796,4,18674,4.127763041556145,0.0,0.0
4524,0,4524,[318  79  64  98 588],457,5,18679,4.127955801104973,40.0,0.0
4525,0,4525,[185 294   7  88 471],655,1,18680,4.12726469288555,0.0,0.0
4526,0,4526,[318  79  64  98 588],18,5,18685,4.127457477358074,40.0,0.0
4527,0,4527,[318  79  64  98 588],457,5,18690,4.127650176678445,40.0,0.0
4528,0,4528,[191 200 228 742 258],457,5,18695,4.1278427909030695,0.0,0.0
4529,0,4529,[  4 328  56 288 179],450,3,18698,4.127593818984548,0.0,0.0
4530,0,4530,[318  79  64  98 588],577,5,18703,4.127786360626793,40.0,0.0
4531,0,4531,[202 235 125 132 210],457,4,18707,4.1277581641659316,0.0,0.0
4532,0,4532,[318  79  64  98 588],796,5,18712,4.127950584601809,40.0,0.0
4533,0,4533,[211 385  96 185 403],655,1,18713,4.12726069695633,0.0,0.0
4534,0,4534,[194 238 111 195 568],269,2,18715,4.126791620727674,0.0,0.0
4535,0,4535,[210 265 302  28  12],655,1,18716,4.12610229276896,0.0,0.0
4536,0,4536,[318  79  64  98 588],577,5,18721,4.126294908529865,40.0,0.0
4537,0,4537,[318  79  64  98 588],457,5,18726,4.126487439400617,40.0,0.0
4538,0,4538,[603 435  70 197  50],716,5,18731,4.126679885437321,20.0,20.0
4539,0,4539,[318  79  64  98 588],716,5,18736,4.126872246696035,40.0,0.0
4540,0,4540,[313 200 302 215 385],655,3,18739,4.126624091609777,0.0,0.0
4541,0,4541,[191 153 269 174 175],23,4,18743,4.126596213121973,0.0,0.0
4542,0,4542,[313  82 161 172 197],796,3,18746,4.126348228043144,0.0,0.0
4543,0,4543,[318  79  64  98 588],457,5,18751,4.126540492957746,40.0,0.0
4544,0,4544,[ 95 210 275 228  28],716,5,18756,4.126732673267327,0.0,20.0
4545,0,4545,[318  79  64  98 588],18,5,18761,4.126924769027717,40.0,0.0
4546,0,4546,[318  79  64  98 588],450,5,18766,4.1271167802947,40.0,0.0
4547,0,4547,[318  79  64  98 588],450,5,18771,4.12730870712401,40.0,0.0
4548,0,4548,[318  79  64  98 588],457,5,18776,4.127500549571335,40.0,0.0
4549,0,4549,[180 423 216  69 135],693,2,18778,4.127032967032967,0.0,0.0
4550,0,4550,[ 50 143 196 211 276],269,2,18780,4.126565589980224,0.0,20.0
4551,0,4551,[210 427 328 423  79],796,4,18784,4.126537785588752,20.0,0.0
4552,0,4552,[318  79  64  98 588],577,5,18789,4.1267296288161655,40.0,0.0
4553,0,4553,[258 289 182 222 172],655,2,18791,4.126262626262626,0.0,0.0
4554,0,4554,[ 15   4  98 179 174],457,5,18796,4.1264544456641055,0.0,0.0
4555,0,4555,[ 95 204 127  22  64],716,5,18801,4.126646180860404,20.0,20.0
4556,0,4556,[301  89 427 276 127],655,4,18805,4.126618389291201,20.0,20.0
4557,0,4557,[318  79  64  98 588],716,5,18810,4.126810004387889,40.0,0.0
4558,0,4558,[318  79  64  98 588],796,5,18815,4.127001535424435,40.0,0.0
4559,0,4559,[318  79  64  98 588],450,5,18820,4.12719298245614,40.0,0.0
4560,0,4560,[318  79  64  98 588],577,5,18825,4.1273843455382595,40.0,0.0
4561,0,4561,[318  79  64  98 588],450,5,18830,4.127575624725997,40.0,0.0
4562,0,4562,[318  79  64  98 588],577,5,18835,4.127766820074513,40.0,0.0
4563,0,4563,[318  79  64  98 588],716,5,18840,4.127957931638913,40.0,0.0
4564,0,4564,[121 237 333 427 181],796,5,18845,4.12814895947426,20.0,0.0
4565,0,4565,[ 97 185 483 183 117],796,4,18849,4.128120893561104,0.0,0.0
4566,0,4566,[175 385   9 132 471],457,5,18854,4.128311802058244,0.0,0.0
4567,0,4567,[ 96 405 294  28 238],796,2,18856,4.12784588441331,0.0,0.0
4568,0,4568,[318  79  64  98 588],18,5,18861,4.128036769533815,40.0,0.0
4569,0,4569,[318  79  64  98 588],18,5,18866,4.128227571115974,40.0,0.0
4570,0,4570,[318  79  64  98 588],716,5,18871,4.128418289214614,40.0,0.0
4571,0,4571,[333 286 222 385 125],796,4,18875,4.128390201224847,0.0,20.0
4572,0,4572,[318  79  64  98 588],18,5,18880,4.12858080034988,40.0,0.0
4573,0,4573,[117 748  15 403 161],450,4,18884,4.128552689112374,0.0,0.0
4574,0,4574,[127 191 427   7   9],296,5,18889,4.128743169398907,20.0,20.0
4575,0,4575,[318  79  64  98 588],577,5,18894,4.128933566433567,40.0,0.0
4576,0,4576,[182 111   8  22 151],269,2,18896,4.128468429102032,0.0,0.0
4577,0,4577,[125  15   9 197 276],457,5,18901,4.12865880297073,0.0,0.0
4578,0,4578,[161 273  89  88 196],796,4,18905,4.128630705394191,0.0,0.0
4579,0,4579,[318  79  64  98 588],457,5,18910,4.12882096069869,40.0,0.0
4580,0,4580,[282 182 181 194 173],535,3,18913,4.12857454704213,0.0,0.0
4581,0,4581,[318  79  64  98 588],450,5,18918,4.128764731558271,40.0,0.0
4582,0,4582,[318  79  64  98 588],457,5,18923,4.12895483307877,40.0,0.0
4583,0,4583,[318  79  64  98 588],457,5,18928,4.129144851657941,40.0,0.0
4584,0,4584,[ 64 655 191 151 294],577,5,18933,4.1293347873500545,20.0,0.0
4585,0,4585,[318  79  64  98 588],577,5,18938,4.129524640209333,40.0,0.0
4586,0,4586,[ 69  95 181 151 215],577,5,18943,4.1297144102899495,0.0,0.0
4587,0,4587,[318  79  64  98 588],450,5,18948,4.129904097646033,40.0,0.0
4588,0,4588,[483 427 286  28 179],639,4,18952,4.129875789932447,20.0,20.0
4589,0,4589,[318  79  64  98 588],577,5,18957,4.130065359477125,40.0,0.0
4590,0,4590,[318  79  64  98 588],457,5,18962,4.130254846438684,40.0,0.0
4591,0,4591,[100 185 294  50  11],450,5,18967,4.13044425087108,0.0,40.0
4592,0,4592,[322 588 300 216 202],796,4,18971,4.130415850206837,0.0,0.0
4593,0,4593,[515   9 194 195  56],72,5,18976,4.130605137135394,0.0,0.0
4594,0,4594,[168  28 196 603 318],716,5,18981,4.130794341675735,40.0,0.0
4595,0,4595,[318  79  64  98 588],450,5,18986,4.130983463881636,40.0,0.0
4596,0,4596,[318  79  64  98 588],18,5,18991,4.13117250380683,40.0,0.0
4597,0,4597,[318  79  64  98 588],577,5,18996,4.131361461505002,40.0,0.0
4598,0,4598,[118  98 294 100  25],457,4,19000,4.131332898456186,0.0,20.0
4599,0,4599,[748 313 423 234 125],280,1,19001,4.1306521739130435,0.0,0.0
4600,0,4600,[318  79  64  98 588],450,5,19006,4.130841121495327,40.0,0.0
4601,0,4601,[ 96  56  88 194 132],796,5,19011,4.13102998696219,0.0,0.0
4602,0,4602,[144 186 182  79   4],655,2,19013,4.130567021507712,0.0,0.0
4603,0,4603,[318  79  64  98 588],716,5,19018,4.130755864465682,40.0,0.0
4604,0,4604,[125 258 357  97 196],796,4,19022,4.130727470141151,0.0,0.0
4605,0,4605,[318  79  64  98 588],577,5,19027,4.130916196265741,40.0,0.0
4606,0,4606,[318  79  64  98 588],796,5,19032,4.13110484046017,40.0,0.0
4607,0,4607,[228 127 125 172 471],256,3,19035,4.130859375,0.0,20.0
4608,0,4608,[318  79  64  98 588],796,5,19040,4.131047949663701,40.0,0.0
4609,0,4609,[ 12  22 180 197  95],18,5,19045,4.131236442516269,0.0,0.0
4610,0,4610,[183 228  50  70 172],655,3,19048,4.130991108219475,0.0,20.0
4611,0,4611,[318  79  64  98 588],457,5,19053,4.1311795316565485,40.0,0.0
4612,0,4612,[ 97   4 289 300 275],655,1,19054,4.130500758725342,0.0,20.0
4613,0,4613,[318  79  64  98 588],450,5,19059,4.130689206762028,40.0,0.0
4614,0,4614,[483 168 475 238 204],269,4,19063,4.130660888407367,0.0,0.0
4615,0,4615,[318  79  64  98 588],716,5,19068,4.130849220103986,40.0,0.0
4616,0,4616,[318  79  64  98 588],577,5,19073,4.1310374702187564,40.0,0.0
4617,0,4617,[318  79  64  98 588],457,5,19078,4.131225638804677,40.0,0.0
4618,0,4618,[318  79  64  98 588],18,5,19083,4.1314137259147,40.0,0.0
4619,0,4619,[135 655 228 471  98],457,5,19088,4.131601731601732,0.0,0.0
4620,0,4620,[ 11  82  28  70 111],716,5,19093,4.131789655918633,0.0,0.0
4621,0,4621,[ 89 234   4 294   7],450,3,19096,4.13154478580701,0.0,0.0
4622,0,4622,[328  22  64   4 153],629,3,19099,4.131300021630976,20.0,0.0
4623,0,4623,[318  79  64  98 588],450,5,19104,4.131487889273356,40.0,0.0
4624,0,4624,[318  79  64  98 588],796,5,19109,4.131675675675676,40.0,0.0
4625,0,4625,[318  79  64  98 588],577,5,19114,4.131863380890619,40.0,0.0
4626,0,4626,[318  79  64  98 588],716,5,19119,4.1320510049708234,40.0,0.0
4627,0,4627,[405 483 273  69 216],655,3,19122,4.131806395851339,0.0,0.0
4628,0,4628,[ 79 215   9  28 237],11,4,19126,4.131777921797364,0.0,0.0
4629,0,4629,[245  50 568  69  98],593,4,19130,4.1317494600431965,0.0,20.0
4630,0,4630,[318  79  64  98 588],796,5,19135,4.131936946663788,40.0,0.0
4631,0,4631,[215 302 276 313 185],655,4,19139,4.131908462867012,0.0,0.0
4632,0,4632,[318  79  64  98 588],716,5,19144,4.132095834232679,40.0,0.0
4633,0,4633,[143 282 202 286 748],450,5,19149,4.132283124730255,0.0,20.0
4634,0,4634,[234 385 322 275 182],796,3,19152,4.132038834951456,0.0,20.0
4635,0,4635,[  8 471 195 127  70],457,5,19157,4.132226056945643,0.0,20.0
4636,0,4636,[318  79  64  98 588],796,5,19162,4.132413198188484,40.0,0.0
4637,0,4637,[210   1 197 313 153],280,2,19164,4.131953428201811,0.0,0.0
4638,0,4638,[318  79  64  98 588],716,5,19169,4.132140547531796,40.0,0.0
4639,0,4639,[ 82 127 196 172 385],457,5,19174,4.132327586206896,0.0,20.0
4640,0,4640,[ 82 180  71 127   8],280,4,19178,4.1322990734755445,0.0,20.0
4641,0,4641,[202 174  96 228 176],457,5,19183,4.132485997414907,0.0,0.0
4642,0,4642,[318  79  64  98 588],18,5,19188,4.132672840835666,40.0,0.0
4643,0,4643,[176  97   1 173 111],796,3,19191,4.1324289405684755,0.0,0.0
4644,0,4644,[318  79  64  98 588],796,5,19196,4.132615715823466,40.0,0.0
4645,0,4645,[318  79  64  98 588],450,5,19201,4.1328024106758505,40.0,0.0
4646,0,4646,[318  79  64  98 588],457,5,19206,4.132989025177534,40.0,0.0
4647,0,4647,[318  79  64  98 588],18,5,19211,4.133175559380379,40.0,0.0
4648,0,4648,[318  79  64  98 588],450,5,19216,4.1333620133362015,40.0,0.0
4649,0,4649,[132 181 143 588 117],807,5,19221,4.133548387096774,0.0,0.0
4650,0,4650,[ 79 204 211 508 117],296,4,19225,4.1335196731885615,0.0,0.0
4651,0,4651,[508 271  50 282 403],655,1,19226,4.1328460877042135,0.0,20.0
4652,0,4652,[318  79  64  98 588],457,5,19231,4.133032452181388,40.0,0.0
4653,0,4653,[318  79  64  98 588],577,5,19236,4.133218736570692,40.0,0.0
4654,0,4654,[187 100 195   4 168],504,4,19240,4.133190118152524,0.0,20.0
4655,0,4655,[318  79  64  98 588],457,5,19245,4.133376288659794,40.0,0.0
4656,0,4656,[318  79  64  98 588],450,5,19250,4.133562379214086,40.0,0.0
4657,0,4657,[211 144 161 216 195],23,3,19253,4.133319021039073,0.0,0.0
4658,0,4658,[210 127 603 204 328],655,2,19255,4.132861128997639,20.0,20.0
4659,0,4659,[318  79  64  98 588],457,5,19260,4.133047210300429,40.0,0.0
4660,0,4660,[168 286 313  71 742],450,4,19264,4.13301866552242,0.0,20.0
4661,0,4661,[318  79  64  98 588],716,5,19269,4.133204633204633,40.0,0.0
4662,0,4662,[318  79  64  98 588],716,5,19274,4.13339052112374,40.0,0.0
4663,0,4663,[318  79  64  98 588],450,5,19279,4.133576329331047,40.0,0.0
4664,0,4664,[318  79  64  98 588],577,5,19284,4.133762057877814,40.0,0.0
4665,0,4665,[286  88 333 197 300],655,0,19284,4.132876125160737,0.0,20.0
4666,0,4666,[210 179   8 357 301],593,3,19287,4.132633383329762,0.0,0.0
4667,0,4667,[318  79  64  98 588],716,5,19292,4.132819194515853,40.0,0.0
4668,0,4668,[318  79  64  98 588],18,5,19297,4.1330049261083746,40.0,0.0
4669,0,4669,[318  79  64  98 588],716,5,19302,4.133190578158458,40.0,0.0
4670,0,4670,[318  79  64  98 588],18,5,19307,4.133376150717191,40.0,0.0
4671,0,4671,[  9  64 273   8 268],655,2,19309,4.132919520547945,20.0,0.0
4672,0,4672,[275 176   1 172 187],716,3,19312,4.132677081104216,0.0,20.0
4673,0,4673,[215  79 357  28 202],151,4,19316,4.132648694908002,0.0,0.0
4674,0,4674,[180  97 603  70 496],450,5,19321,4.1328342245989305,40.0,0.0
4675,0,4675,[183   7 313 265 237],577,4,19325,4.1328058169375534,0.0,0.0
4676,0,4676,[508 238 174 121 195],535,5,19330,4.132991233696814,0.0,0.0
4677,0,4677,[191 118  82 183 216],457,5,19335,4.133176571184267,0.0,0.0
4678,0,4678,[475 195 357 161 143],655,2,19337,4.132720666809147,0.0,0.0
4679,0,4679,[151  95 742 238 135],450,3,19340,4.132478632478633,0.0,0.0
4680,0,4680,[245  22  97 275  95],756,0,19340,4.1315958128605,0.0,20.0
4681,0,4681,[318  79  64  98 588],457,5,19345,4.131781290046988,40.0,0.0
4682,0,4682,[294 176 271 568  79],796,4,19349,4.131753149690369,0.0,0.0
4683,0,4683,[318  79  64  98 588],577,5,19354,4.131938514090521,40.0,0.0
4684,0,4684,[318  79  64  98 588],457,5,19359,4.1321237993596585,40.0,0.0
4685,0,4685,[318  79  64  98 588],450,5,19364,4.132309005548442,40.0,0.0
4686,0,4686,[318  79  64  98 588],18,5,19369,4.132494132707489,40.0,0.0
4687,0,4687,[318  79  64  98 588],450,5,19374,4.132679180887372,40.0,0.0
4688,0,4688,[286 200  69 655   1],786,5,19379,4.132864150138622,0.0,20.0
4689,0,4689,[318  79  64  98 588],457,5,19384,4.133049040511727,40.0,0.0
4690,0,4690,[174 603 135  98 288],655,3,19387,4.132807503730548,20.0,0.0
4691,0,4691,[318  79  64  98 588],796,5,19392,4.132992327365729,40.0,0.0
4692,0,4692,[300   9 135 132  15],629,5,19397,4.133177072235244,0.0,0.0
4693,0,4693,[318  79  64  98 588],577,5,19402,4.133361738389433,40.0,0.0
4694,0,4694,[435 172 173  25 216],389,2,19404,4.132907348242812,0.0,0.0
4695,0,4695,[175  11  79 333 176],421,3,19407,4.132666098807496,0.0,0.0
4696,0,4696,[ 64 187   1 222 301],450,4,19411,4.132637853949329,20.0,0.0
4697,0,4697,[588 288   4 403 118],450,2,19413,4.132183908045977,0.0,0.0
4698,0,4698,[588 435  88 258 238],450,5,19418,4.132368589061502,0.0,0.0
4699,0,4699,[496 742 508 546 245],344,2,19420,4.131914893617021,20.0,0.0
4700,0,4700,[ 12  64 195 182   9],629,5,19425,4.132099553286535,20.0,0.0
4701,0,4701,[191 117 186 127 143],796,4,19429,4.132071458953637,0.0,20.0
4702,0,4702,[318  79  64  98 588],796,5,19434,4.132256006804168,40.0,0.0
4703,0,4703,[318  79  64  98 588],450,5,19439,4.132440476190476,40.0,0.0
4704,0,4704,[318  79  64  98 588],577,5,19444,4.132624867162593,40.0,0.0
4705,0,4705,[318  79  64  98 588],450,5,19449,4.132809179770506,40.0,0.0
4706,0,4706,[318  79  64  98 588],716,5,19454,4.13299341406416,40.0,0.0
4707,0,4707,[  9 179 182  56 313],655,3,19457,4.132752761257434,0.0,0.0
4708,0,4708,[318  79  64  98 588],450,5,19462,4.132936929284349,40.0,0.0
4709,0,4709,[318  79  64  98 588],18,5,19467,4.13312101910828,40.0,0.0
4710,0,4710,[318  79  64  98 588],457,5,19472,4.133305030779028,40.0,0.0
4711,0,4711,[210 423 597 200  97],796,3,19475,4.133064516129032,0.0,0.0
4712,0,4712,[ 22 257 196  28  56],716,5,19480,4.133248461701676,0.0,0.0
4713,0,4713,[318  79  64  98 588],577,5,19485,4.1334323292320745,40.0,0.0
4714,0,4714,[  1 185 475 200 132],655,2,19487,4.1329798515376455,0.0,0.0
4715,0,4715,[322  12 183 294  71],796,3,19490,4.132739609838847,0.0,0.0
4716,0,4716,[318  79  64  98 588],457,5,19495,4.132923468306127,40.0,0.0
4717,0,4717,[ 50   9  71 111 191],786,5,19500,4.133107248834252,0.0,20.0
4718,0,4718,[ 22 153 135 258 288],629,5,19505,4.13329095147277,0.0,0.0
4719,0,4719,[318  79  64  98 588],450,5,19510,4.133474576271187,40.0,0.0
4720,0,4720,[318  79  64  98 588],18,5,19515,4.133658123278966,40.0,0.0
4721,0,4721,[202 385 172  25  64],330,5,19520,4.133841592545531,20.0,0.0
4722,0,4722,[318  79  64  98 588],796,5,19525,4.134024984120263,40.0,0.0
4723,0,4723,[318  79  64  98 588],796,5,19530,4.1342082980524975,40.0,0.0
4724,0,4724,[742 288 289  69 187],655,1,19531,4.133544973544973,0.0,0.0
4725,0,4725,[318  79  64  98 588],577,5,19536,4.133728311468472,40.0,0.0
4726,0,4726,[318  79  64  98 588],577,5,19541,4.133911571821451,40.0,0.0
4727,0,4727,[318  79  64  98 588],457,5,19546,4.13409475465313,40.0,0.0
4728,0,4728,[175 204 423  96 427],269,3,19549,4.133854937618947,20.0,0.0
4729,0,4729,[210  69 276 603 168],18,2,19551,4.133403805496829,20.0,0.0
4730,0,4730,[ 56 125 282 515 181],292,4,19555,4.133375607693933,0.0,0.0
4731,0,4731,[318  79  64  98 588],18,5,19560,4.133558748943364,40.0,0.0
4732,0,4732,[318  79  64  98 588],18,5,19565,4.133741812803718,40.0,0.0
4733,0,4733,[318  79  64  98 588],450,5,19570,4.1339247993240384,40.0,0.0
4734,0,4734,[318  79  64  98 588],796,5,19575,4.134107708553326,40.0,0.0
4735,0,4735,[180 161 194 168 174],450,5,19580,4.13429054054054,0.0,0.0
4736,0,4736,[202  97 275 483 191],457,5,19585,4.1344732953346,0.0,20.0
4737,0,4737,[318  79  64  98 588],450,5,19590,4.1346559729843815,40.0,0.0
4738,0,4738,[275   4 655 186 204],786,5,19595,4.134838573538722,0.0,20.0
4739,0,4739,[237 121  50 135 168],457,5,19600,4.135021097046414,0.0,20.0
4740,0,4740,[215  25 175  82 183],716,3,19603,4.134781691626239,0.0,0.0
4741,0,4741,[318  79  64  98 588],457,5,19608,4.134964150147617,40.0,0.0
4742,0,4742,[202 174  79  71  70],18,4,19612,4.134935694707991,0.0,0.0
4743,0,4743,[318  79  64  98 588],796,5,19617,4.135118043844857,40.0,0.0
4744,0,4744,[197 175 204  97 179],18,4,19621,4.13508956796628,0.0,0.0
4745,0,4745,[318  79  64  98 588],18,5,19626,4.13527180783818,40.0,0.0
4746,0,4746,[318  79  64  98 588],457,5,19631,4.1354539709290075,40.0,0.0
4747,0,4747,[  9  56 183 143 568],655,2,19633,4.135004212299916,0.0,0.0
4748,0,4748,[385 118 111 121  11],450,3,19636,4.134765213729207,0.0,0.0
4749,0,4749,[238 151 144  11 313],296,4,19640,4.134736842105263,0.0,0.0
4750,0,4750,[318  79  64  98 588],577,5,19645,4.134918964428541,40.0,0.0
4751,0,4751,[318  79  64  98 588],18,5,19650,4.13510101010101,40.0,0.0
4752,0,4752,[ 88 471 195 185  11],716,3,19653,4.1348621922996,0.0,0.0
4753,0,4753,[211 183 222  50 245],796,3,19656,4.134623474968448,0.0,20.0
4754,0,4754,[318  79  64  98 588],716,5,19661,4.134805467928496,40.0,0.0
4755,0,4755,[318  79  64  98 588],450,5,19666,4.134987384356602,40.0,0.0
4756,0,4756,[194 269 228 127 258],296,5,19671,4.13516922430103,0.0,20.0
4757,0,4757,[194 597  88 238 328],796,4,19675,4.135140815468684,0.0,0.0
4758,0,4758,[655 194  22 286 288],450,4,19679,4.135112418575331,0.0,20.0
4759,0,4759,[318  79  64  98 588],18,5,19684,4.135294117647059,40.0,0.0
4760,0,4760,[135 265 197 195  56],450,4,19688,4.1352657004830915,0.0,0.0
4761,0,4761,[427 172  56 194 271],72,3,19691,4.135027299454011,20.0,0.0
4762,0,4762,[200 211 168 143 180],18,3,19694,4.134788998530338,0.0,0.0
4763,0,4763,[318  79  64  98 588],450,5,19699,4.134970612930311,40.0,0.0
4764,0,4764,[318  79  64  98 588],457,5,19704,4.135152151101784,40.0,0.0
4765,0,4765,[100 200 172 322 186],796,2,19706,4.134704154427193,0.0,20.0
4766,0,4766,[191 322  95  88 210],786,4,19710,4.1346758967904345,0.0,0.0
4767,0,4767,[603  97 211  12 238],18,4,19714,4.134647651006712,20.0,0.0
4768,0,4768,[318  79  64  98 588],18,5,19719,4.134829104634095,40.0,0.0
4769,0,4769,[318  79  64  98 588],577,5,19724,4.135010482180293,40.0,0.0
4770,0,4770,[245 678 322 237 127],280,2,19726,4.134562984699224,0.0,20.0
4771,0,4771,[496  88 187 204 153],389,3,19729,4.134325230511316,20.0,0.0
4772,0,4772,[318  79  64  98 588],457,5,19734,4.1345065996228785,40.0,0.0
4773,0,4773,[275 196 385 175 210],457,5,19739,4.1346878927524084,0.0,20.0
4774,0,4774,[318  79  64  98 588],18,5,19744,4.134869109947644,40.0,0.0
4775,0,4775,[568 471 175 318 257],716,3,19747,4.13463149078727,20.0,0.0
4776,0,4776,[318  79  64  98 588],450,5,19752,4.134812643918777,40.0,0.0
4777,0,4777,[405 197 196 234 174],786,3,19755,4.134575136040184,0.0,0.0
4778,0,4778,[603 204 179  11 175],269,3,19758,4.134337727558067,20.0,0.0
4779,0,4779,[174 143 237 173 265],786,5,19763,4.134518828451883,0.0,0.0
4780,0,4780,[313 186 496 173 228],911,3,19766,4.134281531060448,20.0,0.0
4781,0,4781,[318  79  64  98 588],796,5,19771,4.134462567963196,40.0,0.0
4782,0,4782,[318  79  64  98 588],796,5,19776,4.134643529165795,40.0,0.0
4783,0,4783,[151 385  64 174  98],344,4,19780,4.134615384615385,20.0,0.0
4784,0,4784,[234 197 275  97 153],151,4,19784,4.1345872518286315,0.0,20.0
4785,0,4785,[215 179 200 161 125],457,5,19789,4.134768073547848,0.0,0.0
4786,0,4786,[318  79  64  98 588],18,5,19794,4.134948819720075,40.0,0.0
4787,0,4787,[318  79  64  98 588],796,5,19799,4.135129490392648,40.0,0.0
4788,0,4788,[318  79  64  98 588],796,5,19804,4.135310085612863,40.0,0.0
4789,0,4789,[  7 427 204 100  50],655,2,19806,4.134864300626305,20.0,40.0
4790,0,4790,[182 237 276 265 234],655,2,19808,4.1344187017324145,0.0,0.0
4791,0,4791,[318  79  64  98 588],577,5,19813,4.134599332220367,40.0,0.0
4792,0,4792,[318  79  64  98 588],450,5,19818,4.134779887335698,40.0,0.0
4793,0,4793,[181 427 168 151 194],577,5,19823,4.134960367125574,20.0,0.0
4794,0,4794,[318  79  64  98 588],577,5,19828,4.135140771637122,40.0,0.0
4795,0,4795,[ 69 183  64 258 294],655,2,19830,4.1346955796497085,20.0,0.0
4796,0,4796,[ 56  50  98 161 117],655,2,19832,4.134250573274963,0.0,20.0
4797,0,4797,[235 568   9 323 181],256,4,19836,4.134222592746978,0.0,0.0
4798,0,4798,[318  79  64  98 588],18,5,19841,4.13440300062513,40.0,0.0
4799,0,4799,[168 196  56 180 742],11,2,19843,4.133958333333333,0.0,0.0
4800,0,4800,[318  79  64  98 588],716,5,19848,4.134138721099771,40.0,0.0
4801,0,4801,[318  79  64  98 588],796,5,19853,4.1343190337359434,40.0,0.0
4802,0,4802,[153 471 144 196 282],593,4,19857,4.134291068082448,0.0,0.0
4803,0,4803,[ 22 132 135 216 238],330,4,19861,4.134263114071607,0.0,0.0
4804,0,4804,[318  79  64  98 588],796,5,19866,4.134443288241415,40.0,0.0
4805,0,4805,[318  79  64  98 588],457,5,19871,4.134623387432376,40.0,0.0
4806,0,4806,[318  79  64  98 588],796,5,19876,4.1348034116912835,40.0,0.0
4807,0,4807,[318  79  64  98 588],716,5,19881,4.134983361064892,40.0,0.0
4808,0,4808,[318  79  64  98 588],716,5,19886,4.135163235599917,40.0,0.0
4809,0,4809,[ 69 483 197 318 173],796,4,19890,4.135135135135135,20.0,0.0
4810,0,4810,[215 153 313 265 294],655,1,19891,4.134483475368946,0.0,0.0
4811,0,4811,[228 125 210 269 333],796,3,19894,4.134247714048213,0.0,0.0
4812,0,4812,[197  56 228 475  11],292,5,19899,4.1344275919385,0.0,0.0
4813,0,4813,[318  79  64  98 588],450,5,19904,4.134607395097632,40.0,0.0
4814,0,4814,[111 282 300 435 204],450,5,19909,4.1347871235721705,0.0,0.0
4815,0,4815,[603  82  79 357 273],450,3,19912,4.134551495016611,20.0,0.0
4816,0,4816,[318  79  64  98 588],450,5,19917,4.134731160473324,40.0,0.0
4817,0,4817,[ 15 211 153   7  28],450,4,19921,4.134703196347032,0.0,0.0
4818,0,4818,[127 357  25 238   9],457,5,19926,4.134882755758456,0.0,20.0
4819,0,4819,[276  69 318 216 237],593,4,19930,4.134854771784233,20.0,0.0
4820,0,4820,[318  79  64  98 588],18,5,19935,4.135034225264468,40.0,0.0
4821,0,4821,[318  79  64  98 588],577,5,19940,4.135213604313563,40.0,0.0
4822,0,4822,[111 423 186 143 196],18,3,19943,4.134978229317852,0.0,0.0
4823,0,4823,[318  79  64  98 588],796,5,19948,4.135157545605307,40.0,0.0
4824,0,4824,[318  79  64  98 588],577,5,19953,4.135336787564767,40.0,0.0
4825,0,4825,[318  79  64  98 588],796,5,19958,4.135515955242437,40.0,0.0
4826,0,4826,[294 276 322 286 191],224,2,19960,4.1350735446447064,0.0,20.0
4827,0,4827,[237  25 200 161   8],457,5,19965,4.135252692626346,0.0,0.0
4828,0,4828,[197  98  28 194  56],504,3,19968,4.13501760198799,0.0,0.0
4829,0,4829,[318  79  64  98 588],796,5,19973,4.1351966873706,40.0,0.0
4830,0,4830,[318  79  64  98 588],796,5,19978,4.135375698613124,40.0,0.0
4831,0,4831,[318  79  64  98 588],796,5,19983,4.135554635761589,40.0,0.0
4832,0,4832,[294 187 742  88 483],450,4,19987,4.1355265880405545,0.0,0.0
4833,0,4833,[318  79  64  98 588],577,5,19992,4.135705419942077,40.0,0.0
4834,0,4834,[318  79  64  98 588],450,5,19997,4.1358841778697,40.0,0.0
4835,0,4835,[318  79  64  98 588],796,5,20002,4.136062861869314,40.0,0.0
4836,0,4836,[318  79  64  98 588],450,5,20007,4.136241471986769,40.0,0.0
4837,0,4837,[597 269  97 118 273],344,2,20009,4.135799917321207,0.0,0.0
4838,0,4838,[328 275 174 216 742],450,5,20014,4.13597850795619,0.0,20.0
4839,0,4839,[235  50  79 748  88],450,4,20018,4.13595041322314,0.0,20.0
4840,0,4840,[322 265 191 172 125],450,5,20023,4.136128898987812,0.0,0.0
4841,0,4841,[318  79  64  98 588],716,5,20028,4.1363073110285,40.0,0.0
4842,0,4842,[318  79  64  98 588],796,5,20033,4.136485649390873,40.0,0.0
4843,0,4843,[  1 173 180 144 318],457,5,20038,4.136663914120562,20.0,0.0
4844,0,4844,[318  79  64  98 588],577,5,20043,4.136842105263158,40.0,0.0
4845,0,4845,[318  79  64  98 588],796,5,20048,4.137020222864218,40.0,0.0
4846,0,4846,[403 323 286 322 174],280,2,20050,4.136579327419022,0.0,20.0
4847,0,4847,[318  79  64  98 588],796,5,20055,4.136757425742574,40.0,0.0
4848,0,4848,[318  79  64  98 588],457,5,20060,4.136935450608373,40.0,0.0
4849,0,4849,[ 25 300  89 211 161],655,1,20061,4.136288659793815,0.0,0.0
4850,0,4850,[318  79  64  98 588],457,5,20066,4.13646670789528,40.0,0.0
4851,0,4851,[318  79  64  98 588],577,5,20071,4.1366446826051115,40.0,0.0
4852,0,4852,[234 258  96 427  56],450,4,20075,4.136616525860292,20.0,0.0
4853,0,4853,[318  79  64  98 588],450,5,20080,4.136794396374125,40.0,0.0
4854,0,4854,[ 69  71 132 273 191],450,3,20083,4.136560247167868,0.0,0.0
4855,0,4855,[405 176 202 237  11],280,1,20084,4.135914332784185,0.0,0.0
4856,0,4856,[ 50  12 568  88 273],450,4,20088,4.135886349598517,0.0,20.0
4857,0,4857,[385 234 678  50 423],280,2,20090,4.1354466858789625,0.0,20.0
4858,0,4858,[191 603 568 194 234],269,3,20093,4.1352130067915205,20.0,0.0
4859,0,4859,[222 546 655 183  98],280,2,20095,4.13477366255144,0.0,0.0
4860,0,4860,[ 79 222 216 127 186],623,4,20099,4.134745937049989,0.0,20.0
4861,0,4861,[318  79  64  98 588],450,5,20104,4.134923899629782,40.0,0.0
4862,0,4862,[210 118 269 191 186],796,2,20106,4.134484885872918,0.0,0.0
4863,0,4863,[403  15  50 238 174],18,4,20110,4.134457236842105,0.0,20.0
4864,0,4864,[318  79  64  98 588],18,5,20115,4.134635149023638,40.0,0.0
4865,0,4865,[222 235 403 294 117],457,3,20118,4.134401972872996,0.0,0.0
4866,0,4866,[288 215 174 194  70],504,3,20121,4.134168892541607,0.0,0.0
4867,0,4867,[ 96   7 275  95  79],344,5,20126,4.134346754313887,0.0,20.0
4868,0,4868,[ 89 273 294 185 179],655,4,20130,4.134319162045594,0.0,0.0
4869,0,4869,[100 132  56 121  64],151,4,20134,4.13429158110883,20.0,20.0
4870,0,4870,[173 197 111 215 117],457,4,20138,4.1342640114966125,0.0,0.0
4871,0,4871,[318  79  64  98 588],18,5,20143,4.13444170771757,40.0,0.0
4872,0,4872,[318  79  64  98 588],716,5,20148,4.134619331007593,40.0,0.0
4873,0,4873,[318  79  64  98 588],577,5,20153,4.134796881411572,40.0,0.0
4874,0,4874,[318  79  64  98 588],457,5,20158,4.134974358974359,40.0,0.0
4875,0,4875,[153 678 161 405 748],280,2,20160,4.13453650533224,0.0,0.0
4876,0,4876,[318  79  64  98 588],457,5,20165,4.134713963502153,40.0,0.0
4877,0,4877,[153 197 483  97  64],535,5,20170,4.134891348913489,20.0,0.0
4878,0,4878,[144 195 568 515 200],716,3,20173,4.134658741545398,0.0,0.0
4879,0,4879,[ 25  71  50 471  97],577,4,20177,4.134631147540984,0.0,20.0
4880,0,4880,[125 228 179 289 318],655,2,20179,4.13419381274329,20.0,0.0
4881,0,4881,[ 70 333   8  11 125],655,0,20179,4.13334698893896,0.0,0.0
4882,0,4882,[202 179 268 238 318],269,4,20183,4.133319680524268,20.0,0.0
4883,0,4883,[  4 210 258 173  79],344,4,20187,4.133292383292384,0.0,0.0
4884,0,4884,[318  79  64  98 588],450,5,20192,4.133469805527124,40.0,0.0
4885,0,4885,[275 471  96 597 202],457,4,20196,4.1334424887433485,0.0,20.0
4886,0,4886,[655 288 515 191 121],655,2,20198,4.133005934110907,0.0,0.0
4887,0,4887,[318  79  64  98 588],18,5,20203,4.133183306055646,40.0,0.0
4888,0,4888,[ 71 172  95  64 333],796,5,20208,4.133360605440785,20.0,0.0
4889,0,4889,[318  79  64  98 588],716,5,20213,4.1335378323108385,40.0,0.0
4890,0,4890,[318  79  64  98 588],796,5,20218,4.1337149867102845,40.0,0.0
4891,0,4891,[318  79  64  98 588],577,5,20223,4.133892068683565,40.0,0.0
4892,0,4892,[318  79  64  98 588],577,5,20228,4.134069078275087,40.0,0.0
4893,0,4893,[313 117 282 301 508],296,4,20232,4.13404168369432,0.0,0.0
4894,0,4894,[318  79  64  98 588],457,5,20237,4.1342185903983655,40.0,0.0
4895,0,4895,[200 508 385 568 117],280,3,20240,4.133986928104576,0.0,0.0
4896,0,4896,[ 12 153  98 238 111],796,4,20244,4.133959567081887,0.0,0.0
4897,0,4897,[318  79  64  98 588],450,5,20249,4.134136382196815,40.0,0.0
4898,0,4898,[151  69 333 258 748],796,5,20254,4.134313125127577,0.0,0.0
4899,0,4899,[318  79  64  98 588],796,5,20259,4.134489795918367,40.0,0.0
4900,0,4900,[318  79  64  98 588],18,5,20264,4.134666394613344,40.0,0.0
4901,0,4901,[151 496 183 195 127],450,5,20269,4.13484292125663,20.0,20.0
4902,0,4902,[318  79  64  98 588],18,5,20274,4.135019375892311,40.0,0.0
4903,0,4903,[318 357  70 237 127],72,4,20278,4.1349918433931485,20.0,20.0
4904,0,4904,[ 88 195  96 603  12],655,1,20279,4.134352701325178,20.0,0.0
4905,0,4905,[318  79  64  98 588],577,5,20284,4.134529147982063,40.0,0.0
4906,0,4906,[318 435  25 168   1],535,4,20288,4.134501732219278,20.0,0.0
4907,0,4907,[ 50 234 174  28 172],389,5,20293,4.134678076609617,0.0,20.0
4908,0,4908,[318  79  64  98 588],796,5,20298,4.134854349154614,40.0,0.0
4909,0,4909,[191 403 195 655 288],655,1,20299,4.134215885947047,0.0,0.0
4910,0,4910,[318  79  64  98 588],716,5,20304,4.134392180818571,40.0,0.0
4911,0,4911,[318  79  64  98 588],716,5,20309,4.134568403908795,40.0,0.0
4912,0,4912,[318  79  64  98 588],18,5,20314,4.134744555261551,40.0,0.0
4913,0,4913,[318  79  64  98 588],457,5,20319,4.134920634920635,40.0,0.0
4914,0,4914,[435 151 196 603 132],269,3,20322,4.13468972533062,20.0,0.0
4915,0,4915,[403 655 127 405 245],796,3,20325,4.134458909682669,0.0,20.0
4916,0,4916,[245 427 471  56 144],450,5,20330,4.134634940004068,20.0,0.0
4917,0,4917,[328 194 603 282 118],796,5,20335,4.134810898739325,20.0,0.0
4918,0,4918,[318  79  64  98 588],796,5,20340,4.1349867859321,40.0,0.0
4919,0,4919,[245 568 197 210 508],280,0,20340,4.134146341463414,0.0,0.0
4920,0,4920,[ 79 471   4 323   1],256,5,20345,4.134322292217029,0.0,0.0
4921,0,4921,[318  79  64  98 588],457,5,20350,4.13449817147501,40.0,0.0
4922,0,4922,[603  22 200 191  50],450,4,20354,4.134470851107048,20.0,20.0
4923,0,4923,[318  79  64  98 588],450,5,20359,4.134646628757108,40.0,0.0
4924,0,4924,[161 111   8 144 125],457,4,20363,4.134619289340102,0.0,0.0
4925,0,4925,[318  79  64  98 588],457,5,20368,4.134794965489241,40.0,0.0
4926,0,4926,[318  79  64  98 588],18,5,20373,4.134970570326771,40.0,0.0
4927,0,4927,[318  79  64  98 588],796,5,20378,4.135146103896104,40.0,0.0
4928,0,4928,[405 268 515  15 143],269,2,20380,4.134712923513898,0.0,0.0
4929,0,4929,[318  79  64  98 588],457,5,20385,4.134888438133874,40.0,0.0
4930,0,4930,[318  79  64  98 588],457,5,20390,4.135063881565605,40.0,0.0
4931,0,4931,[318  79  64  98 588],450,5,20395,4.135239253852393,40.0,0.0
4932,0,4932,[318  79  64  98 588],457,5,20400,4.135414555037502,40.0,0.0
4933,0,4933,[318  79  64  98 588],796,5,20405,4.135589785164167,40.0,0.0
4934,0,4934,[357   1 161 196 204],457,5,20410,4.135764944275582,0.0,0.0
4935,0,4935,[435 204 275 318 403],655,2,20412,4.135332252836305,20.0,20.0
4936,0,4936,[318  79  64  98 588],457,5,20417,4.135507393153737,40.0,0.0
4937,0,4937,[ 96 181   7  25  50],256,5,20422,4.135682462535439,0.0,20.0
4938,0,4938,[318  79  64  98 588],796,5,20427,4.135857461024499,40.0,0.0
4939,0,4939,[318  79  64  98 588],450,5,20432,4.136032388663968,40.0,0.0
4940,0,4940,[318  79  64  98 588],577,5,20437,4.136207245496863,40.0,0.0
4941,0,4941,[357 111  79 269 216],655,3,20440,4.135977337110481,0.0,0.0
4942,0,4942,[318  79  64  98 588],18,5,20445,4.136152134331378,40.0,0.0
4943,0,4943,[496   1  28 238  97],716,5,20450,4.136326860841424,20.0,0.0
4944,0,4944,[318  79  64  98 588],450,5,20455,4.136501516683519,40.0,0.0
4945,0,4945,[ 98 153 546  64 222],151,3,20458,4.136271734735139,20.0,0.0
4946,0,4946,[318  79  64  98 588],577,5,20463,4.136446331109764,40.0,0.0
4947,0,4947,[318  79  64  98 588],796,5,20468,4.136620856911883,40.0,0.0
4948,0,4948,[318  79  64  98 588],716,5,20473,4.1367953121842795,40.0,0.0
4949,0,4949,[318  79  64  98 588],716,5,20478,4.136969696969697,40.0,0.0
4950,0,4950,[234 125 132 546 405],503,3,20481,4.136740052514644,0.0,0.0
4951,0,4951,[318  79  64  98 588],457,5,20486,4.136914378029079,40.0,0.0
4952,0,4952,[423 496  98 403 183],280,3,20489,4.136684837472239,20.0,0.0
4953,0,4953,[318  79  64  98 588],450,5,20494,4.136859103754542,40.0,0.0
4954,0,4954,[322 202  69 235 127],344,2,20496,4.136427850655903,0.0,20.0
4955,0,4955,[655 323 222 275 748],796,3,20499,4.136198547215496,0.0,20.0
4956,0,4956,[318  79  64  98 588],450,5,20504,4.136372806132742,40.0,0.0
4957,0,4957,[185 588 180 300 100],450,5,20509,4.13654699475595,0.0,20.0
4958,0,4958,[ 50 118 483 161 588],450,3,20512,4.136317806009276,0.0,20.0
4959,0,4959,[179 258  89  25 423],450,4,20516,4.1362903225806456,0.0,0.0
4960,0,4960,[318  79  64  98 588],457,5,20521,4.1364644224954645,40.0,0.0
4961,0,4961,[318  79  64  98 588],18,5,20526,4.136638452237001,40.0,0.0
4962,0,4962,[153 313 234 174 125],593,4,20530,4.136610920814023,0.0,0.0
4963,0,4963,[318  79  64  98 588],577,5,20535,4.136784850926672,40.0,0.0
4964,0,4964,[318  79  64  98 588],450,5,20540,4.136958710976838,40.0,0.0
4965,0,4965,[357 183  22 655 200],796,4,20544,4.13693113169553,0.0,0.0
4966,0,4966,[ 50  69 196 181 385],786,5,20549,4.137104892289108,0.0,20.0
4967,0,4967,[318  79  64  98 588],18,5,20554,4.137278582930757,40.0,0.0
4968,0,4968,[318  79  64  98 588],450,5,20559,4.137452203662709,40.0,0.0
4969,0,4969,[ 28 187 132  95 423],716,4,20563,4.137424547283702,0.0,0.0
4970,0,4970,[318  79  64  98 588],457,5,20568,4.137598068799035,40.0,0.0
4971,0,4971,[235 228 403 200  64],330,5,20573,4.1377715205148835,20.0,0.0
4972,0,4972,[282 186 215 173 175],716,2,20575,4.1373416448823646,0.0,0.0
4973,0,4973,[288 282 211 194 385],504,4,20579,4.137314032971451,0.0,0.0
4974,0,4974,[ 96  97 508   1 300],655,0,20579,4.136482412060301,0.0,0.0
4975,0,4975,[318  79  64  98 588],716,5,20584,4.136655948553055,40.0,0.0
4976,0,4976,[357 186 125  69  56],18,3,20587,4.136427566807313,0.0,0.0
4977,0,4977,[318  79  64  98 588],577,5,20592,4.136601044596223,40.0,0.0
4978,0,4978,[318  79  64  98 588],457,5,20597,4.136774452701346,40.0,0.0
4979,0,4979,[186 483 161 204 222],796,4,20601,4.136746987951807,0.0,0.0
4980,0,4980,[216 748 222 313 132],796,5,20606,4.13692029712909,0.0,0.0
4981,0,4981,[197  88 475 357 204],655,1,20607,4.136290646326777,0.0,0.0
4982,0,4982,[318  79  64  98 588],577,5,20612,4.13646397752358,40.0,0.0
4983,0,4983,[318  79  64  98 588],450,5,20617,4.136637239165329,40.0,0.0
4984,0,4984,[318  79  64  98 588],450,5,20622,4.136810431293882,40.0,0.0
4985,0,4985,[318  79  64  98 588],18,5,20627,4.136983553951063,40.0,0.0
4986,0,4986,[ 69 568  97 174 257],330,5,20632,4.137156607178665,0.0,0.0
4987,0,4987,[496 204 237 286 144],796,4,20636,4.137129109863673,20.0,20.0
4988,0,4988,[202 197  70  97  71],450,4,20640,4.1371016235718585,0.0,0.0
4989,0,4989,[172   4 100 276 153],18,3,20643,4.13687374749499,0.0,20.0
4990,0,4990,[328   7 100 176 173],292,3,20646,4.136645962732919,0.0,20.0
4991,0,4991,[318  79  64  98 588],716,5,20651,4.136818910256411,40.0,0.0
4992,0,4992,[176 174  70 228  82],280,1,20652,4.136190666933707,0.0,0.0
4993,0,4993,[ 12 202 100 143 211],18,4,20656,4.136163396075291,0.0,20.0
4994,0,4994,[435 655 174 216 546],236,3,20659,4.135935935935936,0.0,0.0
4995,0,4995,[318  79  64  98 588],18,5,20664,4.136108887109688,40.0,0.0
4996,0,4996,[318  79  64  98 588],457,5,20669,4.136281769061437,40.0,0.0
4997,0,4997,[174 100  70  56 357],457,5,20674,4.136454581832733,0.0,20.0
4998,0,4998,[405  11  96 194  82],269,1,20675,4.135827165433087,0.0,0.0
4999,0,4999,[318  79  64  98 588],457,5,20680,4.136,40.0,0.0
5000,0,5000,[318  79  64  98 588],450,5,20685,4.1361727654469105,40.0,0.0
5001,0,5001,[588 132 423  82   4],786,5,20690,4.1363454618152735,0.0,0.0
5002,0,5002,[ 89 265 257 161 423],807,5,20695,4.136518089146512,0.0,0.0
5003,0,5003,[471   4 117   1 294],716,3,20698,4.136290967226219,0.0,0.0
5004,0,5004,[235 302 568  96 588],450,4,20702,4.136263736263737,0.0,0.0
5005,0,5005,[318  79  64  98 588],796,5,20707,4.136436276468238,40.0,0.0
5006,0,5006,[185 333   4  28  97],655,1,20708,4.135809866187338,0.0,0.0
5007,0,5007,[318  79  64  98 588],18,5,20713,4.135982428115016,40.0,0.0
5008,0,5008,[187  88 185  95 742],796,4,20717,4.135955280495109,0.0,0.0
5009,0,5009,[318  79  64  98 588],716,5,20722,4.136127744510978,40.0,0.0
5010,0,5010,[318  79  64  98 588],457,5,20727,4.136300139692676,40.0,0.0
5011,0,5011,[318  79  64  98 588],450,5,20732,4.136472466081405,40.0,0.0
5012,0,5012,[318  79  64  98 588],577,5,20737,4.136644723718332,40.0,0.0
5013,0,5013,[318  79  64  98 588],18,5,20742,4.136816912644595,40.0,0.0
5014,0,5014,[197 471 168 195 144],535,4,20746,4.13678963110668,0.0,0.0
5015,0,5015,[202 176  79  96 186],577,5,20751,4.136961722488039,0.0,0.0
5016,0,5016,[318  79  64  98 588],450,5,20756,4.1371337452660955,40.0,0.0
5017,0,5017,[318  79  64  98 588],577,5,20761,4.137305699481865,40.0,0.0
5018,0,5018,[121 302  64   9  96],269,2,20763,4.136879856545129,20.0,0.0
5019,0,5019,[318  79  64  98 588],577,5,20768,4.137051792828685,40.0,0.0
5020,0,5020,[117 385 269 294 168],450,5,20773,4.137223660625374,0.0,0.0
5021,0,5021,[318  79  64  98 588],577,5,20778,4.137395459976105,40.0,0.0
5022,0,5022,[318  79  64  98 588],450,5,20783,4.13756719092176,40.0,0.0
5023,0,5023,[195   7 282 234  71],450,3,20786,4.13734076433121,0.0,0.0
5024,0,5024,[238 357 200 143  88],151,4,20790,4.137313432835821,0.0,0.0
5025,0,5025,[318  79  64  98 588],796,5,20795,4.137485077596498,40.0,0.0
5026,0,5026,[300 194 183 405 357],151,3,20798,4.13725880246668,0.0,0.0
5027,0,5027,[234 191 161 186  97],577,4,20802,4.137231503579952,0.0,0.0
5028,0,5028,[318  79  64  98 588],796,5,20807,4.137403062239014,40.0,0.0
5029,0,5029,[318  79  64  98 588],18,5,20812,4.137574552683897,40.0,0.0
5030,0,5030,[215 127 235 237  82],450,3,20815,4.137348439674021,0.0,20.0
5031,0,5031,[143 210 238 200  96],450,3,20818,4.137122416534181,0.0,0.0
5032,0,5032,[318  79  64  98 588],457,5,20823,4.137293860520565,40.0,0.0
5033,0,5033,[318  79  64  98 588],18,5,20828,4.137465236392531,40.0,0.0
5034,0,5034,[597 588   1 655 471],457,4,20832,4.137437934458789,0.0,0.0
5035,0,5035,[318  79  64  98 588],18,5,20837,4.137609213661636,40.0,0.0
5036,0,5036,[385 174 125 216 100],280,2,20839,4.137184832241414,0.0,20.0
5037,0,5037,[597 235  50 100 265],256,4,20843,4.1371576022231045,0.0,40.0
5038,0,5038,[318  79  64  98 588],716,5,20848,4.137328835086326,40.0,0.0
5039,0,5039,[200 197 288 588 286],450,3,20851,4.137103174603174,0.0,20.0
5040,0,5040,[173 237 515   7  69],269,1,20852,4.136480856972823,0.0,0.0
5041,0,5041,[318  79  64  98 588],457,5,20857,4.13665212217374,40.0,0.0
5042,0,5042,[318  79  64  98 588],18,5,20862,4.136823319452707,40.0,0.0
5043,0,5043,[318  79  64  98 588],18,5,20867,4.136994448850119,40.0,0.0
5044,0,5044,[202 127 216 197 174],457,5,20872,4.1371655104063425,0.0,20.0
5045,0,5045,[403 204 228 313 515],807,5,20877,4.137336504161712,0.0,0.0
5046,0,5046,[216  97 100 161 180],796,2,20879,4.136913017634238,0.0,20.0
5047,0,5047,[161 100 237 403  64],655,1,20880,4.136291600633914,20.0,20.0
5048,0,5048,[318  79  64  98 588],18,5,20885,4.136462665874431,40.0,0.0
5049,0,5049,[237 168 403   9 655],269,3,20888,4.136237623762376,0.0,0.0
5050,0,5050,[318  79  64  98 588],577,5,20893,4.136408631954069,40.0,0.0
5051,0,5051,[318  79  64  98 588],716,5,20898,4.136579572446556,40.0,0.0
5052,0,5052,[318  79  64  98 588],450,5,20903,4.136750445280032,40.0,0.0
5053,0,5053,[471 235  82  28  69],716,3,20906,4.136525524337158,0.0,0.0
5054,0,5054,[286 135   1 204 215],655,1,20907,4.135905044510386,0.0,20.0
5055,0,5055,[318  79  64  98 588],716,5,20912,4.136075949367089,40.0,0.0
5056,0,5056,[318  79  64  98 588],716,5,20917,4.136246786632391,40.0,0.0
5057,0,5057,[318  79  64  98 588],577,5,20922,4.136417556346382,40.0,0.0
5058,0,5058,[168 174  98 258 318],878,3,20925,4.136192923502668,20.0,0.0
5059,0,5059,[ 12 257 127 508 318],655,2,20927,4.135770750988143,20.0,20.0
5060,0,5060,[318  79  64  98 588],577,5,20932,4.135941513534875,40.0,0.0
5061,0,5061,[204  97 172 742 197],796,2,20934,4.135519557487159,0.0,0.0
5062,0,5062,[318  79  64  98 588],18,5,20939,4.135690302192376,40.0,0.0
5063,0,5063,[318  79  64  98 588],18,5,20944,4.135860979462875,40.0,0.0
5064,0,5064,[318  79  64  98 588],450,5,20949,4.136031589338598,40.0,0.0
5065,0,5065,[183 257 258 427 202],655,2,20951,4.135609948677457,20.0,0.0
5066,0,5066,[328 678 151 273 302],401,1,20952,4.134991119005329,0.0,0.0
5067,0,5067,[318  79  64  98 588],457,5,20957,4.135161799526441,40.0,0.0
5068,0,5068,[318  79  64  98 588],18,5,20962,4.135332412704676,40.0,0.0
5069,0,5069,[318  79  64  98 588],796,5,20967,4.135502958579882,40.0,0.0
5070,0,5070,[121 132  25 588 183],577,5,20972,4.135673437191875,0.0,0.0
5071,0,5071,[318  79  64  98 588],450,5,20977,4.135843848580442,40.0,0.0
5072,0,5072,[318  79  64  98 588],716,5,20982,4.136014192785334,40.0,0.0
5073,0,5073,[  7 273 111  25 483],450,2,20984,4.135593220338983,0.0,0.0
5074,0,5074,[318  79  64  98 588],18,5,20989,4.13576354679803,40.0,0.0
5075,0,5075,[318  79  64  98 588],577,5,20994,4.135933806146572,40.0,0.0
5076,0,5076,[318  79  64  98 588],577,5,20999,4.136103998424266,40.0,0.0
5077,0,5077,[ 88 496 282  15 313],236,3,21002,4.135880267821977,20.0,0.0
5078,0,5078,[286 265 172 127 175],655,2,21004,4.135459736168537,0.0,40.0
5079,0,5079,[286 176 588 100 172],280,2,21006,4.13503937007874,0.0,40.0
5080,0,5080,[ 70  82 168 151 179],269,3,21009,4.134815981106081,0.0,0.0
5081,0,5081,[318  79  64  98 588],716,5,21014,4.134986225895317,40.0,0.0
5082,0,5082,[238 125   4 173 435],151,5,21019,4.135156403698603,0.0,0.0
5083,0,5083,[121 153 268 179 186],535,4,21023,4.1351298190401256,0.0,0.0
5084,0,5084,[215 153 322 216 144],280,3,21026,4.1349065880039335,0.0,0.0
5085,0,5085,[  8 265 258  96 515],807,3,21029,4.134683444750295,0.0,0.0
5086,0,5086,[144 405 195 301 204],796,4,21033,4.134656968743857,0.0,0.0
5087,0,5087,[ 82 275 222  15 228],796,4,21037,4.134630503144654,0.0,20.0
5088,0,5088,[121 118  22 300 117],450,3,21040,4.134407545686775,0.0,0.0
5089,0,5089,[318  79  64  98 588],18,5,21045,4.134577603143418,40.0,0.0
5090,0,5090,[318  79  64  98 588],457,5,21050,4.134747593792968,40.0,0.0
5091,0,5091,[168 427 655 268 182],535,3,21053,4.134524744697565,20.0,0.0
5092,0,5092,[318  79  64  98 588],716,5,21058,4.134694678971137,40.0,0.0
5093,0,5093,[515 125 181 313 257],296,5,21063,4.134864546525324,0.0,0.0
5094,0,5094,[357 132 603 204 195],731,3,21066,4.134641805691855,20.0,0.0
5095,0,5095,[318  79  64  98 588],457,5,21071,4.134811616954474,40.0,0.0
5096,0,5096,[269 197 215 100 204],878,2,21073,4.1343927800667055,0.0,20.0
5097,0,5097,[318  79  64  98 588],796,5,21078,4.1345625735582585,40.0,0.0
5098,0,5098,[ 98 323 111  71   1],280,4,21082,4.134536183565405,0.0,0.0
5099,0,5099,[318  79  64  98 588],716,5,21087,4.134705882352941,40.0,0.0
5100,0,5100,[161 191   7 211 275],786,5,21092,4.134875514604979,0.0,20.0
5101,0,5101,[204 427  69 238 194],269,3,21095,4.134653077224618,20.0,0.0
5102,0,5102,[194 176 111  96  28],716,3,21098,4.13443072702332,0.0,0.0
5103,0,5103,[181 211 125  12 175],655,0,21098,4.133620689655173,0.0,0.0
5104,0,5104,[318  79  64  98 588],716,5,21103,4.133790401567091,40.0,0.0
5105,0,5105,[  9 182 515 216 100],655,3,21106,4.1335683509596555,0.0,20.0
5106,0,5106,[144 117  15 271 238],796,4,21110,4.133542196984531,0.0,0.0
5107,0,5107,[294 186 742 269 216],655,1,21111,4.132928739232576,0.0,0.0
5108,0,5108,[210 153 143 215 742],504,4,21115,4.13290272068898,0.0,0.0
5109,0,5109,[318  79  64  98 588],457,5,21120,4.1330724070450096,40.0,0.0
5110,0,5110,[100 161 197 357 215],796,3,21123,4.13285071414596,0.0,20.0
5111,0,5111,[405 153 215 234 742],796,3,21126,4.132629107981221,0.0,0.0
5112,0,5112,[318  79  64  98 588],716,5,21131,4.132798748288676,40.0,0.0
5113,0,5113,[318  79  64  98 588],457,5,21136,4.13296832225264,40.0,0.0
5114,0,5114,[144 172 210 238 111],296,3,21139,4.132746823069404,0.0,0.0
5115,0,5115,[318  79  64  98 588],457,5,21144,4.132916340891321,40.0,0.0
5116,0,5116,[318  79  64  98 588],18,5,21149,4.133085792456518,40.0,0.0
5117,0,5117,[318  79  64  98 588],18,5,21154,4.13325517780383,40.0,0.0
5118,0,5118,[172 183  15  97 186],577,4,21158,4.13322914631764,0.0,0.0
5119,0,5119,[ 28 202  64 204 215],731,5,21163,4.1333984375,20.0,0.0
5120,0,5120,[118 172 568 276 748],256,3,21166,4.133177113844952,0.0,0.0
5121,0,5121,[121 313  15 597 471],593,3,21169,4.132955876610699,0.0,0.0
5122,0,5122,[187 273 318  56 357],693,3,21172,4.132734725746633,20.0,0.0
5123,0,5123,[318  79  64  98 588],450,5,21177,4.132903981264637,40.0,0.0
5124,0,5124,[ 64  98 328 185 238],655,3,21180,4.132682926829268,20.0,0.0
5125,0,5125,[318  79  64  98 588],450,5,21185,4.132852126414358,40.0,0.0
5126,0,5126,[228 508 127 216 100],280,2,21187,4.132436122488785,0.0,40.0
5127,0,5127,[318  79  64  98 588],577,5,21192,4.132605304212168,40.0,0.0
5128,0,5128,[318  79  64  98 588],716,5,21197,4.132774419964905,40.0,0.0
5129,0,5129,[176 196 357 235 200],269,2,21199,4.132358674463938,0.0,0.0
5130,0,5130,[ 50 216 275 258 172],655,4,21203,4.132332878581173,0.0,40.0
5131,0,5131,[210 515  98 385 117],655,2,21205,4.131917381137958,0.0,0.0
5132,0,5132,[ 89 185  70 187   7],269,2,21207,4.131502045587376,0.0,0.0
5133,0,5133,[294 181 222 568  97],450,4,21211,4.131476431632255,0.0,0.0
5134,0,5134,[318  79  64  98 588],796,5,21216,4.131645569620253,40.0,0.0
5135,0,5135,[318  79  64  98 588],18,5,21221,4.1318146417445485,40.0,0.0
5136,0,5136,[  4 275 269 161  82],655,1,21222,4.131204983453378,0.0,20.0
5137,0,5137,[318  79  64  98 588],18,5,21227,4.131374075515765,40.0,0.0
5138,0,5138,[300 175 196  97   1],655,0,21227,4.130570149834599,0.0,0.0
5139,0,5139,[210 195 132 143 186],450,3,21230,4.13035019455253,0.0,0.0
5140,0,5140,[318  79  64  98 588],577,5,21235,4.130519354211243,40.0,0.0
5141,0,5141,[318  79  64  98 588],450,5,21240,4.130688448074679,40.0,0.0
5142,0,5142,[211 204 176 475  95],389,4,21244,4.130663037137857,0.0,0.0
5143,0,5143,[318  79  64  98 588],457,5,21249,4.130832037325039,40.0,0.0
5144,0,5144,[318  79  64  98 588],796,5,21254,4.131000971817298,40.0,0.0
5145,0,5145,[125  89 588   1  28],450,5,21259,4.131169840652935,0.0,0.0
5146,0,5146,[186 211 125 333 176],655,0,21259,4.130367204196619,0.0,0.0
5147,0,5147,[222 423 187 151 300],450,4,21263,4.130341880341881,0.0,0.0
5148,0,5148,[204 301 121 153 180],450,4,21267,4.130316566323558,0.0,0.0
5149,0,5149,[318  79  64  98 588],796,5,21272,4.130485436893204,40.0,0.0
5150,0,5150,[318  79  64  98 588],577,5,21277,4.130654241894778,40.0,0.0
5151,0,5151,[318  79  64  98 588],577,5,21282,4.130822981366459,40.0,0.0
5152,0,5152,[210 118  28 181 204],151,4,21286,4.130797593634776,0.0,0.0
5153,0,5153,[111   4 257 273 269],796,3,21289,4.13057819169577,0.0,0.0
5154,0,5154,[318  79  64  98 588],716,5,21294,4.130746847720659,40.0,0.0
5155,0,5155,[318  79  64  98 588],457,5,21299,4.1309154383242825,40.0,0.0
5156,0,5156,[318  79  64  98 588],18,5,21304,4.131083963544697,40.0,0.0
5157,0,5157,[ 97 135 210 180 257],457,4,21308,4.1310585498255135,0.0,0.0
5158,0,5158,[318  79  64  98 588],18,5,21313,4.131226981973251,40.0,0.0
5159,0,5159,[318  79  64  98 588],457,5,21318,4.131395348837209,40.0,0.0
5160,0,5160,[222 300 435 132 204],655,0,21318,4.130594845960085,0.0,0.0
5161,0,5161,[318  79  64  98 588],450,5,21323,4.130763270050368,40.0,0.0
5162,0,5162,[318  79  64  98 588],796,5,21328,4.130931628897928,40.0,0.0
5163,0,5163,[228 180  96 215 282],716,2,21330,4.130518977536793,0.0,0.0
5164,0,5164,[318  79  64  98 588],796,5,21335,4.130687318489835,40.0,0.0
5165,0,5165,[318  79  64  98 588],457,5,21340,4.130855594270228,40.0,0.0
5166,0,5166,[318  79  64  98 588],796,5,21345,4.131023804915812,40.0,0.0
5167,0,5167,[318  79  64  98 588],796,5,21350,4.131191950464396,40.0,0.0
5168,0,5168,[ 28 603 118 215 100],330,5,21355,4.131360030953763,20.0,20.0
5169,0,5169,[ 50 127 508 176  88],655,2,21357,4.130947775628627,0.0,40.0
5170,0,5170,[121 210 257  82 568],796,3,21360,4.130729065944691,0.0,0.0
5171,0,5171,[318  79  64  98 588],577,5,21365,4.130897138437741,40.0,0.0
5172,0,5172,[318  79  64  98 588],450,5,21370,4.131065145950125,40.0,0.0
5173,0,5173,[318  79  64  98 588],450,5,21375,4.1312330885195205,40.0,0.0
5174,0,5174,[318  79  64  98 588],796,5,21380,4.131400966183575,40.0,0.0
5175,0,5175,[153 588 211 322 161],796,3,21383,4.131182380216384,0.0,0.0
5176,0,5176,[176 603 196 197 742],450,5,21388,4.131350202820166,20.0,0.0
5177,0,5177,[195 403 180 174 182],796,4,21392,4.131324835843955,0.0,0.0
5178,0,5178,[318  79  64  98 588],18,5,21397,4.131492566132458,40.0,0.0
5179,0,5179,[318  79  64  98 588],716,5,21402,4.1316602316602316,40.0,0.0
5180,0,5180,[568 228 215 318 423],693,3,21405,4.1314418066010425,20.0,0.0
5181,0,5181,[288 245 222 269 127],344,4,21409,4.131416441528367,0.0,20.0
5182,0,5182,[318  79  64  98 588],450,5,21414,4.131584024696122,40.0,0.0
5183,0,5183,[318  79  64  98 588],18,5,21419,4.131751543209877,40.0,0.0
5184,0,5184,[202 111 211 288 215],655,0,21419,4.130954676952748,0.0,0.0
5185,0,5185,[471  96 151 423 282],716,2,21421,4.13054377169302,0.0,0.0
5186,0,5186,[318  79  64  98 588],577,5,21426,4.130711393869289,40.0,0.0
5187,0,5187,[318  79  64  98 588],577,5,21431,4.130878951426369,40.0,0.0
5188,0,5188,[318  79  64  98 588],450,5,21436,4.131046444401619,40.0,0.0
5189,0,5189,[100 385 357 215 111],450,5,21441,4.13121387283237,0.0,20.0
5190,0,5190,[483 117 132 333  56],655,1,21442,4.130610672317473,0.0,0.0
5191,0,5191,[  7 202 210 186  98],457,5,21447,4.1307781201849,0.0,0.0
5192,0,5192,[318  79  64  98 588],450,5,21452,4.130945503562488,40.0,0.0
5193,0,5193,[318  79  64  98 588],577,5,21457,4.131112822487485,40.0,0.0
5194,0,5194,[ 70 333 289   9 515],655,1,21458,4.130510105871029,0.0,0.0
5195,0,5195,[161 117 294   8  79],577,5,21463,4.130677444187837,0.0,0.0
5196,0,5196,[318  79  64  98 588],450,5,21468,4.1308447181066,40.0,0.0
5197,0,5197,[194 222 288 121 483],450,1,21469,4.130242400923432,0.0,0.0
5198,0,5198,[318  79  64  98 588],716,5,21474,4.130409694171957,40.0,0.0
5199,0,5199,[318  79  64  98 588],457,5,21479,4.130576923076923,40.0,0.0
5200,0,5200,[405 275 153 276 385],655,2,21481,4.130167275523938,0.0,20.0
5201,0,5201,[210  97 173 174 357],344,4,21485,4.130142252979623,0.0,0.0
5202,0,5202,[318  79  64  98 588],577,5,21490,4.130309436863348,40.0,0.0
5203,0,5203,[483 202 151 237 257],401,2,21492,4.129900076863951,0.0,0.0
5204,0,5204,[318  79  64  98 588],716,5,21497,4.130067243035543,40.0,0.0
5205,0,5205,[318  79  64  98 588],577,5,21502,4.130234344986554,40.0,0.0
5206,0,5206,[318  79  64  98 588],577,5,21507,4.130401382753985,40.0,0.0
5207,0,5207,[318  79  64  98 588],577,5,21512,4.130568356374808,40.0,0.0
5208,0,5208,[318  79  64  98 588],457,5,21517,4.130735265885966,40.0,0.0
5209,0,5209,[318  79  64  98 588],716,5,21522,4.130902111324376,40.0,0.0
5210,0,5210,[151   4 258 181 100],535,4,21526,4.130876990980618,0.0,20.0
5211,0,5211,[125 143 568 182 288],593,4,21530,4.1308518802762855,0.0,0.0
5212,0,5212,[117 210 603 215  50],72,4,21534,4.130826779205831,20.0,20.0
5213,0,5213,[200 191 125 210 318],796,4,21538,4.1308016877637135,20.0,0.0
5214,0,5214,[318  79  64  98 588],18,5,21543,4.130968360498562,40.0,0.0
5215,0,5215,[125 191  56  79 603],151,4,21547,4.1309432515337425,20.0,0.0
5216,0,5216,[301 172 258 273 286],344,3,21550,4.130726471152003,0.0,20.0
5217,0,5217,[318  79  64  98 588],796,5,21555,4.130893062476044,40.0,0.0
5218,0,5218,[181 194 204 151 180],296,4,21559,4.130867982372102,0.0,0.0
5219,0,5219,[318  79  64  98 588],577,5,21564,4.13103448275862,40.0,0.0
5220,0,5220,[423  82 322 238  89],796,2,21566,4.1306263167975485,0.0,0.0
5221,0,5221,[423  28 180 125  70],18,3,21569,4.1304098046725395,0.0,0.0
5222,0,5222,[180 216  28 161 269],796,2,21571,4.130001914608463,0.0,0.0
5223,0,5223,[318  79  64  98 588],18,5,21576,4.130168453292496,40.0,0.0
5224,0,5224,[318  79  64  98 588],450,5,21581,4.130334928229665,40.0,0.0
5225,0,5225,[318  79  64  98 588],18,5,21586,4.130501339456563,40.0,0.0
5226,0,5226,[211 202 185  12 546],151,4,21590,4.130476372680314,0.0,0.0
5227,0,5227,[318  79  64  98 588],716,5,21595,4.130642693190513,40.0,0.0
5228,0,5228,[318  79  64  98 588],457,5,21600,4.130808950086059,40.0,0.0
5229,0,5229,[318  79  64  98 588],457,5,21605,4.130975143403441,40.0,0.0
5230,0,5230,[427 748 135 228  88],11,2,21607,4.130567769069011,20.0,0.0
5231,0,5231,[318  79  64  98 588],457,5,21612,4.1307339449541285,40.0,0.0
5232,0,5232,[318  79  64  98 588],457,5,21617,4.130900057328493,40.0,0.0
5233,0,5233,[ 82 200   4  71 323],504,5,21622,4.131066106228506,0.0,0.0
5234,0,5234,[194 318 258 173 215],65,3,21625,4.130850047755492,20.0,0.0
5235,0,5235,[318  79  64  98 588],716,5,21630,4.1310160427807485,40.0,0.0
5236,0,5236,[318  79  64  98 588],457,5,21635,4.131181974412832,40.0,0.0
5237,0,5237,[318  79  64  98 588],450,5,21640,4.131347842688049,40.0,0.0
5238,0,5238,[318  79  64  98 588],450,5,21645,4.13151364764268,40.0,0.0
5239,0,5239,[318  79  64  98 588],457,5,21650,4.1316793893129775,40.0,0.0
5240,0,5240,[318  79  64  98 588],18,5,21655,4.131845067735165,40.0,0.0
5241,0,5241,[144 196 143 127  96],716,3,21658,4.131629149179703,0.0,20.0
5242,0,5242,[318  79  64  98 588],577,5,21663,4.13179477398436,40.0,0.0
5243,0,5243,[ 25  88 237 742  69],450,4,21667,4.131769641495042,0.0,0.0
5244,0,5244,[215 168 174 195 276],535,4,21671,4.131744518589133,0.0,0.0
5245,0,5245,[318  79  64  98 588],716,5,21676,4.131910026687,40.0,0.0
5246,0,5246,[318  79  64  98 588],796,5,21681,4.132075471698113,40.0,0.0
5247,0,5247,[301  79 181 603  82],796,3,21684,4.131859756097561,20.0,0.0
5248,0,5248,[318  79  64  98 588],450,5,21689,4.1320251476471705,40.0,0.0
5249,0,5249,[318  79  64  98 588],450,5,21694,4.132190476190476,40.0,0.0
5250,0,5250,[258  98 175 183 197],655,2,21696,4.131784422014855,0.0,0.0
5251,0,5251,[318  79  64  98 588],18,5,21701,4.131949733434882,40.0,0.0
5252,0,5252,[318  79  64  98 588],457,5,21706,4.132114981915096,40.0,0.0
5253,0,5253,[423 655 200  50 289],236,2,21708,4.131709173962695,0.0,20.0
5254,0,5254,[318  79  64  98 588],18,5,21713,4.131874405328259,40.0,0.0
5255,0,5255,[318  79  64  98 588],457,5,21718,4.132039573820395,40.0,0.0
5256,0,5256,[318  79  64  98 588],18,5,21723,4.132204679474985,40.0,0.0
5257,0,5257,[318  79  64  98 588],18,5,21728,4.132369722327882,40.0,0.0
5258,0,5258,[318  79  64  98 588],577,5,21733,4.132534702414908,40.0,0.0
5259,0,5259,[172 273 268   7 196],655,2,21735,4.13212927756654,0.0,0.0
5260,0,5260,[ 15 143   9 423 496],269,3,21738,4.131914084774758,20.0,0.0
5261,0,5261,[318  79  64  98 588],577,5,21743,4.132079057392627,40.0,0.0
5262,0,5262,[ 64   1 588 222  79],796,4,21747,4.1320539616188485,20.0,0.0
5263,0,5263,[ 15  89 385 546 423],457,4,21751,4.132028875379939,0.0,0.0
5264,0,5264,[211 204 238  97 471],716,4,21755,4.132003798670465,0.0,0.0
5265,0,5265,[ 82  69  70 186   1],151,4,21759,4.131978731484998,0.0,0.0
5266,0,5266,[318  79  64  98 588],577,5,21764,4.13214353521929,40.0,0.0
5267,0,5267,[294 168 568  79 127],716,5,21769,4.132308276385725,0.0,20.0
5268,0,5268,[276 125 118 678  88],344,1,21770,4.13171379768457,0.0,0.0
5269,0,5269,[318  79  64  98 588],796,5,21775,4.131878557874763,40.0,0.0
5270,0,5270,[318  79  64  98 588],18,5,21780,4.132043255549232,40.0,0.0
5271,0,5271,[318  79  64  98 588],796,5,21785,4.132207890743551,40.0,0.0
5272,0,5272,[200 288 678 176  12],280,3,21788,4.131993172766926,0.0,0.0
5273,0,5273,[318  79  64  98 588],577,5,21793,4.132157755024649,40.0,0.0
5274,0,5274,[318  79  64  98 588],18,5,21798,4.132322274881517,40.0,0.0
5275,0,5275,[318  79  64  98 588],18,5,21803,4.1324867323730095,40.0,0.0
5276,0,5276,[318  79  64  98 588],457,5,21808,4.132651127534584,40.0,0.0
5277,0,5277,[132 197 210 471 196],786,4,21812,4.13262599469496,0.0,0.0
5278,0,5278,[ 50 568 258 196 265],450,5,21817,4.132790301193408,0.0,20.0
5279,0,5279,[318  79  64  98 588],450,5,21822,4.132954545454545,40.0,0.0
5280,0,5280,[  1 427 216 234  96],577,4,21826,4.132929369437607,20.0,0.0
5281,0,5281,[ 25 515 268  82 742],655,1,21827,4.1323362362741385,0.0,0.0
5282,0,5282,[385 194  88 176  98],151,3,21830,4.132121900435359,0.0,0.0
5283,0,5283,[318  79  64  98 588],796,5,21835,4.132286146858441,40.0,0.0
5284,0,5284,[318  79  64  98 588],577,5,21840,4.132450331125828,40.0,0.0
5285,0,5285,[318  79  64  98 588],457,5,21845,4.132614453272796,40.0,0.0
5286,0,5286,[318 100 235 161  97],401,3,21848,4.132400226971818,20.0,20.0
5287,0,5287,[328 215  12  50  97],796,4,21852,4.132375189107413,0.0,20.0
5288,0,5288,[186 183 288 427 471],655,2,21854,4.131972017394593,20.0,0.0
5289,0,5289,[588 196 183 276 237],457,5,21859,4.132136105860114,0.0,0.0
5290,0,5290,[174 176 210 183 194],352,3,21862,4.131922131922132,0.0,0.0
5291,0,5291,[318  79  64  98 588],18,5,21867,4.132086167800454,40.0,0.0
5292,0,5292,[151 210 216  96 471],450,4,21871,4.1320612129227285,0.0,0.0
5293,0,5293,[318  79  64  98 588],716,5,21876,4.132225160559123,40.0,0.0
5294,0,5294,[121 258 176 194  15],796,5,21881,4.132389046270066,0.0,0.0
5295,0,5295,[301  89 151 215   7],151,4,21885,4.132364048338369,0.0,0.0
5296,0,5296,[143 238 588  69  98],389,4,21889,4.1323390598451955,0.0,0.0
5297,0,5297,[318  79  64  98 588],450,5,21894,4.132502831257078,40.0,0.0
5298,0,5298,[318  79  64  98 588],18,5,21899,4.132666540856765,40.0,0.0
5299,0,5299,[318  79  64  98 588],577,5,21904,4.132830188679245,40.0,0.0
5300,0,5300,[258 195  56 211 161],693,3,21907,4.132616487455197,0.0,0.0
5301,0,5301,[318  79  64  98 588],796,5,21912,4.132780082987552,40.0,0.0
5302,0,5302,[318  79  64  98 588],450,5,21917,4.1329436168206675,40.0,0.0
5303,0,5303,[183 202 211 111 742],655,1,21918,4.132352941176471,0.0,0.0
5304,0,5304,[318  79  64  98 588],457,5,21923,4.1325164938737045,40.0,0.0
5305,0,5305,[194 403 196 168   8],796,5,21928,4.132679984922729,0.0,0.0
5306,0,5306,[318  79  64  98 588],18,5,21933,4.132843414358395,40.0,0.0
5307,0,5307,[ 12 132  50 211 300],151,5,21938,4.133006782215523,0.0,20.0
5308,0,5308,[180 179 191  89 135],18,3,21941,4.132793369749482,0.0,0.0
5309,0,5309,[191 237 269 183 403],796,4,21945,4.132768361581921,0.0,0.0
5310,0,5310,[180 318 182 276 228],457,5,21950,4.132931651289776,20.0,0.0
5311,0,5311,[117 313 288  70 174],344,2,21952,4.132530120481928,0.0,0.0
5312,0,5312,[318  79  64  98 588],577,5,21957,4.132693393562959,40.0,0.0
5313,0,5313,[210 174 275 172 100],503,5,21962,4.132856605193828,0.0,40.0
5314,0,5314,[403 228 588 176  95],577,4,21966,4.132831608654751,0.0,0.0
5315,0,5315,[318  79  64  98 588],796,5,21971,4.132994732881866,40.0,0.0
5316,0,5316,[ 69 175 181 318 257],457,4,21975,4.132969719766786,20.0,0.0
5317,0,5317,[318  79  64  98 588],18,5,21980,4.133132756675442,40.0,0.0
5318,0,5318,[318  79  64  98 588],457,5,21985,4.133295732280504,40.0,0.0
5319,0,5319,[191 603 588 151 471],401,3,21988,4.133082706766917,20.0,0.0
5320,0,5320,[ 25 568  50 318  96],450,4,21992,4.133057695921819,20.0,20.0
5321,0,5321,[318  79  64  98 588],450,5,21997,4.1332205937617434,40.0,0.0
5322,0,5322,[318  79  64  98 588],450,5,22002,4.133383430396393,40.0,0.0
5323,0,5323,[185 187 427 174 202],18,3,22005,4.1331705484598045,20.0,0.0
5324,0,5324,[318  79  64  98 588],457,5,22010,4.133333333333334,40.0,0.0
5325,0,5325,[269 125 483  96 268],296,5,22015,4.133496057078483,0.0,0.0
5326,0,5326,[186 194  79 185 228],623,3,22018,4.133283273887741,0.0,0.0
5327,0,5327,[  9 603  22 471 182],655,2,22020,4.132882882882883,20.0,0.0
5328,0,5328,[ 98 286 125 238 216],786,5,22025,4.133045599549634,0.0,20.0
5329,0,5329,[318  79  64  98 588],716,5,22030,4.133208255159475,40.0,0.0
5330,0,5330,[179 286 245 237  25],593,3,22033,4.132995685612455,0.0,20.0
5331,0,5331,[318  79  64  98 588],716,5,22038,4.1331582895723935,40.0,0.0
5332,0,5332,[318  79  64  98 588],18,5,22043,4.133320832552035,40.0,0.0
5333,0,5333,[245 313 471 322  22],280,2,22045,4.132920884889389,0.0,0.0
5334,0,5334,[ 64 194 515 603  56],292,5,22050,4.133083411433927,40.0,0.0
5335,0,5335,[515 238 168 182   7],269,4,22054,4.133058470764618,0.0,0.0
5336,0,5336,[ 56 168  97 655 135],716,4,22058,4.133033539441634,0.0,0.0
5337,0,5337,[161 194 215 132 196],450,5,22063,4.1331959535406515,0.0,0.0
5338,0,5338,[196 568 655 215 282],655,0,22063,4.13242180183555,0.0,0.0
5339,0,5339,[ 69 568  79  25 385],655,1,22064,4.131835205992509,0.0,0.0
5340,0,5340,[318  79  64  98 588],450,5,22069,4.131997753229732,40.0,0.0
5341,0,5341,[111 168 357  82 294],716,5,22074,4.1321602396106325,0.0,0.0
5342,0,5342,[ 79   7 385 748 135],151,3,22077,4.131948343627176,0.0,0.0
5343,0,5343,[318  79  64  98 588],18,5,22082,4.1321107784431135,40.0,0.0
5344,0,5344,[318  79  64  98 588],450,5,22087,4.132273152478953,40.0,0.0
5345,0,5345,[318  79  64  98 588],796,5,22092,4.132435465768799,40.0,0.0
5346,0,5346,[318  79  64  98 588],716,5,22097,4.132597718346736,40.0,0.0
5347,0,5347,[276  88 191 186 234],269,2,22099,4.132198952879581,0.0,0.0
5348,0,5348,[318  79  64  98 588],716,5,22104,4.132361189007291,40.0,0.0
5349,0,5349,[435  97 282 238 121],535,4,22108,4.132336448598131,0.0,0.0
5350,0,5350,[ 12 174 294 121 222],457,4,22112,4.132311717435993,0.0,0.0
5351,0,5351,[318  79  64  98 588],18,5,22117,4.132473841554559,40.0,0.0
5352,0,5352,[318  79  64  98 588],716,5,22122,4.132635905099944,40.0,0.0
5353,0,5353,[318  79  64  98 588],18,5,22127,4.132797908106089,40.0,0.0
5354,0,5354,[318  79  64  98 588],457,5,22132,4.13295985060691,40.0,0.0
5355,0,5355,[153  98 187 182  70],18,5,22137,4.133121732636296,0.0,0.0
5356,0,5356,[435 603 175 121 194],269,3,22140,4.132910210938959,20.0,0.0
5357,0,5357,[318  79  64  98 588],577,5,22145,4.133072041806645,40.0,0.0
5358,0,5358,[286  89 176 168 265],796,4,22149,4.133047210300429,0.0,20.0
5359,0,5359,[318  79  64  98 588],18,5,22154,4.13320895522388,40.0,0.0
5360,0,5360,[427 153 143  98 588],18,5,22159,4.133370639806007,20.0,0.0
5361,0,5361,[318  79  64  98 588],450,5,22164,4.133532264080567,40.0,0.0
5362,0,5362,[118  79 132  95 121],344,3,22167,4.133320902479955,0.0,0.0
5363,0,5363,[265 211 234   4 385],655,0,22167,4.132550335570469,0.0,0.0
5364,0,5364,[318  79  64  98 588],18,5,22172,4.132712022367195,40.0,0.0
5365,0,5365,[275 318 423  82 427],450,4,22176,4.1326872903466265,40.0,20.0
5366,0,5366,[318  79  64  98 588],796,5,22181,4.132848891373206,40.0,0.0
5367,0,5367,[286 191 185 172 161],796,4,22185,4.132824143070045,0.0,20.0
5368,0,5368,[183 100 135 265 471],450,4,22189,4.132799403985844,0.0,20.0
5369,0,5369,[172 180 204 182 276],535,2,22191,4.132402234636872,0.0,0.0
5370,0,5370,[288 222 118 135 289],655,1,22192,4.131819028113945,0.0,0.0
5371,0,5371,[318  79  64  98 588],18,5,22197,4.131980640357408,40.0,0.0
5372,0,5372,[318  79  64  98 588],577,5,22202,4.1321421924437,40.0,0.0
5373,0,5373,[318  79  64  98 588],18,5,22207,4.132303684406401,40.0,0.0
5374,0,5374,[204 423 385 153   1],655,0,22207,4.1315348837209305,0.0,0.0
5375,0,5375,[318  79  64  98 588],457,5,22212,4.131696428571429,40.0,0.0
5376,0,5376,[318  79  64  98 588],716,5,22217,4.131857913334573,40.0,0.0
5377,0,5377,[202 655   9   7 185],457,5,22222,4.132019338043882,0.0,0.0
5378,0,5378,[143 258 168 194 286],796,4,22226,4.131994794571482,0.0,20.0
5379,0,5379,[318  79  64  98 588],450,5,22231,4.132156133828996,40.0,0.0
5380,0,5380,[ 28 135 215 435 196],18,1,22232,4.131574056866754,0.0,0.0
5381,0,5381,[125 357   8 222  97],344,3,22235,4.131363805276849,0.0,0.0
5382,0,5382,[ 56 318 195 435   7],151,4,22239,4.131339401820546,20.0,0.0
5383,0,5383,[318  79  64  98 588],450,5,22244,4.131500742942051,40.0,0.0
5384,0,5384,[ 71 196 403 168 125],450,4,22248,4.131476323119777,0.0,0.0
5385,0,5385,[318  79  64  98 588],796,5,22253,4.131637578908281,40.0,0.0
5386,0,5386,[318  79  64  98 588],450,5,22258,4.13179877482829,40.0,0.0
5387,0,5387,[  9 168  88  56 333],174,4,22262,4.13177431328879,0.0,0.0
5388,0,5388,[ 82  12  97 182 180],18,4,22266,4.131749860827612,0.0,0.0
5389,0,5389,[318  79  64  98 588],796,5,22271,4.13191094619666,40.0,0.0
5390,0,5390,[  8 515 234 127  98],878,3,22274,4.131700983120015,0.0,20.0
5391,0,5391,[655  96   1 211 202],450,5,22279,4.1318620178041545,0.0,0.0
5392,0,5392,[186  12  88 181  71],18,3,22282,4.131652141665121,0.0,0.0
5393,0,5393,[195 322   9  98  97],151,3,22285,4.131442343344457,0.0,0.0
5394,0,5394,[318  79  64  98 588],450,5,22290,4.1316033364226135,40.0,0.0
5395,0,5395,[174 405  64 273  56],796,4,22294,4.131578947368421,20.0,0.0
5396,0,5396,[318  79  64  98 588],450,5,22299,4.1317398554752645,40.0,0.0
5397,0,5397,[179   9 100 202 111],878,4,22303,4.131715450166729,0.0,20.0
5398,0,5398,[318  79  64  98 588],577,5,22308,4.13187627338396,40.0,0.0
5399,0,5399,[318  79  64  98 588],18,5,22313,4.132037037037037,40.0,0.0
5400,0,5400,[318  79  64  98 588],796,5,22318,4.132197741159045,40.0,0.0
5401,0,5401,[228 405 172 200 180],280,2,22320,4.1318030359126245,0.0,0.0
5402,0,5402,[318  79  64  98 588],18,5,22325,4.131963723857116,40.0,0.0
5403,0,5403,[318  79  64  98 588],450,5,22330,4.132124352331606,40.0,0.0
5404,0,5404,[318  79  64  98 588],796,5,22335,4.132284921369103,40.0,0.0
5405,0,5405,[185 196 100 180 748],796,3,22338,4.132075471698113,0.0,20.0
5406,0,5406,[318  79  64  98 588],796,5,22343,4.132235990382837,40.0,0.0
5407,0,5407,[318  79  64  98 588],450,5,22348,4.132396449704142,40.0,0.0
5408,0,5408,[ 64  11 385 328 125],655,1,22349,4.131817341467924,20.0,0.0
5409,0,5409,[385 258 588 294  88],796,4,22353,4.131792975970425,0.0,0.0
5410,0,5410,[568 318 180 174 132],457,5,22358,4.131953428201811,20.0,0.0
5411,0,5411,[318  79  64  98 588],450,5,22363,4.132113821138211,40.0,0.0
5412,0,5412,[313 275 286 357  11],450,5,22368,4.132274154812489,0.0,40.0
5413,0,5413,[318  79  64  98 588],457,5,22373,4.13243442925748,40.0,0.0
5414,0,5414,[ 25 111   4  56 204],457,4,22377,4.132409972299169,0.0,0.0
5415,0,5415,[ 97 176  25 405 121],450,3,22380,4.1322008862629245,0.0,0.0
5416,0,5416,[318  79  64  98 588],796,5,22385,4.132361085471663,40.0,0.0
5417,0,5417,[318  79  64  98 588],18,5,22390,4.132521225544481,40.0,0.0
5418,0,5418,[234 301 197 194 127],796,2,22392,4.132127698837424,0.0,20.0
5419,0,5419,[322 323 181  56 151],256,4,22396,4.1321033210332105,0.0,0.0
5420,0,5420,[ 97 180 168 127  71],316,2,22398,4.131710016602103,0.0,20.0
5421,0,5421,[269   7 471 238  70],450,5,22403,4.131870158613058,0.0,0.0
5422,0,5422,[318  79  64  98 588],18,5,22408,4.13203024156371,40.0,0.0
5423,0,5423,[318  79  64  98 588],18,5,22413,4.1321902654867255,40.0,0.0
5424,0,5424,[202 216  50 546 117],577,4,22417,4.132165898617512,0.0,20.0
5425,0,5425,[318  79  64  98 588],457,5,22422,4.132325838555105,40.0,0.0
5426,0,5426,[ 64   9 328 323 191],796,3,22425,4.1321171918186845,20.0,0.0
5427,0,5427,[245 125 655   9 323],796,1,22426,4.131540162122329,0.0,0.0
5428,0,5428,[318  79  64  98 588],450,5,22431,4.131700128937189,40.0,0.0
5429,0,5429,[318  79  64  98 588],716,5,22436,4.131860036832412,40.0,0.0
5430,0,5430,[322 216 183  50 286],796,3,22439,4.131651629534156,0.0,40.0
5431,0,5431,[318  79  64  98 588],796,5,22444,4.131811487481591,40.0,0.0
5432,0,5432,[301 269 172 181   7],344,4,22448,4.131787226210197,0.0,0.0
5433,0,5433,[318  79  64  98 588],716,5,22453,4.131947000368053,40.0,0.0
5434,0,5434,[ 70  50 153 151 204],878,2,22455,4.131554737810488,0.0,20.0
5435,0,5435,[210 175  89  15 100],151,4,22459,4.131530537159676,0.0,20.0
5436,0,5436,[318  79  64  98 588],18,5,22464,4.131690270369689,40.0,0.0
5437,0,5437,[180   7 483 125 118],292,2,22466,4.131298271423318,0.0,0.0
5438,0,5438,[318  79  64  98 588],457,5,22471,4.131457988600846,40.0,0.0
5439,0,5439,[655 194 603   4 118],796,4,22475,4.131433823529412,20.0,0.0
5440,0,5440,[318  79  64  98 588],716,5,22480,4.131593457085095,40.0,0.0
5441,0,5441,[318  79  64  98 588],716,5,22485,4.131753031973539,40.0,0.0
5442,0,5442,[318  79  64  98 588],18,5,22490,4.13191254822708,40.0,0.0
5443,0,5443,[238 179 286 187  88],450,5,22495,4.1320720058780305,0.0,20.0
5444,0,5444,[318  79  64  98 588],716,5,22500,4.132231404958677,40.0,0.0
5445,0,5445,[318  79  64  98 588],716,5,22505,4.132390745501286,40.0,0.0
5446,0,5446,[318  79  64  98 588],18,5,22510,4.132550027538095,40.0,0.0
5447,0,5447,[265 210 655 100 118],450,3,22513,4.132342143906021,0.0,20.0
5448,0,5448,[568 237 483  11 588],716,5,22518,4.13250137639934,0.0,0.0
5449,0,5449,[318  79  64  98 588],796,5,22523,4.1326605504587155,40.0,0.0
5450,0,5450,[182 132 357 268 385],655,2,22525,4.1322693083837825,0.0,0.0
5451,0,5451,[301 117 294 328  97],450,5,22530,4.132428466617755,0.0,0.0
5452,0,5452,[197 238 202 323  95],796,2,22532,4.13203741059967,0.0,0.0
5453,0,5453,[ 22  64 183 357 118],450,4,22536,4.132013201320132,20.0,0.0
5454,0,5454,[318  79  64  98 588],450,5,22541,4.132172318973419,40.0,0.0
5455,0,5455,[318  79  64  98 588],457,5,22546,4.132331378299121,40.0,0.0
5456,0,5456,[215   1 222 183 265],450,4,22550,4.13230712845886,0.0,0.0
5457,0,5457,[  1   8 168 385 117],796,4,22554,4.13228288750458,0.0,0.0
5458,0,5458,[678  96 322 172 245],280,2,22556,4.1318922879648285,0.0,0.0
5459,0,5459,[204 151 357  25 196],344,5,22561,4.1320512820512825,0.0,0.0
5460,0,5460,[ 12 181 271 265 173],796,5,22566,4.132210217908808,0.0,0.0
5461,0,5461,[318  79  64  98 588],457,5,22571,4.132369095569389,40.0,0.0
5462,0,5462,[318  79  64  98 588],796,5,22576,4.1325279150649825,40.0,0.0
5463,0,5463,[288  56 144  79 211],450,4,22580,4.132503660322108,0.0,0.0
5464,0,5464,[161   9 121 655 294],401,0,22580,4.131747483989021,0.0,0.0
5465,0,5465,[132 294   9  96 269],655,0,22580,4.1309915843395535,0.0,0.0
5466,0,5466,[357  88 257 568  28],716,5,22585,4.131150539601244,0.0,0.0
5467,0,5467,[318  79  64  98 588],796,5,22590,4.13130943672275,40.0,0.0
5468,0,5468,[318  79  64  98 588],457,5,22595,4.131468275735966,40.0,0.0
5469,0,5469,[405 597 174 748 546],807,5,22600,4.131627056672761,0.0,0.0
5470,0,5470,[174 210  88 655 515],401,4,22604,4.131602997623835,0.0,0.0
5471,0,5471,[568 403 385 151 655],577,4,22608,4.131578947368421,0.0,0.0
5472,0,5472,[318  79  64  98 588],457,5,22613,4.131737621048785,40.0,0.0
5473,0,5473,[318  79  64  98 588],18,5,22618,4.131896236755572,40.0,0.0
5474,0,5474,[318  79  64  98 588],450,5,22623,4.132054794520548,40.0,0.0
5475,0,5475,[318  79  64  98 588],716,5,22628,4.132213294375457,40.0,0.0
5476,0,5476,[  7 245 282 275 228],450,5,22633,4.132371736352018,0.0,20.0
5477,0,5477,[  7  88 202 195   9],457,5,22638,4.132530120481928,0.0,0.0
5478,0,5478,[237 125 187  89   1],786,5,22643,4.132688446796861,0.0,0.0
5479,0,5479,[282 132 125  15 210],655,0,22643,4.1319343065693435,0.0,0.0
5480,0,5480,[318  79  64  98 588],716,5,22648,4.132092683816822,40.0,0.0
5481,0,5481,[181  98 187 258 211],655,2,22650,4.131703757752645,0.0,0.0
5482,0,5482,[143 234 191   8 172],389,4,22654,4.131679737370053,0.0,0.0
5483,0,5483,[318  79  64  98 588],577,5,22659,4.1318380743982495,40.0,0.0
5484,0,5484,[318  79  64  98 588],457,5,22664,4.131996353691887,40.0,0.0
5485,0,5485,[318  79  64  98 588],457,5,22669,4.132154575282537,40.0,0.0
5486,0,5486,[318  79  64  98 588],450,5,22674,4.132312739201749,40.0,0.0
5487,0,5487,[202 183 100 403 216],655,2,22676,4.131924198250728,0.0,20.0
5488,0,5488,[318  79  64  98 588],796,5,22681,4.132082346511204,40.0,0.0
5489,0,5489,[318  79  64  98 588],450,5,22686,4.13224043715847,40.0,0.0
5490,0,5490,[258 153 143  28 210],796,3,22689,4.132034237843745,0.0,0.0
5491,0,5491,[318  79  64  98 588],796,5,22694,4.132192279679534,40.0,0.0
5492,0,5492,[568  25 186 121 196],577,4,22698,4.132168214090661,0.0,0.0
5493,0,5493,[318  79  64  98 588],450,5,22703,4.132326174008009,40.0,0.0
5494,0,5494,[215 286 186 301 196],450,4,22707,4.1323020928116465,0.0,20.0
5495,0,5495,[318  79  64  98 588],577,5,22712,4.132459970887918,40.0,0.0
5496,0,5496,[318  79  64  98 588],716,5,22717,4.132617791522649,40.0,0.0
5497,0,5497,[435  12 403 238   8],18,4,22721,4.132593670425609,0.0,0.0
5498,0,5498,[318  79  64  98 588],796,5,22726,4.132751409347154,40.0,0.0
5499,0,5499,[475 282 197  12 175],655,0,22726,4.132,0.0,0.0
5500,0,5500,[318  79  64  98 588],796,5,22731,4.13215778949282,40.0,0.0
5501,0,5501,[318 211 191 483 183],269,4,22735,4.13213376953835,20.0,0.0
5502,0,5502,[318  79  64  98 588],796,5,22740,4.1322914773759765,40.0,0.0
5503,0,5503,[318  79  64  98 588],796,5,22745,4.132449127906977,40.0,0.0
5504,0,5504,[318  79  64  98 588],450,5,22750,4.132606721162579,40.0,0.0
5505,0,5505,[385 153 423 603 175],23,4,22754,4.1325826371231384,20.0,0.0
5506,0,5506,[318  79  64  98 588],18,5,22759,4.132740148901398,40.0,0.0
5507,0,5507,[496  98 191 204 655],716,5,22764,4.132897603485839,20.0,0.0
5508,0,5508,[ 95 568 742 237 196],577,4,22768,4.132873479760392,0.0,0.0
5509,0,5509,[515 588 257  88 127],401,2,22770,4.132486388384755,0.0,20.0
5510,0,5510,[318  79  64  98 588],18,5,22775,4.132643803302486,40.0,0.0
5511,0,5511,[318  79  64  98 588],796,5,22780,4.132801161103048,40.0,0.0
5512,0,5512,[318  79  64  98 588],577,5,22785,4.132958461817522,40.0,0.0
5513,0,5513,[ 11 257 427  70 276],655,2,22787,4.132571635836054,20.0,0.0
5514,0,5514,[318  79  64  98 588],457,5,22792,4.132728921124206,40.0,0.0
5515,0,5515,[ 28 294 328 179 357],450,5,22797,4.132886149383611,0.0,0.0
5516,0,5516,[318  79  64  98 588],716,5,22802,4.133043320645278,40.0,0.0
5517,0,5517,[ 56 117 135 588 186],885,3,22805,4.132837984777093,0.0,0.0
5518,0,5518,[318  79  64  98 588],716,5,22810,4.132995107809386,40.0,0.0
5519,0,5519,[318  79  64  98 588],716,5,22815,4.133152173913044,40.0,0.0
5520,0,5520,[265 185 328 258  56],655,1,22816,4.132584676689006,0.0,0.0
5521,0,5521,[318  79  64  98 588],796,5,22821,4.1327417602318,40.0,0.0
5522,0,5522,[318  79  64  98 588],457,5,22826,4.132898786891182,40.0,0.0
5523,0,5523,[318  79  64  98 588],18,5,22831,4.133055756698045,40.0,0.0
5524,0,5524,[ 96 286 222 483 135],450,2,22833,4.132669683257919,0.0,20.0
5525,0,5525,[196  88   9 210  70],269,1,22834,4.1321027868259135,0.0,0.0
5526,0,5526,[318  79  64  98 588],577,5,22839,4.1322598154514205,40.0,0.0
5527,0,5527,[121 132 210 144 748],796,4,22843,4.132235890014472,0.0,0.0
5528,0,5528,[318  79  64  98 588],716,5,22848,4.132392837764514,40.0,0.0
5529,0,5529,[182  79 181  15 282],450,4,22852,4.1323688969258585,0.0,0.0
5530,0,5530,[318  79  64  98 588],716,5,22857,4.132525763876333,40.0,0.0
5531,0,5531,[100 313 173  95 200],280,2,22859,4.132140274765003,0.0,20.0
5532,0,5532,[655 174 176 153 194],796,4,22863,4.132116392553768,0.0,0.0
5533,0,5533,[318  79  64  98 588],457,5,22868,4.132273220093965,40.0,0.0
5534,0,5534,[318  79  64  98 588],457,5,22873,4.1324299909665765,40.0,0.0
5535,0,5535,[483  69  79 117 385],457,5,22878,4.132586705202312,0.0,0.0
5536,0,5536,[144 173 118 174 496],280,1,22879,4.13202094997291,20.0,0.0
5537,0,5537,[318  79  64  98 588],18,5,22884,4.132177681473456,40.0,0.0
5538,0,5538,[423 496  25 144  95],450,3,22887,4.131973280375519,20.0,0.0
5539,0,5539,[318  79  64  98 588],716,5,22892,4.132129963898917,40.0,0.0
5540,0,5540,[172 191 238  71 471],389,5,22897,4.132286590868074,0.0,0.0
5541,0,5541,[234 238   4 210 318],151,5,22902,4.1324431613136055,20.0,0.0
5542,0,5542,[ 96  98 234 174  22],577,4,22906,4.132419267544651,0.0,0.0
5543,0,5543,[318  79  64  98 588],457,5,22911,4.132575757575758,40.0,0.0
5544,0,5544,[318  79  64  98 588],577,5,22916,4.1327321911632104,40.0,0.0
5545,0,5545,[546   7  25 275 322],15,1,22917,4.132167327803822,0.0,20.0
5546,0,5546,[276 427 174 191 100],269,4,22921,4.132143500991527,20.0,20.0
5547,0,5547,[318  79  64  98 588],457,5,22926,4.132299927901947,40.0,0.0
5548,0,5548,[318  79  64  98 588],716,5,22931,4.13245629843215,40.0,0.0
5549,0,5549,[318  79  64  98 588],457,5,22936,4.132612612612613,40.0,0.0
5550,0,5550,[318  79  64  98 588],18,5,22941,4.132768870473789,40.0,0.0
5551,0,5551,[318  79  64  98 588],716,5,22946,4.13292507204611,40.0,0.0
5552,0,5552,[318  79  64  98 588],450,5,22951,4.133081217359986,40.0,0.0
5553,0,5553,[318  79  64  98 588],716,5,22956,4.133237306445805,40.0,0.0
5554,0,5554,[118  88  56 357 385],716,3,22959,4.1330333033303335,0.0,0.0
5555,0,5555,[174 195  71  25 204],450,3,22962,4.132829373650108,0.0,0.0
5556,0,5556,[483 153 191 286 301],450,4,22966,4.13280547057765,0.0,20.0
5557,0,5557,[318  79  64  98 588],18,5,22971,4.132961496941346,40.0,0.0
5558,0,5558,[318  79  64  98 588],457,5,22976,4.133117467170354,40.0,0.0
5559,0,5559,[318  79  64  98 588],457,5,22981,4.1332733812949645,40.0,0.0
5560,0,5560,[318  79  64  98 588],716,5,22986,4.133429239345442,40.0,0.0
5561,0,5561,[318  79  64  98 588],716,5,22991,4.133585041352032,40.0,0.0
5562,0,5562,[313 185 187  12 151],796,5,22996,4.133740787344958,0.0,0.0
5563,0,5563,[318  79  64  98 588],716,5,23001,4.133896477354421,40.0,0.0
5564,0,5564,[568 471 172 323  82],256,4,23005,4.133872416891284,0.0,0.0
5565,0,5565,[143 275 318  56 180],457,5,23010,4.13402802730866,20.0,20.0
5566,0,5566,[318  79  64  98 588],450,5,23015,4.134183581821448,40.0,0.0
5567,0,5567,[655 268 234  89 194],269,3,23018,4.133979885057471,0.0,0.0
5568,0,5568,[318  79  64  98 588],796,5,23023,4.134135392350512,40.0,0.0
5569,0,5569,[318  79  64  98 588],796,5,23028,4.134290843806104,40.0,0.0
5570,0,5570,[318  79  64  98 588],796,5,23033,4.134446239454317,40.0,0.0
5571,0,5571,[318  79  64  98 588],18,5,23038,4.134601579325198,40.0,0.0
5572,0,5572,[318  79  64  98 588],796,5,23043,4.134756863448771,40.0,0.0
5573,0,5573,[318  79  64  98 588],796,5,23048,4.134912091855041,40.0,0.0
5574,0,5574,[546 235 117 191 228],450,4,23052,4.134887892376682,0.0,0.0
5575,0,5575,[216 385 273 748 275],450,4,23056,4.134863701578192,0.0,20.0
5576,0,5576,[ 56 181 300 276   1],655,1,23057,4.134301595840057,0.0,0.0
5577,0,5577,[318  79  64  98 588],457,5,23062,4.134456794550018,40.0,0.0
5578,0,5578,[318  79  64  98 588],457,5,23067,4.13461193762323,40.0,0.0
5579,0,5579,[385 235 483 508  11],280,4,23071,4.1345878136200716,0.0,0.0
5580,0,5580,[168 204 588 742 202],577,5,23076,4.134742877620498,0.0,0.0
5581,0,5581,[269 405 204 222 423],655,0,23076,4.134002149767109,0.0,0.0
5582,0,5582,[475 111 282 313 288],655,1,23077,4.133440802435966,0.0,0.0
5583,0,5583,[748 385 195 210 143],807,4,23081,4.133416905444126,0.0,0.0
5584,0,5584,[318  79  64  98 588],716,5,23086,4.133572068039391,40.0,0.0
5585,0,5585,[117 483 144 200 603],450,3,23089,4.133369137128535,20.0,0.0
5586,0,5586,[ 69  15 121  98 405],72,3,23092,4.133166278861643,0.0,0.0
5587,0,5587,[318  79  64  98 588],18,5,23097,4.133321403006442,40.0,0.0
5588,0,5588,[318  79  64  98 588],457,5,23102,4.133476471640723,40.0,0.0
5589,0,5589,[318  79  64  98 588],18,5,23107,4.133631484794275,40.0,0.0
5590,0,5590,[318  79  64  98 588],716,5,23112,4.13378644249687,40.0,0.0
5591,0,5591,[ 97 318 144 172 471],655,2,23114,4.13340486409156,20.0,0.0
5592,0,5592,[318  79  64  98 588],577,5,23119,4.133559806901484,40.0,0.0
5593,0,5593,[185 183 288  88  25],693,2,23121,4.133178405434394,0.0,0.0
5594,0,5594,[318  79  64  98 588],457,5,23126,4.133333333333334,40.0,0.0
5595,0,5595,[318  79  64  98 588],457,5,23131,4.13348820586133,40.0,0.0
5596,0,5596,[ 56 258  15  50 282],296,4,23135,4.133464355904949,0.0,20.0
5597,0,5597,[427 191 237  28 294],835,4,23139,4.133440514469453,20.0,0.0
5598,0,5598,[117 357 210 144 568],796,4,23143,4.133416681550277,0.0,0.0
5599,0,5599,[496  95 216 127 173],796,5,23148,4.133571428571429,20.0,20.0
5600,0,5600,[ 12  56 302 655 186],655,1,23149,4.133011962149616,0.0,0.0
5601,0,5601,[237 423 222 175  98],716,4,23153,4.132988218493395,0.0,0.0
5602,0,5602,[427 216 405 186  64],655,3,23156,4.132786007495985,40.0,0.0
5603,0,5603,[237  79 179  50 132],457,5,23161,4.1329407566024265,0.0,20.0
5604,0,5604,[318  79  64  98 588],796,5,23166,4.133095450490633,40.0,0.0
5605,0,5605,[318  79  64  98 588],796,5,23171,4.133250089190153,40.0,0.0
5606,0,5606,[258 405 181 568 151],457,5,23176,4.133404672730515,0.0,0.0
5607,0,5607,[117  79  25 168  97],577,5,23181,4.133559201141227,0.0,0.0
5608,0,5608,[318  79  64  98 588],577,5,23186,4.133713674451774,40.0,0.0
5609,0,5609,[318  79  64  98 588],716,5,23191,4.133868092691622,40.0,0.0
5610,0,5610,[318  79  64  98 588],577,5,23196,4.134022455890215,40.0,0.0
5611,0,5611,[318  79  64  98 588],796,5,23201,4.134176764076978,40.0,0.0
5612,0,5612,[210  97 222  22 176],756,2,23203,4.133796543737752,0.0,0.0
5613,0,5613,[318  79  64  98 588],450,5,23208,4.1339508371927325,40.0,0.0
5614,0,5614,[318  79  64  98 588],577,5,23213,4.134105075690115,40.0,0.0
5615,0,5615,[318  79  64  98 588],716,5,23218,4.1342592592592595,40.0,0.0
5616,0,5616,[318  79  64  98 588],450,5,23223,4.1344133879294995,40.0,0.0
5617,0,5617,[318  79  64  98 588],796,5,23228,4.134567461730153,40.0,0.0
5618,0,5618,[ 15  71 196   4  79],389,3,23231,4.134365545470724,0.0,0.0
5619,0,5619,[161 228  64   9 288],457,5,23236,4.134519572953737,20.0,0.0
5620,0,5620,[318  79  64  98 588],18,5,23241,4.13467354563245,40.0,0.0
5621,0,5621,[318 234   7 258 100],151,4,23245,4.134649590892921,20.0,20.0
5622,0,5622,[318  79  64  98 588],450,5,23250,4.134803485683799,40.0,0.0
5623,0,5623,[318  79  64  98 588],716,5,23255,4.134957325746799,40.0,0.0
5624,0,5624,[318  79  64  98 588],577,5,23260,4.135111111111111,40.0,0.0
5625,0,5625,[ 82 216 427 318 200],577,4,23264,4.135087095627444,40.0,0.0
5626,0,5626,[300 121 180 111 435],11,2,23266,4.134707659498845,0.0,0.0
5627,0,5627,[318  79  64  98 588],457,5,23271,4.134861407249467,40.0,0.0
5628,0,5628,[ 12  79 435  22 135],655,2,23273,4.13448214602949,0.0,0.0
5629,0,5629,[318  79  64  98 588],457,5,23278,4.1346358792184725,40.0,0.0
5630,0,5630,[275  11 301 302 603],655,3,23281,4.134434381104599,20.0,20.0
5631,0,5631,[318  79  64  98 588],450,5,23286,4.134588068181818,40.0,0.0
5632,0,5632,[318  79  64  98 588],796,5,23291,4.134741700692349,40.0,0.0
5633,0,5633,[318  79  64  98 588],716,5,23296,4.134895278665247,40.0,0.0
5634,0,5634,[200 210   1 496 238],716,5,23301,4.135048802129547,20.0,0.0
5635,0,5635,[ 22 183 100 405 200],796,4,23305,4.135024840312278,0.0,20.0
5636,0,5636,[603 228 385 151 568],330,5,23310,4.135178286322512,20.0,0.0
5637,0,5637,[135 100 118  12  64],72,4,23314,4.135154310039021,20.0,20.0
5638,0,5638,[318  79  64  98 588],716,5,23319,4.13530767866643,40.0,0.0
5639,0,5639,[  1 202 100  69 423],18,3,23322,4.135106382978724,0.0,20.0
5640,0,5640,[655 508 111  64 357],269,4,23326,4.135082432192873,20.0,0.0
5641,0,5641,[318  79  64  98 588],457,5,23331,4.135235732009925,40.0,0.0
5642,0,5642,[318  79  64  98 588],18,5,23336,4.135388977494241,40.0,0.0
5643,0,5643,[318  79  64  98 588],457,5,23341,4.135542168674699,40.0,0.0
5644,0,5644,[294 211 179  28 186],450,4,23345,4.1355181576616475,0.0,0.0
5645,0,5645,[318  79  64  98 588],457,5,23350,4.1356712716967765,40.0,0.0
5646,0,5646,[385 172 202 185  25],450,4,23354,4.135647246325482,0.0,0.0
5647,0,5647,[318  79  64  98 588],796,5,23359,4.135800283286119,40.0,0.0
5648,0,5648,[ 50   8 204 435 153],878,3,23362,4.13559922110108,0.0,20.0
5649,0,5649,[318  79  64  98 588],18,5,23367,4.135752212389381,40.0,0.0
5650,0,5650,[318  79  64  98 588],796,5,23372,4.135905149531056,40.0,0.0
5651,0,5651,[211 168 191 423 183],269,4,23376,4.13588110403397,0.0,0.0
5652,0,5652,[210 194 183 496 234],503,5,23381,4.136033964266761,20.0,0.0
5653,0,5653,[318  79  64  98 588],716,5,23386,4.136186770428016,40.0,0.0
5654,0,5654,[215 276 222 121 385],457,5,23391,4.136339522546419,0.0,0.0
5655,0,5655,[ 98 117 357 143  28],450,5,23396,4.136492220650637,0.0,0.0
5656,0,5656,[318  79  64  98 588],457,5,23401,4.136644864769313,40.0,0.0
5657,0,5657,[318  79  64  98 588],796,5,23406,4.136797454931071,40.0,0.0
5658,0,5658,[318  79  64  98 588],457,5,23411,4.136949991164517,40.0,0.0
5659,0,5659,[ 69 182 118 194  96],457,5,23416,4.137102473498233,0.0,0.0
5660,0,5660,[318  79  64  98 588],18,5,23421,4.137254901960785,40.0,0.0
5661,0,5661,[318  79  64  98 588],18,5,23426,4.1374072765807135,40.0,0.0
5662,0,5662,[194 237 127 245  70],450,5,23431,4.137559597386544,0.0,20.0
5663,0,5663,[ 28 282 183 204 546],504,3,23434,4.137358757062147,0.0,0.0
5664,0,5664,[318  79  64  98 588],457,5,23439,4.137511032656664,40.0,0.0
5665,0,5665,[117  96 568 168 172],716,4,23443,4.137486763148606,0.0,0.0
5666,0,5666,[318  79  64  98 588],577,5,23448,4.137638962413976,40.0,0.0
5667,0,5667,[258 357 313 202 237],796,5,23453,4.137791107974595,0.0,0.0
5668,0,5668,[286  56  79 655 302],655,2,23455,4.13741400599753,0.0,20.0
5669,0,5669,[318  79  64  98 588],457,5,23460,4.137566137566138,40.0,0.0
5670,0,5670,[318  79  64  98 588],716,5,23465,4.137718215482279,40.0,0.0
5671,0,5671,[ 11 118 132 496 385],577,3,23468,4.137517630465444,20.0,0.0
5672,0,5672,[318  79  64  98 588],716,5,23473,4.137669663317468,40.0,0.0
5673,0,5673,[318  79  64  98 588],18,5,23478,4.137821642580191,40.0,0.0
5674,0,5674,[318  79  64  98 588],796,5,23483,4.1379735682819385,40.0,0.0
5675,0,5675,[276 161   9   7 318],457,5,23488,4.138125440451022,20.0,0.0
5676,0,5676,[275  82 200 655  12],450,3,23491,4.137924960366391,0.0,20.0
5677,0,5677,[ 56 100 194 118 153],796,4,23495,4.137900669249736,0.0,20.0
5678,0,5678,[176  69 435 471  28],716,3,23498,4.137700299348477,0.0,0.0
5679,0,5679,[318  79  64  98 588],796,5,23503,4.137852112676057,40.0,0.0
5680,0,5680,[318  79  64  98 588],18,5,23508,4.138003872557649,40.0,0.0
5681,0,5681,[318  79  64  98 588],18,5,23513,4.138155579021471,40.0,0.0
5682,0,5682,[200  98  95 435 328],450,3,23516,4.137955305296498,0.0,0.0
5683,0,5683,[237 235 172 238 176],457,4,23520,4.137931034482759,0.0,0.0
5684,0,5684,[318  79  64  98 588],577,5,23525,4.138082673702726,40.0,0.0
5685,0,5685,[318  79  64  98 588],450,5,23530,4.138234259584945,40.0,0.0
5686,0,5686,[318  79  64  98 588],577,5,23535,4.138385792157552,40.0,0.0
5687,0,5687,[257 294 423 496 597],796,4,23539,4.138361462728551,20.0,0.0
5688,0,5688,[318  79  64  98 588],457,5,23544,4.138512919669537,40.0,0.0
5689,0,5689,[471   7 265 245 100],280,2,23546,4.138137082601054,0.0,20.0
5690,0,5690,[275 186 483 135 234],389,3,23549,4.13793709365665,0.0,20.0
5691,0,5691,[318  79  64  98 588],457,5,23554,4.138088545326775,40.0,0.0
5692,0,5692,[216 275   9  96 603],796,4,23558,4.138064289478307,20.0,20.0
5693,0,5693,[318  79  64  98 588],716,5,23563,4.138215665612926,40.0,0.0
5694,0,5694,[405 546  12   9 100],151,2,23565,4.1378402107111505,0.0,20.0
5695,0,5695,[273 175 268 181  64],655,2,23567,4.13746488764045,20.0,0.0
5696,0,5696,[234 121 161 238 282],593,4,23571,4.137440758293839,0.0,0.0
5697,0,5697,[ 82 195 121 385 153],796,4,23575,4.137416637416638,0.0,0.0
5698,0,5698,[318  79  64  98 588],18,5,23580,4.1375679943849795,40.0,0.0
5699,0,5699,[161 265 135 118  11],457,5,23585,4.137719298245614,0.0,0.0
5700,0,5700,[318  79  64  98 588],18,5,23590,4.137870549026487,40.0,0.0
5701,0,5701,[568 185 258 328 655],655,1,23591,4.137320238512802,0.0,0.0
5702,0,5702,[ 79 655 245 294 216],796,2,23593,4.136945467297913,0.0,0.0
5703,0,5703,[318  79  64  98 588],796,5,23598,4.137096774193548,40.0,0.0
5704,0,5704,[228 328 271  64 127],796,5,23603,4.137248028045574,20.0,20.0
5705,0,5705,[197   9 234  28 265],655,0,23603,4.13652295828952,0.0,0.0
5706,0,5706,[275 211 282  69 144],401,3,23606,4.136323812861399,0.0,20.0
5707,0,5707,[318  79  64  98 588],796,5,23611,4.136475122634899,40.0,0.0
5708,0,5708,[588   4 118 423 191],450,3,23614,4.1362760553512,0.0,0.0
5709,0,5709,[322 405 195 471 151],256,5,23619,4.136427320490368,0.0,0.0
5710,0,5710,[144 186 174   7 196],655,0,23619,4.135703029241814,0.0,0.0
5711,0,5711,[ 70 234  98 588 191],716,5,23624,4.135854341736695,0.0,0.0
5712,0,5712,[318  79  64  98 588],450,5,23629,4.136005601260283,40.0,0.0
5713,0,5713,[187 588 742 143 200],450,4,23633,4.135981799089954,0.0,0.0
5714,0,5714,[318  79  64  98 588],577,5,23638,4.1361329833770775,40.0,0.0
5715,0,5715,[318  79  64  98 588],18,5,23643,4.13628411476557,40.0,0.0
5716,0,5716,[318  79  64  98 588],457,5,23648,4.136435193283191,40.0,0.0
5717,0,5717,[318  79  64  98 588],450,5,23653,4.136586218957677,40.0,0.0
5718,0,5718,[ 98 282 322 100 182],256,4,23657,4.13656233607274,0.0,20.0
5719,0,5719,[ 98  88  11 194 125],457,5,23662,4.136713286713286,0.0,0.0
5720,0,5720,[238 300 215  71 322],450,4,23666,4.136689389966789,0.0,0.0
5721,0,5721,[318  79  64  98 588],796,5,23671,4.136840265641384,40.0,0.0
5722,0,5722,[318  79  64  98 588],577,5,23676,4.136991088589901,40.0,0.0
5723,0,5723,[318  79  64  98 588],577,5,23681,4.137141858839972,40.0,0.0
5724,0,5724,[318  79  64  98 588],716,5,23686,4.137292576419214,40.0,0.0
5725,0,5725,[318  79  64  98 588],450,5,23691,4.137443241355222,40.0,0.0
5726,0,5726,[385 228  22 181 174],796,5,23696,4.137593853675572,0.0,0.0
5727,0,5727,[357 318  79  89 282],457,5,23701,4.137744413407821,20.0,0.0
5728,0,5728,[318  79  64  98 588],716,5,23706,4.137894920579508,40.0,0.0
5729,0,5729,[179 172 234  70 435],878,3,23709,4.137696335078534,0.0,0.0
5730,0,5730,[215  95 313 143 127],450,4,23713,4.137672308497645,0.0,20.0
5731,0,5731,[318  79  64  98 588],716,5,23718,4.137822749476623,40.0,0.0
5732,0,5732,[318  79  64  98 588],457,5,23723,4.137973137973138,40.0,0.0
5733,0,5733,[515 216  98 405 118],716,4,23727,4.137949075688874,0.0,0.0
5734,0,5734,[603  50 173  64 302],450,5,23732,4.138099389712293,40.0,20.0
5735,0,5735,[318  79  64  98 588],457,5,23737,4.138249651324965,40.0,0.0
5736,0,5736,[127  25 196 210 322],504,5,23742,4.138399860554297,0.0,20.0
5737,0,5737,[318  79  64  98 588],450,5,23747,4.138550017427675,40.0,0.0
5738,0,5738,[318  79  64  98 588],450,5,23752,4.1387001219724695,40.0,0.0
5739,0,5739,[318  79  64  98 588],796,5,23757,4.138850174216028,40.0,0.0
5740,0,5740,[100 228 546 216 202],577,3,23760,4.1386518028218084,0.0,20.0
5741,0,5741,[318  79  64  98 588],577,5,23765,4.138801811215604,40.0,0.0
5742,0,5742,[ 64  69   7 222 135],450,3,23768,4.13860351732544,20.0,0.0
5743,0,5743,[318  79  64  98 588],716,5,23773,4.138753481894151,40.0,0.0
5744,0,5744,[318  79  64  98 588],796,5,23778,4.138903394255875,40.0,0.0
5745,0,5745,[318  79  64  98 588],450,5,23783,4.1390532544378695,40.0,0.0
5746,0,5746,[318  79  64  98 588],577,5,23788,4.139203062467375,40.0,0.0
5747,0,5747,[318  79  64  98 588],796,5,23793,4.1393528183716075,40.0,0.0
5748,0,5748,[318  79  64  98 588],457,5,23798,4.13950252217777,40.0,0.0
5749,0,5749,[  9  22 328 118 117],655,0,23798,4.138782608695652,0.0,0.0
5750,0,5750,[318 328 655 215  12],151,3,23801,4.138584593983655,20.0,0.0
5751,0,5751,[269 125 508 186 111],655,0,23801,4.137865090403338,0.0,0.0
5752,0,5752,[318  79  64  98 588],796,5,23806,4.138014948722406,40.0,0.0
5753,0,5753,[ 96 483 357  82 235],716,3,23809,4.137817170663886,0.0,0.0
5754,0,5754,[318  79  64  98 588],18,5,23814,4.137966985230235,40.0,0.0
5755,0,5755,[496 186 168 172  69],796,4,23818,4.137943015983322,20.0,0.0
5756,0,5756,[318  79  64  98 588],450,5,23823,4.1380927566440855,40.0,0.0
5757,0,5757,[655 187 515 435  95],716,4,23827,4.138068773879819,0.0,0.0
5758,0,5758,[318  79  64  98 588],457,5,23832,4.138218440701511,40.0,0.0
5759,0,5759,[318  79  64  98 588],457,5,23837,4.1383680555555555,40.0,0.0
5760,0,5760,[234 678   7 172 216],256,4,23841,4.138344037493491,0.0,0.0
5761,0,5761,[318  79  64  98 588],457,5,23846,4.138493578618535,40.0,0.0
5762,0,5762,[318  79  64  98 588],796,5,23851,4.1386430678466075,40.0,0.0
5763,0,5763,[568 183 282 196  64],655,2,23853,4.138272033310201,20.0,0.0
5764,0,5764,[187 546  88 496 194],450,5,23858,4.138421509106678,20.0,0.0
5765,0,5765,[196 257  22 423 143],716,5,23863,4.138570933055845,0.0,0.0
5766,0,5766,[405   9 161  28 215],655,0,23863,4.137853303277267,0.0,0.0
5767,0,5767,[228 318 496 200 603],151,4,23867,4.137829403606102,60.0,0.0
5768,0,5768,[318  79  64  98 588],457,5,23872,4.137978852487433,40.0,0.0
5769,0,5769,[161 271   1 180  96],72,4,23876,4.137954939341421,0.0,0.0
5770,0,5770,[211 483 143 161 286],655,2,23878,4.137584474094611,0.0,20.0
5771,0,5771,[ 56  25  70 275 168],716,5,23883,4.137733887733888,0.0,20.0
5772,0,5772,[  4 179  15 127 191],786,4,23887,4.137710029447428,0.0,20.0
5773,0,5773,[ 70 196 174 289 161],655,0,23887,4.136993418773813,0.0,0.0
5774,0,5774,[ 97 118  22   4  98],256,5,23892,4.137142857142857,0.0,0.0
5775,0,5775,[  1 322 546  98 118],593,2,23894,4.136772853185596,0.0,0.0
5776,0,5776,[318  79  64  98 588],18,5,23899,4.136922277998962,40.0,0.0
5777,0,5777,[269 405 185 176 117],450,5,23904,4.137071651090342,0.0,0.0
5778,0,5778,[318  79  64  98 588],796,5,23909,4.137220972486589,40.0,0.0
5779,0,5779,[318  79  64  98 588],457,5,23914,4.137370242214533,40.0,0.0
5780,0,5780,[318  79  64  98 588],457,5,23919,4.137519460300986,40.0,0.0
5781,0,5781,[318  79  64  98 588],577,5,23924,4.137668626772743,40.0,0.0
5782,0,5782,[181 269 237  50 204],450,5,23929,4.13781774165658,0.0,20.0
5783,0,5783,[496 215 125  50 196],151,4,23933,4.137793914246196,20.0,20.0
5784,0,5784,[405 237 197  79 496],503,4,23937,4.137770095073466,20.0,0.0
5785,0,5785,[318  79  64  98 588],457,5,23942,4.137919115105427,40.0,0.0
5786,0,5786,[  9 125 181 202  11],256,4,23946,4.137895282529808,0.0,0.0
5787,0,5787,[210 423 195 172 748],450,4,23950,4.137871458189357,0.0,0.0
5788,0,5788,[  4 180 132  69 204],450,4,23954,4.137847642079807,0.0,0.0
5789,0,5789,[318  79  64  98 588],18,5,23959,4.137996545768567,40.0,0.0
5790,0,5790,[ 89 181 275 234 196],655,2,23961,4.13762735278881,0.0,20.0
5791,0,5791,[322 168 132  79 121],796,4,23965,4.137603591160221,0.0,0.0
5792,0,5792,[ 12 268  15  25 237],655,0,23965,4.136889349214569,0.0,0.0
5793,0,5793,[318  79  64  98 588],450,5,23970,4.137038315498792,40.0,0.0
5794,0,5794,[228  95 143 300 222],807,5,23975,4.137187230371009,0.0,0.0
5795,0,5795,[143 234 655  69 183],716,4,23979,4.137163561076605,0.0,0.0
5796,0,5796,[271 237  64   8   4],655,1,23980,4.136622390891841,20.0,0.0
5797,0,5797,[234 435 173  98 313],503,4,23984,4.136598827181786,0.0,0.0
5798,0,5798,[318  79  64  98 588],450,5,23989,4.136747715123297,40.0,0.0
5799,0,5799,[318  79  64  98 588],450,5,23994,4.136896551724138,40.0,0.0
5800,0,5800,[ 12 185 127 222 100],450,4,23998,4.136872952939148,0.0,40.0
5801,0,5801,[318  79  64  98 588],716,5,24003,4.137021716649431,40.0,0.0
5802,0,5802,[318  79  64  98 588],450,5,24008,4.137170429088402,40.0,0.0
5803,0,5803,[322 132  64  69 153],151,3,24011,4.13697450034459,20.0,0.0
5804,0,5804,[318  79  64  98 588],457,5,24016,4.137123169681309,40.0,0.0
5805,0,5805,[318  79  64  98 588],457,5,24021,4.137271787805719,40.0,0.0
5806,0,5806,[385 269 471  97 210],344,2,24023,4.136903736869296,0.0,0.0
5807,0,5807,[318  79  64  98 588],18,5,24028,4.137052341597796,40.0,0.0
5808,0,5808,[318  79  64  98 588],716,5,24033,4.137200895162678,40.0,0.0
5809,0,5809,[318  79  64  98 588],796,5,24038,4.137349397590361,40.0,0.0
5810,0,5810,[ 50 568 185 100 172],389,4,24042,4.137325761486835,0.0,40.0
5811,0,5811,[ 98 318 191 655   4],151,4,24046,4.137302133516862,20.0,0.0
5812,0,5812,[318  79  64  98 588],457,5,24051,4.13745054188887,40.0,0.0
5813,0,5813,[318  79  64  98 588],18,5,24056,4.137598899208807,40.0,0.0
5814,0,5814,[318  79  64  98 588],18,5,24061,4.137747205503009,40.0,0.0
5815,0,5815,[597 161 151 186 483],457,4,24065,4.1377235213204955,0.0,0.0
5816,0,5816,[ 50 423 515  69 742],655,2,24067,4.137356025442668,0.0,20.0
5817,0,5817,[127 238 318 153 197],796,3,24070,4.137160536266759,20.0,20.0
5818,0,5818,[318  79  64  98 588],457,5,24075,4.137308815947757,40.0,0.0
5819,0,5819,[318  79  64  98 588],457,5,24080,4.13745704467354,40.0,0.0
5820,0,5820,[195 216 222 100 153],655,1,24081,4.136918055316956,0.0,20.0
5821,0,5821,[180 202 568  96 294],457,4,24085,4.136894537959464,0.0,0.0
5822,0,5822,[185 289 216 546 508],693,2,24087,4.136527563111798,0.0,0.0
5823,0,5823,[318  79  64  98 588],796,5,24092,4.136675824175824,40.0,0.0
5824,0,5824,[318  79  64  98 588],577,5,24097,4.136824034334764,40.0,0.0
5825,0,5825,[176  97  28 568 483],693,2,24099,4.136457260556128,0.0,0.0
5826,0,5826,[200 204 191 180 210],450,3,24102,4.136262227561352,0.0,0.0
5827,0,5827,[318  79  64  98 588],796,5,24107,4.136410432395333,40.0,0.0
5828,0,5828,[175 235 183  96 403],457,4,24111,4.136387030365414,0.0,0.0
5829,0,5829,[153  98 195  25 185],450,4,24115,4.136363636363637,0.0,0.0
5830,0,5830,[318  79  64  98 588],796,5,24120,4.136511747556165,40.0,0.0
5831,0,5831,[318  79  64  98 588],796,5,24125,4.1366598079561046,40.0,0.0
5832,0,5832,[173 496 483 423  12],908,3,24128,4.136464940853763,20.0,0.0
5833,0,5833,[ 11 197 195 357 168],457,5,24133,4.136612958519026,0.0,0.0
5834,0,5834,[318  79  64  98 588],18,5,24138,4.136760925449871,40.0,0.0
5835,0,5835,[318  79  64  98 588],457,5,24143,4.136908841672378,40.0,0.0
5836,0,5836,[318  79  64  98 588],18,5,24148,4.13705670721261,40.0,0.0
5837,0,5837,[318  79  64  98 588],716,5,24153,4.137204522096608,40.0,0.0
5838,0,5838,[174 357 181  22 215],535,3,24156,4.137009761945539,0.0,0.0
5839,0,5839,[318  79  64  98 588],796,5,24161,4.137157534246575,40.0,0.0
5840,0,5840,[568 183  97 194 269],450,5,24166,4.1373052559493235,0.0,0.0
5841,0,5841,[ 50  79 202 357  88],18,3,24169,4.137110578568983,0.0,20.0
5842,0,5842,[318  79  64  98 588],18,5,24174,4.1372582577443096,40.0,0.0
5843,0,5843,[132 180 100 194 603],321,4,24178,4.137234770704997,20.0,20.0
5844,0,5844,[318  79  64  98 588],457,5,24183,4.137382378100941,40.0,0.0
5845,0,5845,[185 144   1  82 273],796,2,24185,4.137016763599042,0.0,0.0
5846,0,5846,[318  79  64  98 588],796,5,24190,4.137164357790319,40.0,0.0
5847,0,5847,[ 71  22 282  64 144],535,2,24192,4.136798905608755,20.0,0.0
5848,0,5848,[318  79  64  98 588],577,5,24197,4.1369464865789025,40.0,0.0
5849,0,5849,[318  79  64  98 588],716,5,24202,4.137094017094017,40.0,0.0
5850,0,5850,[  7 151 748  79  64],292,3,24205,4.136899675269185,20.0,0.0
5851,0,5851,[318  79  64  98 588],457,5,24210,4.137047163362952,40.0,0.0
5852,0,5852,[318  79  64  98 588],457,5,24215,4.137194601059286,40.0,0.0
5853,0,5853,[405 238 496  22 191],450,5,24220,4.137341988384011,20.0,0.0
5854,0,5854,[318  79  64  98 588],450,5,24225,4.137489325362938,40.0,0.0
5855,0,5855,[288  98 186   7  96],457,5,24230,4.137636612021858,0.0,0.0
5856,0,5856,[200 191  79 265   7],577,3,24233,4.137442376643333,0.0,0.0
5857,0,5857,[328 179   1 187 300],655,2,24235,4.137077500853533,0.0,0.0
5858,0,5858,[318  79  64  98 588],457,5,24240,4.137224782386073,40.0,0.0
5859,0,5859,[318  79  64  98 588],796,5,24245,4.137372013651877,40.0,0.0
5860,0,5860,[132 302 403 174 183],450,5,24250,4.137519194676677,0.0,0.0
5861,0,5861,[403  11 111 288  71],450,3,24253,4.137325145001706,0.0,0.0
5862,0,5862,[ 64 121 182 202  11],269,2,24255,4.136960600375234,20.0,0.0
5863,0,5863,[318  79  64  98 588],18,5,24260,4.137107776261937,40.0,0.0
5864,0,5864,[318  79  64  98 588],450,5,24265,4.137254901960785,40.0,0.0
5865,0,5865,[ 71 172  50 216  64],450,4,24269,4.137231503579952,20.0,20.0
5866,0,5866,[471 508  88 197  64],693,0,24269,4.136526333731038,20.0,0.0
5867,0,5867,[144 222  98 282 237],280,1,24270,4.1359918200409,0.0,0.0
5868,0,5868,[318  79  64  98 588],577,5,24275,4.136139035610837,40.0,0.0
5869,0,5869,[318  79  64  98 588],796,5,24280,4.136286201022147,40.0,0.0
5870,0,5870,[318  79  64  98 588],577,5,24285,4.13643331630046,40.0,0.0
5871,0,5871,[ 15 271 191  12 288],629,4,24289,4.136410081743869,0.0,0.0
5872,0,5872,[483 200 187 179  88],655,4,24293,4.136386855099609,0.0,0.0
5873,0,5873,[318  79  64  98 588],450,5,24298,4.136533878106912,40.0,0.0
5874,0,5874,[210  70 132  22 186],457,5,24303,4.13668085106383,0.0,0.0
5875,0,5875,[318  79  64  98 588],18,5,24308,4.136827773995916,40.0,0.0
5876,0,5876,[228 174 423 258 132],796,5,24313,4.136974646928705,0.0,0.0
5877,0,5877,[318  79  64  98 588],577,5,24318,4.137121469887717,40.0,0.0
5878,0,5878,[318  79  64  98 588],450,5,24323,4.137268242898452,40.0,0.0
5879,0,5879,[ 28 168 216 318  98],457,5,24328,4.137414965986395,20.0,0.0
5880,0,5880,[204 181  11 237 191],269,1,24329,4.13688148274103,0.0,0.0
5881,0,5881,[742 471  98  22 183],457,5,24334,4.137028221693302,0.0,0.0
5882,0,5882,[269   4 322 143 273],450,3,24337,4.136834948155703,0.0,0.0
5883,0,5883,[318  79  64  98 588],18,5,24342,4.136981645139361,40.0,0.0
5884,0,5884,[427 161 185 405 742],655,2,24344,4.136618521665251,20.0,0.0
5885,0,5885,[318  79  64  98 588],450,5,24349,4.136765205572545,40.0,0.0
5886,0,5886,[318  79  64  98 588],796,5,24354,4.136911839646679,40.0,0.0
5887,0,5887,[202 144 405  70 300],716,4,24358,4.1368885869565215,0.0,0.0
5888,0,5888,[186 238  89 597 655],796,2,24360,4.136525725929699,0.0,0.0
5889,0,5889,[ 97  11 238 215 182],535,4,24364,4.136502546689304,0.0,0.0
5890,0,5890,[318  79  64  98 588],457,5,24369,4.1366491257850955,40.0,0.0
5891,0,5891,[215 202   4 385 234],504,3,24372,4.136456211812627,0.0,0.0
5892,0,5892,[603 174 135 385  89],151,4,24376,4.136433056168335,20.0,0.0
5893,0,5893,[ 88 302 196 216  56],151,4,24380,4.136409908381405,0.0,0.0
5894,0,5894,[ 71  96  11 269 273],344,3,24383,4.136217133163698,0.0,0.0
5895,0,5895,[318  79  64  98 588],457,5,24388,4.136363636363637,40.0,0.0
5896,0,5896,[ 25 204 215 275 435],535,5,24393,4.136510089876208,0.0,20.0
5897,0,5897,[ 69 258 286 301 603],11,4,24397,4.136486944727026,20.0,20.0
5898,0,5898,[318  79  64  98 588],457,5,24402,4.136633327682658,40.0,0.0
5899,0,5899,[328 172 191 125 100],796,4,24406,4.136610169491526,0.0,20.0
5900,0,5900,[ 96 132 181 135 186],457,5,24411,4.136756481952212,0.0,0.0
5901,0,5901,[322  69 471 100 143],401,3,24414,4.136563876651983,0.0,20.0
5902,0,5902,[ 71 182  56 328  96],796,5,24419,4.136710147382686,0.0,0.0
5903,0,5903,[318  79  64  98 588],18,5,24424,4.136856368563685,40.0,0.0
5904,0,5904,[405 237  50   4 508],655,1,24425,4.136325148179509,0.0,20.0
5905,0,5905,[  1 100  70 357 496],330,5,24430,4.136471385032171,20.0,20.0
5906,0,5906,[515 215 471 202 286],655,1,24431,4.1359404096834265,0.0,20.0
5907,0,5907,[318  79  64  98 588],796,5,24436,4.136086662153013,40.0,0.0
5908,0,5908,[318  79  64  98 588],716,5,24441,4.136232865121002,40.0,0.0
5909,0,5909,[427 168 179 100 118],389,4,24445,4.136209813874789,20.0,20.0
5910,0,5910,[318  79  64  98 588],716,5,24450,4.136355946540348,40.0,0.0
5911,0,5911,[403 655  56 183   8],577,4,24454,4.136332882273343,0.0,0.0
5912,0,5912,[ 15 322 405  88 597],593,2,24456,4.135971588026383,0.0,0.0
5913,0,5913,[318  79  64  98 588],18,5,24461,4.136117686844775,40.0,0.0
5914,0,5914,[318 143 282 168 655],716,4,24465,4.136094674556213,20.0,0.0
5915,0,5915,[385  64  25 742 174],577,5,24470,4.1362407031778226,20.0,0.0
5916,0,5916,[318  79  64  98 588],716,5,24475,4.136386682440426,40.0,0.0
5917,0,5917,[318  79  64  98 588],18,5,24480,4.136532612369043,40.0,0.0
5918,0,5918,[318  79  64  98 588],577,5,24485,4.136678492988681,40.0,0.0
5919,0,5919,[318  79  64  98 588],577,5,24490,4.136824324324325,40.0,0.0
5920,0,5920,[318  79  64  98 588],457,5,24495,4.136970106400946,40.0,0.0
5921,0,5921,[197 200 258  25 655],151,4,24499,4.136946977372509,0.0,0.0
5922,0,5922,[197  89 273   9 269],796,1,24500,4.136417356069559,0.0,0.0
5923,0,5923,[318  79  64  98 588],716,5,24505,4.136563133018231,40.0,0.0
5924,0,5924,[318  79  64  98 588],796,5,24510,4.1367088607594935,40.0,0.0
5925,0,5925,[318  79  64  98 588],18,5,24515,4.136854539318258,40.0,0.0
5926,0,5926,[ 28 496 100 121 405],577,4,24519,4.136831449299814,20.0,20.0
5927,0,5927,[318  79  64  98 588],716,5,24524,4.136977058029689,40.0,0.0
5928,0,5928,[318  79  64  98 588],18,5,24529,4.137122617642098,40.0,0.0
5929,0,5929,[318  79  64  98 588],716,5,24534,4.137268128161889,40.0,0.0
5930,0,5930,[318  79  64  98 588],457,5,24539,4.137413589613893,40.0,0.0
5931,0,5931,[427 197 132 257  50],389,4,24543,4.137390424814565,20.0,20.0
5932,0,5932,[318  79  64  98 588],457,5,24548,4.137535816618911,40.0,0.0
5933,0,5933,[318  79  64  98 588],796,5,24553,4.13768115942029,40.0,0.0
5934,0,5934,[318  79  64  98 588],577,5,24558,4.137826453243471,40.0,0.0
5935,0,5935,[238 655 100 302  11],450,5,24563,4.1379716981132075,0.0,20.0
5936,0,5936,[546  69 121 111 175],151,4,24567,4.1379484588175846,0.0,0.0
5937,0,5937,[228 186 132 271 496],796,4,24571,4.1379252273492755,20.0,0.0
5938,0,5938,[318  79  64  98 588],716,5,24576,4.138070382219229,40.0,0.0
5939,0,5939,[265  89 196 117 174],655,1,24577,4.137542087542087,0.0,0.0
5940,0,5940,[ 50 496  71 143 176],389,4,24581,4.137518936206026,20.0,20.0
5941,0,5941,[483 210 173 678 385],280,2,24583,4.137159205654662,0.0,0.0
5942,0,5942,[318  79  64  98 588],796,5,24588,4.137304391721353,40.0,0.0
5943,0,5943,[318  79  64  98 588],796,5,24593,4.137449528936743,40.0,0.0
5944,0,5944,[276 288 143 111  69],655,2,24595,4.137089991589571,0.0,0.0
5945,0,5945,[ 56  82 183 471  28],457,5,24600,4.137235116044399,0.0,0.0
5946,0,5946,[318  79  64  98 588],577,5,24605,4.137380191693291,40.0,0.0
5947,0,5947,[100 427  98 333 111],655,2,24607,4.137020847343645,20.0,20.0
5948,0,5948,[ 28 515 173 172 151],807,4,24611,4.136997814758783,0.0,0.0
5949,0,5949,[405 483 176 144 135],457,5,24616,4.137142857142857,0.0,0.0
5950,0,5950,[204 175 195 183   1],655,1,24617,4.136615694841203,0.0,0.0
5951,0,5951,[186 127 211 286 183],503,4,24621,4.136592741935484,0.0,40.0
5952,0,5952,[  1  79 286 172  96],344,3,24624,4.136401814211322,0.0,20.0
5953,0,5953,[318  79  64  98 588],450,5,24629,4.136546859254283,40.0,0.0
5954,0,5954,[318  79  64  98 588],716,5,24634,4.1366918555835435,40.0,0.0
5955,0,5955,[185 143  82 423 144],655,2,24636,4.136333109469443,0.0,0.0
5956,0,5956,[318  79  64  98 588],18,5,24641,4.136478092999832,40.0,0.0
5957,0,5957,[172 161 151 385 222],796,5,24646,4.136623027861699,0.0,0.0
5958,0,5958,[318  79  64  98 588],457,5,24651,4.1367679140795435,40.0,0.0
5959,0,5959,[ 25  95  88 313 151],344,3,24654,4.136577181208054,0.0,0.0
5960,0,5960,[742 125 302 216 245],450,5,24659,4.13672202650562,0.0,0.0
5961,0,5961,[322  98 143 357 202],450,5,24664,4.136866823213687,0.0,0.0
5962,0,5962,[318  79  64  98 588],716,5,24669,4.1370115713567,40.0,0.0
5963,0,5963,[313 427 275 269 144],796,4,24673,4.136988598256204,20.0,20.0
5964,0,5964,[ 50 435 111 176 286],450,5,24678,4.137133277451802,0.0,40.0
5965,0,5965,[546 194 132 172 197],796,4,24682,4.137110291652698,0.0,0.0
5966,0,5966,[318  79  64  98 588],716,5,24687,4.137254901960785,40.0,0.0
5967,0,5967,[  1 258  97 204 276],535,3,24690,4.137064343163539,0.0,0.0
5968,0,5968,[318  79  64  98 588],716,5,24695,4.137208912715698,40.0,0.0
5969,0,5969,[318  79  64  98 588],18,5,24700,4.1373534338358455,40.0,0.0
5970,0,5970,[195 385  15 234 301],655,0,24700,4.136660525875063,0.0,0.0
5971,0,5971,[318  79  64  98 588],716,5,24705,4.136805090421969,40.0,0.0
5972,0,5972,[318  79  64  98 588],450,5,24710,4.136949606562866,40.0,0.0
5973,0,5973,[181 228 117   1 275],450,5,24715,4.1370940743220626,0.0,20.0
5974,0,5974,[318  79  64  98 588],716,5,24720,4.137238493723849,40.0,0.0
5975,0,5975,[210  70 202 282 211],504,3,24723,4.1370481927710845,0.0,0.0
5976,0,5976,[318  79  64  98 588],18,5,24728,4.137192571524176,40.0,0.0
5977,0,5977,[172 135  11   4 210],716,3,24731,4.1370023419203745,0.0,0.0
5978,0,5978,[318  79  64  98 588],796,5,24736,4.137146680046831,40.0,0.0
5979,0,5979,[196 748 385 357 403],450,5,24741,4.137290969899666,0.0,0.0
5980,0,5980,[318  79  64  98 588],796,5,24746,4.137435211503093,40.0,0.0
5981,0,5981,[318  79  64  98 588],796,5,24751,4.13757940488131,40.0,0.0
5982,0,5982,[  1  79 195  69 655],885,4,24755,4.1375564098278454,0.0,0.0
5983,0,5983,[318  79  64  98 588],457,5,24760,4.137700534759358,40.0,0.0
5984,0,5984,[211 215 210 194 655],796,2,24762,4.13734335839599,0.0,0.0
5985,0,5985,[318  79  64  98 588],450,5,24767,4.137487470765119,40.0,0.0
5986,0,5986,[318  79  64  98 588],796,5,24772,4.137631534992484,40.0,0.0
5987,0,5987,[318  79  64  98 588],450,5,24777,4.137775551102204,40.0,0.0
5988,0,5988,[ 50 186 300  97 176],796,3,24780,4.137585573551511,0.0,20.0
5989,0,5989,[318  79  64  98 588],716,5,24785,4.137729549248748,40.0,0.0
5990,0,5990,[ 56 187 496 175 423],18,5,24790,4.13787347688199,20.0,0.0
5991,0,5991,[215  15 313 748 403],796,5,24795,4.1380173564753004,0.0,0.0
5992,0,5992,[318  79  64  98 588],457,5,24800,4.138161188052728,40.0,0.0
5993,0,5993,[202 180  28 237 125],18,1,24801,4.137637637637638,0.0,0.0
5994,0,5994,[216 257 588 153  95],23,4,24805,4.137614678899083,0.0,0.0
5995,0,5995,[357   7  25 181 258],457,5,24810,4.137758505670447,0.0,0.0
5996,0,5996,[ 50 174 181 318  88],401,3,24813,4.137568784392196,20.0,20.0
5997,0,5997,[318  79  64  98 588],716,5,24818,4.137712570856952,40.0,0.0
5998,0,5998,[318  79  64  98 588],18,5,24823,4.1378563093848975,40.0,0.0
5999,0,5999,[ 70 271 186 427 176],655,1,24824,4.137333333333333,20.0,0.0
6000,0,6000,[144  11  82  25 215],655,0,24824,4.136643892684552,0.0,0.0
6001,0,6001,[318  79  64  98 588],18,5,24829,4.1367877374208595,40.0,0.0
6002,0,6002,[173  98 328 258 118],450,4,24833,4.136764950857905,0.0,0.0
6003,0,6003,[222 121 195 471 508],655,0,24833,4.136075949367089,0.0,0.0
6004,0,6004,[318  79  64  98 588],577,5,24838,4.136219816819318,40.0,0.0
6005,0,6005,[318  79  64  98 588],577,5,24843,4.136363636363637,40.0,0.0
6006,0,6006,[655 117 153 100 127],236,1,24844,4.135841518228733,0.0,40.0
6007,0,6007,[318  79  64  98 588],577,5,24849,4.13598535286285,40.0,0.0
6008,0,6008,[318  79  64  98 588],18,5,24854,4.136129139623898,40.0,0.0
6009,0,6009,[318  79  64  98 588],450,5,24859,4.136272878535774,40.0,0.0
6010,0,6010,[ 79 301  89 153 172],655,3,24862,4.136083846281816,0.0,0.0
6011,0,6011,[ 79 181 286 427 215],796,4,24866,4.13606121091151,20.0,20.0
6012,0,6012,[588  82 204 132 197],450,4,24870,4.136038583070015,0.0,0.0
6013,0,6013,[318  79  64  98 588],450,5,24875,4.136182241436648,40.0,0.0
6014,0,6014,[ 98  82 222 125 151],457,5,24880,4.136325852036575,0.0,0.0
6015,0,6015,[318  79  64  98 588],716,5,24885,4.136469414893617,40.0,0.0
6016,0,6016,[202 318 195 515 427],655,3,24888,4.136280538474323,40.0,0.0
6017,0,6017,[318  79  64  98 588],457,5,24893,4.136424061149883,40.0,0.0
6018,0,6018,[318  79  64  98 588],450,5,24898,4.136567536135571,40.0,0.0
6019,0,6019,[318  79  64  98 588],577,5,24903,4.136710963455149,40.0,0.0
6020,0,6020,[  7   4 183 265 318],655,2,24905,4.136356087028733,20.0,0.0
6021,0,6021,[ 12 121 185  15 265],796,5,24910,4.136499501826636,0.0,0.0
6022,0,6022,[318  79  64  98 588],796,5,24915,4.136642869002158,40.0,0.0
6023,0,6023,[118 132 322  15 333],796,4,24919,4.1366201859229745,0.0,0.0
6024,0,6024,[ 88 228  28 483 597],450,4,24923,4.136597510373444,0.0,0.0
6025,0,6025,[318  79  64  98 588],18,5,24928,4.136740789910388,40.0,0.0
6026,0,6026,[318  79  64  98 588],796,5,24933,4.1368840219014436,40.0,0.0
6027,0,6027,[318  79  64  98 588],577,5,24938,4.137027206370272,40.0,0.0
6028,0,6028,[235 286 143 168   4],450,3,24941,4.136838613368718,0.0,20.0
6029,0,6029,[200 194 302 210 180],269,2,24943,4.136484245439469,0.0,0.0
6030,0,6030,[  9  12  97  89 185],457,5,24948,4.136627424970984,0.0,0.0
6031,0,6031,[257 121 172  96 173],716,4,24952,4.136604774535809,0.0,0.0
6032,0,6032,[318  79  64  98 588],716,5,24957,4.136747886623571,40.0,0.0
6033,0,6033,[153  69 172 258   4],450,4,24961,4.136725223732184,0.0,0.0
6034,0,6034,[ 50 127 655 603 135],655,4,24965,4.136702568351284,20.0,40.0
6035,0,6035,[318  79  64  98 588],18,5,24970,4.136845593108019,40.0,0.0
6036,0,6036,[742 257 194 301 322],796,2,24972,4.136491634918006,0.0,0.0
6037,0,6037,[ 70 237 483 655 186],269,2,24974,4.136137793971514,0.0,0.0
6038,0,6038,[318  79  64  98 588],796,5,24979,4.136280841198874,40.0,0.0
6039,0,6039,[202 385  96  98 161],796,5,24984,4.136423841059603,0.0,0.0
6040,0,6040,[318  79  64  98 588],716,5,24989,4.136566793577222,40.0,0.0
6041,0,6041,[318  79  64  98 588],457,5,24994,4.13670969877524,40.0,0.0
6042,0,6042,[318  79  64  98 588],577,5,24999,4.136852556677147,40.0,0.0
6043,0,6043,[  9  88  69 471 191],401,3,25002,4.136664460622105,0.0,0.0
6044,0,6044,[174  82 568 234  50],655,1,25003,4.136145574855252,0.0,20.0
6045,0,6045,[435 313  98 237 269],503,4,25007,4.1361230565663245,0.0,0.0
6046,0,6046,[269 496 174 238 183],796,3,25010,4.1359351744666775,20.0,0.0
6047,0,6047,[258 204 173 271  98],796,5,25015,4.136078042328043,0.0,0.0
6048,0,6048,[186  50 183  69 222],796,4,25019,4.136055546371301,0.0,20.0
6049,0,6049,[318  79  64  98 588],457,5,25024,4.136198347107438,40.0,0.0
6050,0,6050,[  4 111 174 427  12],151,5,25029,4.136341100644522,20.0,0.0
6051,0,6051,[194 127 151 196 111],401,3,25032,4.13615333773959,0.0,20.0
6052,0,6052,[187 117 176 546  95],716,2,25034,4.135800429539072,0.0,0.0
6053,0,6053,[151 222 132  56 300],151,5,25039,4.13594317806409,0.0,0.0
6054,0,6054,[318  79  64  98 588],450,5,25044,4.136085879438481,40.0,0.0
6055,0,6055,[483 211 245 222 210],796,2,25046,4.135733157199471,0.0,0.0
6056,0,6056,[180  95 197 196 174],796,3,25049,4.135545649661549,0.0,0.0
6057,0,6057,[318  79  64  98 588],577,5,25054,4.135688345988775,40.0,0.0
6058,0,6058,[318  79  64  98 588],450,5,25059,4.135830995213731,40.0,0.0
6059,0,6059,[742  82 215 288 323],280,2,25061,4.1354785478547855,0.0,0.0
6060,0,6060,[357  64 238 301 385],151,4,25065,4.135456195347302,20.0,0.0
6061,0,6061,[127 111 210 194 427],796,4,25069,4.135433850214451,20.0,20.0
6062,0,6062,[313   4 132 200 151],450,3,25072,4.135246577601848,0.0,0.0
6063,0,6063,[ 50 216 204 269 235],344,4,25076,4.135224274406332,0.0,20.0
6064,0,6064,[ 69 588 174 471 180],450,5,25081,4.135366859027205,0.0,0.0
6065,0,6065,[318  79  64  98 588],796,5,25086,4.135509396636993,40.0,0.0
6066,0,6066,[195  79 483   1 216],450,4,25090,4.135487061150486,0.0,0.0
6067,0,6067,[318  79  64  98 588],18,5,25095,4.135629531970995,40.0,0.0
6068,0,6068,[318  79  64  98 588],457,5,25100,4.13577195584116,40.0,0.0
6069,0,6069,[318  79  64  98 588],577,5,25105,4.135914332784185,40.0,0.0
6070,0,6070,[ 64 427  71  22 144],535,3,25108,4.135727227804316,40.0,0.0
6071,0,6071,[222 405 294 204 282],655,0,25108,4.1350461133069825,0.0,0.0
6072,0,6072,[318  79  64  98 588],450,5,25113,4.135188539436852,40.0,0.0
6073,0,6073,[318  79  64  98 588],577,5,25118,4.13533091866974,40.0,0.0
6074,0,6074,[197 257  95 215 385],716,4,25122,4.135308641975309,0.0,0.0
6075,0,6075,[143 204  15  97 742],655,1,25123,4.13479262672811,0.0,0.0
6076,0,6076,[182 211 483 186 180],269,3,25126,4.13460589106467,0.0,0.0
6077,0,6077,[ 64 435 215 144 515],716,4,25130,4.134583744652846,20.0,0.0
6078,0,6078,[191  82   8 588  95],577,5,25135,4.134726106267478,0.0,0.0
6079,0,6079,[318  79  64  98 588],796,5,25140,4.134868421052632,40.0,0.0
6080,0,6080,[318  79  64  98 588],577,5,25145,4.135010689031409,40.0,0.0
6081,0,6081,[318  79  64  98 588],450,5,25150,4.135152910226899,40.0,0.0
6082,0,6082,[ 64 318 496 143 121],577,4,25154,4.1351306920927176,60.0,0.0
6083,0,6083,[273 269 125 588 748],796,3,25157,4.134944115713346,0.0,0.0
6084,0,6084,[318  79  64  98 588],796,5,25162,4.135086277732128,40.0,0.0
6085,0,6085,[117  22  28 265  98],655,1,25163,4.134571146894512,0.0,0.0
6086,0,6086,[318  79  64  98 588],796,5,25168,4.1347133234762605,40.0,0.0
6087,0,6087,[318  79  64  98 588],18,5,25173,4.134855453350855,40.0,0.0
6088,0,6088,[318  79  64  98 588],457,5,25178,4.134997536541304,40.0,0.0
6089,0,6089,[185 121 200  56 294],504,3,25181,4.134811165845648,0.0,0.0
6090,0,6090,[ 98 143 215 508  79],655,3,25184,4.134624856345428,0.0,0.0
6091,0,6091,[271  89 144 182 161],796,5,25189,4.134766907419567,0.0,0.0
6092,0,6092,[318  79  64  98 588],716,5,25194,4.134908911866076,40.0,0.0
6093,0,6093,[318  79  64  98 588],457,5,25199,4.13505086970791,40.0,0.0
6094,0,6094,[121 185 174 222 202],450,3,25202,4.134864643150123,0.0,0.0
6095,0,6095,[301   4 257  25 161],655,0,25202,4.134186351706036,0.0,0.0
6096,0,6096,[168 187  50 435 174],716,4,25206,4.134164343119567,0.0,20.0
6097,0,6097,[318  79  64  98 588],796,5,25211,4.134306329944244,40.0,0.0
6098,0,6098,[ 50  82  11 748  22],280,2,25213,4.133956386292835,0.0,20.0
6099,0,6099,[318  79  64  98 588],577,5,25218,4.134098360655738,40.0,0.0
6100,0,6100,[588  82 238 197   1],330,5,25223,4.134240288477299,0.0,0.0
6101,0,6101,[318  79  64  98 588],18,5,25228,4.1343821697804,40.0,0.0
6102,0,6102,[318  79  64  98 588],450,5,25233,4.134524004587908,40.0,0.0
6103,0,6103,[318  79  64  98 588],716,5,25238,4.134665792922673,40.0,0.0
6104,0,6104,[  4 294  22 100 603],796,3,25241,4.134479934479934,20.0,20.0
6105,0,6105,[318  79  64  98 588],18,5,25246,4.134621683589912,40.0,0.0
6106,0,6106,[318  79  64  98 588],796,5,25251,4.134763386278042,40.0,0.0
6107,0,6107,[  4 195 211 435 471],716,2,25253,4.134413883431566,0.0,0.0
6108,0,6108,[100 258  69 204 268],629,5,25258,4.134555573743657,0.0,20.0
6109,0,6109,[204 187  79 234 191],389,5,25263,4.134697217675941,0.0,0.0
6110,0,6110,[191 202 151 100 195],151,2,25265,4.134347897234496,0.0,20.0
6111,0,6111,[318  79  64  98 588],457,5,25270,4.134489528795812,40.0,0.0
6112,0,6112,[181  95 204 187 273],796,4,25274,4.134467528218551,0.0,0.0
6113,0,6113,[318  79  64  98 588],457,5,25279,4.134609093882892,40.0,0.0
6114,0,6114,[ 96 235 125 508 204],344,3,25282,4.134423548650859,0.0,0.0
6115,0,6115,[588 187 313   4 265],796,5,25287,4.134565075212557,0.0,0.0
6116,0,6116,[318  79  64  98 588],450,5,25292,4.1347065555010625,40.0,0.0
6117,0,6117,[ 64 742 568 161 294],450,5,25297,4.134847989539065,20.0,0.0
6118,0,6118,[ 56 186 200 181 215],450,3,25300,4.134662526556627,0.0,0.0
6119,0,6119,[ 56 143 172  89 427],151,5,25305,4.134803921568627,20.0,0.0
6120,0,6120,[318  79  64  98 588],457,5,25310,4.134945270380657,40.0,0.0
6121,0,6121,[318  79  64  98 588],796,5,25315,4.1350865730153545,40.0,0.0
6122,0,6122,[228 235 210 222   1],5,4,25319,4.13506451086069,0.0,0.0
6123,0,6123,[ 50 127 273 121 235],344,3,25322,4.134879163945134,0.0,40.0
6124,0,6124,[  1 135 153 322  12],450,4,25326,4.134857142857143,0.0,0.0
6125,0,6125,[ 28 200  98   8 196],796,4,25330,4.134835128958537,0.0,0.0
6126,0,6126,[275  28 276   4  82],655,2,25332,4.134486698220989,0.0,20.0
6127,0,6127,[176 172 237 200 183],457,5,25337,4.134627937336814,0.0,0.0
6128,0,6128,[496 228 180 588 282],450,5,25342,4.134769130363844,20.0,0.0
6129,0,6129,[ 95 211   7 216 127],786,5,25347,4.134910277324633,0.0,20.0
6130,0,6130,[211 245 181 153 237],796,3,25350,4.134725167183167,0.0,0.0
6131,0,6131,[318  79  64  98 588],457,5,25355,4.1348662752772345,40.0,0.0
6132,0,6132,[318  79  64  98 588],457,5,25360,4.135007337355291,40.0,0.0
6133,0,6133,[318  79  64  98 588],18,5,25365,4.135148353439844,40.0,0.0
6134,0,6134,[318  79  64  98 588],457,5,25370,4.1352893235533825,40.0,0.0
6135,0,6135,[318  79  64  98 588],457,5,25375,4.135430247718383,40.0,0.0
6136,0,6136,[286 301   9 144 269],796,1,25376,4.134919341697898,0.0,20.0
6137,0,6137,[ 50 405 286 111 288],655,1,25377,4.134408602150538,0.0,40.0
6138,0,6138,[258 215 195 245 568],344,2,25379,4.134060921974263,0.0,0.0
6139,0,6139,[195 238 275 427  79],655,3,25382,4.1338762214983715,20.0,20.0
6140,0,6140,[405 204 234 318 181],796,4,25386,4.133854421104055,20.0,0.0
6141,0,6141,[385  69 196 200 204],151,3,25389,4.1336698143927055,0.0,0.0
6142,0,6142,[197 182 568  15 265],450,4,25393,4.133648054696402,0.0,0.0
6143,0,6143,[318  79  64  98 588],577,5,25398,4.1337890625,40.0,0.0
6144,0,6144,[318  79  64  98 588],450,5,25403,4.133930024410089,40.0,0.0
6145,0,6145,[273 204 357 655 202],629,4,25407,4.133908232997071,0.0,0.0
6146,0,6146,[ 71  70 111 194 172],18,2,25409,4.133561086708964,0.0,0.0
6147,0,6147,[318  79  64  98 588],457,5,25414,4.13370201691607,40.0,0.0
6148,0,6148,[153 318 515  69  25],401,3,25417,4.133517645145552,20.0,0.0
6149,0,6149,[318  79  64  98 588],457,5,25422,4.133658536585366,40.0,0.0
6150,0,6150,[318  79  64  98 588],577,5,25427,4.133799382214274,40.0,0.0
6151,0,6151,[318  79  64  98 588],457,5,25432,4.133940182054617,40.0,0.0
6152,0,6152,[318  79  64  98 588],796,5,25437,4.134080936128718,40.0,0.0
6153,0,6153,[318  79  64  98 588],796,5,25442,4.134221644458888,40.0,0.0
6154,0,6154,[121 211 174 300 204],807,5,25447,4.134362307067425,0.0,0.0
6155,0,6155,[197 216 322  70 258],504,4,25451,4.134340480831709,0.0,0.0
6156,0,6156,[318  79  64  98 588],577,5,25456,4.134481078447296,40.0,0.0
6157,0,6157,[318  79  64  98 588],796,5,25461,4.13462163039948,40.0,0.0
6158,0,6158,[185 100 183 172 655],23,3,25464,4.134437408670238,0.0,20.0
6159,0,6159,[318  79  64  98 588],18,5,25469,4.134577922077922,40.0,0.0
6160,0,6160,[427   9 173 228 121],796,4,25473,4.134556078558676,20.0,0.0
6161,0,6161,[471 235 385 118  64],457,4,25477,4.134534242129178,20.0,0.0
6162,0,6162,[132  11 210 111 127],655,1,25478,4.134025636865163,0.0,20.0
6163,0,6163,[  9 275 202  12 245],796,3,25481,4.133841661258923,0.0,20.0
6164,0,6164,[318  79  64  98 588],796,5,25486,4.133982157339822,40.0,0.0
6165,0,6165,[132 175 588 597 172],457,4,25490,4.133960428154395,0.0,0.0
6166,0,6166,[237  25  79 144 322],450,4,25494,4.133938706015891,0.0,0.0
6167,0,6167,[318  79  64  98 588],577,5,25499,4.134079118028534,40.0,0.0
6168,0,6168,[318  79  64  98 588],450,5,25504,4.134219484519371,40.0,0.0
6169,0,6169,[181 385 257 151  50],5,4,25508,4.13419773095624,0.0,20.0
6170,0,6170,[357 286 268 174 742],344,2,25510,4.133851887862583,0.0,20.0
6171,0,6171,[318  79  64  98 588],577,5,25515,4.13399222294232,40.0,0.0
6172,0,6172,[111  88 301 282 333],655,0,25515,4.133322533614126,0.0,0.0
6173,0,6173,[ 64 143   9 151 568],457,5,25520,4.133462908973113,20.0,0.0
6174,0,6174,[318  79  64  98 588],450,5,25525,4.133603238866397,40.0,0.0
6175,0,6175,[318  79  64  98 588],577,5,25530,4.133743523316062,40.0,0.0
6176,0,6176,[118   4 403  64 187],655,2,25532,4.13339808968755,20.0,0.0
6177,0,6177,[235  69 328  70 748],450,4,25536,4.1333764972483005,0.0,0.0
6178,0,6178,[318  79  64  98 588],716,5,25541,4.133516750283217,40.0,0.0
6179,0,6179,[423 435 161  89   1],807,4,25545,4.133495145631068,0.0,0.0
6180,0,6180,[265 121  71 168 313],577,5,25550,4.133635334088336,0.0,0.0
6181,0,6181,[245 153 385 228 210],280,2,25552,4.1332901973471365,0.0,0.0
6182,0,6182,[294  15 289 191 302],655,2,25554,4.132945172246482,0.0,0.0
6183,0,6183,[ 70 117  15  88 483],450,3,25557,4.1327619663648125,0.0,0.0
6184,0,6184,[318  79  64  98 588],577,5,25562,4.1329021827000805,40.0,0.0
6185,0,6185,[318  79  64  98 588],796,5,25567,4.133042353701907,40.0,0.0
6186,0,6186,[318  79  64  98 588],450,5,25572,4.133182479392274,40.0,0.0
6187,0,6187,[318  79  64  98 588],457,5,25577,4.133322559793148,40.0,0.0
6188,0,6188,[318  79  64  98 588],18,5,25582,4.133462594926482,40.0,0.0
6189,0,6189,[318  79  64  98 588],450,5,25587,4.133602584814216,40.0,0.0
6190,0,6190,[318  79  64  98 588],577,5,25592,4.133742529478275,40.0,0.0
6191,0,6191,[195  22 258 168  95],796,5,25597,4.133882428940568,0.0,0.0
6192,0,6192,[216 655 172 357 151],151,5,25602,4.134022283222993,0.0,0.0
6193,0,6193,[ 28 197 234 172 204],18,1,25603,4.13351630610268,0.0,0.0
6194,0,6194,[172 125 100 215 118],655,1,25604,4.133010492332526,0.0,20.0
6195,0,6195,[ 97 302 196 286 258],151,4,25608,4.132989025177534,0.0,20.0
6196,0,6196,[318  79  64  98 588],457,5,25613,4.1331289333548495,40.0,0.0
6197,0,6197,[216 186 496  25  97],503,5,25618,4.133268796385931,20.0,0.0
6198,0,6198,[357  82   7  15 121],457,5,25623,4.133408614292628,0.0,0.0
6199,0,6199,[ 95 118 318 183  79],450,3,25626,4.1332258064516125,20.0,0.0
6200,0,6200,[318  79  64  98 588],450,5,25631,4.133365586195775,40.0,0.0
6201,0,6201,[215 483 238 174 294],655,1,25632,4.132860367623348,0.0,0.0
6202,0,6202,[318  79  64  98 588],18,5,25637,4.133000161212316,40.0,0.0
6203,0,6203,[318  79  64  98 588],18,5,25642,4.133139909735655,40.0,0.0
6204,0,6204,[121 183 135   1 211],450,3,25645,4.132957292506044,0.0,0.0
6205,0,6205,[318  79  64  98 588],450,5,25650,4.133097002900419,40.0,0.0
6206,0,6206,[ 98 222 151 403 288],256,5,25655,4.133236668277751,0.0,0.0
6207,0,6207,[186 195 603 282  71],450,3,25658,4.13305412371134,20.0,0.0
6208,0,6208,[318  79  64  98 588],18,5,25663,4.133193751006603,40.0,0.0
6209,0,6209,[318 655  82 176 228],151,3,25666,4.133011272141707,20.0,0.0
6210,0,6210,[318  79  64  98 588],577,5,25671,4.13315086137498,40.0,0.0
6211,0,6211,[318  79  64  98 588],796,5,25676,4.133290405666452,40.0,0.0
6212,0,6212,[187 176 269 238 258],655,1,25677,4.132786093674554,0.0,0.0
6213,0,6213,[318 603  98 151 405],151,4,25681,4.132764724814934,40.0,0.0
6214,0,6214,[181 197  22 168   7],535,4,25685,4.132743362831858,0.0,0.0
6215,0,6215,[318  79  64  98 588],796,5,25690,4.132882882882883,40.0,0.0
6216,0,6216,[ 64  15 172   4 427],389,4,25694,4.132861508766286,40.0,0.0
6217,0,6217,[265 151 180  64 215],716,4,25698,4.132840141524606,20.0,0.0
6218,0,6218,[215 202 195 235 168],457,4,25702,4.132818781154526,0.0,0.0
6219,0,6219,[111  71 100 568  98],280,3,25705,4.132636655948553,0.0,20.0
6220,0,6220,[191 237  88 423 568],716,5,25710,4.132776081015914,0.0,0.0
6221,0,6221,[318  79  64  98 588],577,5,25715,4.132915461266474,40.0,0.0
6222,0,6222,[318  79  64  98 588],716,5,25720,4.133054796721838,40.0,0.0
6223,0,6223,[427 588  28 333   9],796,3,25723,4.132872750642673,20.0,0.0
6224,0,6224,[318  79  64  98 588],716,5,25728,4.1330120481927715,40.0,0.0
6225,0,6225,[318  79  64  98 588],457,5,25733,4.133151300995824,40.0,0.0
6226,0,6226,[318  79  64  98 588],450,5,25738,4.13329050907339,40.0,0.0
6227,0,6227,[318  79  64  98 588],796,5,25743,4.133429672447013,40.0,0.0
6228,0,6228,[318  79  64  98 588],18,5,25748,4.133568791138225,40.0,0.0
6229,0,6229,[302 132 111  79 197],450,5,25753,4.13370786516854,0.0,0.0
6230,0,6230,[175 215 176 238 161],716,2,25755,4.133365430909966,0.0,0.0
6231,0,6231,[322 143  71   7 195],786,4,25759,4.133344030808729,0.0,0.0
6232,0,6232,[603 597 322   8 748],796,4,25763,4.133322637574202,20.0,0.0
6233,0,6233,[197 185  56 275 182],796,4,25767,4.13330125120308,0.0,20.0
6234,0,6234,[182  71 132 655  64],450,4,25771,4.133279871692061,20.0,0.0
6235,0,6235,[215 483  79 275 357],535,3,25774,4.133098139833226,0.0,20.0
6236,0,6236,[318  79  64  98 588],796,5,25779,4.133237133237134,40.0,0.0
6237,0,6237,[515  64 100 603 181],72,4,25783,4.13321577428663,40.0,20.0
6238,0,6238,[318  79  64  98 588],18,5,25788,4.133354704279532,40.0,0.0
6239,0,6239,[318  79  64  98 588],796,5,25793,4.13349358974359,40.0,0.0
6240,0,6240,[318  79  64  98 588],457,5,25798,4.133632430700208,40.0,0.0
6241,0,6241,[318  79  64  98 588],796,5,25803,4.1337712271707785,40.0,0.0
6242,0,6242,[168 427 603 357 655],269,5,25808,4.133909979176678,40.0,0.0
6243,0,6243,[100  97 508  95 216],344,4,25812,4.133888532991672,0.0,20.0
6244,0,6244,[742 238  89 215 118],655,1,25813,4.133386709367494,0.0,0.0
6245,0,6245,[318  79  64  98 588],450,5,25818,4.133525456292027,40.0,0.0
6246,0,6246,[318  79  64  98 588],18,5,25823,4.133664158796222,40.0,0.0
6247,0,6247,[318  79  64  98 588],716,5,25828,4.133802816901408,40.0,0.0
6248,0,6248,[318  79  64  98 588],450,5,25833,4.133941430628901,40.0,0.0
6249,0,6249,[318  79  64  98 588],716,5,25838,4.13408,40.0,0.0
6250,0,6250,[655 195 483  56  82],269,3,25841,4.1338985762278035,0.0,0.0
6251,0,6251,[318  79  64  98 588],716,5,25846,4.1340371081253995,40.0,0.0
6252,0,6252,[318  79  64  98 588],450,5,25851,4.134175595714058,40.0,0.0
6253,0,6253,[ 70  69 172 245   8],344,2,25853,4.133834346018548,0.0,0.0
6254,0,6254,[318  79  64  98 588],716,5,25858,4.1339728217426055,40.0,0.0
6255,0,6255,[435  89 132 151  70],18,3,25861,4.133791560102302,0.0,0.0
6256,0,6256,[318  79  64  98 588],18,5,25866,4.13392999840179,40.0,0.0
6257,0,6257,[318  79  64  98 588],716,5,25871,4.134068392457654,40.0,0.0
6258,0,6258,[286  11  64  82 235],450,3,25874,4.133887202428503,20.0,20.0
6259,0,6259,[318  79  64  98 588],796,5,25879,4.134025559105432,40.0,0.0
6260,0,6260,[318  79  64  98 588],457,5,25884,4.134163871586009,40.0,0.0
6261,0,6261,[194 568 237  50 176],450,5,25889,4.134302139891409,0.0,20.0
6262,0,6262,[318  79  64  98 588],450,5,25894,4.134440364042791,40.0,0.0
6263,0,6263,[318  79  64  98 588],457,5,25899,4.134578544061303,40.0,0.0
6264,0,6264,[222 237 185  89 318],796,5,25904,4.134716679968077,20.0,0.0
6265,0,6265,[117 222  28 405 186],796,3,25907,4.134535588892436,0.0,0.0
6266,0,6266,[172 183  88   1 118],716,3,25910,4.134354555608744,0.0,0.0
6267,0,6267,[200  28 135 180  12],18,2,25912,4.13401403956605,0.0,0.0
6268,0,6268,[318  79  64  98 588],796,5,25917,4.134152177380763,40.0,0.0
6269,0,6269,[318  79  64  98 588],18,5,25922,4.134290271132376,40.0,0.0
6270,0,6270,[216 153 181  70 185],23,4,25926,4.134268856641684,0.0,0.0
6271,0,6271,[742 181 313 405 127],655,2,25928,4.133928571428571,0.0,20.0
6272,0,6272,[318  79  64  98 588],18,5,25933,4.134066634783995,40.0,0.0
6273,0,6273,[318  79  64  98 588],716,5,25938,4.134204654128148,40.0,0.0
6274,0,6274,[318  79  64  98 588],796,5,25943,4.134342629482072,40.0,0.0
6275,0,6275,[318  79  64  98 588],577,5,25948,4.134480560866794,40.0,0.0
6276,0,6276,[318  79  64  98 588],457,5,25953,4.134618448303329,40.0,0.0
6277,0,6277,[318  79  64  98 588],577,5,25958,4.134756291812679,40.0,0.0
6278,0,6278,[318  79  64  98 588],716,5,25963,4.1348940914158305,40.0,0.0
6279,0,6279,[318  79  64  98 588],577,5,25968,4.135031847133758,40.0,0.0
6280,0,6280,[168 515 496 202 186],716,4,25972,4.135010348670594,20.0,0.0
6281,0,6281,[318  79  64  98 588],457,5,25977,4.1351480420248325,40.0,0.0
6282,0,6282,[234  97 228 197  88],693,1,25978,4.134649053000159,0.0,0.0
6283,0,6283,[318  79  64  98 588],716,5,25983,4.134786760025461,40.0,0.0
6284,0,6284,[186 211  25 435 111],389,2,25985,4.1344470962609385,0.0,0.0
6285,0,6285,[294  69 357 210 185],504,4,25989,4.134425707922367,0.0,0.0
6286,0,6286,[273 196 194 111 282],796,4,25993,4.134404326387784,0.0,0.0
6287,0,6287,[318  79  64  98 588],450,5,25998,4.134541984732825,40.0,0.0
6288,0,6288,[318  79  64  98 588],457,5,26003,4.134679599300366,40.0,0.0
6289,0,6289,[318  79  64  98 588],450,5,26008,4.134817170111288,40.0,0.0
6290,0,6290,[ 64 403  88 546 196],450,5,26013,4.134954697186457,20.0,0.0
6291,0,6291,[318  79  64  98 588],716,5,26018,4.135092180546726,40.0,0.0
6292,0,6292,[318  79  64  98 588],577,5,26023,4.135229620212935,40.0,0.0
6293,0,6293,[ 88 151 210  89  25],256,5,26028,4.13536701620591,0.0,0.0
6294,0,6294,[318  79  64  98 588],577,5,26033,4.135504368546465,40.0,0.0
6295,0,6295,[318  79  64  98 588],577,5,26038,4.1356416772554,40.0,0.0
6296,0,6296,[318 210  69 125 237],401,2,26040,4.135302525011911,20.0,0.0
6297,0,6297,[245 228 195 508  64],344,4,26044,4.135281041600508,20.0,0.0
6298,0,6298,[180  12 322 288 200],280,5,26049,4.135418320368313,0.0,0.0
6299,0,6299,[328 204 111  70 132],151,4,26053,4.135396825396826,0.0,0.0
6300,0,6300,[318  79  64  98 588],716,5,26058,4.135534042215522,40.0,0.0
6301,0,6301,[318  79  64  98 588],796,5,26063,4.135671215487147,40.0,0.0
6302,0,6302,[  1 197 300   9 483],151,5,26068,4.135808345232429,0.0,0.0
6303,0,6303,[318  79  64  98 588],457,5,26073,4.135945431472082,40.0,0.0
6304,0,6304,[318  79  64  98 588],450,5,26078,4.1360824742268045,40.0,0.0
6305,0,6305,[318  79  64  98 588],796,5,26083,4.1362194735172855,40.0,0.0
6306,0,6306,[318  79  64  98 588],457,5,26088,4.136356429364199,40.0,0.0
6307,0,6307,[  9 748 286  12 265],151,4,26092,4.136334812935955,0.0,20.0
6308,0,6308,[173 265 496  79 204],151,5,26097,4.136471707085117,20.0,0.0
6309,0,6309,[117 121 288 508  22],344,2,26099,4.136133122028526,0.0,0.0
6310,0,6310,[ 56 204 471 186 257],457,4,26103,4.136111551259705,0.0,0.0
6311,0,6311,[318  79  64  98 588],577,5,26108,4.136248415716096,40.0,0.0
6312,0,6312,[211 234 228  28 357],151,5,26113,4.1363852368129255,0.0,0.0
6313,0,6313,[235 174 405 179 216],457,4,26117,4.136363636363637,0.0,0.0
6314,0,6314,[318  79  64  98 588],796,5,26122,4.136500395882819,40.0,0.0
6315,0,6315,[318  79  64  98 588],577,5,26127,4.136637112096263,40.0,0.0
6316,0,6316,[ 70   7 176 200  79],450,4,26131,4.13661548203261,0.0,0.0
6317,0,6317,[258 405 210 742 118],450,3,26134,4.1364355808800255,0.0,0.0
6318,0,6318,[318  79  64  98 588],716,5,26139,4.136572242443425,40.0,0.0
6319,0,6319,[187 111 357 222 271],796,5,26144,4.1367088607594935,0.0,0.0
6320,0,6320,[117 427 197  69 423],716,5,26149,4.136845435848758,20.0,0.0
6321,0,6321,[210 174  70  15 118],593,4,26153,4.136823789939893,0.0,0.0
6322,0,6322,[286 151 300 204 186],389,2,26155,4.136485845326585,0.0,20.0
6323,0,6323,[318  79  64  98 588],450,5,26160,4.136622390891841,40.0,0.0
6324,0,6324,[ 22 568  98 194 168],716,5,26165,4.136758893280632,0.0,0.0
6325,0,6325,[222 475 435 269 282],296,5,26170,4.136895352513436,0.0,0.0
6326,0,6326,[234 216 173 403  64],457,5,26175,4.137031768610716,20.0,0.0
6327,0,6327,[282   1   8 238 748],796,3,26178,4.1368520859671305,0.0,0.0
6328,0,6328,[215 125 210 191 100],450,4,26182,4.136830462948333,0.0,20.0
6329,0,6329,[318  79  64  98 588],457,5,26187,4.13696682464455,40.0,0.0
6330,0,6330,[318  79  64  98 588],796,5,26192,4.137103143263308,40.0,0.0
6331,0,6331,[181 216 294 185 238],450,5,26197,4.137239418825016,0.0,0.0
6332,0,6332,[471 161 187 318 182],450,5,26202,4.137375651350071,20.0,0.0
6333,0,6333,[603  11 127 143 211],655,3,26205,4.137196084622671,20.0,20.0
6334,0,6334,[204 742 328 302 286],450,5,26210,4.13733228097869,0.0,20.0
6335,0,6335,[318  79  64  98 588],450,5,26215,4.137468434343434,40.0,0.0
6336,0,6336,[195  22 210 111 125],655,0,26215,4.1368155278522964,0.0,0.0
6337,0,6337,[ 97 117 121 191 597],457,4,26219,4.136793941306406,0.0,0.0
6338,0,6338,[318  79  64  98 588],450,5,26224,4.13693011516012,40.0,0.0
6339,0,6339,[210  11 176 183 302],344,4,26228,4.136908517350157,0.0,0.0
6340,0,6340,[143 742 546 204 286],796,3,26231,4.136729222520107,0.0,20.0
6341,0,6341,[318  79  64  98 588],457,5,26236,4.136865342163356,40.0,0.0
6342,0,6342,[132 742 546 288 568],457,4,26240,4.136843764780073,0.0,0.0
6343,0,6343,[ 56 121 144 597 405],450,4,26244,4.136822194199244,0.0,0.0
6344,0,6344,[318  79  64  98 588],457,5,26249,4.136958234830575,40.0,0.0
6345,0,6345,[125  12 144 100 742],655,0,26249,4.136306334699023,0.0,20.0
6346,0,6346,[127 385  64 427 237],796,5,26254,4.1364424137387745,40.0,20.0
6347,0,6347,[  1 175 289 300 234],655,0,26254,4.135790800252048,0.0,0.0
6348,0,6348,[318  79  64  98 588],457,5,26259,4.135926917624823,40.0,0.0
6349,0,6349,[318  79  64  98 588],18,5,26264,4.136062992125984,40.0,0.0
6350,0,6350,[100 357 118 172 204],593,5,26269,4.1361990237757835,0.0,20.0
6351,0,6351,[318  79  64  98 588],18,5,26274,4.136335012594459,40.0,0.0
6352,0,6352,[603 204 301  95 118],450,3,26277,4.136156146702345,20.0,0.0
6353,0,6353,[179 475  50  69 300],389,4,26281,4.136134718287693,0.0,20.0
6354,0,6354,[172 294 187 117 282],716,3,26284,4.135955940204563,0.0,0.0
6355,0,6355,[318  79  64  98 588],716,5,26289,4.136091881686595,40.0,0.0
6356,0,6356,[180 210 515 238 202],18,4,26293,4.1360704734937865,0.0,0.0
6357,0,6357,[318  79  64  98 588],716,5,26298,4.136206354199434,40.0,0.0
6358,0,6358,[195 235 216 172  50],330,4,26302,4.136184934738166,0.0,20.0
6359,0,6359,[275 216 313  25   1],655,3,26305,4.136006289308176,0.0,20.0
6360,0,6360,[318  79  64  98 588],577,5,26310,4.136142116019494,40.0,0.0
6361,0,6361,[318  79  64  98 588],796,5,26315,4.136277900031437,40.0,0.0
6362,0,6362,[ 89 748 597  82 176],450,4,26319,4.136256482791136,0.0,0.0
6363,0,6363,[121 318   7 182 187],72,3,26322,4.13607793840352,20.0,0.0
6364,0,6364,[318  79  64  98 588],796,5,26327,4.136213668499607,40.0,0.0
6365,0,6365,[ 88  11 181 294 405],655,0,26327,4.135563933396167,0.0,0.0
6366,0,6366,[318  79  64  98 588],796,5,26332,4.135699701586304,40.0,0.0
6367,0,6367,[195 286 235  69 323],280,3,26335,4.1355213567839195,0.0,20.0
6368,0,6368,[318  79  64  98 588],18,5,26340,4.135657089024964,40.0,0.0
6369,0,6369,[318  79  64  98 588],450,5,26345,4.135792778649922,40.0,0.0
6370,0,6370,[318  79  64  98 588],457,5,26350,4.135928425678857,40.0,0.0
6371,0,6371,[318  79  64  98 588],577,5,26355,4.136064030131827,40.0,0.0
6372,0,6372,[194 301 127 100 132],796,3,26358,4.135885768084105,0.0,40.0
6373,0,6373,[357 385 222 328 302],151,2,26360,4.135550674615626,0.0,0.0
6374,0,6374,[471 288  96  12 144],693,3,26363,4.135372549019608,0.0,0.0
6375,0,6375,[318  79  64  98 588],577,5,26368,4.135508155583438,40.0,0.0
6376,0,6376,[ 64  22 100 357 187],316,4,26372,4.135486906068684,20.0,20.0
6377,0,6377,[286 515  56 187 435],296,5,26377,4.1356224521793665,0.0,20.0
6378,0,6378,[318  79  64  98 588],457,5,26382,4.135757955792444,40.0,0.0
6379,0,6379,[318  79  64  98 588],457,5,26387,4.1358934169279,40.0,0.0
6380,0,6380,[318  79  64  98 588],796,5,26392,4.136028835605704,40.0,0.0
6381,0,6381,[111 185 196  22 508],11,5,26397,4.136164211845816,0.0,0.0
6382,0,6382,[318  79  64  98 588],18,5,26402,4.136299545668181,40.0,0.0
6383,0,6383,[318  79  64  98 588],577,5,26407,4.1364348370927315,40.0,0.0
6384,0,6384,[546 385 211   1 483],151,3,26410,4.136256851996868,0.0,0.0
6385,0,6385,[318  79  64  98 588],18,5,26415,4.136392107735672,40.0,0.0
6386,0,6386,[318  79  64  98 588],457,5,26420,4.136527321121027,40.0,0.0
6387,0,6387,[181 603  88 222  70],450,4,26424,4.136505948653726,20.0,0.0
6388,0,6388,[210 385 427 191 318],151,3,26427,4.136328063859759,40.0,0.0
6389,0,6389,[318  79  64  98 588],796,5,26432,4.1364632237871675,40.0,0.0
6390,0,6390,[151 200 276  96 191],269,4,26436,4.13644187138163,0.0,0.0
6391,0,6391,[ 98 172 318 176 210],693,2,26438,4.136107634543179,20.0,0.0
6392,0,6392,[210 211 161 127 121],716,4,26442,4.136086344439231,0.0,20.0
6393,0,6393,[318  79  64  98 588],796,5,26447,4.136221457616515,40.0,0.0
6394,0,6394,[ 71  88  50 143 121],450,3,26450,4.136043784206411,0.0,20.0
6395,0,6395,[318  79  64  98 588],18,5,26455,4.1361788617886175,40.0,0.0
6396,0,6396,[318  79  64  98 588],796,5,26460,4.136313897139284,40.0,0.0
6397,0,6397,[318  79  64  98 588],577,5,26465,4.136448890278212,40.0,0.0
6398,0,6398,[318  79  64  98 588],796,5,26470,4.136583841225192,40.0,0.0
6399,0,6399,[318  79  64  98 588],796,5,26475,4.13671875,40.0,0.0
6400,0,6400,[271 210 427 211 496],807,4,26479,4.136697391032651,40.0,0.0
6401,0,6401,[318  79  64  98 588],716,5,26484,4.136832239925023,40.0,0.0
6402,0,6402,[286 237 144 197 186],535,3,26487,4.136654693112604,0.0,20.0
6403,0,6403,[215  22  88 245 258],344,0,26487,4.136008744534666,0.0,0.0
6404,0,6404,[427 405 228 153  88],655,1,26488,4.13551912568306,20.0,0.0
6405,0,6405,[318  79  64  98 588],577,5,26493,4.1356540743053385,40.0,0.0
6406,0,6406,[ 11 132 238 172 742],436,2,26495,4.135320742937412,0.0,0.0
6407,0,6407,[ 71 328  50  12 357],450,4,26499,4.135299625468165,0.0,20.0
6408,0,6408,[471 245 423   9  70],280,3,26502,4.135122484006866,0.0,0.0
6409,0,6409,[318  79  64  98 588],18,5,26507,4.135257410296412,40.0,0.0
6410,0,6410,[318  79  64  98 588],796,5,26512,4.135392294493839,40.0,0.0
6411,0,6411,[216 197 118 132 153],716,4,26516,4.135371179039302,0.0,0.0
6412,0,6412,[318  79  64  98 588],716,5,26521,4.135506003430532,40.0,0.0
6413,0,6413,[318  79  64  98 588],796,5,26526,4.135640785781104,40.0,0.0
6414,0,6414,[328 238 175  96 288],655,0,26526,4.134996102883866,0.0,0.0
6415,0,6415,[318  79  64  98 588],450,5,26531,4.135130922693267,40.0,0.0
6416,0,6416,[318  79  64  98 588],796,5,26536,4.1352657004830915,40.0,0.0
6417,0,6417,[318  79  64  98 588],450,5,26541,4.135400436272982,40.0,0.0
6418,0,6418,[318  79  64  98 588],18,5,26546,4.135535130082568,40.0,0.0
6419,0,6419,[318  79  64  98 588],18,5,26551,4.1356697819314645,40.0,0.0
6420,0,6420,[ 69 222 176 237 210],280,1,26552,4.135181435913409,0.0,0.0
6421,0,6421,[  9 237  79   4 423],457,5,26557,4.135316100903146,0.0,0.0
6422,0,6422,[318  79  64  98 588],18,5,26562,4.135450723960766,40.0,0.0
6423,0,6423,[318  79  64  98 588],18,5,26567,4.135585305105853,40.0,0.0
6424,0,6424,[222 151  64 483 111],716,5,26572,4.135719844357976,20.0,0.0
6425,0,6425,[318  79  64  98 588],577,5,26577,4.135854341736695,40.0,0.0
6426,0,6426,[318  79  64  98 588],796,5,26582,4.135988797261553,40.0,0.0
6427,0,6427,[318  79  64  98 588],450,5,26587,4.136123210952085,40.0,0.0
6428,0,6428,[318  79  64  98 588],577,5,26592,4.136257582827811,40.0,0.0
6429,0,6429,[318  79  64  98 588],796,5,26597,4.136391912908243,40.0,0.0
6430,0,6430,[318  79  64  98 588],457,5,26602,4.136526201212875,40.0,0.0
6431,0,6431,[318  79  64  98 588],577,5,26607,4.136660447761194,40.0,0.0
6432,0,6432,[423  70 179 655 135],655,2,26609,4.136328307166174,0.0,0.0
6433,0,6433,[318  79  64  98 588],577,5,26614,4.136462542741685,40.0,0.0
6434,0,6434,[  1 385  79  64 143],151,4,26618,4.136441336441337,20.0,0.0
6435,0,6435,[546 237 483 197 118],796,4,26622,4.136420136730889,0.0,0.0
6436,0,6436,[318  79  64  98 588],577,5,26627,4.136554295479261,40.0,0.0
6437,0,6437,[258 211  12  64 294],655,1,26628,4.136067101584343,20.0,0.0
6438,0,6438,[318  79  64  98 588],577,5,26633,4.1362012734896725,40.0,0.0
6439,0,6439,[238  96 475 405 655],655,0,26633,4.13555900621118,0.0,0.0
6440,0,6440,[318 403 515 282  69],655,2,26635,4.1352274491538585,20.0,0.0
6441,0,6441,[318  79  64  98 588],796,5,26640,4.135361688916485,40.0,0.0
6442,0,6442,[  8   1 215 228 496],796,4,26644,4.135340679807543,20.0,0.0
6443,0,6443,[318  79  64  98 588],18,5,26649,4.135474860335195,40.0,0.0
6444,0,6444,[111  71 215 216 322],280,4,26653,4.135453840186191,0.0,0.0
6445,0,6445,[318  79  64  98 588],716,5,26658,4.135587961526528,40.0,0.0
6446,0,6446,[ 15  69 228 132 234],786,3,26661,4.1354118194509075,0.0,0.0
6447,0,6447,[385 405 273 546 483],796,4,26665,4.135390818858561,0.0,0.0
6448,0,6448,[318  79  64  98 588],577,5,26670,4.13552488757947,40.0,0.0
6449,0,6449,[318  79  64  98 588],457,5,26675,4.135658914728682,40.0,0.0
6450,0,6450,[181 742 568 111 180],457,4,26679,4.135637885599132,0.0,0.0
6451,0,6451,[318  79  64  98 588],18,5,26684,4.135771853688778,40.0,0.0
6452,0,6452,[318  79  64  98 588],716,5,26689,4.135905780257245,40.0,0.0
6453,0,6453,[318  79  64  98 588],450,5,26694,4.13603966532383,40.0,0.0
6454,0,6454,[216   4  70 294 153],716,4,26698,4.136018590240124,0.0,0.0
6455,0,6455,[318  79  64  98 588],457,5,26703,4.136152416356877,40.0,0.0
6456,0,6456,[ 11 483 496   1  88],716,5,26708,4.136286201022147,20.0,0.0
6457,0,6457,[318  79  64  98 588],450,5,26713,4.136419944255187,40.0,0.0
6458,0,6458,[318  79  64  98 588],18,5,26718,4.136553646075244,40.0,0.0
6459,0,6459,[318  79  64  98 588],577,5,26723,4.136687306501548,40.0,0.0
6460,0,6460,[318  79  64  98 588],450,5,26728,4.1368209255533195,40.0,0.0
6461,0,6461,[318  79  64  98 588],796,5,26733,4.136954503249767,40.0,0.0
6462,0,6462,[318  79  64  98 588],450,5,26738,4.137088039610088,40.0,0.0
6463,0,6463,[144 435  12   7 237],450,5,26743,4.137221534653466,0.0,0.0
6464,0,6464,[318  79  64  98 588],577,5,26748,4.137354988399072,40.0,0.0
6465,0,6465,[143 125 117 185 173],450,5,26753,4.137488400866069,0.0,0.0
6466,0,6466,[294 125 237 423 313],152,5,26758,4.137621772073604,0.0,0.0
6467,0,6467,[318  79  64  98 588],716,5,26763,4.137755102040816,40.0,0.0
6468,0,6468,[282 357  22 111   7],655,1,26764,4.137270057195857,0.0,0.0
6469,0,6469,[176 475 183 237 288],655,1,26765,4.136785162287481,0.0,0.0
6470,0,6470,[ 12 100 265 742 117],655,0,26765,4.136145881625715,0.0,20.0
6471,0,6471,[196 161 257 173 195],457,4,26769,4.136124845488257,0.0,0.0
6472,0,6472,[405 257   9 196  97],401,2,26771,4.135794840105052,0.0,0.0
6473,0,6473,[318  79  64  98 588],577,5,26776,4.135928328699413,40.0,0.0
6474,0,6474,[318  79  64  98 588],450,5,26781,4.136061776061776,40.0,0.0
6475,0,6475,[318  79  64  98 588],577,5,26786,4.1361951822112415,40.0,0.0
6476,0,6476,[318  79  64  98 588],18,5,26791,4.136328547166898,40.0,0.0
6477,0,6477,[318  79  64  98 588],450,5,26796,4.136461870947824,40.0,0.0
6478,0,6478,[318  79  64  98 588],577,5,26801,4.136595153573082,40.0,0.0
6479,0,6479,[172  98 238  15 357],796,4,26805,4.136574074074074,0.0,0.0
6480,0,6480,[318  79  64  98 588],457,5,26810,4.136707298256442,40.0,0.0
6481,0,6481,[125 245  56 216 181],256,4,26814,4.136686207960506,0.0,0.0
6482,0,6482,[215  56 118 318 111],151,3,26817,4.1365108745950945,20.0,0.0
6483,0,6483,[185 301 117 215 216],450,5,26822,4.136644046884639,0.0,0.0
6484,0,6484,[435   7 471 237  82],450,4,26826,4.136622976098689,0.0,0.0
6485,0,6485,[117 427  50   1 125],296,4,26830,4.136601911810052,20.0,20.0
6486,0,6486,[318  79  64  98 588],450,5,26835,4.136735008478495,40.0,0.0
6487,0,6487,[282 546 153  79 127],796,5,26840,4.136868064118373,0.0,20.0
6488,0,6488,[318  79  64  98 588],577,5,26845,4.137001078748652,40.0,0.0
6489,0,6489,[318  79  64  98 588],450,5,26850,4.13713405238829,40.0,0.0
6490,0,6490,[  4 172  97 322 385],151,3,26853,4.136958866122323,0.0,0.0
6491,0,6491,[318  79  64  98 588],457,5,26858,4.137091805298829,40.0,0.0
6492,0,6492,[210 181 132 125 423],796,4,26862,4.137070691513938,0.0,0.0
6493,0,6493,[318  79  64  98 588],577,5,26867,4.137203572528488,40.0,0.0
6494,0,6494,[318  79  64  98 588],716,5,26872,4.137336412625096,40.0,0.0
6495,0,6495,[318  79  64  98 588],716,5,26877,4.13746921182266,40.0,0.0
6496,0,6496,[125 405 194 238  69],796,4,26881,4.137448052947514,0.0,0.0
6497,0,6497,[300  88 216 427 357],796,5,26886,4.137580794090489,20.0,0.0
6498,0,6498,[144 427  89 127 313],655,4,26890,4.137559624557624,20.0,20.0
6499,0,6499,[318  79  64  98 588],457,5,26895,4.137692307692308,40.0,0.0
6500,0,6500,[318  79  64  98 588],577,5,26900,4.137824950007691,40.0,0.0
6501,0,6501,[318  79  64  98 588],450,5,26905,4.137957551522608,40.0,0.0
6502,0,6502,[318  79  64  98 588],796,5,26910,4.138090112255882,40.0,0.0
6503,0,6503,[  9 179  69  71 183],786,5,26915,4.138222632226323,0.0,0.0
6504,0,6504,[385 282 176 333 301],655,0,26915,4.137586471944658,0.0,0.0
6505,0,6505,[202 237 357 187 195],18,2,26917,4.137257915770058,0.0,0.0
6506,0,6506,[183 265  71 185 300],796,5,26922,4.137390502535731,0.0,0.0
6507,0,6507,[  8 322 245 210  64],796,2,26924,4.137062077443147,20.0,0.0
6508,0,6508,[318  79  64  98 588],450,5,26929,4.137194653556614,40.0,0.0
6509,0,6509,[318  79  64  98 588],450,5,26934,4.137327188940092,40.0,0.0
6510,0,6510,[318  79  64  98 588],450,5,26939,4.137459683612349,40.0,0.0
6511,0,6511,[245 238 215   7 435],450,5,26944,4.137592137592137,0.0,0.0
6512,0,6512,[318  79  64  98 588],450,5,26949,4.137724550898204,40.0,0.0
6513,0,6513,[ 11 275  98 471 313],344,2,26951,4.13739637703408,0.0,20.0
6514,0,6514,[265 742  71   1 161],577,5,26956,4.137528779739064,0.0,0.0
6515,0,6515,[318  79  64  98 588],457,5,26961,4.137661141804788,40.0,0.0
6516,0,6516,[181 235 655 603 121],269,2,26963,4.1373331287402175,20.0,0.0
6517,0,6517,[318  79  64  98 588],796,5,26968,4.137465480208653,40.0,0.0
6518,0,6518,[235 151  22 118 172],450,3,26971,4.1372909955514645,0.0,0.0
6519,0,6519,[318  79  64  98 588],18,5,26976,4.137423312883436,40.0,0.0
6520,0,6520,[318  79  64  98 588],577,5,26981,4.137555589633492,40.0,0.0
6521,0,6521,[318  79  64  98 588],450,5,26986,4.137687825820301,40.0,0.0
6522,0,6522,[318  79  64  98 588],457,5,26991,4.137820021462518,40.0,0.0
6523,0,6523,[318  79  64  98 588],450,5,26996,4.137952176578786,40.0,0.0
6524,0,6524,[202 301  25 300 174],389,3,26999,4.137777777777778,0.0,0.0
6525,0,6525,[258 173  22  97 234],450,4,27003,4.137756665645112,0.0,0.0
6526,0,6526,[496 228 568 257 132],330,5,27008,4.1378887697257545,20.0,0.0
6527,0,6527,[257 546   1 196 216],23,2,27010,4.137561274509804,0.0,0.0
6528,0,6528,[318  79  64  98 588],577,5,27015,4.137693368050237,40.0,0.0
6529,0,6529,[403 302 322 546  25],450,4,27019,4.137672281776417,0.0,0.0
6530,0,6530,[  1 215   8 268 276],344,2,27021,4.137344970142398,0.0,0.0
6531,0,6531,[ 64 202 127 423 173],716,5,27026,4.137477036129822,20.0,20.0
6532,0,6532,[318  79  64  98 588],716,5,27031,4.13760906168682,40.0,0.0
6533,0,6533,[318  79  64  98 588],796,5,27036,4.137741046831956,40.0,0.0
6534,0,6534,[202  96  69 210  50],655,1,27037,4.137260902830911,0.0,20.0
6535,0,6535,[125   4 111 172 100],151,4,27041,4.1372399020807835,0.0,20.0
6536,0,6536,[228 289 427 273 300],655,2,27043,4.136912957013921,20.0,0.0
6537,0,6537,[318  79  64  98 588],18,5,27048,4.137044967880086,40.0,0.0
6538,0,6538,[ 12  71 300 168   4],796,5,27053,4.137176938369781,0.0,0.0
6539,0,6539,[318  79  64  98 588],577,5,27058,4.137308868501529,40.0,0.0
6540,0,6540,[318  79  64  98 588],18,5,27063,4.137440758293839,40.0,0.0
6541,0,6541,[318  79  64  98 588],450,5,27068,4.137572607765209,40.0,0.0
6542,0,6542,[168 151 269  98 191],796,4,27072,4.137551581843192,0.0,0.0
6543,0,6543,[318  79  64  98 588],716,5,27077,4.13768337408313,40.0,0.0
6544,0,6544,[172 210 194 655   9],796,2,27079,4.137356760886172,0.0,0.0
6545,0,6545,[318  79  64  98 588],450,5,27084,4.1374885426214485,40.0,0.0
6546,0,6546,[  4 423 678  70 200],504,4,27088,4.137467542385825,0.0,0.0
6547,0,6547,[318  79  64  98 588],457,5,27093,4.137599266951741,40.0,0.0
6548,0,6548,[318  79  64  98 588],716,5,27098,4.137730951290274,40.0,0.0
6549,0,6549,[318  79  64  98 588],716,5,27103,4.137862595419847,40.0,0.0
6550,0,6550,[318  79  64  98 588],457,5,27108,4.137994199358877,40.0,0.0
6551,0,6551,[ 22 508  11 588 568],280,3,27111,4.137820512820513,0.0,0.0
6552,0,6552,[318  79  64  98 588],796,5,27116,4.137952083015413,40.0,0.0
6553,0,6553,[318  79  64  98 588],18,5,27121,4.138083613060727,40.0,0.0
6554,0,6554,[300 216 655  71 405],796,4,27125,4.138062547673532,0.0,0.0
6555,0,6555,[318  79  64  98 588],577,5,27130,4.138194020744356,40.0,0.0
6556,0,6556,[216 111 200   7 135],450,3,27133,4.13802043617508,0.0,0.0
6557,0,6557,[318  79  64  98 588],18,5,27138,4.138151875571821,40.0,0.0
6558,0,6558,[318  79  64  98 588],450,5,27143,4.1382832748894645,40.0,0.0
6559,0,6559,[318  79  64  98 588],450,5,27148,4.138414634146342,40.0,0.0
6560,0,6560,[ 25 172 151  28  70],330,5,27153,4.138545953360768,0.0,0.0
6561,0,6561,[546 194  64   4 210],151,4,27157,4.1385248399878085,20.0,0.0
6562,0,6562,[318  79  64  98 588],577,5,27162,4.138656102392199,40.0,0.0
6563,0,6563,[318  79  64  98 588],796,5,27167,4.13878732480195,40.0,0.0
6564,0,6564,[318  79  64  98 588],457,5,27172,4.1389185072353385,40.0,0.0
6565,0,6565,[  8 196 176 276  64],655,2,27174,4.138592750533049,20.0,0.0
6566,0,6566,[196 127  15 176 300],450,4,27178,4.138571646109335,0.0,20.0
6567,0,6567,[211 282 269  89  98],796,3,27181,4.138398294762485,0.0,0.0
6568,0,6568,[318  79  64  98 588],457,5,27186,4.1385294565382855,40.0,0.0
6569,0,6569,[318  79  64  98 588],716,5,27191,4.138660578386606,40.0,0.0
6570,0,6570,[318  79  64  98 588],457,5,27196,4.138791660325674,40.0,0.0
6571,0,6571,[197  89 427   8   4],18,3,27199,4.138618381010347,20.0,0.0
6572,0,6572,[ 56   4 318 300 294],504,3,27202,4.138445154419595,20.0,0.0
6573,0,6573,[318  79  64  98 588],18,5,27207,4.1385762093094005,40.0,0.0
6574,0,6574,[143 117 185 276 182],457,5,27212,4.138707224334601,0.0,0.0
6575,0,6575,[318  79  64  98 588],577,5,27217,4.138838199513382,40.0,0.0
6576,0,6576,[ 89 174 508 202  97],655,1,27218,4.138360954842633,0.0,0.0
6577,0,6577,[655 200  98 151 258],504,5,27223,4.138491942839769,0.0,0.0
6578,0,6578,[318  79  64  98 588],577,5,27228,4.138622891016872,40.0,0.0
6579,0,6579,[318  79  64  98 588],450,5,27233,4.138753799392097,40.0,0.0
6580,0,6580,[ 15  89 204 118 200],796,5,27238,4.138884667983589,0.0,0.0
6581,0,6581,[181 174 185 191 196],269,2,27240,4.138559708295351,0.0,0.0
6582,0,6582,[318  79  64  98 588],450,5,27245,4.1386905666109675,40.0,0.0
6583,0,6583,[318  79  64  98 588],577,5,27250,4.138821385176184,40.0,0.0
6584,0,6584,[318  79  64  98 588],18,5,27255,4.138952164009112,40.0,0.0
6585,0,6585,[111 172 176  12 257],796,5,27260,4.139082903127847,0.0,0.0
6586,0,6586,[269 143  95 603 183],23,3,27263,4.13890997419159,20.0,0.0
6587,0,6587,[318  79  64  98 588],450,5,27268,4.139040680024286,40.0,0.0
6588,0,6588,[ 15 333 357 187 234],796,4,27272,4.139019578084687,0.0,0.0
6589,0,6589,[ 71 204 121  88 187],796,5,27277,4.139150227617602,0.0,0.0
6590,0,6590,[235 302  25 182   1],450,3,27280,4.138977393415264,0.0,0.0
6591,0,6591,[ 79  56   1 151  12],457,5,27285,4.139108009708738,0.0,0.0
6592,0,6592,[215 546  98  96   9],344,3,27288,4.138935234339451,0.0,0.0
6593,0,6593,[318  79  64  98 588],716,5,27293,4.139065817409766,40.0,0.0
6594,0,6594,[153 168 172 151  69],330,4,27297,4.1390447308567095,0.0,0.0
6595,0,6595,[318  79  64  98 588],457,5,27302,4.139175257731959,40.0,0.0
6596,0,6596,[318  79  64  98 588],796,5,27307,4.139305745035622,40.0,0.0
6597,0,6597,[318  79  64  98 588],457,5,27312,4.139436192785692,40.0,0.0
6598,0,6598,[318  79  64  98 588],457,5,27317,4.139566601000151,40.0,0.0
6599,0,6599,[318  79  64  98 588],796,5,27322,4.13969696969697,40.0,0.0
6600,0,6600,[ 96 748 196  88 144],796,5,27327,4.139827298894107,0.0,0.0
6601,0,6601,[588 385  82 483 181],23,4,27331,4.13980611935777,0.0,0.0
6602,0,6602,[318  79  64  98 588],577,5,27336,4.139936392548841,40.0,0.0
6603,0,6603,[  1 202 546 172 151],457,4,27340,4.1399152029073285,0.0,0.0
6604,0,6604,[100  11 210 173  12],577,3,27343,4.1397426192278575,0.0,20.0
6605,0,6605,[318  79  64  98 588],457,5,27348,4.139872842870118,40.0,0.0
6606,0,6606,[318  79  64  98 588],796,5,27353,4.140003027092478,40.0,0.0
6607,0,6607,[318  79  64  98 588],577,5,27358,4.140133171912833,40.0,0.0
6608,0,6608,[215 483  25 515 196],716,5,27363,4.140263277349069,0.0,0.0
6609,0,6609,[172 216 275 318   9],401,3,27366,4.140090771558245,20.0,20.0
6610,0,6610,[748  12   8 173 125],280,2,27368,4.139767054908486,0.0,0.0
6611,0,6611,[318  79  64  98 588],716,5,27373,4.139897156684816,40.0,0.0
6612,0,6612,[ 64 174 245 195  79],796,4,27377,4.139876001814607,20.0,0.0
6613,0,6613,[176 197 603 588 313],796,4,27381,4.139854853341397,20.0,0.0
6614,0,6614,[318  79  64  98 588],18,5,27386,4.139984882842025,40.0,0.0
6615,0,6615,[318  79  64  98 588],18,5,27391,4.140114873035066,40.0,0.0
6616,0,6616,[318  79  64  98 588],716,5,27396,4.140244823938341,40.0,0.0
6617,0,6617,[748 238 173 258 118],450,4,27400,4.140223632517377,0.0,0.0
6618,0,6618,[ 12 195 403 385   8],280,3,27403,4.1400513672760235,0.0,0.0
6619,0,6619,[196 257  89 191 151],23,1,27404,4.139577039274925,0.0,0.0
6620,0,6620,[269 300 301   7  71],450,4,27408,4.139555958314454,0.0,0.0
6621,0,6621,[318  79  64  98 588],577,5,27413,4.1396858954998486,40.0,0.0
6622,0,6622,[318  79  64  98 588],796,5,27418,4.139815793447078,40.0,0.0
6623,0,6623,[515 483 427 568 181],716,5,27423,4.139945652173913,20.0,0.0
6624,0,6624,[273 228  56  12 196],796,4,27427,4.139924528301886,0.0,0.0
6625,0,6625,[228 100 357 161  50],796,4,27431,4.139903410805916,0.0,40.0
6626,0,6626,[318  79  64  98 588],796,5,27436,4.140033197525275,40.0,0.0
6627,0,6627,[318  79  64  98 588],457,5,27441,4.140162945081473,40.0,0.0
6628,0,6628,[318  79  64  98 588],18,5,27446,4.1402926534922315,40.0,0.0
6629,0,6629,[300 234 238 282 403],450,4,27450,4.14027149321267,0.0,0.0
6630,0,6630,[210  28  79 168 100],450,4,27454,4.140250339315337,0.0,20.0
6631,0,6631,[195 427 286 186 313],655,2,27456,4.139927623642944,20.0,20.0
6632,0,6632,[  9   4 211  70  97],151,5,27461,4.140057289311021,0.0,0.0
6633,0,6633,[271 161 275 294  12],655,1,27462,4.139583961410914,0.0,20.0
6634,0,6634,[191 168 196 183 118],716,3,27465,4.1394122079879425,0.0,0.0
6635,0,6635,[ 89  56 475 318 204],269,3,27468,4.139240506329114,20.0,0.0
6636,0,6636,[546  82 125 222  50],280,1,27469,4.138767515443725,0.0,20.0
6637,0,6637,[318  79  64  98 588],457,5,27474,4.138897258210305,40.0,0.0
6638,0,6638,[318  79  64  98 588],716,5,27479,4.139026961891851,40.0,0.0
6639,0,6639,[318  79  64  98 588],450,5,27484,4.139156626506024,40.0,0.0
6640,0,6640,[357 385 204 265 496],796,5,27489,4.139286252070471,20.0,0.0
6641,0,6641,[245 125 161 323 200],504,5,27494,4.13941583860283,0.0,0.0
6642,0,6642,[655 174 100   4 405],457,5,27499,4.139545386120728,0.0,20.0
6643,0,6643,[318  79  64  98 588],796,5,27504,4.139674894641782,40.0,0.0
6644,0,6644,[568 182 132  56 235],450,4,27508,4.139653875094056,0.0,0.0
6645,0,6645,[318  79  64  98 588],18,5,27513,4.139783328317785,40.0,0.0
6646,0,6646,[  1  22   7 483 268],655,1,27514,4.139310967353693,0.0,0.0
6647,0,6647,[318  79  64  98 588],577,5,27519,4.139440433212997,40.0,0.0
6648,0,6648,[132  71 161   9  12],796,4,27523,4.139419461573169,0.0,0.0
6649,0,6649,[318  79  64  98 588],796,5,27528,4.139548872180451,40.0,0.0
6650,0,6650,[  4 742 238  89 300],450,4,27532,4.139527890542776,0.0,0.0
6651,0,6651,[ 70 196 588 127 603],18,3,27535,4.139356584485869,20.0,20.0
6652,0,6652,[258 313 121  95   1],344,1,27536,4.13888471366301,0.0,0.0
6653,0,6653,[ 95 135 655 257 234],716,4,27540,4.138863841298467,0.0,0.0
6654,0,6654,[318  79  64  98 588],457,5,27545,4.138993238166792,40.0,0.0
6655,0,6655,[318  79  64  98 588],450,5,27550,4.139122596153846,40.0,0.0
6656,0,6656,[318  79  64  98 588],716,5,27555,4.139251915277152,40.0,0.0
6657,0,6657,[318  79  64  98 588],716,5,27560,4.13938119555422,40.0,0.0
6658,0,6658,[174 427 132  88   9],236,3,27563,4.139210091605346,20.0,0.0
6659,0,6659,[318  79  64  98 588],18,5,27568,4.139339339339339,40.0,0.0
6660,0,6660,[318  79  64  98 588],457,5,27573,4.139468548266026,40.0,0.0
6661,0,6661,[318  79  64  98 588],18,5,27578,4.139597718402882,40.0,0.0
6662,0,6662,[118 237 286 301 127],655,1,27579,4.139126519585772,0.0,40.0
6663,0,6663,[196 405 183 323 211],23,2,27581,4.138805522208884,0.0,0.0
6664,0,6664,[211 483 288 185 475],655,2,27583,4.138484621155289,0.0,0.0
6665,0,6665,[ 88 276 200  69 423],280,4,27587,4.138463846384639,0.0,0.0
6666,0,6666,[318  79  64  98 588],18,5,27592,4.138593070346483,40.0,0.0
6667,0,6667,[318  79  64  98 588],18,5,27597,4.13872225554889,40.0,0.0
6668,0,6668,[121 125  96 175 216],344,3,27600,4.13855150697256,0.0,0.0
6669,0,6669,[100 168 200 357 427],151,3,27603,4.138380809595202,20.0,20.0
6670,0,6670,[194  50 496 175 235],269,3,27606,4.138210163393794,20.0,20.0
6671,0,6671,[318  79  64  98 588],716,5,27611,4.13833932853717,40.0,0.0
6672,0,6672,[318  79  64  98 588],716,5,27616,4.13846845496778,40.0,0.0
6673,0,6673,[318  79  64  98 588],716,5,27621,4.138597542703026,40.0,0.0
6674,0,6674,[318  79  64  98 588],577,5,27626,4.1387265917602996,40.0,0.0
6675,0,6675,[238 200 568 132 265],436,1,27627,4.138256440982624,0.0,0.0
6676,0,6676,[318  79  64  98 588],450,5,27632,4.13838550247117,40.0,0.0
6677,0,6677,[194 127  70 196 202],401,4,27636,4.138364779874214,0.0,20.0
6678,0,6678,[318  79  64  98 588],716,5,27641,4.138493786494984,40.0,0.0
6679,0,6679,[ 88 182 237 151 300],450,5,27646,4.138622754491018,0.0,0.0
6680,0,6680,[318  79  64  98 588],577,5,27651,4.138751683879659,40.0,0.0
6681,0,6681,[318  79  64  98 588],18,5,27656,4.13888057467824,40.0,0.0
6682,0,6682,[234  64  98 204  56],18,3,27659,4.138710160107736,20.0,0.0
6683,0,6683,[174 258   4 301 183],796,4,27663,4.138689407540395,0.0,0.0
6684,0,6684,[202 268 597  98  12],174,4,27667,4.13866866118175,0.0,0.0
6685,0,6685,[211 318 125  89 216],450,5,27672,4.138797487286868,20.0,0.0
6686,0,6686,[183 195 302 496 176],269,1,27673,4.138328099297143,20.0,0.0
6687,0,6687,[318 257  82   9  25],457,4,27677,4.138307416267943,20.0,0.0
6688,0,6688,[318  79  64  98 588],450,5,27682,4.138436238600688,40.0,0.0
6689,0,6689,[318  79  64  98 588],577,5,27687,4.138565022421525,40.0,0.0
6690,0,6690,[ 11 385 195 742 597],344,1,27688,4.138095949783291,0.0,0.0
6691,0,6691,[318  79  64  98 588],18,5,27693,4.138224745965331,40.0,0.0
6692,0,6692,[597 180 196 210  96],796,3,27696,4.138054683998207,0.0,0.0
6693,0,6693,[318  79  64  98 588],577,5,27701,4.138183447863758,40.0,0.0
6694,0,6694,[ 25 385 286 185  64],655,2,27703,4.137864077669903,20.0,20.0
6695,0,6695,[475   9 118 405 748],292,2,27705,4.137544802867383,0.0,0.0
6696,0,6696,[195   1 275 173 186],457,5,27710,4.137673585187398,0.0,20.0
6697,0,6697,[318  79  64  98 588],716,5,27715,4.137802329053449,40.0,0.0
6698,0,6698,[318  79  64  98 588],716,5,27720,4.137931034482759,40.0,0.0
6699,0,6699,[245 275 742 597  15],593,2,27722,4.137611940298507,0.0,20.0
6700,0,6700,[318  79  64  98 588],450,5,27727,4.137740635726011,40.0,0.0
6701,0,6701,[318  79  64  98 588],457,5,27732,4.137869292748434,40.0,0.0
6702,0,6702,[318  79  64  98 588],457,5,27737,4.137997911382963,40.0,0.0
6703,0,6703,[ 98 117 132  28  11],577,4,27741,4.137977326968974,0.0,0.0
6704,0,6704,[ 12 195   1  71 273],344,3,27744,4.137807606263982,0.0,0.0
6705,0,6705,[318  79  64  98 588],577,5,27749,4.137936176558306,40.0,0.0
6706,0,6706,[318  79  64  98 588],18,5,27754,4.138064708513493,40.0,0.0
6707,0,6707,[318  79  64  98 588],716,5,27759,4.138193202146691,40.0,0.0
6708,0,6708,[318  79  64  98 588],457,5,27764,4.138321657475034,40.0,0.0
6709,0,6709,[318  79  64  98 588],18,5,27769,4.1384500745156485,40.0,0.0
6710,0,6710,[ 12 202 328 234  56],450,4,27773,4.138429444196096,0.0,0.0
6711,0,6711,[318  79  64  98 588],18,5,27778,4.138557806912992,40.0,0.0
6712,0,6712,[318  79  64  98 588],577,5,27783,4.138686131386861,40.0,0.0
6713,0,6713,[245 161 496 257 238],796,3,27786,4.138516532618409,20.0,0.0
6714,0,6714,[318  79  64  98 588],450,5,27791,4.138644825018615,40.0,0.0
6715,0,6715,[195  82 322 234 228],151,2,27793,4.138326384752829,0.0,0.0
6716,0,6716,[318  79  64  98 588],577,5,27798,4.13845466726217,40.0,0.0
6717,0,6717,[318  79  64  98 588],18,5,27803,4.138582911580827,40.0,0.0
6718,0,6718,[318  79  64  98 588],796,5,27808,4.138711117725852,40.0,0.0
6719,0,6719,[ 89 597  96 117 173],450,5,27813,4.138839285714286,0.0,0.0
6720,0,6720,[318  79  64  98 588],457,5,27818,4.13896741556316,40.0,0.0
6721,0,6721,[318  79  64  98 588],450,5,27823,4.139095507289497,40.0,0.0
6722,0,6722,[318  79  64  98 588],18,5,27828,4.139223560910308,40.0,0.0
6723,0,6723,[318  79  64  98 588],716,5,27833,4.139351576442594,40.0,0.0
6724,0,6724,[318  79  64  98 588],577,5,27838,4.139479553903346,40.0,0.0
6725,0,6725,[318  79  64  98 588],450,5,27843,4.139607493309545,40.0,0.0
6726,0,6726,[318  79  64  98 588],457,5,27848,4.139735394678163,40.0,0.0
6727,0,6727,[318  79  64  98 588],450,5,27853,4.13986325802616,40.0,0.0
6728,0,6728,[ 56 144 603 161 100],450,5,27858,4.139991083370486,20.0,20.0
6729,0,6729,[318  79  64  98 588],18,5,27863,4.140118870728084,40.0,0.0
6730,0,6730,[282 515 117 294 435],401,2,27865,4.139800921111276,0.0,0.0
6731,0,6731,[318  79  64  98 588],796,5,27870,4.139928698752228,40.0,0.0
6732,0,6732,[111  89  70 210 179],786,5,27875,4.140056438437546,0.0,0.0
6733,0,6733,[318  79  64  98 588],796,5,27880,4.14018414018414,40.0,0.0
6734,0,6734,[173  71 471 435 235],401,2,27882,4.139866369710468,0.0,0.0
6735,0,6735,[182 202 403 265 185],655,2,27884,4.139548693586699,0.0,0.0
6736,0,6736,[318  79  64  98 588],716,5,27889,4.139676413834051,40.0,0.0
6737,0,6737,[318  79  64  98 588],457,5,27894,4.139804096170971,40.0,0.0
6738,0,6738,[318  79  64  98 588],716,5,27899,4.139931740614334,40.0,0.0
6739,0,6739,[318  79  64  98 588],18,5,27904,4.140059347181009,40.0,0.0
6740,0,6740,[175  50 182 180   8],269,2,27906,4.139741878059635,0.0,20.0
6741,0,6741,[318  79  64  98 588],457,5,27911,4.1398694749332545,40.0,0.0
6742,0,6742,[318  79  64  98 588],716,5,27916,4.139997033961145,40.0,0.0
6743,0,6743,[161  56 294 153 127],716,4,27920,4.139976275207592,0.0,20.0
6744,0,6744,[318  79  64  98 588],716,5,27925,4.140103780578206,40.0,0.0
6745,0,6745,[238  70 100 748 191],450,5,27930,4.1402312481470505,0.0,20.0
6746,0,6746,[318  79  64  98 588],450,5,27935,4.140358677930933,40.0,0.0
6747,0,6747,[318  79  64  98 588],457,5,27940,4.140486069946651,40.0,0.0
6748,0,6748,[318  79  64  98 588],18,5,27945,4.140613424210994,40.0,0.0
6749,0,6749,[176 175 237 111 183],457,4,27949,4.140592592592593,0.0,0.0
6750,0,6750,[318  79  64  98 588],796,5,27954,4.140719893349133,40.0,0.0
6751,0,6751,[100  69 435  70  64],269,2,27956,4.140402843601896,20.0,20.0
6752,0,6752,[318  79  64  98 588],18,5,27961,4.140530134754924,40.0,0.0
6753,0,6753,[318  79  64  98 588],18,5,27966,4.140657388214391,40.0,0.0
6754,0,6754,[318  79  64  98 588],18,5,27971,4.140784603997039,40.0,0.0
6755,0,6755,[ 71 185  56 172 423],23,3,27974,4.140615748963884,0.0,0.0
6756,0,6756,[318  79  64  98 588],450,5,27979,4.140742933254403,40.0,0.0
6757,0,6757,[318  79  64  98 588],796,5,27984,4.140870079905297,40.0,0.0
6758,0,6758,[423 144 228  56 318],450,5,27989,4.140997188933274,20.0,0.0
6759,0,6759,[  1  70   8 125 588],344,2,27991,4.140680473372781,0.0,0.0
6760,0,6760,[322  28 313   8 200],796,3,27994,4.140511758615589,0.0,0.0
6761,0,6761,[318  79  64  98 588],457,5,27999,4.140638864241349,40.0,0.0
6762,0,6762,[318  79  64  98 588],716,5,28004,4.140765932278574,40.0,0.0
6763,0,6763,[117 181 161 269 245],796,3,28007,4.140597279716144,0.0,0.0
6764,0,6764,[318  79  64  98 588],18,5,28012,4.140724316334072,40.0,0.0
6765,0,6765,[318  79  64  98 588],457,5,28017,4.140851315400532,40.0,0.0
6766,0,6766,[318  79  64  98 588],457,5,28022,4.140978276932171,40.0,0.0
6767,0,6767,[245 385  79 182   4],450,4,28026,4.14095744680851,0.0,0.0
6768,0,6768,[196 282 245 234 187],504,3,28029,4.140788890530359,0.0,0.0
6769,0,6769,[318  79  64  98 588],577,5,28034,4.140915805022156,40.0,0.0
6770,0,6770,[405 187 215  15  22],655,1,28035,4.140451927337173,0.0,0.0
6771,0,6771,[318  79  64  98 588],577,5,28040,4.140578854105139,40.0,0.0
6772,0,6772,[ 96 118 211 588 237],450,4,28044,4.140558098331611,0.0,0.0
6773,0,6773,[215 197 423 183 275],450,5,28049,4.14068497195158,0.0,20.0
6774,0,6774,[ 89 185 405 125 483],457,5,28054,4.140811808118081,0.0,0.0
6775,0,6775,[318  79  64  98 588],577,5,28059,4.140938606847698,40.0,0.0
6776,0,6776,[597 183 546 228 194],796,5,28064,4.141065368157002,0.0,0.0
6777,0,6777,[318  79  64  98 588],450,5,28069,4.141192092062555,40.0,0.0
6778,0,6778,[318  79  64  98 588],18,5,28074,4.141318778580912,40.0,0.0
6779,0,6779,[318  79  64  98 588],457,5,28079,4.1414454277286135,40.0,0.0
6780,0,6780,[172 228 143 181   9],796,4,28083,4.141424568647692,0.0,0.0
6781,0,6781,[ 95 234  64  69 216],577,4,28087,4.141403715718077,20.0,0.0
6782,0,6782,[318  79  64  98 588],18,5,28092,4.141530296329058,40.0,0.0
6783,0,6783,[273 357 174 191 194],796,4,28096,4.1415094339622645,0.0,0.0
6784,0,6784,[318  79  64  98 588],796,5,28101,4.141635961680177,40.0,0.0
6785,0,6785,[318  79  64  98 588],457,5,28106,4.14176245210728,40.0,0.0
6786,0,6786,[  8 211 423  79 191],655,2,28108,4.141446883748342,0.0,0.0
6787,0,6787,[111 286  88   9  70],878,4,28112,4.141426045963465,0.0,20.0
6788,0,6788,[318  79  64  98 588],450,5,28117,4.141552511415525,40.0,0.0
6789,0,6789,[318  79  64  98 588],18,5,28122,4.141678939617084,40.0,0.0
6790,0,6790,[318  79  64  98 588],796,5,28127,4.141805330584598,40.0,0.0
6791,0,6791,[318  79  64  98 588],18,5,28132,4.141931684334511,40.0,0.0
6792,0,6792,[318  79  64  98 588],18,5,28137,4.142058000883262,40.0,0.0
6793,0,6793,[176 282 300 288 483],693,1,28138,4.141595525463645,0.0,0.0
6794,0,6794,[318  79  64  98 588],716,5,28143,4.1417218543046355,40.0,0.0
6795,0,6795,[318  79  64  98 588],796,5,28148,4.141848145968217,40.0,0.0
6796,0,6796,[  1 275  50 187 238],796,3,28151,4.14168015300868,0.0,40.0
6797,0,6797,[435 132 289 300 144],655,0,28151,4.141070903206826,0.0,0.0
6798,0,6798,[ 56 151 405 202 161],716,4,28155,4.141050154434476,0.0,0.0
6799,0,6799,[318  79  64  98 588],716,5,28160,4.141176470588236,40.0,0.0
6800,0,6800,[318  79  64  98 588],18,5,28165,4.141302749595647,40.0,0.0
6801,0,6801,[191 302  97 111 118],344,3,28168,4.141134960305792,0.0,0.0
6802,0,6802,[181 423 300  28 191],151,4,28172,4.141114214317213,0.0,0.0
6803,0,6803,[318  79  64  98 588],18,5,28177,4.141240446796003,40.0,0.0
6804,0,6804,[318  79  64  98 588],18,5,28182,4.141366642174871,40.0,0.0
6805,0,6805,[318  79  64  98 588],716,5,28187,4.141492800470173,40.0,0.0
6806,0,6806,[318  79  64  98 588],450,5,28192,4.141618921698252,40.0,0.0
6807,0,6807,[127 258 191 121 216],457,5,28197,4.141745005875441,0.0,20.0
6808,0,6808,[318  79  64  98 588],18,5,28202,4.141871053018065,40.0,0.0
6809,0,6809,[ 98 176 234  50 197],421,4,28206,4.141850220264317,0.0,20.0
6810,0,6810,[318  79  64  98 588],577,5,28211,4.1419762149464106,40.0,0.0
6811,0,6811,[289 655 403 405 568],655,0,28211,4.141368173810922,0.0,0.0
6812,0,6812,[269 483 168 185 603],707,2,28213,4.141053867606047,20.0,0.0
6813,0,6813,[127 238 265 385 597],457,4,28217,4.141033167009099,0.0,20.0
6814,0,6814,[318  79  64  98 588],457,5,28222,4.141159207630228,40.0,0.0
6815,0,6815,[  4 257 153 322 222],796,4,28226,4.141138497652582,0.0,0.0
6816,0,6816,[282  98 483 111 427],655,3,28229,4.1409711016576205,20.0,0.0
6817,0,6817,[111 257 172   1 322],401,1,28230,4.14051041361103,0.0,0.0
6818,0,6818,[197 202   9 191 180],786,4,28234,4.14048980788972,0.0,0.0
6819,0,6819,[318  79  64  98 588],577,5,28239,4.140615835777126,40.0,0.0
6820,0,6820,[294 215 144 238 603],796,3,28242,4.140448614572644,20.0,0.0
6821,0,6821,[ 12 125 210 275  28],450,4,28246,4.140428026971563,0.0,20.0
6822,0,6822,[318  79  64  98 588],716,5,28251,4.14055400850066,40.0,0.0
6823,0,6823,[318  79  64  98 588],450,5,28256,4.140679953106682,40.0,0.0
6824,0,6824,[318  79  64  98 588],457,5,28261,4.140805860805861,40.0,0.0
6825,0,6825,[234 286 496 483 328],450,3,28264,4.140638734251392,20.0,20.0
6826,0,6826,[318  79  64  98 588],457,5,28269,4.1407646111029734,40.0,0.0
6827,0,6827,[405 181 153 322 237],593,3,28272,4.140597539543058,0.0,0.0
6828,0,6828,[318  79  64  98 588],716,5,28277,4.140723385561576,40.0,0.0
6829,0,6829,[ 69 125 597 100 258],796,4,28281,4.140702781844802,0.0,20.0
6830,0,6830,[318  79  64  98 588],457,5,28286,4.1408285756111844,40.0,0.0
6831,0,6831,[245  96 234 185 603],796,3,28289,4.140661592505855,20.0,0.0
6832,0,6832,[187 234  71 211 161],504,3,28292,4.140494658276014,0.0,0.0
6833,0,6833,[202 301 161 118 271],796,4,28296,4.140474100087796,0.0,0.0
6834,0,6834,[174 286 257 202 176],389,3,28299,4.140307242136064,0.0,20.0
6835,0,6835,[  8 357 427 302  79],535,2,28301,4.139994148624927,20.0,0.0
6836,0,6836,[318  64  98  79 588],450,5,28306,4.140119935644289,40.0,0.0
6837,0,6837,[ 82 748  11  79   7],450,4,28310,4.140099444281954,0.0,0.0
6838,0,6838,[318  64  98  79 588],457,5,28315,4.140225179119755,40.0,0.0
6839,0,6839,[121 168 204 132   1],796,4,28319,4.140204678362573,0.0,0.0
6840,0,6840,[ 79 100 202 301 265],655,1,28320,4.139745651220582,0.0,20.0
6841,0,6841,[318  64  98  79 588],716,5,28325,4.139871382636656,40.0,0.0
6842,0,6842,[318  64  98  79 588],577,5,28330,4.139997077305275,40.0,0.0
6843,0,6843,[ 64 265 183 275 100],457,5,28335,4.1401227352425485,20.0,40.0
6844,0,6844,[235 215 196  71 483],23,1,28336,4.139663988312637,0.0,0.0
6845,0,6845,[318  64  98  79 588],18,5,28341,4.139789658194566,40.0,0.0
6846,0,6846,[294 111 265 153 568],796,4,28345,4.139769242003798,0.0,0.0
6847,0,6847,[  8 423 202 403 204],655,0,28345,4.1391647196261685,0.0,0.0
6848,0,6848,[318  64  98  79 588],450,5,28350,4.139290407358739,40.0,0.0
6849,0,6849,[318  64  98  79 588],450,5,28355,4.13941605839416,40.0,0.0
6850,0,6850,[318  64  98  79 588],577,5,28360,4.1395416727485035,40.0,0.0
6851,0,6851,[238  82 423   8 427],23,3,28363,4.139375364856976,20.0,0.0
6852,0,6852,[318  64  98  79 588],457,5,28368,4.1395009484897125,40.0,0.0
6853,0,6853,[288 216 423 655 313],593,4,28372,4.1394805952728335,0.0,0.0
6854,0,6854,[318  64  98  79 588],18,5,28377,4.139606126914661,40.0,0.0
6855,0,6855,[235 179 318  64 111],457,3,28380,4.139439906651108,40.0,0.0
6856,0,6856,[ 22 172 322 257  64],796,4,28384,4.139419571241068,20.0,0.0
6857,0,6857,[181 210 323 742 183],280,1,28385,4.1389617964421115,0.0,0.0
6858,0,6858,[318  64  98  79 588],796,5,28390,4.139087330514652,40.0,0.0
6859,0,6859,[ 82 211 204 168 151],269,3,28393,4.138921282798834,0.0,0.0
6860,0,6860,[318  64  98  79 588],577,5,28398,4.139046786182772,40.0,0.0
6861,0,6861,[328 125 174 265 100],151,3,28401,4.138880792771786,0.0,20.0
6862,0,6862,[318  64  98  79 588],577,5,28406,4.139006265481568,40.0,0.0
6863,0,6863,[318  64  98  79 588],796,5,28411,4.139131701631702,40.0,0.0
6864,0,6864,[222  88 172 196 301],450,4,28415,4.139111434814275,0.0,0.0
6865,0,6865,[ 96 588 403   7 125],577,4,28419,4.139091173900379,0.0,0.0
6866,0,6866,[318  64  98  79 588],796,5,28424,4.139216542886268,40.0,0.0
6867,0,6867,[318  64  98  79 588],577,5,28429,4.139341875364007,40.0,0.0
6868,0,6868,[318  64  98  79 588],716,5,28434,4.1394671713495415,40.0,0.0
6869,0,6869,[318  64  98  79 588],457,5,28439,4.139592430858807,40.0,0.0
6870,0,6870,[  1 132 483 302 210],389,4,28443,4.139572114684907,0.0,0.0
6871,0,6871,[204 151 427 121 216],269,2,28445,4.139260768335274,20.0,0.0
6872,0,6872,[318  64  98  79 588],18,5,28450,4.139386003200931,40.0,0.0
6873,0,6873,[546 237  88 215 313],577,3,28453,4.139220250218213,0.0,0.0
6874,0,6874,[318  64  98  79 588],450,5,28458,4.139345454545454,40.0,0.0
6875,0,6875,[234  15 172  69 161],796,4,28462,4.139325189063409,0.0,0.0
6876,0,6876,[300  88 143 508 405],655,1,28463,4.138868692743929,0.0,0.0
6877,0,6877,[496 483 197 748 204],796,4,28467,4.138848502471649,20.0,0.0
6878,0,6878,[135 143 121  25   7],151,5,28472,4.138973688036052,0.0,0.0
6879,0,6879,[318  64  98  79 588],457,5,28477,4.1390988372093025,40.0,0.0
6880,0,6880,[318  64  98  79 588],457,5,28482,4.139223950007266,40.0,0.0
6881,0,6881,[ 98  11 194 173 282],535,3,28485,4.139058413251962,0.0,0.0
6882,0,6882,[318  64  79  98 588],18,5,28490,4.139183495568792,40.0,0.0
6883,0,6883,[318  64  79  98 588],716,5,28495,4.1393085415456135,40.0,0.0
6884,0,6884,[282 179  98  71   1],450,4,28499,4.139288307915759,0.0,0.0
6885,0,6885,[318  64  79  98 588],796,5,28504,4.139413302352599,40.0,0.0
6886,0,6886,[318  64  79  98 588],457,5,28509,4.13953826049078,40.0,0.0
6887,0,6887,[282 175 423  82 211],655,0,28509,4.138937282229965,0.0,0.0
6888,0,6888,[ 12 423 748 275 118],151,3,28512,4.138771955291044,0.0,20.0
6889,0,6889,[318  64  79  98 588],577,5,28517,4.138896952104499,40.0,0.0
6890,0,6890,[125 275 175  69 286],151,5,28522,4.139021912639675,0.0,40.0
6891,0,6891,[318  64  79  98 588],577,5,28527,4.139146836912362,40.0,0.0
6892,0,6892,[300 237 282 153 204],504,2,28529,4.138836500797911,0.0,0.0
6893,0,6893,[318  64  79  98 588],796,5,28534,4.138961415723818,40.0,0.0
6894,0,6894,[318  64  79  98 588],796,5,28539,4.139086294416244,40.0,0.0
6895,0,6895,[318  64  79  98 588],18,5,28544,4.139211136890951,40.0,0.0
6896,0,6896,[318  64  79  98 588],450,5,28549,4.139335943163695,40.0,0.0
6897,0,6897,[ 82  79 197 234 135],72,4,28553,4.139315743693825,0.0,0.0
6898,0,6898,[318  64  79  98 588],796,5,28558,4.139440498622989,40.0,0.0
6899,0,6899,[318  64  79  98 588],577,5,28563,4.139565217391304,40.0,0.0
6900,0,6900,[181 234  88  50 144],655,1,28564,4.139110273873352,0.0,20.0
6901,0,6901,[318  64  79  98 588],18,5,28569,4.139235004346566,40.0,0.0
6902,0,6902,[237  95  88 143 127],716,5,28574,4.139359698681733,0.0,20.0
6903,0,6903,[271 357 216 568 182],796,5,28579,4.139484356894554,0.0,0.0
6904,0,6904,[  4 197 202 302 118],389,4,28583,4.139464156408399,0.0,0.0
6905,0,6905,[508  50  56 286 302],655,2,28585,4.139154358528815,0.0,40.0
6906,0,6906,[318  64  79  98 588],577,5,28590,4.139278992326625,40.0,0.0
6907,0,6907,[191  98   8 403 151],269,3,28593,4.139114070642733,0.0,0.0
6908,0,6908,[ 22 173  89 111 568],344,4,28597,4.139093935446519,0.0,0.0
6909,0,6909,[  4 435 234 385 179],655,1,28598,4.13863965267728,0.0,0.0
6910,0,6910,[318  64  79  98 588],796,5,28603,4.138764288814933,40.0,0.0
6911,0,6911,[265 333 153 197  56],629,5,28608,4.138888888888889,0.0,0.0
6912,0,6912,[318  64  79  98 588],577,5,28613,4.139013452914798,40.0,0.0
6913,0,6913,[172 237  25 196 153],18,1,28614,4.138559444605149,0.0,0.0
6914,0,6914,[318  64  79  98 588],18,5,28619,4.138684020245843,40.0,0.0
6915,0,6915,[ 28   1 204  96 238],457,5,28624,4.138808559861191,0.0,0.0
6916,0,6916,[ 98 197 405 179 200],655,3,28627,4.138643920774903,0.0,0.0
6917,0,6917,[322   4 603 210 132],450,3,28630,4.1384793292859205,20.0,0.0
6918,0,6918,[318  64  79  98 588],457,5,28635,4.138603844486197,40.0,0.0
6919,0,6919,[313  70 195 118 357],655,2,28637,4.138294797687862,0.0,0.0
6920,0,6920,[318  64  79  98 588],457,5,28642,4.138419303568848,40.0,0.0
6921,0,6921,[318  64  79  98 588],18,5,28647,4.138543773475874,40.0,0.0
6922,0,6922,[318  64  79  98 588],577,5,28652,4.138668207424527,40.0,0.0
6923,0,6923,[508 427 172   9 288],655,2,28654,4.138359329867129,20.0,0.0
6924,0,6924,[ 28  25 185  22 118],655,1,28655,4.137906137184116,0.0,0.0
6925,0,6925,[ 11  96 197  88   4],716,3,28658,4.137741842333237,0.0,0.0
6926,0,6926,[318  64  79  98 588],18,5,28663,4.137866320196333,40.0,0.0
6927,0,6927,[318  64  79  98 588],716,5,28668,4.137990762124711,40.0,0.0
6928,0,6928,[143 403 100  50 202],655,2,28670,4.1376822052244195,0.0,40.0
6929,0,6929,[121 183 318 238   7],269,2,28672,4.137373737373737,20.0,0.0
6930,0,6930,[ 64  98 181  12 118],457,5,28677,4.1374981965084405,20.0,0.0
6931,0,6931,[318  64  79  98 588],577,5,28682,4.1376226197345645,40.0,0.0
6932,0,6932,[318  64  79  98 588],796,5,28687,4.137747007067648,40.0,0.0
6933,0,6933,[275 151 294 172 483],296,3,28690,4.137582924718777,0.0,20.0
6934,0,6934,[135 403 168 234 483],450,2,28692,4.137274693583273,0.0,0.0
6935,0,6935,[168  25 471 161 385],450,4,28696,4.137254901960785,0.0,0.0
6936,0,6936,[196 118 210 423   8],389,2,28698,4.13694680697708,0.0,0.0
6937,0,6937,[179   4 127 328 186],450,3,28701,4.136782934563275,0.0,20.0
6938,0,6938,[427   9 471 182  88],655,2,28703,4.136474996397175,20.0,0.0
6939,0,6939,[318  64  79  98 588],716,5,28708,4.136599423631124,40.0,0.0
6940,0,6940,[ 96 202   1  98 294],577,5,28713,4.136723815012246,0.0,0.0
6941,0,6941,[318  64  79  98 588],796,5,28718,4.136848170556036,40.0,0.0
6942,0,6942,[318  64  79  98 588],450,5,28723,4.136972490277977,40.0,0.0
6943,0,6943,[183 118 132 181  56],796,5,28728,4.137096774193548,0.0,0.0
6944,0,6944,[483 742 186 357 597],796,3,28731,4.136933045356371,0.0,0.0
6945,0,6945,[318  64  79  98 588],457,5,28736,4.137057299164987,40.0,0.0
6946,0,6946,[ 50 288 273 237 405],450,3,28739,4.136893623146682,0.0,20.0
6947,0,6947,[318 273 200 238 125],655,3,28742,4.136729994242947,20.0,0.0
6948,0,6948,[385 245 183  88 173],796,4,28746,4.136710318031372,0.0,0.0
6949,0,6949,[318  64  79  98 588],18,5,28751,4.136834532374101,40.0,0.0
6950,0,6950,[427 204 194 496 174],450,5,28756,4.136958710976838,40.0,0.0
6951,0,6951,[318  64  79  98 588],716,5,28761,4.137082853855006,40.0,0.0
6952,0,6952,[  1 655 276 275   7],655,2,28763,4.1367754925931255,0.0,20.0
6953,0,6953,[318  64  79  98 588],457,5,28768,4.136899626114467,40.0,0.0
6954,0,6954,[435  95 235   1 211],450,3,28771,4.136736161035227,0.0,0.0
6955,0,6955,[318  64  79  98 588],716,5,28776,4.136860264519839,40.0,0.0
6956,0,6956,[318  64  79  98 588],716,5,28781,4.1369843323271525,40.0,0.0
6957,0,6957,[186  22 216  56 403],577,4,28785,4.1369646450129345,0.0,0.0
6958,0,6958,[318  64  79  98 588],577,5,28790,4.137088662164104,40.0,0.0
6959,0,6959,[318  64  79  98 588],716,5,28795,4.137212643678161,40.0,0.0
6960,0,6960,[  9 100 151 245 111],796,2,28797,4.136905617009051,0.0,20.0
6961,0,6961,[ 70 135 234 204 385],5,4,28801,4.136885952312554,0.0,0.0
6962,0,6962,[265 185 182 172  70],457,5,28806,4.137009909521758,0.0,0.0
6963,0,6963,[318  64  79  98 588],457,5,28811,4.137133831131534,40.0,0.0
6964,0,6964,[185  28   4  82 265],716,4,28815,4.137114142139268,0.0,0.0
6965,0,6965,[185 496  69   8   4],389,5,28820,4.137238013207005,20.0,0.0
6966,0,6966,[318  64  79  98 588],716,5,28825,4.137361848715372,40.0,0.0
6967,0,6967,[196 181 483 118 234],151,4,28829,4.137342135476464,0.0,0.0
6968,0,6968,[238 180 121 258   8],796,3,28832,4.137178935284833,0.0,0.0
6969,0,6969,[318  64  79  98 588],450,5,28837,4.1373027259684365,40.0,0.0
6970,0,6970,[257 515  89 318 423],807,5,28842,4.137426481136135,20.0,0.0
6971,0,6971,[  7 143 288 222 568],457,5,28847,4.137550200803213,0.0,0.0
6972,0,6972,[318  64  79  98 588],577,5,28852,4.137673884984942,40.0,0.0
6973,0,6973,[174 603 237 273   1],655,2,28854,4.137367364496702,20.0,0.0
6974,0,6974,[318  64  79  98 588],796,5,28859,4.137491039426523,40.0,0.0
6975,0,6975,[483   9 182  97 195],796,3,28862,4.137327981651376,0.0,0.0
6976,0,6976,[151 405  89  22 174],256,5,28867,4.137451626773685,0.0,0.0
6977,0,6977,[318  64  79  98 588],796,5,28872,4.137575236457438,40.0,0.0
6978,0,6978,[318  64  79  98 588],18,5,28877,4.137698810717868,40.0,0.0
6979,0,6979,[132 195 121  64 210],269,2,28879,4.137392550143266,20.0,0.0
6980,0,6980,[174 175 483 100 546],457,4,28883,4.137372869216445,0.0,20.0
6981,0,6981,[318  64  79  98 588],577,5,28888,4.137496419364079,40.0,0.0
6982,0,6982,[318  64  79  98 588],457,5,28893,4.137619934125734,40.0,0.0
6983,0,6983,[ 79 435 655 546 483],151,4,28897,4.137600229095074,0.0,0.0
6984,0,6984,[318  64  79  98 588],457,5,28902,4.137723693629205,40.0,0.0
6985,0,6985,[318  64  79  98 588],450,5,28907,4.137847122817063,40.0,0.0
6986,0,6986,[318  64  79  98 588],577,5,28912,4.137970516673823,40.0,0.0
6987,0,6987,[318  64  79  98 588],577,5,28917,4.138093875214654,40.0,0.0
6988,0,6988,[318  64  79  98 588],577,5,28922,4.138217198454715,40.0,0.0
6989,0,6989,[318  64  79  98 588],716,5,28927,4.138340486409156,40.0,0.0
6990,0,6990,[197 427 210 294 742],796,1,28928,4.1378915748819916,20.0,0.0
6991,0,6991,[235  71 265 496 238],450,3,28931,4.137728832951945,20.0,0.0
6992,0,6992,[282 286 196 273 496],450,4,28935,4.1377091377091375,20.0,20.0
6993,0,6993,[385 173 435 216 194],151,4,28939,4.13768944809837,0.0,0.0
6994,0,6994,[ 28 228  96 127 161],450,5,28944,4.137812723373838,0.0,20.0
6995,0,6995,[318  64  79  98 588],716,5,28949,4.137935963407662,40.0,0.0
6996,0,6996,[318  64  79  98 588],450,5,28954,4.13805916821495,40.0,0.0
6997,0,6997,[318  64  79  98 588],577,5,28959,4.138182337810803,40.0,0.0
6998,0,6998,[318  64  79  98 588],796,5,28964,4.138305472210316,40.0,0.0
6999,0,6999,[234 655 187 117 275],786,4,28968,4.138285714285714,0.0,20.0
7000,0,7000,[318  64  79  98 588],796,5,28973,4.138408798743037,40.0,0.0
7001,0,7001,[175 257   8 289 385],655,0,28973,4.1378177663524704,0.0,0.0
7002,0,7002,[318  64  79  98 588],577,5,28978,4.137940882478937,40.0,0.0
7003,0,7003,[216 423 187 435 161],450,5,28983,4.138063963449458,0.0,0.0
7004,0,7004,[257 318 238 196  70],655,1,28984,4.137615988579586,20.0,0.0
7005,0,7005,[ 50 258 194 748 186],796,4,28988,4.137596345989152,0.0,20.0
7006,0,7006,[318  64  79  98 588],577,5,28993,4.137719423433709,40.0,0.0
7007,0,7007,[323 588 403  79 405],798,5,28998,4.137842465753424,0.0,0.0
7008,0,7008,[427 176 153 318 357],796,5,29003,4.137965472963333,40.0,0.0
7009,0,7009,[191 182 144  96  98],450,5,29008,4.138088445078459,0.0,0.0
7010,0,7010,[318  64  79  98 588],18,5,29013,4.138211382113822,40.0,0.0
7011,0,7011,[423 655 111 181 183],796,4,29017,4.138191671420422,0.0,0.0
7012,0,7012,[318  64  79  98 588],457,5,29022,4.138314558676743,40.0,0.0
7013,0,7013,[318 195 238 597 117],457,4,29026,4.138294838893641,20.0,0.0
7014,0,7014,[423 125   8 151 111],796,5,29031,4.138417676407697,0.0,0.0
7015,0,7015,[  1 215 151 121  89],344,2,29033,4.138112884834664,0.0,0.0
7016,0,7016,[318  64  79  98 588],450,5,29038,4.138235713267778,40.0,0.0
7017,0,7017,[318  64  79  98 588],450,5,29043,4.138358506697065,40.0,0.0
7018,0,7018,[318  64  79  98 588],18,5,29048,4.138481265137484,40.0,0.0
7019,0,7019,[318  64  79  98 588],457,5,29053,4.138603988603989,40.0,0.0
7020,0,7020,[318  64  79  98 588],450,5,29058,4.1387266771115225,40.0,0.0
7021,0,7021,[546 234 202  96 471],256,4,29062,4.138706921105098,0.0,0.0
7022,0,7022,[318  64  79  98 588],457,5,29067,4.138829560017086,40.0,0.0
7023,0,7023,[174 222 202 181 423],457,5,29072,4.138952164009112,0.0,0.0
7024,0,7024,[318  64  79  98 588],577,5,29077,4.139074733096085,40.0,0.0
7025,0,7025,[300 100 237  71 546],186,4,29081,4.139054938798748,0.0,20.0
7026,0,7026,[191 333 216 234 508],655,2,29083,4.138750533655899,0.0,0.0
7027,0,7027,[748  11 186 216 568],436,3,29086,4.138588503130336,0.0,0.0
7028,0,7028,[318  64  79  98 588],796,5,29091,4.138711054204012,40.0,0.0
7029,0,7029,[323   4  82   9 238],504,4,29095,4.138691322901849,0.0,0.0
7030,0,7030,[211  96  79 318 210],796,3,29098,4.138529369933154,20.0,0.0
7031,0,7031,[300 202 603 568 118],389,2,29100,4.138225255972697,20.0,0.0
7032,0,7032,[318  64  79  98 588],450,5,29105,4.138347788994739,40.0,0.0
7033,0,7033,[742   9 216 276 282],280,4,29109,4.1383281205572935,0.0,0.0
7034,0,7034,[286 125  50 100  56],655,1,29110,4.137882018479034,0.0,60.0
7035,0,7035,[318  64  79  98 588],577,5,29115,4.1380045480386585,40.0,0.0
7036,0,7036,[318  64  79  98 588],450,5,29120,4.13812704277391,40.0,0.0
7037,0,7037,[ 88 216   7 258  15],151,5,29125,4.13824950269963,0.0,0.0
7038,0,7038,[313 515 742  56 118],655,2,29127,4.137945730927688,0.0,0.0
7039,0,7039,[423 187 282 161 427],796,5,29132,4.1380681818181815,20.0,0.0
7040,0,7040,[318  64  79  98 588],716,5,29137,4.138190597926431,40.0,0.0
7041,0,7041,[318  64  79  98 588],18,5,29142,4.138312979267254,40.0,0.0
7042,0,7042,[475 435 153 234  98],389,4,29146,4.1382933409058635,0.0,0.0
7043,0,7043,[318  64  79  98 588],457,5,29151,4.138415672913117,40.0,0.0
7044,0,7044,[318  64  79  98 588],18,5,29156,4.138537970191625,40.0,0.0
7045,0,7045,[318  64  79  98 588],716,5,29161,4.138660232756174,40.0,0.0
7046,0,7046,[318  64  79  98 588],577,5,29166,4.138782460621541,40.0,0.0
7047,0,7047,[318  64  79  98 588],450,5,29171,4.138904653802497,40.0,0.0
7048,0,7048,[ 28 174  56  22 215],796,4,29175,4.138884948219606,0.0,0.0
7049,0,7049,[318  64  79  98 588],577,5,29180,4.1390070921985815,40.0,0.0
7050,0,7050,[318  64  79  98 588],796,5,29185,4.139129201531698,40.0,0.0
7051,0,7051,[318  64  79  98 588],716,5,29190,4.139251276233693,40.0,0.0
7052,0,7052,[318  64  79  98 588],457,5,29195,4.139373316319297,40.0,0.0
7053,0,7053,[403 182 568 588 202],457,5,29200,4.139495321803232,0.0,0.0
7054,0,7054,[318  64  79  98 588],796,5,29205,4.139617292700213,40.0,0.0
7055,0,7055,[318  64  79  98 588],18,5,29210,4.1397392290249435,40.0,0.0
7056,0,7056,[195 197 132   9 748],796,3,29213,4.13957772424543,0.0,0.0
7057,0,7057,[318  64  79  98 588],457,5,29218,4.13969963162369,40.0,0.0
7058,0,7058,[ 64 228 427 143  25],716,5,29223,4.139821504462389,40.0,0.0
7059,0,7059,[423  82 483 385 568],280,3,29226,4.139660056657224,0.0,0.0
7060,0,7060,[282 111 125 597 588],450,5,29231,4.139781900580655,0.0,0.0
7061,0,7061,[121   7 508 179 265],535,4,29235,4.139762107051826,0.0,0.0
7062,0,7062,[132 568  50 173 180],716,4,29239,4.1397423191278495,0.0,20.0
7063,0,7063,[121  12 175 204  97],151,5,29244,4.139864099660249,0.0,0.0
7064,0,7064,[ 89  50 117 191 111],344,4,29248,4.139844302901627,0.0,20.0
7065,0,7065,[318  64  79  98 588],457,5,29253,4.139966034531559,40.0,0.0
7066,0,7066,[288 135  82 282 210],280,2,29255,4.139663223432857,0.0,0.0
7067,0,7067,[483 289  88 174 568],655,1,29256,4.139219015280136,0.0,0.0
7068,0,7068,[181 144 151 282 302],401,1,29257,4.138774932805206,0.0,0.0
7069,0,7069,[173   1 403  88 496],577,4,29261,4.138755304101839,20.0,0.0
7070,0,7070,[318  64  79  98 588],457,5,29266,4.138877103662848,40.0,0.0
7071,0,7071,[318  64  79  98 588],577,5,29271,4.13899886877828,40.0,0.0
7072,0,7072,[318  64  79  98 588],18,5,29276,4.139120599462745,40.0,0.0
7073,0,7073,[121 588  89  69 186],796,4,29280,4.1391009329940625,0.0,0.0
7074,0,7074,[125 282 117 300  12],450,5,29285,4.139222614840989,0.0,0.0
7075,0,7075,[318  64  79  98 588],577,5,29290,4.139344262295082,40.0,0.0
7076,0,7076,[318  64  79  98 588],716,5,29295,4.13946587537092,40.0,0.0
7077,0,7077,[191 210 111 181 423],796,4,29299,4.1394461712348125,0.0,0.0
7078,0,7078,[ 70  79 144  25 186],655,1,29300,4.1390026839949146,0.0,0.0
7079,0,7079,[181 301  82 144 427],450,4,29304,4.138983050847457,20.0,0.0
7080,0,7080,[318  64  79  98 588],450,5,29309,4.139104646236407,40.0,0.0
7081,0,7081,[328 318 135  25  28],655,2,29311,4.138802598136119,20.0,0.0
7082,0,7082,[204 427 357 176 300],655,2,29313,4.138500635324015,20.0,0.0
7083,0,7083,[385 132 655 546 143],151,3,29316,4.138339920948616,0.0,0.0
7084,0,7084,[286  56 175 269 168],18,4,29320,4.138320395201129,0.0,20.0
7085,0,7085,[318  64  79  98 588],577,5,29325,4.1384419983065195,40.0,0.0
7086,0,7086,[ 96 179 127  82 235],269,2,29327,4.13814025680824,0.0,20.0
7087,0,7087,[483 210 275 237 238],716,5,29332,4.138261851015802,0.0,20.0
7088,0,7088,[301 742  97 238 174],655,0,29332,4.137678092819861,0.0,0.0
7089,0,7089,[318  64  79  98 588],450,5,29337,4.137799717912553,40.0,0.0
7090,0,7090,[318  64  79  98 588],18,5,29342,4.137921308701171,40.0,0.0
7091,0,7091,[318  64  79  98 588],457,5,29347,4.138042865200226,40.0,0.0
7092,0,7092,[318  64  79  98 588],457,5,29352,4.138164387424221,40.0,0.0
7093,0,7093,[318  64  79  98 588],457,5,29357,4.138285875387652,40.0,0.0
7094,0,7094,[179 302 318 282 172],535,2,29359,4.137984496124031,20.0,0.0
7095,0,7095,[318  64  79  98 588],450,5,29364,4.138105975197294,40.0,0.0
7096,0,7096,[111 300   1  79 237],796,4,29368,4.1380865154290545,0.0,0.0
7097,0,7097,[176 174  88 180 475],269,1,29369,4.137644406875176,0.0,0.0
7098,0,7098,[385 228 282 200  56],457,5,29374,4.137765882518664,0.0,0.0
7099,0,7099,[135  88  64 117 385],330,4,29378,4.13774647887324,20.0,0.0
7100,0,7100,[385  11  12 182 323],280,3,29381,4.137586255456978,0.0,0.0
7101,0,7101,[258 288  22 742 173],457,5,29386,4.137707687975218,0.0,0.0
7102,0,7102,[318  64  79  98 588],450,5,29391,4.137829086301562,40.0,0.0
7103,0,7103,[202  98   1  71 603],23,3,29394,4.137668918918919,20.0,0.0
7104,0,7104,[318  64  79  98 588],577,5,29399,4.137790288529205,40.0,0.0
7105,0,7105,[318  64  79  98 588],796,5,29404,4.137911623979735,40.0,0.0
7106,0,7106,[318  64  79  98 588],450,5,29409,4.13803292528493,40.0,0.0
7107,0,7107,[294  98  96 273  82],655,2,29411,4.137732132808104,0.0,0.0
7108,0,7108,[318  64  79  98 588],716,5,29416,4.137853425235617,40.0,0.0
7109,0,7109,[172   4 118 161  97],655,1,29417,4.137412095639943,0.0,0.0
7110,0,7110,[318  64  79  98 588],796,5,29422,4.137533398959358,40.0,0.0
7111,0,7111,[200 204 161 546 210],457,4,29426,4.137514060742407,0.0,0.0
7112,0,7112,[235 238 194 204 508],269,3,29429,4.137354140306481,0.0,0.0
7113,0,7113,[  1 187 258 282 204],796,4,29433,4.137334832724206,0.0,0.0
7114,0,7114,[228 385 194 111 238],716,4,29437,4.13731553056922,0.0,0.0
7115,0,7115,[318  64  79  98 588],457,5,29442,4.13743676222597,40.0,0.0
7116,0,7116,[235 200 237 216 151],716,4,29446,4.137417451173247,0.0,0.0
7117,0,7117,[318  64  79  98 588],796,5,29451,4.137538634447878,40.0,0.0
7118,0,7118,[118 403 237 222 174],450,3,29454,4.137378845343447,0.0,0.0
7119,0,7119,[318  64  79  98 588],796,5,29459,4.1375,40.0,0.0
7120,0,7120,[234 235 568 237  98],450,3,29462,4.137340261199269,0.0,0.0
7121,0,7121,[435   4 588 161 269],450,4,29466,4.13732097725358,0.0,0.0
7122,0,7122,[318  64  79  98 588],18,5,29471,4.137442089007441,40.0,0.0
7123,0,7123,[172 194  12 197  88],457,5,29476,4.1375631667602475,0.0,0.0
7124,0,7124,[328 435 143 357 204],401,5,29481,4.137684210526316,0.0,0.0
7125,0,7125,[144 423 143 275 318],593,4,29485,4.1376648891383665,20.0,20.0
7126,0,7126,[318  64  79  98 588],796,5,29490,4.137785884663954,40.0,0.0
7127,0,7127,[357  98 135  88  64],151,5,29495,4.137906846240179,20.0,0.0
7128,0,7128,[588 180  88 294  11],716,4,29499,4.137887501753402,0.0,0.0
7129,0,7129,[318  64  79  98 588],796,5,29504,4.138008415147265,40.0,0.0
7130,0,7130,[318  64  79  98 588],716,5,29509,4.138129294629084,40.0,0.0
7131,0,7131,[318  64  79  98 588],18,5,29514,4.138250140213124,40.0,0.0
7132,0,7132,[655 143  11 186 202],269,1,29515,4.1378101780457035,0.0,0.0
7133,0,7133,[153 174 195 183 322],450,5,29520,4.137931034482759,0.0,0.0
7134,0,7134,[  1 186 132 127 546],503,5,29525,4.138051857042747,0.0,20.0
7135,0,7135,[  4 185 273 300 179],655,3,29528,4.137892376681615,0.0,0.0
7136,0,7136,[318  64  79  98 588],716,5,29533,4.138013170800056,40.0,0.0
7137,0,7137,[742  98 405   1 483],457,5,29538,4.1381339310731295,0.0,0.0
7138,0,7138,[318  64  79  98 588],18,5,29543,4.138254657515058,40.0,0.0
7139,0,7139,[117 403 200 258 301],796,4,29547,4.1382352941176475,0.0,0.0
7140,0,7140,[318  64  79  98 588],796,5,29552,4.138355972552864,40.0,0.0
7141,0,7141,[318  64  79  98 588],457,5,29557,4.138476617194064,40.0,0.0
7142,0,7142,[318  64  79  98 588],450,5,29562,4.138597228055439,40.0,0.0
7143,0,7143,[318  64  79  98 588],796,5,29567,4.138717805151176,40.0,0.0
7144,0,7144,[ 82  11 202 237 483],655,1,29568,4.138278516445067,0.0,0.0
7145,0,7145,[318  64  79  98 588],18,5,29573,4.138399104394066,40.0,0.0
7146,0,7146,[318  64  79  98 588],716,5,29578,4.138519658598013,40.0,0.0
7147,0,7147,[318  64  79  98 588],577,5,29583,4.138640179071069,40.0,0.0
7148,0,7148,[471  11 151 228 405],344,2,29585,4.138341026717024,0.0,0.0
7149,0,7149,[275 197 210 121 496],716,5,29590,4.138461538461539,20.0,20.0
7150,0,7150,[143 117 151 194 301],796,4,29594,4.138442175919452,0.0,0.0
7151,0,7151,[ 89 322 275 135 216],151,4,29598,4.1384228187919465,0.0,20.0
7152,0,7152,[318  64  79  98 588],716,5,29603,4.138543268558647,40.0,0.0
7153,0,7153,[318  64  79  98 588],18,5,29608,4.138663684651943,40.0,0.0
7154,0,7154,[204 282 258 471 597],450,5,29613,4.138784067085954,0.0,0.0
7155,0,7155,[318  64  79  98 588],18,5,29618,4.138904415874791,40.0,0.0
7156,0,7156,[ 12 143  89 603 176],450,5,29623,4.139024731032555,20.0,0.0
7157,0,7157,[ 25 181 118 204  15],593,4,29627,4.1390053087454595,0.0,0.0
7158,0,7158,[132  12 194 210 655],151,5,29632,4.139125576197793,0.0,0.0
7159,0,7159,[318  64  79  98 588],796,5,29637,4.139245810055866,40.0,0.0
7160,0,7160,[318  64  79  98 588],577,5,29642,4.139366010333752,40.0,0.0
7161,0,7161,[117 118 121 435 135],655,1,29643,4.138927673834124,0.0,0.0
7162,0,7162,[508 200 282 118  12],280,2,29645,4.1386290660337846,0.0,0.0
7163,0,7163,[135  98 194   1 210],151,5,29650,4.138749302065885,0.0,0.0
7164,0,7164,[318  64  79  98 588],457,5,29655,4.138869504535939,40.0,0.0
7165,0,7165,[318  64  79  98 588],577,5,29660,4.1389896734579965,40.0,0.0
7166,0,7166,[568 121  88 183 176],450,4,29664,4.138970280452072,0.0,0.0
7167,0,7167,[318  64  79  98 588],716,5,29669,4.139090401785714,40.0,0.0
7168,0,7168,[318  64  79  98 588],18,5,29674,4.139210489608034,40.0,0.0
7169,0,7169,[125 748 568 168 423],436,3,29677,4.139051603905161,0.0,0.0
7170,0,7170,[318  64  79  98 588],450,5,29682,4.139171663645238,40.0,0.0
7171,0,7171,[200 153 282 289 175],655,1,29683,4.138733965421082,0.0,0.0
7172,0,7172,[318  64  79  98 588],457,5,29688,4.138854035968214,40.0,0.0
7173,0,7173,[318  64  79  98 588],457,5,29693,4.138974073041539,40.0,0.0
7174,0,7174,[318  64  79  98 588],716,5,29698,4.139094076655052,40.0,0.0
7175,0,7175,[318  64  79  98 588],18,5,29703,4.139214046822742,40.0,0.0
7176,0,7176,[  9 200  50 228 423],796,4,29707,4.139194649575031,0.0,20.0
7177,0,7177,[318  64  79  98 588],716,5,29712,4.139314572304263,40.0,0.0
7178,0,7178,[ 15  82 183 655  69],796,3,29715,4.139155871291266,0.0,0.0
7179,0,7179,[318  64  79  98 588],716,5,29720,4.139275766016713,40.0,0.0
7180,0,7180,[318  64  79  98 588],457,5,29725,4.139395627349951,40.0,0.0
7181,0,7181,[318  64  79  98 588],450,5,29730,4.139515455304929,40.0,0.0
7182,0,7182,[186 357 496 655  70],786,5,29735,4.139635249895587,20.0,0.0
7183,0,7183,[318  64  79  98 588],577,5,29740,4.139755011135858,40.0,0.0
7184,0,7184,[269 302 546 235 215],344,2,29742,4.139457202505219,0.0,0.0
7185,0,7185,[318  64  79  98 588],577,5,29747,4.139576955190648,40.0,0.0
7186,0,7186,[  7 238 515 282 655],535,3,29750,4.139418394323084,0.0,0.0
7187,0,7187,[318  64  79  98 588],577,5,29755,4.1395381190873675,40.0,0.0
7188,0,7188,[318  64  79  98 588],577,5,29760,4.139657810543887,40.0,0.0
7189,0,7189,[268 257 185 211  11],655,1,29761,4.139221140472879,0.0,0.0
7190,0,7190,[318  64  79  98 588],577,5,29766,4.139340842720067,40.0,0.0
7191,0,7191,[318  64  79  98 588],457,5,29771,4.139460511679644,40.0,0.0
7192,0,7192,[191  88 194 196  28],716,5,29776,4.1395801473654945,0.0,0.0
7193,0,7193,[318  64  79  98 588],450,5,29781,4.139699749791493,40.0,0.0
7194,0,7194,[318  64  79  98 588],716,5,29786,4.139819318971508,40.0,0.0
7195,0,7195,[318  64  79  98 588],18,5,29791,4.1399388549194,40.0,0.0
7196,0,7196,[318  64  79  98 588],577,5,29796,4.14005835764902,40.0,0.0
7197,0,7197,[318  64  79  98 588],450,5,29801,4.140177827174215,40.0,0.0
7198,0,7198,[318  64  79  98 588],716,5,29806,4.14029726350882,40.0,0.0
7199,0,7199,[117  96 204 234 357],716,4,29810,4.1402777777777775,0.0,0.0
7200,0,7200,[318  64  79  98 588],450,5,29815,4.14039716706013,40.0,0.0
7201,0,7201,[168 742 357  88  15],796,4,29819,4.140377672868648,0.0,0.0
7202,0,7202,[195  56   8 168 215],796,5,29824,4.140497015132584,0.0,0.0
7203,0,7203,[183  50 175  12 385],344,4,29828,4.140477512493059,0.0,20.0
7204,0,7204,[318  64  79  98 588],796,5,29833,4.14059680777238,40.0,0.0
7205,0,7205,[748 258  12 180 385],450,5,29838,4.140716069941715,0.0,0.0
7206,0,7206,[318  64  79  98 588],18,5,29843,4.140835299014847,40.0,0.0
7207,0,7207,[318  64  79  98 588],577,5,29848,4.140954495005549,40.0,0.0
7208,0,7208,[318  64  79  98 588],716,5,29853,4.14107365792759,40.0,0.0
7209,0,7209,[215 265   8 228 176],796,5,29858,4.141192787794729,0.0,0.0
7210,0,7210,[318  64  79  98 588],716,5,29863,4.141311884620718,40.0,0.0
7211,0,7211,[191 588 135 483 195],18,3,29866,4.141153632834166,0.0,0.0
7212,0,7212,[471 168 202 186 182],457,5,29871,4.141272702065715,0.0,0.0
7213,0,7213,[318  64  79  98 588],457,5,29876,4.141391738286665,40.0,0.0
7214,0,7214,[191 403   4 423 515],655,2,29878,4.141094941094941,0.0,0.0
7215,0,7215,[318  64  79  98 588],577,5,29883,4.141213968957872,40.0,0.0
7216,0,7216,[172 191 318  70 294],707,2,29885,4.140917278647637,20.0,0.0
7217,0,7217,[318  64  79  98 588],18,5,29890,4.14103629814353,40.0,0.0
7218,0,7218,[318  64  79  98 588],457,5,29895,4.141155284665466,40.0,0.0
7219,0,7219,[385 678  95 323 195],280,2,29897,4.140858725761773,0.0,0.0
7220,0,7220,[318  64  79  98 588],716,5,29902,4.140977703919125,40.0,0.0
7221,0,7221,[318  64  79  98 588],457,5,29907,4.1410966491276655,40.0,0.0
7222,0,7222,[318  64  79  98 588],18,5,29912,4.14121556140108,40.0,0.0
7223,0,7223,[318  64  79  98 588],577,5,29917,4.141334440753045,40.0,0.0
7224,0,7224,[318  64  79  98 588],450,5,29922,4.141453287197232,40.0,0.0
7225,0,7225,[318  64  79  98 588],457,5,29927,4.141572100747301,40.0,0.0
7226,0,7226,[143 211  79 185 181],5,2,29929,4.141275771412758,0.0,0.0
7227,0,7227,[328 257 125 427 191],796,5,29934,4.141394576646375,20.0,0.0
7228,0,7228,[318  64  98  79 588],457,5,29939,4.141513349010928,40.0,0.0
7229,0,7229,[318  64  98  79 588],796,5,29944,4.141632088520056,40.0,0.0
7230,0,7230,[269 403 282 748 294],450,5,29949,4.141750795187388,0.0,0.0
7231,0,7231,[318  64  98  79 588],457,5,29954,4.141869469026549,40.0,0.0
7232,0,7232,[318  64  98  79 588],450,5,29959,4.141988110051154,40.0,0.0
7233,0,7233,[100 322  12 237 204],450,5,29964,4.142106718274813,0.0,20.0
7234,0,7234,[318  64  98  79 588],457,5,29969,4.142225293711126,40.0,0.0
7235,0,7235,[427  64 385 302 161],450,5,29974,4.142343836373687,40.0,0.0
7236,0,7236,[318  64  98  79 588],457,5,29979,4.142462346276082,40.0,0.0
7237,0,7237,[180 202 496  50 172],796,4,29983,4.142442663719259,20.0,20.0
7238,0,7238,[385 288 546 234 269],450,3,29986,4.142284845973201,0.0,0.0
7239,0,7239,[318  64  98  79 588],450,5,29991,4.142403314917127,40.0,0.0
7240,0,7240,[  8 125 258   4 302],655,1,29992,4.141969341251208,0.0,0.0
7241,0,7241,[ 79 357 238 405 228],655,2,29994,4.141673570836786,0.0,0.0
7242,0,7242,[202 182 173 172 180],450,5,29999,4.141792075106999,0.0,0.0
7243,0,7243,[  9 275 196 143 144],655,2,30001,4.14149641082275,0.0,20.0
7244,0,7244,[318  64  98  79 588],18,5,30006,4.141614906832298,40.0,0.0
7245,0,7245,[318  64  98  79 588],450,5,30011,4.141733370135247,40.0,0.0
7246,0,7246,[318  64  98  79 588],716,5,30016,4.141851800745136,40.0,0.0
7247,0,7247,[318  64  98  79 588],796,5,30021,4.141970198675497,40.0,0.0
7248,0,7248,[318  64  98  79 588],796,5,30026,4.142088563939854,40.0,0.0
7249,0,7249,[196  25  71   4 742],577,5,30031,4.142206896551724,0.0,0.0
7250,0,7250,[191 496 234 475 483],389,5,30036,4.1423251965246175,20.0,0.0
7251,0,7251,[318  64  98  79 588],450,5,30041,4.142443463872035,40.0,0.0
7252,0,7252,[ 69 180 161  95 125],450,4,30045,4.142423824624293,0.0,0.0
7253,0,7253,[357 195 197  22 196],450,5,30050,4.142542045767852,0.0,0.0
7254,0,7254,[318  64  98  79 588],457,5,30055,4.142660234321158,40.0,0.0
7255,0,7255,[318  64  98  79 588],577,5,30060,4.142778390297685,40.0,0.0
7256,0,7256,[186 173 204 211 176],503,4,30064,4.14275871572275,0.0,0.0
7257,0,7257,[132  71 151 357 118],330,5,30069,4.142876825571783,0.0,0.0
7258,0,7258,[318  64  98  79 588],457,5,30074,4.142994902879185,40.0,0.0
7259,0,7259,[318  64  98  79 588],716,5,30079,4.143112947658402,40.0,0.0
7260,0,7260,[235 385 282  82  22],716,2,30081,4.142817793692329,0.0,0.0
7261,0,7261,[318  64  98  79 588],796,5,30086,4.142935830349766,40.0,0.0
7262,0,7262,[568 176  96 405 117],280,2,30088,4.142640782045986,0.0,0.0
7263,0,7263,[ 88 385 257 282 237],504,3,30091,4.142483480176211,0.0,0.0
7264,0,7264,[742 237 678  82   1],256,5,30096,4.1426015141087404,0.0,0.0
7265,0,7265,[318  64  98  79 588],796,5,30101,4.142719515551885,40.0,0.0
7266,0,7266,[323 238  88  98  70],174,4,30105,4.14269987615247,0.0,0.0
7267,0,7267,[318  64  98  79 588],457,5,30110,4.142817831590534,40.0,0.0
7268,0,7268,[568 427 435 508  11],269,2,30112,4.142523043059568,20.0,0.0
7269,0,7269,[ 50 496  15   9  79],236,3,30115,4.142365887207703,20.0,20.0
7270,0,7270,[318  64  98  79 588],457,5,30120,4.142483839911979,40.0,0.0
7271,0,7271,[475 180 196 483 135],269,3,30123,4.142326732673268,0.0,0.0
7272,0,7272,[318  64  98  79 588],450,5,30128,4.142444658325313,40.0,0.0
7273,0,7273,[172 197 546 135 191],457,4,30132,4.142425075611768,0.0,0.0
7274,0,7274,[318  64  98  79 588],716,5,30137,4.14254295532646,40.0,0.0
7275,0,7275,[318  64  98  79 588],457,5,30142,4.1426608026388125,40.0,0.0
7276,0,7276,[ 82  89 234 288 318],655,2,30144,4.142366359763638,20.0,0.0
7277,0,7277,[215 111 294 313 222],796,4,30148,4.142346798571036,0.0,0.0
7278,0,7278,[742 179  64 257 265],655,2,30150,4.142052479736227,20.0,0.0
7279,0,7279,[318  64  98  79 588],577,5,30155,4.142170329670329,40.0,0.0
7280,0,7280,[282 568 210 318 121],450,3,30158,4.142013459689603,20.0,0.0
7281,0,7281,[173 204 258 200  56],796,5,30163,4.142131282614666,0.0,0.0
7282,0,7282,[ 79 222 282 176 168],292,4,30167,4.14211176712893,0.0,0.0
7283,0,7283,[318  64  98  79 588],457,5,30172,4.14222954420648,40.0,0.0
7284,0,7284,[ 64 186 597 655 173],450,4,30176,4.142210020590254,20.0,0.0
7285,0,7285,[ 64 210  69 269 471],344,3,30179,4.142053252813615,20.0,0.0
7286,0,7286,[294 183  69 245 496],280,2,30181,4.1417592973788935,20.0,0.0
7287,0,7287,[318  64  98  79 588],796,5,30186,4.141877058177826,40.0,0.0
7288,0,7288,[ 97   1 121 135 200],457,5,30191,4.141994786664838,0.0,0.0
7289,0,7289,[318  64  98  79 588],577,5,30196,4.142112482853223,40.0,0.0
7290,0,7290,[318  64  98  79 588],577,5,30201,4.142230146756275,40.0,0.0
7291,0,7291,[318  64  98  79 588],457,5,30206,4.142347778387274,40.0,0.0
7292,0,7292,[210 276 405  89  56],655,2,30208,4.142054024406965,0.0,0.0
7293,0,7293,[144 111 427 597 313],796,5,30213,4.142171647929805,20.0,0.0
7294,0,7294,[318  64  98  79 588],18,5,30218,4.142289239204935,40.0,0.0
7295,0,7295,[318  64  98  79 588],577,5,30223,4.142406798245614,40.0,0.0
7296,0,7296,[318  64  98  79 588],796,5,30228,4.142524325065096,40.0,0.0
7297,0,7297,[318  64  98  79 588],796,5,30233,4.142641819676624,40.0,0.0
7298,0,7298,[318  64  98  79 588],450,5,30238,4.142759282093437,40.0,0.0
7299,0,7299,[318 216 180 258 546],796,4,30242,4.142739726027397,20.0,0.0
7300,0,7300,[318  64  98  79 588],796,5,30247,4.142857142857143,40.0,0.0
7301,0,7301,[ 25 496  15 125  56],593,4,30251,4.142837578745549,20.0,0.0
7302,0,7302,[121 195 187  69 238],796,4,30255,4.142818019991784,0.0,0.0
7303,0,7303,[318  64  98  79 588],450,5,30260,4.142935377875137,40.0,0.0
7304,0,7304,[ 11 185 483 197 238],655,2,30262,4.142642026009582,0.0,0.0
7305,0,7305,[  4 435 471  79 187],655,2,30264,4.142348754448399,0.0,0.0
7306,0,7306,[237  50 357 234  56],655,2,30266,4.142055563158615,0.0,20.0
7307,0,7307,[ 69 603 117 182 258],450,5,30271,4.1421729611384785,20.0,0.0
7308,0,7308,[318  64  98  79 588],796,5,30276,4.142290326994117,40.0,0.0
7309,0,7309,[ 95 135 180  96 273],450,2,30278,4.141997264021888,0.0,0.0
7310,0,7310,[132 568 179 215 742],457,5,30283,4.142114621802763,0.0,0.0
7311,0,7311,[597 357 405 125 121],11,2,30285,4.141821663019694,0.0,0.0
7312,0,7312,[318  64  98  79 588],577,5,30290,4.141939012717079,40.0,0.0
7313,0,7313,[318  64  98  79 588],450,5,30295,4.142056330325404,40.0,0.0
7314,0,7314,[318  64  98  79 588],716,5,30300,4.142173615857827,40.0,0.0
7315,0,7315,[ 96 568 322 180  95],280,4,30304,4.14215418261345,0.0,0.0
7316,0,7316,[403 168  50 313  69],577,5,30309,4.142271422714227,0.0,20.0
7317,0,7317,[318  64  98  79 588],796,5,30314,4.142388630773436,40.0,0.0
7318,0,7318,[100 322 168 111 176],151,2,30316,4.142095914742451,0.0,20.0
7319,0,7319,[318  64  98  79 588],450,5,30321,4.142213114754099,40.0,0.0
7320,0,7320,[ 79 180 125 197 597],450,5,30326,4.142330282748259,0.0,0.0
7321,0,7321,[318  64  98  79 588],577,5,30331,4.142447418738049,40.0,0.0
7322,0,7322,[174 265 282 286   9],280,3,30334,4.142291410624061,0.0,20.0
7323,0,7323,[318  64  98  79 588],716,5,30339,4.142408519934462,40.0,0.0
7324,0,7324,[515 496 405 603 180],269,3,30342,4.142252559726963,40.0,0.0
7325,0,7325,[318  64  98  79 588],796,5,30347,4.142369642369642,40.0,0.0
7326,0,7326,[427 186 151 143 181],5,2,30349,4.142077248532824,20.0,0.0
7327,0,7327,[181 427 135 333 222],236,3,30352,4.141921397379913,20.0,0.0
7328,0,7328,[588  98 111  89  25],18,2,30354,4.141629144494474,0.0,0.0
7329,0,7329,[185 181 151 125 265],256,5,30359,4.141746248294679,0.0,0.0
7330,0,7330,[195 237 423 144  11],716,3,30362,4.141590506070113,0.0,0.0
7331,0,7331,[175   1 294 121 180],457,4,30366,4.141571194762684,0.0,0.0
7332,0,7332,[  1 194 222 597 172],23,4,30370,4.141551888722215,0.0,0.0
7333,0,7333,[318  64  98  79 588],577,5,30375,4.141668939187347,40.0,0.0
7334,0,7334,[742 423 181 265 204],280,3,30378,4.141513292433538,0.0,0.0
7335,0,7335,[318  64  98  79 588],796,5,30383,4.141630316248637,40.0,0.0
7336,0,7336,[318  64  98  79 588],577,5,30388,4.1417473081641,40.0,0.0
7337,0,7337,[215 195 118 258 185],504,4,30392,4.141727991278278,0.0,0.0
7338,0,7338,[186 210 271 357 475],655,1,30393,4.141299904619158,0.0,0.0
7339,0,7339,[318  64  98  79 588],457,5,30398,4.14141689373297,40.0,0.0
7340,0,7340,[ 82 132 172 238 180],786,5,30403,4.141533850973982,0.0,0.0
7341,0,7341,[318  64  98  79 588],18,5,30408,4.141650776355217,40.0,0.0
7342,0,7342,[238 322  79 300  64],591,3,30411,4.1414953016478275,20.0,0.0
7343,0,7343,[ 56   1 515 273 238],655,2,30413,4.141203703703703,0.0,0.0
7344,0,7344,[ 12  71 215 496 176],577,5,30418,4.141320626276379,20.0,0.0
7345,0,7345,[318  64  98  79 588],796,5,30423,4.1414375170160636,40.0,0.0
7346,0,7346,[258 237 275 151 195],796,5,30428,4.1415543759357565,0.0,20.0
7347,0,7347,[318  64  98  79 588],796,5,30433,4.141671203048449,40.0,0.0
7348,0,7348,[286 265 197 237 603],796,3,30436,4.141515852496938,20.0,20.0
7349,0,7349,[318  64  98  79 588],450,5,30441,4.141632653061224,40.0,0.0
7350,0,7350,[318  64  98  79 588],450,5,30446,4.141749421847368,40.0,0.0
7351,0,7351,[318  64  98  79 588],716,5,30451,4.141866158868335,40.0,0.0
7352,0,7352,[318  64  98  79 588],796,5,30456,4.141982864137087,40.0,0.0
7353,0,7353,[  1  71  88 588 655],796,3,30459,4.141827576828937,0.0,0.0
7354,0,7354,[ 98 496 111 269 196],450,5,30464,4.14194425560843,20.0,0.0
7355,0,7355,[318  64  98  79 588],450,5,30469,4.1420609026644915,40.0,0.0
7356,0,7356,[318  64  98  79 588],450,5,30474,4.142177518010058,40.0,0.0
7357,0,7357,[318  64  98  79 588],796,5,30479,4.1422941016580594,40.0,0.0
7358,0,7358,[265 423 179 235 322],450,4,30483,4.142274765593151,0.0,0.0
7359,0,7359,[183 282 211 143   9],693,2,30485,4.141983695652174,0.0,0.0
7360,0,7360,[318  64  98  79 588],18,5,30490,4.142100258117104,40.0,0.0
7361,0,7361,[318  64  98  79 588],796,5,30495,4.1422167889160555,40.0,0.0
7362,0,7362,[318  64  98  79 588],450,5,30500,4.1423332880619315,40.0,0.0
7363,0,7363,[318  64  98  79 588],577,5,30505,4.142449755567626,40.0,0.0
7364,0,7364,[318  64  98  79 588],450,5,30510,4.142566191446028,40.0,0.0
7365,0,7365,[  7  25 153 302  50],655,2,30512,4.142275319033397,0.0,20.0
7366,0,7366,[100 143  89 237 204],655,2,30514,4.141984525587078,0.0,20.0
7367,0,7367,[318  64  98  79 588],450,5,30519,4.142100977198697,40.0,0.0
7368,0,7368,[  1 176 286  25  50],503,4,30523,4.142081693581218,0.0,40.0
7369,0,7369,[318 403 603 289 238],655,2,30525,4.141791044776119,40.0,0.0
7370,0,7370,[ 15 216 202 118 204],389,2,30527,4.1415004748338085,0.0,0.0
7371,0,7371,[ 88 195 161  96  71],280,3,30530,4.141345632121541,0.0,0.0
7372,0,7372,[ 79 234 194 168  50],5,2,30532,4.141055201410552,0.0,20.0
7373,0,7373,[318  64  98  79 588],457,5,30537,4.141171684296176,40.0,0.0
7374,0,7374,[588 173 215 742 127],796,4,30541,4.141152542372882,0.0,20.0
7375,0,7375,[174 282 182 245 185],796,4,30545,4.141133405639914,0.0,0.0
7376,0,7376,[172 655 300 176  22],655,1,30546,4.140707604717365,0.0,0.0
7377,0,7377,[174 294 176 328 118],796,4,30550,4.140688533477907,0.0,0.0
7378,0,7378,[ 89 385 183 182 111],796,5,30555,4.140804987125627,0.0,0.0
7379,0,7379,[318  64  98  79 588],796,5,30560,4.1409214092140925,40.0,0.0
7380,0,7380,[471 234 144  89  97],450,4,30564,4.140902316759247,0.0,0.0
7381,0,7381,[318  64  98  79 588],457,5,30569,4.1410186941208345,40.0,0.0
7382,0,7382,[127 100 403 603   7],655,2,30571,4.140728701070025,20.0,40.0
7383,0,7383,[423  70   9  11  96],457,5,30576,4.140845070422535,0.0,0.0
7384,0,7384,[ 22 187 237 286 228],296,5,30581,4.140961408259987,0.0,20.0
7385,0,7385,[ 15  25  82 127 121],450,1,30582,4.140536149471974,0.0,20.0
7386,0,7386,[318  64  98  79 588],18,5,30587,4.140652497630973,40.0,0.0
7387,0,7387,[234 215 197 294 257],504,3,30590,4.140498105035192,0.0,0.0
7388,0,7388,[318  64  98  79 588],716,5,30595,4.140614426850724,40.0,0.0
7389,0,7389,[318  64  98  79 588],450,5,30600,4.140730717185385,40.0,0.0
7390,0,7390,[318  64  98  79 588],796,5,30605,4.1408469760519555,40.0,0.0
7391,0,7391,[318  64  98  79 588],457,5,30610,4.140963203463204,40.0,0.0
7392,0,7392,[ 79 100  28 265 180],72,5,30615,4.141079399431895,0.0,20.0
7393,0,7393,[318  64  98  79 588],716,5,30620,4.141195563970787,40.0,0.0
7394,0,7394,[318  64  98  79 588],457,5,30625,4.14131169709263,40.0,0.0
7395,0,7395,[100 172 508 196 191],655,2,30627,4.141022174148188,0.0,20.0
7396,0,7396,[172 405 748 313 286],280,1,30628,4.140597539543058,0.0,20.0
7397,0,7397,[125   8 174 210 151],577,4,30632,4.140578534739118,0.0,0.0
7398,0,7398,[318  64  98  79 588],577,5,30637,4.140694688471415,40.0,0.0
7399,0,7399,[318  64  98  79 588],796,5,30642,4.140810810810811,40.0,0.0
7400,0,7400,[265 273  96  79 143],796,4,30646,4.140791784893933,0.0,0.0
7401,0,7401,[318  64  98  79 588],450,5,30651,4.1409078627398,40.0,0.0
7402,0,7402,[265 257 125 228 200],655,1,30652,4.140483587734702,0.0,0.0
7403,0,7403,[318  64  98  79 588],457,5,30657,4.140599675850892,40.0,0.0
7404,0,7404,[ 11 180   9 173  70],457,5,30662,4.140715732613099,0.0,0.0
7405,0,7405,[  7 275 300  82 202],450,4,30666,4.140696732379152,0.0,20.0
7406,0,7406,[173 405  56 143 211],593,4,30670,4.14067773727555,0.0,0.0
7407,0,7407,[318  64  98  79 588],450,5,30675,4.14079373650108,40.0,0.0
7408,0,7408,[318  64  98  79 588],796,5,30680,4.140909704413551,40.0,0.0
7409,0,7409,[318  64  98  79 588],450,5,30685,4.141025641025641,40.0,0.0
7410,0,7410,[289 258 191 215 118],655,1,30686,4.14060180812306,0.0,0.0
7411,0,7411,[200  96 179 427 222],655,3,30689,4.140447922288181,20.0,0.0
7412,0,7412,[ 88 181 276 655  56],457,5,30694,4.140563874274922,0.0,0.0
7413,0,7413,[194  11  25 234  12],457,5,30699,4.140679794982465,0.0,0.0
7414,0,7414,[318  64  98  79 588],450,5,30704,4.140795684423466,40.0,0.0
7415,0,7415,[ 82  12 385 742 323],256,5,30709,4.140911542610572,0.0,0.0
7416,0,7416,[ 28 588 235 127 181],716,4,30713,4.140892544155319,0.0,20.0
7417,0,7417,[275 100 245 286  89],344,3,30716,4.140738743596657,0.0,60.0
7418,0,7418,[118 357 187 200 235],450,2,30718,4.14045019544413,0.0,0.0
7419,0,7419,[318  64  98  79 588],450,5,30723,4.140566037735849,40.0,0.0
7420,0,7420,[423 161  79 597 742],593,4,30727,4.140547096078696,0.0,0.0
7421,0,7421,[423 483  95 273 143],450,2,30729,4.140258690379952,0.0,0.0
7422,0,7422,[318  64  98  79 588],450,5,30734,4.14037451165297,40.0,0.0
7423,0,7423,[318  64  98  79 588],450,5,30739,4.140490301724138,40.0,0.0
7424,0,7424,[111   8  25 132 143],389,2,30741,4.14020202020202,0.0,0.0
7425,0,7425,[228 200 405  82 183],457,5,30746,4.140317802316186,0.0,0.0
7426,0,7426,[318  64  98  79 588],450,5,30751,4.14043355325165,40.0,0.0
7427,0,7427,[153  79 216 546  11],450,5,30756,4.140549273021001,0.0,0.0
7428,0,7428,[210 269 215  97 258],942,4,30760,4.140530354018037,0.0,0.0
7429,0,7429,[  8 427 100 173 483],535,5,30765,4.14064602960969,20.0,20.0
7430,0,7430,[318  64  98  79 588],450,5,30770,4.140761674068093,40.0,0.0
7431,0,7431,[318  64  98  79 588],450,5,30775,4.140877287405813,40.0,0.0
7432,0,7432,[ 50 546 195 173 153],796,5,30780,4.14099286963541,0.0,20.0
7433,0,7433,[318  64  98  79 588],716,5,30785,4.141108420769438,40.0,0.0
7434,0,7434,[ 69 172 357 258 496],450,5,30790,4.141223940820444,20.0,0.0
7435,0,7435,[265 100 403 185 496],450,5,30795,4.1413394298009685,20.0,20.0
7436,0,7436,[161 153 435 655  15],450,4,30799,4.141320424902514,0.0,0.0
7437,0,7437,[318  64  98  79 588],457,5,30804,4.141435869857489,40.0,0.0
7438,0,7438,[153 111 200 196 135],716,4,30808,4.141416857104449,0.0,0.0
7439,0,7439,[318  64  98  79 588],577,5,30813,4.141532258064516,40.0,0.0
7440,0,7440,[318  64  98  79 588],457,5,30818,4.1416476280069885,40.0,0.0
7441,0,7441,[333 202 294  56 301],655,0,30818,4.14109110454179,0.0,0.0
7442,0,7442,[318  64  98  79 588],796,5,30823,4.141206502754266,40.0,0.0
7443,0,7443,[117 300 197 328  96],450,5,30828,4.141321869962386,0.0,0.0
7444,0,7444,[  7 275  82  97 204],655,1,30829,4.140899932840833,0.0,20.0
7445,0,7445,[186 185 153 423 655],655,1,30830,4.14047810905184,0.0,0.0
7446,0,7446,[235  71 132 385 258],23,3,30833,4.140324963072378,0.0,0.0
7447,0,7447,[318  64  98  79 588],18,5,30838,4.1404403866809885,40.0,0.0
7448,0,7448,[172 179  70  79 121],655,3,30841,4.140287286884146,0.0,0.0
7449,0,7449,[603 179 269 655 173],535,5,30846,4.1404026845637585,20.0,0.0
7450,0,7450,[318  64  98  79 588],577,5,30851,4.140518051268286,40.0,0.0
7451,0,7451,[185  25 435 196 197],401,5,30856,4.140633387010198,0.0,0.0
7452,0,7452,[183 196 655 405  69],151,3,30859,4.140480343485844,0.0,0.0
7453,0,7453,[318  64  98  79 588],18,5,30864,4.140595653340489,40.0,0.0
7454,0,7454,[318  64  98  79 588],450,5,30869,4.1407109322602285,40.0,0.0
7455,0,7455,[204  22 403  12  11],655,0,30869,4.140155579399142,0.0,0.0
7456,0,7456,[ 50   8 195 403 194],807,4,30873,4.140136784229583,0.0,20.0
7457,0,7457,[197 153 300 204 118],796,4,30877,4.140117994100295,0.0,0.0
7458,0,7458,[144 318  50 215 282],693,4,30881,4.140099209009251,20.0,20.0
7459,0,7459,[318  64  98  79 588],577,5,30886,4.140214477211797,40.0,0.0
7460,0,7460,[318  64  98  79 588],18,5,30891,4.140329714515481,40.0,0.0
7461,0,7461,[211 245 301 168 258],796,2,30893,4.140042883945323,0.0,0.0
7462,0,7462,[318  64  98  79 588],457,5,30898,4.140158113359239,40.0,0.0
7463,0,7463,[151 195  89 301 742],344,4,30902,4.140139335476956,0.0,0.0
7464,0,7464,[318  64  98  79 588],18,5,30907,4.140254521098459,40.0,0.0
7465,0,7465,[313 179 100 135 191],450,4,30911,4.140235735333512,0.0,20.0
7466,0,7466,[318  64  98  79 588],716,5,30916,4.140350877192983,40.0,0.0
7467,0,7467,[ 11 125 210 173 132],577,3,30919,4.140198178896625,0.0,0.0
7468,0,7468,[318  64  98  79 588],577,5,30924,4.14031329495247,40.0,0.0
7469,0,7469,[318  64  98  79 588],450,5,30929,4.140428380187417,40.0,0.0
7470,0,7470,[ 28 471 385   7 100],450,5,30934,4.14054343461384,0.0,20.0
7471,0,7471,[194  89 515 435 151],18,2,30936,4.140256959314775,0.0,0.0
7472,0,7472,[ 79 144 196 210 215],655,1,30937,4.139836745617557,0.0,0.0
7473,0,7473,[182 197 186  69 257],457,4,30941,4.1398180358576395,0.0,0.0
7474,0,7474,[318  64  98  79 588],457,5,30946,4.139933110367893,40.0,0.0
7475,0,7475,[269 238 216 588 144],796,3,30949,4.139780631353665,0.0,0.0
7476,0,7476,[318  64  98  79 588],716,5,30954,4.139895680085596,40.0,0.0
7477,0,7477,[655 265 357 181  98],72,4,30958,4.1398769724525275,0.0,0.0
7478,0,7478,[318  64  98  79 588],577,5,30963,4.139991977537104,40.0,0.0
7479,0,7479,[318  64  98  79 588],18,5,30968,4.140106951871657,40.0,0.0
7480,0,7480,[423 302   4 294 508],655,1,30969,4.1396872075925675,0.0,0.0
7481,0,7481,[318  64  98  79 588],716,5,30974,4.139802191927292,40.0,0.0
7482,0,7482,[300 186 269 483 211],796,2,30976,4.139516236803421,0.0,0.0
7483,0,7483,[153 132 182 174 194],450,5,30981,4.139631213254944,0.0,0.0
7484,0,7484,[282 143 215 742 300],504,5,30986,4.139746158984636,0.0,0.0
7485,0,7485,[318  64  98  79 588],796,5,30991,4.139861074004809,40.0,0.0
7486,0,7486,[216 196 328 271  98],655,2,30993,4.1395752637905705,0.0,0.0
7487,0,7487,[318  64  98  79 588],457,5,30998,4.139690170940171,40.0,0.0
7488,0,7488,[318  64  98  79 588],716,5,31003,4.139805047402858,40.0,0.0
7489,0,7489,[318  64  98  79 588],577,5,31008,4.139919893190921,40.0,0.0
7490,0,7490,[318  64  98  79 588],18,5,31013,4.140034708316646,40.0,0.0
7491,0,7491,[318  64  98  79 588],450,5,31018,4.140149492792312,40.0,0.0
7492,0,7492,[ 79 135  95 515  50],716,4,31022,4.140130788736154,0.0,20.0
7493,0,7493,[ 79 234 185 238 228],457,5,31027,4.140245529757139,0.0,0.0
7494,0,7494,[172   4 238 234  22],716,4,31031,4.1402268178785855,0.0,0.0
7495,0,7495,[179 144 238  56 111],457,4,31035,4.140208110992529,0.0,0.0
7496,0,7496,[176 216  98 210 204],655,2,31037,4.139922635720955,0.0,0.0
7497,0,7497,[204  25  50 318 313],593,4,31041,4.139903974393172,20.0,20.0
7498,0,7498,[318  64  98  79 588],796,5,31046,4.140018669155888,40.0,0.0
7499,0,7499,[ 56 475 143 269  11],655,1,31047,4.1396,0.0,0.0
7500,0,7500,[318  64  98  79 588],457,5,31052,4.139714704706039,40.0,0.0
7501,0,7501,[318  64  98  79 588],457,5,31057,4.139829378832311,40.0,0.0
7502,0,7502,[318  64  98  79 588],577,5,31062,4.1399440223910435,40.0,0.0
7503,0,7503,[318  64  98  79 588],18,5,31067,4.140058635394456,40.0,0.0
7504,0,7504,[318  64  98  79 588],716,5,31072,4.140173217854763,40.0,0.0
7505,0,7505,[318  64  98  79 588],796,5,31077,4.140287769784172,40.0,0.0
7506,0,7506,[228 238  11 204 258],11,1,31078,4.13986945517517,0.0,0.0
7507,0,7507,[655 117  88 276 143],504,3,31081,4.139717634523175,0.0,0.0
7508,0,7508,[175 238 405 302 121],151,3,31084,4.139565854308164,0.0,0.0
7509,0,7509,[318  64  98  79 588],450,5,31089,4.139680426098535,40.0,0.0
7510,0,7510,[318  64  98  79 588],716,5,31094,4.1397949673811745,40.0,0.0
7511,0,7511,[318  64  98  79 588],716,5,31099,4.139909478168264,40.0,0.0
7512,0,7512,[204 286   4  95 121],786,4,31103,4.139890855849861,0.0,20.0
7513,0,7513,[ 89 238 196  70 174],786,5,31108,4.140005323396327,0.0,0.0
7514,0,7514,[202 234 265   4 258],796,4,31112,4.139986693280107,0.0,0.0
7515,0,7515,[318  64  98  79 588],577,5,31117,4.140101117615753,40.0,0.0
7516,0,7516,[742 197 288 603 483],655,2,31119,4.139816416123454,20.0,0.0
7517,0,7517,[318  64  98  79 588],577,5,31124,4.139930832668263,40.0,0.0
7518,0,7518,[ 69  50 288 234 182],450,3,31127,4.139779225960899,0.0,20.0
7519,0,7519,[318  64  98  79 588],450,5,31132,4.139893617021277,40.0,0.0
7520,0,7520,[  8 268   4 185 265],535,2,31134,4.1396090945353015,0.0,0.0
7521,0,7521,[183 282 588 187 197],450,5,31139,4.139723477798458,0.0,0.0
7522,0,7522,[318  64  98  79 588],716,5,31144,4.139837830652665,40.0,0.0
7523,0,7523,[318  64  98  79 588],18,5,31149,4.139952153110048,40.0,0.0
7524,0,7524,[100 742 268 135 143],655,2,31151,4.139667774086378,0.0,20.0
7525,0,7525,[318  64  98  79 588],450,5,31156,4.1397820887589685,40.0,0.0
7526,0,7526,[175  12 257 276 215],457,4,31160,4.13976351800186,0.0,0.0
7527,0,7527,[161 100  28 186 282],796,2,31162,4.139479277364506,0.0,20.0
7528,0,7528,[168 191 196 273 282],796,4,31166,4.139460751759862,0.0,0.0
7529,0,7529,[235 144 234 168  22],457,4,31170,4.139442231075697,0.0,0.0
7530,0,7530,[318  64  98  79 588],796,5,31175,4.139556499800824,40.0,0.0
7531,0,7531,[ 15 191 423 603 204],151,4,31179,4.139537971322358,20.0,0.0
7532,0,7532,[318  64  98  79 588],450,5,31184,4.139652196999867,40.0,0.0
7533,0,7533,[318  64  98  79 588],18,5,31189,4.139766392354659,40.0,0.0
7534,0,7534,[318  64  98  79 588],716,5,31194,4.139880557398806,40.0,0.0
7535,0,7535,[318  64  98  79 588],577,5,31199,4.1399946921443735,40.0,0.0
7536,0,7536,[318  64  98  79 588],450,5,31204,4.140108796603423,40.0,0.0
7537,0,7537,[ 11  15 228  64   8],330,5,31209,4.1402228707880075,20.0,0.0
7538,0,7538,[216 210 117 742  22],450,4,31213,4.140204271123491,0.0,0.0
7539,0,7539,[318  64  98  79 588],450,5,31218,4.140318302387268,40.0,0.0
7540,0,7540,[180 405 603 168 181],796,4,31222,4.140299695000663,20.0,0.0
7541,0,7541,[118 195  56 168  15],151,3,31225,4.14014850172368,0.0,0.0
7542,0,7542,[273 179 191  69  56],236,3,31228,4.139997348535066,0.0,0.0
7543,0,7543,[318  64  98  79 588],796,5,31233,4.140111346765641,40.0,0.0
7544,0,7544,[211 257 121 568 111],716,5,31238,4.140225314777998,0.0,0.0
7545,0,7545,[318  64  98  79 588],457,5,31243,4.140339252584151,40.0,0.0
7546,0,7546,[318  64  98  79 588],457,5,31248,4.140453160196104,40.0,0.0
7547,0,7547,[118 153 318 588 405],796,5,31253,4.140567037625861,20.0,0.0
7548,0,7548,[515 174 202 191 185],401,5,31258,4.140680884885415,0.0,0.0
7549,0,7549,[318  64  98  79 588],577,5,31263,4.140794701986755,40.0,0.0
7550,0,7550,[318  64  98  79 588],18,5,31268,4.140908488941862,40.0,0.0
7551,0,7551,[655 282  98  70 196],655,1,31269,4.140492584745763,0.0,0.0
7552,0,7552,[174  56 196 273 100],655,1,31270,4.1400767906792,0.0,20.0
7553,0,7553,[318  64  98  79 588],18,5,31275,4.140190627482129,40.0,0.0
7554,0,7554,[318  64  98  79 588],18,5,31280,4.14030443414957,40.0,0.0
7555,0,7555,[111 185 182 258 588],457,4,31284,4.140285865537321,0.0,0.0
7556,0,7556,[222 269  11 265 211],450,4,31288,4.140267301839354,0.0,0.0
7557,0,7557,[265 483 289 121 222],655,1,31289,4.139851812648849,0.0,0.0
7558,0,7558,[318  64  98  79 588],716,5,31294,4.139965603915862,40.0,0.0
7559,0,7559,[318  64  98  79 588],796,5,31299,4.140079365079365,40.0,0.0
7560,0,7560,[508 286 268 121  50],463,4,31303,4.140060838513424,0.0,40.0
7561,0,7561,[ 15   9 238  97 211],655,0,31303,4.139513356254959,0.0,0.0
7562,0,7562,[275 322  97 172 286],450,5,31308,4.13962713209044,0.0,40.0
7563,0,7563,[318  64  98  79 588],18,5,31313,4.139740877842412,40.0,0.0
7564,0,7564,[318  64  98  79 588],577,5,31318,4.139854593522802,40.0,0.0
7565,0,7565,[273 568 168 323 286],796,2,31320,4.139571768437748,0.0,20.0
7566,0,7566,[210  12 127 204 117],344,4,31324,4.13955332364213,0.0,20.0
7567,0,7567,[197  64  98 202  12],796,4,31328,4.1395348837209305,20.0,0.0
7568,0,7568,[121 125 176 322   1],151,3,31331,4.139384330823094,0.0,0.0
7569,0,7569,[ 70 143   9 161 288],457,5,31336,4.139498018494056,0.0,0.0
7570,0,7570,[333 195 118  15 357],655,1,31337,4.1390833443402455,0.0,0.0
7571,0,7571,[318  64  98  79 588],457,5,31342,4.139197041732699,40.0,0.0
7572,0,7572,[318  64  98  79 588],18,5,31347,4.139310709098112,40.0,0.0
7573,0,7573,[318  64  98  79 588],450,5,31352,4.139424346448376,40.0,0.0
7574,0,7574,[313 161 273 228 174],796,4,31356,4.1394059405940595,0.0,0.0
7575,0,7575,[235  11 180 195 204],450,4,31360,4.139387539598733,0.0,0.0
7576,0,7576,[318  64  98  79 588],457,5,31365,4.139501121816022,40.0,0.0
7577,0,7577,[318  64  98  79 588],450,5,31370,4.139614674056479,40.0,0.0
7578,0,7578,[181   9 483 195   7],269,2,31372,4.13933236574746,0.0,0.0
7579,0,7579,[328 265 258 151 318],450,5,31377,4.139445910290237,20.0,0.0
7580,0,7580,[ 22 405 357 286  95],344,2,31379,4.139163698720486,0.0,20.0
7581,0,7581,[318  64  98  79 588],450,5,31384,4.1392772355579,40.0,0.0
7582,0,7582,[ 56   7 423 191 195],629,3,31387,4.139126994593169,0.0,0.0
7583,0,7583,[275 186   7 117 161],457,5,31392,4.139240506329114,0.0,20.0
7584,0,7584,[ 56 275  12 194  11],629,4,31396,4.139222148978247,0.0,20.0
7585,0,7585,[318  64  98  79 588],716,5,31401,4.139335618244134,40.0,0.0
7586,0,7586,[318  64  98  79 588],796,5,31406,4.139449057598524,40.0,0.0
7587,0,7587,[318  64  98  79 588],450,5,31411,4.139562467053242,40.0,0.0
7588,0,7588,[318  64  98  79 588],796,5,31416,4.139675846620108,40.0,0.0
7589,0,7589,[318  64  98  79 588],457,5,31421,4.139789196310935,40.0,0.0
7590,0,7590,[289  88 144 135 210],693,2,31423,4.139507311289685,0.0,0.0
7591,0,7591,[318  64  98  79 588],450,5,31428,4.139620653319284,40.0,0.0
7592,0,7592,[318  64  98  79 588],577,5,31433,4.139733965494535,40.0,0.0
7593,0,7593,[127 185 273 196 144],401,3,31436,4.139583882012115,0.0,20.0
7594,0,7594,[318  64  98  79 588],577,5,31441,4.139697169190256,40.0,0.0
7595,0,7595,[132   8  11 216 187],655,2,31443,4.139415481832543,0.0,0.0
7596,0,7596,[318  64  98  79 588],577,5,31448,4.139528761353166,40.0,0.0
7597,0,7597,[318 127 161 181 196],504,4,31452,4.139510397473019,20.0,20.0
7598,0,7598,[182 196 127 258 194],629,5,31457,4.139623634688775,0.0,20.0
7599,0,7599,[202 603 237 175 483],269,3,31460,4.139473684210526,20.0,0.0
7600,0,7600,[265 385 546 172 237],786,5,31465,4.139586896460992,0.0,0.0
7601,0,7601,[151 174 269  15 423],18,4,31469,4.139568534596159,0.0,0.0
7602,0,7602,[318  64  98  79 588],577,5,31474,4.139681704590293,40.0,0.0
7603,0,7603,[ 25 161 496 427 318],450,4,31478,4.139663335086796,60.0,0.0
7604,0,7604,[318  64  98  79 588],796,5,31483,4.139776462853386,40.0,0.0
7605,0,7605,[ 56 183 200 174 185],504,3,31486,4.139626610570602,0.0,0.0
7606,0,7606,[318  64  98  79 588],577,5,31491,4.139739713421848,40.0,0.0
7607,0,7607,[318  64  98  79 588],577,5,31496,4.139852786540484,40.0,0.0
7608,0,7608,[ 98 294  70 202 215],65,4,31500,4.139834406623735,0.0,0.0
7609,0,7609,[318  64  98  79 588],18,5,31505,4.139947437582129,40.0,0.0
7610,0,7610,[ 88  71 195 127 204],280,2,31507,4.139666272500328,0.0,20.0
7611,0,7611,[275 191  95 405 235],23,3,31510,4.139516552811351,0.0,20.0
7612,0,7612,[195 258 515  11 125],655,1,31511,4.13910416393012,0.0,0.0
7613,0,7613,[318  64  98  79 588],457,5,31516,4.139217231415813,40.0,0.0
7614,0,7614,[318  64  98  79 588],577,5,31521,4.139330269205516,40.0,0.0
7615,0,7615,[318  64  98  79 588],716,5,31526,4.139443277310924,40.0,0.0
7616,0,7616,[318  64  98  79 588],457,5,31531,4.139556255743731,40.0,0.0
7617,0,7617,[117 180 118 211 273],796,2,31533,4.13927540036755,0.0,0.0
7618,0,7618,[176 496 185 173 187],716,3,31536,4.139125869536684,20.0,0.0
7619,0,7619,[568 132 153 405 222],796,5,31541,4.139238845144357,0.0,0.0
7620,0,7620,[172   1  15 168 194],389,4,31545,4.139220574727726,0.0,0.0
7621,0,7621,[121 405 185  82 471],716,4,31549,4.1392023091052215,0.0,0.0
7622,0,7622,[318  64  98  79 588],18,5,31554,4.139315230224321,40.0,0.0
7623,0,7623,[135 271 179 302 385],655,3,31557,4.1391657922350475,0.0,0.0
7624,0,7624,[318  64  98  79 588],577,5,31562,4.13927868852459,40.0,0.0
7625,0,7625,[ 98 215 180 282 174],504,5,31567,4.139391555205875,0.0,0.0
7626,0,7626,[318  64  98  79 588],577,5,31572,4.139504392290546,40.0,0.0
7627,0,7627,[318  64  98  79 588],18,5,31577,4.139617199790247,40.0,0.0
7628,0,7628,[ 88 483 742 211 282],693,1,31578,4.139205662603224,0.0,0.0
7629,0,7629,[ 82  56 588 385 300],716,4,31582,4.1391874180865,0.0,0.0
7630,0,7630,[318  64  98  79 588],716,5,31587,4.139300222775521,40.0,0.0
7631,0,7631,[183  56 471 427  96],693,3,31590,4.139150943396227,20.0,0.0
7632,0,7632,[195 196 173 191 234],629,4,31594,4.139132713218918,0.0,0.0
7633,0,7633,[318  64  98  79 588],796,5,31599,4.13924548074404,40.0,0.0
7634,0,7634,[318  64  98  79 588],577,5,31604,4.1393582187295355,40.0,0.0
7635,0,7635,[318  64  98  79 588],450,5,31609,4.139470927187009,40.0,0.0
7636,0,7636,[318  64  98  79 588],450,5,31614,4.139583606128061,40.0,0.0
7637,0,7637,[143 405 100 483 258],23,4,31618,4.139565331238544,0.0,20.0
7638,0,7638,[143 546  79 121 222],450,3,31621,4.1394161539468515,0.0,0.0
7639,0,7639,[318  64  98  79 588],450,5,31626,4.139528795811518,40.0,0.0
7640,0,7640,[546  79  88 143 151],151,4,31630,4.139510535270253,0.0,0.0
7641,0,7641,[318  64  98  79 588],796,5,31635,4.139623135304894,40.0,0.0
7642,0,7642,[318  64  98  79 588],18,5,31640,4.1397357058746564,40.0,0.0
7643,0,7643,[318  64  98  79 588],716,5,31645,4.139848246991104,40.0,0.0
7644,0,7644,[318  64  98  79 588],450,5,31650,4.1399607586657945,40.0,0.0
7645,0,7645,[318  64  98  79 588],457,5,31655,4.14007324091028,40.0,0.0
7646,0,7646,[238  69   9 508 211],269,4,31659,4.140054923499411,0.0,0.0
7647,0,7647,[318  64  98  79 588],457,5,31664,4.140167364016737,40.0,0.0
7648,0,7648,[318  64  98  79 588],457,5,31669,4.140279775134005,40.0,0.0
7649,0,7649,[318  64  98  79 588],716,5,31674,4.140392156862745,40.0,0.0
7650,0,7650,[ 22 191 181 385 471],716,3,31677,4.140243105476408,0.0,0.0
7651,0,7651,[318  64  98  79 588],457,5,31682,4.14035546262415,40.0,0.0
7652,0,7652,[179 385 222 216 742],450,4,31686,4.140337122696981,0.0,0.0
7653,0,7653,[318  64  98  79 588],450,5,31691,4.140449438202247,40.0,0.0
7654,0,7654,[318  64  98  79 588],457,5,31696,4.140561724363161,40.0,0.0
7655,0,7655,[  9 318  96  25 215],72,5,31701,4.140673981191223,20.0,0.0
7656,0,7656,[ 70 237   9 185 181],535,5,31706,4.140786208697923,0.0,0.0
7657,0,7657,[318  64  98  79 588],716,5,31711,4.140898406894751,40.0,0.0
7658,0,7658,[318  64  98  79 588],716,5,31716,4.141010575793184,40.0,0.0
7659,0,7659,[258 181 275   1 215],796,4,31720,4.140992167101827,0.0,20.0
7660,0,7660,[195 318 197  15   4],655,1,31721,4.140582169429578,20.0,0.0
7661,0,7661,[318  64  98  79 588],457,5,31726,4.140694335682589,40.0,0.0
7662,0,7662,[318  64  98  79 588],796,5,31731,4.140806472660838,40.0,0.0
7663,0,7663,[174   8 117 427 483],796,5,31736,4.140918580375783,20.0,0.0
7664,0,7664,[318  64  98  79 588],716,5,31741,4.141030658838878,40.0,0.0
7665,0,7665,[204 183 186 100  25],264,5,31746,4.141142708061571,0.0,20.0
7666,0,7666,[318  64  98  79 588],450,5,31751,4.141254728055302,40.0,0.0
7667,0,7667,[196 289 211 143 427],693,2,31753,4.140975482524778,20.0,0.0
7668,0,7668,[318  64  98  79 588],18,5,31758,4.141087495110184,40.0,0.0
7669,0,7669,[238 318 180  71 100],18,5,31763,4.141199478487614,20.0,20.0
7670,0,7670,[318  64  98  79 588],450,5,31768,4.141311432668492,40.0,0.0
7671,0,7671,[ 22 195 271 211 151],807,3,31771,4.141162669447341,0.0,0.0
7672,0,7672,[318  64  98  79 588],450,5,31776,4.1412745992441025,40.0,0.0
7673,0,7673,[210 200 603 269 182],450,3,31779,4.1411258795934325,20.0,0.0
7674,0,7674,[318  64  98  79 588],577,5,31784,4.141237785016287,40.0,0.0
7675,0,7675,[318  64  98  79 588],577,5,31789,4.141349661281918,40.0,0.0
7676,0,7676,[318  64  98  79 588],577,5,31794,4.1414615084017194,40.0,0.0
7677,0,7677,[318  64  98  79 588],450,5,31799,4.14157332638708,40.0,0.0
7678,0,7678,[ 1 69 88  7 50],655,1,31800,4.141164214090376,0.0,20.0
7679,0,7679,[318  64  98  79 588],457,5,31805,4.141276041666667,40.0,0.0
7680,0,7680,[318  64  98  79 588],796,5,31810,4.141387840124984,40.0,0.0
7681,0,7681,[ 12 222 405 508 127],655,1,31811,4.140978911741734,0.0,20.0
7682,0,7682,[318  64  98  79 588],577,5,31816,4.141090719770923,40.0,0.0
7683,0,7683,[318  64  98  79 588],796,5,31821,4.141202498698594,40.0,0.0
7684,0,7684,[288 118 100 202 181],504,2,31823,4.140923877683799,0.0,20.0
7685,0,7685,[196 204 161 174 385],504,4,31827,4.140905542544886,0.0,0.0
7686,0,7686,[ 88  50 238 322 121],786,3,31830,4.140757122414466,0.0,20.0
7687,0,7687,[228 196 182 195  15],72,4,31834,4.140738813735692,0.0,0.0
7688,0,7688,[ 95 197 181 174  82],389,4,31838,4.140720509819222,0.0,0.0
7689,0,7689,[258 265 328 197  95],942,4,31842,4.140702210663199,0.0,0.0
7690,0,7690,[318  22 588 195 385],807,4,31846,4.140683916265766,20.0,0.0
7691,0,7691,[318  64  98  79 588],796,5,31851,4.140795631825273,40.0,0.0
7692,0,7692,[318  64  98  79 588],716,5,31856,4.140907318341349,40.0,0.0
7693,0,7693,[318  64  98  79 588],796,5,31861,4.141018975825318,40.0,0.0
7694,0,7694,[318  64  98  79 588],796,5,31866,4.141130604288499,40.0,0.0
7695,0,7695,[318  64  98  79 588],18,5,31871,4.141242203742204,40.0,0.0
7696,0,7696,[318  64  98  79 588],457,5,31876,4.141353774197739,40.0,0.0
7697,0,7697,[  7 286 257 117 175],655,0,31876,4.14081579631073,0.0,20.0
7698,0,7698,[318  64  98  79 588],796,5,31881,4.140927393167944,40.0,0.0
7699,0,7699,[318  64  98  79 588],457,5,31886,4.141038961038961,40.0,0.0
7700,0,7700,[546 496  69 196 508],344,3,31889,4.140890793403454,20.0,0.0
7701,0,7701,[265 172 125  56  64],796,5,31894,4.14100233705531,20.0,0.0
7702,0,7702,[318  64  98  79 588],716,5,31899,4.141113851746073,40.0,0.0
7703,0,7703,[191   7 357 234 204],655,2,31901,4.140835929387332,0.0,0.0
7704,0,7704,[318  64  98  79 588],450,5,31906,4.140947436729396,40.0,0.0
7705,0,7705,[191 300 405 143 168],450,5,31911,4.141058915131067,0.0,0.0
7706,0,7706,[ 98 471 135 603 187],535,2,31913,4.14078110808356,20.0,0.0
7707,0,7707,[318  64  98  79 588],18,5,31918,4.140892579138558,40.0,0.0
7708,0,7708,[318  64  98  79 588],457,5,31923,4.141004021273836,40.0,0.0
7709,0,7709,[318  64  98  79 588],796,5,31928,4.141115434500649,40.0,0.0
7710,0,7710,[ 82 228 265 483 508],655,1,31929,4.140708079367138,0.0,0.0
7711,0,7711,[318  64  98  79 588],450,5,31934,4.140819502074689,40.0,0.0
7712,0,7712,[318  64  98  79 588],796,5,31939,4.1409308958900555,40.0,0.0
7713,0,7713,[286 195 173  97  50],796,3,31942,4.1407829919626655,0.0,40.0
7714,0,7714,[ 50 168  98 173 197],503,5,31947,4.140894361633182,0.0,20.0
7715,0,7715,[202 276 515 111 265],655,2,31949,4.14061689994816,0.0,0.0
7716,0,7716,[318  64  98  79 588],796,5,31954,4.140728262278087,40.0,0.0
7717,0,7717,[  8 423 196 273  96],796,4,31958,4.140710028504794,0.0,0.0
7718,0,7718,[318  64  98  79 588],457,5,31963,4.140821349915792,40.0,0.0
7719,0,7719,[187 282 471 153 183],716,1,31964,4.140414507772021,0.0,0.0
7720,0,7720,[ 22  95 742 235  98],280,5,31969,4.14052583862194,0.0,0.0
7721,0,7721,[176 174 197 100 191],269,3,31972,4.14037814037814,0.0,20.0
7722,0,7722,[300 132 118 174 385],151,3,31975,4.140230480383271,0.0,0.0
7723,0,7723,[318  64  98  79 588],577,5,31980,4.140341791817711,40.0,0.0
7724,0,7724,[318  64  98  79 588],457,5,31985,4.140453074433657,40.0,0.0
7725,0,7725,[318  64  98  79 588],18,5,31990,4.140564328242299,40.0,0.0
7726,0,7726,[318  64  98  79 588],450,5,31995,4.1406755532548205,40.0,0.0
7727,0,7727,[318  64  98  79 588],716,5,32000,4.140786749482402,40.0,0.0
7728,0,7728,[172 405  79 204 197],151,4,32004,4.14076853409238,0.0,0.0
7729,0,7729,[216 183 182 191  50],269,2,32006,4.140491591203105,0.0,20.0
7730,0,7730,[318  64  98  79 588],457,5,32011,4.140602768076575,40.0,0.0
7731,0,7731,[318  64  98  79 588],18,5,32016,4.140713916192447,40.0,0.0
7732,0,7732,[268 172 118 546 301],344,2,32018,4.140437087805509,0.0,0.0
7733,0,7733,[318  64  98  79 588],577,5,32023,4.1405482286009825,40.0,0.0
7734,0,7734,[318  64  98  79 588],457,5,32028,4.140659340659341,40.0,0.0
7735,0,7735,[318  64  98  79 588],716,5,32033,4.140770423991727,40.0,0.0
7736,0,7736,[318  64  98  79 588],577,5,32038,4.1408814786092805,40.0,0.0
7737,0,7737,[318  64  98  79 588],450,5,32043,4.140992504523132,40.0,0.0
7738,0,7738,[318  64  98  79 588],577,5,32048,4.1411035017444116,40.0,0.0
7739,0,7739,[318  64  98  79 588],18,5,32053,4.141214470284238,40.0,0.0
7740,0,7740,[271 182 323 215  89],796,4,32057,4.141196227877535,0.0,0.0
7741,0,7741,[318  64  98  79 588],796,5,32062,4.141307155773702,40.0,0.0
7742,0,7742,[318  64  98  79 588],716,5,32067,4.141418055017435,40.0,0.0
7743,0,7743,[318  64  98  79 588],18,5,32072,4.141528925619835,40.0,0.0
7744,0,7744,[318  64  98  79 588],457,5,32077,4.141639767591995,40.0,0.0
7745,0,7745,[318  64  98  79 588],18,5,32082,4.141750580945004,40.0,0.0
7746,0,7746,[318  64  98  79 588],18,5,32087,4.141861365689945,40.0,0.0
7747,0,7747,[132 245  82 483 275],796,3,32090,4.141713990707279,0.0,20.0
7748,0,7748,[318  64  98  79 588],18,5,32095,4.141824751580849,40.0,0.0
7749,0,7749,[202  70 117 568 273],450,4,32099,4.141806451612903,0.0,0.0
7750,0,7750,[588 127 132 228  25],450,4,32103,4.14178815636692,0.0,20.0
7751,0,7751,[322 200  98 153 265],796,4,32107,4.1417698658410735,0.0,0.0
7752,0,7752,[258 245   9 172 269],344,3,32110,4.141622597704115,0.0,0.0
7753,0,7753,[318  64  98  79 588],457,5,32115,4.141733298942481,40.0,0.0
7754,0,7754,[318  64  98  79 588],716,5,32120,4.141843971631205,40.0,0.0
7755,0,7755,[318  64  98  79 588],18,5,32125,4.141954615781331,40.0,0.0
7756,0,7756,[132 100 195 288 202],280,2,32127,4.14167848394998,0.0,20.0
7757,0,7757,[427   7 118  89 546],450,4,32131,4.141660221706625,20.0,0.0
7758,0,7758,[180 357 185  64 202],716,4,32135,4.14164196417064,20.0,0.0
7759,0,7759,[318  64  25 118 182],655,3,32138,4.141494845360825,40.0,0.0
7760,0,7760,[ 98 273 655 210 216],450,3,32141,4.141347764463342,0.0,0.0
7761,0,7761,[ 12 180 173   8   9],11,3,32144,4.14120072146354,0.0,0.0
7762,0,7762,[318  64  98  79 588],577,5,32149,4.141311348705397,40.0,0.0
7763,0,7763,[318  64  98  79 588],716,5,32154,4.141421947449768,40.0,0.0
7764,0,7764,[179 121 357   1 427],296,5,32159,4.141532517707662,20.0,0.0
7765,0,7765,[597  89 174 143 748],450,5,32164,4.141643059490085,0.0,0.0
7766,0,7766,[176 121  15  12 588],450,3,32167,4.141496073129908,0.0,0.0
7767,0,7767,[357 427  25 215 135],693,5,32172,4.141606591143152,20.0,0.0
7768,0,7768,[301  82 211  11 294],450,4,32176,4.141588364010812,0.0,0.0
7769,0,7769,[318  64  98  79 588],457,5,32181,4.141698841698842,40.0,0.0
7770,0,7770,[ 89 423 144 216 275],457,5,32186,4.141809290953545,0.0,20.0
7771,0,7771,[ 64 216 191 135 118],457,5,32191,4.141919711785898,20.0,0.0
7772,0,7772,[  9 191  25 153 202],401,3,32194,4.141772803293452,0.0,0.0
7773,0,7773,[318  64  98  79 588],457,5,32199,4.141883200411629,40.0,0.0
7774,0,7774,[318  64  98  79 588],18,5,32204,4.141993569131833,40.0,0.0
7775,0,7775,[318  64  98  79 588],716,5,32209,4.14210390946502,40.0,0.0
7776,0,7776,[153  79 318  97  70],593,5,32214,4.142214221422142,20.0,0.0
7777,0,7777,[ 70 135 265  96 385],716,2,32216,4.1419388017485215,0.0,0.0
7778,0,7778,[318  64  98  79 588],577,5,32221,4.142049106568968,40.0,0.0
7779,0,7779,[318  64  98  79 588],716,5,32226,4.142159383033419,40.0,0.0
7780,0,7780,[ 11 161 100 132  82],457,5,32231,4.142269631152808,0.0,20.0
7781,0,7781,[132 269 471 197 328],450,5,32236,4.142379850938062,0.0,0.0
7782,0,7782,[204  70 496 471 181],535,5,32241,4.1424900424001025,20.0,0.0
7783,0,7783,[289 172 318 265 151],807,5,32246,4.142600205549845,20.0,0.0
7784,0,7784,[318  64  98  79 588],450,5,32251,4.142710340398201,40.0,0.0
7785,0,7785,[182 238 301 172 300],655,2,32253,4.142435139994863,0.0,0.0
7786,0,7786,[245 546 265 276   1],280,4,32257,4.14241684859381,0.0,0.0
7787,0,7787,[286  12 196   9 194],11,4,32261,4.142398561890087,0.0,20.0
7788,0,7788,[318  64  98  79 588],796,5,32266,4.142508666067531,40.0,0.0
7789,0,7789,[237 143 282 194 200],457,5,32271,4.142618741976894,0.0,0.0
7790,0,7790,[318  64  98  79 588],716,5,32276,4.142728789629059,40.0,0.0
7791,0,7791,[318  64  98  79 588],796,5,32281,4.142838809034908,40.0,0.0
7792,0,7792,[318  64  98  79 588],18,5,32286,4.142948800205312,40.0,0.0
7793,0,7793,[222 471 191 182 187],655,3,32289,4.142802155504234,0.0,0.0
7794,0,7794,[180  69 423 185 655],693,1,32290,4.1423989737010904,0.0,0.0
7795,0,7795,[318  64  98  79 588],716,5,32295,4.142508978963571,40.0,0.0
7796,0,7796,[173 234 748 496 265],807,3,32298,4.142362447095037,20.0,0.0
7797,0,7797,[238 197 423 135 655],716,4,32302,4.142344190818158,0.0,0.0
7798,0,7798,[318  64  98  79 588],450,5,32307,4.142454160789844,40.0,0.0
7799,0,7799,[318  64  98  79 588],457,5,32312,4.142564102564102,40.0,0.0
7800,0,7800,[ 70  97 588 235  15],450,3,32315,4.142417638764261,0.0,0.0
7801,0,7801,[357 286 742 427 234],796,2,32317,4.142143040246091,20.0,20.0
7802,0,7802,[275 132  97 204 197],535,5,32322,4.142252979623222,0.0,20.0
7803,0,7803,[ 98 132   1 257 180],796,3,32325,4.142106611993849,0.0,0.0
7804,0,7804,[323  82  50 125 161],798,3,32328,4.141960281870595,0.0,20.0
7805,0,7805,[318  64  98  79 588],457,5,32333,4.142070202408404,40.0,0.0
7806,0,7806,[194 200 427 204 333],796,5,32338,4.14218009478673,20.0,0.0
7807,0,7807,[318  64  98  79 588],18,5,32343,4.142289959016393,40.0,0.0
7808,0,7808,[318  64  98  79 588],577,5,32348,4.142399795108209,40.0,0.0
7809,0,7809,[234 183  96 202 238],716,3,32351,4.142253521126761,0.0,0.0
7810,0,7810,[405  50 235 153 282],280,2,32353,4.141979260017924,0.0,20.0
7811,0,7811,[318  64  98  79 588],450,5,32358,4.142089093701997,40.0,0.0
7812,0,7812,[ 22 180  11 144 197],450,5,32363,4.142198899270447,0.0,0.0
7813,0,7813,[318  64  98  79 588],457,5,32368,4.142308676734067,40.0,0.0
7814,0,7814,[403  70 168  15   1],457,5,32373,4.142418426103647,0.0,0.0
7815,0,7815,[127 403 237  64 132],796,5,32378,4.142528147389969,20.0,20.0
7816,0,7816,[318  64  98  79 588],450,5,32383,4.142637840603812,40.0,0.0
7817,0,7817,[ 56 235 294 185 302],450,4,32387,4.142619595804554,0.0,0.0
7818,0,7818,[318  64  98  79 588],18,5,32392,4.142729249264612,40.0,0.0
7819,0,7819,[318  64  98  79 588],457,5,32397,4.142838874680307,40.0,0.0
7820,0,7820,[405 245 181  71  56],450,4,32401,4.142820611175042,0.0,0.0
7821,0,7821,[318  64  98  79 588],450,5,32406,4.142930196880593,40.0,0.0
7822,0,7822,[318  64  98  79 588],716,5,32411,4.143039754569858,40.0,0.0
7823,0,7823,[588 300 176 125 117],796,5,32416,4.143149284253579,0.0,0.0
7824,0,7824,[  7   4 282 318 186],535,3,32419,4.143003194888179,20.0,0.0
7825,0,7825,[318  64  98  79 588],450,5,32424,4.143112701252236,40.0,0.0
7826,0,7826,[318  64  98  79 588],18,5,32429,4.1432221796345985,40.0,0.0
7827,0,7827,[318  64  98  79 588],577,5,32434,4.143331630045989,40.0,0.0
7828,0,7828,[318  64  98  79 588],450,5,32439,4.143441052497126,40.0,0.0
7829,0,7829,[318  64  98  79 588],18,5,32444,4.143550446998723,40.0,0.0
7830,0,7830,[172 405  69 211  89],796,4,32448,4.143532115949432,0.0,0.0
7831,0,7831,[318  64  98  79 588],457,5,32453,4.143641470888662,40.0,0.0
7832,0,7832,[318  64  98  79 588],577,5,32458,4.143750797906294,40.0,0.0
7833,0,7833,[  1  98 175 202 423],23,3,32461,4.143604799591524,0.0,0.0
7834,0,7834,[318  64  98  79 588],716,5,32466,4.143714103382259,40.0,0.0
7835,0,7835,[318  64  98  79 588],577,5,32471,4.14382337927514,40.0,0.0
7836,0,7836,[318 181 288  11  89],655,2,32473,4.143549827740206,20.0,0.0
7837,0,7837,[215  98 143 286  89],796,4,32477,4.143531513141108,0.0,20.0
7838,0,7838,[568 245  89  70 235],450,4,32481,4.143513203214696,0.0,0.0
7839,0,7839,[405 288  88  28 182],457,5,32486,4.143622448979592,0.0,0.0
7840,0,7840,[318  64  98  79 588],796,5,32491,4.143731666879225,40.0,0.0
7841,0,7841,[318  64  98  79 588],716,5,32496,4.143840856924254,40.0,0.0
7842,0,7842,[318  64  98  79 588],796,5,32501,4.1439500191253344,40.0,0.0
7843,0,7843,[300 195 197 121   1],796,3,32504,4.14380418154003,0.0,0.0
7844,0,7844,[318  64  98  79 588],716,5,32509,4.1439133205863605,40.0,0.0
7845,0,7845,[318  64  98  79 588],450,5,32514,4.144022431812388,40.0,0.0
7846,0,7846,[318  64  98  79 588],450,5,32519,4.14413151522875,40.0,0.0
7847,0,7847,[318  64  98  79 588],18,5,32524,4.144240570846075,40.0,0.0
7848,0,7848,[318  64  98  79 588],457,5,32529,4.1443495986749905,40.0,0.0
7849,0,7849,[318  64  98  79 588],716,5,32534,4.144458598726114,40.0,0.0
7850,0,7850,[655 187  70 202 322],450,5,32539,4.144567571010063,0.0,0.0
7851,0,7851,[318  64  98  79 588],796,5,32544,4.1446765155374425,40.0,0.0
7852,0,7852,[318  64  98  79 588],716,5,32549,4.144785432318859,40.0,0.0
7853,0,7853,[318  64  98  79 588],716,5,32554,4.14489432136491,40.0,0.0
7854,0,7854,[238 275 258 172 294],23,4,32558,4.144875875238702,0.0,20.0
7855,0,7855,[265 197 423 132  50],716,5,32563,4.144984725050916,0.0,20.0
7856,0,7856,[318  64  98  79 588],796,5,32568,4.145093547155403,40.0,0.0
7857,0,7857,[216 151  96 161 546],457,4,32572,4.1450750827182485,0.0,0.0
7858,0,7858,[318  64  98  79 588],450,5,32577,4.1451838656317594,40.0,0.0
7859,0,7859,[269 603 742 273 234],796,1,32578,4.144783715012722,20.0,0.0
7860,0,7860,[318  64  98  79 588],450,5,32583,4.144892507314591,40.0,0.0
7861,0,7861,[328 228 748  97 111],450,5,32588,4.145001271940982,0.0,0.0
7862,0,7862,[200  79 496 176  71],796,5,32593,4.145110008902455,20.0,0.0
7863,0,7863,[318  64  98  79 588],457,5,32598,4.145218718209563,40.0,0.0
7864,0,7864,[318  64  98  79 588],796,5,32603,4.145327399872855,40.0,0.0
7865,0,7865,[194  70 357 172 111],457,4,32607,4.145308924485126,0.0,0.0
7866,0,7866,[222 301 191  12 427],655,2,32609,4.1450362272785055,20.0,0.0
7867,0,7867,[258 174 215 135  22],655,1,32610,4.144636502287748,0.0,0.0
7868,0,7868,[318  64  98  79 588],457,5,32615,4.144745202694116,40.0,0.0
7869,0,7869,[318 427   9 403  89],655,3,32618,4.144599745870394,40.0,0.0
7870,0,7870,[196  79 118  28 111],796,4,32622,4.1445813746664975,0.0,0.0
7871,0,7871,[  1 405 117 483 588],716,5,32627,4.144690040650406,0.0,0.0
7872,0,7872,[318  64  98  79 588],18,5,32632,4.144798679029595,40.0,0.0
7873,0,7873,[318  64  98  79 588],716,5,32637,4.144907289814579,40.0,0.0
7874,0,7874,[318  64  98  79 588],796,5,32642,4.145015873015873,40.0,0.0
7875,0,7875,[ 82 546 286 111 210],786,5,32647,4.145124428643982,0.0,20.0
7876,0,7876,[195 483 185 313 245],796,4,32651,4.1451060048241715,0.0,0.0
7877,0,7877,[318  64  98  79 588],716,5,32656,4.145214521452146,40.0,0.0
7878,0,7878,[237 275 301 151  71],450,4,32660,4.145196090874476,0.0,20.0
7879,0,7879,[483 127 179 202 435],655,3,32663,4.14505076142132,0.0,20.0
7880,0,7880,[318  64  98  79 588],457,5,32668,4.145159243750793,40.0,0.0
7881,0,7881,[318  64  98  79 588],18,5,32673,4.145267698553667,40.0,0.0
7882,0,7882,[  9 288 210 471  11],174,4,32677,4.145249270582266,0.0,0.0
7883,0,7883,[318  64  98  79 588],577,5,32682,4.145357686453577,40.0,0.0
7884,0,7884,[318  64  98  79 588],577,5,32687,4.1454660748256185,40.0,0.0
7885,0,7885,[318  64  98  79 588],577,5,32692,4.145574435708851,40.0,0.0
7886,0,7886,[318  64  98  79 588],716,5,32697,4.145682769113732,40.0,0.0
7887,0,7887,[318  64  98  79 588],18,5,32702,4.14579107505071,40.0,0.0
7888,0,7888,[318  64  98  79 588],18,5,32707,4.145899353530232,40.0,0.0
7889,0,7889,[238 202 195 210 194],457,5,32712,4.146007604562738,0.0,0.0
7890,0,7890,[546 483 181 180 568],716,3,32715,4.145862374857432,0.0,0.0
7891,0,7891,[318  64  98  79 588],716,5,32720,4.145970603142422,40.0,0.0
7892,0,7892,[318  64  98  79 588],716,5,32725,4.1460788040035474,40.0,0.0
7893,0,7893,[121 183 143 357 273],655,4,32729,4.1460602989612365,0.0,0.0
7894,0,7894,[318  64  98  79 588],577,5,32734,4.146168461051298,40.0,0.0
7895,0,7895,[318  64  98  79 588],716,5,32739,4.1462765957446805,40.0,0.0
7896,0,7896,[318  64  98  79 588],577,5,32744,4.146384703051792,40.0,0.0
7897,0,7897,[222 117 385 118 403],280,2,32746,4.146112939984806,0.0,0.0
7898,0,7898,[318  64  98  79 588],450,5,32751,4.146221040638055,40.0,0.0
7899,0,7899,[282  64 403 183 196],655,2,32753,4.145949367088607,20.0,0.0
7900,0,7900,[282 180 111 275 742],796,3,32756,4.145804328566005,0.0,20.0
7901,0,7901,[318  64  98  79 588],457,5,32761,4.145912427233612,40.0,0.0
7902,0,7902,[318  64  98  79 588],716,5,32766,4.146020498544856,40.0,0.0
7903,0,7903,[ 69 288 182 179 173],457,5,32771,4.146128542510121,0.0,0.0
7904,0,7904,[302 185  82 186 135],269,2,32773,4.145857052498418,0.0,0.0
7905,0,7905,[318  64  98  79 588],457,5,32778,4.145965089805212,40.0,0.0
7906,0,7906,[318  64  98  79 588],457,5,32783,4.146073099785001,40.0,0.0
7907,0,7907,[275 546 175 748 121],151,3,32786,4.145928174001011,0.0,20.0
7908,0,7908,[318  64  98  79 588],450,5,32791,4.1460361613351875,40.0,0.0
7909,0,7909,[ 12 603 318 174 194],503,3,32794,4.145891276864728,40.0,0.0
7910,0,7910,[318  64  98  79 588],450,5,32799,4.145999241562381,40.0,0.0
7911,0,7911,[318  64  98  79 588],450,5,32804,4.146107178968655,40.0,0.0
7912,0,7912,[ 64 182   4 273 111],629,3,32807,4.14596234045242,20.0,0.0
7913,0,7913,[318  64  98  79 588],18,5,32812,4.146070255243871,40.0,0.0
7914,0,7914,[286 215 385 211 196],151,3,32815,4.145925457991156,0.0,20.0
7915,0,7915,[318  64  98  79 588],577,5,32820,4.146033350176857,40.0,0.0
7916,0,7916,[234 200  98 546 168],151,3,32823,4.1458885941644565,0.0,0.0
7917,0,7917,[195 144 222 191 210],450,3,32826,4.145743874715837,0.0,0.0
7918,0,7918,[100 121 302 313 111],450,4,32830,4.145725470387675,0.0,20.0
7919,0,7919,[194 180  98 121 435],296,5,32835,4.145833333333333,0.0,0.0
7920,0,7920,[318  64  98  79 588],796,5,32840,4.145941169044312,40.0,0.0
7921,0,7921,[318  64  98  79 588],716,5,32845,4.146048977530927,40.0,0.0
7922,0,7922,[318 135  95 204 234],716,4,32849,4.146030543985864,20.0,0.0
7923,0,7923,[318  64  98  79 588],450,5,32854,4.146138313982837,40.0,0.0
7924,0,7924,[318  64  98  79 588],457,5,32859,4.146246056782334,40.0,0.0
7925,0,7925,[318  64  98  79 588],796,5,32864,4.146353772394651,40.0,0.0
7926,0,7926,[318  64  98  79 588],716,5,32869,4.146461460830074,40.0,0.0
7927,0,7927,[318  64  98  79 588],796,5,32874,4.14656912209889,40.0,0.0
7928,0,7928,[144 257 121 173   8],457,4,32878,4.14655063690251,0.0,0.0
7929,0,7929,[269 182  89 313 234],655,3,32881,4.14640605296343,0.0,0.0
7930,0,7930,[318  64  98  79 588],716,5,32886,4.146513680494263,40.0,0.0
7931,0,7931,[655 111 215 183 174],457,4,32890,4.1464952092788705,0.0,0.0
7932,0,7932,[603 182 175 423  56],18,4,32894,4.146476742720282,20.0,0.0
7933,0,7933,[ 88 168   1 172  79],450,5,32899,4.146584320645324,0.0,0.0
7934,0,7934,[185  69   4 234 161],389,4,32903,4.146565847511027,0.0,0.0
7935,0,7935,[603 172 161  97 385],655,2,32905,4.146295362903226,20.0,0.0
7936,0,7936,[302 161 603 301 132],389,4,32909,4.146276930830289,20.0,0.0
7937,0,7937,[235 216  64  28  12],457,4,32913,4.14625850340136,20.0,0.0
7938,0,7938,[318  64  98  79 588],18,5,32918,4.146366041063106,40.0,0.0
7939,0,7939,[318  64  98  79 588],716,5,32923,4.146473551637279,40.0,0.0
7940,0,7940,[318  64  98  79 588],796,5,32928,4.146581035134114,40.0,0.0
7941,0,7941,[318  64  98  79 588],450,5,32933,4.146688491563838,40.0,0.0
7942,0,7942,[318  64  98  79 588],716,5,32938,4.146795920936674,40.0,0.0
7943,0,7943,[318  64  98  79 588],577,5,32943,4.14690332326284,40.0,0.0
7944,0,7944,[127  88 135 237 185],450,4,32947,4.146884833228445,0.0,20.0
7945,0,7945,[258 222 216 235 588],344,3,32950,4.146740498363957,0.0,0.0
7946,0,7946,[318  64  98  79 588],577,5,32955,4.146847867119668,40.0,0.0
7947,0,7947,[ 28 151 202 197 174],457,5,32960,4.146955208857574,0.0,0.0
7948,0,7948,[289 204 237 603 333],655,1,32961,4.146559315637187,20.0,0.0
7949,0,7949,[318  64  98  79 588],716,5,32966,4.1466666666666665,40.0,0.0
7950,0,7950,[174  89  64 187 435],72,4,32970,4.1466482203496415,20.0,0.0
7951,0,7951,[471 403 568  95  79],577,3,32973,4.146504024144869,0.0,0.0
7952,0,7952,[195 168 282   1 423],796,4,32977,4.146485602917138,0.0,0.0
7953,0,7953,[496 204   4  88  98],716,4,32981,4.146467186321348,20.0,0.0
7954,0,7954,[318  64  98  79 588],457,5,32986,4.146574481458202,40.0,0.0
7955,0,7955,[234 546 405 357 403],450,4,32990,4.146556058320765,0.0,0.0
7956,0,7956,[318  64  98  79 588],457,5,32995,4.146663315319844,40.0,0.0
7957,0,7957,[  9 216 288  64  82],256,5,33000,4.1467705453631565,20.0,0.0
7958,0,7958,[172 288 175 265  22],457,5,33005,4.146877748460862,0.0,0.0
7959,0,7959,[742  98  56 405  88],280,3,33008,4.146733668341708,0.0,0.0
7960,0,7960,[ 79 603 176 568 194],716,4,33012,4.146715236779299,20.0,0.0
7961,0,7961,[318  64  98  79 588],716,5,33017,4.1468224064305454,40.0,0.0
7962,0,7962,[318  64  98  79 588],18,5,33022,4.146929549164888,40.0,0.0
7963,0,7963,[318  64  98  79 588],457,5,33027,4.147036664992466,40.0,0.0
7964,0,7964,[318  64  98  79 588],577,5,33032,4.147143753923415,40.0,0.0
7965,0,7965,[318  64  98  79 588],457,5,33037,4.147250815967864,40.0,0.0
7966,0,7966,[318  64  98  79 588],457,5,33042,4.1473578511359355,40.0,0.0
7967,0,7967,[318  64  98  79 588],18,5,33047,4.147464859437751,40.0,0.0
7968,0,7968,[318  64  98  79 588],457,5,33052,4.1475718408834235,40.0,0.0
7969,0,7969,[182 202  64 568   9],796,4,33056,4.147553324968633,20.0,0.0
7970,0,7970,[318  64  98  79 588],796,5,33061,4.147660268473215,40.0,0.0
7971,0,7971,[318  98 257 117 302],655,3,33064,4.147516307074762,20.0,0.0
7972,0,7972,[273 196   1 568 186],655,1,33065,4.1471215351812365,0.0,0.0
7973,0,7973,[144 183 196 222 132],716,3,33068,4.146977677451718,0.0,0.0
7974,0,7974,[588  70  11  28 200],330,5,33073,4.147084639498432,0.0,0.0
7975,0,7975,[318  64  98  79 588],457,5,33078,4.1471915747241725,40.0,0.0
7976,0,7976,[318  64  98  79 588],457,5,33083,4.147298483139025,40.0,0.0
7977,0,7977,[318  64  98  79 588],18,5,33088,4.147405364753071,40.0,0.0
7978,0,7978,[318  64  98  79 588],18,5,33093,4.147512219576388,40.0,0.0
7979,0,7979,[318  64  98  79 588],796,5,33098,4.147619047619048,40.0,0.0
7980,0,7980,[ 28 228  11 318 204],655,1,33099,4.14722465856409,20.0,0.0
7981,0,7981,[318  64  98  79 588],457,5,33104,4.147331495865698,40.0,0.0
7982,0,7982,[172 568 181  56 121],655,1,33105,4.146937241638482,0.0,0.0
7983,0,7983,[183  25 405 194 234],835,4,33109,4.146918837675351,0.0,0.0
7984,0,7984,[322 183 234 265 655],450,4,33113,4.146900438321853,0.0,0.0
7985,0,7985,[ 95  79 117  88   4],344,3,33116,4.146756824442775,0.0,0.0
7986,0,7986,[111 588 546 195 179],786,5,33121,4.146863653436835,0.0,0.0
7987,0,7987,[423  11 195 655  71],280,3,33124,4.14672008012018,0.0,0.0
7988,0,7988,[318  64  98  79 588],796,5,33129,4.146826886969583,40.0,0.0
7989,0,7989,[318  64  98  79 588],577,5,33134,4.146933667083855,40.0,0.0
7990,0,7990,[200 176 174  88 328],236,1,33135,4.146539857339507,0.0,0.0
7991,0,7991,[175 143 183 151 168],269,3,33138,4.146396396396397,0.0,0.0
7992,0,7992,[210 118 125  12  64],151,4,33142,4.1463780808207185,20.0,0.0
7993,0,7993,[318  64  98  79 588],796,5,33147,4.146484863647736,40.0,0.0
7994,0,7994,[111 191  88 385 204],457,4,33151,4.1464665415884925,0.0,0.0
7995,0,7995,[318  64  98  79 588],796,5,33156,4.146573286643322,40.0,0.0
7996,0,7996,[174 151 257 483   1],716,5,33161,4.146680005001875,0.0,0.0
7997,0,7997,[153 748 742  69 111],280,4,33165,4.146661665416354,0.0,0.0
7998,0,7998,[318  64  98  79 588],716,5,33170,4.146768346043255,40.0,0.0
7999,0,7999,[318  64  98  79 588],716,5,33175,4.146875,40.0,0.0
8000,0,8000,[318  64  98  79 588],716,5,33180,4.146981627296588,40.0,0.0
8001,0,8001,[318  64  98  79 588],796,5,33185,4.147088227943014,40.0,0.0
8002,0,8002,[603 135  89 181 427],450,4,33189,4.147069848806697,40.0,0.0
8003,0,8003,[ 15 179 210 151 181],18,3,33192,4.146926536731634,0.0,0.0
8004,0,8004,[111  88   4 427 153],796,5,33197,4.1470331043098065,20.0,0.0
8005,0,8005,[ 64 202 176 186 174],655,1,33198,4.1466400199850115,20.0,0.0
8006,0,8006,[318  64  98  79 588],450,5,33203,4.146746596727863,40.0,0.0
8007,0,8007,[318  64  98  79 588],796,5,33208,4.146853146853147,40.0,0.0
8008,0,8008,[318  64  98  79 588],18,5,33213,4.1469596703708325,40.0,0.0
8009,0,8009,[318  64  98  79 588],18,5,33218,4.147066167290887,40.0,0.0
8010,0,8010,[265 318  95 200 588],786,5,33223,4.147172637623268,20.0,0.0
8011,0,8011,[318  64  98  79 588],450,5,33228,4.147279081377933,40.0,0.0
8012,0,8012,[318  64  98  79 588],716,5,33233,4.147385498564832,40.0,0.0
8013,0,8013,[318  64  98  79 588],716,5,33238,4.147491889193911,40.0,0.0
8014,0,8014,[483  88  64 200  79],18,3,33241,4.147348721147848,20.0,0.0
8015,0,8015,[265 228 385   1 186],655,0,33241,4.14683133732535,0.0,0.0
8016,0,8016,[144 172 427 423 483],693,2,33243,4.146563552451042,20.0,0.0
8017,0,8017,[318  64  98  79 588],577,5,33248,4.146669992516837,40.0,0.0
8018,0,8018,[318  64  98  79 588],577,5,33253,4.1467764060356656,40.0,0.0
8019,0,8019,[318  64  98  79 588],716,5,33258,4.146882793017457,40.0,0.0
8020,0,8020,[318  64  98  79 588],457,5,33263,4.146989153472136,40.0,0.0
8021,0,8021,[186 294 121 196 655],504,3,33266,4.1468461730241835,0.0,0.0
8022,0,8022,[318  64  98  79 588],796,5,33271,4.146952511529353,40.0,0.0
8023,0,8023,[ 64 176 313 258 286],450,5,33276,4.147058823529412,20.0,20.0
8024,0,8024,[286 597 423 546  98],450,5,33281,4.147165109034268,0.0,20.0
8025,0,8025,[318  64  98  79 588],450,5,33286,4.147271368053825,40.0,0.0
8026,0,8026,[143 173   4  98 235],450,3,33289,4.147128441509904,0.0,0.0
8027,0,8027,[117 423 546 195 174],796,5,33294,4.147234678624813,0.0,0.0
8028,0,8028,[318  64  98  79 588],450,5,33299,4.147340889276373,40.0,0.0
8029,0,8029,[172 143 125 185 118],796,5,33304,4.147447073474471,0.0,0.0
8030,0,8030,[ 64 191  69 200 182],269,4,33308,4.147428713734279,20.0,0.0
8031,0,8031,[135   1 196 655 403],450,4,33312,4.147410358565737,0.0,0.0
8032,0,8032,[216  15 234 496 180],796,3,33315,4.14726752147392,20.0,0.0
8033,0,8033,[318  64  98  79 588],716,5,33320,4.1473736619367685,40.0,0.0
8034,0,8034,[ 22 200 143 215 210],457,5,33325,4.147479775980087,0.0,0.0
8035,0,8035,[ 69 202 161 181   8],280,3,33328,4.147336983573918,0.0,0.0
8036,0,8036,[273 161 176 183   1],796,3,33331,4.147194226701505,0.0,0.0
8037,0,8037,[265 423 276 191 300],655,2,33333,4.14692709629261,0.0,0.0
8038,0,8038,[318  64  98  79 588],796,5,33338,4.147033213086205,40.0,0.0
8039,0,8039,[597  88 302 268  89],344,2,33340,4.146766169154229,0.0,0.0
8040,0,8040,[318 204 117 271 475],655,1,33341,4.146374829001368,20.0,0.0
8041,0,8041,[318  64  98  79 588],457,5,33346,4.14648097488187,40.0,0.0
8042,0,8042,[318  64  98  79 588],796,5,33351,4.146587094367773,40.0,0.0
8043,0,8043,[143 144 427 118 403],655,2,33353,4.14632023868722,20.0,0.0
8044,0,8044,[127 742 403  22 568],796,4,33357,4.146302050963331,0.0,20.0
8045,0,8045,[318  64  98  79 588],457,5,33362,4.1464081531195625,40.0,0.0
8046,0,8046,[289  28 435 176  64],655,1,33363,4.146017149248167,20.0,0.0
8047,0,8047,[318  64  98  79 588],796,5,33368,4.146123260437376,40.0,0.0
8048,0,8048,[313 328  15 234 135],450,2,33370,4.145856628152566,0.0,0.0
8049,0,8049,[318  64  98  79 588],796,5,33375,4.145962732919255,40.0,0.0
8050,0,8050,[238 161 237 301 423],450,5,33380,4.146068811327785,0.0,0.0
8051,0,8051,[318  64  98  79 588],716,5,33385,4.146174863387978,40.0,0.0
8052,0,8052,[144 202 328 403 276],655,1,33386,4.145784179808767,0.0,0.0
8053,0,8053,[ 56 257  79 173 176],716,4,33390,4.145766078966973,0.0,0.0
8054,0,8054,[127 357 238 185 508],269,5,33395,4.145872129112353,0.0,20.0
8055,0,8055,[132 268   8 496 302],269,3,33398,4.145729890764647,20.0,0.0
8056,0,8056,[175 197  98 153 475],269,4,33402,4.145711803400769,0.0,0.0
8057,0,8057,[546 237 151 211 273],796,3,33405,4.1455696202531644,0.0,0.0
8058,0,8058,[318 185  25 265  82],450,3,33408,4.145427472391115,20.0,0.0
8059,0,8059,[318  64  98  79 588],18,5,33413,4.145533498759305,40.0,0.0
8060,0,8060,[ 11 117  89  96   7],344,3,33416,4.145391390646322,0.0,0.0
8061,0,8061,[ 89  98 271 200 186],796,4,33420,4.145373356487224,0.0,0.0
8062,0,8062,[318  64  98  79 588],796,5,33425,4.145479350117822,40.0,0.0
8063,0,8063,[318  64  98  79 588],18,5,33430,4.145585317460317,40.0,0.0
8064,0,8064,[ 89 238 200 385 194],450,4,33434,4.145567265964043,0.0,0.0
8065,0,8065,[200 508   7 405  64],269,3,33437,4.145425241755517,20.0,0.0
8066,0,8066,[318  64  98  79 588],450,5,33442,4.14553117639767,40.0,0.0
8067,0,8067,[237 678 294 282 195],280,0,33442,4.145017352503719,0.0,0.0
8068,0,8068,[186  97 216 588  82],716,4,33446,4.144999380344529,0.0,0.0
8069,0,8069,[318  64  98  79 588],796,5,33451,4.145105328376704,40.0,0.0
8070,0,8070,[318  64  98  79 588],796,5,33456,4.145211250154875,40.0,0.0
8071,0,8071,[588 568   4 118  11],344,3,33459,4.145069375619425,0.0,0.0
8072,0,8072,[135 405 182 100   1],655,2,33461,4.144803666542797,0.0,20.0
8073,0,8073,[655  95 172 215 235],716,4,33465,4.1447857319791925,0.0,0.0
8074,0,8074,[172 742 168  88  69],796,4,33469,4.1447678018575855,0.0,0.0
8075,0,8075,[111 238 301 183  95],450,4,33473,4.144749876176325,0.0,0.0
8076,0,8076,[318  64  98  79 588],716,5,33478,4.144855763278445,40.0,0.0
8077,0,8077,[318  64  98  79 588],457,5,33483,4.144961624164397,40.0,0.0
8078,0,8078,[318  64  98  79 588],18,5,33488,4.145067458843917,40.0,0.0
8079,0,8079,[655  22 222 125 215],224,4,33492,4.145049504950495,0.0,0.0
8080,0,8080,[318  64  98  79 588],796,5,33497,4.145155302561564,40.0,0.0
8081,0,8081,[204 483   8 195  56],23,4,33501,4.14513734224202,0.0,0.0
8082,0,8082,[ 96 282 742 200  82],450,3,33504,4.144995669924533,0.0,0.0
8083,0,8083,[228  98 294 174 202],23,3,33507,4.144854032657101,0.0,0.0
8084,0,8084,[318  64  98  79 588],796,5,33512,4.144959802102659,40.0,0.0
8085,0,8085,[318  64  98  79 588],716,5,33517,4.145065545387089,40.0,0.0
8086,0,8086,[268 180 234 196  11],269,1,33518,4.144676641523433,0.0,0.0
8087,0,8087,[318  64  98  79 588],577,5,33523,4.144782393669634,40.0,0.0
8088,0,8088,[318  64  98  79 588],716,5,33528,4.1448881196686855,40.0,0.0
8089,0,8089,[318  64  98  79 588],716,5,33533,4.144993819530284,40.0,0.0
8090,0,8090,[118 121  25  15   8],577,3,33536,4.14485230503028,0.0,0.0
8091,0,8091,[318  64  98  79 588],450,5,33541,4.144957983193278,40.0,0.0
8092,0,8092,[318  64  98  79 588],577,5,33546,4.145063635240331,40.0,0.0
8093,0,8093,[318  64  98  79 588],457,5,33551,4.145169261181122,40.0,0.0
8094,0,8094,[496 216  28 258 405],151,4,33555,4.145151327980234,20.0,0.0
8095,0,8095,[ 71   8 179 172  11],593,4,33559,4.145133399209486,0.0,0.0
8096,0,8096,[318  64  98  79 588],796,5,33564,4.145238977399036,40.0,0.0
8097,0,8097,[ 50  97   4 269 127],18,4,33568,4.14522104223265,0.0,40.0
8098,0,8098,[318  64  98  79 588],18,5,33573,4.14532658352883,40.0,0.0
8099,0,8099,[318  64  98  79 588],457,5,33578,4.145432098765432,40.0,0.0
8100,0,8100,[318  64  98  79 588],457,5,33583,4.145537587952105,40.0,0.0
8101,0,8101,[318  64  98  79 588],457,5,33588,4.145643051098494,40.0,0.0
8102,0,8102,[197  28 191 546 127],450,5,33593,4.145748488214242,0.0,20.0
8103,0,8103,[318  64  98  79 588],18,5,33598,4.1458538993089835,40.0,0.0
8104,0,8104,[176 265 111 121 313],450,4,33602,4.14583590376311,0.0,0.0
8105,0,8105,[318  64  98  79 588],18,5,33607,4.145941278065631,40.0,0.0
8106,0,8106,[  1 322 196   7 183],450,5,33612,4.146046626372271,0.0,0.0
8107,0,8107,[546  98 216   1 597],457,3,33615,4.145905278737049,0.0,0.0
8108,0,8108,[ 25 211 210 245 546],593,1,33616,4.145517326427426,0.0,0.0
8109,0,8109,[603 111  56   1 405],450,5,33621,4.145622688039458,20.0,0.0
8110,0,8110,[222  82 125 100 181],280,0,33621,4.145111576870916,0.0,20.0
8111,0,8111,[318  64  98  79 588],457,5,33626,4.145216962524655,40.0,0.0
8112,0,8112,[318  64  98  79 588],796,5,33631,4.14532232219894,40.0,0.0
8113,0,8113,[200 385 568 175  50],716,3,33634,4.145181168350998,0.0,20.0
8114,0,8114,[318  64  98  79 588],457,5,33639,4.145286506469501,40.0,0.0
8115,0,8115,[127 191 322 597 182],450,5,33644,4.145391818629867,0.0,20.0
8116,0,8116,[286  69 200 237 191],18,2,33646,4.145127510163854,0.0,20.0
8117,0,8117,[318  64  98  79 588],18,5,33651,4.1452328159645235,40.0,0.0
8118,0,8118,[ 82 153 435 742  28],450,4,33655,4.145214927946792,0.0,0.0
8119,0,8119,[318  64  98  79 588],457,5,33660,4.145320197044335,40.0,0.0
8120,0,8120,[318  64  98  79 588],716,5,33665,4.145425440216722,40.0,0.0
8121,0,8121,[318  64  98  79 588],577,5,33670,4.145530657473529,40.0,0.0
8122,0,8122,[ 56 222   7 196 175],151,5,33675,4.145635848824326,0.0,0.0
8123,0,8123,[318  64  98  79 588],457,5,33680,4.145741014278681,40.0,0.0
8124,0,8124,[318  64  98  79 588],457,5,33685,4.145846153846154,40.0,0.0
8125,0,8125,[318  64  98  79 588],796,5,33690,4.1459512675363035,40.0,0.0
8126,0,8126,[180 187 175 603 181],716,2,33692,4.145687215454657,20.0,0.0
8127,0,8127,[182 603  71 655 313],796,4,33696,4.145669291338582,20.0,0.0
8128,0,8128,[  9 118 175 568 135],655,1,33697,4.145282322548899,0.0,0.0
8129,0,8129,[318  64  98  79 588],18,5,33702,4.145387453874538,40.0,0.0
8130,0,8130,[318  64  98  79 588],450,5,33707,4.145492559340794,40.0,0.0
8131,0,8131,[318  64  98  79 588],457,5,33712,4.145597638957206,40.0,0.0
8132,0,8132,[318  64  98  79 588],577,5,33717,4.145702692733309,40.0,0.0
8133,0,8133,[318  64  98  79 588],716,5,33722,4.145807720678633,40.0,0.0
8134,0,8134,[318  64  98  79 588],577,5,33727,4.145912722802704,40.0,0.0
8135,0,8135,[318  64  98  79 588],18,5,33732,4.146017699115045,40.0,0.0
8136,0,8136,[183 483 269 245 265],450,4,33736,4.145999754209168,0.0,0.0
8137,0,8137,[172 117 174 483 405],450,4,33740,4.145981813713443,0.0,0.0
8138,0,8138,[ 56 186 273 328 288],655,1,33741,4.145595281975672,0.0,0.0
8139,0,8139,[568 276 143  96 180],457,5,33746,4.145700245700246,0.0,0.0
8140,0,8140,[300 515 357   4 257],716,4,33750,4.145682348605822,0.0,0.0
8141,0,8141,[ 88 132  50 603 258],655,2,33752,4.145418816015721,20.0,20.0
8142,0,8142,[318  64  98  79 588],577,5,33757,4.145523762741004,40.0,0.0
8143,0,8143,[210 181 202 215 496],796,4,33761,4.145505893909626,20.0,0.0
8144,0,8144,[ 98 176 211 288 173],450,4,33765,4.14548802946593,0.0,0.0
8145,0,8145,[313 183  25 269 210],450,3,33768,4.145347409771667,0.0,0.0
8146,0,8146,[318  64  98  79 588],716,5,33773,4.145452313735118,40.0,0.0
8147,0,8147,[273 546  15 211 742],796,2,33775,4.1451890034364265,0.0,0.0
8148,0,8148,[271 111 238 655 288],655,0,33775,4.144680328874709,0.0,0.0
8149,0,8149,[202 423 186 210  97],504,3,33778,4.1445398773006135,0.0,0.0
8150,0,8150,[211 144 269  15 294],450,4,33782,4.144522144522145,0.0,0.0
8151,0,8151,[318  64  98  79 588],457,5,33787,4.144627085377821,40.0,0.0
8152,0,8152,[ 64  15 176 318 234],655,2,33789,4.144364037777505,40.0,0.0
8153,0,8153,[318  64  98  79 588],450,5,33794,4.1444689722835415,40.0,0.0
8154,0,8154,[172 182 111 176  98],389,4,33798,4.144451256897609,0.0,0.0
8155,0,8155,[222 483 127 318 276],457,5,33803,4.144556154977931,20.0,20.0
8156,0,8156,[318  64  98  79 588],716,5,33808,4.144661027338482,40.0,0.0
8157,0,8157,[318  64  98  79 588],716,5,33813,4.144765873988723,40.0,0.0
8158,0,8158,[318  64  98  79 588],716,5,33818,4.144870694938105,40.0,0.0
8159,0,8159,[318  64  98  79 588],450,5,33823,4.144975490196078,40.0,0.0
8160,0,8160,[318  64  98  79 588],450,5,33828,4.145080259772087,40.0,0.0
8161,0,8161,[276  64 196 427 216],655,4,33832,4.145062484685126,40.0,0.0
8162,0,8162,[125 222 121 237 204],457,5,33837,4.145167217934583,0.0,0.0
8163,0,8163,[318  64  98  79 588],577,5,33842,4.1452719255267025,40.0,0.0
8164,0,8164,[185  69 183 294 282],655,2,33844,4.145009185548071,0.0,0.0
8165,0,8165,[318  64  98  79 588],796,5,33849,4.145113886847906,40.0,0.0
8166,0,8166,[318  64  98  79 588],457,5,33854,4.145218562507653,40.0,0.0
8167,0,8167,[427 655 435  98 172],436,3,33857,4.145078354554358,20.0,0.0
8168,0,8168,[318  64  98  79 588],577,5,33862,4.145183008936223,40.0,0.0
8169,0,8169,[191  96 257 234 588],23,2,33864,4.144920440636475,0.0,0.0
8170,0,8170,[318  64  98  79 588],457,5,33869,4.1450250887284295,40.0,0.0
8171,0,8171,[318  64  98  79 588],18,5,33874,4.145129711209006,40.0,0.0
8172,0,8172,[328 286 161 202 111],655,0,33874,4.144622537623883,0.0,20.0
8173,0,8173,[318  64  98  79 588],457,5,33879,4.144727183753364,40.0,0.0
8174,0,8174,[313   8   1 121 271],807,4,33883,4.144709480122324,0.0,0.0
8175,0,8175,[196 245  98 174 234],629,4,33887,4.144691780821918,0.0,0.0
8176,0,8176,[318  64  98  79 588],577,5,33892,4.144796380090498,40.0,0.0
8177,0,8177,[318  64  98  79 588],457,5,33897,4.14490095377843,40.0,0.0
8178,0,8178,[282 202   7 588 235],457,4,33901,4.144883237559604,0.0,0.0
8179,0,8179,[318  64  98  79 588],457,5,33906,4.144987775061125,40.0,0.0
8180,0,8180,[318  64  98  79 588],450,5,33911,4.145092287006478,40.0,0.0
8181,0,8181,[ 22 282  70  56  71],535,2,33913,4.144830114886336,0.0,0.0
8182,0,8182,[ 50  25 313 143 496],577,4,33917,4.144812415984358,20.0,20.0
8183,0,8183,[275 265 357 202 216],786,5,33922,4.144916911045943,0.0,20.0
8184,0,8184,[121  70 515  11  82],716,5,33927,4.145021380574221,0.0,0.0
8185,0,8185,[202 405 357 302 322],151,2,33929,4.1447593452235525,0.0,0.0
8186,0,8186,[546 318 185 216 161],716,3,33932,4.144619518749237,20.0,0.0
8187,0,8187,[245   7 748 176  95],450,4,33936,4.144601856375183,0.0,0.0
8188,0,8188,[318  64  98  79 588],716,5,33941,4.144706313347173,40.0,0.0
8189,0,8189,[405 197 196  12 385],655,0,33941,4.144200244200245,0.0,0.0
8190,0,8190,[318  64  98  79 588],18,5,33946,4.1443047246978395,40.0,0.0
8191,0,8191,[271 187 318   1   8],796,4,33950,4.144287109375,20.0,0.0
8192,0,8192,[318  64  98  79 588],18,5,33955,4.144391553765409,40.0,0.0
8193,0,8193,[318  64  98  79 588],716,5,33960,4.1444959726629245,40.0,0.0
8194,0,8194,[318  64  98  79 588],577,5,33965,4.144600366076876,40.0,0.0
8195,0,8195,[403 202 195 568 100],280,0,33965,4.144094680331869,0.0,20.0
8196,0,8196,[ 96 294 127   4 508],655,1,33966,4.14371111382213,0.0,20.0
8197,0,8197,[318  64  98  79 588],18,5,33971,4.143815564771896,40.0,0.0
8198,0,8198,[318  64  98  79 588],450,5,33976,4.143919990242712,40.0,0.0
8199,0,8199,[318  64  98  79 588],577,5,33981,4.144024390243902,40.0,0.0
8200,0,8200,[318  64  98  79 588],457,5,33986,4.144128764784782,40.0,0.0
8201,0,8201,[161 228 483 289 204],655,1,33987,4.1437454279444035,0.0,0.0
8202,0,8202,[318  64  98  79 588],18,5,33992,4.14384981104474,40.0,0.0
8203,0,8203,[318  64  98  79 588],457,5,33997,4.143954168698196,40.0,0.0
8204,0,8204,[427 174 300  50 151],389,4,34001,4.14393662400975,20.0,20.0
8205,0,8205,[200 588 313 258 183],796,5,34006,4.144040945649524,0.0,0.0
8206,0,8206,[ 70 483  64 234 211],151,5,34011,4.144145241866699,20.0,0.0
8207,0,8207,[ 97 183  11  69 275],344,2,34013,4.143884015594542,0.0,20.0
8208,0,8208,[  8   1 423  69  70],457,5,34018,4.1439883055183335,0.0,0.0
8209,0,8209,[318  64  98  79 588],577,5,34023,4.144092570036541,40.0,0.0
8210,0,8210,[318  64  98  79 588],796,5,34028,4.144196809158446,40.0,0.0
8211,0,8211,[  9 118 302 194 100],151,2,34030,4.143935703848027,0.0,20.0
8212,0,8212,[318  64  98  79 588],577,5,34035,4.1440399366857426,40.0,0.0
8213,0,8213,[318  64  98  79 588],457,5,34040,4.1441441441441444,40.0,0.0
8214,0,8214,[ 71 215 403 179  50],450,4,34044,4.1441265976871575,0.0,20.0
8215,0,8215,[132 180 286 191 269],450,5,34049,4.144230769230769,0.0,20.0
8216,0,8216,[318  64  98  79 588],577,5,34054,4.144334915419253,40.0,0.0
8217,0,8217,[318  64  98  79 588],577,5,34059,4.144439036261864,40.0,0.0
8218,0,8218,[318  64  98  79 588],18,5,34064,4.144543131767855,40.0,0.0
8219,0,8219,[121 222 423 196 117],796,5,34069,4.144647201946472,0.0,0.0
8220,0,8220,[385 273 301 471 286],344,2,34071,4.144386327697361,0.0,20.0
8221,0,8221,[ 89 195 181 135 172],18,0,34071,4.1438822670882995,0.0,0.0
8222,0,8222,[318  64  98  79 588],716,5,34076,4.143986379666789,40.0,0.0
8223,0,8223,[125 144 172 195 313],655,2,34078,4.143725680933852,0.0,0.0
8224,0,8224,[318  64  98  79 588],716,5,34083,4.143829787234043,40.0,0.0
8225,0,8225,[318  64  98  79 588],457,5,34088,4.1439338682227085,40.0,0.0
8226,0,8226,[197 117 187 153 237],450,5,34093,4.14403792390908,0.0,0.0
8227,0,8227,[423 318 153   9 135],280,5,34098,4.144141954302382,20.0,0.0
8228,0,8228,[300 172 271 245 197],796,3,34101,4.144002916514765,0.0,0.0
8229,0,8229,[318  64  98  79 588],450,5,34106,4.144106925880924,40.0,0.0
8230,0,8230,[257 357   8 423 385],655,1,34107,4.143724942291338,0.0,0.0
8231,0,8231,[286 118 237 546  50],593,4,34111,4.1437074829931975,0.0,40.0
8232,0,8232,[318  64  98  79 588],450,5,34116,4.143811490343738,40.0,0.0
8233,0,8233,[742   9 237   4 423],593,4,34120,4.143794024775322,0.0,0.0
8234,0,8234,[  4 173 153 275 100],389,3,34123,4.143655130540377,0.0,40.0
8235,0,8235,[318  64  98  79 588],450,5,34128,4.143759106362312,40.0,0.0
8236,0,8236,[318  64  98  79 588],18,5,34133,4.143863056938206,40.0,0.0
8237,0,8237,[318  64  98  79 588],577,5,34138,4.143966982277251,40.0,0.0
8238,0,8238,[210 144 357 118 181],457,5,34143,4.14407088238864,0.0,0.0
8239,0,8239,[182 216 286 603 496],18,4,34147,4.144053398058253,40.0,20.0
8240,0,8240,[269 175 405   8 238],655,0,34147,4.1435505399830115,0.0,0.0
8241,0,8241,[318  64  98  79 588],716,5,34152,4.143654452802718,40.0,0.0
8242,0,8242,[318  64  98  79 588],457,5,34157,4.143758340410045,40.0,0.0
8243,0,8243,[174 268  98  82 302],269,2,34159,4.143498301795245,0.0,0.0
8244,0,8244,[118 183 257 144 176],655,1,34160,4.143117040630686,0.0,0.0
8245,0,8245,[435   7 288 515 135],655,2,34162,4.142857142857143,0.0,0.0
8246,0,8246,[318  64  98  79 588],577,5,34167,4.142961076755184,40.0,0.0
8247,0,8247,[323 286 282   8 204],796,3,34170,4.14282250242483,0.0,20.0
8248,0,8248,[318  64  98  79 588],18,5,34175,4.142926415323069,40.0,0.0
8249,0,8249,[318  64  98  79 588],796,5,34180,4.143030303030303,40.0,0.0
8250,0,8250,[125  64  12 185 405],655,2,34182,4.142770573263847,20.0,0.0
8251,0,8251,[318  64  98  79 588],716,5,34187,4.142874454677654,40.0,0.0
8252,0,8252,[  9  15 423 568 385],796,4,34191,4.142857142857143,0.0,0.0
8253,0,8253,[318  64  98  79 588],716,5,34196,4.142960988611582,40.0,0.0
8254,0,8254,[318  64  98  79 588],577,5,34201,4.143064809206542,40.0,0.0
8255,0,8255,[318  64  98  79 588],577,5,34206,4.143168604651163,40.0,0.0
8256,0,8256,[318  64  98  79 588],450,5,34211,4.143272374954584,40.0,0.0
8257,0,8257,[318  64  98  79 588],796,5,34216,4.1433761201259385,40.0,0.0
8258,0,8258,[403 294 318 196 603],655,2,34218,4.143116600072648,40.0,0.0
8259,0,8259,[427 238 215 318 186],151,4,34222,4.143099273607748,40.0,0.0
8260,0,8260,[179   1  98 427 435],450,5,34227,4.143203002057862,20.0,0.0
8261,0,8261,[318  64  98  79 588],577,5,34232,4.143306705398208,40.0,0.0
8262,0,8262,[546 121  71 471 143],577,2,34234,4.14304731937553,0.0,0.0
8263,0,8263,[318  64  98  79 588],796,5,34239,4.143151016456922,40.0,0.0
8264,0,8264,[318  25 405 100 238],151,3,34242,4.143012704174229,20.0,20.0
8265,0,8265,[483  70  12 300   9],655,1,34243,4.142632470360513,0.0,0.0
8266,0,8266,[318  64  98  79 588],18,5,34248,4.142736179992742,40.0,0.0
8267,0,8267,[318  64  98  79 588],796,5,34253,4.142839864537978,40.0,0.0
8268,0,8268,[318  64  98  79 588],716,5,34258,4.142943524005321,40.0,0.0
8269,0,8269,[258 132  22 216  97],457,5,34263,4.14304715840387,0.0,0.0
8270,0,8270,[318  64  98  79 588],457,5,34268,4.143150767742715,40.0,0.0
8271,0,8271,[318  64  98  79 588],457,5,34273,4.143254352030948,40.0,0.0
8272,0,8272,[318  64  98  79 588],716,5,34278,4.143357911277651,40.0,0.0
8273,0,8273,[318  64  98  79 588],577,5,34283,4.143461445491902,40.0,0.0
8274,0,8274,[318  64  98  79 588],450,5,34288,4.1435649546827795,40.0,0.0
8275,0,8275,[318  64  98  79 588],796,5,34293,4.143668438859352,40.0,0.0
8276,0,8276,[238 288 385  64 111],450,4,34297,4.143651081309653,20.0,0.0
8277,0,8277,[ 22   8 282 195 200],457,5,34302,4.14375453007973,0.0,0.0
8278,0,8278,[318  64  98  79 588],18,5,34307,4.143857953859162,40.0,0.0
8279,0,8279,[318  64  98  79 588],716,5,34312,4.143961352657005,40.0,0.0
8280,0,8280,[508  79 176 111 268],11,4,34316,4.1439439681197925,0.0,0.0
8281,0,8281,[161 282 204 222 191],450,4,34320,4.143926587780729,0.0,0.0
8282,0,8282,[318  64  98  79 588],577,5,34325,4.14402994084269,40.0,0.0
8283,0,8283,[318  64  98  79 588],18,5,34330,4.144133268952197,40.0,0.0
8284,0,8284,[318  64  98  79 588],577,5,34335,4.144236572118286,40.0,0.0
8285,0,8285,[174 210 742  79  22],450,4,34339,4.144219164856384,0.0,0.0
8286,0,8286,[121 174 180 210  50],72,3,34342,4.14408109086521,0.0,20.0
8287,0,8287,[318  64  98  79 588],716,5,34347,4.144184362934363,40.0,0.0
8288,0,8288,[588 135 210 211 172],716,4,34351,4.144166968271203,0.0,0.0
8289,0,8289,[118  22  56 742  88],796,4,34355,4.144149577804584,0.0,0.0
8290,0,8290,[179 200 403 322 294],504,2,34357,4.143890966107827,0.0,0.0
8291,0,8291,[318  64  98  79 588],577,5,34362,4.143994211287988,40.0,0.0
8292,0,8292,[318  64  98  79 588],716,5,34367,4.144097431568793,40.0,0.0
8293,0,8293,[ 79 125 427 191 588],450,5,34372,4.144200626959248,20.0,0.0
8294,0,8294,[302 186 235 211 173],450,3,34375,4.1440626883664855,0.0,0.0
8295,0,8295,[318  64  98  79 588],577,5,34380,4.144165863066538,40.0,0.0
8296,0,8296,[318  64  98  79 588],716,5,34385,4.144269012896228,40.0,0.0
8297,0,8297,[269 294  97 328 187],450,5,34390,4.144372137864545,0.0,0.0
8298,0,8298,[211 234 197 300  50],151,5,34395,4.14447523798048,0.0,20.0
8299,0,8299,[ 25 273 234 204  56],450,2,34397,4.144216867469879,0.0,0.0
8300,0,8300,[357 191 187 423 301],450,5,34402,4.144319961450428,0.0,0.0
8301,0,8301,[318  64  98  79 588],577,5,34407,4.144423030595037,40.0,0.0
8302,0,8302,[168  79 127  95 318],18,4,34411,4.144405636516922,20.0,20.0
8303,0,8303,[144 471 238  50 135],450,4,34415,4.144388246628131,0.0,20.0
8304,0,8304,[168 423 180 288 174],504,5,34420,4.144491270319085,0.0,0.0
8305,0,8305,[318  64  98  79 588],796,5,34425,4.144594269202986,40.0,0.0
8306,0,8306,[318  64  98  79 588],577,5,34430,4.1446972432887925,40.0,0.0
8307,0,8307,[318  64  98  79 588],450,5,34435,4.14480019258546,40.0,0.0
8308,0,8308,[289 238  79 153 181],296,4,34439,4.144782765675774,0.0,0.0
8309,0,8309,[405 176 216  89 435],151,3,34442,4.144645006016847,0.0,0.0
8310,0,8310,[276  15 172 187 200],18,3,34445,4.144507279509084,0.0,0.0
8311,0,8311,[238 423 118  95 186],716,3,34448,4.144369586140519,0.0,0.0
8312,0,8312,[318  64  98  79 588],796,5,34453,4.144472512931553,40.0,0.0
8313,0,8313,[318  64  98  79 588],457,5,34458,4.144575414962714,40.0,0.0
8314,0,8314,[318  64  98  79 588],450,5,34463,4.144678292242935,40.0,0.0
8315,0,8315,[568 182 144 471  82],655,1,34464,4.144300144300145,0.0,0.0
8316,0,8316,[496 172  88 234  79],389,4,34468,4.144282794276783,20.0,0.0
8317,0,8317,[318  64  98  79 588],577,5,34473,4.144385669632123,40.0,0.0
8318,0,8318,[318  64  98  79 588],18,5,34478,4.144488520254838,40.0,0.0
8319,0,8319,[318  64  98  79 588],716,5,34483,4.144591346153846,40.0,0.0
8320,0,8320,[318  64  98  79 588],450,5,34488,4.14469414733806,40.0,0.0
8321,0,8321,[318  64  98  79 588],577,5,34493,4.14479692381639,40.0,0.0
8322,0,8322,[318  64  98  79 588],457,5,34498,4.144899675597741,40.0,0.0
8323,0,8323,[318  64  98  79 588],716,5,34503,4.145002402691014,40.0,0.0
8324,0,8324,[194 197 748 174 275],796,4,34507,4.144984984984985,0.0,20.0
8325,0,8325,[318  64  98  79 588],577,5,34512,4.145087677155897,40.0,0.0
8326,0,8326,[318  64  98  79 588],457,5,34517,4.145190344661943,40.0,0.0
8327,0,8327,[ 97 180  70 471 268],535,4,34521,4.145172910662824,0.0,0.0
8328,0,8328,[318  64  98  79 588],450,5,34526,4.145275543282507,40.0,0.0
8329,0,8329,[318  64  98  79 588],796,5,34531,4.145378151260505,40.0,0.0
8330,0,8330,[302  50 191 135 282],401,1,34532,4.145000600168047,0.0,20.0
8331,0,8331,[318  64  98  79 588],796,5,34537,4.145103216514642,40.0,0.0
8332,0,8332,[234   1  89 173 222],151,5,34542,4.145205808232329,0.0,0.0
8333,0,8333,[678 258  96 204 294],504,3,34545,4.145068394528438,0.0,0.0
8334,0,8334,[318  64  98  79 588],716,5,34550,4.145170965806838,40.0,0.0
8335,0,8335,[ 96 245 125 655 182],280,1,34551,4.144793666026872,0.0,0.0
8336,0,8336,[405 385   8 117 143],807,5,34556,4.144896245651913,0.0,0.0
8337,0,8337,[318  64  98  79 588],450,5,34561,4.144998800671624,40.0,0.0
8338,0,8338,[288 181 161 111 185],450,4,34565,4.144981412639405,0.0,0.0
8339,0,8339,[318  64  98  79 588],18,5,34570,4.1450839328537175,40.0,0.0
8340,0,8340,[318  64  98  79 588],577,5,34575,4.145186428485793,40.0,0.0
8341,0,8341,[318  64  98  79 588],450,5,34580,4.145288899544473,40.0,0.0
8342,0,8342,[318  64  98  79 588],796,5,34585,4.145391346038595,40.0,0.0
8343,0,8343,[471 603 655 385 135],401,2,34587,4.14513422818792,20.0,0.0
8344,0,8344,[204 435 282  97 194],236,3,34590,4.144997004194129,0.0,0.0
8345,0,8345,[200  95  98 238 258],450,3,34593,4.144859813084112,0.0,0.0
8346,0,8346,[318  64  98  79 588],577,5,34598,4.1449622618905,40.0,0.0
8347,0,8347,[111  28 496 405 427],151,4,34602,4.144944896981313,40.0,0.0
8348,0,8348,[181 238 748 172 117],450,5,34607,4.145047311055216,0.0,0.0
8349,0,8349,[216  89 191 405 127],786,5,34612,4.145149700598802,0.0,20.0
8350,0,8350,[238 357 234  88 215],450,4,34616,4.145132319482697,0.0,0.0
8351,0,8351,[100 215 318 200 385],280,3,34619,4.144995210727969,20.0,20.0
8352,0,8352,[153 294  89 276 508],296,4,34623,4.144977852268646,0.0,0.0
8353,0,8353,[318  64  98  79 588],18,5,34628,4.145080201101269,40.0,0.0
8354,0,8354,[318  64  98  79 588],716,5,34633,4.145182525433872,40.0,0.0
8355,0,8355,[161 568 118 187 100],72,4,34637,4.145165150789851,0.0,20.0
8356,0,8356,[245 276 258  96 216],504,4,34641,4.145147780303937,0.0,0.0
8357,0,8357,[318  64  98  79 588],716,5,34646,4.145250059822924,40.0,0.0
8358,0,8358,[175 333 301 276 186],655,1,34647,4.14487378873071,0.0,0.0
8359,0,8359,[597 222 202  88  95],344,3,34650,4.144736842105263,0.0,0.0
8360,0,8360,[385  22 333 405 302],655,1,34651,4.144360722401626,0.0,0.0
8361,0,8361,[ 98 176 483   7 268],655,2,34653,4.144104281272423,0.0,0.0
8362,0,8362,[210  88 403  22 197],450,4,34657,4.144087050101638,0.0,0.0
8363,0,8363,[318  64  98  79 588],18,5,34662,4.144189383070302,40.0,0.0
8364,0,8364,[125 655 276 265 471],457,5,34667,4.144291691572026,0.0,0.0
8365,0,8365,[211   4 748 183 202],796,4,34671,4.144274444178819,0.0,0.0
8366,0,8366,[318  64  98  79 588],716,5,34676,4.144376718059042,40.0,0.0
8367,0,8367,[ 11 100 228 144 235],457,4,34680,4.144359464627151,0.0,20.0
8368,0,8368,[318  64  98  79 588],577,5,34685,4.144461703907277,40.0,0.0
8369,0,8369,[318  64  98  79 588],577,5,34690,4.144563918757467,40.0,0.0
8370,0,8370,[318  64  98  79 588],796,5,34695,4.144666109186477,40.0,0.0
8371,0,8371,[318  64  98  79 588],716,5,34700,4.144768275203058,40.0,0.0
8372,0,8372,[318  64  98  79 588],450,5,34705,4.144870416815956,40.0,0.0
8373,0,8373,[318  64  98  79 588],577,5,34710,4.144972534033914,40.0,0.0
8374,0,8374,[ 69 216 151 328 302],450,5,34715,4.1450746268656715,0.0,0.0
8375,0,8375,[275 121 237 125 588],450,4,34719,4.145057306590258,0.0,20.0
8376,0,8376,[318  64  98  79 588],796,5,34724,4.145159364927778,40.0,0.0
8377,0,8377,[318  64  98  79 588],450,5,34729,4.145261398901886,40.0,0.0
8378,0,8378,[318  64  98  79 588],450,5,34734,4.145363408521304,40.0,0.0
8379,0,8379,[318  64  98  79 588],450,5,34739,4.145465393794749,40.0,0.0
8380,0,8380,[ 64 180 168 121 333],796,4,34743,4.1454480372270615,20.0,0.0
8381,0,8381,[318  64  98  79 588],18,5,34748,4.145549988069673,40.0,0.0
8382,0,8382,[228  25 185 100  98],256,4,34752,4.145532625551712,0.0,20.0
8383,0,8383,[318  64  98  79 588],18,5,34757,4.145634541984733,40.0,0.0
8384,0,8384,[318  64  98  79 588],577,5,34762,4.145736434108527,40.0,0.0
8385,0,8385,[318  64  98  79 588],716,5,34767,4.145838301931791,40.0,0.0
8386,0,8386,[234 294 127 183 357],796,3,34770,4.145701681173244,0.0,20.0
8387,0,8387,[318  64  98  79 588],450,5,34775,4.145803528850739,40.0,0.0
8388,0,8388,[318  64  98  79 588],796,5,34780,4.14590535224699,40.0,0.0
8389,0,8389,[318  64  98  79 588],18,5,34785,4.1460071513706795,40.0,0.0
8390,0,8390,[405 475  12 210   9],655,0,34785,4.145513049696103,0.0,0.0
8391,0,8391,[186 180 174 111  56],269,1,34786,4.145138226882746,0.0,0.0
8392,0,8392,[655 185 265 318 228],716,5,34791,4.145240081019898,20.0,0.0
8393,0,8393,[182 603  28 194  89],18,1,34792,4.144865380033357,20.0,0.0
8394,0,8394,[183 302 175 121 210],269,1,34793,4.144490768314473,0.0,0.0
8395,0,8395,[318  64  98  79 588],577,5,34798,4.144592663172939,40.0,0.0
8396,0,8396,[210 127  12 194 117],457,5,34803,4.144694533762058,0.0,20.0
8397,0,8397,[748 183 483 275 168],796,5,34808,4.144796380090498,0.0,20.0
8398,0,8398,[187  12 235 151 748],256,3,34811,4.144660078580784,0.0,0.0
8399,0,8399,[318  64  98  79 588],457,5,34816,4.144761904761904,40.0,0.0
8400,0,8400,[318  64  98  79 588],796,5,34821,4.144863706701583,40.0,0.0
8401,0,8401,[318  64  98  79 588],577,5,34826,4.144965484408474,40.0,0.0
8402,0,8402,[318  64  98  79 588],457,5,34831,4.145067237891229,40.0,0.0
8403,0,8403,[318  64  98  79 588],18,5,34836,4.145168967158496,40.0,0.0
8404,0,8404,[318  64  98  79 588],716,5,34841,4.145270672218917,40.0,0.0
8405,0,8405,[318  64  98  79 588],796,5,34846,4.145372353081132,40.0,0.0
8406,0,8406,[318  64  98  79 588],18,5,34851,4.145474009753777,40.0,0.0
8407,0,8407,[245 282  69 100  96],796,3,34854,4.145337773549001,0.0,20.0
8408,0,8408,[181 300 172   7 183],693,1,34855,4.144963729337614,0.0,0.0
8409,0,8409,[427 228 313 235 117],807,4,34859,4.144946492271106,20.0,0.0
8410,0,8410,[318  64  98  79 588],577,5,34864,4.145048151230531,40.0,0.0
8411,0,8411,[318  64  98  79 588],450,5,34869,4.145149786019972,40.0,0.0
8412,0,8412,[318  64  98  79 588],18,5,34874,4.145251396648045,40.0,0.0
8413,0,8413,[318  64  98  79 588],716,5,34879,4.145352983123366,40.0,0.0
8414,0,8414,[143 111 271 185 210],796,4,34883,4.145335710041592,0.0,0.0
8415,0,8415,[318  64  98  79 588],716,5,34888,4.145437262357414,40.0,0.0
8416,0,8416,[318  64  98  79 588],577,5,34893,4.145538790542949,40.0,0.0
8417,0,8417,[318  64  98  79 588],457,5,34898,4.145640294606795,40.0,0.0
8418,0,8418,[  4 204 237 176 427],655,1,34899,4.14526665874807,20.0,0.0
8419,0,8419,[318  64  98  79 588],450,5,34904,4.145368171021378,40.0,0.0
8420,0,8420,[153  22 405 172   9],269,1,34905,4.144994656216602,0.0,0.0
8421,0,8421,[318  64  98  79 588],450,5,34910,4.1450961766801235,40.0,0.0
8422,0,8422,[318  64  98  79 588],577,5,34915,4.14519767303811,40.0,0.0
8423,0,8423,[118  56 179  82  50],457,5,34920,4.145299145299146,0.0,20.0
8424,0,8424,[318  64  98  79 588],796,5,34925,4.14540059347181,40.0,0.0
8425,0,8425,[313  69 403 276 322],224,3,34928,4.145264657014004,0.0,0.0
8426,0,8426,[ 25 187 151 435 302],535,3,34931,4.145128752818322,0.0,0.0
8427,0,8427,[318  64  98  79 588],796,5,34936,4.145230185097295,40.0,0.0
8428,0,8428,[144  15  25   8 237],655,0,34936,4.1447384031320444,0.0,0.0
8429,0,8429,[286 132 237   4 313],344,2,34938,4.144483985765125,0.0,20.0
8430,0,8430,[197   9 269 301 385],796,1,34939,4.144111018858973,0.0,0.0
8431,0,8431,[318  64  98  79 588],577,5,34944,4.144212523719165,40.0,0.0
8432,0,8432,[403 508  28 357 282],693,2,34946,4.143958259219732,0.0,0.0
8433,0,8433,[318  64  98  79 588],450,5,34951,4.144059758121887,40.0,0.0
8434,0,8434,[483  82 294 182 153],796,3,34954,4.143924125666865,0.0,0.0
8435,0,8435,[318  64  98  79 588],716,5,34959,4.144025604551921,40.0,0.0
8436,0,8436,[318  64  98  79 588],577,5,34964,4.144127059381296,40.0,0.0
8437,0,8437,[318  64  98  79 588],796,5,34969,4.144228490163546,40.0,0.0
8438,0,8438,[197 143 588  15 125],798,3,34972,4.144092902002607,0.0,0.0
8439,0,8439,[403 435 282 275 268],655,1,34973,4.143720379146919,0.0,20.0
8440,0,8440,[318  64  98  79 588],716,5,34978,4.143821822058998,40.0,0.0
8441,0,8441,[318  64  98  79 588],450,5,34983,4.143923240938166,40.0,0.0
8442,0,8442,[ 56 257 111  89 127],796,5,34988,4.144024635792965,0.0,20.0
8443,0,8443,[318  64  98  79 588],18,5,34993,4.144126006631928,40.0,0.0
8444,0,8444,[228 143 132 174 216],655,2,34995,4.143872113676732,0.0,0.0
8445,0,8445,[ 97  98 423 257 435],655,1,34996,4.143499881600758,0.0,0.0
8446,0,8446,[153 435 271 333 161],655,0,34996,4.143009352432816,0.0,0.0
8447,0,8447,[318  64  98  79 588],450,5,35001,4.143110795454546,40.0,0.0
8448,0,8448,[318  64  98  79 588],796,5,35006,4.14321221446325,40.0,0.0
8449,0,8449,[318  64  98  79 588],457,5,35011,4.143313609467455,40.0,0.0
8450,0,8450,[318  64  98  79 588],450,5,35016,4.143414980475684,40.0,0.0
8451,0,8451,[318  64  98  79 588],577,5,35021,4.14351632749645,40.0,0.0
8452,0,8452,[318  64  98  79 588],796,5,35026,4.14361765053827,40.0,0.0
8453,0,8453,[ 96 238 181 423 132],655,0,35026,4.143127513603028,0.0,0.0
8454,0,8454,[269  71 215 322  56],796,3,35029,4.142992312241278,0.0,0.0
8455,0,8455,[318  64  98  79 588],716,5,35034,4.143093661305582,40.0,0.0
8456,0,8456,[282 210 234 180  70],450,3,35037,4.142958495920539,0.0,0.0
8457,0,8457,[ 50 286 185 748 100],151,3,35040,4.142823362497044,0.0,60.0
8458,0,8458,[318  64  98  79 588],796,5,35045,4.142924695590495,40.0,0.0
8459,0,8459,[215 144  64 286 268],655,1,35046,4.142553191489362,20.0,20.0
8460,0,8460,[318  64  98  79 588],577,5,35051,4.142654532561163,40.0,0.0
8461,0,8461,[318  64  98  79 588],450,5,35056,4.142755849680927,40.0,0.0
8462,0,8462,[318  64  98  79 588],577,5,35061,4.142857142857143,40.0,0.0
8463,0,8463,[318  64  98  79 588],716,5,35066,4.142958412098299,40.0,0.0
8464,0,8464,[318  64  98  79 588],457,5,35071,4.143059657412876,40.0,0.0
8465,0,8465,[318  64  98  79 588],796,5,35076,4.143160878809355,40.0,0.0
8466,0,8466,[318  64  98  79 588],577,5,35081,4.1432620762962085,40.0,0.0
8467,0,8467,[318  64  98  79 588],577,5,35086,4.143363249881908,40.0,0.0
8468,0,8468,[318  64  98  79 588],450,5,35091,4.1434643995749205,40.0,0.0
8469,0,8469,[ 71 168 234   9 276],504,3,35094,4.143329397874853,0.0,0.0
8470,0,8470,[161 515 385 197 405],655,1,35095,4.142958328414591,0.0,0.0
8471,0,8471,[318  64  98  79 588],18,5,35100,4.143059490084986,40.0,0.0
8472,0,8472,[151 496  95 168 427],330,4,35104,4.143042605924702,40.0,0.0
8473,0,8473,[135 197  50 179 196],389,3,35107,4.142907717724805,0.0,20.0
8474,0,8474,[235 603   7 234 228],23,3,35110,4.142772861356932,20.0,0.0
8475,0,8475,[186 405 135 195 289],655,1,35111,4.142402076451156,0.0,0.0
8476,0,8476,[ 15 172  22 238 282],450,4,35115,4.142385277810546,0.0,0.0
8477,0,8477,[318  64  98  79 588],796,5,35120,4.142486435480066,40.0,0.0
8478,0,8478,[ 11 195 183 258 238],655,1,35121,4.142115815544286,0.0,0.0
8479,0,8479,[195  96 125 546 202],504,4,35125,4.142099056603773,0.0,0.0
8480,0,8480,[318  64  98  79 588],18,5,35130,4.142200212239123,40.0,0.0
8481,0,8481,[742 185 161  69 125],655,1,35131,4.141829757132752,0.0,0.0
8482,0,8482,[318  64  98  79 588],457,5,35136,4.141930920664859,40.0,0.0
8483,0,8483,[318  64  98  79 588],457,5,35141,4.142032060348892,40.0,0.0
8484,0,8484,[  9  71 210 127   1],401,1,35142,4.141661756040071,0.0,20.0
8485,0,8485,[318  64  98  79 588],457,5,35147,4.141762903605939,40.0,0.0
8486,0,8486,[174 405  82 323  98],798,4,35151,4.141746200070696,0.0,0.0
8487,0,8487,[318  64  79  98 588],457,5,35156,4.1418473138548535,40.0,0.0
8488,0,8488,[318  64  79  98 588],577,5,35161,4.141948403816704,40.0,0.0
8489,0,8489,[483 172 195 200   4],716,3,35164,4.141813898704358,0.0,0.0
8490,0,8490,[322 180 200   8 111],796,3,35167,4.14167942527382,0.0,0.0
8491,0,8491,[ 11 268  71   7  70],344,1,35168,4.141309467734338,0.0,0.0
8492,0,8492,[318  64  79  98 588],577,5,35173,4.141410573413399,40.0,0.0
8493,0,8493,[282 748 245 151 173],796,4,35177,4.141393925123617,0.0,0.0
8494,0,8494,[318  64  79  98 588],450,5,35182,4.141494997057093,40.0,0.0
8495,0,8495,[ 82  96 161 282   8],796,4,35186,4.141478342749529,0.0,0.0
8496,0,8496,[318  64  79  98 588],457,5,35191,4.141579380957985,40.0,0.0
8497,0,8497,[318  64  79  98 588],796,5,35196,4.14168039538715,40.0,0.0
8498,0,8498,[318  64  79  98 588],450,5,35201,4.141781386045417,40.0,0.0
8499,0,8499,[496 655 234 100 294],450,4,35205,4.141764705882353,20.0,20.0
8500,0,8500,[ 15 245 153 204 276],629,4,35209,4.141748029643571,0.0,0.0
8501,0,8501,[174 427 385 588 181],807,5,35214,4.141848976711362,20.0,0.0
8502,0,8502,[318  64  79  98 588],450,5,35219,4.141949900035281,40.0,0.0
8503,0,8503,[172 294 228  11 151],716,5,35224,4.142050799623706,0.0,0.0
8504,0,8504,[318  64  79  98 588],18,5,35229,4.1421516754850085,40.0,0.0
8505,0,8505,[318  64  79  98 588],18,5,35234,4.142252527627557,40.0,0.0
8506,0,8506,[  4  25  56  98 405],577,3,35237,4.14211825555425,0.0,0.0
8507,0,8507,[185  89 603   1 211],151,5,35242,4.142219087917255,20.0,0.0
8508,0,8508,[318  64  79  98 588],18,5,35247,4.142319896580092,40.0,0.0
8509,0,8509,[483 282 508 211 302],535,3,35250,4.142185663924795,0.0,0.0
8510,0,8510,[318  64  79  98 588],450,5,35255,4.142286452825755,40.0,0.0
8511,0,8511,[318  64  79  98 588],450,5,35260,4.142387218045113,40.0,0.0
8512,0,8512,[318  64  79  98 588],457,5,35265,4.142487959591214,40.0,0.0
8513,0,8513,[318  64  79  98 588],457,5,35270,4.142588677472398,40.0,0.0
8514,0,8514,[200 588 117 211 471],716,4,35274,4.142571931884909,0.0,0.0
8515,0,8515,[186 200  97  82 269],450,2,35276,4.142320338186942,0.0,0.0
8516,0,8516,[318  64  79  98 588],716,5,35281,4.142421040272397,40.0,0.0
8517,0,8517,[275 435 168 181 508],401,2,35283,4.142169523362291,0.0,20.0
8518,0,8518,[318  64  79  98 588],716,5,35288,4.142270219509332,40.0,0.0
8519,0,8519,[ 88  25 202  69 195],344,3,35291,4.142136150234742,0.0,0.0
8520,0,8520,[204 191  95 185 300],450,4,35295,4.142119469545828,0.0,0.0
8521,0,8521,[318  64  79  98 588],577,5,35300,4.142220136118282,40.0,0.0
8522,0,8522,[196  15 204 222 202],796,5,35305,4.142320779068403,0.0,0.0
8523,0,8523,[318  64  79  98 588],796,5,35310,4.142421398404505,40.0,0.0
8524,0,8524,[655 216 288  11 597],457,4,35314,4.142404692082112,0.0,0.0
8525,0,8525,[ 69 195 117 121 210],344,2,35316,4.142153413089374,0.0,0.0
8526,0,8526,[  7 568 423   9 191],655,1,35317,4.141784918494195,0.0,0.0
8527,0,8527,[135 238 117 273  98],655,3,35320,4.141651031894934,0.0,0.0
8528,0,8528,[200 183 286 228  89],450,4,35324,4.1416344237308005,0.0,20.0
8529,0,8529,[318  64  79  98 588],577,5,35329,4.141735052754982,40.0,0.0
8530,0,8530,[ 89 215 202   7 483],450,4,35333,4.141718438635564,0.0,0.0
8531,0,8531,[318  64  79  98 588],796,5,35338,4.141819034224097,40.0,0.0
8532,0,8532,[168 181 300 403 144],807,5,35343,4.141919606234619,0.0,0.0
8533,0,8533,[318  64  79  98 588],716,5,35348,4.142020154675416,40.0,0.0
8534,0,8534,[318  64  79  98 588],796,5,35353,4.1421206795547745,40.0,0.0
8535,0,8535,[ 69 655  11 234 185],655,1,35354,4.141752577319588,0.0,0.0
8536,0,8536,[318  64  79  98 588],796,5,35359,4.141853109991801,40.0,0.0
8537,0,8537,[318  64  79  98 588],796,5,35364,4.141953619114546,40.0,0.0
8538,0,8538,[318  64  79  98 588],18,5,35369,4.142054104696101,40.0,0.0
8539,0,8539,[318  64  79  98 588],796,5,35374,4.142154566744731,40.0,0.0
8540,0,8540,[111 100 180 194 238],18,3,35377,4.142020840650978,0.0,20.0
8541,0,8541,[100 127 405   4  50],256,5,35382,4.14212128307188,0.0,60.0
8542,0,8542,[204 168 143 237   1],457,5,35387,4.142221701978228,0.0,0.0
8543,0,8543,[ 96  12 597 191  71],796,5,35392,4.142322097378277,0.0,0.0
8544,0,8544,[300 269 202 328 211],655,0,35392,4.141837331772967,0.0,0.0
8545,0,8545,[318  64  79  98 588],577,5,35397,4.141937748654342,40.0,0.0
8546,0,8546,[318  64  79  98 588],457,5,35402,4.1420381420381425,40.0,0.0
8547,0,8547,[318  64  79  98 588],577,5,35407,4.1421385119326155,40.0,0.0
8548,0,8548,[179 435  82 173 187],450,4,35411,4.142121885600655,0.0,0.0
8549,0,8549,[117  12 111  64 185],655,2,35413,4.14187134502924,20.0,0.0
8550,0,8550,[172  79  95   4 144],280,2,35415,4.141620863056953,0.0,0.0
8551,0,8551,[265 121 179 174 742],457,5,35420,4.141721234798878,0.0,0.0
8552,0,8552,[318  64  79  98 588],577,5,35425,4.141821583070268,40.0,0.0
8553,0,8553,[318  64  79  98 588],450,5,35430,4.141921907879355,40.0,0.0
8554,0,8554,[318  64  79  98 588],577,5,35435,4.142022209234366,40.0,0.0
8555,0,8555,[197  95 515  12  28],18,4,35439,4.142005610098177,0.0,0.0
8556,0,8556,[318  64  79  98 588],716,5,35444,4.142105878228351,40.0,0.0
8557,0,8557,[318  64  79  98 588],457,5,35449,4.142206122925917,40.0,0.0
8558,0,8558,[318  64  79  98 588],716,5,35454,4.142306344199088,40.0,0.0
8559,0,8559,[ 64 194  88 186 282],457,5,35459,4.142406542056075,20.0,0.0
8560,0,8560,[318  64  79  98 588],716,5,35464,4.142506716505081,40.0,0.0
8561,0,8561,[318  64  79  98 588],18,5,35469,4.14260686755431,40.0,0.0
8562,0,8562,[238 228 546  97 210],457,4,35473,4.1425902137101485,0.0,0.0
8563,0,8563,[318  64  79  98 588],796,5,35478,4.142690331620738,40.0,0.0
8564,0,8564,[318  64  79  98 588],18,5,35483,4.142790426152948,40.0,0.0
8565,0,8565,[318  64  79  98 588],577,5,35488,4.1428904973149665,40.0,0.0
8566,0,8566,[318  64  79  98 588],18,5,35493,4.142990545114976,40.0,0.0
8567,0,8567,[175 176 172 546 182],457,4,35497,4.14297385620915,0.0,0.0
8568,0,8568,[318  64  79  98 588],18,5,35502,4.143073870930097,40.0,0.0
8569,0,8569,[318  64  79  98 588],450,5,35507,4.143173862310385,40.0,0.0
8570,0,8570,[546 228  70 153 151],450,5,35512,4.143273830358185,0.0,0.0
8571,0,8571,[318  64  79  98 588],577,5,35517,4.1433737750816615,40.0,0.0
8572,0,8572,[286 118 210 245 405],450,3,35520,4.143240405925581,0.0,20.0
8573,0,8573,[318  64  79  98 588],18,5,35525,4.143340331233963,40.0,0.0
8574,0,8574,[ 98 496 234   1   9],593,2,35527,4.143090379008746,20.0,0.0
8575,0,8575,[318  64  79  98 588],450,5,35532,4.143190298507463,40.0,0.0
8576,0,8576,[318  64  79  98 588],796,5,35537,4.143290194706774,40.0,0.0
8577,0,8577,[318  64  79  98 588],450,5,35542,4.1433900676148285,40.0,0.0
8578,0,8578,[318  64  79  98 588],796,5,35547,4.143489917239772,40.0,0.0
8579,0,8579,[318  64  79  98 588],577,5,35552,4.143589743589744,40.0,0.0
8580,0,8580,[187 197  28 238 222],786,4,35556,4.143573010138678,0.0,0.0
8581,0,8581,[318  64  79  98 588],796,5,35561,4.143672803542298,40.0,0.0
8582,0,8582,[603 183 302 197  70],151,3,35564,4.143539554934172,20.0,0.0
8583,0,8583,[318  64  79  98 588],457,5,35569,4.143639328984157,40.0,0.0
8584,0,8584,[ 56  82 176 187 294],655,1,35570,4.143273150844497,0.0,0.0
8585,0,8585,[318  64  79  98 588],450,5,35575,4.143372932681109,40.0,0.0
8586,0,8586,[172  56 427 265 215],796,5,35580,4.143472691277513,20.0,0.0
8587,0,8587,[111 143  97 216 300],450,5,35585,4.143572426641826,0.0,0.0
8588,0,8588,[318  64  79  98 588],457,5,35590,4.143672138782163,40.0,0.0
8589,0,8589,[655 100  22   4 121],655,0,35590,4.1431897555296855,0.0,20.0
8590,0,8590,[318  64  79  98 588],18,5,35595,4.143289489000116,40.0,0.0
8591,0,8591,[318  64  79  98 588],577,5,35600,4.143389199255121,40.0,0.0
8592,0,8592,[471   4 216  50 385],786,5,35605,4.143488886302805,0.0,20.0
8593,0,8593,[318  64  79  98 588],577,5,35610,4.143588550151268,40.0,0.0
8594,0,8594,[318  64  79  98 588],457,5,35615,4.14368819080861,40.0,0.0
8595,0,8595,[318  64  79  98 588],450,5,35620,4.143787808282922,40.0,0.0
8596,0,8596,[318  64  79  98 588],450,5,35625,4.143887402582296,40.0,0.0
8597,0,8597,[318  64  79  98 588],18,5,35630,4.143986973714817,40.0,0.0
8598,0,8598,[318  64  79  98 588],577,5,35635,4.1440865216885685,40.0,0.0
8599,0,8599,[318  64  79  98 588],18,5,35640,4.144186046511628,40.0,0.0
8600,0,8600,[318  64  79  98 588],18,5,35645,4.14428554819207,40.0,0.0
8601,0,8601,[318  64  79  98 588],716,5,35650,4.144385026737968,40.0,0.0
8602,0,8602,[423 173  12   8 202],577,5,35655,4.144484482157387,0.0,0.0
8603,0,8603,[ 79 568 385  71 405],280,3,35658,4.144351464435147,0.0,0.0
8604,0,8604,[222 194 100 273 181],236,2,35660,4.144102266124347,0.0,20.0
8605,0,8605,[222 508  82  11  28],655,0,35660,4.143620729723449,0.0,0.0
8606,0,8606,[318  64  79  98 588],457,5,35665,4.143720227721622,40.0,0.0
8607,0,8607,[318  64  79  98 588],450,5,35670,4.14381970260223,40.0,0.0
8608,0,8608,[176 180  69 210 191],716,3,35673,4.143686839354165,0.0,0.0
8609,0,8609,[191  25  88 289 185],693,2,35675,4.143437862950058,0.0,0.0
8610,0,8610,[318  64  79  98 588],18,5,35680,4.143537335965625,40.0,0.0
8611,0,8611,[215 257 183 234  96],23,1,35681,4.143172317696238,0.0,0.0
8612,0,8612,[172  79 471 200 175],716,3,35684,4.143039591315453,0.0,0.0
8613,0,8613,[ 69 197 187 173 143],450,5,35689,4.1431390759229165,0.0,0.0
8614,0,8614,[185 179  22 111 403],450,5,35694,4.143238537434707,0.0,0.0
8615,0,8615,[161 294 180 245 121],796,2,35696,4.142989786443826,0.0,0.0
8616,0,8616,[ 50 179 204 180 121],457,5,35701,4.14308924219566,0.0,20.0
8617,0,8617,[318  64  79  98 588],18,5,35706,4.1431886748665585,40.0,0.0
8618,0,8618,[265  11  56 204 135],655,1,35707,4.142823993502726,0.0,0.0
8619,0,8619,[318  64  79  98 588],18,5,35712,4.14292343387471,40.0,0.0
8620,0,8620,[179 318 176 427 237],655,3,35715,4.142790859529057,40.0,0.0
8621,0,8621,[318  64  79  98 588],796,5,35720,4.142890280677337,40.0,0.0
8622,0,8622,[318  64  79  98 588],450,5,35725,4.1429896787660905,40.0,0.0
8623,0,8623,[200 202 100 423 234],269,3,35728,4.142857142857143,0.0,20.0
8624,0,8624,[318  64  79  98 588],796,5,35733,4.142956521739131,40.0,0.0
8625,0,8625,[328 204  28 200 568],796,4,35737,4.142939948991422,0.0,0.0
8626,0,8626,[318  64  79  98 588],577,5,35742,4.143039295235887,40.0,0.0
8627,0,8627,[196 183  96 168  22],716,3,35745,4.142906815020862,0.0,0.0
8628,0,8628,[144 202 216 175 288],655,1,35746,4.1425425889442575,0.0,0.0
8629,0,8629,[318  64  79  98 588],796,5,35751,4.142641946697567,40.0,0.0
8630,0,8630,[ 56 186  22 313  25],655,1,35752,4.142277835708493,0.0,0.0
8631,0,8631,[385 286 121 597 176],344,1,35753,4.141913809082483,0.0,20.0
8632,0,8632,[496  96 185  22 172],269,2,35755,4.1416657013784315,20.0,0.0
8633,0,8633,[ 70   9 471  71 276],344,2,35757,4.14141765114663,0.0,0.0
8634,0,8634,[655  64 318 475 153],269,4,35761,4.14140127388535,40.0,0.0
8635,0,8635,[748 385   1 435 234],807,3,35764,4.141269106067624,0.0,0.0
8636,0,8636,[235 603 132  28 111],716,4,35768,4.141252749797383,20.0,0.0
8637,0,8637,[258 117 357 275   1],296,4,35772,4.141236397314193,0.0,20.0
8638,0,8638,[127 496 603 180  98],796,4,35776,4.141220048616738,40.0,20.0
8639,0,8639,[197 265 300 742 357],796,3,35779,4.141087962962963,0.0,0.0
8640,0,8640,[318  64  79  98 588],18,5,35784,4.141187362573776,40.0,0.0
8641,0,8641,[204  95 174   9  82],280,2,35786,4.140939597315437,0.0,0.0
8642,0,8642,[318  64  79  98 588],716,5,35791,4.141038991091056,40.0,0.0
8643,0,8643,[318  64  79  98 588],18,5,35796,4.141138361869505,40.0,0.0
8644,0,8644,[275 180  79 222 118],450,3,35799,4.141006362058993,0.0,20.0
8645,0,8645,[271 289  98  79 508],655,2,35801,4.140758732361785,0.0,0.0
8646,0,8646,[318  64  79  98 588],577,5,35806,4.140858101075517,40.0,0.0
8647,0,8647,[318  64  79  98 588],716,5,35811,4.14095744680851,40.0,0.0
8648,0,8648,[318  64  79  98 588],796,5,35816,4.141056769568737,40.0,0.0
8649,0,8649,[318  64  79  98 588],716,5,35821,4.141156069364162,40.0,0.0
8650,0,8650,[  8  88 435 202 268],269,1,35822,4.140792971910762,0.0,0.0
8651,0,8651,[294 313 496 435 121],450,4,35826,4.140776699029126,20.0,0.0
8652,0,8652,[318  64  79  98 588],796,5,35831,4.140875996764128,40.0,0.0
8653,0,8653,[172 117 275 210 238],786,5,35836,4.140975271550728,0.0,20.0
8654,0,8654,[176 172  70 182  89],450,5,35841,4.14107452339688,0.0,0.0
8655,0,8655,[183 403 194 597 100],450,5,35846,4.141173752310536,0.0,20.0
8656,0,8656,[318  64  79  98 588],18,5,35851,4.141272958299642,40.0,0.0
8657,0,8657,[  8 210 216 322 271],796,3,35854,4.141141141141141,0.0,0.0
8658,0,8658,[161 385 597 568 144],796,5,35859,4.141240327982446,0.0,0.0
8659,0,8659,[597 318 211 121 175],269,3,35862,4.141108545034642,20.0,0.0
8660,0,8660,[318  64  79  98 588],577,5,35867,4.14120771273525,40.0,0.0
8661,0,8661,[194 197 275 655   8],878,3,35870,4.1410759639806045,0.0,20.0
8662,0,8662,[275 508 313 271 742],655,2,35872,4.140828812189772,0.0,20.0
8663,0,8663,[318  64  79  98 588],18,5,35877,4.140927977839335,40.0,0.0
8664,0,8664,[318  64  79  98 588],450,5,35882,4.141027120600115,40.0,0.0
8665,0,8665,[117  98 195 282   7],457,5,35887,4.141126240480037,0.0,0.0
8666,0,8666,[ 56 588 300   1 132],716,5,35892,4.14122533748702,0.0,0.0
8667,0,8667,[318  64  79  98 588],796,5,35897,4.14132441162898,40.0,0.0
8668,0,8668,[318  64  79  98 588],450,5,35902,4.1414234629138305,40.0,0.0
8669,0,8669,[ 69 132 318 234 172],316,2,35904,4.141176470588236,20.0,0.0
8670,0,8670,[286 215 245  69 161],280,3,35907,4.141044862184293,0.0,20.0
8671,0,8671,[568   1 222 275 176],344,4,35911,4.1410285977859775,0.0,20.0
8672,0,8672,[182 313 328 238   1],796,3,35914,4.140897036780814,0.0,0.0
8673,0,8673,[318  64  79  98 588],577,5,35919,4.140996080239797,40.0,0.0
8674,0,8674,[318  64  79  98 588],796,5,35924,4.141095100864553,40.0,0.0
8675,0,8675,[318  64  79  98 588],18,5,35929,4.141194098662979,40.0,0.0
8676,0,8676,[ 71 216 173 318 742],450,4,35933,4.141177826437709,20.0,0.0
8677,0,8677,[427 100 385 172  88],503,4,35937,4.141161557962664,20.0,20.0
8678,0,8678,[135  82 195 127 546],457,4,35941,4.141145293236548,0.0,20.0
8679,0,8679,[195 197  15 211 302],450,4,35945,4.141129032258065,0.0,0.0
8680,0,8680,[195 385 597  12 471],344,2,35947,4.1408823868217945,0.0,0.0
8681,0,8681,[191 151 423  15 168],151,4,35951,4.140866159870997,0.0,0.0
8682,0,8682,[318  64  79  98 588],716,5,35956,4.14096510422665,40.0,0.0
8683,0,8683,[318  64  79  98 588],457,5,35961,4.141064025794565,40.0,0.0
8684,0,8684,[228 127  56 151 191],796,5,35966,4.141162924582614,0.0,20.0
8685,0,8685,[210 588 568 427 216],450,4,35970,4.141146672806816,20.0,0.0
8686,0,8686,[318  64  79  98 588],457,5,35975,4.141245539311615,40.0,0.0
8687,0,8687,[180 194 168 172 195],457,5,35980,4.14134438305709,0.0,0.0
8688,0,8688,[385 186 197 111 289],786,4,35984,4.141328116008746,0.0,0.0
8689,0,8689,[135 435 176 423  95],5,4,35988,4.141311852704257,0.0,0.0
8690,0,8690,[ 96 195 204 435 187],72,5,35993,4.141410654700264,0.0,0.0
8691,0,8691,[ 56 318 282 132 176],796,5,35998,4.1415094339622645,20.0,0.0
8692,0,8692,[191  79 143 211 742],796,3,36001,4.141378120326699,0.0,0.0
8693,0,8693,[318  64  79  98 588],716,5,36006,4.141476880607315,40.0,0.0
8694,0,8694,[ 71  15 286 197 100],389,3,36009,4.141345600920069,0.0,40.0
8695,0,8695,[318  64  79  98 588],18,5,36014,4.141444342226311,40.0,0.0
8696,0,8696,[197 180 276 215 100],535,4,36018,4.1414280786478095,0.0,20.0
8697,0,8697,[318  64  79  98 588],716,5,36023,4.141526787767303,40.0,0.0
8698,0,8698,[ 56 216 183 151 282],716,3,36026,4.141395562708357,0.0,0.0
8699,0,8699,[318  64  79  98 588],716,5,36031,4.141494252873564,40.0,0.0
8700,0,8700,[125  89  22 423 100],450,5,36036,4.1415929203539825,0.0,20.0
8701,0,8701,[222 496 143 215 318],450,4,36040,4.141576649046196,40.0,0.0
8702,0,8702,[318  64  79  98 588],18,5,36045,4.141675284384695,40.0,0.0
8703,0,8703,[216 222 182 135  88],655,3,36048,4.141544117647059,0.0,0.0
8704,0,8704,[228 117 515 132 423],807,5,36053,4.141642734060884,0.0,0.0
8705,0,8705,[ 82 195  71 215 294],280,1,36054,4.1412818745692626,0.0,0.0
8706,0,8706,[286 183  28  64 483],450,4,36058,4.141265648328931,20.0,20.0
8707,0,8707,[318  64  79  98 588],18,5,36063,4.141364262746899,40.0,0.0
8708,0,8708,[318  64  79  98 588],450,5,36068,4.1414628545183145,40.0,0.0
8709,0,8709,[234  88   4 121  79],796,4,36072,4.141446613088404,0.0,0.0
8710,0,8710,[318  64  79  98 588],18,5,36077,4.141545172770061,40.0,0.0
8711,0,8711,[210  97 483 132 168],18,4,36081,4.141528925619835,0.0,0.0
8712,0,8712,[  8 333 222 286 275],655,1,36082,4.141168369103638,0.0,40.0
8713,0,8713,[ 69  89 143 742   1],655,2,36084,4.140922653201744,0.0,0.0
8714,0,8714,[216  64  82  56 294],716,5,36089,4.141021227768216,20.0,0.0
8715,0,8715,[748 125 235 322 508],15,1,36090,4.14066085360257,0.0,0.0
8716,0,8716,[385  95  12 132 111],577,5,36095,4.140759435585637,0.0,0.0
8717,0,8717,[269 111  79 202  82],18,2,36097,4.140513879330122,0.0,0.0
8718,0,8718,[318  64  79  98 588],18,5,36102,4.1406124555568296,40.0,0.0
8719,0,8719,[210 302 111 204  12],450,4,36106,4.14059633027523,0.0,0.0
8720,0,8720,[118  70 546 125 143],457,4,36110,4.140580208691664,0.0,0.0
8721,0,8721,[318  64  79  98 588],716,5,36115,4.140678743407475,40.0,0.0
8722,0,8722,[318  64  79  98 588],796,5,36120,4.140777255531354,40.0,0.0
8723,0,8723,[183 294 385 427 271],796,4,36124,4.140761118752866,20.0,0.0
8724,0,8724,[ 50 174 546 655   1],23,3,36127,4.140630372492836,0.0,20.0
8725,0,8725,[318  64  79  98 588],18,5,36132,4.140728856291543,40.0,0.0
8726,0,8726,[318  64  79  98 588],457,5,36137,4.14082731752034,40.0,0.0
8727,0,8727,[318  64  79  98 588],457,5,36142,4.140925756186984,40.0,0.0
8728,0,8728,[318  64  79  98 588],716,5,36147,4.1410241722992325,40.0,0.0
8729,0,8729,[  4 144 288 588 172],457,5,36152,4.141122565864834,0.0,0.0
8730,0,8730,[  8 300 403 211 286],796,3,36155,4.140991868056351,0.0,20.0
8731,0,8731,[181 143 151   1  50],151,5,36160,4.141090242785158,0.0,20.0
8732,0,8732,[318  64  79  98 588],450,5,36165,4.141188594984541,40.0,0.0
8733,0,8733,[111 508 318 276 174],401,4,36169,4.141172429585528,20.0,0.0
8734,0,8734,[318 546 483 235 183],716,2,36171,4.140927303949628,20.0,0.0
8735,0,8735,[265  69 195 603 258],450,5,36176,4.141025641025641,20.0,0.0
8736,0,8736,[318  64  79  98 588],796,5,36181,4.141123955591164,40.0,0.0
8737,0,8737,[322  56   4 144 403],450,4,36185,4.1411078049897005,0.0,0.0
8738,0,8738,[496 655 173 403  12],280,2,36187,4.140862798947248,20.0,0.0
8739,0,8739,[318  64  79  98 588],796,5,36192,4.1409610983981695,40.0,0.0
8740,0,8740,[216 181  82 603 143],655,3,36195,4.14083056858483,20.0,0.0
8741,0,8741,[318  64  79  98 588],450,5,36200,4.140928849233585,40.0,0.0
8742,0,8742,[318  64  79  98 588],457,5,36205,4.141027107400206,40.0,0.0
8743,0,8743,[318  64  79  98 588],18,5,36210,4.141125343092407,40.0,0.0
8744,0,8744,[195  69  50  98 245],629,4,36214,4.141109205260149,0.0,20.0
8745,0,8745,[318  64  79  98 588],18,5,36219,4.141207409101304,40.0,0.0
8746,0,8746,[181 174 172 127 210],450,4,36223,4.1411912655767695,0.0,20.0
8747,0,8747,[318  64  79  98 588],450,5,36228,4.141289437585734,40.0,0.0
8748,0,8748,[322 318 568 313 181],450,5,36233,4.141387587152818,20.0,0.0
8749,0,8749,[204 234 222 300 215],450,3,36236,4.1412571428571425,0.0,0.0
8750,0,8750,[318  64  79  98 588],450,5,36241,4.141355273683008,40.0,0.0
8751,0,8751,[318  64  79  98 588],18,5,36246,4.141453382084095,40.0,0.0
8752,0,8752,[423 282  15  71  70],593,5,36251,4.141551468068091,0.0,0.0
8753,0,8753,[318  64  79  98 588],796,5,36256,4.141649531642678,40.0,0.0
8754,0,8754,[237   1  95 153 187],18,4,36260,4.141633352370074,0.0,0.0
8755,0,8755,[318  64  79  98 588],450,5,36265,4.141731384193696,40.0,0.0
8756,0,8756,[318  64  79  98 588],796,5,36270,4.141829393627955,40.0,0.0
8757,0,8757,[117 603 121 294 216],401,2,36272,4.141584836720712,20.0,0.0
8758,0,8758,[405 182 215 508 118],280,0,36272,4.141111999086654,0.0,0.0
8759,0,8759,[318  64  79  98 588],18,5,36277,4.141210045662101,40.0,0.0
8760,0,8760,[318  64  79  98 588],450,5,36282,4.1413080698550395,40.0,0.0
8761,0,8761,[318  64  79  98 588],716,5,36287,4.141406071673134,40.0,0.0
8762,0,8762,[216 215 423 211 153],23,3,36290,4.141275818783521,0.0,0.0
8763,0,8763,[153  70  79  22 144],655,1,36291,4.140917389319945,0.0,0.0
8764,0,8764,[318  64  79  98 588],577,5,36296,4.141015402167713,40.0,0.0
8765,0,8765,[318  64  79  98 588],18,5,36301,4.141113392653434,40.0,0.0
8766,0,8766,[ 11 151 194 204 427],577,4,36305,4.1410972966807345,20.0,0.0
8767,0,8767,[181 183  50 276 302],655,4,36309,4.141081204379562,0.0,20.0
8768,0,8768,[318  64  79  98 588],577,5,36314,4.141179153837382,40.0,0.0
8769,0,8769,[286 191 196 276 194],18,3,36317,4.141049030786773,0.0,20.0
8770,0,8770,[318  64  79  98 588],450,5,36322,4.1411469615779275,40.0,0.0
8771,0,8771,[318  64  79  98 588],457,5,36327,4.14124487004104,40.0,0.0
8772,0,8772,[318  64  79  98 588],457,5,36332,4.141342756183746,40.0,0.0
8773,0,8773,[318  64  79  98 588],796,5,36337,4.141440620013677,40.0,0.0
8774,0,8774,[172  79 197 135 269],535,2,36339,4.141196581196581,0.0,0.0
8775,0,8775,[301 176 237 357   1],655,1,36340,4.140838650865998,0.0,0.0
8776,0,8776,[204 143 269 176 181],450,5,36345,4.140936538680642,0.0,0.0
8777,0,8777,[318  64  98  79 588],796,5,36350,4.141034404192299,40.0,0.0
8778,0,8778,[127 403 235  82 228],457,4,36354,4.14101833921859,0.0,20.0
8779,0,8779,[  7  11 405 173 186],269,0,36354,4.140546697038724,0.0,0.0
8780,0,8780,[318  64  98  79 588],716,5,36359,4.14064457351099,40.0,0.0
8781,0,8781,[ 79 215  50 210 483],535,4,36363,4.14062855841494,0.0,20.0
8782,0,8782,[318  64  98  79 588],450,5,36368,4.140726403279062,40.0,0.0
8783,0,8783,[318  64  98  79 588],716,5,36373,4.1408242258652095,40.0,0.0
8784,0,8784,[318  64  98  79 588],577,5,36378,4.1409220261809905,40.0,0.0
8785,0,8785,[742   8 655 275 423],796,3,36381,4.140792169360346,0.0,20.0
8786,0,8786,[222 655 313 161 172],693,1,36382,4.140434733128485,0.0,0.0
8787,0,8787,[318  64  98  79 588],577,5,36387,4.140532544378698,40.0,0.0
8788,0,8788,[182 202 323  28 546],796,3,36390,4.1404027761975195,0.0,0.0
8789,0,8789,[ 71 323   1 202 196],796,3,36393,4.140273037542662,0.0,0.0
8790,0,8790,[300 215 125  98 385],450,5,36398,4.140370833807303,0.0,0.0
8791,0,8791,[318  64  98  79 588],796,5,36403,4.140468607825296,40.0,0.0
8792,0,8792,[318  64  98  79 588],18,5,36408,4.140566359604231,40.0,0.0
8793,0,8793,[238 185  82 322 179],450,4,36412,4.140550375255856,0.0,0.0
8794,0,8794,[508 322 195 403 117],280,2,36414,4.140306992609437,0.0,0.0
8795,0,8795,[200 173   1 210 276],457,5,36419,4.140404729422465,0.0,0.0
8796,0,8796,[318  64  98  79 588],18,5,36424,4.140502444015005,40.0,0.0
8797,0,8797,[ 12 496 322 483 183],908,3,36427,4.140372812002728,20.0,0.0
8798,0,8798,[318  64  98  79 588],18,5,36432,4.140470508012275,40.0,0.0
8799,0,8799,[318  64  98  79 588],450,5,36437,4.140568181818182,40.0,0.0
8800,0,8800,[216 405 597  15 173],593,3,36440,4.140438586524259,0.0,0.0
8801,0,8801,[318  64  98  79 588],796,5,36445,4.140536241763235,40.0,0.0
8802,0,8802,[318  64  98  79 588],577,5,36450,4.1406338748154035,40.0,0.0
8803,0,8803,[318  64  98  79 588],18,5,36455,4.140731485688323,40.0,0.0
8804,0,8804,[318  64  98  79 588],457,5,36460,4.1408290743895515,40.0,0.0
8805,0,8805,[546 132 655 423 483],151,4,36464,4.140813081989553,0.0,0.0
8806,0,8806,[ 11  96 179 182 132],655,2,36466,4.14057000113546,0.0,0.0
8807,0,8807,[515 174 118 258 405],655,1,36467,4.140213442325159,0.0,0.0
8808,0,8808,[286 508 117 742 186],655,0,36467,4.1397434442047905,0.0,20.0
8809,0,8809,[ 22  98 161  28 302],655,2,36469,4.13950056753689,0.0,0.0
8810,0,8810,[194  11 496 318 435],450,5,36474,4.13959822948587,40.0,0.0
8811,0,8811,[318  64  98  79 588],450,5,36479,4.139695869269178,40.0,0.0
8812,0,8812,[191 234 200 215   9],18,2,36481,4.139453080676273,0.0,0.0
8813,0,8813,[318  64  98  79 588],796,5,36486,4.1395507147719535,40.0,0.0
8814,0,8814,[118 245 322 168  69],504,4,36490,4.1395348837209305,0.0,0.0
8815,0,8815,[318  64  98  79 588],796,5,36495,4.139632486388384,40.0,0.0
8816,0,8816,[180 161 182  98  69],450,5,36500,4.139730066916185,0.0,0.0
8817,0,8817,[318  64  98  79 588],450,5,36505,4.139827625311862,40.0,0.0
8818,0,8818,[318  64  98  79 588],577,5,36510,4.139925161582946,40.0,0.0
8819,0,8819,[117 143  11 496  96],716,4,36514,4.139909297052154,20.0,0.0
8820,0,8820,[318  64  98  79 588],18,5,36519,4.140006801949892,40.0,0.0
8821,0,8821,[318  64  98  79 588],457,5,36524,4.140104284742689,40.0,0.0
8822,0,8822,[588 435 678 300 195],807,2,36526,4.139861725036836,0.0,0.0
8823,0,8823,[210 269 151 196 168],796,3,36529,4.139732547597461,0.0,0.0
8824,0,8824,[318  64  98  79 588],577,5,36534,4.139830028328612,40.0,0.0
8825,0,8825,[318  64  98  79 588],716,5,36539,4.139927486970315,40.0,0.0
8826,0,8826,[117 186 143   4 588],577,4,36543,4.139911634756996,0.0,0.0
8827,0,8827,[127 200 196 357 235],457,4,36547,4.139895786135025,0.0,20.0
8828,0,8828,[318  64  98  79 588],796,5,36552,4.139993204213388,40.0,0.0
8829,0,8829,[568  89  56  12 191],450,5,36557,4.1400906002265,0.0,0.0
8830,0,8830,[200 405 245 210   1],796,2,36559,4.139848261805005,0.0,0.0
8831,0,8831,[318  64  98  79 588],716,5,36564,4.139945652173913,40.0,0.0
8832,0,8832,[216  15 125  88 268],11,3,36567,4.139816596852712,0.0,0.0
8833,0,8833,[176   4 125 200   9],504,4,36571,4.139800769753226,0.0,0.0
8834,0,8834,[318  64  98  79 588],457,5,36576,4.139898132427843,40.0,0.0
8835,0,8835,[258  82 183 405  12],655,1,36577,4.139542779538252,0.0,0.0
8836,0,8836,[318  64  98  79 588],796,5,36582,4.139640149371959,40.0,0.0
8837,0,8837,[748 132 318  25 210],450,3,36585,4.139511201629328,20.0,0.0
8838,0,8838,[238   7 275 172 258],296,5,36590,4.139608553003733,0.0,20.0
8839,0,8839,[318  64  98  79 588],796,5,36595,4.139705882352941,40.0,0.0
8840,0,8840,[215 202 175 258 435],655,0,36595,4.139237642800588,0.0,0.0
8841,0,8841,[423 125  79 603  82],655,2,36597,4.138995702329789,20.0,0.0
8842,0,8842,[318  64  98  79 588],577,5,36602,4.139093067963361,40.0,0.0
8843,0,8843,[588 127 288 313 385],450,4,36606,4.1390773405698775,0.0,20.0
8844,0,8844,[200 265 294 161 185],457,4,36610,4.139061616732617,0.0,0.0
8845,0,8845,[405 655 185 546  12],151,3,36613,4.138932851006104,0.0,0.0
8846,0,8846,[176 111  97 228  12],457,4,36617,4.138917147055499,0.0,0.0
8847,0,8847,[275 185 196 215  50],716,5,36622,4.139014466546112,0.0,40.0
8848,0,8848,[318  64  98  79 588],457,5,36627,4.139111764041135,40.0,0.0
8849,0,8849,[144 294 597 222 143],796,4,36631,4.13909604519774,0.0,0.0
8850,0,8850,[318  64  98  79 588],457,5,36636,4.139193311490227,40.0,0.0
8851,0,8851,[318  64  98  79 588],18,5,36641,4.139290555806597,40.0,0.0
8852,0,8852,[318  64  98  79 588],796,5,36646,4.139387778154298,40.0,0.0
8853,0,8853,[111 204   1 216 275],344,4,36650,4.139372035238311,0.0,20.0
8854,0,8854,[318  64  98  79 588],716,5,36655,4.139469226425748,40.0,0.0
8855,0,8855,[ 98   9 228 288 127],655,2,36657,4.139227642276423,0.0,20.0
8856,0,8856,[318  64  98  79 588],450,5,36662,4.139324827819803,40.0,0.0
8857,0,8857,[318  64  98  79 588],18,5,36667,4.1394219914201855,40.0,0.0
8858,0,8858,[ 22  70 245 748  97],450,5,36672,4.139519133084998,0.0,0.0
8859,0,8859,[318  64  98  79 588],18,5,36677,4.1396162528216705,40.0,0.0
8860,0,8860,[318  64  98  79 588],577,5,36682,4.139713350637625,40.0,0.0
8861,0,8861,[318  64  98  79 588],457,5,36687,4.139810426540285,40.0,0.0
8862,0,8862,[121 174 257 197  11],716,5,36692,4.139907480537064,0.0,0.0
8863,0,8863,[210 286 180 144 100],450,4,36696,4.139891696750903,0.0,40.0
8864,0,8864,[318  64  98  79 588],577,5,36701,4.139988719684151,40.0,0.0
8865,0,8865,[180 403 196 202 151],504,3,36704,4.13986013986014,0.0,0.0
8866,0,8866,[318  64  98  79 588],796,5,36709,4.139957144468253,40.0,0.0
8867,0,8867,[318  64  98  79 588],457,5,36714,4.140054127198917,40.0,0.0
8868,0,8868,[  7 125 357 385 121],151,4,36718,4.1400383357763,0.0,0.0
8869,0,8869,[318  64  98  79 588],716,5,36723,4.140135287485908,40.0,0.0
8870,0,8870,[318  64  98  79 588],796,5,36728,4.140232217337392,40.0,0.0
8871,0,8871,[318  64  98  79 588],577,5,36733,4.140329125338143,40.0,0.0
8872,0,8872,[ 71 174 173  11  98],577,4,36737,4.1403133100417,0.0,0.0
8873,0,8873,[288 197 588 210 118],280,2,36739,4.140072120802344,0.0,0.0
8874,0,8874,[318  64  98  79 588],796,5,36744,4.140169014084507,40.0,0.0
8875,0,8875,[318  64  98  79 588],457,5,36749,4.140265885534024,40.0,0.0
8876,0,8876,[318  64  98  79 588],18,5,36754,4.140362735158274,40.0,0.0
8877,0,8877,[318  64  98  79 588],457,5,36759,4.140459562964631,40.0,0.0
8878,0,8878,[132  97 175 546  82],716,3,36762,4.140331118369185,0.0,0.0
8879,0,8879,[ 50 121   8   4 143],577,4,36766,4.140315315315315,0.0,20.0
8880,0,8880,[318  64  98  79 588],716,5,36771,4.1404121157527305,40.0,0.0
8881,0,8881,[603 151 210  56 318],151,5,36776,4.140508894393155,40.0,0.0
8882,0,8882,[318  64  98  79 588],457,5,36781,4.140605651243949,40.0,0.0
8883,0,8883,[294 234 405   7  98],577,2,36783,4.140364700585322,0.0,0.0
8884,0,8884,[318  64  98  79 588],577,5,36788,4.1404614518852,40.0,0.0
8885,0,8885,[318  64  98  79 588],450,5,36793,4.140558181408958,40.0,0.0
8886,0,8886,[143 216 423 186 603],796,4,36797,4.1405423652526165,20.0,0.0
8887,0,8887,[117  71 210  97  56],504,4,36801,4.140526552655266,0.0,0.0
8888,0,8888,[588  96  95 187  97],716,3,36804,4.140398245021937,0.0,0.0
8889,0,8889,[318  64  98  79 588],450,5,36809,4.140494938132734,40.0,0.0
8890,0,8890,[174 216 313 202 742],577,5,36814,4.140591609492746,0.0,0.0
8891,0,8891,[318  64  98  79 588],577,5,36819,4.140688259109312,40.0,0.0
8892,0,8892,[182  50  89 187 288],256,4,36823,4.140672438996964,0.0,20.0
8893,0,8893,[181 194 200  97 216],716,5,36828,4.140769057791769,0.0,0.0
8894,0,8894,[318  64  98  79 588],450,5,36833,4.140865654862282,40.0,0.0
8895,0,8895,[318  64  98  79 588],18,5,36838,4.140962230215828,40.0,0.0
8896,0,8896,[318  64  98  79 588],457,5,36843,4.141058783859728,40.0,0.0
8897,0,8897,[ 82 275 195 357 200],457,5,36848,4.141155315801304,0.0,20.0
8898,0,8898,[318  64  98  79 588],450,5,36853,4.141251826047871,40.0,0.0
8899,0,8899,[568  71  88 100 191],344,3,36856,4.141123595505618,0.0,20.0
8900,0,8900,[269 385 125 176  96],796,4,36860,4.1411077407032915,0.0,0.0
8901,0,8901,[318  64  98  79 588],796,5,36865,4.14120422376994,40.0,0.0
8902,0,8902,[313 176   1  98 125],280,2,36867,4.1409637200943505,0.0,0.0
8903,0,8903,[318  64  98  79 588],18,5,36872,4.141060197663971,40.0,0.0
8904,0,8904,[318  64  98  79 588],577,5,36877,4.141156653565413,40.0,0.0
8905,0,8905,[318  64  98  79 588],457,5,36882,4.141253087805974,40.0,0.0
8906,0,8906,[603  56 385  71 286],796,4,36886,4.141237229145616,20.0,20.0
8907,0,8907,[ 82 202 322 318 197],280,2,36888,4.140996856757971,20.0,0.0
8908,0,8908,[318  64  98  79 588],450,5,36893,4.141093276462005,40.0,0.0
8909,0,8909,[127 483  50 515 318],269,4,36897,4.141077441077441,20.0,40.0
8910,0,8910,[318  64  98  79 588],457,5,36902,4.141173830097632,40.0,0.0
8911,0,8911,[ 82 271 471 191  15],655,1,36903,4.140821364452424,0.0,0.0
8912,0,8912,[318  64  98  79 588],796,5,36908,4.140917760574442,40.0,0.0
8913,0,8913,[286 435 125 546 168],450,5,36913,4.141014135068431,0.0,20.0
8914,0,8914,[328 318  22  79  82],450,4,36917,4.140998317442513,20.0,0.0
8915,0,8915,[318  64  98  79 588],18,5,36922,4.141094661283087,40.0,0.0
8916,0,8916,[318  64  98  79 588],457,5,36927,4.141190983514635,40.0,0.0
8917,0,8917,[318  64  98  79 588],457,5,36932,4.141287284144427,40.0,0.0
8918,0,8918,[496 121 204  11 161],577,4,36936,4.1412714429868815,20.0,0.0
8919,0,8919,[318  64  98  79 588],457,5,36941,4.141367713004485,40.0,0.0
8920,0,8920,[318  64  98  79 588],450,5,36946,4.1414639614393005,40.0,0.0
8921,0,8921,[318  64  98  79 588],577,5,36951,4.1415601882985875,40.0,0.0
8922,0,8922,[385 196 215 200 179],450,4,36955,4.141544323657962,0.0,0.0
8923,0,8923,[318  64  98  79 588],716,5,36960,4.141640519946212,40.0,0.0
8924,0,8924,[318  64  98  79 588],18,5,36965,4.1417366946778715,40.0,0.0
8925,0,8925,[ 98 211  71 151 187],18,4,36969,4.1417208155948915,0.0,0.0
8926,0,8926,[318  64  98  79 588],577,5,36974,4.141816959784922,40.0,0.0
8927,0,8927,[318  64  98  79 588],457,5,36979,4.141913082437276,40.0,0.0
8928,0,8928,[ 98 294 313  15 333],655,2,36981,4.141673199686415,0.0,0.0
8929,0,8929,[318  64  98  79 588],796,5,36986,4.141769316909294,40.0,0.0
8930,0,8930,[144 210  22 603 200],655,2,36988,4.141529503974919,20.0,0.0
8931,0,8931,[181 222 196 191 127],236,4,36992,4.141513658755038,0.0,20.0
8932,0,8932,[318 121 655 211 179],535,5,36997,4.141609761558267,20.0,0.0
8933,0,8933,[318  64  98  79 588],18,5,37002,4.141705842847549,40.0,0.0
8934,0,8934,[318  64  98  79 588],457,5,37007,4.141801902630107,40.0,0.0
8935,0,8935,[423 323  82 153 174],796,3,37010,4.141674127126231,0.0,0.0
8936,0,8936,[318  64  98  79 588],457,5,37015,4.141770168960501,40.0,0.0
8937,0,8937,[318  64  98  79 588],18,5,37020,4.1418661893040944,40.0,0.0
8938,0,8938,[196 174 127 655  56],629,5,37025,4.141962188164224,0.0,20.0
8939,0,8939,[318  64  98  79 588],18,5,37030,4.142058165548098,40.0,0.0
8940,0,8940,[204 202 127 568  97],655,1,37031,4.1417067442120565,0.0,20.0
8941,0,8941,[318  64  98  79 588],577,5,37036,4.1418027286960415,40.0,0.0
8942,0,8942,[125 175  97 333 655],655,0,37036,4.141339595214134,0.0,0.0
8943,0,8943,[275 111 423 228 180],786,5,37041,4.141435599284437,0.0,20.0
8944,0,8944,[318  64  98  79 588],457,5,37046,4.141531581889324,40.0,0.0
8945,0,8945,[318  64  98  79 588],18,5,37051,4.141627543035994,40.0,0.0
8946,0,8946,[318  64  98  79 588],716,5,37056,4.141723482731642,40.0,0.0
8947,0,8947,[234 423  88 174  98],503,5,37061,4.14181940098346,0.0,0.0
8948,0,8948,[318  64  98  79 588],18,5,37066,4.141915297798636,40.0,0.0
8949,0,8949,[245 405 282 300 172],450,5,37071,4.142011173184358,0.0,0.0
8950,0,8950,[318  64  98  79 588],796,5,37076,4.142107027147805,40.0,0.0
8951,0,8951,[318  64  98  79 588],450,5,37081,4.142202859696157,40.0,0.0
8952,0,8952,[210 483 111  98 568],269,2,37083,4.14196358762426,0.0,0.0
8953,0,8953,[318  64  98  79 588],450,5,37088,4.142059414786687,40.0,0.0
8954,0,8954,[318  64  98  79 588],716,5,37093,4.14215522054718,40.0,0.0
8955,0,8955,[318  64  98  79 588],716,5,37098,4.142251004912907,40.0,0.0
8956,0,8956,[318  64  98  79 588],450,5,37103,4.142346767891035,40.0,0.0
8957,0,8957,[318  64  98  79 588],577,5,37108,4.142442509488725,40.0,0.0
8958,0,8958,[742  82 655  98 508],280,2,37110,4.142203370911932,0.0,0.0
8959,0,8959,[318  64  98  79 588],716,5,37115,4.142299107142857,40.0,0.0
8960,0,8960,[ 22  12   4   9 678],280,3,37118,4.142171632630287,0.0,0.0
8961,0,8961,[294 403 151  88  28],450,5,37123,4.142267351037715,0.0,0.0
8962,0,8962,[318  64  98  79 588],796,5,37128,4.142363048086578,40.0,0.0
8963,0,8963,[211   4 135 300 185],389,3,37131,4.142235609103079,0.0,0.0
8964,0,8964,[ 64 121 211  96 194],796,4,37135,4.142219743446737,20.0,0.0
8965,0,8965,[318  64  98  79 588],716,5,37140,4.142315413785411,40.0,0.0
8966,0,8966,[186 405  82 121  25],716,4,37144,4.142299542767927,0.0,0.0
8967,0,8967,[323 322 183 117 300],504,4,37148,4.14228367528992,0.0,0.0
8968,0,8968,[318  64  98  79 588],18,5,37153,4.1423793065001675,40.0,0.0
8969,0,8969,[318  64  98  79 588],457,5,37158,4.14247491638796,40.0,0.0
8970,0,8970,[318  64  98  79 588],450,5,37163,4.142570504960428,40.0,0.0
8971,0,8971,[318  64  98  79 588],577,5,37168,4.142666072224699,40.0,0.0
8972,0,8972,[187  50  98 144 234],629,5,37173,4.1427616181878975,0.0,20.0
8973,0,8973,[483 294 172 143 176],23,2,37175,4.142522843770894,0.0,0.0
8974,0,8974,[ 88 294 194 117 168],796,4,37179,4.142506963788301,0.0,0.0
8975,0,8975,[318  64  98  79 588],796,5,37184,4.142602495543672,40.0,0.0
8976,0,8976,[318  64  98  79 588],457,5,37189,4.142698006015372,40.0,0.0
8977,0,8977,[318  64  98  79 588],18,5,37194,4.1427934952105145,40.0,0.0
8978,0,8978,[318  64  98  79 588],796,5,37199,4.1428889631362065,40.0,0.0
8979,0,8979,[318  64  98  79 588],450,5,37204,4.1429844097995545,40.0,0.0
8980,0,8980,[228 237 483 175 235],716,3,37207,4.142857142857143,0.0,0.0
8981,0,8981,[318  64  98  79 588],457,5,37212,4.142952571810287,40.0,0.0
8982,0,8982,[318  64  98  79 588],457,5,37217,4.143047979516865,40.0,0.0
8983,0,8983,[210 204   1 195 282],796,3,37220,4.142920747996438,0.0,0.0
8984,0,8984,[385 202 215 210  88],344,2,37222,4.14268224819143,0.0,0.0
8985,0,8985,[318  64  98  79 588],457,5,37227,4.142777654128644,40.0,0.0
8986,0,8986,[ 89 153 183 423 273],796,4,37231,4.142761766996773,0.0,0.0
8987,0,8987,[ 82 238 144  50  25],655,1,37232,4.142412105028927,0.0,20.0
8988,0,8988,[132  56 508 174 300],655,0,37232,4.141951273779063,0.0,0.0
8989,0,8989,[318  64  98  79 588],18,5,37237,4.1420467185761956,40.0,0.0
8990,0,8990,[318  64  98  79 588],716,5,37242,4.142142142142142,40.0,0.0
8991,0,8991,[318  64  98  79 588],18,5,37247,4.142237544483986,40.0,0.0
8992,0,8992,[ 89 186  88 179 181],786,5,37252,4.142332925608807,0.0,0.0
8993,0,8993,[318  64  98  79 588],457,5,37257,4.142428285523683,40.0,0.0
8994,0,8994,[318  64  98  79 588],577,5,37262,4.142523624235687,40.0,0.0
8995,0,8995,[282 405 216 111 742],655,1,37263,4.142174299688751,0.0,0.0
8996,0,8996,[318  64  98  79 588],457,5,37268,4.142269645437368,40.0,0.0
8997,0,8997,[318  64  98  79 588],457,5,37273,4.142364969993332,40.0,0.0
8998,0,8998,[546 161 202 176 204],577,4,37277,4.142349149905545,0.0,0.0
8999,0,8999,[318  64  98  79 588],457,5,37282,4.142444444444444,40.0,0.0
9000,0,9000,[195  50   1 197 215],655,1,37283,4.142095322741918,0.0,20.0
9001,0,9001,[318  64  98  79 588],577,5,37288,4.14219062430571,40.0,0.0
9002,0,9002,[655 215 151 200  69],796,4,37292,4.142174830612018,0.0,0.0
9003,0,9003,[318  64  98  79 588],796,5,37297,4.14227010217681,40.0,0.0
9004,0,9004,[195 222 174 185 127],450,4,37301,4.142254303164909,0.0,20.0
9005,0,9005,[318  64  98  79 588],18,5,37306,4.142349544747946,40.0,0.0
9006,0,9006,[318  64  98  79 588],457,5,37311,4.142444765182636,40.0,0.0
9007,0,9007,[515 265 153 475 118],292,4,37315,4.1424289520426285,0.0,0.0
9008,0,9008,[216 135 153 318   7],885,1,37316,4.142080142080142,20.0,0.0
9009,0,9009,[318  64  98  79 588],716,5,37321,4.142175360710322,40.0,0.0
9010,0,9010,[238 183 153  50 258],504,1,37322,4.141826656308956,0.0,20.0
9011,0,9011,[318  64  98  79 588],457,5,37327,4.141921881935198,40.0,0.0
9012,0,9012,[318  64  98  79 588],18,5,37332,4.1420170864307115,40.0,0.0
9013,0,9013,[318  64  98  79 588],457,5,37337,4.14211226980253,40.0,0.0
9014,0,9014,[161 385 111 245 265],280,4,37341,4.142096505823627,0.0,0.0
9015,0,9015,[318  64  98  79 588],450,5,37346,4.142191659272404,40.0,0.0
9016,0,9016,[318  64  98  79 588],716,5,37351,4.142286791615836,40.0,0.0
9017,0,9017,[678 235  88  98   1],256,4,37355,4.142271013528498,0.0,0.0
9018,0,9018,[603 187 471 742 427],450,5,37360,4.1423661159773815,40.0,0.0
9019,0,9019,[318  64  98  79 588],18,5,37365,4.142461197339246,40.0,0.0
9020,0,9020,[496 121 191 127 471],786,4,37369,4.1424454051657245,20.0,20.0
9021,0,9021,[161 271   7  88 196],655,0,37369,4.141986255819109,0.0,0.0
9022,0,9022,[161 318 196 435 238],450,5,37374,4.142081347667073,20.0,0.0
9023,0,9023,[153 211 423 318 257],504,4,37378,4.14206560283688,20.0,0.0
9024,0,9024,[301 423  88 655 200],593,4,37382,4.1420498614958445,0.0,0.0
9025,0,9025,[ 70 132 196 275 603],450,5,37387,4.142144914690893,20.0,20.0
9026,0,9026,[ 96 186 151 258 210],796,3,37390,4.142018389276615,0.0,0.0
9027,0,9027,[318  64  98  79 588],450,5,37395,4.14211342490031,40.0,0.0
9028,0,9028,[318  64  98  79 588],577,5,37400,4.14220843947281,40.0,0.0
9029,0,9029,[318  64  98  79 588],457,5,37405,4.142303433001107,40.0,0.0
9030,0,9030,[  9 215  56 515 194],535,3,37408,4.142176946074632,0.0,0.0
9031,0,9031,[318  64  98  79 588],450,5,37413,4.142271922054916,40.0,0.0
9032,0,9032,[183 144 161 143 435],716,2,37415,4.1420347614303115,0.0,0.0
9033,0,9033,[318  64  98  79 588],796,5,37420,4.142129732123091,40.0,0.0
9034,0,9034,[111  22  88 568 186],269,0,37420,4.141671278361926,0.0,0.0
9035,0,9035,[318  64  98  79 588],796,5,37425,4.141766268260292,40.0,0.0
9036,0,9036,[318  64  98  79 588],716,5,37430,4.141861237136218,40.0,0.0
9037,0,9037,[318  64  98  79 588],18,5,37435,4.141956184996681,40.0,0.0
9038,0,9038,[318  64  98  79 588],457,5,37440,4.142051111848656,40.0,0.0
9039,0,9039,[275 172 144 318 222],796,5,37445,4.142146017699115,20.0,20.0
9040,0,9040,[318  64  98  79 588],716,5,37450,4.142240902555027,40.0,0.0
9041,0,9041,[197 471 302 135  56],450,4,37454,4.142225171422251,0.0,0.0
9042,0,9042,[181 271   9 238 328],655,0,37454,4.141767112683844,0.0,0.0
9043,0,9043,[275   8  15 153 471],593,2,37456,4.141530296329058,0.0,20.0
9044,0,9044,[318  64  98  79 588],18,5,37461,4.141625207296849,40.0,0.0
9045,0,9045,[318  64  98  79 588],577,5,37466,4.141720097280566,40.0,0.0
9046,0,9046,[318  64  98  79 588],457,5,37471,4.141814966287167,40.0,0.0
9047,0,9047,[655  50  25 191  64],72,4,37475,4.141799292661362,20.0,20.0
9048,0,9048,[318  64  98  79 588],716,5,37480,4.141894131948281,40.0,0.0
9049,0,9049,[  1 161  22 182  79],457,5,37485,4.141988950276243,0.0,0.0
9050,0,9050,[546  50  64 275 403],796,5,37490,4.142083747652193,20.0,40.0
9051,0,9051,[405 197  89 179  82],786,4,37494,4.142068051259391,0.0,0.0
9052,0,9052,[318  64  98  79 588],450,5,37499,4.142162818955042,40.0,0.0
9053,0,9053,[144 471 187 273 175],655,2,37501,4.141926220455048,0.0,0.0
9054,0,9054,[318  64  98  79 588],796,5,37506,4.142020982882386,40.0,0.0
9055,0,9055,[318  64  98  79 588],716,5,37511,4.142115724381625,40.0,0.0
9056,0,9056,[196 172 515 748 143],401,3,37514,4.141989621287402,0.0,0.0
9057,0,9057,[318  64  98  79 588],716,5,37519,4.142084345330095,40.0,0.0
9058,0,9058,[318  64  98  79 588],577,5,37524,4.142179048460095,40.0,0.0
9059,0,9059,[318  64  98  79 588],18,5,37529,4.142273730684327,40.0,0.0
9060,0,9060,[ 82 121  98 144  79],655,2,37531,4.142037302725968,0.0,0.0
9061,0,9061,[318  64  98  79 588],457,5,37536,4.1421319796954315,40.0,0.0
9062,0,9062,[471 273   4  28 265],655,1,37537,4.141785280812093,0.0,0.0
9063,0,9063,[222  95 216  96 471],716,3,37540,4.141659311562224,0.0,0.0
9064,0,9064,[ 15 435 204 202  56],151,5,37545,4.141753998896856,0.0,0.0
9065,0,9065,[318  64  98  79 588],716,5,37550,4.14184866534304,40.0,0.0
9066,0,9066,[ 88 271 176 200  69],796,5,37555,4.1419433109076875,0.0,0.0
9067,0,9067,[385 151 483 603 318],716,4,37559,4.141927657697398,40.0,0.0
9068,0,9068,[318  64  98  79 588],457,5,37564,4.142022273679568,40.0,0.0
9069,0,9069,[ 50 300   4 197 322],151,4,37568,4.142006615214995,0.0,20.0
9070,0,9070,[483 269  69 403 235],450,3,37571,4.141880718774115,0.0,0.0
9071,0,9071,[318  64  98  79 588],716,5,37576,4.1419753086419755,40.0,0.0
9072,0,9072,[318  64  98  79 588],577,5,37581,4.142069877658988,40.0,0.0
9073,0,9073,[ 28 237 151 678 118],504,3,37584,4.141944015869517,0.0,0.0
9074,0,9074,[597 210 328 143 183],450,4,37588,4.141928374655647,0.0,0.0
9075,0,9075,[ 82 181  11 200 228],716,5,37593,4.142022917584839,0.0,0.0
9076,0,9076,[318  64  98  79 588],457,5,37598,4.142117439682715,40.0,0.0
9077,0,9077,[191 135 546  79 483],450,3,37601,4.141991628111919,0.0,0.0
9078,0,9078,[238 475 182 435 269],655,1,37602,4.141645555677938,0.0,0.0
9079,0,9079,[318  64  98  79 588],457,5,37607,4.141740088105727,40.0,0.0
9080,0,9080,[300 568 742 328  64],655,1,37608,4.141394119590354,20.0,0.0
9081,0,9081,[318  64  98  79 588],18,5,37613,4.141488658885708,40.0,0.0
9082,0,9082,[318  64  98  79 588],577,5,37618,4.141583177364307,40.0,0.0
9083,0,9083,[ 98 118  97 265 180],457,5,37623,4.1416776750330255,0.0,0.0
9084,0,9084,[117 238 237 301 318],593,5,37628,4.141772151898734,20.0,0.0
9085,0,9085,[318  64  98  79 588],450,5,37633,4.141866607968303,40.0,0.0
9086,0,9086,[161 228  56 475 286],655,0,37633,4.141410806646858,0.0,20.0
9087,0,9087,[238 174  64  11 197],330,5,37638,4.141505281690141,20.0,0.0
9088,0,9088,[318  64  98  79 588],18,5,37643,4.141599735944548,40.0,0.0
9089,0,9089,[318  64  98  79 588],18,5,37648,4.141694169416942,40.0,0.0
9090,0,9090,[318  64  98  79 588],450,5,37653,4.141788582114179,40.0,0.0
9091,0,9091,[318  64  98  79 588],18,5,37658,4.1418829740431145,40.0,0.0
9092,0,9092,[318  64  98  79 588],18,5,37663,4.141977345210601,40.0,0.0
9093,0,9093,[318  64  98  79 588],716,5,37668,4.142071695623488,40.0,0.0
9094,0,9094,[204 328 603 322 183],450,5,37673,4.1421660252886205,20.0,0.0
9095,0,9095,[202  50 172 195 237],256,3,37676,4.142040457343888,0.0,20.0
9096,0,9096,[228 276 222  96 385],655,1,37677,4.141695064306915,0.0,0.0
9097,0,9097,[318  64  98  79 588],716,5,37682,4.1417894042646735,40.0,0.0
9098,0,9098,[318  64  98  79 588],457,5,37687,4.141883723486098,40.0,0.0
9099,0,9099,[  9 211 603 475 328],655,1,37688,4.141538461538461,20.0,0.0
9100,0,9100,[289 318 181 191  97],693,2,37690,4.141303153499615,20.0,0.0
9101,0,9101,[318  64  98  79 588],796,5,37695,4.141397495056031,40.0,0.0
9102,0,9102,[318  64  98  79 588],796,5,37700,4.141491815884873,40.0,0.0
9103,0,9103,[257 111 405 144 282],401,2,37702,4.141256590509666,0.0,0.0
9104,0,9104,[318  64  98  79 588],18,5,37707,4.141350906095552,40.0,0.0
9105,0,9105,[318  64  98  79 588],796,5,37712,4.141445200966396,40.0,0.0
9106,0,9106,[318  64  98  79 588],18,5,37717,4.141539475129021,40.0,0.0
9107,0,9107,[318  64  98  79 588],716,5,37722,4.14163372859025,40.0,0.0
9108,0,9108,[318  64  98  79 588],18,5,37727,4.141727961356899,40.0,0.0
9109,0,9109,[245 151 423  95 300],885,4,37731,4.1417124039517015,0.0,0.0
9110,0,9110,[318  64  98  79 588],577,5,37736,4.141806607397651,40.0,0.0
9111,0,9111,[318  64  98  79 588],18,5,37741,4.141900790166813,40.0,0.0
9112,0,9112,[117 111 597 302 385],344,2,37743,4.1416657522221,0.0,0.0
9113,0,9113,[318  64  98  79 588],716,5,37748,4.141759929778363,40.0,0.0
9114,0,9114,[318  64  98  79 588],18,5,37753,4.141854086670324,40.0,0.0
9115,0,9115,[318  64  98  79 588],450,5,37758,4.141948222904783,40.0,0.0
9116,0,9116,[172 186 210 180 181],693,0,37758,4.141493912471208,0.0,0.0
9117,0,9117,[318  64  98  79 588],450,5,37763,4.141588067558676,40.0,0.0
9118,0,9118,[  1 471 200 111 546],786,5,37768,4.141682201995833,0.0,0.0
9119,0,9119,[318 174 211 185 300],450,5,37773,4.141776315789474,20.0,0.0
9120,0,9120,[742 496  11 121 228],450,4,37777,4.141760771845193,20.0,0.0
9121,0,9121,[288 245 603  95  56],450,3,37780,4.141635606226704,20.0,0.0
9122,0,9122,[318  64  98  79 588],716,5,37785,4.1417296941795465,40.0,0.0
9123,0,9123,[318  64  98  79 588],18,5,37790,4.14182376150811,40.0,0.0
9124,0,9124,[300  64  28 357 405],450,5,37795,4.141917808219178,20.0,0.0
9125,0,9125,[318  64  98  79 588],18,5,37800,4.1420118343195265,40.0,0.0
9126,0,9126,[318  64  98  79 588],796,5,37805,4.1421058398159305,40.0,0.0
9127,0,9127,[ 95 121 202  89 211],796,4,37809,4.142090271691499,0.0,0.0
9128,0,9128,[210 405 117  82 313],796,3,37812,4.14196516595465,0.0,0.0
9129,0,9129,[318  64  98  79 588],457,5,37817,4.142059145673604,40.0,0.0
9130,0,9130,[318  64  98  79 588],18,5,37822,4.1421531048077975,40.0,0.0
9131,0,9131,[ 28 175 222 161  82],655,0,37822,4.141699518177836,0.0,0.0
9132,0,9132,[ 28  98  11 508 238],655,1,37823,4.141355523924231,0.0,0.0
9133,0,9133,[276 546 194 258 176],504,2,37825,4.141121086052113,0.0,0.0
9134,0,9134,[318  64  98  79 588],18,5,37830,4.141215106732348,40.0,0.0
9135,0,9135,[318  64  98  79 588],18,5,37835,4.141309106830122,40.0,0.0
9136,0,9136,[385 176 183 172 181],280,1,37836,4.140965305899091,0.0,0.0
9137,0,9137,[318  64  98  79 588],716,5,37841,4.141059312759904,40.0,0.0
9138,0,9138,[172 427 282 471 655],450,5,37846,4.141153299048036,20.0,0.0
9139,0,9139,[234 172 435 153  25],151,4,37850,4.141137855579869,0.0,0.0
9140,0,9140,[385 568 286 132 173],344,3,37853,4.141013018269336,0.0,20.0
9141,0,9141,[318  64  98  79 588],577,5,37858,4.141106978779261,40.0,0.0
9142,0,9142,[318  64  98  79 588],577,5,37863,4.141200918735644,40.0,0.0
9143,0,9143,[183 273  28 328 202],796,3,37866,4.141076115485564,0.0,0.0
9144,0,9144,[ 97 195 235 153 172],450,4,37870,4.141060688901039,0.0,0.0
9145,0,9145,[161 423  56 405 191],655,1,37871,4.140717253444128,0.0,0.0
9146,0,9146,[127 228 144 180 483],450,4,37875,4.140701869465398,0.0,20.0
9147,0,9147,[318  64  98  79 588],18,5,37880,4.140795802361172,40.0,0.0
9148,0,9148,[182 286 210   1 471],593,1,37881,4.140452508470871,0.0,20.0
9149,0,9149,[273 121 228  96 186],655,1,37882,4.140109289617486,0.0,0.0
9150,0,9150,[318  64  98  79 588],716,5,37887,4.140203256474702,40.0,0.0
9151,0,9151,[228 210 265  70 216],151,5,37892,4.1402972027972025,0.0,0.0
9152,0,9152,[318  64  98  79 588],796,5,37897,4.140391128591719,40.0,0.0
9153,0,9153,[174 144 405 282  22],796,5,37902,4.1404850338649775,0.0,0.0
9154,0,9154,[222  70 172 194 568],450,4,37906,4.1404696886947026,0.0,0.0
9155,0,9155,[318  64  98  79 588],577,5,37911,4.1405635648754915,40.0,0.0
9156,0,9156,[318  64  98  79 588],796,5,37916,4.140657420552583,40.0,0.0
9157,0,9157,[435 322 258 202 180],450,5,37921,4.140751255732693,0.0,0.0
9158,0,9158,[318  64  98  79 588],716,5,37926,4.140845070422535,40.0,0.0
9159,0,9159,[318  64  98  79 588],450,5,37931,4.140938864628821,40.0,0.0
9160,0,9160,[318  64  98  79 588],716,5,37936,4.141032638358258,40.0,0.0
9161,0,9161,[318  64  98  79 588],796,5,37941,4.141126391617551,40.0,0.0
9162,0,9162,[318  64  98  79 588],577,5,37946,4.141220124413402,40.0,0.0
9163,0,9163,[318  64  98  79 588],796,5,37951,4.14131383675251,40.0,0.0
9164,0,9164,[245 322 176  98 546],344,2,37953,4.141080196399345,0.0,0.0
9165,0,9165,[318  64  98  79 588],796,5,37958,4.141173903556623,40.0,0.0
9166,0,9166,[318  64  98  79 588],716,5,37963,4.141267590269445,40.0,0.0
9167,0,9167,[318  64  98  79 588],18,5,37968,4.141361256544503,40.0,0.0
9168,0,9168,[289 100 176 132 427],236,3,37971,4.141236776093358,20.0,20.0
9169,0,9169,[568 508  97 161  50],655,1,37972,4.140894220283533,0.0,20.0
9170,0,9170,[269 271 328 258 182],655,1,37973,4.140551739177843,0.0,0.0
9171,0,9171,[318  64  98  79 588],450,5,37978,4.140645442651548,40.0,0.0
9172,0,9172,[276  64 268 234 568],655,2,37980,4.1404120789272865,20.0,0.0
9173,0,9173,[318  64  98  79 588],716,5,37985,4.140505777196425,40.0,0.0
9174,0,9174,[475 238 175  22 200],269,4,37989,4.140490463215259,0.0,0.0
9175,0,9175,[318  64  98  79 588],18,5,37994,4.140584132519616,40.0,0.0
9176,0,9176,[100 471   9 435 111],401,4,37998,4.140568813337692,0.0,20.0
9177,0,9177,[318  64  98  79 588],457,5,38003,4.140662453693615,40.0,0.0
9178,0,9178,[318  64  98  79 588],450,5,38008,4.140756073646367,40.0,0.0
9179,0,9179,[318  64  98  79 588],457,5,38013,4.140849673202615,40.0,0.0
9180,0,9180,[302 403  96 176 333],655,1,38014,4.140507569981484,0.0,0.0
9181,0,9181,[318  64  98  79 588],18,5,38019,4.140601176214332,40.0,0.0
9182,0,9182,[ 79 100 234 197 748],796,2,38021,4.14036807143635,0.0,20.0
9183,0,9183,[318  64  98  79 588],716,5,38026,4.140461672473868,40.0,0.0
9184,0,9184,[318  64  98  79 588],450,5,38031,4.1405552531301035,40.0,0.0
9185,0,9185,[228 234 655  64 322],450,4,38035,4.140539952101023,20.0,0.0
9186,0,9186,[655 238  50 132 135],535,4,38039,4.14052465440296,0.0,20.0
9187,0,9187,[318  64  98  79 588],577,5,38044,4.140618197649108,40.0,0.0
9188,0,9188,[182 546 313 228  97],796,4,38048,4.140602894765481,0.0,0.0
9189,0,9189,[318  64  98  79 588],716,5,38053,4.14069640914037,40.0,0.0
9190,0,9190,[117  96   9  98 196],344,4,38057,4.14068110107714,0.0,0.0
9191,0,9191,[322 603  98  50 204],796,4,38061,4.140665796344647,20.0,20.0
9192,0,9192,[318  64  98  79 588],796,5,38066,4.140759273360166,40.0,0.0
9193,0,9193,[385 144 176 238 216],450,5,38071,4.140852730041331,0.0,0.0
9194,0,9194,[318  64  98  79 588],577,5,38076,4.14094616639478,40.0,0.0
9195,0,9195,[ 11 515 127 435 191],269,3,38079,4.140822096563723,0.0,20.0
9196,0,9196,[328 237  15  69  70],65,3,38082,4.140698053713168,0.0,0.0
9197,0,9197,[275 182 180  11  69],457,5,38087,4.140791476407915,0.0,20.0
9198,0,9198,[318  64  98  79 588],450,5,38092,4.140884878791173,40.0,0.0
9199,0,9199,[318  64  98  79 588],716,5,38097,4.1409782608695656,40.0,0.0
9200,0,9200,[ 82  64 100 121   7],151,3,38100,4.140854254972286,20.0,20.0
9201,0,9201,[318  64  98  79 588],577,5,38105,4.14094762008259,40.0,0.0
9202,0,9202,[ 25 403 603 237 234],72,3,38108,4.140823644463762,20.0,0.0
9203,0,9203,[568   1   8 268 271],655,0,38108,4.140373750543242,0.0,0.0
9204,0,9204,[318  64  98  79 588],577,5,38113,4.140467137425312,40.0,0.0
9205,0,9205,[748   1 318  70 117],401,2,38115,4.140234629589398,20.0,0.0
9206,0,9206,[238 211 183 111 179],593,5,38120,4.140328011295753,0.0,0.0
9207,0,9207,[318  64  98  79 588],450,5,38125,4.140421372719374,40.0,0.0
9208,0,9208,[427 275  71 197 172],316,3,38128,4.140297535020089,20.0,20.0
9209,0,9209,[202 471 357 496 151],450,5,38133,4.140390879478828,20.0,0.0
9210,0,9210,[318  64  98  79 588],457,5,38138,4.1404842036695255,40.0,0.0
9211,0,9211,[318  64  98  79 588],796,5,38143,4.140577507598784,40.0,0.0
9212,0,9212,[655  97 546  71 235],450,3,38146,4.140453706718767,0.0,0.0
9213,0,9213,[195 318 204 234 405],786,4,38150,4.140438463208161,20.0,0.0
9214,0,9214,[318  64  98  79 588],796,5,38155,4.1405317417254475,40.0,0.0
9215,0,9215,[275 238 245 655  22],796,2,38157,4.140299479166667,0.0,20.0
9216,0,9216,[318  64  98  79 588],457,5,38162,4.140392752522513,40.0,0.0
9217,0,9217,[603 100  70 427  50],18,4,38166,4.140377522239097,40.0,40.0
9218,0,9218,[318  64  98  79 588],716,5,38171,4.140470766894457,40.0,0.0
9219,0,9219,[ 82 275 328 182 180],796,3,38174,4.1403470715835144,0.0,20.0
9220,0,9220,[318  64  98  79 588],18,5,38179,4.140440299316777,40.0,0.0
9221,0,9221,[318  64  98  79 588],18,5,38184,4.14053350683149,40.0,0.0
9222,0,9222,[ 82 282 186 118  11],655,0,38184,4.1400845711807435,0.0,0.0
9223,0,9223,[172 183 196 175 238],716,3,38187,4.139960971379011,0.0,0.0
9224,0,9224,[318  64  98  79 588],577,5,38192,4.140054200542005,40.0,0.0
9225,0,9225,[237 200  50 568 186],577,3,38195,4.139930630825927,0.0,20.0
9226,0,9226,[210 180 168 603 172],796,3,38198,4.139807087894224,20.0,0.0
9227,0,9227,[318  64  98  79 588],796,5,38203,4.13990030342436,40.0,0.0
9228,0,9228,[318  64  98  79 588],450,5,38208,4.1399934987539275,40.0,0.0
9229,0,9229,[237  15 275   7 234],457,5,38213,4.140086673889491,0.0,20.0
9230,0,9230,[328 423 125 222  82],450,3,38216,4.139963167587477,0.0,0.0
9231,0,9231,[318  64  98  79 588],457,5,38221,4.140056325823224,40.0,0.0
9232,0,9232,[ 56  12 197 496   4],18,4,38225,4.140041156720459,20.0,0.0
9233,0,9233,[318  64  98  79 588],577,5,38230,4.140134286333117,40.0,0.0
9234,0,9234,[173 135 191 471 176],716,2,38232,4.139902544667027,0.0,0.0
9235,0,9235,[318  64  98  79 588],450,5,38237,4.1399956691208315,40.0,0.0
9236,0,9236,[100 194 258 118 597],796,4,38241,4.139980513153621,0.0,20.0
9237,0,9237,[ 15  69 194 742 313],450,4,38245,4.139965360467634,0.0,0.0
9238,0,9238,[194 258 286  89 275],151,5,38250,4.14005844788397,0.0,40.0
9239,0,9239,[318  64  98  79 588],796,5,38255,4.140151515151516,40.0,0.0
9240,0,9240,[403  64 435  98 194],18,3,38258,4.140028135483173,20.0,0.0
9241,0,9241,[197 423 258 135 403],693,2,38260,4.139796580826661,0.0,0.0
9242,0,9242,[603 597 185 234  96],796,4,38264,4.139781456237152,20.0,0.0
9243,0,9243,[405 258 265 483 127],655,2,38266,4.139549978364345,0.0,20.0
9244,0,9244,[238 603 301 313  64],450,5,38271,4.139643050297458,40.0,0.0
9245,0,9245,[151  28  82 546  50],23,1,38272,4.1393034825870645,0.0,20.0
9246,0,9246,[318  64  98  79 588],796,5,38277,4.139396561046826,40.0,0.0
9247,0,9247,[318  64  98  79 588],796,5,38282,4.139489619377162,40.0,0.0
9248,0,9248,[269   7 258   9 195],344,4,38286,4.139474537787869,0.0,0.0
9249,0,9249,[ 88 132  64 135 222],693,2,38288,4.139243243243243,20.0,0.0
9250,0,9250,[258 235 222 322 655],450,3,38291,4.139120095124851,0.0,0.0
9251,0,9251,[161  22 173   7 111],450,5,38296,4.139213143104194,0.0,0.0
9252,0,9252,[  4  64 100 161   7],577,4,38300,4.13919809791419,20.0,20.0
9253,0,9253,[168 197 179  95 302],450,4,38304,4.139183055975794,0.0,0.0
9254,0,9254,[318  64  98  79 588],450,5,38309,4.139276066990816,40.0,0.0
9255,0,9255,[318  64  98  79 588],457,5,38314,4.139369057908384,40.0,0.0
9256,0,9256,[318  64  98  79 588],796,5,38319,4.139462028735012,40.0,0.0
9257,0,9257,[333 228 286 318 483],655,2,38321,4.139230935407215,20.0,20.0
9258,0,9258,[318  64  98  79 588],796,5,38326,4.13932390106923,40.0,0.0
9259,0,9259,[257 161 211 100  70],23,2,38328,4.1390928725701945,0.0,20.0
9260,0,9260,[275 302 176 118 132],655,2,38330,4.138861893963935,0.0,20.0
9261,0,9261,[318  64  98  79 588],716,5,38335,4.1389548693586695,40.0,0.0
9262,0,9262,[318  64  98  79 588],577,5,38340,4.13904782467883,40.0,0.0
9263,0,9263,[313 222  88 294 180],450,4,38344,4.139032815198618,0.0,0.0
9264,0,9264,[318  64  98  79 588],577,5,38349,4.139125742039935,40.0,0.0
9265,0,9265,[ 50  96 144 191 183],716,2,38351,4.138894884524066,0.0,20.0
9266,0,9266,[318  64  98  79 588],796,5,38356,4.138987806194022,40.0,0.0
9267,0,9267,[471 200  25  56 161],593,3,38359,4.138864911523521,0.0,0.0
9268,0,9268,[282 302 273 210 405],655,2,38361,4.138634156866976,0.0,0.0
9269,0,9269,[300  25 135 181 265],151,5,38366,4.138727076591154,0.0,0.0
9270,0,9270,[318  64  98  79 588],450,5,38371,4.1388199762700895,40.0,0.0
9271,0,9271,[318  64  98  79 588],457,5,38376,4.1389128559102675,40.0,0.0
9272,0,9272,[318  64  98  79 588],18,5,38381,4.139005715518171,40.0,0.0
9273,0,9273,[742  22 286 603 435],11,4,38385,4.1389907267629935,20.0,20.0
9274,0,9274,[318  64  98  79 588],577,5,38390,4.139083557951483,40.0,0.0
9275,0,9275,[228 597 405  88 655],457,4,38394,4.139068564036222,0.0,0.0
9276,0,9276,[318  64  98  79 588],450,5,38399,4.13916136682117,40.0,0.0
9277,0,9277,[318  64  98  79 588],450,5,38404,4.139254149601207,40.0,0.0
9278,0,9278,[111 322 328 176 204],450,5,38409,4.1393469123828,0.0,0.0
9279,0,9279,[483 118 568 200  56],796,5,38414,4.1394396551724135,0.0,0.0
9280,0,9280,[313 180 161 483 200],280,4,38418,4.139424630966491,0.0,0.0
9281,0,9281,[318  64  98  79 588],796,5,38423,4.139517345399699,40.0,0.0
9282,0,9282,[318  64  98  79 588],450,5,38428,4.139610039857804,40.0,0.0
9283,0,9283,[318  64  98  79 588],716,5,38433,4.139702714347264,40.0,0.0
9284,0,9284,[318  64  98  79 588],796,5,38438,4.139795368874529,40.0,0.0
9285,0,9285,[405 187  15 235 216],269,1,38439,4.139457247469308,0.0,0.0
9286,0,9286,[180 176   9 222 568],457,5,38444,4.139549908474211,0.0,0.0
9287,0,9287,[318  64  98  79 588],450,5,38449,4.13964254952627,40.0,0.0
9288,0,9288,[173 568 215 151 180],796,4,38453,4.139627516417268,0.0,0.0
9289,0,9289,[153 403  88 161  15],796,5,38458,4.139720129171152,0.0,0.0
9290,0,9290,[118 135 186 197 196],693,1,38459,4.139382197825853,0.0,0.0
9291,0,9291,[318  64  98  79 588],716,5,38464,4.139474817046922,40.0,0.0
9292,0,9292,[318  64  98  79 588],796,5,38469,4.1395674163348755,40.0,0.0
9293,0,9293,[222 234 132 210 125],655,0,38469,4.139122014202711,0.0,0.0
9294,0,9294,[318  64  98  79 588],716,5,38474,4.139214631522324,40.0,0.0
9295,0,9295,[ 97  79 427 603  50],655,4,38478,4.139199655765921,40.0,20.0
9296,0,9296,[318  64  98  79 588],796,5,38483,4.139292244810154,40.0,0.0
9297,0,9297,[318  64  98  79 588],716,5,38488,4.139384813938482,40.0,0.0
9298,0,9298,[265  95  50 357 302],450,4,38492,4.139369824712334,0.0,20.0
9299,0,9299,[301 568  97 269 127],655,1,38493,4.139032258064516,0.0,20.0
9300,0,9300,[318  64  98  79 588],796,5,38498,4.139124825287603,40.0,0.0
9301,0,9301,[318  64  98  79 588],18,5,38503,4.139217372608042,40.0,0.0
9302,0,9302,[ 22 181 135 471 215],655,1,38504,4.138879931204988,0.0,0.0
9303,0,9303,[175 125  50 182 289],655,2,38506,4.1386500429922615,0.0,20.0
9304,0,9304,[496   9 117 181 144],280,3,38509,4.138527673293928,20.0,0.0
9305,0,9305,[742 196 222 234 228],457,5,38514,4.1386202450032235,0.0,0.0
9306,0,9306,[318  64  98  79 588],796,5,38519,4.138712796819598,40.0,0.0
9307,0,9307,[318  64  98  79 588],450,5,38524,4.138805328749463,40.0,0.0
9308,0,9308,[318  64  98  79 588],577,5,38529,4.138897840799227,40.0,0.0
9309,0,9309,[318  64  98  79 588],457,5,38534,4.138990332975295,40.0,0.0
9310,0,9310,[288  50 118 405 181],593,4,38538,4.138975405434432,0.0,20.0
9311,0,9311,[318  64  98  79 588],577,5,38543,4.139067869415808,40.0,0.0
9312,0,9312,[ 69   4 176 143 186],504,3,38546,4.138945559969934,0.0,0.0
9313,0,9313,[161 286  98 423 568],796,4,38550,4.138930642044235,0.0,20.0
9314,0,9314,[318  64  98  79 588],716,5,38555,4.139023081052066,40.0,0.0
9315,0,9315,[483 568   7 300 403],450,4,38559,4.139008158007728,0.0,0.0
9316,0,9316,[ 11 265 100 173 423],450,5,38564,4.139100568852635,0.0,20.0
9317,0,9317,[318  64  98  79 588],18,5,38569,4.139192959862632,40.0,0.0
9318,0,9318,[186 238 357 161 269],450,4,38573,4.139178023393068,0.0,0.0
9319,0,9319,[588 144 187   1 194],450,5,38578,4.1392703862660944,0.0,0.0
9320,0,9320,[ 64 228 118 194  22],796,5,38583,4.139362729320888,20.0,0.0
9321,0,9321,[318  64  98  79 588],18,5,38588,4.139455052563828,40.0,0.0
9322,0,9322,[210 405 200 265 515],716,5,38593,4.139547356001287,0.0,0.0
9323,0,9323,[318  64  98  79 588],457,5,38598,4.13963963963964,40.0,0.0
9324,0,9324,[318  64  98  79 588],457,5,38603,4.139731903485255,40.0,0.0
9325,0,9325,[ 89 289 161 423 181],807,5,38608,4.139824147544499,0.0,0.0
9326,0,9326,[318  64  98  79 588],577,5,38613,4.1399163718237375,40.0,0.0
9327,0,9327,[ 56  89 143 742 196],655,2,38615,4.1396869639794165,0.0,0.0
9328,0,9328,[197  98 405 288 194],450,4,38619,4.139671990567049,0.0,0.0
9329,0,9329,[318  64  98  79 588],716,5,38624,4.139764201500536,40.0,0.0
9330,0,9330,[ 56 483 135 197  79],655,3,38627,4.139642053370485,0.0,0.0
9331,0,9331,[318  64  98  79 588],716,5,38632,4.139734247749678,40.0,0.0
9332,0,9332,[202 286 143 508  71],401,2,38634,4.139504982320797,0.0,20.0
9333,0,9333,[318  64  98  79 588],716,5,38639,4.139597171630598,40.0,0.0
9334,0,9334,[318  64  98  79 588],796,5,38644,4.139689341189073,40.0,0.0
9335,0,9335,[143 405  71 125 655],796,4,38648,4.1396743787489285,0.0,0.0
9336,0,9336,[100  56 269  11 172],450,5,38653,4.139766520295598,0.0,20.0
9337,0,9337,[318  64  98  79 588],18,5,38658,4.139858642107518,40.0,0.0
9338,0,9338,[ 98  50 265 301 210],535,3,38661,4.139736588499839,0.0,20.0
9339,0,9339,[318  64  98  79 588],18,5,38666,4.13982869379015,40.0,0.0
9340,0,9340,[318  64  98  79 588],796,5,38671,4.139920779359811,40.0,0.0
9341,0,9341,[245 288 423 357 546],450,4,38675,4.139905801755512,0.0,0.0
9342,0,9342,[318  64  98  79 588],18,5,38680,4.139997859359949,40.0,0.0
9343,0,9343,[210  25 275 385 196],401,4,38684,4.139982876712328,0.0,20.0
9344,0,9344,[ 15  98 328 195  88],450,4,38688,4.139967897271268,0.0,0.0
9345,0,9345,[318  64  98  79 588],450,5,38693,4.140059918681789,40.0,0.0
9346,0,9346,[273 215 195 210  88],450,3,38696,4.139937948004707,0.0,0.0
9347,0,9347,[318  64  98  79 588],796,5,38701,4.140029952931108,40.0,0.0
9348,0,9348,[405 234 357 172 125],593,3,38704,4.139908011552038,0.0,0.0
9349,0,9349,[265 168 180 144 191],450,5,38709,4.14,0.0,0.0
9350,0,9350,[318  64  98  79 588],577,5,38714,4.140091968773393,40.0,0.0
9351,0,9351,[318  64  98  79 588],577,5,38719,4.140183917878528,40.0,0.0
9352,0,9352,[191 435 175 318  25],655,2,38721,4.139955094622047,20.0,0.0
9353,0,9353,[ 15 322 153 282  28],796,3,38724,4.139833226427197,0.0,0.0
9354,0,9354,[318  64  98  79 588],457,5,38729,4.139925173703902,40.0,0.0
9355,0,9355,[318  64  98  79 588],457,5,38734,4.140017101325353,40.0,0.0
9356,0,9356,[ 89  95 265 176 427],796,5,38739,4.140109009297852,20.0,0.0
9357,0,9357,[196  50  25  98 568],457,5,38744,4.1402008976276985,0.0,20.0
9358,0,9358,[318  64  98  79 588],716,5,38749,4.140292766321188,40.0,0.0
9359,0,9359,[318  64  98  79 588],450,5,38754,4.140384615384615,40.0,0.0
9360,0,9360,[ 11 144 187 117 228],716,3,38757,4.1402627924367055,0.0,0.0
9361,0,9361,[742 269  88 405 216],344,2,38759,4.140034180730613,0.0,0.0
9362,0,9362,[318  64  98  79 588],796,5,38764,4.140126027982484,40.0,0.0
9363,0,9363,[318  64  98  79 588],577,5,38769,4.140217855617258,40.0,0.0
9364,0,9364,[318  64  98  79 588],577,5,38774,4.140309663641217,40.0,0.0
9365,0,9365,[318  64  98  79 588],18,5,38779,4.140401452060645,40.0,0.0
9366,0,9366,[ 70  22 191 185 161],269,2,38781,4.140172947581936,0.0,0.0
9367,0,9367,[183  11 195 144 180],716,1,38782,4.139837745516653,0.0,0.0
9368,0,9368,[403 202 143 132  50],655,2,38784,4.139609349983989,0.0,20.0
9369,0,9369,[318  64  98  79 588],577,5,38789,4.139701173959445,40.0,0.0
9370,0,9370,[318  64  98  79 588],457,5,38794,4.139792978337424,40.0,0.0
9371,0,9371,[318  64  98  79 588],796,5,38799,4.1398847631242,40.0,0.0
9372,0,9372,[191   4 180 200 748],450,3,38802,4.139763149471888,0.0,0.0
9373,0,9373,[185 196 121 215 265],450,4,38806,4.1397482398122465,0.0,0.0
9374,0,9374,[318  64  98  79 588],18,5,38811,4.13984,40.0,0.0
9375,0,9375,[318  64  98  79 588],796,5,38816,4.139931740614334,40.0,0.0
9376,0,9376,[121   9  96 195 301],796,3,38819,4.139810173829583,0.0,0.0
9377,0,9377,[187 357 174 202 238],786,5,38824,4.139901898059287,0.0,0.0
9378,0,9378,[323  50 117 168 318],504,4,38828,4.139886981554537,20.0,20.0
9379,0,9379,[ 56 194 143 234 742],457,5,38833,4.139978678038379,0.0,0.0
9380,0,9380,[195 357 568  64 210],655,2,38835,4.139750559641829,20.0,0.0
9381,0,9381,[318  64  98  79 588],796,5,38840,4.139842251119164,40.0,0.0
9382,0,9382,[318  64  98  79 588],18,5,38845,4.139933923052329,40.0,0.0
9383,0,9383,[318  64  98  79 588],796,5,38850,4.14002557544757,40.0,0.0
9384,0,9384,[318  64  98  79 588],18,5,38855,4.140117208311135,40.0,0.0
9385,0,9385,[294 127 117 181 318],236,3,38858,4.139995738333688,20.0,20.0
9386,0,9386,[318  64  98  79 588],457,5,38863,4.140087354852455,40.0,0.0
9387,0,9387,[318  64  98  79 588],450,5,38868,4.1401789518534295,40.0,0.0
9388,0,9388,[318  64  98  79 588],716,5,38873,4.140270529342848,40.0,0.0
9389,0,9389,[318  64  98  79 588],18,5,38878,4.1403620873269436,40.0,0.0
9390,0,9390,[211 313  97 196 568],796,3,38881,4.140240655947183,0.0,0.0
9391,0,9391,[318  64  98  79 588],577,5,38886,4.140332197614992,40.0,0.0
9392,0,9392,[318  64  98  79 588],716,5,38891,4.140423719791334,40.0,0.0
9393,0,9393,[318  64  98  79 588],577,5,38896,4.140515222482436,40.0,0.0
9394,0,9394,[318  64  98  79 588],577,5,38901,4.140606705694518,40.0,0.0
9395,0,9395,[111 183 186 204 191],796,4,38905,4.140591741166454,0.0,0.0
9396,0,9396,[196 210 100 508 318],655,1,38906,4.1402575289986165,20.0,20.0
9397,0,9397,[318  64  98  79 588],450,5,38911,4.140349010427751,40.0,0.0
9398,0,9398,[300 597   1  95 234],450,3,38914,4.140227683796149,0.0,0.0
9399,0,9399,[318  64  98  79 588],577,5,38919,4.14031914893617,40.0,0.0
9400,0,9400,[318  64  98  79 588],18,5,38924,4.1404105946175935,40.0,0.0
9401,0,9401,[318  64  98  79 588],457,5,38929,4.140502020846628,40.0,0.0
9402,0,9402,[195 357  88   8 176],457,5,38934,4.14059342762948,0.0,0.0
9403,0,9403,[135 204 318 597 180],450,4,38938,4.140578477243726,20.0,0.0
9404,0,9404,[318  64  98  79 588],796,5,38943,4.14066985645933,40.0,0.0
9405,0,9405,[161 288   4 742 151],256,5,38948,4.14076121624495,0.0,0.0
9406,0,9406,[ 50 117  22 153 211],296,4,38952,4.140746252790475,0.0,20.0
9407,0,9407,[183 655 313  97 286],593,4,38956,4.140731292517007,0.0,20.0
9408,0,9408,[318  64  98  79 588],716,5,38961,4.140822616643639,40.0,0.0
9409,0,9409,[318  64  98  79 588],18,5,38966,4.140913921360255,40.0,0.0
9410,0,9410,[  1 496 588 288 176],280,4,38970,4.140898948039529,20.0,0.0
9411,0,9411,[318  64  98  79 588],450,5,38975,4.140990225244369,40.0,0.0
9412,0,9412,[318  64  98  79 588],577,5,38980,4.141081483055349,40.0,0.0
9413,0,9413,[183 204  15 168 427],731,3,38983,4.140960271935415,20.0,0.0
9414,0,9414,[  9 161 546 405 210],593,1,38984,4.1406266595857675,0.0,0.0
9415,0,9415,[318  64  98  79 588],577,5,38989,4.14071792693288,40.0,0.0
9416,0,9416,[318  64  98  79 588],18,5,38994,4.1408091748964635,40.0,0.0
9417,0,9417,[ 11 100 471 175 742],655,0,38994,4.140369505202803,0.0,20.0
9418,0,9418,[237 742 405 183   1],593,3,38997,4.14024843401635,0.0,0.0
9419,0,9419,[427 257 180 282 117],796,4,39001,4.1402335456475585,20.0,0.0
9420,0,9420,[ 97   1 282  50 238],796,2,39003,4.140006368750663,0.0,20.0
9421,0,9421,[318  64  98  79 588],457,5,39008,4.1400976438123545,40.0,0.0
9422,0,9422,[318 127   1  64 180],716,4,39012,4.1400827761859285,40.0,20.0
9423,0,9423,[318   7 403 151 161],457,5,39017,4.1401740237691005,20.0,0.0
9424,0,9424,[318  64  98  79 588],457,5,39022,4.14026525198939,40.0,0.0
9425,0,9425,[196 294 111 238 121],457,3,39025,4.140144281773817,0.0,0.0
9426,0,9426,[318  64  98  79 588],450,5,39030,4.14023549379442,40.0,0.0
9427,0,9427,[318  64  98  79 588],457,5,39035,4.140326686465847,40.0,0.0
9428,0,9428,[403  98 245 228  25],450,4,39039,4.140311804008909,0.0,0.0
9429,0,9429,[318  64  98  79 588],450,5,39044,4.140402969247083,40.0,0.0
9430,0,9430,[ 88 273 357 200 153],796,4,39048,4.1403880818577035,0.0,0.0
9431,0,9431,[318  64  98  79 588],18,5,39053,4.140479219677693,40.0,0.0
9432,0,9432,[318  64  98  79 588],577,5,39058,4.140570338174494,40.0,0.0
9433,0,9433,[143 275 245 111  50],450,5,39063,4.14066143735425,0.0,40.0
9434,0,9434,[183 197  95 118 161],796,4,39067,4.140646528881823,0.0,0.0
9435,0,9435,[172 427 153 597   7],23,4,39071,4.140631623569309,20.0,0.0
9436,0,9436,[  4 275 143 183 318],786,5,39076,4.140722687294691,20.0,20.0
9437,0,9437,[ 11 237 568 385 210],280,2,39078,4.140495867768595,0.0,0.0
9438,0,9438,[238 204 125 423  50],450,5,39083,4.140586926581205,0.0,20.0
9439,0,9439,[318  64  98  79 588],18,5,39088,4.140677966101695,40.0,0.0
9440,0,9440,[318  64  98  79 588],18,5,39093,4.140768986336194,40.0,0.0
9441,0,9441,[318  64  98  79 588],450,5,39098,4.1408599872908285,40.0,0.0
9442,0,9442,[191  89  70 275  15],18,4,39102,4.140845070422535,0.0,20.0
9443,0,9443,[117  97  64 237 288],344,2,39104,4.140618382041508,20.0,0.0
9444,0,9444,[318  64  98  79 588],796,5,39109,4.140709370037056,40.0,0.0
9445,0,9445,[318  64  98  79 588],716,5,39114,4.140800338767733,40.0,0.0
9446,0,9446,[318  64  98  79 588],716,5,39119,4.1408912882396525,40.0,0.0
9447,0,9447,[121  82 318  97 172],450,3,39122,4.140770533446232,20.0,0.0
9448,0,9448,[318  64  98  79 588],18,5,39127,4.140861466821886,40.0,0.0
9449,0,9449,[405  25 318 202 211],716,5,39132,4.140952380952381,20.0,0.0
9450,0,9450,[318  64  98  79 588],18,5,39137,4.141043275843826,40.0,0.0
9451,0,9451,[  1 211 191 313 125],655,2,39139,4.140816758358019,0.0,0.0
9452,0,9452,[185 161 197 471   4],457,5,39144,4.140907648365598,0.0,0.0
9453,0,9453,[318  64  98  79 588],796,5,39149,4.140998519145335,40.0,0.0
9454,0,9454,[302 515 143 435 423],269,2,39151,4.140772078265468,0.0,0.0
9455,0,9455,[483  82  88  12 597],457,4,39155,4.140757191201353,0.0,0.0
9456,0,9456,[100 187 181   1  69],450,5,39160,4.140848049064186,0.0,20.0
9457,0,9457,[ 15 588  56 742  96],450,4,39164,4.14083315711567,0.0,0.0
9458,0,9458,[568 185  50 211 483],269,3,39167,4.140712548895232,0.0,20.0
9459,0,9459,[318  64  98  79 588],577,5,39172,4.140803382663848,40.0,0.0
9460,0,9460,[118 183 228 211 176],716,2,39174,4.140577106014163,0.0,0.0
9461,0,9461,[121 132 300  64 742],655,1,39175,4.1402451912914815,20.0,0.0
9462,0,9462,[318  64  98  79 588],18,5,39180,4.140336045651485,40.0,0.0
9463,0,9463,[588   1 222 121 143],716,5,39185,4.140426880811496,0.0,0.0
9464,0,9464,[ 98 300 216 483 181],908,2,39187,4.140200739566825,0.0,0.0
9465,0,9465,[318  64  98  79 588],18,5,39192,4.140291569828861,40.0,0.0
9466,0,9466,[181  56 144 111  96],655,0,39192,4.1398542304848425,0.0,0.0
9467,0,9467,[318  64  98  79 588],18,5,39197,4.139945078158006,40.0,0.0
9468,0,9468,[318  64  98  79 588],796,5,39202,4.140035906642729,40.0,0.0
9469,0,9469,[238 655   9  96 568],269,3,39205,4.139915522703274,0.0,0.0
9470,0,9470,[405 282 161 200 202],280,2,39207,4.139689578713969,0.0,0.0
9471,0,9471,[318  64  98  79 588],18,5,39212,4.139780405405405,40.0,0.0
9472,0,9472,[286 210 111 135 273],450,2,39214,4.139554523382245,0.0,20.0
9473,0,9473,[318  64  98  79 588],457,5,39219,4.139645345155161,40.0,0.0
9474,0,9474,[318  64  98  79 588],796,5,39224,4.139736147757256,40.0,0.0
9475,0,9475,[238 211 603 496  95],18,4,39228,4.139721401435205,40.0,0.0
9476,0,9476,[234  98  11 176  64],269,2,39230,4.139495620977103,20.0,0.0
9477,0,9477,[318  64  98  79 588],457,5,39235,4.139586410635155,40.0,0.0
9478,0,9478,[318  64  98  79 588],457,5,39240,4.139677181137251,40.0,0.0
9479,0,9479,[318  64  98  79 588],18,5,39245,4.139767932489452,40.0,0.0
9480,0,9480,[318  64  98  79 588],716,5,39250,4.139858664697817,40.0,0.0
9481,0,9481,[202 194  69 191 403],457,5,39255,4.139949377768403,0.0,0.0
9482,0,9482,[ 79 172   7   9 195],151,4,39259,4.1399346198460405,0.0,0.0
9483,0,9483,[318  64  98  79 588],450,5,39264,4.140025305778153,40.0,0.0
9484,0,9484,[403 357   1 182   7],655,2,39266,4.139799683711122,0.0,0.0
9485,0,9485,[318  64  98  79 588],450,5,39271,4.13989036474805,40.0,0.0
9486,0,9486,[143 301 176   7 135],450,4,39275,4.139875619268473,0.0,0.0
9487,0,9487,[ 15 588 742 273 211],796,2,39277,4.139650084317032,0.0,0.0
9488,0,9488,[ 89 195 265 144 200],450,4,39281,4.1396353672673625,0.0,0.0
9489,0,9489,[176 125 132  28 483],457,5,39286,4.13972602739726,0.0,0.0
9490,0,9490,[318  64  98  79 588],18,5,39291,4.139816668422716,40.0,0.0
9491,0,9491,[318  64  98  79 588],457,5,39296,4.139907290349768,40.0,0.0
9492,0,9492,[546 186   1  95   7],577,3,39299,4.1397872116296215,0.0,0.0
9493,0,9493,[318  64  98  79 588],716,5,39304,4.1398778175689905,40.0,0.0
9494,0,9494,[318  64  98  79 588],457,5,39309,4.139968404423381,40.0,0.0
9495,0,9495,[318  64  98  79 588],796,5,39314,4.140058972198821,40.0,0.0
9496,0,9496,[318  64  98  79 588],577,5,39319,4.140149520901337,40.0,0.0
9497,0,9497,[318  64  98  79 588],457,5,39324,4.140240050536955,40.0,0.0
9498,0,9498,[117 276   7 151 515],296,3,39327,4.1401200126329085,0.0,0.0
9499,0,9499,[318  64  98  79 588],577,5,39332,4.14021052631579,40.0,0.0
9500,0,9500,[175 234 282 183  64],716,2,39334,4.139985264708978,20.0,0.0
9501,0,9501,[289 258 121 222 173],798,3,39337,4.139865291517575,0.0,0.0
9502,0,9502,[ 69 588 568 161 234],450,4,39341,4.139850573503105,0.0,0.0
9503,0,9503,[222 135 100 191  96],450,3,39344,4.13973063973064,0.0,20.0
9504,0,9504,[423 182 228 204 174],280,1,39345,4.139400315623356,0.0,0.0
9505,0,9505,[211 302 100  98  22],655,2,39347,4.139175257731959,0.0,20.0
9506,0,9506,[318  64  98  79 588],457,5,39352,4.139265804144315,40.0,0.0
9507,0,9507,[328 181 288 333 568],655,0,39352,4.138830458561212,0.0,0.0
9508,0,9508,[ 88 742 121  56 168],504,3,39355,4.1387106951309285,0.0,0.0
9509,0,9509,[318  64  98  79 588],577,5,39360,4.138801261829653,40.0,0.0
9510,0,9510,[204 191 121 234 174],716,5,39365,4.138891809483756,0.0,0.0
9511,0,9511,[568 173 748 132 117],450,5,39370,4.138982338099243,0.0,0.0
9512,0,9512,[318  64  98  79 588],457,5,39375,4.139072847682119,40.0,0.0
9513,0,9513,[175 132  69 265 568],457,5,39380,4.139163338238386,0.0,0.0
9514,0,9514,[318  64  98  79 588],716,5,39385,4.139253809774041,40.0,0.0
9515,0,9515,[318  64  98  79 588],457,5,39390,4.139344262295082,40.0,0.0
9516,0,9516,[568 174  50 118  71],798,4,39394,4.139329620678786,0.0,20.0
9517,0,9517,[153  15 282 172  50],593,5,39399,4.139420046228199,0.0,20.0
9518,0,9518,[742 202 313 300 496],450,5,39404,4.139510452778653,20.0,0.0
9519,0,9519,[ 22 172   1 282  89],655,2,39406,4.139285714285714,0.0,0.0
9520,0,9520,[318  64  98  79 588],457,5,39411,4.139376115954207,40.0,0.0
9521,0,9521,[318  64  98  79 588],18,5,39416,4.13946649863474,40.0,0.0
9522,0,9522,[318  64  98  79 588],457,5,39421,4.139556862333298,40.0,0.0
9523,0,9523,[318  64  98  79 588],716,5,39426,4.139647207055859,40.0,0.0
9524,0,9524,[132 210 302  69  11],269,1,39427,4.139317585301837,0.0,0.0
9525,0,9525,[181 471 125 174 385],577,4,39431,4.139302960319126,0.0,0.0
9526,0,9526,[318  64  98  79 588],577,5,39436,4.139393303243414,40.0,0.0
9527,0,9527,[546   1 742 181 405],15,1,39437,4.139063811922754,0.0,0.0
9528,0,9528,[318  64  98  79 588],577,5,39442,4.139154160982264,40.0,0.0
9529,0,9529,[423 187 265 258 135],655,2,39444,4.138929695697796,0.0,0.0
9530,0,9530,[301 161 127 194  98],450,5,39449,4.139020039869898,0.0,20.0
9531,0,9531,[ 96  97 742  79 294],577,5,39454,4.139110365086026,0.0,0.0
9532,0,9532,[318  64  98  79 588],577,5,39459,4.139200671352145,40.0,0.0
9533,0,9533,[318  64  98  79 588],450,5,39464,4.139290958674218,40.0,0.0
9534,0,9534,[318  64  98  79 588],716,5,39469,4.139381227058206,40.0,0.0
9535,0,9535,[496 202 302 216 181],344,4,39473,4.139366610738255,20.0,0.0
9536,0,9536,[318  64  98  79 588],577,5,39478,4.13945685225962,40.0,0.0
9537,0,9537,[286 275 153   4 111],655,1,39479,4.139127699727406,0.0,40.0
9538,0,9538,[318  64  98  79 588],716,5,39484,4.139217947373939,40.0,0.0
9539,0,9539,[318  64  98  79 588],450,5,39489,4.139308176100629,40.0,0.0
9540,0,9540,[318  64  98  79 588],796,5,39494,4.1393983859134265,40.0,0.0
9541,0,9541,[318  64  98  79 588],716,5,39499,4.139488576818277,40.0,0.0
9542,0,9542,[318  64  98  79 588],577,5,39504,4.139578748821125,40.0,0.0
9543,0,9543,[318  64  98  79 588],450,5,39509,4.139668901927913,40.0,0.0
9544,0,9544,[286 121 568   8 313],593,4,39513,4.139654269250917,0.0,20.0
9545,0,9545,[318  64  98  79 588],18,5,39518,4.139744395558349,40.0,0.0
9546,0,9546,[318  64  98  79 588],457,5,39523,4.139834502985231,40.0,0.0
9547,0,9547,[385 168  56  25 228],450,4,39527,4.139819857561793,0.0,0.0
9548,0,9548,[318  64  98  79 588],18,5,39532,4.1399099382134255,40.0,0.0
9549,0,9549,[234 215 200  82 318],280,2,39534,4.1396858638743455,20.0,0.0
9550,0,9550,[318  64  98  79 588],796,5,39539,4.1397759396921785,40.0,0.0
9551,0,9551,[318  64  98  79 588],577,5,39544,4.139865996649916,40.0,0.0
9552,0,9552,[216 179 125 385  64],577,4,39548,4.139851355595101,20.0,0.0
9553,0,9553,[405   1   7  11 117],256,5,39553,4.139941385806992,0.0,0.0
9554,0,9554,[237  70 143  97 168],450,5,39558,4.140031397174254,0.0,0.0
9555,0,9555,[176 234 202  15  25],457,5,39563,4.140121389702805,0.0,0.0
9556,0,9556,[183  82 269   7 286],450,4,39567,4.140106728052737,0.0,20.0
9557,0,9557,[ 97 568 427 121 357],716,5,39572,4.140196693869011,20.0,0.0
9558,0,9558,[ 56 172 568  69 185],269,2,39574,4.139972800502145,0.0,0.0
9559,0,9559,[318  64  98  79 588],18,5,39579,4.140062761506276,40.0,0.0
9560,0,9560,[318  64  98  79 588],796,5,39584,4.140152703692082,40.0,0.0
9561,0,9561,[318  64  98  79 588],450,5,39589,4.140242627065468,40.0,0.0
9562,0,9562,[286 216 222 234  50],623,4,39593,4.140227961936631,0.0,40.0
9563,0,9563,[318  64  98  79 588],450,5,39598,4.140317858636553,40.0,0.0
9564,0,9564,[318  64  98  79 588],577,5,39603,4.1404077365394665,40.0,0.0
9565,0,9565,[ 98   1 174 151 301],535,3,39606,4.140288521848213,0.0,0.0
9566,0,9566,[318  64  79 588  98],450,5,39611,4.140378384028431,40.0,0.0
9567,0,9567,[275   7 135 385 357],151,4,39615,4.140363712374582,0.0,20.0
9568,0,9568,[318  64  79 588  98],457,5,39620,4.1404535479151425,40.0,0.0
9569,0,9569,[234 655 172 258 546],151,4,39624,4.140438871473354,0.0,0.0
9570,0,9570,[318  64  79 588  98],450,5,39629,4.140528680388674,40.0,0.0
9571,0,9571,[318  64  79 588  98],18,5,39634,4.1406184705390725,40.0,0.0
9572,0,9572,[318  64  79 588  98],716,5,39639,4.1407082419304295,40.0,0.0
9573,0,9573,[ 97   7 234 742 179],577,2,39641,4.140484645916023,0.0,0.0
9574,0,9574,[597 182 111 228 195],796,5,39646,4.140574412532637,0.0,0.0
9575,0,9575,[ 15  82 475   9 216],655,1,39647,4.140246449456976,0.0,0.0
9576,0,9576,[  7  79 427 237 181],296,5,39652,4.140336222199019,20.0,0.0
9577,0,9577,[318  64  79 588  98],716,5,39657,4.140425976195448,40.0,0.0
9578,0,9578,[127 216 182 742  82],450,4,39661,4.140411316421338,0.0,20.0
9579,0,9579,[318  64  79 588  98],450,5,39666,4.140501043841336,40.0,0.0
9580,0,9580,[318  64  79 588  98],450,5,39671,4.140590752531051,40.0,0.0
9581,0,9581,[318  64  79 588  98],450,5,39676,4.140680442496348,40.0,0.0
9582,0,9582,[318  64  79 588  98],577,5,39681,4.140770113743087,40.0,0.0
9583,0,9583,[318  64  79 588  98],18,5,39686,4.140859766277129,40.0,0.0
9584,0,9584,[318  64  79 588  98],18,5,39691,4.14094940010433,40.0,0.0
9585,0,9585,[318  64  79 588  98],18,5,39696,4.141039015230545,40.0,0.0
9586,0,9586,[56 64 96  7 98],577,3,39699,4.140919995827684,20.0,0.0
9587,0,9587,[318  64  79 588  98],457,5,39704,4.141009595327493,40.0,0.0
9588,0,9588,[318  64  79 588  98],716,5,39709,4.141099176139326,40.0,0.0
9589,0,9589,[318  64  79 588  98],457,5,39714,4.1411887382690304,40.0,0.0
9590,0,9590,[318  64  79 588  98],577,5,39719,4.141278281722448,40.0,0.0
9591,0,9591,[  1 742 161  89 181],655,1,39720,4.140950792326939,0.0,0.0
9592,0,9592,[195   1 238 174 245],450,5,39725,4.14104034191598,0.0,0.0
9593,0,9593,[318  64  79 588  98],450,5,39730,4.1411298728371895,40.0,0.0
9594,0,9594,[125 132 100 258 286],655,0,39730,4.140698280354351,0.0,40.0
9595,0,9595,[385 210   1   4   9],344,3,39733,4.140579408086703,0.0,0.0
9596,0,9596,[144 423  79 357 100],796,4,39737,4.140564759820777,0.0,20.0
9597,0,9597,[318  64  79 588  98],450,5,39742,4.1406543029797875,40.0,0.0
9598,0,9598,[ 97  22 175 742  98],655,1,39743,4.140327117408063,0.0,0.0
9599,0,9599,[318  64  79 588  98],450,5,39748,4.140416666666667,40.0,0.0
9600,0,9600,[318  64  79 588  98],796,5,39753,4.140506197271118,40.0,0.0
9601,0,9601,[200 265 143 195 117],450,4,39757,4.140491564257446,0.0,0.0
9602,0,9602,[357 276 195  82 111],655,2,39759,4.1402686660418615,0.0,0.0
9603,0,9603,[257 195 186 168 194],796,4,39763,4.1402540608079965,0.0,0.0
9604,0,9604,[318  64  79 588  98],577,5,39768,4.140343571056741,40.0,0.0
9605,0,9605,[742 117 258  12 211],655,0,39768,4.139912554653342,0.0,0.0
9606,0,9606,[ 95 655 748 216 197],280,2,39770,4.1396898095138965,0.0,0.0
9607,0,9607,[276 288 127 258 135],457,5,39775,4.1397793505412155,0.0,20.0
9608,0,9608,[301 294  25 313 204],450,4,39779,4.139764803829743,0.0,0.0
9609,0,9609,[318  64  79 588  98],796,5,39784,4.1398543184183145,40.0,0.0
9610,0,9610,[318  64  79 588  98],450,5,39789,4.1399438143793565,40.0,0.0
9611,0,9611,[318  64  79 588  98],716,5,39794,4.140033291718685,40.0,0.0
9612,0,9612,[318  64  79 588  98],450,5,39799,4.140122750442109,40.0,0.0
9613,0,9613,[318  64  79 588  98],450,5,39804,4.14021219055544,40.0,0.0
9614,0,9614,[318  64  79 588  98],18,5,39809,4.140301612064483,40.0,0.0
9615,0,9615,[318  64  79 588  98],18,5,39814,4.140391014975042,40.0,0.0
9616,0,9616,[318  64  79 588  98],450,5,39819,4.140480399292919,40.0,0.0
9617,0,9617,[318  64  79 588  98],796,5,39824,4.140569765023914,40.0,0.0
9618,0,9618,[318  64  79 588  98],716,5,39829,4.1406591121738225,40.0,0.0
9619,0,9619,[313 742 215  98 234],655,2,39831,4.1404365904365905,0.0,0.0
9620,0,9620,[318  64  79 588  98],716,5,39836,4.140525932855213,40.0,0.0
9621,0,9621,[161 118 228   1 222],756,1,39837,4.140199542714613,0.0,0.0
9622,0,9622,[318  64  79 588  98],577,5,39842,4.140288891198171,40.0,0.0
9623,0,9623,[200 245 204 568 143],450,4,39846,4.140274314214464,0.0,0.0
9624,0,9624,[318  64  79 588  98],457,5,39851,4.140363636363636,40.0,0.0
9625,0,9625,[318  64  79 588  98],577,5,39856,4.14045293995429,40.0,0.0
9626,0,9626,[318  64  79 588  98],18,5,39861,4.14054222499221,40.0,0.0
9627,0,9627,[318  64  79 588  98],457,5,39866,4.140631491483174,40.0,0.0
9628,0,9628,[318  64  79 588  98],796,5,39871,4.140720739432963,40.0,0.0
9629,0,9629,[318  64  79 588  98],457,5,39876,4.140809968847352,40.0,0.0
9630,0,9630,[318  64  79 588  98],716,5,39881,4.140899179732115,40.0,0.0
9631,0,9631,[ 82 117  88 286 204],450,4,39885,4.1408845514950166,0.0,20.0
9632,0,9632,[423 204 181 222 151],807,5,39890,4.140973736115437,0.0,0.0
9633,0,9633,[318  64  79 588  98],18,5,39895,4.141062902221299,40.0,0.0
9634,0,9634,[161 185 237   7 143],269,1,39896,4.14073689673067,0.0,0.0
9635,0,9635,[ 70 181 301  89 202],344,3,39899,4.140618513906185,0.0,0.0
9636,0,9636,[144 483 288 132  11],457,5,39904,4.14070768911487,0.0,0.0
9637,0,9637,[318  64  79 588  98],716,5,39909,4.140796845818635,40.0,0.0
9638,0,9638,[655 258 127 144 282],450,5,39914,4.140885984023239,0.0,20.0
9639,0,9639,[318  64  79 588  98],577,5,39919,4.14097510373444,40.0,0.0
9640,0,9640,[318  64  79 588  98],577,5,39924,4.141064204957992,40.0,0.0
9641,0,9641,[180 588 568 245 286],280,3,39927,4.140945861854387,0.0,20.0
9642,0,9642,[228 385   8 655  56],23,4,39931,4.1409312454630305,0.0,0.0
9643,0,9643,[318  64  79 588  98],18,5,39936,4.141020323517213,40.0,0.0
9644,0,9644,[286 183 238  89 196],786,5,39941,4.141109383100052,0.0,20.0
9645,0,9645,[318  64  79 588  98],577,5,39946,4.141198424217293,40.0,0.0
9646,0,9646,[191 273 385 235 603],450,3,39949,4.141080128537369,20.0,0.0
9647,0,9647,[318  64  79 588  98],796,5,39954,4.141169154228856,40.0,0.0
9648,0,9648,[318  64  79 588  98],716,5,39959,4.141258161467509,40.0,0.0
9649,0,9649,[318  64  79 588  98],716,5,39964,4.141347150259067,40.0,0.0
9650,0,9650,[318  64  79 588  98],450,5,39969,4.141436120609264,40.0,0.0
9651,0,9651,[182 175 215 294  88],457,4,39973,4.14142146705346,0.0,0.0
9652,0,9652,[318  64  79 588  98],450,5,39978,4.141510411271107,40.0,0.0
9653,0,9653,[318  64  79 588  98],796,5,39983,4.141599337062358,40.0,0.0
9654,0,9654,[318  64  79 588  98],577,5,39988,4.141688244432936,40.0,0.0
9655,0,9655,[  8 197 174  88  95],280,2,39990,4.141466445733223,0.0,0.0
9656,0,9656,[238 135 204 121  64],151,5,39995,4.1415553484519005,20.0,0.0
9657,0,9657,[588  25  11 235  89],344,3,39998,4.141437150548768,0.0,0.0
9658,0,9658,[318  64  79 588  98],450,5,40003,4.141526037892121,40.0,0.0
9659,0,9659,[318  64  79 588  98],796,5,40008,4.141614906832298,40.0,0.0
9660,0,9660,[117 237 245 195 655],280,1,40009,4.1412897215609155,0.0,0.0
9661,0,9661,[318  64  79 588  98],18,5,40014,4.141378596563858,40.0,0.0
9662,0,9662,[318  64  79 588  98],577,5,40019,4.1414674531718925,40.0,0.0
9663,0,9663,[187 132 403  97 143],504,3,40022,4.141349337748345,0.0,0.0
9664,0,9664,[318  64  79 588  98],450,5,40027,4.141438178996379,40.0,0.0
9665,0,9665,[258  88 228   9 655],655,0,40027,4.141009724808607,0.0,0.0
9666,0,9666,[655 228 427 186 588],796,3,40030,4.140891693389883,20.0,0.0
9667,0,9667,[318  64  79 588  98],457,5,40035,4.140980554406289,40.0,0.0
9668,0,9668,[135 234 197 357  69],629,5,40040,4.141069397042093,0.0,0.0
9669,0,9669,[ 95 323 125   1 118],280,2,40042,4.140847983453981,0.0,0.0
9670,0,9670,[318  64  79 588  98],796,5,40047,4.140936821424878,40.0,0.0
9671,0,9671,[318  64  79 588  98],450,5,40052,4.141025641025641,40.0,0.0
9672,0,9672,[ 50 194  98 168  28],389,5,40057,4.141114442261967,0.0,20.0
9673,0,9673,[318  64  79 588  98],577,5,40062,4.14120322513955,40.0,0.0
9674,0,9674,[100 273  71   4 216],344,4,40066,4.141188630490956,0.0,20.0
9675,0,9675,[318  64  79 588  98],18,5,40071,4.1412773873501445,40.0,0.0
9676,0,9676,[ 95 121 196  88  25],577,4,40075,4.141262788054149,0.0,0.0
9677,0,9677,[742 172   4 202 195],655,1,40076,4.140938210374045,0.0,0.0
9678,0,9678,[318  64  79 588  98],796,5,40081,4.14102696559562,40.0,0.0
9679,0,9679,[185  22 135 318 234],450,3,40084,4.140909090909091,20.0,0.0
9680,0,9680,[144  69 655 286  88],401,2,40086,4.14068794546018,0.0,20.0
9681,0,9681,[318  64  79 588  98],457,5,40091,4.140776699029126,40.0,0.0
9682,0,9682,[195  25 483 597  97],457,4,40095,4.140762160487452,0.0,0.0
9683,0,9683,[318  64  79 588  98],450,5,40100,4.140850888062784,40.0,0.0
9684,0,9684,[318  64  79 588  98],716,5,40105,4.140939597315437,40.0,0.0
9685,0,9685,[318  64  79 588  98],450,5,40110,4.141028288251084,40.0,0.0
9686,0,9686,[318  64  79 588  98],450,5,40115,4.1411169608754,40.0,0.0
9687,0,9687,[318  64  79 588  98],18,5,40120,4.141205615194054,40.0,0.0
9688,0,9688,[405 194 195  22 385],450,5,40125,4.141294251212716,0.0,0.0
9689,0,9689,[273 197 275 257 174],655,2,40127,4.141073271413829,0.0,20.0
9690,0,9690,[174 313 678 288 121],344,2,40129,4.140852337220101,0.0,0.0
9691,0,9691,[222   9 289 121 427],655,1,40130,4.140528270738754,20.0,0.0
9692,0,9692,[318  64  79 588  98],450,5,40135,4.140616940059837,40.0,0.0
9693,0,9693,[194 423  71 265 127],807,4,40139,4.140602434495564,0.0,20.0
9694,0,9694,[222  98  89 196  95],796,5,40144,4.140691077875194,0.0,0.0
9695,0,9695,[282 568 100 187 483],796,4,40148,4.140676567656766,0.0,20.0
9696,0,9696,[161  56 288 568 588],457,5,40153,4.140765185108797,0.0,0.0
9697,0,9697,[216 210 245 202 423],796,3,40156,4.140647556197154,0.0,0.0
9698,0,9698,[187 186   7 172 182],535,2,40158,4.140426848128673,0.0,0.0
9699,0,9699,[318  64  79 588  98],450,5,40163,4.1405154639175255,40.0,0.0
9700,0,9700,[132 216  79  56 588],796,5,40168,4.1406040614369655,0.0,0.0
9701,0,9701,[176 515 118 185 153],655,2,40170,4.140383426097712,0.0,0.0
9702,0,9702,[496 276  64 100  15],878,3,40173,4.140265897145213,40.0,20.0
9703,0,9703,[318  64  79 588  98],18,5,40178,4.14035449299258,40.0,0.0
9704,0,9704,[403  69 100 118  56],655,0,40178,4.139927872230809,0.0,20.0
9705,0,9705,[318  64  79 588  98],457,5,40183,4.140016484648671,40.0,0.0
9706,0,9706,[238 483 265  89 135],151,5,40188,4.140105078809107,0.0,0.0
9707,0,9707,[318  64  79 588  98],796,5,40193,4.140193654717758,40.0,0.0
9708,0,9708,[ 22 234 143  97 568],152,5,40198,4.140282212380265,0.0,0.0
9709,0,9709,[  8 181 568  11  50],655,1,40199,4.139958805355304,0.0,20.0
9710,0,9710,[318  64  79 588  98],796,5,40204,4.140047368963032,40.0,0.0
9711,0,9711,[318  64  79 588  98],577,5,40209,4.1401359143327845,40.0,0.0
9712,0,9712,[318  64  79 588  98],716,5,40214,4.1402244414701945,40.0,0.0
9713,0,9713,[318  64  79 588  98],577,5,40219,4.140312950380894,40.0,0.0
9714,0,9714,[318  64  79 588  98],457,5,40224,4.14040144107051,40.0,0.0
9715,0,9715,[ 12 385 195 282  96],796,5,40229,4.140489913544669,0.0,0.0
9716,0,9716,[318  64  79 588  98],18,5,40234,4.1405783678089945,40.0,0.0
9717,0,9717,[318  64  79 588  98],18,5,40239,4.140666803869109,40.0,0.0
9718,0,9718,[182 153 186  11 173],269,1,40240,4.14034365675481,0.0,0.0
9719,0,9719,[318  64  79 588  98],18,5,40245,4.140432098765432,40.0,0.0
9720,0,9720,[215 202 234 211 237],796,3,40248,4.140314782429791,0.0,0.0
9721,0,9721,[318  64  79 588  98],577,5,40253,4.140403209216211,40.0,0.0
9722,0,9722,[210 276 222 294  56],296,3,40256,4.140285919983544,0.0,0.0
9723,0,9723,[318  64  79 588  98],796,5,40261,4.140374331550802,40.0,0.0
9724,0,9724,[174 286 265   4 294],450,4,40265,4.140359897172236,0.0,20.0
9725,0,9725,[318  64  79 588  98],577,5,40270,4.14044828295291,40.0,0.0
9726,0,9726,[318  64  79 588  98],796,5,40275,4.140536650560296,40.0,0.0
9727,0,9727,[173 132 176 597  70],269,1,40276,4.1402138157894735,0.0,0.0
9728,0,9728,[435  70   1  79  82],151,4,40280,4.140199403844178,0.0,0.0
9729,0,9729,[ 82 568 200 121 216],796,4,40284,4.1401849948612535,0.0,0.0
9730,0,9730,[318  64  79 588  98],716,5,40289,4.14027335320111,40.0,0.0
9731,0,9731,[318  64  79 588  98],796,5,40294,4.140361693382655,40.0,0.0
9732,0,9732,[ 56 496  98 265 483],716,5,40299,4.140450015411487,20.0,0.0
9733,0,9733,[357 144 172 655 151],796,4,40303,4.140435586603657,0.0,0.0
9734,0,9734,[318  64  79 588  98],577,5,40308,4.1405238828967645,40.0,0.0
9735,0,9735,[288 127 423 183 271],655,2,40310,4.140304026294166,0.0,20.0
9736,0,9736,[187 127 132 174 202],450,5,40315,4.140392317962411,0.0,20.0
9737,0,9737,[496 216  82 182 603],450,4,40319,4.140377901006366,40.0,0.0
9738,0,9738,[318  64  79 588  98],577,5,40324,4.1404661669575935,40.0,0.0
9739,0,9739,[318  64  79 588  98],577,5,40329,4.140554414784394,40.0,0.0
9740,0,9740,[ 64 301  98 185 173],535,4,40333,4.140539985627759,20.0,0.0
9741,0,9741,[318  64  79 588  98],457,5,40338,4.140628207760214,40.0,0.0
9742,0,9742,[186 151 265 748  82],450,3,40341,4.140511136200349,0.0,0.0
9743,0,9743,[318  64  79 588  98],577,5,40346,4.14059934318555,40.0,0.0
9744,0,9744,[318  64  79 588  98],18,5,40351,4.140687532067727,40.0,0.0
9745,0,9745,[ 82  70 143  56 216],716,5,40356,4.140775702852452,0.0,0.0
9746,0,9746,[318  64  79 588  98],716,5,40361,4.140863855545296,40.0,0.0
9747,0,9747,[121 125  82 216 655],786,4,40365,4.140849405006155,0.0,0.0
9748,0,9748,[118 328 357 187  11],450,4,40369,4.140834957431531,0.0,0.0
9749,0,9749,[318  64  79 588  98],450,5,40374,4.140923076923077,40.0,0.0
9750,0,9750,[318  64  79 588  98],18,5,40379,4.141011178340683,40.0,0.0
9751,0,9751,[ 28 197 273 215 568],693,2,40381,4.140791632485644,0.0,0.0
9752,0,9752,[318  64  79 588  98],796,5,40386,4.140879729314057,40.0,0.0
9753,0,9753,[ 97  70 151 191 603],151,4,40390,4.140865286036498,20.0,0.0
9754,0,9754,[318  64  79 588  98],457,5,40395,4.140953357252691,40.0,0.0
9755,0,9755,[318  64  79 588  98],18,5,40400,4.141041410414104,40.0,0.0
9756,0,9756,[132 245 257  98   9],796,3,40403,4.140924464487035,0.0,0.0
9757,0,9757,[655 161  15  88 210],269,1,40404,4.140602582496413,0.0,0.0
9758,0,9758,[318  64  79 588  98],450,5,40409,4.140690644533251,40.0,0.0
9759,0,9759,[318  64  79 588  98],450,5,40414,4.14077868852459,40.0,0.0
9760,0,9760,[318  64  79 588  98],18,5,40419,4.140866714475976,40.0,0.0
9761,0,9761,[318  64  79 588  98],796,5,40424,4.140954722392952,40.0,0.0
9762,0,9762,[135 588 238 191 215],18,3,40427,4.140837857216019,0.0,0.0
9763,0,9763,[194 294 568  11 405],577,2,40429,4.1406185989348625,0.0,0.0
9764,0,9764,[174 194 182  89 179],457,5,40434,4.140706605222734,0.0,0.0
9765,0,9765,[228 197 323 151 144],796,3,40437,4.140589801351628,0.0,0.0
9766,0,9766,[742 191 237 215 216],577,5,40442,4.140677792566807,0.0,0.0
9767,0,9767,[176 143 269 435 196],450,5,40447,4.1407657657657655,0.0,0.0
9768,0,9768,[ 69 568 405 196  89],655,1,40448,4.140444262462893,0.0,0.0
9769,0,9769,[318  64  79 588  98],18,5,40453,4.140532241555783,40.0,0.0
9770,0,9770,[318  64  79 588  98],450,5,40458,4.140620202640466,40.0,0.0
9771,0,9771,[294  70  98 435 276],655,2,40460,4.140401146131805,0.0,0.0
9772,0,9772,[161 286 179 318 181],593,5,40465,4.140489102629694,20.0,20.0
9773,0,9773,[318  64  79 588  98],716,5,40470,4.140577041129528,40.0,0.0
9774,0,9774,[318  64  79 588  98],18,5,40475,4.140664961636829,40.0,0.0
9775,0,9775,[423 405 118 588 322],796,4,40479,4.140650572831424,0.0,0.0
9776,0,9776,[333 210 273 289  56],693,1,40480,4.1403293443796665,0.0,0.0
9777,0,9777,[318  64  79 588  98],450,5,40485,4.140417263244017,40.0,0.0
9778,0,9778,[195 483 568  95 286],796,4,40489,4.140402904182432,0.0,20.0
9779,0,9779,[286  15 187 301 405],655,1,40490,4.140081799591002,0.0,20.0
9780,0,9780,[748 286 275  89 168],450,5,40495,4.140169716797874,0.0,40.0
9781,0,9781,[318  64  79 588  98],577,5,40500,4.140257616029442,40.0,0.0
9782,0,9782,[318  64  79 588  98],450,5,40505,4.14034549729122,40.0,0.0
9783,0,9783,[121 216 211 195 228],796,4,40509,4.140331152902698,0.0,0.0
9784,0,9784,[318  64  79 588  98],18,5,40514,4.140419008686766,40.0,0.0
9785,0,9785,[678  25 121 153 127],401,1,40515,4.140098099325567,0.0,20.0
9786,0,9786,[318  64  79 588  98],577,5,40520,4.140185960968632,40.0,0.0
9787,0,9787,[196 257  70 135 143],401,3,40523,4.140069472823866,0.0,0.0
9788,0,9788,[318  64  79 588  98],450,5,40528,4.140157319440188,40.0,0.0
9789,0,9789,[182  88 603  96 282],655,2,40530,4.1399387129724206,20.0,0.0
9790,0,9790,[174 132 748  28 265],796,4,40534,4.139924420386069,0.0,0.0
9791,0,9791,[ 69 546 222 127 196],796,5,40539,4.1400122549019605,0.0,20.0
9792,0,9792,[318  64  79 588  98],796,5,40544,4.140100071479628,40.0,0.0
9793,0,9793,[318  64  79 588  98],457,5,40549,4.140187870124566,40.0,0.0
9794,0,9794,[318  64  79 588  98],577,5,40554,4.140275650842266,40.0,0.0
9795,0,9795,[357 238 196  64 405],796,4,40558,4.140261331155574,20.0,0.0
9796,0,9796,[318  64  79 588  98],577,5,40563,4.140349086455037,40.0,0.0
9797,0,9797,[125 318 195  50 289],786,5,40568,4.1404368238416005,20.0,20.0
9798,0,9798,[748 275 176 228  25],151,3,40571,4.140320440861313,0.0,20.0
9799,0,9799,[ 50 121 276 237 196],401,2,40573,4.140102040816327,0.0,20.0
9800,0,9800,[173  79 405  82 276],280,2,40575,4.139883685338231,0.0,0.0
9801,0,9801,[318  64  79 588  98],18,5,40580,4.139971434401143,40.0,0.0
9802,0,9802,[318  64  79 588  98],796,5,40585,4.140059165561563,40.0,0.0
9803,0,9803,[ 88  28 237 286 174],18,2,40587,4.13984088127295,0.0,20.0
9804,0,9804,[318  64  79 588  98],716,5,40592,4.139928607853136,40.0,0.0
9805,0,9805,[179 191 568 603 194],389,4,40596,4.13991433816031,20.0,0.0
9806,0,9806,[357 197 216 185 200],151,4,40600,4.139900071377587,0.0,0.0
9807,0,9807,[318  64  79 588  98],716,5,40605,4.139987765089723,40.0,0.0
9808,0,9808,[318  64  79 588  98],457,5,40610,4.140075440921603,40.0,0.0
9809,0,9809,[318  64  79 588  98],450,5,40615,4.140163098878695,40.0,0.0
9810,0,9810,[216  64 588 194 496],389,4,40619,4.140148812557333,40.0,0.0
9811,0,9811,[173 168 181 313   9],796,4,40623,4.140134529147982,0.0,0.0
9812,0,9812,[204   8  25 313  95],344,4,40627,4.14012024864975,0.0,0.0
9813,0,9813,[318  64  79 588  98],457,5,40632,4.14020786631343,40.0,0.0
9814,0,9814,[318  64  79 588  98],18,5,40637,4.1402954661232805,40.0,0.0
9815,0,9815,[318  64  79 588  98],18,5,40642,4.140383048084759,40.0,0.0
9816,0,9816,[318  64  79 588  98],577,5,40647,4.140470612203321,40.0,0.0
9817,0,9817,[403 121 423  64 185],457,5,40652,4.140558158484416,20.0,0.0
9818,0,9818,[ 97 235 194 265 403],457,4,40656,4.140543843568591,0.0,0.0
9819,0,9819,[318  64  79 588  98],796,5,40661,4.140631364562118,40.0,0.0
9820,0,9820,[318  64  79 588  98],577,5,40666,4.14071886773241,40.0,0.0
9821,0,9821,[318  64  79 588  98],796,5,40671,4.140806353084911,40.0,0.0
9822,0,9822,[318  64  79 588  98],18,5,40676,4.140893820625064,40.0,0.0
9823,0,9823,[196 234 313 194 100],577,4,40680,4.140879478827362,0.0,20.0
9824,0,9824,[210 215  98 318 127],835,5,40685,4.140966921119593,20.0,20.0
9825,0,9825,[179 210  22 597 132],450,4,40689,4.140952574801547,0.0,0.0
9826,0,9826,[318  64  79 588  98],577,5,40694,4.141039991859164,40.0,0.0
9827,0,9827,[215   4  11  25  50],344,3,40697,4.140923890923891,0.0,20.0
9828,0,9828,[183 161 172 603 132],23,3,40700,4.140807813612779,20.0,0.0
9829,0,9829,[ 96 151 238 100 282],450,5,40705,4.140895218718209,0.0,20.0
9830,0,9830,[313 275 237  64 204],450,5,40710,4.140982606042112,20.0,20.0
9831,0,9831,[318  64  79 588  98],577,5,40715,4.14106997558991,40.0,0.0
9832,0,9832,[318  64  79 588  98],716,5,40720,4.141157327367029,40.0,0.0
9833,0,9833,[318  64  79 588  98],457,5,40725,4.14124466137889,40.0,0.0
9834,0,9834,[  1 286 385 234 127],786,4,40729,4.141230299949161,0.0,40.0
9835,0,9835,[318  64  79 588  98],450,5,40734,4.141317608784059,40.0,0.0
9836,0,9836,[202   4 195 204 222],457,5,40739,4.141404899867846,0.0,0.0
9837,0,9837,[215  95 117 183 186],577,5,40744,4.141492173205936,0.0,0.0
9838,0,9838,[118  25  96 655 100],457,5,40749,4.14157942880374,0.0,20.0
9839,0,9839,[427 180 196 215 210],716,4,40753,4.1415650406504065,20.0,0.0
9840,0,9840,[515 257 655 210 211],401,3,40756,4.141449039731735,0.0,0.0
9841,0,9841,[318  64  79 588  98],457,5,40761,4.1415362731152205,40.0,0.0
9842,0,9842,[318  64  79 588  98],18,5,40766,4.141623488773748,40.0,0.0
9843,0,9843,[202 121 286 471 215],655,0,40766,4.141202763104429,0.0,20.0
9844,0,9844,[655  50 161 183 222],655,2,40768,4.1409852717115285,0.0,20.0
9845,0,9845,[318  64  79 588  98],457,5,40773,4.141072516758074,40.0,0.0
9846,0,9846,[151 135 202   1 435],18,2,40775,4.140855082766325,0.0,0.0
9847,0,9847,[228 172 385 405 186],786,5,40780,4.140942323314379,0.0,0.0
9848,0,9848,[168 483 174 173 269],535,5,40785,4.141029546146817,0.0,0.0
9849,0,9849,[282 117 202 268 215],655,0,40785,4.140609137055837,0.0,0.0
9850,0,9850,[318  64  79 588  98],716,5,40790,4.1406963760024365,40.0,0.0
9851,0,9851,[318  88 405 135 282],450,4,40794,4.14068209500609,20.0,0.0
9852,0,9852,[181  69  25 300 568],885,4,40798,4.140667816908556,0.0,0.0
9853,0,9853,[ 89  11 257 174  22],655,1,40799,4.140349096813477,0.0,0.0
9854,0,9854,[318  64  79 588  98],457,5,40804,4.140436326737697,40.0,0.0
9855,0,9855,[318  64  79 588  98],796,5,40809,4.140523538961039,40.0,0.0
9856,0,9856,[318  64  79 588  98],577,5,40814,4.1406107334888915,40.0,0.0
9857,0,9857,[423   9 196 286 273],655,1,40815,4.140292148508825,0.0,20.0
9858,0,9858,[313 268 568 471 333],655,1,40816,4.139973628157014,0.0,0.0
9859,0,9859,[385 125 357 228 100],796,4,40820,4.139959432048681,0.0,20.0
9860,0,9860,[183 100 282 318 322],593,4,40824,4.1399452388195925,20.0,20.0
9861,0,9861,[515 132 238 185 435],269,4,40828,4.1399310484688705,0.0,0.0
9862,0,9862,[271  69 655 301 127],629,4,40832,4.1399168609956405,0.0,20.0
9863,0,9863,[318  64  79 588  98],450,5,40837,4.14000405515004,40.0,0.0
9864,0,9864,[195 161 238 289 176],655,0,40837,4.139584389254941,0.0,0.0
9865,0,9865,[318  64  79 588  98],716,5,40842,4.139671599432394,40.0,0.0
9866,0,9866,[318  64  79 588  98],450,5,40847,4.139758791932705,40.0,0.0
9867,0,9867,[318  64  79 588  98],457,5,40852,4.139845966761248,40.0,0.0
9868,0,9868,[132 180 282 151 546],796,4,40856,4.139831796534604,0.0,0.0
9869,0,9869,[318  64  79 588  98],457,5,40861,4.139918946301925,40.0,0.0
9870,0,9870,[117 271 301  56   7],655,0,40861,4.139499544119137,0.0,0.0
9871,0,9871,[182 125 216 483  79],457,5,40866,4.139586709886548,0.0,0.0
9872,0,9872,[318  64  79 588  98],18,5,40871,4.139673857996557,40.0,0.0
9873,0,9873,[318  64  79 588  98],577,5,40876,4.139760988454527,40.0,0.0
9874,0,9874,[318  64  79 588  98],796,5,40881,4.139848101265823,40.0,0.0
9875,0,9875,[210 117 100 181 196],344,3,40884,4.139732685297691,0.0,20.0
9876,0,9876,[168 318 210 121 132],716,5,40889,4.139819783335021,20.0,0.0
9877,0,9877,[318  82   7  79 273],450,3,40892,4.139704393601944,20.0,0.0
9878,0,9878,[ 89 288 180 132  22],450,4,40896,4.139690252049802,0.0,0.0
9879,0,9879,[302  69 153 357 294],401,1,40897,4.139372469635627,0.0,0.0
9880,0,9880,[568 496 237 210 423],280,2,40899,4.139155955874911,20.0,0.0
9881,0,9881,[117 427 176 228 204],72,3,40902,4.139040680024286,20.0,0.0
9882,0,9882,[132 588 294 496 216],450,5,40907,4.139127795203885,20.0,0.0
9883,0,9883,[546 294 211  15  50],236,2,40909,4.1389113719142046,0.0,20.0
9884,0,9884,[318  64  79 588  98],450,5,40914,4.138998482549317,40.0,0.0
9885,0,9885,[210 127 179 515 204],18,4,40918,4.138984422415537,0.0,20.0
9886,0,9886,[  1  15 200 176 143],835,4,40922,4.138970365125923,0.0,0.0
9887,0,9887,[318  64  79 588  98],796,5,40927,4.1390574433656955,40.0,0.0
9888,0,9888,[ 97 135 405 403 127],72,3,40930,4.1389422590757405,0.0,20.0
9889,0,9889,[185  56 289 200 143],655,3,40933,4.138827098078868,0.0,0.0
9890,0,9890,[318  64  79 588  98],450,5,40938,4.138914164391871,40.0,0.0
9891,0,9891,[546  88 235 238  28],716,3,40941,4.138799029518803,0.0,0.0
9892,0,9892,[216 257 191 588  28],389,3,40944,4.138683917921763,0.0,0.0
9893,0,9893,[237 111 597  89 483],457,3,40947,4.1385688295936935,0.0,0.0
9894,0,9894,[318  64  79 588  98],796,5,40952,4.138655886811521,40.0,0.0
9895,0,9895,[ 50 151  28 125  70],174,4,40956,4.138641875505255,0.0,20.0
9896,0,9896,[318  64  79 588  98],457,5,40961,4.138728907749823,40.0,0.0
9897,0,9897,[300 265   7 427 118],450,4,40965,4.138714891897353,20.0,0.0
9898,0,9898,[300 127 288 286 328],938,2,40967,4.138498838266492,0.0,40.0
9899,0,9899,[748 200  97 211 282],450,4,40971,4.138484848484849,0.0,0.0
9900,0,9900,[318  64  79 588  98],457,5,40976,4.138571861428138,40.0,0.0
9901,0,9901,[161 176 118 175 211],716,1,40977,4.138254898000404,0.0,0.0
9902,0,9902,[318  64  79 588  98],457,5,40982,4.138341916590932,40.0,0.0
9903,0,9903,[ 12 357 118 143 568],457,5,40987,4.138428917609047,0.0,0.0
9904,0,9904,[127  98 204 234 125],796,4,40991,4.138414941948511,0.0,20.0
9905,0,9905,[318  64  79 588  98],457,5,40996,4.138501918029477,40.0,0.0
9906,0,9906,[318  64  79 588  98],450,5,41001,4.138588876551933,40.0,0.0
9907,0,9907,[202 313 268 174  89],655,2,41003,4.138373031893419,0.0,0.0
9908,0,9908,[496  82  50 175 234],716,4,41007,4.138359067514381,20.0,20.0
9909,0,9909,[ 11 191 322 288 357],450,4,41011,4.138345105953582,0.0,0.0
9910,0,9910,[144 286 496 211 423],593,5,41016,4.1384320452023005,20.0,20.0
9911,0,9911,[357 496 173  96 161],716,3,41019,4.138317191283293,20.0,0.0
9912,0,9912,[ 89 173 318 197 322],704,4,41023,4.138303238172098,20.0,0.0
9913,0,9913,[318  64  79 588  98],796,5,41028,4.138390155335888,40.0,0.0
9914,0,9914,[318  64  79 588  98],577,5,41033,4.138477054967221,40.0,0.0
9915,0,9915,[318  64  79 588  98],457,5,41038,4.1385639370714,40.0,0.0
9916,0,9916,[216 597 172 496 176],450,5,41043,4.138650801653726,20.0,0.0
9917,0,9917,[144  71 357  64  82],450,3,41046,4.138535995160314,20.0,0.0
9918,0,9918,[222 153 210 496  79],280,3,41049,4.138421211815707,20.0,0.0
9919,0,9919,[318  64  79 588  98],18,5,41054,4.138508064516129,40.0,0.0
9920,0,9920,[435 200 204 118 282],655,1,41055,4.138191714544905,0.0,0.0
9921,0,9921,[318  64  79 588  98],450,5,41060,4.138278572868374,40.0,0.0
9922,0,9922,[318  64  79 588  98],796,5,41065,4.138365413685378,40.0,0.0
9923,0,9923,[ 56 118 200 385 405],577,1,41066,4.138049173720274,0.0,0.0
9924,0,9924,[ 88 546 191 195 202],151,2,41068,4.137833753148614,0.0,0.0
9925,0,9925,[  9  28 197 100  56],292,5,41073,4.137920612532742,0.0,20.0
9926,0,9926,[ 50 211  89 286 181],296,5,41078,4.138007454417246,0.0,40.0
9927,0,9927,[ 88  95 197  12 143],796,4,41082,4.137993553585818,0.0,0.0
9928,0,9928,[318  64  79 588  98],796,5,41087,4.138080370631483,40.0,0.0
9929,0,9929,[318  64  79 588  98],18,5,41092,4.138167170191339,40.0,0.0
9930,0,9930,[216 238 427 655 118],655,2,41094,4.13795186788843,20.0,0.0
9931,0,9931,[318  64  79 588  98],457,5,41099,4.138038662907773,40.0,0.0
9932,0,9932,[318  64  79 588  98],577,5,41104,4.138125440451022,40.0,0.0
9933,0,9933,[318  64  79 588  98],796,5,41109,4.138212200523455,40.0,0.0
9934,0,9934,[318  64  79 588  98],18,5,41114,4.138298943130347,40.0,0.0
9935,0,9935,[ 28 132 222 194 197],450,4,41118,4.138285024154589,0.0,0.0
9936,0,9936,[195 318 174 181 172],450,5,41123,4.138371741974439,20.0,0.0
9937,0,9937,[748 211  12 323 238],796,2,41125,4.1381565707385795,0.0,0.0
9938,0,9938,[318  64  79 588  98],18,5,41130,4.1382432840325984,40.0,0.0
9939,0,9939,[276  89 195 185 475],269,3,41133,4.138128772635815,0.0,0.0
9940,0,9940,[204 318  89  95 174],786,5,41138,4.138215471280556,20.0,0.0
9941,0,9941,[153  28 196 211 111],716,5,41143,4.1383021524844095,0.0,0.0
9942,0,9942,[273 245 127 328 597],450,4,41147,4.1382882429850145,0.0,20.0
9943,0,9943,[318  64  79 588  98],18,5,41152,4.1383748994368466,40.0,0.0
9944,0,9944,[118 405 215  50  79],151,2,41154,4.13815987933635,0.0,20.0
9945,0,9945,[153 603 204  50  69],796,5,41159,4.138246531268852,20.0,20.0
9946,0,9946,[403 195  25 235  89],256,4,41163,4.13823263295466,0.0,0.0
9947,0,9947,[318  64  79 588  98],577,5,41168,4.1383192601527945,40.0,0.0
9948,0,9948,[273 191 302 182 179],655,5,41173,4.138405869936677,0.0,0.0
9949,0,9949,[318  64  79 588  98],18,5,41178,4.138492462311558,40.0,0.0
9950,0,9950,[318  64  79 588  98],577,5,41183,4.138579037282685,40.0,0.0
9951,0,9951,[301 194 234   7 121],450,3,41186,4.13846463022508,0.0,0.0
9952,0,9952,[318  64  79 588  98],18,5,41191,4.1385511905958,40.0,0.0
9953,0,9953,[172 127  88 204 197],18,2,41193,4.138336347197106,0.0,20.0
9954,0,9954,[318  64  79 588  98],18,5,41198,4.138422903063787,40.0,0.0
9955,0,9955,[ 71 153  96 222  12],796,5,41203,4.138509441542788,0.0,0.0
9956,0,9956,[475  50 435 196  64],269,2,41205,4.138294667068394,20.0,20.0
9957,0,9957,[176 143 197 385 196],716,3,41208,4.138180357501506,0.0,0.0
9958,0,9958,[403  56 191  25 294],457,4,41212,4.138166482578572,0.0,0.0
9959,0,9959,[125 173 143 121 655],401,1,41213,4.13785140562249,0.0,0.0
9960,0,9960,[597 603 202 195 174],269,1,41214,4.1375363919285215,20.0,0.0
9961,0,9961,[143 276 357 216 118],655,4,41218,4.137522585826139,0.0,0.0
9962,0,9962,[318  64  79 588  98],18,5,41223,4.137609153869317,40.0,0.0
9963,0,9963,[ 69 235 588 144 121],450,3,41226,4.137494981934966,0.0,0.0
9964,0,9964,[245 132 151 180  11],450,5,41231,4.137581535373808,0.0,0.0
9965,0,9965,[318  64  79 588  98],450,5,41236,4.1376680714429055,40.0,0.0
9966,0,9966,[269  11 215 118 121],655,0,41236,4.137252934684459,0.0,0.0
9967,0,9967,[318  64  79 588  98],796,5,41241,4.13733948635634,40.0,0.0
9968,0,9968,[121 117 405  95 678],807,4,41245,4.13732570970007,0.0,0.0
9969,0,9969,[187 185 423  11  15],269,3,41248,4.137211634904714,0.0,0.0
9970,0,9970,[318  64  79 588  98],796,5,41253,4.137298164677565,40.0,0.0
9971,0,9971,[318  64  79 588  98],457,5,41258,4.137384677095868,40.0,0.0
9972,0,9972,[318  64  79 588  98],577,5,41263,4.137471172164845,40.0,0.0
9973,0,9973,[  4 161 546 245 121],593,3,41266,4.137357128534189,0.0,0.0
9974,0,9974,[318  64  79 588  98],457,5,41271,4.137443609022556,40.0,0.0
9975,0,9975,[282 318 313 144 200],450,4,41275,4.1374298315958296,20.0,0.0
9976,0,9976,[200 174 121 222 202],786,4,41279,4.137416056930941,0.0,0.0
9977,0,9977,[ 89 125 275 471  28],450,5,41284,4.137502505512127,0.0,20.0
9978,0,9978,[111 275  97  98  88],798,2,41286,4.137288305441427,0.0,20.0
9979,0,9979,[  9 185 423 508 211],655,1,41287,4.136973947895791,0.0,0.0
9980,0,9980,[318  64  79 588  98],577,5,41292,4.137060414788097,40.0,0.0
9981,0,9981,[318  64  79 588  98],577,5,41297,4.137146864355841,40.0,0.0
9982,0,9982,[318  64  79 588  98],796,5,41302,4.137233296604228,40.0,0.0
9983,0,9983,[318  64  79 588  98],18,5,41307,4.137319711538462,40.0,0.0
9984,0,9984,[318  64  79 588  98],18,5,41312,4.137406109163746,40.0,0.0
9985,0,9985,[318  64  79 588  98],457,5,41317,4.13749248948528,40.0,0.0
9986,0,9986,[185  71 143 191 211],796,4,41321,4.137478722339041,0.0,0.0
9987,0,9987,[135 191 174 216  28],639,3,41324,4.137364837805366,0.0,0.0
9988,0,9988,[172 228 204 196 603],796,5,41329,4.137451196315948,20.0,0.0
9989,0,9989,[245 237 143 357 153],504,3,41332,4.137337337337337,0.0,0.0
9990,0,9990,[318  64  79 588  98],577,5,41337,4.137423681313182,40.0,0.0
9991,0,9991,[194 742 153 245 132],796,3,41340,4.137309847878303,0.0,0.0
9992,0,9992,[318  64  79 588  98],796,5,41345,4.137396177324127,40.0,0.0
9993,0,9993,[125 195 100  50 172],256,4,41349,4.137382429457674,0.0,40.0
9994,0,9994,[318  64  79 588  98],716,5,41354,4.137468734367183,40.0,0.0
9995,0,9995,[318  64  79 588  98],796,5,41359,4.1375550220088035,40.0,0.0
9996,0,9996,[318  64  79 588  98],457,5,41364,4.137641292387716,40.0,0.0
9997,0,9997,[318  64  79 588  98],18,5,41369,4.137727545509102,40.0,0.0
9998,0,9998,[318  64  79 588  98],577,5,41374,4.137813781378138,40.0,0.0
9999,0,9999,[ 98 121 568   1 237],593,4,41378,4.1378,0.0,0.0
10000,1,0,[289 268 181  11 127],655,1,1,1.0,0.0,20.0
10001,1,1,[ 70  50 195 204 210],504,2,3,1.5,0.0,20.0
10002,1,2,[127 195 210 286  22],450,4,7,2.3333333333333335,0.0,40.0
10003,1,3,[127 286  22 195 210],450,4,11,2.75,0.0,40.0
10004,1,4,[127 286  22 195 210],796,3,14,2.8,0.0,40.0
10005,1,5,[200   1 172 132 423],796,4,18,3.0,0.0,0.0
10006,1,6,[127  22 132 200 172],280,4,22,3.142857142857143,0.0,20.0
10007,1,7,[174 318  97   7 286],786,5,27,3.375,20.0,20.0
10008,1,8,[405 228 269 288  50],450,4,31,3.4444444444444446,0.0,20.0
10009,1,9,[127 195 174   7  22],280,3,34,3.4,0.0,20.0
10010,1,10,[475 288 100 196 318],655,1,35,3.1818181818181817,20.0,20.0
10011,1,11,[127  97   7  22 269],450,5,40,3.3333333333333335,0.0,20.0
10012,1,12,[161 191 172 597 186],450,4,44,3.3846153846153846,0.0,0.0
10013,1,13,[127 597 228 191 269],796,4,48,3.4285714285714284,0.0,20.0
10014,1,14,[655 197 111   7 100],151,4,52,3.466666666666667,0.0,20.0
10015,1,15,[127 597   7 191 228],344,4,56,3.5,0.0,20.0
10016,1,16,[127 655   7 191 228],457,5,61,3.588235294117647,0.0,20.0
10017,1,17,[211 301 302 191 313],450,5,66,3.6666666666666665,0.0,0.0
10018,1,18,[ 69  70 168 471 132],716,4,70,3.6842105263157894,0.0,0.0
10019,1,19,[183 200 194 742 282],450,4,74,3.7,0.0,0.0
10020,1,20,[127  97 183 228   7],344,4,78,3.7142857142857144,0.0,20.0
10021,1,21,[127 313 132 183 228],450,5,83,3.772727272727273,0.0,20.0
10022,1,22,[ 79 496 111 286   1],450,5,88,3.8260869565217392,20.0,20.0
10023,1,23,[127 318 183 228   7],457,5,93,3.875,20.0,20.0
10024,1,24,[234 275 100  69 185],796,3,96,3.84,0.0,40.0
10025,1,25,[403 597 176 118 496],450,4,100,3.8461538461538463,20.0,0.0
10026,1,26,[ 98  64 211 168 515],18,4,104,3.8518518518518516,20.0,0.0
10027,1,27,[174 182 282 176  12],655,1,105,3.75,0.0,0.0
10028,1,28,[127 132 228   7 161],693,3,108,3.7241379310344827,0.0,20.0
10029,1,29,[127 403 183   7 182],655,3,111,3.7,0.0,20.0
10030,1,30,[238 172  97 385  96],655,1,112,3.6129032258064515,0.0,0.0
10031,1,31,[127 318 183 182 515],269,4,116,3.625,20.0,20.0
10032,1,32,[180  64 328  98 269],796,3,119,3.606060606060606,20.0,0.0
10033,1,33,[301  69  96 168 204],796,4,123,3.6176470588235294,0.0,0.0
10034,1,34,[271 257 313 161 678],807,3,126,3.6,0.0,0.0
10035,1,35,[  9   4 181  71 265],280,3,129,3.5833333333333335,0.0,0.0
10036,1,36,[471 118 173 265 111],716,3,132,3.5675675675675675,0.0,0.0
10037,1,37,[127 132 265 182 515],655,3,135,3.5526315789473686,0.0,20.0
10038,1,38,[238   1 181 127 100],796,2,137,3.5128205128205128,0.0,40.0
10039,1,39,[127 318 182 515 173],269,4,141,3.525,20.0,20.0
10040,1,40,[127 111 182 515 194],18,3,144,3.5121951219512195,0.0,20.0
10041,1,41,[195 568 118 328 228],796,5,149,3.5476190476190474,0.0,0.0
10042,1,42,[127  22 515  64 197],655,3,152,3.5348837209302326,20.0,20.0
10043,1,43,[ 25 125 172 403 179],450,4,156,3.5454545454545454,0.0,0.0
10044,1,44,[127   9 515  64 125],655,3,159,3.533333333333333,20.0,20.0
10045,1,45,[228   8  22   9 405],796,4,163,3.5434782608695654,0.0,0.0
10046,1,46,[127 182  64 328 423],796,5,168,3.574468085106383,20.0,20.0
10047,1,47,[127 182  64 328 423],796,5,173,3.6041666666666665,20.0,20.0
10048,1,48,[180 186 215 172   8],457,5,178,3.63265306122449,0.0,0.0
10049,1,49,[127 191  64 328 423],655,3,181,3.62,20.0,20.0
10050,1,50,[127  69  64 313 318],693,3,184,3.607843137254902,40.0,20.0
10051,1,51,[ 71 483  98 237 273],236,3,187,3.5961538461538463,0.0,0.0
10052,1,52,[127 483 742 237 257],655,2,189,3.5660377358490565,0.0,20.0
10053,1,53,[111  71 435  98 235],450,3,192,3.5555555555555554,0.0,0.0
10054,1,54,[127 496  79 568  98],344,5,197,3.581818181818182,20.0,20.0
10055,1,55,[127 496  79 568  98],344,5,202,3.607142857142857,20.0,20.0
10056,1,56,[127 496  79 568  98],344,5,207,3.6315789473684212,20.0,20.0
10057,1,57,[185  56 323 282  88],796,4,211,3.6379310344827585,0.0,0.0
10058,1,58,[127 483  79 568  98],716,5,216,3.6610169491525424,0.0,20.0
10059,1,59,[234  12 269 288 597],450,3,219,3.65,0.0,0.0
10060,1,60,[127 483  79 568  98],655,4,223,3.6557377049180326,0.0,20.0
10061,1,61,[202 423 568 197 180],457,5,228,3.6774193548387095,0.0,0.0
10062,1,62,[127 496  79  98  56],716,5,233,3.6984126984126986,20.0,20.0
10063,1,63,[302  69 237   1 588],450,5,238,3.71875,0.0,0.0
10064,1,64,[127 483 588  79  98],457,5,243,3.7384615384615385,0.0,20.0
10065,1,65,[127 483 588  79  98],457,5,248,3.757575757575758,0.0,20.0
10066,1,66,[182 245 385  15 405],450,4,252,3.7611940298507465,0.0,0.0
10067,1,67,[127 483 588  79  98],716,5,257,3.7794117647058822,0.0,20.0
10068,1,68,[127 483 588  79  98],716,5,262,3.7971014492753623,0.0,20.0
10069,1,69,[127 483 588  79  98],18,5,267,3.8142857142857145,0.0,20.0
10070,1,70,[183 603 282 508 186],655,2,269,3.788732394366197,20.0,0.0
10071,1,71,[588 176 237 269 215],796,4,273,3.7916666666666665,0.0,0.0
10072,1,72,[ 64 183  70 118 313],344,2,275,3.767123287671233,20.0,0.0
10073,1,73,[191 100 172 144  22],296,5,280,3.7837837837837838,0.0,20.0
10074,1,74,[127 215 435 182 515],321,2,282,3.76,0.0,20.0
10075,1,75,[546  88 202 117 286],450,5,287,3.776315789473684,0.0,20.0
10076,1,76,[302 185 603 144 318],655,4,291,3.779220779220779,40.0,0.0
10077,1,77,[ 88 300 181 210 100],796,3,294,3.769230769230769,0.0,20.0
10078,1,78,[191  95 357 194  88],23,2,296,3.7468354430379747,0.0,0.0
10079,1,79,[  7 195 588 318 204],280,3,299,3.7375,20.0,0.0
10080,1,80,[ 79 210 228 172 742],655,2,301,3.7160493827160495,0.0,0.0
10081,1,81,[282 143 275  28 742],655,2,303,3.6951219512195124,0.0,20.0
10082,1,82,[176 118 237 143 318],450,4,307,3.6987951807228914,20.0,0.0
10083,1,83,[302 185 603 143 318],151,4,311,3.7023809523809526,40.0,0.0
10084,1,84,[245 655 143 405  56],593,2,313,3.6823529411764704,0.0,0.0
10085,1,85,[435 211  98 483 143],236,4,317,3.686046511627907,0.0,0.0
10086,1,86,[ 56  95 603 143 318],716,5,322,3.7011494252873565,40.0,0.0
10087,1,87,[ 56  95 603 143 318],450,4,326,3.7045454545454546,40.0,0.0
10088,1,88,[496  79 318 603 435],18,4,330,3.707865168539326,60.0,0.0
10089,1,89,[496 300 318 435 483],716,5,335,3.7222222222222223,40.0,0.0
10090,1,90,[496 300 318 435 483],807,4,339,3.7252747252747254,40.0,0.0
10091,1,91,[ 22 496   8  95   4],577,5,344,3.739130434782609,20.0,0.0
10092,1,92,[176  89  69   1 175],344,3,347,3.7311827956989245,0.0,0.0
10093,1,93,[185 300 318 143  56],693,4,351,3.734042553191489,20.0,0.0
10094,1,94,[ 79 515 175 143  56],716,4,355,3.736842105263158,0.0,0.0
10095,1,95,[187 288 111 179 742],450,4,359,3.7395833333333335,0.0,0.0
10096,1,96,[204 183 275 180 186],796,3,362,3.731958762886598,0.0,20.0
10097,1,97,[ 79 515 187 143  56],716,4,366,3.7346938775510203,0.0,0.0
10098,1,98,[603 276  15 655 186],655,2,368,3.717171717171717,20.0,0.0
10099,1,99,[423 197 282 237 471],280,1,369,3.69,0.0,0.0
10100,1,100,[515 483 143 496  98],716,5,374,3.702970297029703,20.0,0.0
10101,1,101,[515 483 143 496  98],269,4,378,3.7058823529411766,20.0,0.0
10102,1,102,[515  89 496  98 185],18,3,381,3.6990291262135924,20.0,0.0
10103,1,103,[185 282 194 200 132],796,5,386,3.7115384615384617,0.0,0.0
10104,1,104,[269 182  50 403 196],450,5,391,3.723809523809524,0.0,20.0
10105,1,105,[ 22 276 127 435 496],878,3,394,3.7169811320754715,20.0,20.0
10106,1,106,[515  98 275 202 179],878,5,399,3.7289719626168223,0.0,20.0
10107,1,107,[ 15 282  11  79 100],296,4,403,3.7314814814814814,0.0,20.0
10108,1,108,[257 172 183  79 185],655,4,407,3.7339449541284404,0.0,0.0
10109,1,109,[ 15 143 405 427  12],151,4,411,3.7363636363636363,20.0,0.0
10110,1,110,[258  88 222 144 318],693,3,414,3.72972972972973,20.0,0.0
10111,1,111,[111 153 273 183 471],450,4,418,3.732142857142857,0.0,0.0
10112,1,112,[257 282 121 127 508],296,5,423,3.743362831858407,0.0,20.0
10113,1,113,[ 98 172 423 196 546],457,4,427,3.745614035087719,0.0,0.0
10114,1,114,[ 79 318 258 483  56],693,4,431,3.747826086956522,20.0,0.0
10115,1,115,[245 187 127  71 423],796,4,435,3.75,0.0,20.0
10116,1,116,[ 79 318 258  56 496],151,5,440,3.7606837606837606,40.0,0.0
10117,1,117,[ 79 318 258  56 496],535,3,443,3.7542372881355934,40.0,0.0
10118,1,118,[258  98 275 202 179],450,5,448,3.764705882352941,0.0,20.0
10119,1,119,[258  98 275 202 179],457,5,453,3.775,0.0,20.0
10120,1,120,[405 172  22 275 496],716,5,458,3.7851239669421486,20.0,20.0
10121,1,121,[ 12 655 191 423  64],457,5,463,3.7950819672131146,20.0,0.0
10122,1,122,[  4 197 300 117 234],504,4,467,3.796747967479675,0.0,0.0
10123,1,123,[153  98 275 202 179],878,5,472,3.806451612903226,0.0,20.0
10124,1,124,[153  98 275 202 179],389,4,476,3.808,0.0,20.0
10125,1,125,[405 195  97  50 180],796,3,479,3.8015873015873014,0.0,20.0
10126,1,126,[  4 216 385 135 175],457,5,484,3.811023622047244,0.0,0.0
10127,1,127,[ 89  22   9   7 196],269,1,485,3.7890625,0.0,0.0
10128,1,128,[405 143 222 265 151],807,5,490,3.798449612403101,0.0,0.0
10129,1,129,[742 328 655 748 273],450,4,494,3.8,0.0,0.0
10130,1,130,[568 435 385 405 234],716,4,498,3.801526717557252,0.0,0.0
10131,1,131,[121 135 496 427 318],151,5,503,3.8106060606060606,60.0,0.0
10132,1,132,[121 135 496 427 318],330,4,507,3.81203007518797,60.0,0.0
10133,1,133,[328 204 282 222  82],655,0,507,3.783582089552239,0.0,0.0
10134,1,134,[496 121 318 427 151],807,5,512,3.7925925925925927,60.0,0.0
10135,1,135,[496 121 318 427 151],716,5,517,3.801470588235294,60.0,0.0
10136,1,136,[496 121 318 427 151],716,5,522,3.81021897810219,60.0,0.0
10137,1,137,[496 121 318 427 151],450,4,526,3.8115942028985508,60.0,0.0
10138,1,138,[245 197   1 483  82],796,1,527,3.79136690647482,0.0,0.0
10139,1,139,[235 183 117  98  12],280,4,531,3.7928571428571427,0.0,0.0
10140,1,140,[ 12 191   9 588 196],457,5,536,3.801418439716312,0.0,0.0
10141,1,141,[216 496 275 202 179],786,5,541,3.8098591549295775,20.0,20.0
10142,1,142,[132 210 322  28 196],450,4,545,3.8111888111888113,0.0,0.0
10143,1,143,[282 183 202 185 603],716,3,548,3.8055555555555554,20.0,0.0
10144,1,144,[143 405 151 235 742],457,4,552,3.806896551724138,0.0,0.0
10145,1,145,[ 98 515 318 151 258],878,3,555,3.8013698630136985,20.0,0.0
10146,1,146,[ 98   8 318 427 496],503,5,560,3.8095238095238093,60.0,0.0
10147,1,147,[ 98   8 318 427 496],18,5,565,3.8175675675675675,60.0,0.0
10148,1,148,[ 98   8 318 427 496],330,5,570,3.825503355704698,60.0,0.0
10149,1,149,[ 98   8 318 427 496],577,5,575,3.8333333333333335,60.0,0.0
10150,1,150,[ 98   8 318 427 496],878,4,579,3.834437086092715,60.0,0.0
10151,1,151,[ 56  89 100 172 185],796,4,583,3.835526315789474,0.0,20.0
10152,1,152,[282 211 181 385 496],796,4,587,3.8366013071895426,20.0,0.0
10153,1,153,[194 186   9  15 200],269,3,590,3.831168831168831,0.0,0.0
10154,1,154,[288 202 216 300 742],450,4,594,3.832258064516129,0.0,0.0
10155,1,155,[ 98 174 210 183 143],151,4,598,3.8333333333333335,0.0,0.0
10156,1,156,[423  89  12 427  64],655,3,601,3.828025477707006,40.0,0.0
10157,1,157,[318 275 202 179 588],18,4,605,3.829113924050633,20.0,20.0
10158,1,158,[172 111 237 427 385],655,2,607,3.8176100628930816,20.0,0.0
10159,1,159,[196 187 211 173 603],716,4,611,3.81875,20.0,0.0
10160,1,160,[127 275 210 276  70],18,5,616,3.8260869565217392,0.0,40.0
10161,1,161,[275 427 179 588 748],450,5,621,3.8333333333333335,20.0,20.0
10162,1,162,[289 300 268 204 655],655,0,621,3.8098159509202456,0.0,0.0
10163,1,163,[742 191 748 161 496],450,5,626,3.817073170731707,20.0,0.0
10164,1,164,[288 183  28 216 168],457,5,631,3.824242424242424,0.0,0.0
10165,1,165,[216 322  98 496 748],796,4,635,3.825301204819277,20.0,0.0
10166,1,166,[222 265 200 427 257],716,5,640,3.8323353293413174,20.0,0.0
10167,1,167,[151  70 215 181  98],504,3,643,3.8273809523809526,0.0,0.0
10168,1,168,[173   8 211 483 216],269,2,645,3.8165680473372783,0.0,0.0
10169,1,169,[748 427 275  98 179],450,5,650,3.823529411764706,20.0,20.0
10170,1,170,[100 197  56  69 427],450,5,655,3.8304093567251463,20.0,20.0
10171,1,171,[269 357 161 423 186],655,1,656,3.813953488372093,0.0,0.0
10172,1,172,[ 98 427 275 515 179],18,5,661,3.820809248554913,20.0,20.0
10173,1,173,[125 588 185 172 328],401,2,663,3.810344827586207,0.0,0.0
10174,1,174,[174 271 318 245 202],796,4,667,3.8114285714285714,20.0,0.0
10175,1,175,[328 144 475  96 125],655,0,667,3.789772727272727,0.0,0.0
10176,1,176,[ 98 427 275 496 179],389,5,672,3.7966101694915255,40.0,20.0
10177,1,177,[435 168 135 210 121],401,2,674,3.7865168539325844,0.0,0.0
10178,1,178,[ 98 427 275 496 179],450,5,679,3.793296089385475,40.0,20.0
10179,1,179,[ 98 427 275 496 179],389,5,684,3.8,40.0,20.0
10180,1,180,[176 125 194  25 269],503,4,688,3.8011049723756907,0.0,0.0
10181,1,181,[282 222  12 546  98],457,4,692,3.802197802197802,0.0,0.0
10182,1,182,[ 98 427 275 496 179],535,4,696,3.80327868852459,40.0,20.0
10183,1,183,[258  69 182 176 385],655,1,697,3.7880434782608696,0.0,0.0
10184,1,184,[181 117  96 135 427],693,4,701,3.789189189189189,20.0,0.0
10185,1,185,[186 185  22 515   7],655,2,703,3.7795698924731185,0.0,0.0
10186,1,186,[144 423 385 302 222],655,1,704,3.764705882352941,0.0,0.0
10187,1,187,[655  70 276 603 153],269,3,707,3.7606382978723403,20.0,0.0
10188,1,188,[318 196 172  69 655],593,4,711,3.761904761904762,20.0,0.0
10189,1,189,[318 496 275 515 179],18,5,716,3.768421052631579,40.0,20.0
10190,1,190,[568  71 100 546 655],577,3,719,3.764397905759162,0.0,20.0
10191,1,191,[ 89 210  22  82 204],269,0,719,3.7447916666666665,0.0,0.0
10192,1,192,[228 275  50 181 111],798,3,722,3.7409326424870466,0.0,40.0
10193,1,193,[  4 288 215 121 435],655,0,722,3.7216494845360826,0.0,0.0
10194,1,194,[173 269 475 204 271],629,4,726,3.723076923076923,0.0,0.0
10195,1,195,[196 216 210 276 172],655,3,729,3.7193877551020407,0.0,0.0
10196,1,196,[194 210   7 222 180],72,3,732,3.715736040609137,0.0,0.0
10197,1,197,[234  70 475 423 175],269,3,735,3.712121212121212,0.0,0.0
10198,1,198,[235  82 222 200 216],716,4,739,3.71356783919598,0.0,0.0
10199,1,199,[176 423   1 515 172],72,3,742,3.71,0.0,0.0
10200,1,200,[318 496 275 515 179],535,4,746,3.711442786069652,40.0,20.0
10201,1,201,[318 117 275 427 179],655,4,750,3.712871287128713,40.0,20.0
10202,1,202,[183 288 185  28 117],450,4,754,3.7142857142857144,0.0,0.0
10203,1,203,[318 268 269 289  12],655,1,755,3.700980392156863,20.0,0.0
10204,1,204,[234  89 181 302  15],269,0,755,3.682926829268293,0.0,0.0
10205,1,205,[ 97 318 132  69 151],330,5,760,3.6893203883495147,20.0,0.0
10206,1,206,[ 71 194 202 117 127],450,4,764,3.6908212560386473,0.0,20.0
10207,1,207,[ 50 100 271 176 161],72,2,766,3.6826923076923075,0.0,40.0
10208,1,208,[318 496 275 427 179],236,2,768,3.674641148325359,60.0,20.0
10209,1,209,[ 97 153 268 234 179],655,1,769,3.6619047619047618,0.0,0.0
10210,1,210,[301  96 183 269   9],796,2,771,3.654028436018957,0.0,0.0
10211,1,211,[194 127 282 143 322],504,4,775,3.6556603773584904,0.0,20.0
10212,1,212,[204 117 328 111   7],450,5,780,3.6619718309859155,0.0,0.0
10213,1,213,[427 748 318 127  98],450,5,785,3.6682242990654204,40.0,20.0
10214,1,214,[ 89 313 588  28  70],450,5,790,3.6744186046511627,0.0,0.0
10215,1,215,[427 748 318 127  98],450,5,795,3.6805555555555554,40.0,20.0
10216,1,216,[191 357 403 222 186],796,4,799,3.6820276497695854,0.0,0.0
10217,1,217,[ 64  28  97  69 286],236,5,804,3.688073394495413,20.0,20.0
10218,1,218,[427 748 318 127  98],796,5,809,3.6940639269406392,40.0,20.0
10219,1,219,[427 748 318 127  98],796,5,814,3.7,40.0,20.0
10220,1,220,[ 25 496  98 182 132],389,4,818,3.7013574660633486,20.0,0.0
10221,1,221,[  1 195 237 435 132],535,4,822,3.7027027027027026,0.0,0.0
10222,1,222,[135  69 483 173 237],716,4,826,3.704035874439462,0.0,0.0
10223,1,223,[427 748 318 127  98],796,5,831,3.7098214285714284,40.0,20.0
10224,1,224,[427 748 318 127  98],796,5,836,3.7155555555555555,40.0,20.0
10225,1,225,[181 204 748 286 282],796,4,840,3.7168141592920354,0.0,20.0
10226,1,226,[210 403  97 179 144],450,4,844,3.7180616740088106,0.0,0.0
10227,1,227,[322 234 151  69 238],450,4,848,3.719298245614035,0.0,0.0
10228,1,228,[357 118 294 183 176],655,2,850,3.7117903930131004,0.0,0.0
10229,1,229,[427 318 748 127  98],796,5,855,3.717391304347826,40.0,20.0
10230,1,230,[385 234 153  25 121],151,3,858,3.7142857142857144,0.0,0.0
10231,1,231,[318 748 427 127  98],450,5,863,3.7198275862068964,40.0,20.0
10232,1,232,[318 748 427 127  98],796,5,868,3.725321888412017,40.0,20.0
10233,1,233,[588 603 176   9  15],796,4,872,3.7264957264957266,20.0,0.0
10234,1,234,[215 181 100 111 265],577,5,877,3.7319148936170214,0.0,20.0
10235,1,235,[ 28  69 181  12 202],577,5,882,3.73728813559322,0.0,0.0
10236,1,236,[ 15 282 222  12 597],256,4,886,3.738396624472574,0.0,0.0
10237,1,237,[318 427 748 127  98],450,5,891,3.7436974789915967,40.0,20.0
10238,1,238,[234 265 435 313 179],450,4,895,3.7447698744769875,0.0,0.0
10239,1,239,[483 121  12 423 118],450,2,897,3.7375,0.0,0.0
10240,1,240,[588 168 132 357 100],457,5,902,3.7427385892116183,0.0,20.0
10241,1,241,[187 471  97   4 183],716,1,903,3.731404958677686,0.0,0.0
10242,1,242,[276 195  15 153 186],269,1,904,3.720164609053498,0.0,0.0
10243,1,243,[655 313 508   9 118],280,1,905,3.709016393442623,0.0,0.0
10244,1,244,[318 748 427 127  98],450,5,910,3.7142857142857144,40.0,20.0
10245,1,245,[318 748 427 127  98],450,5,915,3.7195121951219514,40.0,20.0
10246,1,246,[ 15  56 234 276  50],256,3,918,3.716599190283401,0.0,20.0
10247,1,247,[ 64 403 271 202 183],655,2,920,3.7096774193548385,20.0,0.0
10248,1,248,[228 273 588   8 132],344,5,925,3.714859437751004,0.0,0.0
10249,1,249,[427 748 318 127  98],796,5,930,3.72,40.0,20.0
10250,1,250,[568 186 234 300 118],796,3,933,3.7171314741035855,0.0,0.0
10251,1,251,[117   9 288 257 275],457,4,937,3.7182539682539684,0.0,20.0
10252,1,252,[357   4 423 204 132],504,4,941,3.719367588932806,0.0,0.0
10253,1,253,[234  22 111 423 215],152,5,946,3.7244094488188977,0.0,0.0
10254,1,254,[597 125 196 483   4],457,4,950,3.7254901960784315,0.0,0.0
10255,1,255,[118 748  98  97 546],256,5,955,3.73046875,0.0,0.0
10256,1,256,[294 222 302 603 275],450,4,959,3.7315175097276265,20.0,20.0
10257,1,257,[427 748 318 127  98],450,5,964,3.7364341085271318,40.0,20.0
10258,1,258,[183 237 200 313 125],450,4,968,3.7374517374517375,0.0,0.0
10259,1,259,[282 202 258  50 269],796,4,972,3.7384615384615385,0.0,20.0
10260,1,260,[180 153 195 174 151],504,4,976,3.739463601532567,0.0,0.0
10261,1,261,[125  95 405  15 427],450,3,979,3.736641221374046,20.0,0.0
10262,1,262,[483 127 204 357  25],401,4,983,3.7376425855513307,0.0,20.0
10263,1,263,[655 237 313 245 546],280,1,984,3.727272727272727,0.0,0.0
10264,1,264,[237  88 100  69 200],236,2,986,3.720754716981132,0.0,20.0
10265,1,265,[144 423 385 234 427],655,1,987,3.710526315789474,20.0,0.0
10266,1,266,[265   4 196  98 153],716,4,991,3.7116104868913857,0.0,0.0
10267,1,267,[ 71 357 132  95  22],450,3,994,3.708955223880597,0.0,0.0
10268,1,268,[427 748 318  98 496],151,4,998,3.7100371747211898,60.0,0.0
10269,1,269,[427 318  98 496 127],716,5,1003,3.714814814814815,60.0,20.0
10270,1,270,[427 318  98 496 127],503,5,1008,3.7195571955719555,60.0,20.0
10271,1,271,[427 318  98 496 127],450,5,1013,3.724264705882353,60.0,20.0
10272,1,272,[427 318  98 496 127],908,5,1018,3.728937728937729,60.0,20.0
10273,1,273,[427 318  98 496 127],908,5,1023,3.7335766423357666,60.0,20.0
10274,1,274,[427 318  98 496 127],878,5,1028,3.7381818181818183,60.0,20.0
10275,1,275,[427 318  98 496 127],18,5,1033,3.7427536231884058,60.0,20.0
10276,1,276,[222 275 216  15 546],796,5,1038,3.747292418772563,0.0,20.0
10277,1,277,[427 318  98 496 127],503,5,1043,3.7517985611510793,60.0,20.0
10278,1,278,[546 183 318  50  98],503,5,1048,3.7562724014336917,20.0,20.0
10279,1,279,[405 121  25   1 471],938,3,1051,3.7535714285714286,0.0,0.0
10280,1,280,[  1 588 111 258 143],756,4,1055,3.7544483985765122,0.0,0.0
10281,1,281,[ 96 125  98  89 100],344,4,1059,3.75531914893617,0.0,20.0
10282,1,282,[427 318  98 496 127],450,5,1064,3.7597173144876326,60.0,20.0
10283,1,283,[127 655   4  11  82],655,1,1065,3.75,0.0,20.0
10284,1,284,[195 496 173 202 210],151,4,1069,3.7508771929824563,20.0,0.0
10285,1,285,[427 318  98 496 127],908,5,1074,3.7552447552447554,60.0,20.0
10286,1,286,[427 318  98 496 127],450,5,1079,3.759581881533101,60.0,20.0
10287,1,287,[427 318  98 496 127],236,4,1083,3.7604166666666665,60.0,20.0
10288,1,288,[ 89 196 143 405   1],786,5,1088,3.764705882352941,0.0,0.0
10289,1,289,[427 318  98 127 275],796,5,1093,3.768965517241379,40.0,40.0
10290,1,290,[204   7 568 200 197],655,1,1094,3.759450171821306,0.0,0.0
10291,1,291,[318 427  98 127 275],236,4,1098,3.76027397260274,40.0,40.0
10292,1,292,[427   4 151 172 238],389,5,1103,3.7645051194539247,20.0,0.0
10293,1,293,[318 427  98 127 496],269,5,1108,3.7687074829931975,60.0,20.0
10294,1,294,[318 427  98 127 496],716,5,1113,3.772881355932203,60.0,20.0
10295,1,295,[151 322 180 153 117],450,5,1118,3.777027027027027,0.0,0.0
10296,1,296,[318 427  98 127 496],18,5,1123,3.781144781144781,60.0,20.0
10297,1,297,[ 97 153 258 423 302],151,3,1126,3.778523489932886,0.0,0.0
10298,1,298,[144  69 234 423 200],655,1,1127,3.769230769230769,0.0,0.0
10299,1,299,[427 318  98 127 496],18,5,1132,3.7733333333333334,60.0,20.0
10300,1,300,[427 318  98 127 496],18,5,1137,3.777408637873754,60.0,20.0
10301,1,301,[427 318  98 127 496],269,5,1142,3.781456953642384,60.0,20.0
10302,1,302,[268  82 179 405 237],269,2,1144,3.7755775577557755,0.0,0.0
10303,1,303,[427 318  98 127 496],908,5,1149,3.7796052631578947,60.0,20.0
10304,1,304,[427 318  98 127 496],503,5,1154,3.783606557377049,60.0,20.0
10305,1,305,[427 318  98 127 496],796,5,1159,3.787581699346405,60.0,20.0
10306,1,306,[427 318  98 127 496],236,4,1163,3.788273615635179,60.0,20.0
10307,1,307,[427 318  98 127 179],835,5,1168,3.792207792207792,40.0,20.0
10308,1,308,[427 294 286 302  71],450,4,1172,3.792880258899676,20.0,20.0
10309,1,309,[183 175 273 125 385],655,2,1174,3.7870967741935484,0.0,0.0
10310,1,310,[175  64  70  97 405],151,4,1178,3.787781350482315,20.0,0.0
10311,1,311,[318 427  98 127 179],655,5,1183,3.7916666666666665,40.0,20.0
10312,1,312,[204  98 161 234 276],786,3,1186,3.7891373801916934,0.0,0.0
10313,1,313,[ 71 483  11 257 276],401,2,1188,3.78343949044586,0.0,0.0
10314,1,314,[427 318  98 127 179],878,5,1193,3.787301587301587,40.0,20.0
10315,1,315,[125 118  89  70 121],450,3,1196,3.7848101265822787,0.0,0.0
10316,1,316,[234 194 405 435 471],716,4,1200,3.7854889589905363,0.0,0.0
10317,1,317,[ 22  11 135 202 197],330,4,1204,3.7861635220125787,0.0,0.0
10318,1,318,[588 197 257 403 245],796,3,1207,3.7836990595611284,0.0,0.0
10319,1,319,[318 427  98 127 179],835,5,1212,3.7875,40.0,20.0
10320,1,320,[318 427  98 127 179],450,5,1217,3.791277258566978,40.0,20.0
10321,1,321,[318 427  98 127 179],878,5,1222,3.7950310559006213,40.0,20.0
10322,1,322,[318 427  98 127 179],269,5,1227,3.7987616099071206,40.0,20.0
10323,1,323,[195 118  56  22  28],796,4,1231,3.799382716049383,0.0,0.0
10324,1,324,[ 97  12   7 423 385],577,4,1235,3.8,0.0,0.0
10325,1,325,[318 427  98 127 179],18,5,1240,3.803680981595092,40.0,20.0
10326,1,326,[318 427  98 127 179],269,5,1245,3.8073394495412844,40.0,20.0
10327,1,327,[318 427  98 127 179],450,5,1250,3.8109756097560976,40.0,20.0
10328,1,328,[318 427  98 127 179],835,5,1255,3.814589665653495,40.0,20.0
10329,1,329,[318 427  98 127 179],835,5,1260,3.8181818181818183,40.0,20.0
10330,1,330,[318 427  98 127 179],655,5,1265,3.821752265861027,40.0,20.0
10331,1,331,[318 427  98 127 179],450,5,1270,3.825301204819277,40.0,20.0
10332,1,332,[742 202  88 328 144],655,0,1270,3.813813813813814,0.0,0.0
10333,1,333,[ 11 222 173 195  50],344,4,1274,3.81437125748503,0.0,20.0
10334,1,334,[216 196 117 423 238],655,1,1275,3.8059701492537314,0.0,0.0
10335,1,335,[427 318  98 127 179],878,5,1280,3.8095238095238093,40.0,20.0
10336,1,336,[597 269 328  79 748],796,4,1284,3.8100890207715135,0.0,0.0
10337,1,337,[357   8   1 180   9],796,2,1286,3.804733727810651,0.0,0.0
10338,1,338,[179 282 300 483 655],450,4,1290,3.8053097345132745,0.0,0.0
10339,1,339,[204 515 172 286 588],18,3,1293,3.802941176470588,0.0,20.0
10340,1,340,[427 318  98 127 179],18,5,1298,3.806451612903226,40.0,20.0
10341,1,341,[427 318  98 127 179],236,4,1302,3.807017543859649,40.0,20.0
10342,1,342,[121 144 172 385  64],655,2,1304,3.801749271137026,20.0,0.0
10343,1,343,[204 333 288 271 210],655,0,1304,3.7906976744186047,0.0,0.0
10344,1,344,[496 483  22 258 435],535,4,1308,3.791304347826087,20.0,0.0
10345,1,345,[174 135  15 294 508],655,1,1309,3.7832369942196533,0.0,0.0
10346,1,346,[471  97 276 173 568],344,3,1312,3.7809798270893373,0.0,0.0
10347,1,347,[185 427 403 174 117],330,5,1317,3.7844827586206895,20.0,0.0
10348,1,348,[ 69 181 204 318  97],655,1,1318,3.7765042979942693,20.0,0.0
10349,1,349,[174  64 655 405 288],457,5,1323,3.78,20.0,0.0
10350,1,350,[ 69 186 748 100  82],151,2,1325,3.774928774928775,0.0,20.0
10351,1,351,[427 318  98 127  79],908,5,1330,3.778409090909091,40.0,20.0
10352,1,352,[204 179 191  12 151],18,3,1333,3.776203966005666,0.0,0.0
10353,1,353,[427 318  98 127  79],655,5,1338,3.7796610169491527,40.0,20.0
10354,1,354,[427 318  98 127  79],655,5,1343,3.7830985915492956,40.0,20.0
10355,1,355,[427 318  98 127  79],693,5,1348,3.7865168539325844,40.0,20.0
10356,1,356,[427 318  98 127  79],236,5,1353,3.7899159663865545,40.0,20.0
10357,1,357,[427 318  98 127  79],908,5,1358,3.793296089385475,40.0,20.0
10358,1,358,[427 318  98 127  79],908,5,1363,3.796657381615599,40.0,20.0
10359,1,359,[427 318  98 127  79],693,5,1368,3.8,40.0,20.0
10360,1,360,[ 95 275 323 405 125],798,4,1372,3.8005540166204987,0.0,20.0
10361,1,361,[427 318  98 127  79],693,5,1377,3.803867403314917,40.0,20.0
10362,1,362,[195 175 191 117 546],716,2,1379,3.798898071625344,0.0,0.0
10363,1,363,[427 318  98 127  79],236,5,1384,3.802197802197802,40.0,20.0
10364,1,364,[282  82 153  97 111],655,0,1384,3.791780821917808,0.0,0.0
10365,1,365,[427 318  98 127  79],716,5,1389,3.7950819672131146,40.0,20.0
10366,1,366,[427 318  98 127  79],908,5,1394,3.7983651226158037,40.0,20.0
10367,1,367,[427 318  98 127  79],72,5,1399,3.801630434782609,40.0,20.0
10368,1,368,[427 318  98 127  79],72,5,1404,3.8048780487804876,40.0,20.0
10369,1,369,[143 496 183  64  97],731,4,1408,3.8054054054054056,40.0,0.0
10370,1,370,[186 273  88 271 111],655,1,1409,3.797843665768194,0.0,0.0
10371,1,371,[318 427  98 127  79],796,5,1414,3.8010752688172045,40.0,20.0
10372,1,372,[483 603 117 191 132],450,4,1418,3.8016085790884717,20.0,0.0
10373,1,373,[318 427  98 127  79],655,5,1423,3.804812834224599,40.0,20.0
10374,1,374,[ 25 200 271 174 179],655,2,1425,3.8,0.0,0.0
10375,1,375,[318 427  98 127  79],693,5,1430,3.8031914893617023,40.0,20.0
10376,1,376,[318 427  98 127  79],719,4,1434,3.8037135278514587,40.0,20.0
10377,1,377,[318 427  98  79 127],719,4,1438,3.804232804232804,40.0,20.0
10378,1,378,[318 427  98  79 127],18,5,1443,3.807387862796834,40.0,20.0
10379,1,379,[318 427  98  79 127],450,5,1448,3.8105263157894735,40.0,20.0
10380,1,380,[318 427  98  79 127],655,5,1453,3.8136482939632548,40.0,20.0
10381,1,381,[318 427  98  79 127],18,5,1458,3.816753926701571,40.0,20.0
10382,1,382,[318 427  98  79 127],503,5,1463,3.8198433420365534,40.0,20.0
10383,1,383,[185 286 194 204 127],623,4,1467,3.8203125,0.0,40.0
10384,1,384,[546 265  64  22 427],796,5,1472,3.8233766233766233,40.0,0.0
10385,1,385,[588 496 238  71 153],330,5,1477,3.826424870466321,20.0,0.0
10386,1,386,[302 200 322 143 286],450,4,1481,3.8268733850129197,0.0,20.0
10387,1,387,[427 318  98  79 127],719,4,1485,3.827319587628866,40.0,20.0
10388,1,388,[427 318  98  79 127],18,5,1490,3.8303341902313623,40.0,20.0
10389,1,389,[427 318  98  79 127],716,5,1495,3.8333333333333335,40.0,20.0
10390,1,390,[427 318  98  79 127],18,5,1500,3.836317135549872,40.0,20.0
10391,1,391,[427 318  98  79 127],450,5,1505,3.8392857142857144,40.0,20.0
10392,1,392,[427 318  98  79 127],693,5,1510,3.842239185750636,40.0,20.0
10393,1,393,[427 318  98  79 127],796,5,1515,3.8451776649746194,40.0,20.0
10394,1,394,[286 294 185 318 132],796,3,1518,3.8430379746835444,20.0,20.0
10395,1,395,[427 318  98  79 127],655,5,1523,3.845959595959596,40.0,20.0
10396,1,396,[187 257 194 655 175],716,3,1526,3.8438287153652393,0.0,0.0
10397,1,397,[294  11 288 153 100],450,4,1530,3.8442211055276383,0.0,20.0
10398,1,398,[427 318  98  79 127],450,5,1535,3.8471177944862154,40.0,20.0
10399,1,399,[ 50 234  71 423 276],280,3,1538,3.845,0.0,20.0
10400,1,400,[496 210 197   9 678],280,2,1540,3.8403990024937658,20.0,0.0
10401,1,401,[405 515 204 202 603],401,4,1544,3.8407960199004973,20.0,0.0
10402,1,402,[265  28  79  96 313],807,4,1548,3.8411910669975184,0.0,0.0
10403,1,403,[427 318  98  79 127],72,5,1553,3.844059405940594,40.0,20.0
10404,1,404,[427 318  98  79 127],719,4,1557,3.8444444444444446,40.0,20.0
10405,1,405,[238  69 568 275 118],796,4,1561,3.8448275862068964,0.0,20.0
10406,1,406,[427 318  98  79 127],72,5,1566,3.847665847665848,40.0,20.0
10407,1,407,[258   8  12  70 268],344,2,1568,3.843137254901961,0.0,0.0
10408,1,408,[427 318  98  79 127],908,5,1573,3.845965770171149,40.0,20.0
10409,1,409,[191  28  88 496 181],151,4,1577,3.846341463414634,20.0,0.0
10410,1,410,[423 181  12 655 117],796,4,1581,3.846715328467153,0.0,0.0
10411,1,411,[318 427  98  79 127],796,5,1586,3.849514563106796,40.0,20.0
10412,1,412,[318 427  98  79 127],716,5,1591,3.8523002421307506,40.0,20.0
10413,1,413,[318 427  98  79 127],716,5,1596,3.8550724637681157,40.0,20.0
10414,1,414,[318 427  98  79 127],503,5,1601,3.8578313253012047,40.0,20.0
10415,1,415,[318 427  98  79 127],796,5,1606,3.860576923076923,40.0,20.0
10416,1,416,[186 603 483 496 153],321,5,1611,3.8633093525179856,40.0,0.0
10417,1,417,[318 427  98  79 127],72,5,1616,3.8660287081339715,40.0,20.0
10418,1,418,[318 427  98  79 127],719,4,1620,3.8663484486873507,40.0,20.0
10419,1,419,[294 423 211   9 742],796,1,1621,3.8595238095238096,0.0,0.0
10420,1,420,[286  12  82 183 300],450,4,1625,3.8598574821852734,0.0,20.0
10421,1,421,[234 603 300 176 210],796,3,1628,3.8578199052132702,20.0,0.0
10422,1,422,[153 245 483 187 403],796,4,1632,3.858156028368794,0.0,0.0
10423,1,423,[318 427  98  79 496],450,5,1637,3.8608490566037736,60.0,0.0
10424,1,424,[318 427  98  79 496],535,3,1640,3.8588235294117648,60.0,0.0
10425,1,425,[318 427  98  79 496],236,4,1644,3.859154929577465,60.0,0.0
10426,1,426,[318 427  98  79 515],72,5,1649,3.8618266978922717,40.0,0.0
10427,1,427,[186  64 132 197 405],716,4,1653,3.8621495327102804,20.0,0.0
10428,1,428,[186 153 300 183 496],151,3,1656,3.86013986013986,20.0,0.0
10429,1,429,[318 427  98  79 515],535,2,1658,3.855813953488372,40.0,0.0
10430,1,430,[357 322 194 204 288],504,3,1661,3.8538283062645013,0.0,0.0
10431,1,431,[ 82  95 385 118 405],280,2,1663,3.849537037037037,0.0,0.0
10432,1,432,[318 427  98  79 179],18,5,1668,3.852193995381062,40.0,0.0
10433,1,433,[323  98  71 294  88],280,2,1670,3.847926267281106,0.0,0.0
10434,1,434,[318 427  98  79 179],236,4,1674,3.8482758620689657,40.0,0.0
10435,1,435,[318 427  98  79 127],655,5,1679,3.8509174311926606,40.0,20.0
10436,1,436,[ 69 200 179 186 196],835,5,1684,3.8535469107551488,0.0,0.0
10437,1,437,[427 318  98  79 127],72,5,1689,3.856164383561644,40.0,20.0
10438,1,438,[427 318  98  79 127],18,5,1694,3.85876993166287,40.0,20.0
10439,1,439,[204 143 496  88  98],269,2,1696,3.8545454545454545,20.0,0.0
10440,1,440,[286 238 161  12 210],655,0,1696,3.8458049886621315,0.0,20.0
10441,1,441,[427 318  98  79 127],716,5,1701,3.8484162895927603,40.0,20.0
10442,1,442,[ 25 357 245 118 121],450,2,1703,3.8442437923250563,0.0,0.0
10443,1,443,[  8  82 238 603 423],269,3,1706,3.8423423423423424,20.0,0.0
10444,1,444,[427 318  98  79 127],503,5,1711,3.844943820224719,40.0,20.0
10445,1,445,[427 318  98  79 127],236,5,1716,3.8475336322869955,40.0,20.0
10446,1,446,[127 179 313  22   1],296,5,1721,3.850111856823266,0.0,20.0
10447,1,447,[427 318  98  79 127],655,5,1726,3.8526785714285716,40.0,20.0
10448,1,448,[427 318  98  79 127],908,5,1731,3.8552338530066814,40.0,20.0
10449,1,449,[111 357 117 294 603],401,3,1734,3.8533333333333335,20.0,0.0
10450,1,450,[427 318  98  79 127],562,4,1738,3.8536585365853657,40.0,20.0
10451,1,451,[ 71 174   9  98 195],796,4,1742,3.853982300884956,0.0,0.0
10452,1,452,[496 216  56 423   7],908,3,1745,3.8520971302428255,20.0,0.0
10453,1,453,[427 318  98  79 127],655,5,1750,3.854625550660793,40.0,20.0
10454,1,454,[427 318  98  79 127],693,5,1755,3.857142857142857,40.0,20.0
10455,1,455,[237 176  97 197 191],796,3,1758,3.8552631578947367,0.0,0.0
10456,1,456,[427 318  98  79 127],796,5,1763,3.8577680525164113,40.0,20.0
10457,1,457,[294 496 546 222 118],450,3,1766,3.8558951965065504,20.0,0.0
10458,1,458,[301 289  64 237 508],655,1,1767,3.849673202614379,20.0,0.0
10459,1,459,[427 318  98  79 127],562,4,1771,3.85,40.0,20.0
10460,1,460,[427 318  98  79 127],562,4,1775,3.8503253796095445,40.0,20.0
10461,1,461,[427  98 318  79 127],236,5,1780,3.8528138528138527,40.0,20.0
10462,1,462,[427  98 318  79 127],908,5,1785,3.8552915766738662,40.0,20.0
10463,1,463,[427  98 318  79 127],693,5,1790,3.8577586206896552,40.0,20.0
10464,1,464,[427  98 318  79 127],562,4,1794,3.858064516129032,40.0,20.0
10465,1,465,[427  98 318  79 127],908,5,1799,3.8605150214592276,40.0,20.0
10466,1,466,[  1   8 508 204 496],731,2,1801,3.856531049250535,20.0,0.0
10467,1,467,[238  15  96 508 568],655,0,1801,3.8482905982905984,0.0,0.0
10468,1,468,[427  98 318  79 127],503,5,1806,3.8507462686567164,40.0,20.0
10469,1,469,[357 151 195 118 318],716,3,1809,3.848936170212766,20.0,0.0
10470,1,470,[ 69 603 216 172 181],450,5,1814,3.851380042462845,20.0,0.0
10471,1,471,[  4 603 235  71 180],450,2,1816,3.847457627118644,20.0,0.0
10472,1,472,[423 100  71 161 405],796,4,1820,3.8477801268498943,0.0,20.0
10473,1,473,[427  98 318  79 127],908,5,1825,3.850210970464135,40.0,20.0
10474,1,474,[427  98 318  79 127],796,5,1830,3.8526315789473684,40.0,20.0
10475,1,475,[427  98 318  79 127],562,4,1834,3.8529411764705883,40.0,20.0
10476,1,476,[111 179 183 202   8],269,1,1835,3.846960167714885,0.0,0.0
10477,1,477,[427  98 318  79 127],18,5,1840,3.8493723849372383,40.0,20.0
10478,1,478,[427  98 318  79 127],655,5,1845,3.8517745302713986,40.0,20.0
10479,1,479,[427  98 318  79 127],18,5,1850,3.8541666666666665,40.0,20.0
10480,1,480,[257  56 475 313 300],655,1,1851,3.8482328482328483,0.0,0.0
10481,1,481,[ 64 100 294 546 300],796,3,1854,3.8464730290456433,20.0,20.0
10482,1,482,[427  98 318  79 127],236,5,1859,3.8488612836438922,40.0,20.0
10483,1,483,[187 546 200 151  64],450,4,1863,3.8491735537190084,20.0,0.0
10484,1,484,[427  98 318  79 127],450,5,1868,3.8515463917525774,40.0,20.0
10485,1,485,[197  98  97  25 151],330,5,1873,3.853909465020576,0.0,0.0
10486,1,486,[210 748 204 568 265],280,1,1874,3.8480492813141685,0.0,0.0
10487,1,487,[ 50 125 322 200 144],593,4,1878,3.848360655737705,0.0,20.0
10488,1,488,[427  98 318  79 127],18,5,1883,3.850715746421268,40.0,20.0
10489,1,489,[427  98 318  79 127],72,5,1888,3.853061224489796,40.0,20.0
10490,1,490,[427  98 318  79 127],562,4,1892,3.8533604887983706,40.0,20.0
10491,1,491,[427  98  79 318 127],655,5,1897,3.855691056910569,40.0,20.0
10492,1,492,[111 187 204 143 655],786,5,1902,3.8580121703853956,0.0,0.0
10493,1,493,[427  98  79 318 127],72,5,1907,3.860323886639676,40.0,20.0
10494,1,494,[427  98  79 318 127],716,5,1912,3.8626262626262626,40.0,20.0
10495,1,495,[427  98  79 318 127],693,5,1917,3.8649193548387095,40.0,20.0
10496,1,496,[427  98  79 318 127],562,4,1921,3.865191146881288,40.0,20.0
10497,1,497,[ 97 125   1  88 180],450,5,1926,3.8674698795180724,0.0,0.0
10498,1,498,[151 153 174 211 328],236,1,1927,3.8617234468937878,0.0,0.0
10499,1,499,[151 211 153  11 210],535,5,1932,3.864,0.0,0.0
10500,1,500,[117 403  28 282  95],796,4,1936,3.8642714570858283,0.0,0.0
10501,1,501,[258 176  71 235 257],23,1,1937,3.858565737051793,0.0,0.0
10502,1,502,[427  98  79 318 127],72,5,1942,3.8608349900596424,40.0,20.0
10503,1,503,[234  25  88 322 300],151,4,1946,3.861111111111111,0.0,0.0
10504,1,504,[427  98  79 318 127],72,5,1951,3.8633663366336632,40.0,20.0
10505,1,505,[427  98  79 318 127],655,5,1956,3.8656126482213438,40.0,20.0
10506,1,506,[427  98  79 318 127],693,5,1961,3.8678500986193294,40.0,20.0
10507,1,507,[216 228  70 238 357],151,5,1966,3.87007874015748,0.0,0.0
10508,1,508,[427  98  79 318 127],908,5,1971,3.8722986247544204,40.0,20.0
10509,1,509,[182  98  82  71  69],450,3,1974,3.8705882352941177,0.0,0.0
10510,1,510,[427  98  79 318 127],562,4,1978,3.8708414872798436,40.0,20.0
10511,1,511,[197 100 603 204 143],330,5,1983,3.873046875,20.0,20.0
10512,1,512,[427  98  79 127 318],655,5,1988,3.875243664717349,40.0,20.0
10513,1,513,[655 238 180 427 179],450,5,1993,3.877431906614786,20.0,0.0
10514,1,514,[427  98  79 127 318],236,5,1998,3.8796116504854368,40.0,20.0
10515,1,515,[127 174  97 215  96],716,4,2002,3.87984496124031,0.0,20.0
10516,1,516,[427  98  79 127 318],908,5,2007,3.882011605415861,40.0,20.0
10517,1,517,[300 333 234 196 202],655,0,2007,3.8745173745173744,0.0,0.0
10518,1,518,[427  98  79 127 318],18,5,2012,3.876685934489403,40.0,20.0
10519,1,519,[427  98  79 127 318],796,5,2017,3.878846153846154,40.0,20.0
10520,1,520,[202 144 176 318 588],457,5,2022,3.8809980806142033,20.0,0.0
10521,1,521,[427  98  79 127 318],72,5,2027,3.8831417624521074,40.0,20.0
10522,1,522,[  7 294 427 483 132],450,4,2031,3.8833652007648185,20.0,0.0
10523,1,523,[427  98  79 127 318],503,5,2036,3.885496183206107,40.0,20.0
10524,1,524,[427  98  79 127 318],908,5,2041,3.8876190476190478,40.0,20.0
10525,1,525,[427  98  79 127 318],18,5,2046,3.8897338403041823,40.0,20.0
10526,1,526,[427  98  79 127 318],693,5,2051,3.891840607210626,40.0,20.0
10527,1,527,[127 276  88 186 357],786,4,2055,3.8920454545454546,0.0,20.0
10528,1,528,[427  98  79 127 318],796,5,2060,3.89413988657845,40.0,20.0
10529,1,529,[597 200   1 196 216],593,3,2063,3.892452830188679,0.0,0.0
10530,1,530,[427  98  79 127 318],719,4,2067,3.8926553672316384,40.0,20.0
10531,1,531,[200  22  98 197 135],280,4,2071,3.892857142857143,0.0,0.0
10532,1,532,[427  98  79 318 127],716,5,2076,3.8949343339587243,40.0,20.0
10533,1,533,[300 357  82 176  79],151,3,2079,3.893258426966292,0.0,0.0
10534,1,534,[427  98  79 318 127],72,5,2084,3.8953271028037384,40.0,20.0
10535,1,535,[427  98  79 318 127],716,5,2089,3.8973880597014925,40.0,20.0
10536,1,536,[427  98  79 318 127],796,5,2094,3.899441340782123,40.0,20.0
10537,1,537,[202 143 258 318   1],450,5,2099,3.9014869888475836,20.0,0.0
10538,1,538,[211  28 301  71 300],389,4,2103,3.901669758812616,0.0,0.0
10539,1,539,[427  98  79 318 127],450,5,2108,3.903703703703704,40.0,20.0
10540,1,540,[228 191 195 385 117],457,5,2113,3.9057301293900184,0.0,0.0
10541,1,541,[118 300 289 127 333],693,1,2114,3.9003690036900367,0.0,20.0
10542,1,542,[427 300 191 186 568],716,4,2118,3.9005524861878453,20.0,0.0
10543,1,543,[301 196 118 151 357],796,4,2122,3.900735294117647,0.0,0.0
10544,1,544,[ 70 127  28  12 742],655,1,2123,3.8954128440366973,0.0,20.0
10545,1,545,[318  98 568 237 153],716,5,2128,3.8974358974358974,20.0,0.0
10546,1,546,[427  98  79 318 127],562,4,2132,3.8976234003656307,40.0,20.0
10547,1,547,[427  98  79 127 318],796,5,2137,3.8996350364963503,40.0,20.0
10548,1,548,[ 64  97 117  15 318],72,5,2142,3.901639344262295,40.0,0.0
10549,1,549,[427  98  79 127 318],72,5,2147,3.903636363636364,40.0,20.0
10550,1,550,[427  98  79 127 318],18,5,2152,3.9056261343012704,40.0,20.0
10551,1,551,[127 568 265 185 181],450,5,2157,3.907608695652174,0.0,20.0
10552,1,552,[204 125 235 202 180],450,4,2161,3.907775768535262,0.0,0.0
10553,1,553,[196 313 423   1 483],450,4,2165,3.907942238267148,0.0,0.0
10554,1,554,[ 15 197  28 289 323],798,3,2168,3.9063063063063064,0.0,0.0
10555,1,555,[427  98  79 127 318],18,5,2173,3.908273381294964,40.0,20.0
10556,1,556,[100  98 185   7   1],65,2,2175,3.9048473967684023,0.0,20.0
10557,1,557,[427  98  79 127 318],72,5,2180,3.9068100358422937,40.0,20.0
10558,1,558,[427  98  79 127 318],908,5,2185,3.9087656529516996,40.0,20.0
10559,1,559,[427  98  79 127 318],503,5,2190,3.9107142857142856,40.0,20.0
10560,1,560,[427  98  79 127 318],562,4,2194,3.910873440285205,40.0,20.0
10561,1,561,[313  11  96 597 603],450,5,2199,3.912811387900356,20.0,0.0
10562,1,562,[ 88 111 194 588 117],716,5,2204,3.9147424511545292,0.0,0.0
10563,1,563,[174  15 289 185 183],655,2,2206,3.9113475177304964,0.0,0.0
10564,1,564,[427  98  79 127  64],236,5,2211,3.9132743362831857,40.0,20.0
10565,1,565,[ 97 603   4 117 127],450,4,2215,3.9134275618374557,20.0,20.0
10566,1,566,[427  98  79 127  64],72,5,2220,3.9153439153439153,40.0,20.0
10567,1,567,[197  70 357 265 405],716,5,2225,3.9172535211267605,0.0,0.0
10568,1,568,[427  98  79 127  64],450,5,2230,3.9191564147627416,40.0,20.0
10569,1,569,[202 200 294   1 215],457,4,2234,3.9192982456140353,0.0,0.0
10570,1,570,[427  98  79 127  64],72,5,2239,3.9211908931698773,40.0,20.0
10571,1,571,[427  98  79 127  64],450,5,2244,3.923076923076923,40.0,20.0
10572,1,572,[111 174 100 288 237],344,4,2248,3.9232111692844676,0.0,20.0
10573,1,573,[100 197 191 265 216],786,4,2252,3.923344947735192,0.0,20.0
10574,1,574,[  1 121 301 300 257],15,3,2255,3.9217391304347826,0.0,0.0
10575,1,575,[427  98  79 127  64],18,5,2260,3.923611111111111,40.0,20.0
10576,1,576,[427  98  79  64 127],716,5,2265,3.9254766031195842,40.0,20.0
10577,1,577,[427  98  79  64 127],72,5,2270,3.9273356401384083,40.0,20.0
10578,1,578,[655 143 100 238 423],450,5,2275,3.929188255613126,0.0,20.0
10579,1,579,[427  98  79  64 127],450,5,2280,3.9310344827586206,40.0,20.0
10580,1,580,[427  98  79  64 127],719,4,2284,3.9311531841652325,40.0,20.0
10581,1,581,[427  98  79  64 127],18,5,2289,3.9329896907216493,40.0,20.0
10582,1,582,[427  98  79  64 127],716,5,2294,3.934819897084048,40.0,20.0
10583,1,583,[427  98  79  64 127],18,5,2299,3.9366438356164384,40.0,20.0
10584,1,584,[427  98  79  64 127],655,5,2304,3.9384615384615387,40.0,20.0
10585,1,585,[179 175  12 742 216],264,4,2308,3.938566552901024,0.0,0.0
10586,1,586,[427  98  79  64 127],693,4,2312,3.938671209540034,40.0,20.0
10587,1,587,[216  50 286 202   1],330,5,2317,3.9404761904761907,0.0,40.0
10588,1,588,[215  97 496  98  15],796,4,2321,3.940577249575552,20.0,0.0
10589,1,589,[427  98  79 127 603],450,5,2326,3.942372881355932,40.0,20.0
10590,1,590,[228 302 265  79 483],151,4,2330,3.942470389170897,0.0,0.0
10591,1,591,[427  98  79 127 603],421,5,2335,3.9442567567567566,40.0,20.0
10592,1,592,[427  98  79 127 603],796,5,2340,3.946037099494098,40.0,20.0
10593,1,593,[427  98  79 127 603],421,5,2345,3.9478114478114477,40.0,20.0
10594,1,594,[427  98  79 603 127],655,5,2350,3.9495798319327733,40.0,20.0
10595,1,595,[276   8  11 275 143],655,3,2353,3.947986577181208,0.0,20.0
10596,1,596,[ 56  82  69   1 216],280,4,2357,3.9480737018425462,0.0,0.0
10597,1,597,[427  98  79 603 127],389,5,2362,3.9498327759197323,40.0,20.0
10598,1,598,[427  98  79 603 127],655,5,2367,3.951585976627713,40.0,20.0
10599,1,599,[182   1 194 174 127],72,5,2372,3.953333333333333,0.0,20.0
10600,1,600,[427  98  79 603 127],421,5,2377,3.9550748752079867,40.0,20.0
10601,1,601,[427  98  79 603 127],655,5,2382,3.956810631229236,40.0,20.0
10602,1,602,[427  98  79 603 127],421,5,2387,3.958540630182421,40.0,20.0
10603,1,603,[216  70 183  82 181],457,5,2392,3.9602649006622515,0.0,0.0
10604,1,604,[427  98  79 603 127],655,5,2397,3.96198347107438,40.0,20.0
10605,1,605,[427  98  79 603 127],908,5,2402,3.963696369636964,40.0,20.0
10606,1,606,[405 191 271 603 195],72,3,2405,3.9621087314662273,20.0,0.0
10607,1,607,[427  98  79 603 127],72,5,2410,3.963815789473684,40.0,20.0
10608,1,608,[427  98  79 603 127],716,5,2415,3.9655172413793105,40.0,20.0
10609,1,609,[427  98  79 603 127],421,5,2420,3.9672131147540983,40.0,20.0
10610,1,610,[427  98  79 603 127],72,5,2425,3.968903436988543,40.0,20.0
10611,1,611,[655  22 403 143 588],796,4,2429,3.968954248366013,0.0,0.0
10612,1,612,[427  98  79 603 127],18,4,2433,3.9690048939641107,40.0,20.0
10613,1,613,[427  98  79 127 588],450,5,2438,3.970684039087948,20.0,20.0
10614,1,614,[333 211 195 187 237],655,1,2439,3.9658536585365853,0.0,0.0
10615,1,615,[427  98  79 127 588],389,5,2444,3.9675324675324677,20.0,20.0
10616,1,616,[183 258 568  79 135],450,4,2448,3.967585089141005,0.0,0.0
10617,1,617,[238 135  11  97 273],450,3,2451,3.966019417475728,0.0,0.0
10618,1,618,[322 179 286 143 228],450,5,2456,3.9676898222940227,0.0,20.0
10619,1,619,[211 185 179 100  69],65,2,2458,3.964516129032258,0.0,20.0
10620,1,620,[427  98  79 127 588],18,5,2463,3.966183574879227,20.0,20.0
10621,1,621,[185 403 216 211  98],504,4,2467,3.9662379421221865,0.0,0.0
10622,1,622,[ 25 185 186 172 483],693,2,2469,3.9630818619582664,0.0,0.0
10623,1,623,[181  69 153 132   8],280,4,2473,3.9631410256410255,0.0,0.0
10624,1,624,[197 216 132  50   4],151,5,2478,3.9648,0.0,20.0
10625,1,625,[  7 286 202 423 318],655,1,2479,3.9600638977635785,20.0,20.0
10626,1,626,[197 405 132 210 385],796,3,2482,3.958532695374801,0.0,0.0
10627,1,627,[405 132 195 515 197],269,3,2485,3.9570063694267517,0.0,0.0
10628,1,628,[427  98  79 127 588],389,5,2490,3.958664546899841,20.0,20.0
10629,1,629,[427  98  79 127 588],450,5,2495,3.9603174603174605,20.0,20.0
10630,1,630,[427  98  79 127 588],389,5,2500,3.9619651347068148,20.0,20.0
10631,1,631,[196 174 202   7 161],269,0,2500,3.9556962025316458,0.0,0.0
10632,1,632,[125 234  82 678 202],504,3,2503,3.9541864139020535,0.0,0.0
10633,1,633,[427  98  79 127 588],18,5,2508,3.9558359621451102,20.0,20.0
10634,1,634,[427  98  79 588 127],450,5,2513,3.95748031496063,20.0,20.0
10635,1,635,[ 64 496  25 222 175],151,5,2518,3.959119496855346,40.0,0.0
10636,1,636,[183  98 168 546 174],504,4,2522,3.9591836734693877,0.0,0.0
10637,1,637,[ 89  79 125 118  15],457,5,2527,3.9608150470219434,0.0,0.0
10638,1,638,[423  98  88 427 275],330,5,2532,3.9624413145539905,20.0,20.0
10639,1,639,[427  98  79 588 127],389,5,2537,3.9640625,20.0,20.0
10640,1,640,[258  98 234 127 322],450,4,2541,3.9641185647425896,0.0,20.0
10641,1,641,[ 79  50 204  98 185],151,5,2546,3.965732087227414,0.0,20.0
10642,1,642,[427  98  79 588 127],796,5,2551,3.967340590979782,20.0,20.0
10643,1,643,[ 22  79 234 313 483],807,4,2555,3.967391304347826,0.0,0.0
10644,1,644,[144 121 161 111 435],716,3,2558,3.965891472868217,0.0,0.0
10645,1,645,[202   8  15 117 294],577,4,2562,3.9659442724458205,0.0,0.0
10646,1,646,[118 435   4 238 191],151,3,2565,3.964451313755796,0.0,0.0
10647,1,647,[427  98  79 588 127],18,5,2570,3.9660493827160495,20.0,20.0
10648,1,648,[ 98 282 135  89 111],457,4,2574,3.9661016949152543,0.0,0.0
10649,1,649,[427  98  79 588 127],450,5,2579,3.9676923076923076,20.0,20.0
10650,1,650,[427  98  79 588 127],18,5,2584,3.9692780337941627,20.0,20.0
10651,1,651,[427  98  79 588 127],18,5,2589,3.9708588957055215,20.0,20.0
10652,1,652,[182 655 135 180 313],280,2,2591,3.9678407350689127,0.0,0.0
10653,1,653,[427  98  79 588 127],796,5,2596,3.9694189602446484,20.0,20.0
10654,1,654,[175 288 210 117 258],344,3,2599,3.96793893129771,0.0,0.0
10655,1,655,[275 191 185 194 322],796,4,2603,3.9679878048780486,0.0,20.0
10656,1,656,[427  98  79 588 127],796,5,2608,3.9695585996955858,20.0,20.0
10657,1,657,[ 82 405 186  11 301],655,0,2608,3.9635258358662613,0.0,0.0
10658,1,658,[385 276  12 127 234],280,4,2612,3.9635811836115327,0.0,20.0
10659,1,659,[153 318   7 168  89],269,2,2614,3.9606060606060605,20.0,0.0
10660,1,660,[ 11   7 202 496  25],577,3,2617,3.9591527987897126,20.0,0.0
10661,1,661,[ 79 117 168  82 234],457,5,2622,3.960725075528701,0.0,0.0
10662,1,662,[427  98  79 588 127],716,5,2627,3.962292609351433,20.0,20.0
10663,1,663,[427  98  79 588 127],389,5,2632,3.963855421686747,20.0,20.0
10664,1,664,[427  98  79 588 127],796,5,2637,3.9654135338345866,20.0,20.0
10665,1,665,[210 748 258 222 151],807,4,2641,3.9654654654654653,0.0,0.0
10666,1,666,[215 237   9 118 276],457,5,2646,3.967016491754123,0.0,0.0
10667,1,667,[196 742  50 276 100],593,4,2650,3.967065868263473,0.0,40.0
10668,1,668,[427  98  79 588 127],18,5,2655,3.968609865470852,20.0,20.0
10669,1,669,[427  98  79 588 127],450,5,2660,3.970149253731343,20.0,20.0
10670,1,670,[427  98  79 588 127],796,5,2665,3.9716840536512668,20.0,20.0
10671,1,671,[ 88 194 286 132  70],151,5,2670,3.9732142857142856,0.0,20.0
10672,1,672,[427  98  79 588 127],450,5,2675,3.974739970282318,20.0,20.0
10673,1,673,[427  98  79 588 127],18,5,2680,3.9762611275964392,20.0,20.0
10674,1,674,[568 508 288 127 483],280,3,2683,3.974814814814815,0.0,20.0
10675,1,675,[427  98  79 588 127],450,5,2688,3.9763313609467454,20.0,20.0
10676,1,676,[427  98  79 588 127],796,5,2693,3.9778434268833087,20.0,20.0
10677,1,677,[427  98  79 588 127],796,5,2698,3.9793510324483776,20.0,20.0
10678,1,678,[245 181 313  88  79],796,4,2702,3.979381443298969,0.0,0.0
10679,1,679,[427  98  79 588 127],450,5,2707,3.9808823529411765,20.0,20.0
10680,1,680,[182 588 288  25 294],457,4,2711,3.9809104258443466,0.0,0.0
10681,1,681,[258   1 471 202 111],450,5,2716,3.9824046920821115,0.0,0.0
10682,1,682,[427  98  79 588 127],450,5,2721,3.9838945827232797,20.0,20.0
10683,1,683,[ 50 269  64 318 187],655,4,2725,3.9839181286549707,40.0,20.0
10684,1,684,[427  98  79 588 127],716,5,2730,3.9854014598540144,20.0,20.0
10685,1,685,[191 151   9 268  96],269,4,2734,3.9854227405247813,0.0,0.0
10686,1,686,[118 322 204 161 228],280,2,2736,3.982532751091703,0.0,0.0
10687,1,687,[210 117   7 215 161],577,3,2739,3.9811046511627906,0.0,0.0
10688,1,688,[282 187 191  95 496],450,4,2743,3.981132075471698,20.0,0.0
10689,1,689,[ 82 180  89  56 237],18,2,2745,3.9782608695652173,0.0,0.0
10690,1,690,[475 197 268 118 202],655,0,2745,3.9725036179450073,0.0,0.0
10691,1,691,[546  50 423 196 508],693,0,2745,3.9667630057803467,0.0,20.0
10692,1,692,[427  98  79 588 127],389,5,2750,3.9682539682539684,20.0,20.0
10693,1,693,[ 97 151 161 196 588],796,4,2754,3.968299711815562,0.0,0.0
10694,1,694,[427  98  79 588 127],389,5,2759,3.9697841726618703,20.0,20.0
10695,1,695,[182 258 313 168 132],450,5,2764,3.971264367816092,0.0,0.0
10696,1,696,[271 143 427 603 286],796,4,2768,3.971305595408895,40.0,20.0
10697,1,697,[435 185  50  97 423],716,5,2773,3.9727793696275073,0.0,20.0
10698,1,698,[427  98  79 588 127],389,5,2778,3.9742489270386265,20.0,20.0
10699,1,699,[187 143  70 435 191],269,2,2780,3.9714285714285715,0.0,0.0
10700,1,700,[435 245 300  89 181],450,5,2785,3.9728958630527815,0.0,0.0
10701,1,701,[289 187 423   7 191],655,2,2787,3.97008547008547,0.0,0.0
10702,1,702,[427  98  79 588 127],18,5,2792,3.9715504978662874,20.0,20.0
10703,1,703,[328  98 423 181 302],655,2,2794,3.96875,0.0,0.0
10704,1,704,[427  98  79 588 127],18,5,2799,3.970212765957447,20.0,20.0
10705,1,705,[168   4 204 187 323],796,4,2803,3.9702549575070822,0.0,0.0
10706,1,706,[427  98  79 588 127],389,5,2808,3.9717114568599716,20.0,20.0
10707,1,707,[ 71 181  28  97 161],798,2,2810,3.968926553672316,0.0,0.0
10708,1,708,[172  11 121  79   1],256,4,2814,3.9689703808180536,0.0,0.0
10709,1,709,[427  98  79 588 127],18,5,2819,3.9704225352112674,20.0,20.0
10710,1,710,[144  56 322 173 655],450,5,2824,3.9718706047819974,0.0,0.0
10711,1,711,[427  98  79 588 127],450,5,2829,3.973314606741573,20.0,20.0
10712,1,712,[273 222 197 238 385],796,2,2831,3.97054698457223,0.0,0.0
10713,1,713,[183 174 322  56  79],908,3,2834,3.969187675070028,0.0,0.0
10714,1,714,[  8 127 173 234 294],796,3,2837,3.9678321678321677,0.0,20.0
10715,1,715,[427  98  79 588 127],450,5,2842,3.96927374301676,20.0,20.0
10716,1,716,[427  98  79 588 127],389,5,2847,3.9707112970711296,20.0,20.0
10717,1,717,[ 82 385 258 187 655],450,4,2851,3.9707520891364902,0.0,0.0
10718,1,718,[427  98  79 588 127],796,5,2856,3.9721835883171073,20.0,20.0
10719,1,719,[427  98  79 588 127],18,5,2861,3.973611111111111,20.0,20.0
10720,1,720,[322 182 742 471 111],593,2,2863,3.970873786407767,0.0,0.0
10721,1,721,[269 300   4 333   8],655,0,2863,3.9653739612188366,0.0,0.0
10722,1,722,[153 222 186 597 182],796,4,2867,3.9654218533886585,0.0,0.0
10723,1,723,[427  98  79 588 127],716,5,2872,3.9668508287292816,20.0,20.0
10724,1,724,[427  98  79 588 127],450,5,2877,3.9682758620689653,20.0,20.0
10725,1,725,[179 245 144 121  69],593,4,2881,3.96831955922865,0.0,0.0
10726,1,726,[427  98  79 588 127],796,5,2886,3.969738651994498,20.0,20.0
10727,1,727,[357  69 153 496 211],151,4,2890,3.96978021978022,20.0,0.0
10728,1,728,[427  98  79 588 127],389,5,2895,3.97119341563786,20.0,20.0
10729,1,729,[427  98  79 588 127],18,5,2900,3.9726027397260273,20.0,20.0
10730,1,730,[174 271 228 423 111],655,0,2900,3.9671682626538987,0.0,0.0
10731,1,731,[186 194  79 174 313],577,5,2905,3.9685792349726774,0.0,0.0
10732,1,732,[182  70 153   4 179],264,5,2910,3.969986357435198,0.0,0.0
10733,1,733,[153  70 132 100 286],330,5,2915,3.9713896457765667,0.0,40.0
10734,1,734,[ 96 173   8 117   4],796,5,2920,3.9727891156462585,0.0,0.0
10735,1,735,[427  98  79 588 127],450,5,2925,3.974184782608696,20.0,20.0
10736,1,736,[  9 183 423 275 496],593,3,2928,3.972862957937585,20.0,20.0
10737,1,737,[427  98  79 588 127],18,5,2933,3.9742547425474255,20.0,20.0
10738,1,738,[276 168 191 196 202],401,4,2937,3.9742895805142084,0.0,0.0
10739,1,739,[ 25  56 423   9 228],72,4,2941,3.9743243243243245,0.0,0.0
10740,1,740,[427  98  79 588 127],18,5,2946,3.9757085020242915,20.0,20.0
10741,1,741,[271 265 515 282  70],655,1,2947,3.9716981132075473,0.0,0.0
10742,1,742,[748 176 603 508   8],11,3,2950,3.970390309555855,20.0,0.0
10743,1,743,[427  98  79 588 127],796,5,2955,3.971774193548387,20.0,20.0
10744,1,744,[427  98  79 588 127],716,5,2960,3.9731543624161074,20.0,20.0
10745,1,745,[  7 211 197 328  82],655,0,2960,3.967828418230563,0.0,0.0
10746,1,746,[ 15 568 588 603 144],450,4,2964,3.967871485943775,20.0,0.0
10747,1,747,[427  98  79 588 127],18,5,2969,3.9692513368983957,20.0,20.0
10748,1,748,[427  98  79 588 127],716,5,2974,3.970627503337784,20.0,20.0
10749,1,749,[678  69 173 125 215],344,1,2975,3.966666666666667,0.0,0.0
10750,1,750,[427  98 588  79 127],716,5,2980,3.9680426098535286,20.0,20.0
10751,1,751,[435  97 318 182  71],535,4,2984,3.9680851063829787,20.0,0.0
10752,1,752,[ 22 179 196 228 111],450,5,2989,3.9694555112881806,0.0,0.0
10753,1,753,[427  98 588  79 127],450,5,2994,3.970822281167109,20.0,20.0
10754,1,754,[742 200  98 238   7],457,5,2999,3.972185430463576,0.0,0.0
10755,1,755,[ 95 195 405  50 100],280,1,3000,3.9682539682539684,0.0,40.0
10756,1,756,[ 89 202 172 176 546],344,4,3004,3.9682959048877144,0.0,0.0
10757,1,757,[427  98 588  79 127],716,5,3009,3.969656992084433,20.0,20.0
10758,1,758,[427  98 588  79 127],716,5,3014,3.971014492753623,20.0,20.0
10759,1,759,[427  98 588  79 127],450,5,3019,3.9723684210526318,20.0,20.0
10760,1,760,[179 168 117 294 742],450,5,3024,3.973718791064389,0.0,0.0
10761,1,761,[294 153 210 282 269],796,2,3026,3.9711286089238844,0.0,0.0
10762,1,762,[427  98 588  79 127],796,5,3031,3.9724770642201834,20.0,20.0
10763,1,763,[427  98 588  79 127],796,5,3036,3.973821989528796,20.0,20.0
10764,1,764,[427  98 588  79 127],716,5,3041,3.9751633986928105,20.0,20.0
10765,1,765,[427  98 588  79 127],716,5,3046,3.976501305483029,20.0,20.0
10766,1,766,[427  98 588  79 127],450,5,3051,3.9778357235984356,20.0,20.0
10767,1,767,[234 185   1   4 197],389,5,3056,3.9791666666666665,0.0,0.0
10768,1,768,[197  98 118 483 216],655,3,3059,3.977893368010403,0.0,0.0
10769,1,769,[427  98 588  79 127],389,5,3064,3.979220779220779,20.0,20.0
10770,1,770,[427  98 588  79 127],18,5,3069,3.980544747081712,20.0,20.0
10771,1,771,[508 125 111 268 216],655,1,3070,3.976683937823834,0.0,0.0
10772,1,772,[ 56 153   8 357  71],593,4,3074,3.976714100905563,0.0,0.0
10773,1,773,[427  98 588  79 127],450,5,3079,3.9780361757105944,20.0,20.0
10774,1,774,[ 97  89 210 216 423],450,4,3083,3.9780645161290322,0.0,0.0
10775,1,775,[132 655   1 194 322],796,2,3085,3.975515463917526,0.0,0.0
10776,1,776,[427  98 588  79 127],18,5,3090,3.976833976833977,20.0,20.0
10777,1,777,[ 79 111 405 238  25],716,5,3095,3.9781491002570695,0.0,0.0
10778,1,778,[427  98 588  79 127],716,5,3100,3.9794608472400514,20.0,20.0
10779,1,779,[  4 174 655   9 568],593,3,3103,3.9782051282051283,0.0,0.0
10780,1,780,[183 195 121 385 313],450,4,3107,3.978233034571063,0.0,0.0
10781,1,781,[427  98 588  79 127],796,5,3112,3.979539641943734,20.0,20.0
10782,1,782,[245 286 258  69  64],629,4,3116,3.979565772669221,20.0,20.0
10783,1,783,[427  98 588  79 127],716,5,3121,3.9808673469387754,20.0,20.0
10784,1,784,[427  98 588  79 127],389,5,3126,3.9821656050955414,20.0,20.0
10785,1,785,[427  98 588  79 127],796,5,3131,3.9834605597964376,20.0,20.0
10786,1,786,[427  98 588  79 127],450,5,3136,3.9847522236340533,20.0,20.0
10787,1,787,[176 423  64 300   7],450,5,3141,3.986040609137056,20.0,0.0
10788,1,788,[176 125 173 197  82],280,0,3141,3.9809885931558937,0.0,0.0
10789,1,789,[ 56  97 202  69 294],65,3,3144,3.979746835443038,0.0,0.0
10790,1,790,[200 111  96  89  56],655,2,3146,3.97724399494311,0.0,0.0
10791,1,791,[427  98 588  79 127],796,5,3151,3.9785353535353534,20.0,20.0
10792,1,792,[202 121 168 143  25],577,4,3155,3.978562421185372,0.0,0.0
10793,1,793,[427  98 588  79 127],18,5,3160,3.9798488664987404,20.0,20.0
10794,1,794,[ 95 195   8 172  82],18,2,3162,3.9773584905660377,0.0,0.0
10795,1,795,[194 269 144 161 294],796,3,3165,3.9761306532663316,0.0,0.0
10796,1,796,[483   9 200 288  98],457,5,3170,3.9774153074027603,0.0,0.0
10797,1,797,[211 143  64 202  22],655,2,3172,3.974937343358396,20.0,0.0
10798,1,798,[235 318 405  50 588],401,1,3173,3.9712140175219024,20.0,20.0
10799,1,799,[125  96 185  28  15],655,1,3174,3.9675,0.0,0.0
10800,1,800,[ 11 202 276 181 265],655,1,3175,3.9637952559300875,0.0,0.0
10801,1,801,[174   7 125 195   9],292,3,3178,3.9625935162094765,0.0,0.0
10802,1,802,[172 179  69 313 200],236,2,3180,3.9601494396014942,0.0,0.0
10803,1,803,[204 183 181 322 496],151,3,3183,3.958955223880597,20.0,0.0
10804,1,804,[273 174 515 475 144],655,2,3185,3.9565217391304346,0.0,0.0
10805,1,805,[427  98  79 588 127],389,5,3190,3.957816377171216,20.0,20.0
10806,1,806,[471 176 210 318 496],786,5,3195,3.95910780669145,40.0,0.0
10807,1,807,[427  98  79 588 127],389,5,3200,3.9603960396039604,20.0,20.0
10808,1,808,[151 237 204  56 385],457,5,3205,3.96168108776267,0.0,0.0
10809,1,809,[ 28 603 496 275  22],18,3,3208,3.960493827160494,40.0,20.0
10810,1,810,[427  98  79 588 127],450,5,3213,3.961775585696671,20.0,20.0
10811,1,811,[427  98  79 588 127],716,5,3218,3.9630541871921183,20.0,20.0
10812,1,812,[323 186 742  82  22],20,4,3222,3.96309963099631,0.0,0.0
10813,1,813,[258 143  69 187 117],504,4,3226,3.963144963144963,0.0,0.0
10814,1,814,[302 427  69  56  79],151,4,3230,3.96319018404908,20.0,0.0
10815,1,815,[ 88 385 323 742  71],504,4,3234,3.963235294117647,0.0,0.0
10816,1,816,[427  98  79 588 127],716,5,3239,3.964504283965728,20.0,20.0
10817,1,817,[  7  82 483  88 228],280,2,3241,3.9621026894865525,0.0,0.0
10818,1,818,[ 64 271 100  88 258],796,4,3245,3.9621489621489623,20.0,20.0
10819,1,819,[286  79 143 127 234],450,4,3249,3.9621951219512197,0.0,40.0
10820,1,820,[427  98  79 588 127],716,5,3254,3.9634591961023142,20.0,20.0
10821,1,821,[179  12 222 403 603],450,4,3258,3.9635036496350367,20.0,0.0
10822,1,822,[ 88 132 294 118 210],655,0,3258,3.9586877278250303,0.0,0.0
10823,1,823,[742 143 186 275  28],796,2,3260,3.9563106796116503,0.0,20.0
10824,1,824,[427  98  79 588 127],18,5,3265,3.9575757575757575,20.0,20.0
10825,1,825,[427  98  79 588 127],450,5,3270,3.9588377723970942,20.0,20.0
10826,1,826,[127 180 286  79 144],796,3,3273,3.957678355501814,0.0,40.0
10827,1,827,[161 265  70 275 202],786,5,3278,3.9589371980676327,0.0,20.0
10828,1,828,[427  98  79 588 127],716,5,3283,3.960193003618818,20.0,20.0
10829,1,829,[427  98  79 588 127],796,5,3288,3.9614457831325303,20.0,20.0
10830,1,830,[496 200 135 191 210],716,4,3292,3.9614921780986765,20.0,0.0
10831,1,831,[475 288 185 125   4],655,1,3293,3.9579326923076925,0.0,0.0
10832,1,832,[202  64 286 597 235],450,4,3297,3.957983193277311,20.0,20.0
10833,1,833,[427  98  79 588 127],450,5,3302,3.9592326139088727,20.0,20.0
10834,1,834,[427  98  79 588 127],18,5,3307,3.9604790419161677,20.0,20.0
10835,1,835,[427  98  79 588 127],18,5,3312,3.9617224880382773,20.0,20.0
10836,1,836,[117 135 385  79 405],655,2,3314,3.959378733572282,0.0,0.0
10837,1,837,[  7   9 180 568 275],457,5,3319,3.960620525059666,0.0,20.0
10838,1,838,[117 100 111  70 318],593,5,3324,3.961859356376639,20.0,20.0
10839,1,839,[655 328 100 183   9],236,2,3326,3.9595238095238097,0.0,20.0
10840,1,840,[132   1 742 202 173],280,3,3329,3.9583828775267538,0.0,0.0
10841,1,841,[427 265  70 196 357],450,5,3334,3.959619952494062,20.0,0.0
10842,1,842,[508  97   4 288  79],655,1,3335,3.956109134045077,0.0,0.0
10843,1,843,[ 64 328   9 748  70],151,3,3338,3.9549763033175354,20.0,0.0
10844,1,844,[  1 200 286 269 121],655,1,3339,3.951479289940828,0.0,20.0
10845,1,845,[427  98  79 588 127],450,5,3344,3.9527186761229314,20.0,20.0
10846,1,846,[144  28  96 313  69],693,3,3347,3.9515938606847696,0.0,0.0
10847,1,847,[427  98  79 588 127],716,5,3352,3.952830188679245,20.0,20.0
10848,1,848,[275  28 100 228 318],796,3,3355,3.9517078916372204,20.0,40.0
10849,1,849,[235 143  28 195 275],450,4,3359,3.951764705882353,0.0,20.0
10850,1,850,[121 273 238 210 237],450,2,3361,3.9494712103407754,0.0,0.0
10851,1,851,[ 82 423 132 742 300],796,3,3364,3.948356807511737,0.0,0.0
10852,1,852,[153  56 195 161   9],504,3,3367,3.947245017584994,0.0,0.0
10853,1,853,[174 186 216 127 357],321,3,3370,3.946135831381733,0.0,20.0
10854,1,854,[328 187 597 132 168],450,5,3375,3.9473684210526314,0.0,0.0
10855,1,855,[127 144  98 282 385],655,2,3377,3.9450934579439254,0.0,20.0
10856,1,856,[245 172  71 357  88],796,4,3381,3.9451575262543757,0.0,0.0
10857,1,857,[427  98  79 588 127],716,5,3386,3.9463869463869465,20.0,20.0
10858,1,858,[ 88 216 175 471  82],655,1,3387,3.9429569266589057,0.0,0.0
10859,1,859,[191 135 237 161 183],450,4,3391,3.9430232558139533,0.0,0.0
10860,1,860,[427  98  79 588 127],716,5,3396,3.9442508710801394,20.0,20.0
10861,1,861,[  9 265 483   8 276],457,5,3401,3.945475638051044,0.0,0.0
10862,1,862,[427  98  79 588 127],716,5,3406,3.9466975666280417,20.0,20.0
10863,1,863,[168  98 176  71   4],577,5,3411,3.9479166666666665,0.0,0.0
10864,1,864,[427  98  79 588 127],18,5,3416,3.9491329479768784,20.0,20.0
10865,1,865,[  9  71 143 403 300],504,4,3420,3.9491916859122402,0.0,0.0
10866,1,866,[405 175 294 100 181],23,4,3424,3.949250288350634,0.0,20.0
10867,1,867,[427  98  79 588 127],796,5,3429,3.9504608294930876,20.0,20.0
10868,1,868,[125  28 144 318  64],450,5,3434,3.951668584579977,40.0,0.0
10869,1,869,[238 118 117 200 181],796,4,3438,3.9517241379310346,0.0,0.0
10870,1,870,[ 79 322 180  82 471],450,4,3442,3.951779563719862,0.0,0.0
10871,1,871,[427  98  79 588 127],796,5,3447,3.9529816513761467,20.0,20.0
10872,1,872,[427  98  79 588 127],716,5,3452,3.9541809851088203,20.0,20.0
10873,1,873,[427  98  79 588 127],389,5,3457,3.9553775743707096,20.0,20.0
10874,1,874,[118 200 168 161 235],716,2,3459,3.9531428571428573,0.0,0.0
10875,1,875,[127 496 282 179 603],450,5,3464,3.954337899543379,40.0,20.0
10876,1,876,[427  98  79 588 127],18,5,3469,3.9555302166476625,20.0,20.0
10877,1,877,[ 50 179 168 210 655],504,3,3472,3.9544419134396356,0.0,20.0
10878,1,878,[143  69 234 118  28],807,4,3476,3.9544937428896474,0.0,0.0
10879,1,879,[ 95 196 204 357 153],23,2,3478,3.952272727272727,0.0,0.0
10880,1,880,[427  98  79 588 127],389,5,3483,3.953461975028377,20.0,20.0
10881,1,881,[427  98  79 588 127],18,5,3488,3.9546485260770976,20.0,20.0
10882,1,882,[427  98  79 588 127],450,5,3493,3.955832389580974,20.0,20.0
10883,1,883,[143 168   9 423 268],269,4,3497,3.9558823529411766,0.0,0.0
10884,1,884,[427  98  79 588 127],716,5,3502,3.9570621468926555,20.0,20.0
10885,1,885,[313 423  89 144 161],655,2,3504,3.9548532731376973,0.0,0.0
10886,1,886,[118 405  71 195 172],280,1,3505,3.95152198421646,0.0,0.0
10887,1,887,[427  98  79 588 127],796,5,3510,3.9527027027027026,20.0,20.0
10888,1,888,[427  98  79 588 127],389,5,3515,3.953880764904387,20.0,20.0
10889,1,889,[ 64  22 385  95 318],716,4,3519,3.953932584269663,40.0,0.0
10890,1,890,[427  98  79 588 127],450,5,3524,3.9551066217732886,20.0,20.0
10891,1,891,[235 222 269 180 179],450,3,3527,3.954035874439462,0.0,0.0
10892,1,892,[427  98  79 588 127],796,5,3532,3.9552071668533033,20.0,20.0
10893,1,893,[168   4 211 301 234],796,2,3534,3.953020134228188,0.0,0.0
10894,1,894,[427  98  79 588 127],796,5,3539,3.9541899441340784,20.0,20.0
10895,1,895,[427  98  79 588 127],716,5,3544,3.955357142857143,20.0,20.0
10896,1,896,[427  98  79 588 127],18,5,3549,3.9565217391304346,20.0,20.0
10897,1,897,[427  98  79 588 127],389,5,3554,3.9576837416481068,20.0,20.0
10898,1,898,[427  98  79 588 127],18,5,3559,3.9588431590656286,20.0,20.0
10899,1,899,[204 144 483 546 173],716,3,3562,3.957777777777778,0.0,0.0
10900,1,900,[182 144 333 183 301],796,4,3566,3.957824639289678,0.0,0.0
10901,1,901,[597 302 210 508 175],269,2,3568,3.9556541019955653,0.0,0.0
10902,1,902,[385 300 118  15  70],151,3,3571,3.9545957918050942,0.0,0.0
10903,1,903,[427  98  79 588 127],450,5,3576,3.9557522123893807,20.0,20.0
10904,1,904,[265 427 196 655 210],236,1,3577,3.9524861878453037,20.0,0.0
10905,1,905,[427  98  79 588 127],389,5,3582,3.9536423841059603,20.0,20.0
10906,1,906,[427  98  79 588 127],450,5,3587,3.9547960308710035,20.0,20.0
10907,1,907,[427  98  79 588 127],716,5,3592,3.9559471365638768,20.0,20.0
10908,1,908,[222 333 568 603  64],796,5,3597,3.957095709570957,40.0,0.0
10909,1,909,[179 186  70 234 318],18,4,3601,3.9571428571428573,20.0,0.0
10910,1,910,[100 194 187 238 195],18,3,3604,3.95609220636663,0.0,20.0
10911,1,911,[427  98  79 588 127],716,5,3609,3.9572368421052633,20.0,20.0
10912,1,912,[  4 151 200 238  12],18,2,3611,3.955093099671413,0.0,0.0
10913,1,913,[187 174 176 183 117],786,5,3616,3.9562363238512037,0.0,0.0
10914,1,914,[173 588 174  28 196],577,5,3621,3.957377049180328,0.0,0.0
10915,1,915,[427  98  79 588 127],716,5,3626,3.958515283842795,20.0,20.0
10916,1,916,[427  98  79 588 127],716,5,3631,3.959651035986914,20.0,20.0
10917,1,917,[427  98  79 588 127],796,5,3636,3.9607843137254903,20.0,20.0
10918,1,918,[475 288  56 238 275],655,1,3637,3.957562568008705,0.0,20.0
10919,1,919,[135 175 216  22  97],11,3,3640,3.9565217391304346,0.0,0.0
10920,1,920,[153  25 196 271  88],655,0,3640,3.952225841476656,0.0,0.0
10921,1,921,[427  98  79 588 127],450,5,3645,3.953362255965293,20.0,20.0
10922,1,922,[423 301 318 191 238],655,2,3647,3.95124593716143,20.0,0.0
10923,1,923,[427  98  79 588 127],18,5,3652,3.9523809523809526,20.0,20.0
10924,1,924,[216 176 385 132 172],655,2,3654,3.9502702702702703,0.0,0.0
10925,1,925,[100 181 546 197 127],450,5,3659,3.951403887688985,0.0,40.0
10926,1,926,[427  98  79 588 127],450,5,3664,3.9525350593311757,20.0,20.0
10927,1,927,[427  98  79 588 127],389,5,3669,3.9536637931034484,20.0,20.0
10928,1,928,[423 588 195  71 151],756,2,3671,3.951560818083961,0.0,0.0
10929,1,929,[427  98  79 588 127],716,5,3676,3.9526881720430107,20.0,20.0
10930,1,930,[ 25 195 385 175 435],151,3,3679,3.9516648764769067,0.0,0.0
10931,1,931,[135  12 172  88 185],707,0,3679,3.9474248927038627,0.0,0.0
10932,1,932,[182 173 423  22 318],796,5,3684,3.9485530546623795,20.0,0.0
10933,1,933,[300 211 234 176 118],504,2,3686,3.9464668094218416,0.0,0.0
10934,1,934,[  4 183  50 568 191],655,3,3689,3.9454545454545453,0.0,20.0
10935,1,935,[181 742 748 258  25],277,3,3692,3.9444444444444446,0.0,0.0
10936,1,936,[427  98  79 588 127],796,5,3697,3.945570971184632,20.0,20.0
10937,1,937,[597 265 748 357 258],450,5,3702,3.946695095948827,0.0,0.0
10938,1,938,[427  98  79 588 127],716,5,3707,3.9478168264110756,20.0,20.0
10939,1,939,[427  98  79 588 127],716,5,3712,3.948936170212766,20.0,20.0
10940,1,940,[153 302 258 200 179],450,4,3716,3.948990435706695,0.0,0.0
10941,1,941,[  4 318 385 275 182],450,4,3720,3.949044585987261,20.0,20.0
10942,1,942,[427  98  79 588 127],389,5,3725,3.9501590668080593,20.0,20.0
10943,1,943,[427  98  79 588 127],18,5,3730,3.9512711864406778,20.0,20.0
10944,1,944,[427  98  79 588 127],716,5,3735,3.9523809523809526,20.0,20.0
10945,1,945,[427  98  79 588 127],450,5,3740,3.953488372093023,20.0,20.0
10946,1,946,[258 173 275 111 235],457,3,3743,3.9524815205913413,0.0,20.0
10947,1,947,[597  82 475 100  56],269,3,3746,3.951476793248945,0.0,20.0
10948,1,948,[427  98  79 588 127],796,5,3751,3.952581664910432,20.0,20.0
10949,1,949,[427  98  79 588 127],18,5,3756,3.953684210526316,20.0,20.0
10950,1,950,[546  98 269   1 174],503,5,3761,3.9547844374342795,0.0,0.0
10951,1,951,[427  98  79 588 127],389,5,3766,3.9558823529411766,20.0,20.0
10952,1,952,[427  98  79 588 127],796,5,3771,3.95697796432319,20.0,20.0
10953,1,953,[ 28 546 286 111 742],174,4,3775,3.957023060796646,0.0,20.0
10954,1,954,[ 12 210 515 196 603],72,5,3780,3.9581151832460733,20.0,0.0
10955,1,955,[179 202 181   1  64],655,2,3782,3.9560669456066946,20.0,0.0
10956,1,956,[427  98  79 588 127],716,5,3787,3.9571577847439916,20.0,20.0
10957,1,957,[ 28  56 508 176 127],655,1,3788,3.954070981210856,0.0,20.0
10958,1,958,[427  98  79 588 127],716,5,3793,3.9551616266944736,20.0,20.0
10959,1,959,[427  98  79 588 127],716,5,3798,3.95625,20.0,20.0
10960,1,960,[ 50 100   9 204 322],280,2,3800,3.9542143600416235,0.0,40.0
10961,1,961,[427  98  79 588 127],18,5,3805,3.955301455301455,20.0,20.0
10962,1,962,[427  98  79 588 127],450,5,3810,3.956386292834891,20.0,20.0
10963,1,963,[ 69 405  70 118 202],280,2,3812,3.954356846473029,0.0,0.0
10964,1,964,[427  98  79 588 127],796,5,3817,3.955440414507772,20.0,20.0
10965,1,965,[ 95  82 288 125 357],450,2,3819,3.953416149068323,0.0,0.0
10966,1,966,[427  98  79 588 127],796,5,3824,3.954498448810755,20.0,20.0
10967,1,967,[427  98  79 588 127],796,5,3829,3.955578512396694,20.0,20.0
10968,1,968,[427  98  79 588 127],450,5,3834,3.956656346749226,20.0,20.0
10969,1,969,[427  98  79 588 127],450,5,3839,3.9577319587628867,20.0,20.0
10970,1,970,[ 82  79 294  12 176],280,2,3841,3.955715756951596,0.0,0.0
10971,1,971,[427  98  79 588 127],389,5,3846,3.95679012345679,20.0,20.0
10972,1,972,[471 328 194 318 181],450,5,3851,3.9578622816032887,20.0,0.0
10973,1,973,[427  98  79 588 127],389,5,3856,3.9589322381930185,20.0,20.0
10974,1,974,[ 82 111 483 135 265],716,4,3860,3.958974358974359,0.0,0.0
10975,1,975,[183 125 182 135 258],450,4,3864,3.959016393442623,0.0,0.0
10976,1,976,[427  98  79 588 127],450,5,3869,3.960081883316274,20.0,20.0
10977,1,977,[427  98  79 588 127],18,5,3874,3.9611451942740286,20.0,20.0
10978,1,978,[496 275 427 181  95],18,4,3878,3.961184882533197,40.0,20.0
10979,1,979,[427  98  79 588 127],796,5,3883,3.9622448979591836,20.0,20.0
10980,1,980,[427  98  79 588 127],716,5,3888,3.963302752293578,20.0,20.0
10981,1,981,[186 185 265 183 597],450,4,3892,3.9633401221995928,0.0,0.0
10982,1,982,[211  25 181 100 405],5,3,3895,3.9623601220752795,0.0,20.0
10983,1,983,[427  98  79 588 127],18,5,3900,3.9634146341463414,20.0,20.0
10984,1,984,[153  64 161 603 265],450,5,3905,3.964467005076142,40.0,0.0
10985,1,985,[323 194   9  12  98],796,3,3908,3.9634888438133875,0.0,0.0
10986,1,986,[588 127 183 168  82],716,4,3912,3.9635258358662613,0.0,20.0
10987,1,987,[427  98  79 588 127],716,5,3917,3.964574898785425,20.0,20.0
10988,1,988,[ 97 318 100 132 153],330,5,3922,3.9656218402426693,20.0,20.0
10989,1,989,[427  98  79 588 127],796,5,3927,3.966666666666667,20.0,20.0
10990,1,990,[588 655  12 471 174],577,4,3931,3.966700302724521,0.0,0.0
10991,1,991,[403 172 127 286 748],450,5,3936,3.967741935483871,0.0,40.0
10992,1,992,[ 89  28 603 289 144],655,2,3938,3.9657603222557904,20.0,0.0
10993,1,993,[  1 258 748  70 385],151,3,3941,3.964788732394366,0.0,0.0
10994,1,994,[588 127  98 301 125],796,4,3945,3.9648241206030153,0.0,20.0
10995,1,995,[135 403 111  15   4],450,2,3947,3.96285140562249,0.0,0.0
10996,1,996,[322 176 588 111  82],450,4,3951,3.962888665997994,0.0,0.0
10997,1,997,[216 427 603   1  98],655,4,3955,3.9629258517034067,40.0,0.0
10998,1,998,[ 28 294 185  79 117],450,5,3960,3.963963963963964,0.0,0.0
10999,1,999,[  1 182 175  56 194],18,4,3964,3.964,0.0,0.0
11000,1,1000,[288 655 174 161 228],280,2,3966,3.962037962037962,0.0,0.0
11001,1,1001,[427  98  79 588 127],18,5,3971,3.963073852295409,20.0,20.0
11002,1,1002,[742 176 196 175 127],344,4,3975,3.9631106679960117,0.0,20.0
11003,1,1003,[173 179 588  82 195],450,4,3979,3.9631474103585655,0.0,0.0
11004,1,1004,[427  98  79 588 127],18,5,3984,3.964179104477612,20.0,20.0
11005,1,1005,[  8 175 385 515 125],655,1,3985,3.9612326043737576,0.0,0.0
11006,1,1006,[300 282 322 323 196],796,3,3988,3.9602780536246276,0.0,0.0
11007,1,1007,[385 200 179 273 153],655,3,3991,3.9593253968253967,0.0,0.0
11008,1,1008,[427  98  79 588 127],450,5,3996,3.960356788899901,20.0,20.0
11009,1,1009,[ 15 180 111 471 235],450,3,3999,3.9594059405940594,0.0,0.0
11010,1,1010,[111  15 195 204 588],786,4,4003,3.95944609297725,0.0,0.0
11011,1,1011,[ 64 403 228  97 423],450,5,4008,3.960474308300395,20.0,0.0
11012,1,1012,[100 185  56  50 273],450,4,4012,3.960513326752221,0.0,40.0
11013,1,1013,[471  95 118  28 143],450,3,4015,3.9595660749506902,0.0,0.0
11014,1,1014,[234 194 568  28 175],457,5,4020,3.960591133004926,0.0,0.0
11015,1,1015,[180 132 185 181  79],535,4,4024,3.9606299212598426,0.0,0.0
11016,1,1016,[282 180 174 385  71],504,5,4029,3.96165191740413,0.0,0.0
11017,1,1017,[ 79 234  69 135 385],655,2,4031,3.9597249508840866,0.0,0.0
11018,1,1018,[427  98 588  79 127],450,5,4036,3.9607458292443574,20.0,20.0
11019,1,1019,[427  98 588  79 127],450,5,4041,3.961764705882353,20.0,20.0
11020,1,1020,[ 89 357 202 132 182],269,3,4044,3.960822722820764,0.0,0.0
11021,1,1021,[427  98 588  79 127],796,5,4049,3.961839530332681,20.0,20.0
11022,1,1022,[185 180   8  98  71],796,4,4053,3.961876832844575,0.0,0.0
11023,1,1023,[427  98 588  79 127],18,5,4058,3.962890625,20.0,20.0
11024,1,1024,[182  56 179  79 403],655,3,4061,3.961951219512195,0.0,0.0
11025,1,1025,[427  98 588  79 127],796,5,4066,3.962962962962963,20.0,20.0
11026,1,1026,[191 132 546 200  88],796,5,4071,3.963972736124635,0.0,0.0
11027,1,1027,[427  98 588  79 127],796,5,4076,3.964980544747082,20.0,20.0
11028,1,1028,[427  98 588  79 127],796,5,4081,3.9659863945578233,20.0,20.0
11029,1,1029,[ 97 125 143 237 269],450,5,4086,3.9669902912621358,0.0,0.0
11030,1,1030,[427  98 588  79 127],18,5,4091,3.967992240543162,20.0,20.0
11031,1,1031,[ 11 235  96 191 288],344,3,4094,3.9670542635658914,0.0,0.0
11032,1,1032,[313   1 195 222 568],796,4,4098,3.967086156824782,0.0,0.0
11033,1,1033,[427  98 588  79 127],796,5,4103,3.9680851063829787,20.0,20.0
11034,1,1034,[435  12  28 471 268],655,0,4103,3.9642512077294687,0.0,0.0
11035,1,1035,[181 144  98 597 228],450,5,4108,3.965250965250965,0.0,0.0
11036,1,1036,[427  98 588  79 127],796,5,4113,3.966248794599807,20.0,20.0
11037,1,1037,[496 211 238 301 405],593,4,4117,3.966281310211946,20.0,0.0
11038,1,1038,[427  98 588  79 127],796,5,4122,3.967276227141482,20.0,20.0
11039,1,1039,[ 50 333 173 271 194],629,5,4127,3.9682692307692307,0.0,20.0
11040,1,1040,[427  98 588  79 127],389,5,4132,3.96926032660903,20.0,20.0
11041,1,1041,[427  98 588  79 127],389,5,4137,3.970249520153551,20.0,20.0
11042,1,1042,[132 603 237 185 196],796,5,4142,3.9712368168744008,20.0,0.0
11043,1,1043,[210   1  56 187 294],716,4,4146,3.971264367816092,0.0,0.0
11044,1,1044,[204  89 200 273 568],655,3,4149,3.970334928229665,0.0,0.0
11045,1,1045,[125 172 204 237 276],296,5,4154,3.9713193116634797,0.0,0.0
11046,1,1046,[427  98 588  79 127],716,5,4159,3.9723018147086915,20.0,20.0
11047,1,1047,[427  98 588  79 127],450,5,4164,3.9732824427480917,20.0,20.0
11048,1,1048,[ 89 427 204 100 318],269,3,4167,3.9723546234509057,40.0,20.0
11049,1,1049,[195 300  56 273 282],450,4,4171,3.9723809523809526,0.0,0.0
11050,1,1050,[238 197  95  28  22],716,5,4176,3.973358705994291,0.0,0.0
11051,1,1051,[ 69 197 357 603 153],269,3,4179,3.972433460076046,20.0,0.0
11052,1,1052,[333   1 144 228 181],796,4,4183,3.972459639126306,0.0,0.0
11053,1,1053,[181 328 294 202  70],401,3,4186,3.9715370018975333,0.0,0.0
11054,1,1054,[ 98 202 228 172 588],798,2,4188,3.9696682464454978,0.0,0.0
11055,1,1055,[427  98 588  79 127],389,5,4193,3.9706439393939394,20.0,20.0
11056,1,1056,[ 88  70 273 211   1],655,1,4194,3.967833491012299,0.0,0.0
11057,1,1057,[427  98 588  79 127],796,5,4199,3.9688090737240076,20.0,20.0
11058,1,1058,[ 82 275 151 238 118],389,4,4203,3.9688385269121813,0.0,20.0
11059,1,1059,[427  98 588  79 127],389,5,4208,3.969811320754717,20.0,20.0
11060,1,1060,[ 69 238 185 182 186],269,3,4211,3.9688972667295004,0.0,0.0
11061,1,1061,[176 127 237 191 275],786,5,4216,3.969868173258004,0.0,40.0
11062,1,1062,[195  12 100 496 222],344,5,4221,3.9708372530573848,20.0,20.0
11063,1,1063,[427  98 588  79 127],389,5,4226,3.9718045112781954,20.0,20.0
11064,1,1064,[ 64   1  25 222  89],256,5,4231,3.9727699530516434,20.0,0.0
11065,1,1065,[ 28  15 111  96 357],450,4,4235,3.972795497185741,0.0,0.0
11066,1,1066,[ 98 265 187 273 257],796,4,4239,3.97282099343955,0.0,0.0
11067,1,1067,[427  98 588  79 127],450,5,4244,3.9737827715355807,20.0,20.0
11068,1,1068,[427  98 588  79 127],389,5,4249,3.9747427502338635,20.0,20.0
11069,1,1069,[427  98 588  79 127],450,5,4254,3.9757009345794394,20.0,20.0
11070,1,1070,[427  98 588  79 127],796,5,4259,3.976657329598506,20.0,20.0
11071,1,1071,[161 273 173 182 215],450,4,4263,3.9766791044776117,0.0,0.0
11072,1,1072,[427  98 588  79 127],796,5,4268,3.977632805219012,20.0,20.0
11073,1,1073,[  9 181 275 194 286],18,3,4271,3.9767225325884543,0.0,40.0
11074,1,1074,[211 568 234  50 276],593,3,4274,3.9758139534883723,0.0,20.0
11075,1,1075,[427  98 588  79 127],716,5,4279,3.9767657992565058,20.0,20.0
11076,1,1076,[143 288  98 423 197],655,2,4281,3.9749303621169916,0.0,0.0
11077,1,1077,[ 50 210 282 186 121],504,3,4284,3.9740259740259742,0.0,20.0
11078,1,1078,[ 50 475 181 289 118],655,1,4285,3.9712696941612604,0.0,20.0
11079,1,1079,[496 210   7 301 179],450,4,4289,3.971296296296296,20.0,0.0
11080,1,1080,[288 179  25  82 196],655,1,4290,3.9685476410730804,0.0,0.0
11081,1,1081,[125 151 172 118 471],577,3,4293,3.967652495378928,0.0,0.0
11082,1,1082,[427  98 588  79 127],450,5,4298,3.9686057248384117,20.0,20.0
11083,1,1083,[427  98 588  79 127],796,5,4303,3.9695571955719555,20.0,20.0
11084,1,1084,[427  98 588  79 127],389,5,4308,3.970506912442396,20.0,20.0
11085,1,1085,[427  98 588  79 127],450,5,4313,3.9714548802946594,20.0,20.0
11086,1,1086,[427  98 588  79 127],796,5,4318,3.972401103955842,20.0,20.0
11087,1,1087,[153 423 405 127 197],655,1,4319,3.969669117647059,0.0,20.0
11088,1,1088,[427  98 588  79 127],796,5,4324,3.970615243342516,20.0,20.0
11089,1,1089,[427  98 588  79 127],389,5,4329,3.971559633027523,20.0,20.0
11090,1,1090,[172 238 568  15  79],457,5,4334,3.97250229147571,0.0,0.0
11091,1,1091,[195   9 427 144 483],796,4,4338,3.9725274725274726,20.0,0.0
11092,1,1092,[427  98 588  79 127],796,5,4343,3.9734675205855443,20.0,20.0
11093,1,1093,[427  98 588  79 127],450,5,4348,3.974405850091408,20.0,20.0
11094,1,1094,[427  98 588  79 127],450,5,4353,3.9753424657534246,20.0,20.0
11095,1,1095,[ 89  98 144 204 322],796,4,4357,3.9753649635036497,0.0,0.0
11096,1,1096,[427  98 588  79 127],18,5,4362,3.976298997265269,20.0,20.0
11097,1,1097,[200   7 183  25 313],655,3,4365,3.9754098360655736,0.0,0.0
11098,1,1098,[427  98 588  79 127],450,5,4370,3.9763421292083714,20.0,20.0
11099,1,1099,[275 234  82  22 186],655,1,4371,3.9736363636363636,0.0,20.0
11100,1,1100,[427  98 588  79 127],716,5,4376,3.974568574023615,20.0,20.0
11101,1,1101,[ 15 143 194 191 483],389,3,4379,3.973684210526316,0.0,0.0
11102,1,1102,[427  98 588  79 127],18,5,4384,3.9746146872166817,20.0,20.0
11103,1,1103,[ 97 194 211 423 175],151,5,4389,3.9755434782608696,0.0,0.0
11104,1,1104,[237 111 181  50  71],401,1,4390,3.9728506787330318,0.0,20.0
11105,1,1105,[427  98 588  79 127],796,5,4395,3.9737793851717904,20.0,20.0
11106,1,1106,[174 127  11 176 143],693,4,4399,3.973803071364047,0.0,20.0
11107,1,1107,[483 135 568 204  69],655,2,4401,3.9720216606498195,0.0,0.0
11108,1,1108,[318 151 191 211 202],401,4,4405,3.9720468890892695,20.0,0.0
11109,1,1109,[427  98 588  79 127],716,5,4410,3.972972972972973,20.0,20.0
11110,1,1110,[427 100 172 496 181],269,3,4413,3.972097209720972,40.0,20.0
11111,1,1111,[427  98 588  79 127],389,5,4418,3.973021582733813,20.0,20.0
11112,1,1112,[427  98 588  79 127],389,5,4423,3.973944294699012,20.0,20.0
11113,1,1113,[118 132  97  11  88],655,0,4423,3.9703770197486534,0.0,0.0
11114,1,1114,[427  98 588  79 127],450,5,4428,3.9713004484304935,20.0,20.0
11115,1,1115,[111 181 100 204 117],786,5,4433,3.9722222222222223,0.0,20.0
11116,1,1116,[318 125 748 603  25],11,3,4436,3.971351835273053,40.0,0.0
11117,1,1117,[427  98 588  79 127],389,5,4441,3.9722719141323792,20.0,20.0
11118,1,1118,[175  12 245  95 111],344,4,4445,3.972296693476318,0.0,0.0
11119,1,1119,[427  98 588  79 127],716,5,4450,3.9732142857142856,20.0,20.0
11120,1,1120,[427  98 588  79 127],18,5,4455,3.974130240856378,20.0,20.0
11121,1,1121,[427  98 588  79 127],18,5,4460,3.9750445632798574,20.0,20.0
11122,1,1122,[427  98 588  79 127],18,5,4465,3.9759572573463937,20.0,20.0
11123,1,1123,[100 237 742 273   8],796,2,4467,3.974199288256228,0.0,20.0
11124,1,1124,[185 322 265 153 588],450,5,4472,3.975111111111111,0.0,0.0
11125,1,1125,[294 181 168 182 385],450,5,4477,3.976021314387211,0.0,0.0
11126,1,1126,[183  96 179 357 300],450,5,4482,3.976929902395741,0.0,0.0
11127,1,1127,[196 275  50 132 204],18,3,4485,3.976063829787234,0.0,40.0
11128,1,1128,[427  98 588  79 127],18,5,4490,3.9769707705934456,20.0,20.0
11129,1,1129,[427  98 588  79 127],716,5,4495,3.97787610619469,20.0,20.0
11130,1,1130,[427  98 588  79 127],389,5,4500,3.9787798408488064,20.0,20.0
11131,1,1131,[215   8 144  98 179],655,2,4502,3.977031802120141,0.0,0.0
11132,1,1132,[427  98 588  79 127],18,5,4507,3.9779346866725507,20.0,20.0
11133,1,1133,[ 95  12 143 427 603],450,4,4511,3.9779541446208113,40.0,0.0
11134,1,1134,[  1 275 153 144 423],655,1,4512,3.975330396475771,0.0,20.0
11135,1,1135,[216 151 483 435 546],716,4,4516,3.9753521126760565,0.0,0.0
11136,1,1136,[427  98 588  79 127],716,5,4521,3.9762532981530345,20.0,20.0
11137,1,1137,[427 588  98  79 127],796,5,4526,3.977152899824253,20.0,20.0
11138,1,1138,[427 588  98  79 127],796,5,4531,3.9780509218612816,20.0,20.0
11139,1,1139,[117 546 153  28 211],450,5,4536,3.9789473684210526,0.0,0.0
11140,1,1140,[301 423   7 144 211],450,5,4541,3.9798422436459244,0.0,0.0
11141,1,1141,[427 588  98  79 127],389,5,4546,3.9807355516637477,20.0,20.0
11142,1,1142,[427 588  98  79 127],18,5,4551,3.9816272965879267,20.0,20.0
11143,1,1143,[427 588  98  79 127],716,5,4556,3.9825174825174825,20.0,20.0
11144,1,1144,[427 588  98  79 127],18,5,4561,3.983406113537118,20.0,20.0
11145,1,1145,[211  12 742 117  89],655,1,4562,3.980802792321117,0.0,0.0
11146,1,1146,[427 588  98  79 127],450,5,4567,3.981691368788143,20.0,20.0
11147,1,1147,[269  97  89 127 118],450,4,4571,3.981707317073171,0.0,20.0
11148,1,1148,[172 483 318 195   7],535,4,4575,3.9817232375979112,20.0,0.0
11149,1,1149,[ 50 216 211 144 238],593,5,4580,3.982608695652174,0.0,20.0
11150,1,1150,[427 588  98  79 127],18,5,4585,3.983492615117289,20.0,20.0
11151,1,1151,[427 588  98  79 127],796,5,4590,3.984375,20.0,20.0
11152,1,1152,[100 210 483  28 187],18,4,4594,3.98438855160451,0.0,20.0
11153,1,1153,[210  64 237 357 228],344,4,4598,3.9844020797227038,20.0,0.0
11154,1,1154,[427 588  98  79 127],18,5,4603,3.985281385281385,20.0,20.0
11155,1,1155,[197 204  56 186 202],450,4,4607,3.985294117647059,0.0,0.0
11156,1,1156,[ 88 175 318 237 132],716,4,4611,3.9853068280034574,20.0,0.0
11157,1,1157,[427 588  98  79 127],796,5,4616,3.9861830742659756,20.0,20.0
11158,1,1158,[151  69 471 143  50],174,4,4620,3.986194995685936,0.0,20.0
11159,1,1159,[427 588  98  79 127],716,5,4625,3.9870689655172415,20.0,20.0
11160,1,1160,[  9  82  97 496   8],878,2,4627,3.9853574504737295,20.0,0.0
11161,1,1161,[ 82 597 173 187 100],450,4,4631,3.985370051635112,0.0,20.0
11162,1,1162,[427 588  98  79 127],716,5,4636,3.9862424763542563,20.0,20.0
11163,1,1163,[427 588  98  79 127],716,5,4641,3.9871134020618557,20.0,20.0
11164,1,1164,[175  12 191 435   9],18,5,4646,3.9879828326180258,0.0,0.0
11165,1,1165,[ 15 238 475 117 187],655,1,4647,3.985420240137221,0.0,0.0
11166,1,1166,[427 588  98  79 127],796,5,4652,3.9862896315338476,20.0,20.0
11167,1,1167,[ 88 228 237 275 161],786,5,4657,3.9871575342465753,0.0,20.0
11168,1,1168,[427 588  98  79 127],450,5,4662,3.9880239520958085,20.0,20.0
11169,1,1169,[427 588  98  79 127],18,5,4667,3.988888888888889,20.0,20.0
11170,1,1170,[127 125 197 196 288],504,5,4672,3.989752348420154,0.0,20.0
11171,1,1171,[427 588  98  79 127],450,5,4677,3.99061433447099,20.0,20.0
11172,1,1172,[427 588  98  79 127],796,5,4682,3.991474850809889,20.0,20.0
11173,1,1173,[427 588  98  79 127],716,5,4687,3.992333901192504,20.0,20.0
11174,1,1174,[427 588  98  79 127],796,5,4692,3.993191489361702,20.0,20.0
11175,1,1175,[294 385 210 176 196],450,4,4696,3.993197278911565,0.0,0.0
11176,1,1176,[132 161 234 238 185],796,3,4699,3.9923534409515717,0.0,0.0
11177,1,1177,[427 588  98  79 127],716,5,4704,3.99320882852292,20.0,20.0
11178,1,1178,[238 258 173 211 176],450,5,4709,3.9940627650551312,0.0,0.0
11179,1,1179,[427 588  98  79 127],450,5,4714,3.9949152542372883,20.0,20.0
11180,1,1180,[427 588  98  79 127],716,5,4719,3.995766299745978,20.0,20.0
11181,1,1181,[427 588  98  79 127],796,5,4724,3.996615905245347,20.0,20.0
11182,1,1182,[427 588  98  79 127],450,5,4729,3.9974640743871515,20.0,20.0
11183,1,1183,[302  96 173 238 100],450,5,4734,3.998310810810811,0.0,20.0
11184,1,1184,[427 588  98  79 127],389,5,4739,3.99915611814346,20.0,20.0
11185,1,1185,[196 179 118 483   7],655,2,4741,3.9974704890387858,0.0,0.0
11186,1,1186,[132  79 427 181 515],18,4,4745,3.9974726200505475,20.0,0.0
11187,1,1187,[427 588  98  79 127],18,5,4750,3.9983164983164983,20.0,20.0
11188,1,1188,[313 200 174 191 423],236,3,4753,3.9974768713204374,0.0,0.0
11189,1,1189,[204  70  56  64 294],716,5,4758,3.9983193277310924,20.0,0.0
11190,1,1190,[  4 271 111 300 125],655,0,4758,3.994962216624685,0.0,0.0
11191,1,1191,[427 588  98  79 127],389,5,4763,3.995805369127517,20.0,20.0
11192,1,1192,[333  88 175 202  15],655,0,4763,3.9924559932942163,0.0,0.0
11193,1,1193,[588 183  12 121  79],344,4,4767,3.992462311557789,0.0,0.0
11194,1,1194,[174 216 172 179 210],18,4,4771,3.992468619246862,0.0,0.0
11195,1,1195,[427 588  98  79 127],18,5,4776,3.9933110367892977,20.0,20.0
11196,1,1196,[ 11 202 195 300 143],450,5,4781,3.9941520467836256,0.0,0.0
11197,1,1197,[ 82 173  89 385  28],450,4,4785,3.9941569282136893,0.0,0.0
11198,1,1198,[276 161   8 655 313],280,3,4788,3.993327773144287,0.0,0.0
11199,1,1199,[125 176 483 151 127],450,4,4792,3.993333333333333,0.0,20.0
11200,1,1200,[427 588  98  79 127],716,5,4797,3.9941715237302247,20.0,20.0
11201,1,1201,[181 215  88 508 748],280,0,4797,3.990848585690516,0.0,0.0
11202,1,1202,[427 588  98  79 127],18,5,4802,3.9916874480465503,20.0,20.0
11203,1,1203,[313 173 294  89  82],450,4,4806,3.9916943521594686,0.0,0.0
11204,1,1204,[273 179  82 603 546],450,3,4809,3.990871369294606,20.0,0.0
11205,1,1205,[161 197 237 151 117],330,5,4814,3.9917081260364844,0.0,0.0
11206,1,1206,[237  64 216 423 127],719,2,4816,3.9900579950289976,20.0,20.0
11207,1,1207,[427 588  98  79 127],18,5,4821,3.990894039735099,20.0,20.0
11208,1,1208,[286 216 125 100 385],655,1,4822,3.988420181968569,0.0,40.0
11209,1,1209,[ 97 216 197 168 144],716,4,4826,3.9884297520661156,0.0,0.0
11210,1,1210,[427 588  98  79 127],716,5,4831,3.9892650701899255,20.0,20.0
11211,1,1211,[ 64 234 423 194  98],72,5,4836,3.99009900990099,20.0,0.0
11212,1,1212,[318 742  88 568 161],577,3,4839,3.989282769991756,20.0,0.0
11213,1,1213,[ 70   4 196 427 286],450,4,4843,3.989291598023064,20.0,20.0
11214,1,1214,[427 588  98  79 127],450,5,4848,3.9901234567901236,20.0,20.0
11215,1,1215,[471 427 265 161 191],716,3,4851,3.989309210526316,20.0,0.0
11216,1,1216,[427 588  98  79 127],18,5,4856,3.990139687756779,20.0,20.0
11217,1,1217,[172  95  98 215 180],280,3,4859,3.9893267651888342,0.0,0.0
11218,1,1218,[194 185  97 153  70],707,2,4861,3.9876948318293683,0.0,0.0
11219,1,1219,[  8  96 403 228 200],655,1,4862,3.9852459016393444,0.0,0.0
11220,1,1220,[427 588  98  79 127],716,5,4867,3.986076986076986,20.0,20.0
11221,1,1221,[216 194 204  28 328],796,4,4871,3.986088379705401,0.0,0.0
11222,1,1222,[187 257 125 222  71],796,5,4876,3.9869174161896974,0.0,0.0
11223,1,1223,[427 588  98  79 127],450,5,4881,3.9877450980392157,20.0,20.0
11224,1,1224,[197 111 276 275 174],878,3,4884,3.986938775510204,0.0,20.0
11225,1,1225,[427 588  98  79 127],450,5,4889,3.9877650897226755,20.0,20.0
11226,1,1226,[427 588  98  79 127],18,5,4894,3.9885900570497146,20.0,20.0
11227,1,1227,[118  96 282  11 172],693,3,4897,3.987785016286645,0.0,0.0
11228,1,1228,[257 175 288  82 143],655,1,4898,3.985353946297803,0.0,0.0
11229,1,1229,[427 588  98  79 127],389,5,4903,3.986178861788618,20.0,20.0
11230,1,1230,[427 588  98  79 127],796,5,4908,3.9870024370430546,20.0,20.0
11231,1,1231,[333 568 483  97 271],655,1,4909,3.9845779220779223,0.0,0.0
11232,1,1232,[200 125  22 175   1],655,1,4910,3.9821573398215735,0.0,0.0
11233,1,1233,[427 588  98  79 127],18,5,4915,3.9829821717990277,20.0,20.0
11234,1,1234,[  1 151 318 181 186],807,5,4920,3.983805668016194,20.0,0.0
11235,1,1235,[427 588  98  79 127],389,5,4925,3.98462783171521,20.0,20.0
11236,1,1236,[427 588  98  79 127],389,5,4930,3.9854486661277284,20.0,20.0
11237,1,1237,[111 173  82 257 403],796,4,4934,3.98546042003231,0.0,0.0
11238,1,1238,[427 588  98  79 127],450,5,4939,3.9862792574656982,20.0,20.0
11239,1,1239,[117 318 357 172 222],450,4,4943,3.986290322580645,20.0,0.0
11240,1,1240,[427 588  98  79 127],796,5,4948,3.9871071716357775,20.0,20.0
11241,1,1241,[427 588  98  79 127],450,5,4953,3.9879227053140096,20.0,20.0
11242,1,1242,[496 216 211  22 132],450,5,4958,3.988736926790024,20.0,0.0
11243,1,1243,[385 117 191 172  88],450,5,4963,3.989549839228296,0.0,0.0
11244,1,1244,[603  98 238 313 143],450,5,4968,3.9903614457831327,20.0,0.0
11245,1,1245,[427 588  98  79 127],389,5,4973,3.991171749598716,20.0,20.0
11246,1,1246,[427 588  98  79 127],450,5,4978,3.991980753809142,20.0,20.0
11247,1,1247,[427 588  98  79 127],389,5,4983,3.9927884615384617,20.0,20.0
11248,1,1248,[427 588  98  79 127],18,5,4988,3.9935948759007207,20.0,20.0
11249,1,1249,[427 588  98  79 127],796,5,4993,3.9944,20.0,20.0
11250,1,1250,[182 294 301 385 135],450,4,4997,3.994404476418865,0.0,0.0
11251,1,1251,[238 385 204 405 318],796,4,5001,3.9944089456869007,20.0,0.0
11252,1,1252,[181 180 144 183 210],693,1,5002,3.992019154030327,0.0,0.0
11253,1,1253,[195  50 333 313 289],655,2,5004,3.9904306220095696,0.0,20.0
11254,1,1254,[427 588  98  79 127],796,5,5009,3.9912350597609563,20.0,20.0
11255,1,1255,[191 204  89  15 245],796,4,5013,3.9912420382165603,0.0,0.0
11256,1,1256,[125 210 258 286 269],655,0,5013,3.988066825775656,0.0,20.0
11257,1,1257,[275 153 301 276 423],655,2,5015,3.9864864864864864,0.0,20.0
11258,1,1258,[ 56  95 127  98 168],389,4,5019,3.9864972200158855,0.0,20.0
11259,1,1259,[ 82 210 204 423 186],796,2,5021,3.984920634920635,0.0,0.0
11260,1,1260,[496 181 215 195  11],280,2,5023,3.9833465503568597,20.0,0.0
11261,1,1261,[427 588  98  79 127],796,5,5028,3.9841521394611727,20.0,20.0
11262,1,1262,[427 588  98  79 127],716,5,5033,3.9849564528899446,20.0,20.0
11263,1,1263,[427 588  98  79 127],389,5,5038,3.9857594936708862,20.0,20.0
11264,1,1264,[210 423 328 313  97],942,3,5041,3.9849802371541503,0.0,0.0
11265,1,1265,[202 427 118 176  25],655,1,5042,3.9826224328593995,20.0,0.0
11266,1,1266,[ 56  50 204 127 153],796,5,5047,3.983425414364641,0.0,40.0
11267,1,1267,[132  71 265   8 194],796,5,5052,3.9842271293375395,0.0,0.0
11268,1,1268,[  9 288 655  82 173],280,2,5054,3.9826635145784084,0.0,0.0
11269,1,1269,[427 588  98  79 127],18,5,5059,3.983464566929134,20.0,20.0
11270,1,1270,[187 427 403  50 125],655,3,5062,3.982690794649882,20.0,20.0
11271,1,1271,[185 182 187 302 143],655,5,5067,3.983490566037736,0.0,0.0
11272,1,1272,[121 168 216  96 471],457,5,5072,3.9842890809112332,0.0,0.0
11273,1,1273,[427 588  98  79 127],716,5,5077,3.9850863422291996,20.0,20.0
11274,1,1274,[269 275 210 403 151],18,3,5080,3.984313725490196,0.0,20.0
11275,1,1275,[ 88  56 194 144 603],716,4,5084,3.9843260188087775,20.0,0.0
11276,1,1276,[210 100 286 173 357],639,1,5085,3.981989036805012,0.0,40.0
11277,1,1277,[427 588  98  79 127],716,5,5090,3.9827856025039123,20.0,20.0
11278,1,1278,[117 183 294 197  50],796,3,5093,3.982017200938233,0.0,20.0
11279,1,1279,[427 588  98  79 127],716,5,5098,3.9828125,20.0,20.0
11280,1,1280,[568 597 588 135   7],450,4,5102,3.9828259172521467,0.0,0.0
11281,1,1281,[151 603 100 423 427],908,4,5106,3.982839313572543,40.0,20.0
11282,1,1282,[191 273 181  15   4],796,4,5110,3.9828526890101323,0.0,0.0
11283,1,1283,[143 301 269 195 204],450,5,5115,3.9836448598130842,0.0,0.0
11284,1,1284,[301   1 222 238 427],796,2,5117,3.982101167315175,20.0,0.0
11285,1,1285,[427 588  98  79 127],716,5,5122,3.982892690513219,20.0,20.0
11286,1,1286,[215  12 204 546 197],174,4,5126,3.982905982905983,0.0,0.0
11287,1,1287,[427 588  98  79 127],796,5,5131,3.983695652173913,20.0,20.0
11288,1,1288,[300  69 288 195 187],629,5,5136,3.9844840961986034,0.0,0.0
11289,1,1289,[405 211 273 143 174],796,3,5139,3.983720930232558,0.0,0.0
11290,1,1290,[132 742  97  22 195],450,5,5144,3.984508133230054,0.0,0.0
11291,1,1291,[258 276 175 603  98],655,3,5147,3.98374613003096,20.0,0.0
11292,1,1292,[268 265 289  15 195],655,0,5147,3.9806651198762566,0.0,0.0
11293,1,1293,[748 144 196 483 187],796,5,5152,3.98145285935085,0.0,0.0
11294,1,1294,[427 588  98  79 127],18,5,5157,3.9822393822393822,20.0,20.0
11295,1,1295,[234 132 496 405  25],577,3,5160,3.9814814814814814,20.0,0.0
11296,1,1296,[  8  11 237   9 200],280,4,5164,3.981495759444873,0.0,0.0
11297,1,1297,[427 588  98  79 127],796,5,5169,3.9822804314329736,20.0,20.0
11298,1,1298,[294 181  71 143 173],401,1,5170,3.9799846035411854,0.0,0.0
11299,1,1299,[427 588  98  79 127],450,5,5175,3.980769230769231,20.0,20.0
11300,1,1300,[245 496 187  71 265],796,4,5179,3.980784012298232,20.0,0.0
11301,1,1301,[427 588  98  79 127],716,5,5184,3.9815668202764978,20.0,20.0
11302,1,1302,[385 151 427 181 546],151,3,5187,3.980813507290867,20.0,0.0
11303,1,1303,[174 748 257  89 144],807,5,5192,3.98159509202454,0.0,0.0
11304,1,1304,[144 185 269  56 228],796,4,5196,3.981609195402299,0.0,0.0
11305,1,1305,[427 588  98  79 127],18,5,5201,3.982388973966309,20.0,20.0
11306,1,1306,[427 588  98  79 127],389,5,5206,3.983167559296098,20.0,20.0
11307,1,1307,[ 28 127 238 588 197],450,5,5211,3.9839449541284404,0.0,20.0
11308,1,1308,[216 385 118 275 423],593,4,5215,3.983957219251337,0.0,20.0
11309,1,1309,[ 88 318  69 222  50],450,4,5219,3.983969465648855,20.0,20.0
11310,1,1310,[204 111 228 175 117],344,4,5223,3.9839816933638446,0.0,0.0
11311,1,1311,[117 275  25 161 168],716,4,5227,3.9839939024390243,0.0,20.0
11312,1,1312,[194 435   4 238  12],629,4,5231,3.984006092916984,0.0,0.0
11313,1,1313,[ 70 385 118 121 215],450,3,5234,3.983257229832572,0.0,0.0
11314,1,1314,[195 603 117 294  12],655,1,5235,3.9809885931558937,20.0,0.0
11315,1,1315,[427 588  98  79 127],450,5,5240,3.9817629179331306,20.0,20.0
11316,1,1316,[427 588  98  79 127],18,5,5245,3.982536066818527,20.0,20.0
11317,1,1317,[  1 132 215 100 151],457,5,5250,3.983308042488619,0.0,20.0
11318,1,1318,[237 210 197  70  12],450,4,5254,3.9833206974981046,0.0,0.0
11319,1,1319,[181  22 655 435  64],655,1,5255,3.981060606060606,20.0,0.0
11320,1,1320,[100 322  79   9 603],796,2,5257,3.979560938682816,20.0,20.0
11321,1,1321,[  7 210  82 161 204],786,5,5262,3.9803328290468984,0.0,0.0
11322,1,1322,[153  64 196  71 655],450,4,5266,3.980347694633409,20.0,0.0
11323,1,1323,[202 153  97 194 269],450,5,5271,3.981117824773414,0.0,0.0
11324,1,1324,[427 588  98  79 127],796,5,5276,3.9818867924528303,20.0,20.0
11325,1,1325,[427 588  98  79 127],716,5,5281,3.982654600301659,20.0,20.0
11326,1,1326,[282 204 588 186 238],457,5,5286,3.983421250941974,0.0,0.0
11327,1,1327,[ 82 210 161 135 204],450,2,5288,3.9819277108433737,0.0,0.0
11328,1,1328,[  4 282 235  96  97],256,3,5291,3.981188863807374,0.0,0.0
11329,1,1329,[174 286  97   7 202],786,5,5296,3.9819548872180452,0.0,20.0
11330,1,1330,[427 588  98  79 127],18,5,5301,3.982719759579264,20.0,20.0
11331,1,1331,[427 588  98  79 127],796,5,5306,3.9834834834834836,20.0,20.0
11332,1,1332,[222 204 286 245  50],796,3,5309,3.9827456864216053,0.0,40.0
11333,1,1333,[135 168   1 483 496],389,4,5313,3.9827586206896552,20.0,0.0
11334,1,1334,[427 588  98  79 127],450,5,5318,3.9835205992509364,20.0,20.0
11335,1,1335,[  4 568 323 174 118],796,4,5322,3.9835329341317367,0.0,0.0
11336,1,1336,[427 588  98  79 127],389,5,5327,3.9842931937172774,20.0,20.0
11337,1,1337,[ 98 195 237 234 187],655,2,5329,3.982810164424514,0.0,0.0
11338,1,1338,[357 191 127 268 568],269,4,5333,3.982823002240478,0.0,20.0
11339,1,1339,[202  28 125  56 405],450,5,5338,3.9835820895522387,0.0,0.0
11340,1,1340,[427 318 173  95 211],450,4,5342,3.983594332587621,40.0,0.0
11341,1,1341,[427 588  98  79 127],796,5,5347,3.9843517138599105,20.0,20.0
11342,1,1342,[357 603 257 237 234],716,5,5352,3.985107967237528,20.0,0.0
11343,1,1343,[ 98 100 195 655 257],655,1,5353,3.9828869047619047,0.0,20.0
11344,1,1344,[427 588  98  79 127],18,5,5358,3.98364312267658,20.0,20.0
11345,1,1345,[546 597  95 294 200],450,3,5361,3.9829123328380387,0.0,0.0
11346,1,1346,[ 12 153  22 568  95],450,4,5365,3.9829250185597624,0.0,0.0
11347,1,1347,[427 588  98  79 127],450,5,5370,3.983679525222552,20.0,20.0
11348,1,1348,[161 237 195 121 546],716,2,5372,3.9822090437361006,0.0,0.0
11349,1,1349,[427 588  98  79 127],18,5,5377,3.982962962962963,20.0,20.0
11350,1,1350,[427 588  98  79 127],18,5,5382,3.983715766099186,20.0,20.0
11351,1,1351,[427 588  98  79 127],716,5,5387,3.9844674556213016,20.0,20.0
11352,1,1352,[427 588  98  79 127],18,5,5392,3.985218033998522,20.0,20.0
11353,1,1353,[427 588  98  79 127],716,5,5397,3.985967503692762,20.0,20.0
11354,1,1354,[282 191 121 289 187],655,2,5399,3.98450184501845,0.0,0.0
11355,1,1355,[135 546 183  50 176],693,1,5400,3.982300884955752,0.0,20.0
11356,1,1356,[427 588  98  79 127],18,5,5405,3.983050847457627,20.0,20.0
11357,1,1357,[427 588  98  79 127],716,5,5410,3.98379970544919,20.0,20.0
11358,1,1358,[125 204  79 151 322],450,5,5415,3.9845474613686536,0.0,0.0
11359,1,1359,[427 588  98  79 127],18,5,5420,3.985294117647059,20.0,20.0
11360,1,1360,[328 211 151  50  56],151,4,5424,3.985304922850845,0.0,20.0
11361,1,1361,[ 64 435 180 300 483],535,4,5428,3.9853157121879588,20.0,0.0
11362,1,1362,[265  25 202  82 357],151,4,5432,3.9853264856933235,0.0,0.0
11363,1,1363,[427 588  98  79 127],450,5,5437,3.9860703812316713,20.0,20.0
11364,1,1364,[427 588  98  79 127],716,5,5442,3.986813186813187,20.0,20.0
11365,1,1365,[427  11   9 268 423],269,4,5446,3.986822840409956,20.0,0.0
11366,1,1366,[568  71 222 269   9],796,3,5449,3.9861009509875642,0.0,0.0
11367,1,1367,[ 96 257 238  98 182],457,4,5453,3.986111111111111,0.0,0.0
11368,1,1368,[111  96  64 197 265],292,5,5458,3.9868517165814463,20.0,0.0
11369,1,1369,[288 237 258 257 678],504,4,5462,3.986861313868613,0.0,0.0
11370,1,1370,[191 143 275 195 173],716,4,5466,3.9868708971553612,0.0,20.0
11371,1,1371,[  1 302 357   9 405],401,1,5467,3.9846938775510203,0.0,0.0
11372,1,1372,[176 216 265 357 173],457,5,5472,3.9854333576110705,0.0,0.0
11373,1,1373,[427 588  98  79 127],18,5,5477,3.9861717612809318,20.0,20.0
11374,1,1374,[ 50 294 483  56 271],655,2,5479,3.9847272727272727,0.0,20.0
11375,1,1375,[202 282 111 357 742],450,5,5484,3.98546511627907,0.0,0.0
11376,1,1376,[135 275  11 300 655],655,2,5486,3.9840232389251997,0.0,20.0
11377,1,1377,[427 588  98  79 127],389,5,5491,3.9847605224963716,20.0,20.0
11378,1,1378,[127 237 228 385 282],280,2,5493,3.9833212472806383,0.0,20.0
11379,1,1379,[385 405 196 132 143],23,3,5496,3.982608695652174,0.0,0.0
11380,1,1380,[357 427 153 181 186],296,4,5500,3.9826212889210715,20.0,0.0
11381,1,1381,[427 588  98  79 127],716,5,5505,3.983357452966715,20.0,20.0
11382,1,1382,[427 588  98  79 127],716,5,5510,3.9840925524222706,20.0,20.0
11383,1,1383,[427 588  98  79 127],389,5,5515,3.9848265895953756,20.0,20.0
11384,1,1384,[135 423 210 238 655],269,4,5519,3.9848375451263536,0.0,0.0
11385,1,1385,[204 245 183 176 273],796,3,5522,3.984126984126984,0.0,0.0
11386,1,1386,[427 588  98  79 127],796,5,5527,3.9848594087959626,20.0,20.0
11387,1,1387,[427 588  98  79 127],716,5,5532,3.9855907780979827,20.0,20.0
11388,1,1388,[194   7 197  56 496],269,4,5536,3.9856011519078476,20.0,0.0
11389,1,1389,[427 588  98  79 127],18,5,5541,3.9863309352517984,20.0,20.0
11390,1,1390,[603 273 153 322 427],450,4,5545,3.9863407620416966,40.0,0.0
11391,1,1391,[294 357 228 161 275],450,5,5550,3.9870689655172415,0.0,20.0
11392,1,1392,[568  12 234 125 195],256,5,5555,3.9877961234745154,0.0,0.0
11393,1,1393,[195 191 228 125 121],344,3,5558,3.987087517934003,0.0,0.0
11394,1,1394,[ 82 132  89   7   4],151,4,5562,3.9870967741935486,0.0,0.0
11395,1,1395,[427 588  98  79 127],716,5,5567,3.9878223495702008,20.0,20.0
11396,1,1396,[204 318 100 427 588],878,2,5569,3.9863994273443093,40.0,20.0
11397,1,1397,[427  98  79 588 127],18,5,5574,3.9871244635193133,20.0,20.0
11398,1,1398,[151 568 588 197 235],756,2,5576,3.9857040743388135,0.0,0.0
11399,1,1399,[427  98  79 588 127],716,5,5581,3.986428571428571,20.0,20.0
11400,1,1400,[427  98  79 588 127],716,5,5586,3.987152034261242,20.0,20.0
11401,1,1401,[ 95  88  22 216  28],450,4,5590,3.9871611982881596,0.0,0.0
11402,1,1402,[194 200  11 191 568],716,5,5595,3.9878831076265144,0.0,0.0
11403,1,1403,[405 603  25 179 195],450,4,5599,3.987891737891738,20.0,0.0
11404,1,1404,[ 50 161 135 117 318],693,3,5602,3.987188612099644,20.0,20.0
11405,1,1405,[427  98  79 588 127],716,5,5607,3.987908961593172,20.0,20.0
11406,1,1406,[742 183  96 597 180],796,3,5610,3.9872068230277184,0.0,0.0
11407,1,1407,[318 194 357 300  88],796,5,5615,3.9879261363636362,20.0,0.0
11408,1,1408,[427  98  79 588 127],389,5,5620,3.9886444286728175,20.0,20.0
11409,1,1409,[427  98  79 588 127],389,5,5625,3.9893617021276597,20.0,20.0
11410,1,1410,[427  98  79 588 127],716,5,5630,3.990077958894401,20.0,20.0
11411,1,1411,[179 742 181  28 258],504,3,5633,3.9893767705382435,0.0,0.0
11412,1,1412,[427  98  79 588 127],796,5,5638,3.990092002830856,20.0,20.0
11413,1,1413,[427  98  79 588 127],450,5,5643,3.990806223479491,20.0,20.0
11414,1,1414,[385 195 288  71 273],344,3,5646,3.990106007067138,0.0,0.0
11415,1,1415,[202 111 405 273 655],796,3,5649,3.989406779661017,0.0,0.0
11416,1,1416,[427  98  79 588 127],716,5,5654,3.990119971771348,20.0,20.0
11417,1,1417,[427  98  79 588 127],18,5,5659,3.9908321579689705,20.0,20.0
11418,1,1418,[173   8 196 181 568],457,5,5664,3.9915433403805496,0.0,0.0
11419,1,1419,[427  98  79 588 127],389,5,5669,3.9922535211267607,20.0,20.0
11420,1,1420,[173  98 597 216 186],796,4,5673,3.992258972554539,0.0,0.0
11421,1,1421,[427  98  79 588 127],18,5,5678,3.9929676511954995,20.0,20.0
11422,1,1422,[427  98  79 588 127],796,5,5683,3.993675333801827,20.0,20.0
11423,1,1423,[405 423 318 127  97],503,4,5687,3.993679775280899,20.0,20.0
11424,1,1424,[427  98  79 588 127],796,5,5692,3.9943859649122806,20.0,20.0
11425,1,1425,[234 127 121  69 125],504,4,5696,3.994389901823282,0.0,20.0
11426,1,1426,[427  98  79 588 127],18,5,5701,3.995094604064471,20.0,20.0
11427,1,1427,[427  98  79 588 127],389,5,5706,3.995798319327731,20.0,20.0
11428,1,1428,[257  97  69 125 385],401,1,5707,3.99370188943317,0.0,0.0
11429,1,1429,[328 655  82 191 194],796,3,5710,3.993006993006993,0.0,0.0
11430,1,1430,[210 185 289  96   7],693,3,5713,3.992313067784766,0.0,0.0
11431,1,1431,[427  98  79 588 127],796,5,5718,3.9930167597765363,20.0,20.0
11432,1,1432,[427  98  79 588 127],450,5,5723,3.993719469644103,20.0,20.0
11433,1,1433,[427  98  79 588 127],18,5,5728,3.99442119944212,20.0,20.0
11434,1,1434,[  1 294  56 427 300],450,5,5733,3.995121951219512,20.0,0.0
11435,1,1435,[427  98  79 588 127],716,5,5738,3.9958217270194987,20.0,20.0
11436,1,1436,[427  98  79 588 127],450,5,5743,3.99652052887961,20.0,20.0
11437,1,1437,[ 82  98 111 302 182],389,4,5747,3.9965229485396385,0.0,0.0
11438,1,1438,[427  98  79 588 127],796,5,5752,3.9972202918693536,20.0,20.0
11439,1,1439,[405 216   9 174 186],796,3,5755,3.9965277777777777,0.0,0.0
11440,1,1440,[ 28 144 234 196  82],23,0,5755,3.9937543372657878,0.0,0.0
11441,1,1441,[427  98  79 588 127],18,5,5760,3.9944521497919556,20.0,20.0
11442,1,1442,[125 204  82  79 423],577,5,5765,3.995148995148995,0.0,0.0
11443,1,1443,[427  98  79 588 127],796,5,5770,3.9958448753462603,20.0,20.0
11444,1,1444,[427  98  79 588 127],389,5,5775,3.9965397923875434,20.0,20.0
11445,1,1445,[427  98  79 588 127],18,5,5780,3.9972337482710927,20.0,20.0
11446,1,1446,[427  98  79 588 127],716,5,5785,3.9979267449896336,20.0,20.0
11447,1,1447,[172  71 357 161 210],786,5,5790,3.998618784530387,0.0,0.0
11448,1,1448,[143   8 301 271  96],655,1,5791,3.996549344375431,0.0,0.0
11449,1,1449,[427  98  79 588 127],450,5,5796,3.9972413793103447,20.0,20.0
11450,1,1450,[427  98  79 588 127],18,5,5801,3.9979324603721573,20.0,20.0
11451,1,1451,[427  98  79 588 127],796,5,5806,3.9986225895316805,20.0,20.0
11452,1,1452,[427  98  79 588 127],796,5,5811,3.9993117687543016,20.0,20.0
11453,1,1453,[127 435   1  71  79],18,5,5816,4.0,0.0,20.0
11454,1,1454,[427  98  79 588 127],450,5,5821,4.000687285223368,20.0,20.0
11455,1,1455,[427  98  79 588 127],716,5,5826,4.001373626373627,20.0,20.0
11456,1,1456,[322  25 135  70 194],450,3,5829,4.0006863417982155,0.0,0.0
11457,1,1457,[210 678 127  50 322],504,4,5833,4.000685871056241,0.0,40.0
11458,1,1458,[ 28  96 238 546 603],23,3,5836,4.0,20.0,0.0
11459,1,1459,[427  98  79 588 127],450,5,5841,4.000684931506849,20.0,20.0
11460,1,1460,[405  98 175 235 403],269,2,5843,3.9993155373032168,0.0,0.0
11461,1,1461,[427  98  79 588 127],389,5,5848,4.0,20.0,20.0
11462,1,1462,[427  98  79 588 127],389,5,5853,4.000683526999317,20.0,20.0
11463,1,1463,[427  98  79 588 127],389,5,5858,4.001366120218579,20.0,20.0
11464,1,1464,[ 50 186  15 196  89],151,5,5863,4.002047781569966,0.0,20.0
11465,1,1465,[427  98  79 588 127],450,5,5868,4.002728512960436,20.0,20.0
11466,1,1466,[427  98  79 588 127],796,5,5873,4.003408316291752,20.0,20.0
11467,1,1467,[288  95  97 357  28],450,3,5876,4.002724795640327,0.0,0.0
11468,1,1468,[186 153 204 179 423],504,1,5877,4.00068073519401,0.0,0.0
11469,1,1469,[427  98  79 588 127],796,5,5882,4.001360544217687,20.0,20.0
11470,1,1470,[427  98  79 588 127],18,5,5887,4.0020394289598915,20.0,20.0
11471,1,1471,[ 82 216   9   1  71],280,4,5891,4.002038043478261,0.0,0.0
11472,1,1472,[275 257 268 182 357],655,3,5894,4.001357773251867,0.0,20.0
11473,1,1473,[186  79   7 357 195],457,5,5899,4.002035278154681,0.0,0.0
11474,1,1474,[427  98  79 588 127],450,5,5904,4.00271186440678,20.0,20.0
11475,1,1475,[427  98  79 588 127],716,5,5909,4.003387533875339,20.0,20.0
11476,1,1476,[427  98  79 588 127],389,5,5914,4.004062288422478,20.0,20.0
11477,1,1477,[427  98  79 588 127],389,5,5919,4.004736129905277,20.0,20.0
11478,1,1478,[427  98  79 588 127],389,5,5924,4.005409060175794,20.0,20.0
11479,1,1479,[427  98  79 588 127],389,5,5929,4.006081081081081,20.0,20.0
11480,1,1480,[427  98  79 588 127],796,5,5934,4.006752194463201,20.0,20.0
11481,1,1481,[182 423 194 597 200],457,4,5938,4.006747638326586,0.0,0.0
11482,1,1482,[427  98  79 588 127],389,5,5943,4.007417397167903,20.0,20.0
11483,1,1483,[427  98  79 588 127],18,5,5948,4.008086253369272,20.0,20.0
11484,1,1484,[ 28 196  96 144  71],23,1,5949,4.006060606060606,0.0,0.0
11485,1,1485,[427  98  79 588 127],389,5,5954,4.006729475100942,20.0,20.0
11486,1,1486,[200 403 269 258  89],450,4,5958,4.006724949562878,0.0,0.0
11487,1,1487,[427  98  79 588 127],450,5,5963,4.00739247311828,20.0,20.0
11488,1,1488,[427  98  79 588 127],796,5,5968,4.008059100067159,20.0,20.0
11489,1,1489,[333 196 275 300 322],796,4,5972,4.008053691275168,0.0,20.0
11490,1,1490,[427  98  79 588 127],796,5,5977,4.008718980549967,20.0,20.0
11491,1,1491,[427  98  79 588 127],796,5,5982,4.009383378016086,20.0,20.0
11492,1,1492,[172 357 288 257 234],655,2,5984,4.0080375083724045,0.0,0.0
11493,1,1493,[427  98  79 588 127],450,5,5989,4.008701472556894,20.0,20.0
11494,1,1494,[427  98  79 588 127],18,5,5994,4.009364548494983,20.0,20.0
11495,1,1495,[  4  95 238  15  28],796,3,5997,4.008689839572193,0.0,0.0
11496,1,1496,[ 70   7 286  95 546],450,4,6001,4.008684034736139,0.0,20.0
11497,1,1497,[118 174 276  70 125],504,2,6003,4.007343124165554,0.0,0.0
11498,1,1498,[245  56 265 234 588],796,3,6006,4.006671114076051,0.0,0.0
11499,1,1499,[588 282 546  89  11],457,4,6010,4.006666666666667,0.0,0.0
11500,1,1500,[748 271   1  88 132],796,4,6014,4.006662225183211,0.0,0.0
11501,1,1501,[  1 265 678 435 597],807,3,6017,4.005992010652464,0.0,0.0
11502,1,1502,[427  98  79 588 127],716,5,6022,4.006653359946773,20.0,20.0
11503,1,1503,[173 258 118 257 235],807,2,6024,4.00531914893617,0.0,0.0
11504,1,1504,[427  98  79 588 127],389,5,6029,4.005980066445183,20.0,20.0
11505,1,1505,[427  98  79 588 127],716,5,6034,4.0066401062417,20.0,20.0
11506,1,1506,[237 228 269 185 300],796,4,6038,4.006635700066357,0.0,0.0
11507,1,1507,[427  98  79 588 127],716,5,6043,4.007294429708223,20.0,20.0
11508,1,1508,[275 742 204   1  56],450,5,6048,4.007952286282306,0.0,20.0
11509,1,1509,[172 204 300 275 265],796,5,6053,4.008609271523179,0.0,20.0
11510,1,1510,[427  98  79 588 127],18,5,6058,4.009265387160821,20.0,20.0
11511,1,1511,[427 191 175 153 276],18,5,6063,4.009920634920635,20.0,0.0
11512,1,1512,[176 427 100 132 195],236,2,6065,4.008592200925314,20.0,20.0
11513,1,1513,[427  98  79 588 127],796,5,6070,4.009247027741083,20.0,20.0
11514,1,1514,[211 257 294 161 175],655,0,6070,4.006600660066007,0.0,0.0
11515,1,1515,[197 144 423 195 301],629,4,6074,4.006596306068602,0.0,0.0
11516,1,1516,[427  98  79 588 127],18,5,6079,4.007251153592617,20.0,20.0
11517,1,1517,[302 483 204 423 322],450,4,6083,4.007246376811594,0.0,0.0
11518,1,1518,[427  98  79 588 127],716,5,6088,4.007899934167216,20.0,20.0
11519,1,1519,[427  98  79 588 127],389,5,6093,4.008552631578947,20.0,20.0
11520,1,1520,[ 89 125 180 282 121],457,5,6098,4.009204470742932,0.0,0.0
11521,1,1521,[427  98  79 588 127],796,5,6103,4.009855453350855,20.0,20.0
11522,1,1522,[427  98  79 588 127],450,5,6108,4.010505581089954,20.0,20.0
11523,1,1523,[427  98  79 588 127],716,5,6113,4.011154855643045,20.0,20.0
11524,1,1524,[ 88 174 603  95 176],716,4,6117,4.011147540983607,20.0,0.0
11525,1,1525,[427  98  79 588 127],716,5,6122,4.011795543905635,20.0,20.0
11526,1,1526,[357 215 742 161 288],504,5,6127,4.012442698100851,0.0,0.0
11527,1,1527,[427  98  79 588 127],18,5,6132,4.013089005235602,20.0,20.0
11528,1,1528,[196 175 100 111 186],655,0,6132,4.010464355788097,0.0,20.0
11529,1,1529,[748 132   4  97  70],450,4,6136,4.010457516339869,0.0,0.0
11530,1,1530,[427  98  79 588 127],716,5,6141,4.011103853690399,20.0,20.0
11531,1,1531,[427  98  79 588 127],389,5,6146,4.011749347258486,20.0,20.0
11532,1,1532,[286 483  22 153  69],539,4,6150,4.011741682974559,0.0,20.0
11533,1,1533,[238 282 323  98  50],504,3,6153,4.011082138200782,0.0,20.0
11534,1,1534,[181 238 202 302 111],269,1,6154,4.009120521172639,0.0,0.0
11535,1,1535,[179  56 471 186  70],535,4,6158,4.009114583333333,0.0,0.0
11536,1,1536,[172 195 200 258  95],450,3,6161,4.008458035133376,0.0,0.0
11537,1,1537,[427  98  79 588 127],716,5,6166,4.0091027308192455,20.0,20.0
11538,1,1538,[427  98  79 588 127],450,5,6171,4.009746588693957,20.0,20.0
11539,1,1539,[427  98  79 588 127],716,5,6176,4.01038961038961,20.0,20.0
11540,1,1540,[427  98  79 588 127],389,5,6181,4.011031797534069,20.0,20.0
11541,1,1541,[427  98  79 588 127],389,5,6186,4.011673151750973,20.0,20.0
11542,1,1542,[427  98  79 588 127],389,5,6191,4.012313674659754,20.0,20.0
11543,1,1543,[427  98  79 588 127],716,5,6196,4.012953367875648,20.0,20.0
11544,1,1544,[427  98  79 588 127],450,5,6201,4.0135922330097085,20.0,20.0
11545,1,1545,[427  98  79 588 127],716,5,6206,4.014230271668823,20.0,20.0
11546,1,1546,[ 12  98 546 496 144],450,5,6211,4.014867485455721,20.0,0.0
11547,1,1547,[427  98  79 588 127],18,5,6216,4.015503875968992,20.0,20.0
11548,1,1548,[427  98  79 588 127],389,5,6221,4.016139444803099,20.0,20.0
11549,1,1549,[427  98  79 588 127],389,5,6226,4.016774193548387,20.0,20.0
11550,1,1550,[ 88  71 100 282 245],450,4,6230,4.016763378465506,0.0,20.0
11551,1,1551,[405 196 176 197 100],450,5,6235,4.017396907216495,0.0,20.0
11552,1,1552,[427  98  79 588 127],450,5,6240,4.018029620090148,20.0,20.0
11553,1,1553,[191  70 471 185 182],457,5,6245,4.018661518661519,0.0,0.0
11554,1,1554,[143 222 286 483 403],450,3,6248,4.0180064308681676,0.0,20.0
11555,1,1555,[200  97  56 238 168],457,5,6253,4.018637532133676,0.0,0.0
11556,1,1556,[427  98  79 588 127],18,5,6258,4.019267822736031,20.0,20.0
11557,1,1557,[427  98  79 588 127],716,5,6263,4.0198973042362,20.0,20.0
11558,1,1558,[385  98 276  97 183],593,4,6267,4.019884541372675,0.0,0.0
11559,1,1559,[194 228 427 423  82],911,3,6270,4.019230769230769,20.0,0.0
11560,1,1560,[427  98  79 588 127],450,5,6275,4.019859064702114,20.0,20.0
11561,1,1561,[427  98  79 588 127],389,5,6280,4.020486555697823,20.0,20.0
11562,1,1562,[427  98  79 588 127],716,5,6285,4.021113243761996,20.0,20.0
11563,1,1563,[195 216 135 204 194],236,1,6286,4.0191815856777495,0.0,0.0
11564,1,1564,[427  98  79 588 127],796,5,6291,4.019808306709265,20.0,20.0
11565,1,1565,[427  98  79 588 127],716,5,6296,4.020434227330779,20.0,20.0
11566,1,1566,[427  98  79 588 127],796,5,6301,4.021059349074665,20.0,20.0
11567,1,1567,[191 245 117 132 655],450,5,6306,4.021683673469388,0.0,0.0
11568,1,1568,[269  97 237 357  25],655,1,6307,4.019757807520714,0.0,0.0
11569,1,1569,[ 50 125 238 127 655],796,3,6310,4.019108280254777,0.0,40.0
11570,1,1570,[427  98  79 588 127],18,5,6315,4.01973265436028,20.0,20.0
11571,1,1571,[ 56 204 228 385  69],450,5,6320,4.020356234096692,0.0,0.0
11572,1,1572,[427  98  79 588 127],18,5,6325,4.020979020979021,20.0,20.0
11573,1,1573,[301 127  89  96 215],796,4,6329,4.020965692503177,0.0,20.0
11574,1,1574,[301   9 603  97 302],535,4,6333,4.020952380952381,20.0,0.0
11575,1,1575,[202 655 282 403  69],280,1,6334,4.019035532994923,0.0,0.0
11576,1,1576,[427  98  79 588 127],450,5,6339,4.019657577679138,20.0,20.0
11577,1,1577,[185 151 111  98  88],236,3,6342,4.019011406844107,0.0,0.0
11578,1,1578,[427  98  79 588 127],389,5,6347,4.019632678910703,20.0,20.0
11579,1,1579,[427  98  79 588 127],18,5,6352,4.020253164556962,20.0,20.0
11580,1,1580,[427  98  79 588 127],716,5,6357,4.020872865275142,20.0,20.0
11581,1,1581,[117 275 185 161 191],716,4,6361,4.02085967130215,0.0,20.0
11582,1,1582,[427  98  79 588 127],796,5,6366,4.0214782059380925,20.0,20.0
11583,1,1583,[427  98  79 588 127],716,5,6371,4.022095959595959,20.0,20.0
11584,1,1584,[202 245 194 151 322],504,3,6374,4.021451104100946,0.0,0.0
11585,1,1585,[210 318 294 302   7],655,2,6376,4.020176544766708,20.0,0.0
11586,1,1586,[  4 597 385 288 175],457,4,6380,4.020163831127914,0.0,0.0
11587,1,1587,[427  98  79 588 127],18,5,6385,4.0207808564231735,20.0,20.0
11588,1,1588,[427  98  79 588 127],450,5,6390,4.021397105097545,20.0,20.0
11589,1,1589,[186  64  50 237 180],716,3,6393,4.020754716981132,20.0,20.0
11590,1,1590,[132 286 121 228 385],655,0,6393,4.018227529855436,0.0,20.0
11591,1,1591,[508 187 179 238 222],655,2,6395,4.016959798994975,0.0,0.0
11592,1,1592,[435 187  79 237 211],236,3,6398,4.016321406151914,0.0,0.0
11593,1,1593,[  4 276  96 245   9],280,3,6401,4.015683814303639,0.0,0.0
11594,1,1594,[742 546 127 125 282],120,4,6405,4.015673981191223,0.0,20.0
11595,1,1595,[127 182 568 175  88],269,3,6408,4.015037593984962,0.0,20.0
11596,1,1596,[ 98  15 286 496 216],593,5,6413,4.015654351909831,20.0,20.0
11597,1,1597,[210 275  96 132 151],457,5,6418,4.016270337922403,0.0,20.0
11598,1,1598,[427  98  79 588 127],796,5,6423,4.016885553470919,20.0,20.0
11599,1,1599,[427  98  79 588 127],450,5,6428,4.0175,20.0,20.0
11600,1,1600,[508 195 135 172 313],655,3,6431,4.0168644597126795,0.0,0.0
11601,1,1601,[  1 197 175 471 385],716,2,6433,4.015605493133583,0.0,0.0
11602,1,1602,[427  98  79 588 127],450,5,6438,4.01621958827199,20.0,20.0
11603,1,1603,[100 132 181 111 228],450,5,6443,4.016832917705735,0.0,20.0
11604,1,1604,[100  64 127 294  69],236,3,6446,4.01619937694704,20.0,40.0
11605,1,1605,[427  98  79 588 127],389,5,6451,4.016811955168119,20.0,20.0
11606,1,1606,[ 25 286 125 191 127],18,3,6454,4.016179215930305,0.0,40.0
11607,1,1607,[228 483 174 202  89],796,5,6459,4.016791044776119,0.0,0.0
11608,1,1608,[427  98  79 588 127],796,5,6464,4.017402113113735,20.0,20.0
11609,1,1609,[748 282 117   8  22],280,3,6467,4.016770186335404,0.0,0.0
11610,1,1610,[186 333 289 153  25],655,0,6467,4.014276846679081,0.0,0.0
11611,1,1611,[427  98  79 588 127],796,5,6472,4.0148883374689825,20.0,20.0
11612,1,1612,[588 210 161 301 313],796,3,6475,4.014259144451333,0.0,0.0
11613,1,1613,[127 174 678 471  25],401,3,6478,4.01363073110285,0.0,20.0
11614,1,1614,[174  71 211 111 185],401,4,6482,4.0136222910216715,0.0,0.0
11615,1,1615,[427  98  79 588 127],389,5,6487,4.014232673267327,20.0,20.0
11616,1,1616,[ 98 435 181 216 300],450,5,6492,4.0148423005565865,0.0,0.0
11617,1,1617,[427  98  79 588 127],18,5,6497,4.015451174289246,20.0,20.0
11618,1,1618,[237 357 175 275 222],457,5,6502,4.016059295861643,0.0,20.0
11619,1,1619,[ 97 300 135 328  88],655,1,6503,4.014197530864197,0.0,0.0
11620,1,1620,[144 237 172  56 185],535,2,6505,4.0129549660703265,0.0,0.0
11621,1,1621,[ 70 132 546  79 204],716,4,6509,4.012946979038224,0.0,0.0
11622,1,1622,[ 64 427 161   8   7],655,2,6511,4.011706715958102,40.0,0.0
11623,1,1623,[228 172 216 318 568],796,5,6516,4.012315270935961,20.0,0.0
11624,1,1624,[427  98  79 588 127],716,5,6521,4.012923076923077,20.0,20.0
11625,1,1625,[  7 471 302 301  50],450,5,6526,4.013530135301353,0.0,20.0
11626,1,1626,[427  98  79 588 127],450,5,6531,4.014136447449293,20.0,20.0
11627,1,1627,[427  98  79 588 127],796,5,6536,4.014742014742015,20.0,20.0
11628,1,1628,[197  96  98 135   4],655,2,6538,4.013505217925108,0.0,0.0
11629,1,1629,[  1 588 196 234 168],18,2,6540,4.012269938650307,0.0,0.0
11630,1,1630,[748 294 403 234 265],450,4,6544,4.012262415695892,0.0,0.0
11631,1,1631,[237 597 196 181 216],450,5,6549,4.012867647058823,0.0,0.0
11632,1,1632,[ 98 427 143  95 197],18,5,6554,4.013472137170851,20.0,0.0
11633,1,1633,[427  98  79 588 127],716,5,6559,4.0140758873929006,20.0,20.0
11634,1,1634,[427  98  79 588 127],450,5,6564,4.014678899082568,20.0,20.0
11635,1,1635,[210 515 100  97 216],401,5,6569,4.015281173594132,0.0,20.0
11636,1,1636,[210 275 294 176 194],796,3,6572,4.014660965180208,0.0,20.0
11637,1,1637,[427  98  79 588 127],716,5,6577,4.015262515262515,20.0,20.0
11638,1,1638,[121 127 300 282 175],716,3,6580,4.014643075045759,0.0,20.0
11639,1,1639,[427  98  79 588 127],389,5,6585,4.015243902439025,20.0,20.0
11640,1,1640,[427  98  79 588 127],716,5,6590,4.015843997562462,20.0,20.0
11641,1,1641,[546 496  98  50 403],577,4,6594,4.015834348355664,20.0,20.0
11642,1,1642,[200   4  28   1 234],716,4,6598,4.015824710894705,0.0,0.0
11643,1,1643,[427  98  79 588 127],389,5,6603,4.016423357664234,20.0,20.0
11644,1,1644,[313  95 245 172  79],280,2,6605,4.015197568389058,0.0,0.0
11645,1,1645,[427  98  79 588 127],450,5,6610,4.015795868772782,20.0,20.0
11646,1,1646,[176 427  82 323  79],796,3,6613,4.015179113539769,20.0,0.0
11647,1,1647,[215 588 282 151 273],796,4,6617,4.015169902912621,0.0,0.0
11648,1,1648,[427  98  79 588 127],18,5,6622,4.015767131594906,20.0,20.0
11649,1,1649,[300  70  69 135 568],885,4,6626,4.015757575757576,0.0,0.0
11650,1,1650,[118 435 588 172 100],450,4,6630,4.015748031496063,0.0,20.0
11651,1,1651,[ 64 173 186 180 194],716,3,6633,4.015133171912833,20.0,0.0
11652,1,1652,[194 385 121 403  79],796,5,6638,4.015728977616455,0.0,0.0
11653,1,1653,[427  98 588  79 127],389,5,6643,4.016324062877872,20.0,20.0
11654,1,1654,[185 194 282 471 125],457,5,6648,4.016918429003021,0.0,0.0
11655,1,1655,[427  98 588  79 127],796,5,6653,4.017512077294686,20.0,20.0
11656,1,1656,[427  98 588  79 127],450,5,6658,4.018105009052505,20.0,20.0
11657,1,1657,[427  98 588  79 127],18,5,6663,4.018697225572979,20.0,20.0
11658,1,1658,[427  70  88 186 179],269,2,6665,4.017480409885473,20.0,0.0
11659,1,1659,[322 328 196 333 143],796,4,6669,4.017469879518072,0.0,0.0
11660,1,1660,[144 135 435 182 132],629,5,6674,4.018061408789886,0.0,0.0
11661,1,1661,[742 118 234  71  25],450,1,6675,4.016245487364621,0.0,0.0
11662,1,1662,[427  98 588  79 127],389,5,6680,4.01683704149128,20.0,20.0
11663,1,1663,[125 294 179 258 216],655,2,6682,4.015625,0.0,0.0
11664,1,1664,[403 385 151 111 118],450,4,6686,4.015615615615616,0.0,0.0
11665,1,1665,[427  98 588  79 127],389,5,6691,4.016206482593037,20.0,20.0
11666,1,1666,[186 151  50 204 655],504,2,6693,4.01499700059988,0.0,20.0
11667,1,1667,[ 97  79 191 125 405],11,4,6697,4.014988009592326,0.0,0.0
11668,1,1668,[ 22 176 301 237 179],450,5,6702,4.015578190533254,0.0,0.0
11669,1,1669,[427  98 588  79 127],389,5,6707,4.016167664670658,20.0,20.0
11670,1,1670,[427  98 588  79 127],18,5,6712,4.016756433273489,20.0,20.0
11671,1,1671,[132 117 161 118 125],796,5,6717,4.017344497607655,0.0,0.0
11672,1,1672,[273 191 182 245 200],450,3,6720,4.01673640167364,0.0,0.0
11673,1,1673,[121 204   8 132  64],655,1,6721,4.0149342891278375,20.0,0.0
11674,1,1674,[100 268 195 276 153],629,5,6726,4.0155223880597015,0.0,20.0
11675,1,1675,[427  98 588  79 127],389,5,6731,4.016109785202864,20.0,20.0
11676,1,1676,[427  98 588  79 127],389,5,6736,4.016696481812761,20.0,20.0
11677,1,1677,[132  69  88  70 183],344,2,6738,4.01549463647199,0.0,0.0
11678,1,1678,[427  98 588  79 127],716,5,6743,4.016081000595593,20.0,20.0
11679,1,1679,[508 118 273 228 117],344,3,6746,4.015476190476191,0.0,0.0
11680,1,1680,[483  88 302 135 210],655,3,6749,4.014872099940511,0.0,0.0
11681,1,1681,[385 143 183 313  22],577,4,6753,4.01486325802616,0.0,0.0
11682,1,1682,[313  50  88  97 328],236,3,6756,4.0142602495543676,0.0,20.0
11683,1,1683,[174 427 168  64 135],707,1,6757,4.012470308788599,40.0,0.0
11684,1,1684,[182 100   4 127 125],457,5,6762,4.0130563798219585,0.0,40.0
11685,1,1685,[427  98 588  79 127],18,5,6767,4.013641755634638,20.0,20.0
11686,1,1686,[228  98 742  95  71],280,4,6771,4.013633669235329,0.0,0.0
11687,1,1687,[100 195 234 197  88],756,1,6772,4.011848341232228,0.0,20.0
11688,1,1688,[427  98 588  79 127],450,5,6777,4.012433392539965,20.0,20.0
11689,1,1689,[427  98 588  79 127],18,5,6782,4.01301775147929,20.0,20.0
11690,1,1690,[222 153 168 143 118],716,4,6786,4.013010053222945,0.0,0.0
11691,1,1691,[174 117 202  50  95],344,4,6790,4.013002364066194,0.0,20.0
11692,1,1692,[186  64 471 228  82],655,1,6791,4.011222681630242,20.0,0.0
11693,1,1693,[286 100 228  71 748],450,4,6795,4.0112160566706025,0.0,40.0
11694,1,1694,[427  98 588  79 127],18,5,6800,4.011799410029498,20.0,20.0
11695,1,1695,[173 245  88 172 211],450,5,6805,4.012382075471698,0.0,0.0
11696,1,1696,[186 275 153 273 234],655,2,6807,4.011196228638775,0.0,20.0
11697,1,1697,[427  98 588  79 127],716,5,6812,4.011778563015312,20.0,20.0
11698,1,1698,[182 275 357 258 318],450,5,6817,4.012360211889347,20.0,20.0
11699,1,1699,[427  98 588  79 127],389,5,6822,4.012941176470588,20.0,20.0
11700,1,1700,[179 210 172  97 117],655,2,6824,4.011757789535567,0.0,0.0
11701,1,1701,[427  98 588  79 127],796,5,6829,4.012338425381904,20.0,20.0
11702,1,1702,[423 216 568  22 427],450,5,6834,4.012918379330593,20.0,0.0
11703,1,1703,[125 132 222 135   8],280,3,6837,4.012323943661972,0.0,0.0
11704,1,1704,[300 471 118 191  89],655,2,6839,4.011143695014662,0.0,0.0
11705,1,1705,[427  98 588  79 127],716,5,6844,4.011723329425557,20.0,20.0
11706,1,1706,[427  98 588  79 127],796,5,6849,4.012302284710017,20.0,20.0
11707,1,1707,[179 237 196  11 195],269,1,6850,4.010538641686183,0.0,0.0
11708,1,1708,[132  50  88 186 265],450,4,6854,4.010532475131656,0.0,20.0
11709,1,1709,[427  98 588  79 127],796,5,6859,4.011111111111111,20.0,20.0
11710,1,1710,[427  98 588  79 127],796,5,6864,4.0116890707188775,20.0,20.0
11711,1,1711,[427  98 588  79 127],450,5,6869,4.012266355140187,20.0,20.0
11712,1,1712,[202  69 748 182 385],280,2,6871,4.011091652072388,0.0,0.0
11713,1,1713,[427  98 588  79 127],389,5,6876,4.01166861143524,20.0,20.0
11714,1,1714,[195 210 144   4   9],280,1,6877,4.0099125364431485,0.0,0.0
11715,1,1715,[483 216  25 357 318],716,5,6882,4.010489510489511,20.0,0.0
11716,1,1716,[237 100  25 275 127],450,4,6886,4.010483401281305,0.0,60.0
11717,1,1717,[427  98 588  79 127],18,5,6891,4.011059371362049,20.0,20.0
11718,1,1718,[151 181  25 196  12],450,4,6895,4.011052937754508,0.0,0.0
11719,1,1719,[  9  56  28 100 228],655,0,6895,4.008720930232558,0.0,20.0
11720,1,1720,[265 222 194 111  64],796,5,6900,4.009296920395119,20.0,0.0
11721,1,1721,[427  98 588  79 127],716,5,6905,4.009872241579559,20.0,20.0
11722,1,1722,[183 603 121   7 210],450,3,6908,4.009286128845038,20.0,0.0
11723,1,1723,[187 185 588  56 597],796,5,6913,4.009860788863109,0.0,0.0
11724,1,1724,[427  98 588  79 127],450,5,6918,4.010434782608695,20.0,20.0
11725,1,1725,[427  98 588  79 127],716,5,6923,4.011008111239861,20.0,20.0
11726,1,1726,[197 475 151 276 211],269,5,6928,4.011580775911986,0.0,0.0
11727,1,1727,[234 385 143 194 597],450,4,6932,4.011574074074074,0.0,0.0
11728,1,1728,[427  98 588  79 127],796,5,6937,4.012145748987854,20.0,20.0
11729,1,1729,[195 121 302  50   9],535,4,6941,4.012138728323699,0.0,20.0
11730,1,1730,[427  64 215  97 143],796,4,6945,4.012131715771231,40.0,0.0
11731,1,1731,[427  98 588  79 127],796,5,6950,4.01270207852194,20.0,20.0
11732,1,1732,[185  25 588 655 237],450,4,6954,4.0126947489901905,0.0,0.0
11733,1,1733,[427 588 180 228  89],796,4,6958,4.012687427912342,20.0,0.0
11734,1,1734,[276  71 427 181 151],535,4,6962,4.012680115273775,20.0,0.0
11735,1,1735,[427  98 588  79 127],450,5,6967,4.013248847926267,20.0,20.0
11736,1,1736,[ 71   8  56 276 237],535,3,6970,4.012665515256189,0.0,0.0
11737,1,1737,[427  98 588  79 127],796,5,6975,4.013233601841197,20.0,20.0
11738,1,1738,[427  98 588  79 127],796,5,6980,4.0138010350776305,20.0,20.0
11739,1,1739,[427  98 588  79 127],389,5,6985,4.014367816091954,20.0,20.0
11740,1,1740,[427  98 588  79 127],716,5,6990,4.014933946008042,20.0,20.0
11741,1,1741,[427  98 588  79 127],389,5,6995,4.015499425947187,20.0,20.0
11742,1,1742,[215   8 200  70  11],280,4,6999,4.015490533562823,0.0,0.0
11743,1,1743,[742 161 176   4 328],450,4,7003,4.015481651376147,0.0,0.0
11744,1,1744,[427  98 588  79 127],796,5,7008,4.016045845272206,20.0,20.0
11745,1,1745,[427  98 588  79 127],716,5,7013,4.016609392898053,20.0,20.0
11746,1,1746,[ 88  64 143 423 195],457,5,7018,4.01717229536348,20.0,0.0
11747,1,1747,[333 191 318 143 282],236,4,7022,4.017162471395881,20.0,0.0
11748,1,1748,[427  98 588  79 127],796,5,7027,4.0177244139508295,20.0,20.0
11749,1,1749,[ 88 655 117 200 275],457,5,7032,4.018285714285715,0.0,20.0
11750,1,1750,[222 125   7 258 273],344,3,7035,4.017704169046259,0.0,0.0
11751,1,1751,[427  98 588  79 127],796,5,7040,4.018264840182648,20.0,20.0
11752,1,1752,[118 742 385  98 294],504,3,7043,4.017683970336566,0.0,0.0
11753,1,1753,[427  98 588  79 127],450,5,7048,4.01824401368301,20.0,20.0
11754,1,1754,[ 88 269  11 135 546],450,4,7052,4.0182336182336185,0.0,0.0
11755,1,1755,[427  98 588  79 127],389,5,7057,4.01879271070615,20.0,20.0
11756,1,1756,[427  98 588  79 127],716,5,7062,4.019351166761525,20.0,20.0
11757,1,1757,[427  98 588  79 127],18,5,7067,4.019908987485779,20.0,20.0
11758,1,1758,[427  98 588  79 127],18,5,7072,4.020466173962479,20.0,20.0
11759,1,1759,[427  98 588  79 127],716,5,7077,4.021022727272728,20.0,20.0
11760,1,1760,[117 187 174  69 197],72,5,7082,4.021578648495173,0.0,0.0
11761,1,1761,[427  98 588  79 127],389,5,7087,4.022133938706016,20.0,20.0
11762,1,1762,[427  98 588  79 127],389,5,7092,4.022688598979013,20.0,20.0
11763,1,1763,[427  98 588  79 127],18,5,7097,4.023242630385488,20.0,20.0
11764,1,1764,[271  70 237 100 405],72,2,7099,4.022096317280453,0.0,20.0
11765,1,1765,[427  98 588  79 127],450,5,7104,4.0226500566251415,20.0,20.0
11766,1,1766,[427  98 588  79 127],450,5,7109,4.023203169213356,20.0,20.0
11767,1,1767,[172   9 275 357 215],655,3,7112,4.02262443438914,0.0,20.0
11768,1,1768,[427  98 588  79 127],716,5,7117,4.023176936122103,20.0,20.0
11769,1,1769,[181 111   9  69 144],593,4,7121,4.02316384180791,0.0,0.0
11770,1,1770,[427  98 588  79 127],716,5,7126,4.023715415019763,20.0,20.0
11771,1,1771,[175 265 215 127  12],457,5,7131,4.024266365688487,0.0,20.0
11772,1,1772,[210 435 185 183  64],450,4,7135,4.024252679075014,20.0,0.0
11773,1,1773,[185 294  97  98 202],504,3,7138,4.023675310033822,0.0,0.0
11774,1,1774,[302 210 268 276 179],535,2,7140,4.022535211267606,0.0,0.0
11775,1,1775,[427  98 588  79 127],716,5,7145,4.023085585585585,20.0,20.0
11776,1,1776,[427  98 588  79 127],18,5,7150,4.0236353404614515,20.0,20.0
11777,1,1777,[427  98 588  79 127],18,5,7155,4.024184476940382,20.0,20.0
11778,1,1778,[597 196 496 174   4],796,5,7160,4.024732996065205,20.0,0.0
11779,1,1779,[496 127  50 196 183],796,5,7165,4.025280898876405,20.0,40.0
11780,1,1780,[496 117   4 238  69],593,5,7170,4.025828186412128,20.0,0.0
11781,1,1781,[268 186 172 271  96],655,1,7171,4.024130190796858,0.0,0.0
11782,1,1782,[258  97   9  11 191],344,2,7173,4.0229949523275375,0.0,0.0
11783,1,1783,[546 496 273 182 313],450,4,7177,4.022982062780269,20.0,0.0
11784,1,1784,[427  98 588  79 127],796,5,7182,4.023529411764706,20.0,20.0
11785,1,1785,[427  98 588  79 127],716,5,7187,4.024076147816349,20.0,20.0
11786,1,1786,[427  98 588  79 127],716,5,7192,4.024622271964186,20.0,20.0
11787,1,1787,[427  98 588  79 127],716,5,7197,4.025167785234899,20.0,20.0
11788,1,1788,[ 56   7 127 678 181],280,3,7200,4.024594745667971,0.0,20.0
11789,1,1789,[143 257  82 111  15],655,1,7201,4.022905027932961,0.0,0.0
11790,1,1790,[427  98 588  79 127],18,5,7206,4.023450586264657,20.0,20.0
11791,1,1791,[286  22 405 174 427],655,1,7207,4.021763392857143,20.0,20.0
11792,1,1792,[427  98 588  79 127],716,5,7212,4.022308979364194,20.0,20.0
11793,1,1793,[ 70 143 483 135 318],151,5,7217,4.022853957636566,20.0,0.0
11794,1,1794,[185 117 204  64 175],716,4,7221,4.022841225626741,20.0,0.0
11795,1,1795,[118 204 475  97 603],655,1,7222,4.021158129175946,20.0,0.0
11796,1,1796,[427  98 588  79 127],18,5,7227,4.021702838063439,20.0,20.0
11797,1,1797,[100 286 288 258 265],655,0,7227,4.019466073414906,0.0,40.0
11798,1,1798,[427  98 588  79 127],389,5,7232,4.020011117287382,20.0,20.0
11799,1,1799,[427  98 588  79 127],716,5,7237,4.020555555555555,20.0,20.0
11800,1,1800,[405 269 185  97 216],503,4,7241,4.020544142143254,0.0,0.0
11801,1,1801,[111 196 322 286  12],344,3,7244,4.019977802441732,0.0,20.0
11802,1,1802,[196 655 568  79  95],796,4,7248,4.019966722129784,0.0,0.0
11803,1,1803,[427  98 588  79 127],716,5,7253,4.020509977827051,20.0,20.0
11804,1,1804,[210  98 132 179 196],389,3,7256,4.0199445983379505,0.0,0.0
11805,1,1805,[174 195 197 405 185],450,5,7261,4.020487264673311,0.0,0.0
11806,1,1806,[427  98 588  79 127],716,5,7266,4.0210293303818485,20.0,20.0
11807,1,1807,[  7 597  28 132 215],23,2,7268,4.019911504424779,0.0,0.0
11808,1,1808,[234 588   9  88 655],878,2,7270,4.0187949143173025,0.0,0.0
11809,1,1809,[195 597   4 748 568],256,5,7275,4.019337016574585,0.0,0.0
11810,1,1810,[258 161  95 318 200],450,3,7278,4.018774157923799,20.0,0.0
11811,1,1811,[427  98  79 588 127],389,5,7283,4.019315673289183,20.0,20.0
11812,1,1812,[435 269   8 357 143],655,2,7285,4.018201875344732,0.0,0.0
11813,1,1813,[427  98  79 588 127],389,5,7290,4.018743109151047,20.0,20.0
11814,1,1814,[427  98  79 588 127],18,5,7295,4.019283746556474,20.0,20.0
11815,1,1815,[185 282 357 100  22],450,5,7300,4.0198237885462555,0.0,20.0
11816,1,1816,[427  98  79 588 127],716,5,7305,4.020363236103467,20.0,20.0
11817,1,1817,[179 181 588 111   8],577,4,7309,4.02035203520352,0.0,0.0
11818,1,1818,[121 655 172  15 173],593,4,7313,4.020340846619021,0.0,0.0
11819,1,1819,[427  98  79 588 127],450,5,7318,4.020879120879121,20.0,20.0
11820,1,1820,[427  98  79 588 127],389,5,7323,4.021416803953872,20.0,20.0
11821,1,1821,[588 144 245 151 127],450,5,7328,4.021953896816685,0.0,20.0
11822,1,1822,[ 88 496 265 161  12],280,4,7332,4.021941854086671,20.0,0.0
11823,1,1823,[179 173 385   4 275],593,4,7336,4.021929824561403,0.0,20.0
11824,1,1824,[405 153 258 302 265],450,5,7341,4.022465753424657,0.0,0.0
11825,1,1825,[427  98  79 588 127],796,5,7346,4.023001095290252,20.0,20.0
11826,1,1826,[427  98  79 588 127],18,5,7351,4.023535851122058,20.0,20.0
11827,1,1827,[195 258 269 655 300],655,0,7351,4.021334792122539,0.0,0.0
11828,1,1828,[ 22 265 181 588 235],280,4,7355,4.021323127392018,0.0,0.0
11829,1,1829,[427  98  79 588 127],796,5,7360,4.021857923497268,20.0,20.0
11830,1,1830,[ 79 118  22   9 403],756,1,7361,4.020207536865101,0.0,0.0
11831,1,1831,[172 132   4  15 222],450,2,7363,4.01910480349345,0.0,0.0
11832,1,1832,[191 403 194 180 185],796,4,7367,4.019094380796508,0.0,0.0
11833,1,1833,[427  98  79 588 127],796,5,7372,4.019629225736096,20.0,20.0
11834,1,1834,[  7 234 197  97 194],457,5,7377,4.02016348773842,0.0,0.0
11835,1,1835,[427  98  79 588 127],18,5,7382,4.0206971677559915,20.0,20.0
11836,1,1836,[258 234 237  98 186],450,3,7385,4.020141535111595,0.0,0.0
11837,1,1837,[235 111  15 174 176],269,0,7385,4.017954298150163,0.0,0.0
11838,1,1838,[ 12 294 111 211 427],450,5,7390,4.018488308863513,20.0,0.0
11839,1,1839,[179  82  98 121 191],269,3,7393,4.0179347826086955,0.0,0.0
11840,1,1840,[427  98  79 588 127],389,5,7398,4.018468223791418,20.0,20.0
11841,1,1841,[483  50 172 275 195],151,4,7402,4.018458197611292,0.0,40.0
11842,1,1842,[427  98  79 588 127],18,5,7407,4.018990775908844,20.0,20.0
11843,1,1843,[427  98  79 588 127],450,5,7412,4.019522776572668,20.0,20.0
11844,1,1844,[427  98  79 588 127],796,5,7417,4.020054200542005,20.0,20.0
11845,1,1845,[427  98  79 588 127],18,5,7422,4.020585048754063,20.0,20.0
11846,1,1846,[427  98  79 588 127],389,5,7427,4.021115322144017,20.0,20.0
11847,1,1847,[ 64 172 313 423 289],236,4,7431,4.021103896103896,20.0,0.0
11848,1,1848,[405  79 200 273 210],655,3,7434,4.020551649540292,0.0,0.0
11849,1,1849,[176  64  97   4 118],151,3,7437,4.02,20.0,0.0
11850,1,1850,[435 235  96 405 238],450,4,7441,4.019989195029714,0.0,0.0
11851,1,1851,[215 143 742 182  97],457,5,7446,4.020518358531318,0.0,0.0
11852,1,1852,[427  98  79 588 127],389,5,7451,4.021046950890448,20.0,20.0
11853,1,1853,[742 405 228  25 282],450,4,7455,4.0210355987055015,0.0,0.0
11854,1,1854,[111 496  15 174 181],796,5,7460,4.02156334231806,20.0,0.0
11855,1,1855,[210  88 191   1 603],655,2,7462,4.020474137931035,20.0,0.0
11856,1,1856,[121  98 294  12 173],457,4,7466,4.020463112547119,0.0,0.0
11857,1,1857,[176  82 215 282  56],716,3,7469,4.019913885898816,0.0,0.0
11858,1,1858,[204 172 216 403 202],577,5,7474,4.020441097364174,0.0,0.0
11859,1,1859,[  8  11  71  98 176],577,4,7478,4.020430107526882,0.0,0.0
11860,1,1860,[100 204 238  88 276],593,4,7482,4.020419129500269,0.0,20.0
11861,1,1861,[427  98  79 588 127],389,5,7487,4.02094522019334,20.0,20.0
11862,1,1862,[271  95 678 222 181],807,3,7490,4.020397208803006,0.0,0.0
11863,1,1863,[427  98  79 588 127],796,5,7495,4.020922746781116,20.0,20.0
11864,1,1864,[200   4 153 127 742],504,4,7499,4.020911528150134,0.0,20.0
11865,1,1865,[275 196 222 132 195],450,4,7503,4.020900321543408,0.0,20.0
11866,1,1866,[427  98  79 588 127],18,5,7508,4.021424745581146,20.0,20.0
11867,1,1867,[153  28   4 257  56],389,3,7511,4.020877944325481,0.0,0.0
11868,1,1868,[427  98  79 588 127],716,5,7516,4.021401819154629,20.0,20.0
11869,1,1869,[111 300 568 294 289],655,0,7516,4.019251336898396,0.0,0.0
11870,1,1870,[357 228 161  82 603],450,4,7520,4.019241047568145,20.0,0.0
11871,1,1871,[597 195 423  89 496],796,5,7525,4.019764957264957,20.0,0.0
11872,1,1872,[483 187 100 403 111],655,2,7527,4.018686599038975,0.0,20.0
11873,1,1873,[180 191  56  15 172],269,2,7529,4.017609391675561,0.0,0.0
11874,1,1874,[121 288  28 179 237],457,5,7534,4.018133333333333,0.0,0.0
11875,1,1875,[427  98  79 588 127],450,5,7539,4.018656716417911,20.0,20.0
11876,1,1876,[427  98  79 588 127],389,5,7544,4.019179541822057,20.0,20.0
11877,1,1877,[143 588 175 318 202],716,4,7548,4.019169329073482,20.0,0.0
11878,1,1878,[211 234  12 161 121],693,1,7549,4.017562533262374,0.0,0.0
11879,1,1879,[427  98  79 588 127],450,5,7554,4.018085106382979,20.0,20.0
11880,1,1880,[265  79 172 496 328],450,5,7559,4.018607123870281,20.0,0.0
11881,1,1881,[143 174  50 183 427],236,2,7561,4.017534537725823,20.0,20.0
11882,1,1882,[237 435 132 195 385],716,3,7564,4.016994158258099,0.0,0.0
11883,1,1883,[228 483 181 357   4],457,5,7569,4.017515923566879,0.0,0.0
11884,1,1884,[195 183 111 385  50],344,4,7573,4.017506631299735,0.0,20.0
11885,1,1885,[427  98  79 588 127],389,5,7578,4.018027571580063,20.0,20.0
11886,1,1886,[ 71 179 195 282 180],450,4,7582,4.018018018018018,0.0,0.0
11887,1,1887,[427  98  79 588 127],389,5,7587,4.018538135593221,20.0,20.0
11888,1,1888,[168 546 144 405 210],716,3,7590,4.0179989412387505,0.0,0.0
11889,1,1889,[427  98  79 588 127],389,5,7595,4.018518518518518,20.0,20.0
11890,1,1890,[234 143  50 238 546],23,2,7597,4.017451084082496,0.0,20.0
11891,1,1891,[357 328 176 216 228],655,2,7599,4.016384778012685,0.0,0.0
11892,1,1892,[ 88 168 588 403 237],18,1,7600,4.014791336502905,0.0,0.0
11893,1,1893,[322 121  50 655 313],796,3,7603,4.014255543822598,0.0,20.0
11894,1,1894,[222  96 215 216 678],344,3,7606,4.013720316622691,0.0,0.0
11895,1,1895,[427  98  79 588 127],450,5,7611,4.014240506329114,20.0,20.0
11896,1,1896,[161 187 191 204 186],269,2,7613,4.013178703215604,0.0,0.0
11897,1,1897,[204 117 357 288 405],344,3,7616,4.012644889357218,0.0,0.0
11898,1,1898,[ 82 288 496 273 282],450,2,7618,4.0115850447604,20.0,0.0
11899,1,1899,[301 173 195  28 194],151,4,7622,4.011578947368421,0.0,0.0
11900,1,1900,[215 301  64  79 265],151,4,7626,4.011572856391373,20.0,0.0
11901,1,1901,[200 121 328 161 127],450,3,7629,4.011041009463723,0.0,20.0
11902,1,1902,[ 71 302 328 385  69],401,1,7630,4.009458749343143,0.0,0.0
11903,1,1903,[427  98  79 588 127],18,5,7635,4.009978991596639,20.0,20.0
11904,1,1904,[427  98  79 588 127],796,5,7640,4.010498687664042,20.0,20.0
11905,1,1905,[427  98  79 588 127],796,5,7645,4.011017838405037,20.0,20.0
11906,1,1906,[427  98  79 588 127],450,5,7650,4.011536444677504,20.0,20.0
11907,1,1907,[  9 196 471 603 191],655,2,7652,4.010482180293501,20.0,0.0
11908,1,1908,[204  15 172 403 282],457,5,7657,4.011000523834468,0.0,0.0
11909,1,1909,[153 301  12 385 216],655,1,7658,4.009424083769633,0.0,0.0
11910,1,1910,[215 258  96 603  82],23,3,7661,4.008895866038723,20.0,0.0
11911,1,1911,[427  98  79 588 127],716,5,7666,4.0094142259414225,20.0,20.0
11912,1,1912,[427  98  79 588 127],450,5,7671,4.009932043910089,20.0,20.0
11913,1,1913,[427  98  79 588 127],450,5,7676,4.010449320794148,20.0,20.0
11914,1,1914,[427  98  79 588 127],450,5,7681,4.010966057441253,20.0,20.0
11915,1,1915,[179  89 195 182 423],18,3,7684,4.010438413361169,0.0,0.0
11916,1,1916,[427  98  79 588 127],796,5,7689,4.010954616588419,20.0,20.0
11917,1,1917,[427  98  79 588 127],450,5,7694,4.011470281543274,20.0,20.0
11918,1,1918,[294 200   4 742  25],655,1,7695,4.00990099009901,0.0,0.0
11919,1,1919,[  4 286 174 215  15],450,3,7698,4.009375,0.0,20.0
11920,1,1920,[385 111  12 423 210],450,4,7702,4.009370119729308,0.0,0.0
11921,1,1921,[427  98  79 588 127],796,5,7707,4.009885535900104,20.0,20.0
11922,1,1922,[427  98  79 588 127],450,5,7712,4.01040041601664,20.0,20.0
11923,1,1923,[427  98  79 588 127],716,5,7717,4.010914760914761,20.0,20.0
11924,1,1924,[496 435 179  97 286],535,4,7721,4.010909090909091,20.0,20.0
11925,1,1925,[427  98  79 588 127],716,5,7726,4.0114226375908615,20.0,20.0
11926,1,1926,[194 183 168 200 175],457,5,7731,4.011935651271406,0.0,0.0
11927,1,1927,[ 56 186 111 257 435],296,3,7734,4.011410788381743,0.0,0.0
11928,1,1928,[196 175 183 258 210],151,4,7738,4.0114048729911875,0.0,0.0
11929,1,1929,[427  98  79 588 127],18,5,7743,4.011917098445596,20.0,20.0
11930,1,1930,[ 97 471 181  64 483],457,5,7748,4.01242879337131,20.0,0.0
11931,1,1931,[  7 568  79 179 300],655,2,7750,4.011387163561077,0.0,0.0
11932,1,1932,[427  98  79 588 127],450,5,7755,4.01189860320745,20.0,20.0
11933,1,1933,[427  98  79 588 127],18,5,7760,4.012409513960703,20.0,20.0
11934,1,1934,[427  98  79 588 127],796,5,7765,4.012919896640827,20.0,20.0
11935,1,1935,[ 95 405 173 427 118],716,4,7769,4.012913223140496,20.0,0.0
11936,1,1936,[427  98  79 588 127],18,5,7774,4.0134228187919465,20.0,20.0
11937,1,1937,[427  98  79 588 127],450,5,7779,4.013931888544891,20.0,20.0
11938,1,1938,[427  98  79 588 127],796,5,7784,4.014440433212997,20.0,20.0
11939,1,1939,[  4 125 313 174 191],450,4,7788,4.014432989690722,0.0,0.0
11940,1,1940,[313 568 302 301 179],450,5,7793,4.014940752189593,0.0,0.0
11941,1,1941,[245 546 286 144  95],280,3,7796,4.014418125643666,0.0,20.0
11942,1,1942,[ 56 603 568 172   9],796,4,7800,4.014410705095214,20.0,0.0
11943,1,1943,[427  98  79 588 127],716,5,7805,4.014917695473251,20.0,20.0
11944,1,1944,[125 237 286 153  22],450,5,7810,4.015424164524422,0.0,20.0
11945,1,1945,[385 195  28 100  97],796,2,7812,4.014388489208633,0.0,20.0
11946,1,1946,[427  98  79 588 127],796,5,7817,4.014894709809964,20.0,20.0
11947,1,1947,[427  98  79 588 127],796,5,7822,4.015400410677618,20.0,20.0
11948,1,1948,[427  98  79 588 127],450,5,7827,4.015905592611595,20.0,20.0
11949,1,1949,[427  98  79 588 127],450,5,7832,4.016410256410256,20.0,20.0
11950,1,1950,[427  98  79 588 127],796,5,7837,4.016914402870323,20.0,20.0
11951,1,1951,[196 603 318 258 117],450,5,7842,4.017418032786885,40.0,0.0
11952,1,1952,[427  98  79 588 127],450,5,7847,4.017921146953405,20.0,20.0
11953,1,1953,[427  98  79 588 127],796,5,7852,4.018423746161719,20.0,20.0
11954,1,1954,[427  98  79 588 127],389,5,7857,4.018925831202046,20.0,20.0
11955,1,1955,[269  70 215 238 597],23,2,7859,4.017893660531698,0.0,0.0
11956,1,1956,[427  98  79 588 127],389,5,7864,4.01839550332141,20.0,20.0
11957,1,1957,[603 269 234 215  28],450,4,7868,4.018386108273749,20.0,0.0
11958,1,1958,[427  98  79 588 127],716,5,7873,4.0188871873404794,20.0,20.0
11959,1,1959,[222 258 210 385 211],151,4,7877,4.018877551020408,0.0,0.0
11960,1,1960,[508 153 111 289 483],296,3,7880,4.018357980622132,0.0,0.0
11961,1,1961,[427  98  79 588 127],18,5,7885,4.018858307849134,20.0,20.0
11962,1,1962,[427  98  79 588 127],18,5,7890,4.01935812531839,20.0,20.0
11963,1,1963,[357 289  28 204   7],786,5,7895,4.0198574338085535,0.0,0.0
11964,1,1964,[ 82 183 143 313 185],655,4,7899,4.019847328244275,0.0,0.0
11965,1,1965,[427  98  79 588 127],389,5,7904,4.020345879959308,20.0,20.0
11966,1,1966,[427  98  79 588 127],18,5,7909,4.020843924758515,20.0,20.0
11967,1,1967,[427  98  79 588 127],716,5,7914,4.021341463414634,20.0,20.0
11968,1,1968,[427  98  79 588 127],796,5,7919,4.021838496698832,20.0,20.0
11969,1,1969,[483 302  50 655 197],655,3,7922,4.021319796954315,0.0,20.0
11970,1,1970,[118 265 111 135 268],655,1,7923,4.019786910197869,0.0,0.0
11971,1,1971,[568   7 117 313 742],577,3,7926,4.019269776876268,0.0,0.0
11972,1,1972,[427  98  79 588 127],796,5,7931,4.0197668525088694,20.0,20.0
11973,1,1973,[127 435 655  50 238],450,5,7936,4.020263424518744,0.0,40.0
11974,1,1974,[ 50  56   1 185 471],535,3,7939,4.019746835443038,0.0,20.0
11975,1,1975,[200 237 215 588 265],796,5,7944,4.020242914979757,0.0,0.0
11976,1,1976,[427  98  79 588 127],18,5,7949,4.020738492665655,20.0,20.0
11977,1,1977,[427  98  79 588 127],450,5,7954,4.021233569261881,20.0,20.0
11978,1,1978,[427  98  79 588 127],796,5,7959,4.021728145528044,20.0,20.0
11979,1,1979,[  9   1 176 118 153],280,3,7962,4.0212121212121215,0.0,0.0
11980,1,1980,[197 187 196 245  98],504,4,7966,4.021201413427562,0.0,0.0
11981,1,1981,[300  89 117 655 235],450,4,7970,4.021190716448032,0.0,0.0
11982,1,1982,[568 222   7  56 357],72,3,7973,4.020675743822491,0.0,0.0
11983,1,1983,[427  98  79 588 127],796,5,7978,4.02116935483871,20.0,20.0
11984,1,1984,[ 89 597  95 194 405],807,5,7983,4.021662468513854,0.0,0.0
11985,1,1985,[427  98  79 588 127],450,5,7988,4.022155085599194,20.0,20.0
11986,1,1986,[427  98  79 588 127],450,5,7993,4.022647206844489,20.0,20.0
11987,1,1987,[117 197 234 187  98],421,4,7997,4.022635814889336,0.0,0.0
11988,1,1988,[427  98  79 588 127],389,5,8002,4.023127199597788,20.0,20.0
11989,1,1989,[211  15 202 568 183],796,4,8006,4.023115577889447,0.0,0.0
11990,1,1990,[427  98  79 588 127],450,5,8011,4.023606228026117,20.0,20.0
11991,1,1991,[423 100 496 179 427],236,2,8013,4.022590361445783,40.0,20.0
11992,1,1992,[427  98  79 588 127],716,5,8018,4.023080782739589,20.0,20.0
11993,1,1993,[427  98  79 588 127],450,5,8023,4.023570712136409,20.0,20.0
11994,1,1994,[427  98  79 588 127],389,5,8028,4.02406015037594,20.0,20.0
11995,1,1995,[427  98  79 588 127],450,5,8033,4.024549098196393,20.0,20.0
11996,1,1996,[427  98  79 588 127],389,5,8038,4.025037556334501,20.0,20.0
11997,1,1997,[ 25  15 265 202 135],151,5,8043,4.025525525525525,0.0,0.0
11998,1,1998,[427  98  79 588 127],450,5,8048,4.026013006503252,20.0,20.0
11999,1,1999,[313 483  22 234 187],655,3,8051,4.0255,0.0,0.0
12000,1,2000,[100 172 185   7  82],256,4,8055,4.0254872563718145,0.0,20.0
12001,1,2001,[427  98  79 588 127],450,5,8060,4.025974025974026,20.0,20.0
12002,1,2002,[427  98  79 588 127],716,5,8065,4.026460309535697,20.0,20.0
12003,1,2003,[427  98  79 588 127],450,5,8070,4.026946107784431,20.0,20.0
12004,1,2004,[427  98  79 588 127],796,5,8075,4.027431421446384,20.0,20.0
12005,1,2005,[427  98  79 588 127],450,5,8080,4.027916251246261,20.0,20.0
12006,1,2006,[427  98  79 588 127],389,5,8085,4.028400597907324,20.0,20.0
12007,1,2007,[144  15 245 300   4],450,3,8088,4.027888446215139,0.0,0.0
12008,1,2008,[181  98 143 318 194],716,5,8093,4.028372324539572,20.0,0.0
12009,1,2009,[121 185   4  97 181],151,5,8098,4.028855721393035,0.0,0.0
12010,1,2010,[181 237 118 597 187],796,5,8103,4.029338637493784,0.0,0.0
12011,1,2011,[ 15 153  11 161 275],655,1,8104,4.027833001988071,0.0,20.0
12012,1,2012,[427  98  79 588 127],796,5,8109,4.028315946348733,20.0,20.0
12013,1,2013,[ 71 568  25 313  98],593,4,8113,4.028301886792453,0.0,0.0
12014,1,2014,[185 322 168 204   4],450,4,8117,4.028287841191067,0.0,0.0
12015,1,2015,[427  98  79 588 127],18,5,8122,4.028769841269841,20.0,20.0
12016,1,2016,[238 435 742 597 196],450,5,8127,4.0292513634110065,0.0,0.0
12017,1,2017,[427  98  79 588 127],18,5,8132,4.029732408325074,20.0,20.0
12018,1,2018,[427  98  79 588 127],716,5,8137,4.030212976721149,20.0,20.0
12019,1,2019,[202   4   8 182 603],389,5,8142,4.03069306930693,20.0,0.0
12020,1,2020,[228 204  82 423  25],457,5,8147,4.031172686788718,0.0,0.0
12021,1,2021,[ 79 204 471 176 655],457,5,8152,4.031651829871414,0.0,0.0
12022,1,2022,[194  69   1  98 471],577,4,8156,4.031636183885319,0.0,0.0
12023,1,2023,[427  98  79 588 127],389,5,8161,4.032114624505929,20.0,20.0
12024,1,2024,[191 195 301 144 161],655,1,8162,4.030617283950617,0.0,0.0
12025,1,2025,[435 603 385 257 269],655,1,8163,4.029121421520237,20.0,0.0
12026,1,2026,[210 313  96 187 183],693,2,8165,4.028120374938332,0.0,0.0
12027,1,2027,[300 125 174 546 182],450,5,8170,4.0285996055226825,0.0,0.0
12028,1,2028,[427  98  79 588 127],716,5,8175,4.029078363725973,20.0,20.0
12029,1,2029,[427  98  79 588 127],389,5,8180,4.029556650246305,20.0,20.0
12030,1,2030,[153  96 318 273 496],450,4,8184,4.029542097488922,40.0,0.0
12031,1,2031,[168 125 546 204 385],450,5,8189,4.03001968503937,0.0,0.0
12032,1,2032,[ 96  64 234 195 111],796,4,8193,4.030004918839154,20.0,0.0
12033,1,2033,[132  15  25 483 568],450,2,8195,4.029006882989184,0.0,0.0
12034,1,2034,[ 25 235 100 496 200],330,5,8200,4.0294840294840295,20.0,20.0
12035,1,2035,[161  56 288 238  88],504,2,8202,4.028487229862476,0.0,0.0
12036,1,2036,[427  98  79 588 127],716,5,8207,4.028964162984781,20.0,20.0
12037,1,2037,[427  98  79 588 127],18,5,8212,4.029440628066732,20.0,20.0
12038,1,2038,[181 172 153  64 211],236,2,8214,4.028445316331535,20.0,0.0
12039,1,2039,[181 265 300 117   1],796,4,8218,4.0284313725490195,0.0,0.0
12040,1,2040,[427  98  79 588 127],18,5,8223,4.02890739833415,20.0,20.0
12041,1,2041,[427  98  79 588 127],389,5,8228,4.029382957884427,20.0,20.0
12042,1,2042,[423  82   7 237 195],269,1,8229,4.027900146842878,0.0,0.0
12043,1,2043,[427  98  79 588 127],389,5,8234,4.028375733855186,20.0,20.0
12044,1,2044,[271  64 328 568  82],655,1,8235,4.026894865525672,20.0,0.0
12045,1,2045,[427  98  79 588 127],450,5,8240,4.027370478983382,20.0,20.0
12046,1,2046,[ 56 427 197 515 191],655,3,8243,4.0268685881778215,20.0,0.0
12047,1,2047,[427  98  79 588 127],796,5,8248,4.02734375,20.0,20.0
12048,1,2048,[427  98  79 588 127],450,5,8253,4.027818448023426,20.0,20.0
12049,1,2049,[282  50 588   7  89],450,5,8258,4.028292682926829,0.0,20.0
12050,1,2050,[ 15 748 151   1 127],450,4,8262,4.028278888347148,0.0,20.0
12051,1,2051,[427  98  79 588 127],796,5,8267,4.028752436647173,20.0,20.0
12052,1,2052,[173 183 200  64   4],716,3,8270,4.028251339503166,20.0,0.0
12053,1,2053,[427  98  79 588 127],389,5,8275,4.028724440116846,20.0,20.0
12054,1,2054,[151 748 313 237 245],450,5,8280,4.029197080291971,0.0,0.0
12055,1,2055,[427  98  79 588 127],796,5,8285,4.029669260700389,20.0,20.0
12056,1,2056,[427  98  79 588 127],716,5,8290,4.0301409820126395,20.0,20.0
12057,1,2057,[ 95  64 282 117 172],716,4,8294,4.030126336248785,20.0,0.0
12058,1,2058,[427  98  79 588 127],450,5,8299,4.030597377367654,20.0,20.0
12059,1,2059,[427  98  79 588 127],450,5,8304,4.031067961165048,20.0,20.0
12060,1,2060,[282 546 118 423 176],450,4,8308,4.031052886948084,0.0,0.0
12061,1,2061,[302   7 132  69 471],344,3,8311,4.030552861299709,0.0,0.0
12062,1,2062,[211 127  25 286 135],18,3,8314,4.030053320407174,0.0,40.0
12063,1,2063,[427  98  79 588 127],716,5,8319,4.030523255813954,20.0,20.0
12064,1,2064,[427  98  79 588 127],716,5,8324,4.030992736077482,20.0,20.0
12065,1,2065,[143 191 194  71 121],796,5,8329,4.031461761858664,0.0,0.0
12066,1,2066,[427  98  79 588 127],716,5,8334,4.031930333817126,20.0,20.0
12067,1,2067,[427  98  79 588 127],450,5,8339,4.032398452611218,20.0,20.0
12068,1,2068,[427  98  79 588 127],450,5,8344,4.032866118898018,20.0,20.0
12069,1,2069,[427  98  79 588 127],796,5,8349,4.033333333333333,20.0,20.0
12070,1,2070,[  4  89 202 328 118],151,3,8352,4.032834379526799,0.0,0.0
12071,1,2071,[357   7 222  12 196],344,5,8357,4.033301158301159,0.0,0.0
12072,1,2072,[483 301 143 313  22],450,4,8361,4.03328509406657,0.0,0.0
12073,1,2073,[427  98  79 588 127],450,5,8366,4.0337512054001925,20.0,20.0
12074,1,2074,[294 211 302 333 289],860,1,8367,4.032289156626506,0.0,0.0
12075,1,2075,[427  98  79 588 127],389,5,8372,4.032755298651252,20.0,20.0
12076,1,2076,[427  98  79 588 127],18,5,8377,4.033220991815118,20.0,20.0
12077,1,2077,[117 742 238 195  64],457,5,8382,4.033686236766122,20.0,0.0
12078,1,2078,[427  98  79 588 127],716,5,8387,4.0341510341510345,20.0,20.0
12079,1,2079,[187 286 385 179 403],655,2,8389,4.033173076923077,0.0,20.0
12080,1,2080,[427  98  79 588 127],389,5,8394,4.0336376741950986,20.0,20.0
12081,1,2081,[173 179  97  98 111],450,5,8399,4.034101825168108,0.0,0.0
12082,1,2082,[ 22 196 174 185 168],18,2,8401,4.033125300048008,0.0,0.0
12083,1,2083,[427  98  79 588 127],450,5,8406,4.0335892514395395,20.0,20.0
12084,1,2084,[161 185  64 588 200],330,5,8411,4.034052757793765,20.0,0.0
12085,1,2085,[ 11 322 603 181 257],401,1,8412,4.032598274209012,20.0,0.0
12086,1,2086,[427  98  79 588 127],716,5,8417,4.033061811212266,20.0,20.0
12087,1,2087,[427  98  79 588 127],796,5,8422,4.033524904214559,20.0,20.0
12088,1,2088,[ 96  82 423  15 215],72,4,8426,4.033508855911919,0.0,0.0
12089,1,2089,[195 228   9 174 269],796,3,8429,4.033014354066986,0.0,0.0
12090,1,2090,[  9 161 151 210  82],256,5,8434,4.033476805356289,0.0,0.0
12091,1,2091,[322 546  82 195 471],256,5,8439,4.033938814531549,0.0,0.0
12092,1,2092,[427  98  79 588 127],18,5,8444,4.034400382226469,20.0,20.0
12093,1,2093,[427  98  79 588 127],450,5,8449,4.034861509073544,20.0,20.0
12094,1,2094,[121  98 275  82 222],457,5,8454,4.035322195704057,0.0,20.0
12095,1,2095,[655   4 234 168  25],716,4,8458,4.0353053435114505,0.0,0.0
12096,1,2096,[313   4  82 117 405],280,1,8459,4.033857892226991,0.0,0.0
12097,1,2097,[427  98  79 588 127],796,5,8464,4.0343183984747375,20.0,20.0
12098,1,2098,[121 185 181 301 302],450,4,8468,4.034302048594569,0.0,0.0
12099,1,2099,[427  98  79 588 127],18,5,8473,4.034761904761905,20.0,20.0
12100,1,2100,[318 185  69 215 191],716,5,8478,4.035221323179439,20.0,0.0
12101,1,2101,[182 174 423  12 179],18,5,8483,4.035680304471931,0.0,0.0
12102,1,2102,[405 238 127 328 196],450,5,8488,4.036138849262958,0.0,20.0
12103,1,2103,[191  70 202 197 427],655,2,8490,4.035171102661597,20.0,0.0
12104,1,2104,[427  98  79 588 127],18,5,8495,4.03562945368171,20.0,20.0
12105,1,2105,[427  98  79 588 127],389,5,8500,4.036087369420703,20.0,20.0
12106,1,2106,[275  96 257 176 183],655,2,8502,4.035121025154248,0.0,20.0
12107,1,2107,[117 179 196 258  98],504,4,8506,4.035104364326376,0.0,0.0
12108,1,2108,[318 186 655   9  28],693,1,8507,4.03366524419156,20.0,0.0
12109,1,2109,[508 475 132   7  70],269,3,8510,4.033175355450237,0.0,0.0
12110,1,2110,[427  98  79 588 127],389,5,8515,4.0336333491236385,20.0,20.0
12111,1,2111,[427  98  79 588 127],796,5,8520,4.034090909090909,20.0,20.0
12112,1,2112,[427  98  79 588 127],450,5,8525,4.034548035967818,20.0,20.0
12113,1,2113,[427  98  79 588 127],450,5,8530,4.035004730368969,20.0,20.0
12114,1,2114,[181   1 168 125 748],292,3,8533,4.03451536643026,0.0,0.0
12115,1,2115,[427  98  79 588 127],450,5,8538,4.034971644612476,20.0,20.0
12116,1,2116,[ 11 483 471  71 144],401,3,8541,4.0344827586206895,0.0,0.0
12117,1,2117,[568 546 423  64 276],457,4,8545,4.034466477809254,20.0,0.0
12118,1,2118,[427  98  79 588 127],716,5,8550,4.0349221330816425,20.0,20.0
12119,1,2119,[427  98  79 588 127],716,5,8555,4.035377358490566,20.0,20.0
12120,1,2120,[427  98  79 588 127],450,5,8560,4.035832154644035,20.0,20.0
12121,1,2121,[200 185 742 300 179],450,4,8564,4.035815268614515,0.0,0.0
12122,1,2122,[427  98  79 588 127],796,5,8569,4.036269430051814,20.0,20.0
12123,1,2123,[546  50  28 111 175],457,3,8572,4.03578154425612,0.0,20.0
12124,1,2124,[427  98  79 588 127],796,5,8577,4.036235294117647,20.0,20.0
12125,1,2125,[127 174 172 288 215],436,3,8580,4.035747883349012,0.0,20.0
12126,1,2126,[427  98  79 588 127],18,5,8585,4.036201222378938,20.0,20.0
12127,1,2127,[135 132  69 405 182],450,4,8589,4.036184210526316,0.0,0.0
12128,1,2128,[275  82 183 151  64],450,4,8593,4.036167214654768,20.0,20.0
12129,1,2129,[427  98  79 588 127],389,5,8598,4.0366197183098596,20.0,20.0
12130,1,2130,[427  98  79 588 127],716,5,8603,4.037071797278273,20.0,20.0
12131,1,2131,[427  98  79 588 127],796,5,8608,4.037523452157599,20.0,20.0
12132,1,2132,[427  98  79 588 127],389,5,8613,4.037974683544304,20.0,20.0
12133,1,2133,[125 216 748 151 174],256,5,8618,4.038425492033739,0.0,0.0
12134,1,2134,[176 265 118 195 168],151,2,8620,4.037470725995316,0.0,0.0
12135,1,2135,[427  98  79 588 127],450,5,8625,4.037921348314606,20.0,20.0
12136,1,2136,[427  98  79 588 127],389,5,8630,4.038371548900328,20.0,20.0
12137,1,2137,[265 742 234 161 318],280,4,8634,4.038353601496726,20.0,0.0
12138,1,2138,[588 144 742  64 423],796,4,8638,4.038335670874241,20.0,0.0
12139,1,2139,[423 204  64  89 211],151,5,8643,4.038785046728972,20.0,0.0
12140,1,2140,[100  88 228 172   4],577,3,8646,4.0382998598785615,0.0,20.0
12141,1,2141,[181 117 235 216 748],450,4,8650,4.03828197945845,0.0,0.0
12142,1,2142,[276 302  96 268 176],655,2,8652,4.037330844610359,0.0,0.0
12143,1,2143,[  9 508 121 204 405],401,1,8653,4.035914179104478,0.0,0.0
12144,1,2144,[405  71 234 323  89],796,3,8656,4.035431235431235,0.0,0.0
12145,1,2145,[174  50 121 135 238],535,4,8660,4.035414725069898,0.0,20.0
12146,1,2146,[427  98  79 588 127],796,5,8665,4.0358639962738705,20.0,20.0
12147,1,2147,[111 168 174  97   8],577,5,8670,4.0363128491620115,0.0,0.0
12148,1,2148,[257 286 182 196 187],796,4,8674,4.036295951605398,0.0,20.0
12149,1,2149,[ 71 179 197 186  95],450,2,8676,4.035348837209303,0.0,0.0
12150,1,2150,[258 172 282 496  56],796,5,8681,4.035797303579731,20.0,0.0
12151,1,2151,[427  98  79 588 127],796,5,8686,4.036245353159852,20.0,20.0
12152,1,2152,[427  98  79 588 127],389,5,8691,4.036692986530423,20.0,20.0
12153,1,2153,[ 96 588 597 483 423],796,5,8696,4.0371402042711235,0.0,0.0
12154,1,2154,[ 22 210 183 173  98],450,4,8700,4.037122969837587,0.0,0.0
12155,1,2155,[ 98 151 182 180  12],18,4,8704,4.037105751391466,0.0,0.0
12156,1,2156,[301  79 475 275  50],389,5,8709,4.037552155771905,0.0,40.0
12157,1,2157,[161 187  15 603 655],796,4,8713,4.037534754402224,20.0,0.0
12158,1,2158,[427  98  79 588 127],716,5,8718,4.037980546549329,20.0,20.0
12159,1,2159,[111 210 191 678 135],401,3,8721,4.0375,0.0,0.0
12160,1,2160,[471 161  22 176 153],716,2,8723,4.036557149467839,0.0,0.0
12161,1,2161,[132 483 181  12 180],457,5,8728,4.0370027752081405,0.0,0.0
12162,1,2162,[427  98  79 588 127],389,5,8733,4.0374479889043,20.0,20.0
12163,1,2163,[235 238 183 161 151],23,1,8734,4.036044362292052,0.0,0.0
12164,1,2164,[427  98  79 588 127],18,5,8739,4.0364896073903,20.0,20.0
12165,1,2165,[328 161 313 125 568],655,1,8740,4.035087719298246,0.0,0.0
12166,1,2166,[  4  69 200 286 174],796,4,8744,4.035071527457315,0.0,20.0
12167,1,2167,[174 186 121 182 216],269,1,8745,4.033671586715867,0.0,0.0
12168,1,2168,[427  98  79 588 127],450,5,8750,4.034117104656524,20.0,20.0
12169,1,2169,[238 202 204 143  28],786,5,8755,4.034562211981567,0.0,0.0
12170,1,2170,[238 403  69 258 215],504,3,8758,4.0340856748042375,0.0,0.0
12171,1,2171,[125 273 357  82 268],655,2,8760,4.033149171270718,0.0,0.0
12172,1,2172,[185 100  22 313 202],796,4,8764,4.0331339162448225,0.0,20.0
12173,1,2173,[180  89  95 234 197],786,3,8767,4.0326586936522535,0.0,0.0
12174,1,2174,[483 275 151 265 194],236,1,8768,4.0312643678160915,0.0,20.0
12175,1,2175,[427  98  79 588 127],389,5,8773,4.031709558823529,20.0,20.0
12176,1,2176,[427  98  79 588 127],18,5,8778,4.032154340836013,20.0,20.0
12177,1,2177,[427  98  79 588 127],450,5,8783,4.032598714416896,20.0,20.0
12178,1,2178,[  4 100 655 144  12],796,3,8786,4.032124827902708,0.0,20.0
12179,1,2179,[127 125 237 228 258],450,5,8791,4.03256880733945,0.0,20.0
12180,1,2180,[132 294  96 228 588],23,4,8795,4.0325538743695555,0.0,0.0
12181,1,2181,[405  82  69   4 328],655,0,8795,4.03070577451879,0.0,0.0
12182,1,2182,[ 69 191 588 135 405],716,4,8799,4.030691708657811,0.0,0.0
12183,1,2183,[187  12 568 182 237],450,5,8804,4.031135531135531,0.0,0.0
12184,1,2184,[ 56 313 197 282 237],280,1,8805,4.02974828375286,0.0,0.0
12185,1,2185,[427  98  79 588 127],716,5,8810,4.030192131747484,20.0,20.0
12186,1,2186,[ 70 282 117 111 135],280,4,8814,4.030178326474623,0.0,0.0
12187,1,2187,[427  98  79 588 127],450,5,8819,4.030621572212066,20.0,20.0
12188,1,2188,[111 174 286 172 121],786,4,8823,4.030607583371403,0.0,20.0
12189,1,2189,[427  98  79 588 127],389,5,8828,4.0310502283105025,20.0,20.0
12190,1,2190,[427  98  79 588 127],796,5,8833,4.03149246919215,20.0,20.0
12191,1,2191,[179 475 202 471 118],655,1,8834,4.030109489051095,0.0,0.0
12192,1,2192,[427  98  79 588 127],389,5,8839,4.030551755585956,20.0,20.0
12193,1,2193,[ 15 153 405 235  50],450,3,8842,4.030082041932543,0.0,20.0
12194,1,2194,[427  98  79 588 127],716,5,8847,4.030523917995445,20.0,20.0
12195,1,2195,[ 11 655  70 237 173],457,5,8852,4.030965391621129,0.0,0.0
12196,1,2196,[ 71 301  28 172 161],450,4,8856,4.030951297223487,0.0,0.0
12197,1,2197,[  9 655 125 176 222],280,1,8857,4.029572338489536,0.0,0.0
12198,1,2198,[ 69 405 125 282 237],401,0,8857,4.027739881764439,0.0,0.0
12199,1,2199,[742  98 313 333 289],655,2,8859,4.026818181818181,0.0,0.0
12200,1,2200,[100  25  97 210 286],655,0,8859,4.024988641526579,0.0,40.0
12201,1,2201,[427  98  79 588 127],450,5,8864,4.025431425976385,20.0,20.0
12202,1,2202,[172 357 322 118  50],344,3,8867,4.024965955515206,0.0,20.0
12203,1,2203,[ 56 127 282 245 151],504,4,8871,4.0249546279491835,0.0,20.0
12204,1,2204,[ 56 187 174 302  96],269,2,8873,4.024036281179138,0.0,0.0
12205,1,2205,[427  98  79 588 127],716,5,8878,4.024478694469629,20.0,20.0
12206,1,2206,[427  98  79 588 127],389,5,8883,4.024920706841867,20.0,20.0
12207,1,2207,[427  98  79 588 127],18,5,8888,4.02536231884058,20.0,20.0
12208,1,2208,[427  98  79 588 127],450,5,8893,4.025803531009506,20.0,20.0
12209,1,2209,[ 15 318 210 427 288],655,2,8895,4.024886877828054,40.0,0.0
12210,1,2210,[427  98  79 588 127],18,5,8900,4.025327905924921,20.0,20.0
12211,1,2211,[427  98  79 588 127],796,5,8905,4.025768535262206,20.0,20.0
12212,1,2212,[742 427 172  97 258],693,3,8908,4.0253050158156345,20.0,0.0
12213,1,2213,[100 546 300   9 121],151,3,8911,4.024841915085817,0.0,20.0
12214,1,2214,[265 475  96 100  64],292,5,8916,4.0252821670428895,20.0,20.0
12215,1,2215,[ 88 174  22 588 168],18,3,8919,4.024819494584838,0.0,0.0
12216,1,2216,[ 97 127 121  98  82],716,5,8924,4.025259359494813,0.0,20.0
12217,1,2217,[ 69 234 289 301  82],655,0,8924,4.023444544634806,0.0,0.0
12218,1,2218,[405 245  15 204  97],450,4,8928,4.023433979269941,0.0,0.0
12219,1,2219,[313  28 210  79 333],655,2,8930,4.0225225225225225,0.0,0.0
12220,1,2220,[427  98  79 588 127],389,5,8935,4.022962629446195,20.0,20.0
12221,1,2221,[ 50 568 111 435 515],716,5,8940,4.023402340234023,0.0,20.0
12222,1,2222,[ 79 282 423  89 216],457,5,8945,4.023841655420603,0.0,0.0
12223,1,2223,[427  98  79 588 127],450,5,8950,4.024280575539568,20.0,20.0
12224,1,2224,[427  98  79 588 127],796,5,8955,4.024719101123596,20.0,20.0
12225,1,2225,[ 25 318 191 185 111],401,5,8960,4.0251572327044025,20.0,0.0
12226,1,2226,[  1 183 245 435 215],450,5,8965,4.025594970812753,0.0,0.0
12227,1,2227,[ 28 174  97 215   9],655,0,8965,4.023788150807899,0.0,0.0
12228,1,2228,[427  98  79 588 127],389,5,8970,4.024226110363392,20.0,20.0
12229,1,2229,[127  56  89 222 117],457,5,8975,4.024663677130045,0.0,20.0
12230,1,2230,[357   7 238 403 111],269,2,8977,4.023756163155536,0.0,0.0
12231,1,2231,[222 186 210  12  98],151,5,8982,4.024193548387097,0.0,0.0
12232,1,2232,[748 427 313 197 257],796,4,8986,4.024182713837886,20.0,0.0
12233,1,2233,[427  98  79 588 127],716,5,8991,4.02461951656222,20.0,20.0
12234,1,2234,[427  98  79 588 127],716,5,8996,4.025055928411633,20.0,20.0
12235,1,2235,[301 118 228 515  11],655,1,8997,4.023703041144902,0.0,0.0
12236,1,2236,[204 313 161  50 216],450,5,9002,4.024139472507823,0.0,20.0
12237,1,2237,[  9 161 475 202 216],655,1,9003,4.022788203753351,0.0,0.0
12238,1,2238,[427  98  79 588 127],450,5,9008,4.023224653863332,20.0,20.0
12239,1,2239,[427  98  79 588 127],389,5,9013,4.023660714285715,20.0,20.0
12240,1,2240,[427  98  79 588 127],450,5,9018,4.024096385542169,20.0,20.0
12241,1,2241,[121 742 237  96 228],256,4,9022,4.024085637823372,0.0,0.0
12242,1,2242,[427  98  79 588 127],450,5,9027,4.02452073116362,20.0,20.0
12243,1,2243,[204 180 210 111 202],280,2,9029,4.0236185383244205,0.0,0.0
12244,1,2244,[427  98  79 588 127],716,5,9034,4.024053452115813,20.0,20.0
12245,1,2245,[161 125 271  28  25],655,0,9034,4.022261798753339,0.0,0.0
12246,1,2246,[186 748 588 215 427],450,4,9038,4.02225189141077,20.0,0.0
12247,1,2247,[588 597 191   9  82],457,4,9042,4.022241992882562,0.0,0.0
12248,1,2248,[427  98  79 588 127],716,5,9047,4.022676745220098,20.0,20.0
12249,1,2249,[302 195 222 143 127],450,4,9051,4.022666666666667,0.0,20.0
12250,1,2250,[121 117 435 313 215],655,1,9052,4.0213238560639715,0.0,0.0
12251,1,2251,[427  98  79 588 127],18,5,9057,4.021758436944938,20.0,20.0
12252,1,2252,[194 100 301 435 153],450,5,9062,4.022192632046161,0.0,20.0
12253,1,2253,[125  12 286 196 111],174,5,9067,4.0226264418811,0.0,20.0
12254,1,2254,[ 69  56 121  28 182],655,1,9068,4.021286031042129,0.0,0.0
12255,1,2255,[427  98  79 588 127],796,5,9073,4.021719858156028,20.0,20.0
12256,1,2256,[200 143 121 100 144],5,2,9075,4.020824102791316,0.0,20.0
12257,1,2257,[603  22 427  25 508],11,4,9079,4.020814880425155,40.0,0.0
12258,1,2258,[301 211 237 143 200],593,5,9084,4.02124833997344,0.0,0.0
12259,1,2259,[ 70 357 121 176 204],457,5,9089,4.021681415929203,0.0,0.0
12260,1,2260,[127 655 288 179  56],655,2,9091,4.0207872622733305,0.0,20.0
12261,1,2261,[258 127 200 265 276],629,5,9096,4.021220159151194,0.0,20.0
12262,1,2262,[294 282 546 180 174],796,3,9099,4.0207688908528505,0.0,0.0
12263,1,2263,[427  98  79 588 127],18,5,9104,4.021201413427562,20.0,20.0
12264,1,2264,[313 121 195 151 228],796,5,9109,4.021633554083885,0.0,0.0
12265,1,2265,[427  98  79 588 127],716,5,9114,4.022065313327449,20.0,20.0
12266,1,2266,[427  98  79 588 127],389,5,9119,4.022496691662991,20.0,20.0
12267,1,2267,[257 143 194 191 210],457,4,9123,4.022486772486772,0.0,0.0
12268,1,2268,[132 597   1  22  96],796,4,9127,4.022476862053768,0.0,0.0
12269,1,2269,[588 273 385 655 269],450,4,9131,4.022466960352423,0.0,0.0
12270,1,2270,[181 204 271 191 300],902,2,9133,4.021576398062527,0.0,0.0
12271,1,2271,[427  98  79 588 127],18,5,9138,4.022007042253521,20.0,20.0
12272,1,2272,[185 228 183 174  15],151,4,9142,4.021997360316762,0.0,0.0
12273,1,2273,[588   4 568 301 187],450,4,9146,4.021987686895339,0.0,0.0
12274,1,2274,[427  98  79 588 127],450,5,9151,4.0224175824175825,20.0,20.0
12275,1,2275,[294 483  28 191 427],450,4,9155,4.022407732864675,20.0,0.0
12276,1,2276,[ 25  98 257 197 132],716,5,9160,4.0228370663153274,0.0,0.0
12277,1,2277,[286  11 655  97 132],450,5,9165,4.023266022827041,0.0,20.0
12278,1,2278,[496 174 132 483 435],236,3,9168,4.02281702501097,20.0,0.0
12279,1,2279,[210 318 300 191 597],796,4,9172,4.02280701754386,20.0,0.0
12280,1,2280,[471 117  15 127 301],655,1,9173,4.0214818062253395,0.0,20.0
12281,1,2281,[427  98  79 588 127],450,5,9178,4.021910604732691,20.0,20.0
12282,1,2282,[427  98  79 588 127],18,5,9183,4.02233902759527,20.0,20.0
12283,1,2283,[  7   8 100 216 143],269,1,9184,4.021015761821366,0.0,20.0
12284,1,2284,[153 173 238 185 318],269,3,9187,4.020568927789935,20.0,0.0
12285,1,2285,[515 588  88  70 168],878,3,9190,4.020122484689414,0.0,0.0
12286,1,2286,[427  98  79 588 127],389,5,9195,4.020550940096196,20.0,20.0
12287,1,2287,[118 597 302 385 273],344,2,9197,4.0196678321678325,0.0,0.0
12288,1,2288,[742 173 427  89 597],796,4,9201,4.019659239842726,20.0,0.0
12289,1,2289,[300  64 172 483 176],450,4,9205,4.0196506550218345,20.0,0.0
12290,1,2290,[132  11 204  96 268],655,0,9205,4.017896115233523,0.0,0.0
12291,1,2291,[183 742 127  79 186],693,2,9207,4.017015706806283,0.0,20.0
12292,1,2292,[111 135 182  69 195],629,5,9212,4.017444395987789,0.0,0.0
12293,1,2293,[427  98  79 588 127],18,5,9217,4.017872711421099,20.0,20.0
12294,1,2294,[ 71 655 286  98  79],236,3,9220,4.017429193899782,0.0,20.0
12295,1,2295,[  8 286 423 144 175],655,0,9220,4.015679442508711,0.0,20.0
12296,1,2296,[427  98  79 588 127],389,5,9225,4.016107966913365,20.0,20.0
12297,1,2297,[172 288 268 191 144],655,2,9227,4.015230635335074,0.0,0.0
12298,1,2298,[143 211   4 185  98],655,3,9230,4.014789038712483,0.0,0.0
12299,1,2299,[161 204 228  96 151],807,4,9234,4.014782608695652,0.0,0.0
12300,1,2300,[427  98  79 588 127],18,5,9239,4.0152107779226425,20.0,20.0
12301,1,2301,[222  25 301 286 328],450,3,9242,4.014769765421373,0.0,20.0
12302,1,2302,[427  98  79 588 127],18,5,9247,4.015197568389058,20.0,20.0
12303,1,2303,[427  98  79 588 127],18,5,9252,4.015625,20.0,20.0
12304,1,2304,[ 64  89  98 228 195],256,4,9256,4.015618221258134,20.0,0.0
12305,1,2305,[427  98  79 588 127],18,5,9261,4.016045099739809,20.0,20.0
12306,1,2306,[427  98  79 588 127],716,5,9266,4.016471608149112,20.0,20.0
12307,1,2307,[427  98  79 588 127],18,5,9271,4.0168977469670715,20.0,20.0
12308,1,2308,[427  98  79 588 127],796,5,9276,4.017323516673885,20.0,20.0
12309,1,2309,[135 173  79  12  64],450,4,9280,4.017316017316017,20.0,0.0
12310,1,2310,[427  98  79 588 127],389,5,9285,4.017741237559498,20.0,20.0
12311,1,2311,[ 50   1 204 234   9],18,3,9288,4.017301038062284,0.0,20.0
12312,1,2312,[427  98  79 588 127],716,5,9293,4.017725897103329,20.0,20.0
12313,1,2313,[427  98  79 588 127],389,5,9298,4.018150388936906,20.0,20.0
12314,1,2314,[276   9 195 313 181],280,2,9300,4.017278617710583,0.0,0.0
12315,1,2315,[273 568  11  15 496],450,3,9303,4.016839378238342,20.0,0.0
12316,1,2316,[ 70 151 269 603  97],707,3,9306,4.016400517911092,20.0,0.0
12317,1,2317,[161 271 196  95 151],796,5,9311,4.016824849007765,0.0,0.0
12318,1,2318,[313 603 318 385 197],655,3,9314,4.016386373436826,40.0,0.0
12319,1,2319,[313 323  11 182  71],280,2,9316,4.01551724137931,0.0,0.0
12320,1,2320,[427  98  79 588 127],18,5,9321,4.0159414045669966,20.0,20.0
12321,1,2321,[405 151 322 117 216],344,2,9323,4.015073212747631,0.0,0.0
12322,1,2322,[125 174 234 100 258],655,0,9323,4.013344812742144,0.0,20.0
12323,1,2323,[153 655 118 176 333],796,4,9327,4.013339070567986,0.0,0.0
12324,1,2324,[427  98  79 588 127],796,5,9332,4.013763440860215,20.0,20.0
12325,1,2325,[427  98  79 588 127],716,5,9337,4.014187446259673,20.0,20.0
12326,1,2326,[ 69 211 216  98 318],450,5,9342,4.014611087236785,20.0,0.0
12327,1,2327,[ 82  69 257 427 117],796,4,9346,4.0146048109965635,20.0,0.0
12328,1,2328,[427  98  79 588 127],450,5,9351,4.015027908973808,20.0,20.0
12329,1,2329,[328 202 210 483 176],151,3,9354,4.014592274678112,0.0,0.0
12330,1,2330,[427  98  79 588 127],450,5,9359,4.015015015015015,20.0,20.0
12331,1,2331,[403 301 269  12 187],796,3,9362,4.014579759862778,0.0,0.0
12332,1,2332,[427  98  79 588 127],796,5,9367,4.015002143163309,20.0,20.0
12333,1,2333,[427  98  79 588 127],18,5,9372,4.015424164524422,20.0,20.0
12334,1,2334,[210 435 153 211 496],535,5,9377,4.015845824411135,20.0,0.0
12335,1,2335,[403 357 215 546  28],504,4,9381,4.015839041095891,0.0,0.0
12336,1,2336,[427  98  79 588 127],450,5,9386,4.016260162601626,20.0,20.0
12337,1,2337,[204 216 195  79 483],236,3,9389,4.015825491873396,0.0,0.0
12338,1,2338,[238 475 187 204 153],655,1,9390,4.014536126549808,0.0,0.0
12339,1,2339,[  1 215   4 245 313],344,1,9391,4.013247863247863,0.0,0.0
12340,1,2340,[427  98  79 588 127],716,5,9396,4.013669372063221,20.0,20.0
12341,1,2341,[125 265 300 427  64],796,5,9401,4.014090520922289,40.0,0.0
12342,1,2342,[496   1  56 195 125],450,5,9406,4.014511310285958,20.0,0.0
12343,1,2343,[427  98  79 588 127],450,5,9411,4.014931740614334,20.0,20.0
12344,1,2344,[185 121 174 405 215],450,4,9415,4.014925373134329,0.0,0.0
12345,1,2345,[405 228 216 258 172],344,3,9418,4.0144927536231885,0.0,0.0
12346,1,2346,[427  98  79 588 127],18,5,9423,4.014912654452493,20.0,20.0
12347,1,2347,[427  98  79 588 127],450,5,9428,4.015332197614992,20.0,20.0
12348,1,2348,[568  56 186 168 176],577,3,9431,4.014899957428693,0.0,0.0
12349,1,2349,[427  98  79 588 127],18,5,9436,4.01531914893617,20.0,20.0
12350,1,2350,[121 385 125 100  89],151,3,9439,4.014887282007656,0.0,20.0
12351,1,2351,[427  98  79 588 127],716,5,9444,4.01530612244898,20.0,20.0
12352,1,2352,[427  98  79 588 127],716,5,9449,4.015724606884828,20.0,20.0
12353,1,2353,[215 655 678 357 258],504,5,9454,4.016142735768904,0.0,0.0
12354,1,2354,[597  96 151 405 210],269,1,9455,4.014861995753716,0.0,0.0
12355,1,2355,[143 405 435 127 471],450,5,9460,4.01528013582343,0.0,20.0
12356,1,2356,[294 187 568  88 204],655,1,9461,4.014000848536275,0.0,0.0
12357,1,2357,[286 179 195 216 117],655,2,9463,4.01314673452078,0.0,20.0
12358,1,2358,[427  98  79 588 127],796,5,9468,4.0135650699448915,20.0,20.0
12359,1,2359,[273 216 191  79 196],344,5,9473,4.013983050847457,0.0,0.0
12360,1,2360,[127 179 172  97  11],450,5,9478,4.01440067767895,0.0,20.0
12361,1,2361,[228 143 197 403 603],655,2,9480,4.013547840812871,20.0,0.0
12362,1,2362,[427  98  79 588 127],389,5,9485,4.0139652983495555,20.0,20.0
12363,1,2363,[125  15 313  56  79],593,5,9490,4.014382402707276,0.0,0.0
12364,1,2364,[471 234 117 143  96],457,5,9495,4.014799154334038,0.0,0.0
12365,1,2365,[318  25 183 273 194],450,3,9498,4.014370245139476,20.0,0.0
12366,1,2366,[427  98  79 588 127],450,5,9503,4.014786649767639,20.0,20.0
12367,1,2367,[427  98  79 588 127],18,5,9508,4.015202702702703,20.0,20.0
12368,1,2368,[427  98  79 588 127],796,5,9513,4.015618404390038,20.0,20.0
12369,1,2369,[289 273 179 174 508],655,2,9515,4.014767932489452,0.0,0.0
12370,1,2370,[ 50 172 333 204 228],796,5,9520,4.015183466891607,0.0,20.0
12371,1,2371,[151 180 173 423 181],535,5,9525,4.015598650927488,0.0,0.0
12372,1,2372,[ 79 216  11 121  22],655,2,9527,4.014749262536873,0.0,0.0
12373,1,2373,[427  98  79 588 127],796,5,9532,4.015164279696714,20.0,20.0
12374,1,2374,[427  98  79 588 127],389,5,9537,4.015578947368421,20.0,20.0
12375,1,2375,[237 318 271 257 276],655,2,9539,4.01473063973064,20.0,0.0
12376,1,2376,[ 50 197 286 423 181],280,2,9541,4.013883045856121,0.0,40.0
12377,1,2377,[427  98  79 588 127],389,5,9546,4.014297729184189,20.0,20.0
12378,1,2378,[ 22 313 302  64 132],344,3,9549,4.013871374527112,20.0,0.0
12379,1,2379,[427  98  79 588 127],796,5,9554,4.014285714285714,20.0,20.0
12380,1,2380,[ 70 196 143 238  28],655,1,9555,4.013019739605208,0.0,0.0
12381,1,2381,[427  98  79 588 127],716,5,9560,4.01343408900084,20.0,20.0
12382,1,2382,[742 151 117 176 403],756,3,9563,4.013008812421318,0.0,0.0
12383,1,2383,[143 185 174  95 168],716,5,9568,4.0134228187919465,0.0,0.0
12384,1,2384,[211 172 143  28 483],18,3,9571,4.012997903563941,0.0,0.0
12385,1,2385,[427  98  79 588 127],389,5,9576,4.013411567476949,20.0,20.0
12386,1,2386,[427  98  79 588 127],18,5,9581,4.013824884792626,20.0,20.0
12387,1,2387,[588  82 151 176 655],23,1,9582,4.0125628140703515,0.0,0.0
12388,1,2388,[515 275 125 405 100],655,2,9584,4.011720385098368,0.0,40.0
12389,1,2389,[  8 403  97 216  64],796,4,9588,4.0117154811715485,20.0,0.0
12390,1,2390,[216 271 127 197 588],796,4,9592,4.011710581346716,0.0,20.0
12391,1,2391,[427  98  79 588 127],796,5,9597,4.012123745819398,20.0,20.0
12392,1,2392,[427  98  79 588 127],389,5,9602,4.012536564981195,20.0,20.0
12393,1,2393,[ 25 176 181 179 100],450,4,9606,4.012531328320802,0.0,20.0
12394,1,2394,[168 127  69 191 427],316,2,9608,4.011691022964509,20.0,20.0
12395,1,2395,[289 153 273 183 265],655,2,9610,4.010851419031719,0.0,0.0
12396,1,2396,[427  98  79 588 127],389,5,9615,4.011264080100125,20.0,20.0
12397,1,2397,[405 127 286   1 121],503,2,9617,4.010425354462051,0.0,40.0
12398,1,2398,[ 82 187  88 245 385],256,4,9621,4.010421008753648,0.0,0.0
12399,1,2399,[ 22 655 100   1 182],457,5,9626,4.010833333333333,0.0,20.0
12400,1,2400,[235  96 323 153 508],280,3,9629,4.010412328196585,0.0,0.0
12401,1,2401,[427  98  79 588 127],716,5,9634,4.0108243130724395,20.0,20.0
12402,1,2402,[127 333 568 257   8],796,5,9639,4.01123595505618,0.0,20.0
12403,1,2403,[427  98  79 588 127],450,5,9644,4.011647254575707,20.0,20.0
12404,1,2404,[427  98  79 588 127],796,5,9649,4.0120582120582124,20.0,20.0
12405,1,2405,[ 70 282 238 269 186],535,4,9653,4.0120532003325025,0.0,0.0
12406,1,2406,[202 655 496 135 127],716,4,9657,4.0120481927710845,20.0,20.0
12407,1,2407,[427  98  79 588 127],450,5,9662,4.012458471760797,20.0,20.0
12408,1,2408,[ 98 322 161 204  71],450,4,9666,4.012453300124533,0.0,0.0
12409,1,2409,[234  50 403 515 175],655,2,9668,4.011618257261411,0.0,20.0
12410,1,2410,[286  89  95 496  96],796,4,9672,4.0116134384072994,20.0,20.0
12411,1,2411,[ 96 186 282 258 271],655,0,9672,4.009950248756219,0.0,0.0
12412,1,2412,[222 132 168 172 423],457,5,9677,4.010360547036884,0.0,0.0
12413,1,2413,[427  98  79 588 127],796,5,9682,4.010770505385253,20.0,20.0
12414,1,2414,[603  12 273  82 202],450,3,9685,4.010351966873706,20.0,0.0
12415,1,2415,[423 127 313 204 238],655,2,9687,4.009519867549669,0.0,20.0
12416,1,2416,[172 210 111 603 196],151,5,9692,4.009929664873811,20.0,0.0
12417,1,2417,[427  98  79 588 127],389,5,9697,4.010339123242349,20.0,20.0
12418,1,2418,[181 471 121 301   1],450,4,9701,4.010334849111203,0.0,0.0
12419,1,2419,[ 12 318 187 100  50],503,4,9705,4.010330578512397,20.0,40.0
12420,1,2420,[ 89  15 210 294 276],655,2,9707,4.009500206526229,0.0,0.0
12421,1,2421,[322  79 273  50 275],450,4,9711,4.009496284062758,0.0,40.0
12422,1,2422,[151 385 265 117 143],457,5,9716,4.009905076351631,0.0,0.0
12423,1,2423,[405 568 183  22 204],716,4,9720,4.00990099009901,0.0,0.0
12424,1,2424,[ 69  70 121 183 216],655,2,9722,4.009072164948454,0.0,0.0
12425,1,2425,[ 64 111 475 275   4],655,2,9724,4.0082440230832646,20.0,20.0
12426,1,2426,[427  98  79 588 127],716,5,9729,4.008652657601978,20.0,20.0
12427,1,2427,[427  98  79 588 127],450,5,9734,4.009060955518946,20.0,20.0
12428,1,2428,[168 237 175 176 275],457,5,9739,4.009468917249897,0.0,20.0
12429,1,2429,[427  98  79 588 127],796,5,9744,4.009876543209876,20.0,20.0
12430,1,2430,[118 176 222   9 423],457,5,9749,4.010283833813245,0.0,0.0
12431,1,2431,[427  98  79 588 127],18,5,9754,4.010690789473684,20.0,20.0
12432,1,2432,[176  89 180 132 385],450,5,9759,4.011097410604193,0.0,0.0
12433,1,2433,[ 28 168  12 403 176],450,5,9764,4.0115036976170915,0.0,0.0
12434,1,2434,[111  70 191  25 322],450,4,9768,4.0114989733059545,0.0,0.0
12435,1,2435,[294  56 196  11  28],716,5,9773,4.011904761904762,0.0,0.0
12436,1,2436,[435 191 301 273 294],450,4,9777,4.011899876897825,0.0,0.0
12437,1,2437,[258 288 175  11  12],655,0,9777,4.01025430680886,0.0,0.0
12438,1,2438,[427  98  79 588 127],450,5,9782,4.010660106601066,20.0,20.0
12439,1,2439,[ 69 588 276 180 111],280,5,9787,4.011065573770492,0.0,0.0
12440,1,2440,[302 273 405 202 118],450,3,9790,4.010651372388366,0.0,0.0
12441,1,2441,[275 294 135 132   4],450,3,9793,4.01023751023751,0.0,20.0
12442,1,2442,[ 15 185 423 182 143],389,3,9796,4.009823986901351,0.0,0.0
12443,1,2443,[117 194 186   9 655],796,2,9798,4.009001636661211,0.0,0.0
12444,1,2444,[215 127 403 300 328],796,5,9803,4.009406952965235,0.0,20.0
12445,1,2445,[427  98  79 588 127],389,5,9808,4.009811937857727,20.0,20.0
12446,1,2446,[ 89 200 185 195 483],151,3,9811,4.009399264405395,0.0,0.0
12447,1,2447,[475 183 403 333 385],655,1,9812,4.008169934640523,0.0,0.0
12448,1,2448,[427  98  79 588 127],716,5,9817,4.008574928542262,20.0,20.0
12449,1,2449,[202 194 222 100 257],796,4,9821,4.008571428571429,0.0,20.0
12450,1,2450,[427  98  79 588 127],18,5,9826,4.008975928192575,20.0,20.0
12451,1,2451,[216 132  28 357 175],716,4,9830,4.008972267536705,0.0,0.0
12452,1,2452,[ 50  69 173   9 117],786,5,9835,4.009376273950265,0.0,20.0
12453,1,2453,[ 11 655  25 318 435],401,3,9838,4.008964955175224,20.0,0.0
12454,1,2454,[435 185 238  88 186],450,4,9842,4.008961303462322,0.0,0.0
12455,1,2455,[742 186 508  88 111],655,0,9842,4.007328990228013,0.0,0.0
12456,1,2456,[427  98  79 588 127],18,5,9847,4.007733007733008,20.0,20.0
12457,1,2457,[ 89 172 403 302 748],450,5,9852,4.008136696501221,0.0,0.0
12458,1,2458,[405  95 195 385 191],344,3,9855,4.007726718178121,0.0,0.0
12459,1,2459,[427  98  79 588 127],716,5,9860,4.008130081300813,20.0,20.0
12460,1,2460,[222 172  69  15 289],655,1,9861,4.006907761072735,0.0,0.0
12461,1,2461,[228 117 176 508 172],280,1,9862,4.005686433793664,0.0,0.0
12462,1,2462,[427  98  79 588 127],796,5,9867,4.006090133982948,20.0,20.0
12463,1,2463,[ 88 174 294 301 176],450,5,9872,4.0064935064935066,0.0,0.0
12464,1,2464,[257   1  98  12 191],457,4,9876,4.006490872210954,0.0,0.0
12465,1,2465,[427  98  79 588 127],450,5,9881,4.006893755068938,20.0,20.0
12466,1,2466,[427  98  79 588 127],716,5,9886,4.0072963113092825,20.0,20.0
12467,1,2467,[655 508  98 195 237],269,3,9889,4.006888168557537,0.0,0.0
12468,1,2468,[483 100  95 125 168],450,3,9892,4.006480356419603,0.0,20.0
12469,1,2469,[427  98  79 588 127],796,5,9897,4.006882591093118,20.0,20.0
12470,1,2470,[427  98  79 588 127],796,5,9902,4.007284500202347,20.0,20.0
12471,1,2471,[211  95 546 194  96],23,4,9906,4.007281553398058,0.0,0.0
12472,1,2472,[427  98  79 588 127],716,5,9911,4.007682976142338,20.0,20.0
12473,1,2473,[427  98  79 588 127],389,5,9916,4.0080840743734845,20.0,20.0
12474,1,2474,[265 313  28 210 179],655,2,9918,4.007272727272727,0.0,0.0
12475,1,2475,[135  28 385  70  82],655,1,9919,4.00605815831987,0.0,0.0
12476,1,2476,[427  98  79 588 127],450,5,9924,4.006459426725878,20.0,20.0
12477,1,2477,[742  11 423  12 182],450,5,9929,4.006860371267151,0.0,0.0
12478,1,2478,[135  96 405 515  82],72,3,9932,4.006454215409439,0.0,0.0
12479,1,2479,[427  98  79 588 127],18,5,9937,4.006854838709677,20.0,20.0
12480,1,2480,[200 195 127 546 211],236,2,9939,4.006045949214027,0.0,20.0
12481,1,2481,[427  98  79 588 127],796,5,9944,4.006446414182111,20.0,20.0
12482,1,2482,[216 183 568 313 288],450,4,9948,4.006443817962142,0.0,0.0
12483,1,2483,[427  98  79 588 127],18,5,9953,4.006843800322061,20.0,20.0
12484,1,2484,[588 172 471 202 180],716,3,9956,4.006438631790744,0.0,0.0
12485,1,2485,[282 276 172 127  22],256,2,9958,4.005631536604988,0.0,20.0
12486,1,2486,[427  98  79 588 127],18,5,9963,4.0060313630880575,20.0,20.0
12487,1,2487,[427  98  79 588 127],796,5,9968,4.006430868167203,20.0,20.0
12488,1,2488,[ 96 234 175 185 588],23,4,9972,4.006428284451587,0.0,0.0
12489,1,2489,[204  79 385 245 318],280,3,9975,4.006024096385542,20.0,0.0
12490,1,2490,[427  98  79 588 127],18,5,9980,4.006423123243677,20.0,20.0
12491,1,2491,[427  98  79 588 127],389,5,9985,4.006821829855538,20.0,20.0
12492,1,2492,[427  98  79 588 127],716,5,9990,4.007220216606498,20.0,20.0
12493,1,2493,[427  98  79 588 127],716,5,9995,4.007618283881315,20.0,20.0
12494,1,2494,[300 135 196 313  28],224,4,9999,4.007615230460922,0.0,0.0
12495,1,2495,[ 69 222 127 742 121],450,3,10002,4.007211538461538,0.0,20.0
12496,1,2496,[427  98  79 588 127],18,5,10007,4.007609130957149,20.0,20.0
12497,1,2497,[269  89  50   7  11],450,5,10012,4.0080064051241,0.0,20.0
12498,1,2498,[  4 271 200 357 471],655,2,10014,4.007202881152461,0.0,0.0
12499,1,2499,[ 95 313  71  64 174],344,3,10017,4.0068,20.0,0.0
12500,1,2500,[ 28  97   9 117 143],693,3,10020,4.006397441023591,0.0,0.0
12501,1,2501,[333 405  70 357 302],655,2,10022,4.005595523581135,0.0,0.0
12502,1,2502,[427  98  79 588 127],716,5,10027,4.005992808629644,20.0,20.0
12503,1,2503,[427  98  79 588 127],796,5,10032,4.006389776357827,20.0,20.0
12504,1,2504,[427  98  79 588 127],389,5,10037,4.006786427145709,20.0,20.0
12505,1,2505,[176 483 222  89   1],655,2,10039,4.005985634477255,0.0,0.0
12506,1,2506,[ 64 302 237 144 210],450,4,10043,4.005983246908656,20.0,0.0
12507,1,2507,[427  98  79 588 127],18,5,10048,4.006379585326954,20.0,20.0
12508,1,2508,[ 11 183 258 127 100],655,2,10050,4.005579912315664,0.0,40.0
12509,1,2509,[568  50 318 144 181],655,2,10052,4.004780876494024,20.0,20.0
12510,1,2510,[427  98  79 588 127],18,5,10057,4.005177220230983,20.0,20.0
12511,1,2511,[427  98  79 588 127],716,5,10062,4.005573248407643,20.0,20.0
12512,1,2512,[427  98  79 588 127],18,5,10067,4.005968961400717,20.0,20.0
12513,1,2513,[ 56 403  71 215 257],796,5,10072,4.006364359586317,0.0,0.0
12514,1,2514,[403 742 210 238 172],457,5,10077,4.00675944333996,0.0,0.0
12515,1,2515,[135  82  97  64 405],330,4,10081,4.006756756756757,20.0,0.0
12516,1,2516,[427  98  79 588 127],450,5,10086,4.00715137067938,20.0,20.0
12517,1,2517,[427  98  79 588 127],18,5,10091,4.007545671167593,20.0,20.0
12518,1,2518,[427  98  79 588 127],389,5,10096,4.0079396585946805,20.0,20.0
12519,1,2519,[210 125 655   7 144],457,5,10101,4.008333333333334,0.0,0.0
12520,1,2520,[427  98  79 588 127],796,5,10106,4.008726695755652,20.0,20.0
12521,1,2521,[288 172 313  12 180],280,3,10109,4.00832672482157,0.0,0.0
12522,1,2522,[ 79 546 313 655 318],450,5,10114,4.008719778042013,20.0,0.0
12523,1,2523,[ 88  97 211 132 234],151,5,10119,4.009112519809825,0.0,0.0
12524,1,2524,[144 161 282 195 135],457,5,10124,4.0095049504950495,0.0,0.0
12525,1,2525,[427  98  79 588 127],389,5,10129,4.009897070467142,20.0,20.0
12526,1,2526,[ 28 151 161 328 234],450,4,10133,4.009893153937475,0.0,0.0
12527,1,2527,[ 56 269 222   9  82],796,2,10135,4.009098101265823,0.0,0.0
12528,1,2528,[427  98  79 588 127],389,5,10140,4.0094899169632265,20.0,20.0
12529,1,2529,[427  98  79 588 127],18,5,10145,4.009881422924901,20.0,20.0
12530,1,2530,[257  15 275 210 269],796,3,10148,4.009482418016594,0.0,20.0
12531,1,2531,[427  98  79 588 127],450,5,10153,4.009873617693523,20.0,20.0
12532,1,2532,[427  98  79 588 127],716,5,10158,4.010264508487959,20.0,20.0
12533,1,2533,[127   4 182 135   9],18,3,10161,4.009865824782952,0.0,20.0
12534,1,2534,[195 748 202 183  96],796,5,10166,4.01025641025641,0.0,0.0
12535,1,2535,[ 11 318 568 111  95],450,4,10170,4.010252365930599,20.0,0.0
12536,1,2536,[  7 235 294 121 168],457,3,10173,4.009854158454868,0.0,0.0
12537,1,2537,[435 179 265 405 286],655,1,10174,4.008668242710796,0.0,20.0
12538,1,2538,[427  98  79 588 127],450,5,10179,4.009058684521465,20.0,20.0
12539,1,2539,[427  98  79 588 127],796,5,10184,4.009448818897638,20.0,20.0
12540,1,2540,[ 96 286 403 282  56],280,3,10187,4.0090515545061,0.0,20.0
12541,1,2541,[257 435 204 173 300],389,2,10189,4.008261211644374,0.0,0.0
12542,1,2542,[427  98  79 588 127],716,5,10194,4.008651199370822,20.0,20.0
12543,1,2543,[427  98  79 588 127],389,5,10199,4.009040880503145,20.0,20.0
12544,1,2544,[427  98  79 588 127],389,5,10204,4.0094302554027506,20.0,20.0
12545,1,2545,[  1 234 288  89  70],655,1,10205,4.008248232521603,0.0,0.0
12546,1,2546,[427  98  79 588 127],450,5,10210,4.008637612877895,20.0,20.0
12547,1,2547,[427  98  79 588 127],796,5,10215,4.009026687598116,20.0,20.0
12548,1,2548,[427  98  79 588 127],450,5,10220,4.009415457041977,20.0,20.0
12549,1,2549,[427  98  79 588 127],716,5,10225,4.009803921568627,20.0,20.0
12550,1,2550,[215 333 195 176 153],655,0,10225,4.008232065856527,0.0,0.0
12551,1,2551,[185 204  69 655 258],655,1,10226,4.00705329153605,0.0,0.0
12552,1,2552,[427  98  79 588 127],450,5,10231,4.007442224833529,20.0,20.0
12553,1,2553,[748  69 151 302 191],450,5,10236,4.007830853563038,0.0,0.0
12554,1,2554,[427  98  79 588 127],796,5,10241,4.008219178082192,20.0,20.0
12555,1,2555,[265 202 181 172 197],716,5,10246,4.008607198748043,0.0,0.0
12556,1,2556,[405 202 185 238  89],796,4,10250,4.008603832616347,0.0,0.0
12557,1,2557,[427  98  79 588 127],389,5,10255,4.008991399530884,20.0,20.0
12558,1,2558,[183 216  25 678 196],504,4,10259,4.008987885892927,0.0,0.0
12559,1,2559,[427  98  79 588 127],716,5,10264,4.009375,20.0,20.0
12560,1,2560,[202   9 742 357  96],504,4,10268,4.009371339320578,0.0,0.0
12561,1,2561,[245 568 153 222 197],280,1,10269,4.008196721311475,0.0,0.0
12562,1,2562,[427  98  79 588 127],796,5,10274,4.008583690987124,20.0,20.0
12563,1,2563,[269 273 100 153 568],796,2,10276,4.00780031201248,0.0,20.0
12564,1,2564,[172  25 151 322 196],344,4,10280,4.007797270955166,0.0,0.0
12565,1,2565,[427  98  79 588 127],450,5,10285,4.008183943881527,20.0,20.0
12566,1,2566,[427  98  79 588 127],796,5,10290,4.008570315543436,20.0,20.0
12567,1,2567,[427  98  79 588 127],796,5,10295,4.008956386292835,20.0,20.0
12568,1,2568,[187 125  70 483 238],18,4,10299,4.008952899961074,0.0,0.0
12569,1,2569,[275 191 302 127 121],655,4,10303,4.008949416342412,0.0,40.0
12570,1,2570,[ 50 215 423 742   1],280,3,10306,4.008556981719176,0.0,20.0
12571,1,2571,[427  98  79 588 127],389,5,10311,4.0089424572317265,20.0,20.0
12572,1,2572,[427  98  79 588 127],389,5,10316,4.009327633113098,20.0,20.0
12573,1,2573,[176 215  64  11 180],450,5,10321,4.00971250971251,20.0,0.0
12574,1,2574,[427  98  79 588 127],716,5,10326,4.01009708737864,20.0,20.0
12575,1,2575,[100  97 273 742 300],655,1,10327,4.008928571428571,0.0,20.0
12576,1,2576,[427  98  79 588 127],450,5,10332,4.009313154831199,20.0,20.0
12577,1,2577,[385  25  64 269 215],655,1,10333,4.008145849495733,20.0,0.0
12578,1,2578,[427  98  79 588 127],450,5,10338,4.008530438154323,20.0,20.0
12579,1,2579,[568   7 182 742 183],450,5,10343,4.0089147286821705,0.0,0.0
12580,1,2580,[151  96  12 546 318],450,5,10348,4.009298721425804,20.0,0.0
12581,1,2581,[427  98  79 588 127],716,5,10353,4.009682416731216,20.0,20.0
12582,1,2582,[483 427 318 161 275],450,4,10357,4.009678668215254,40.0,20.0
12583,1,2583,[111 427 161  98  28],796,4,10361,4.009674922600619,20.0,0.0
12584,1,2584,[427  98  79 588 127],796,5,10366,4.010058027079304,20.0,20.0
12585,1,2585,[427  98  79 588 127],450,5,10371,4.010440835266821,20.0,20.0
12586,1,2586,[427  98  79 588 127],389,5,10376,4.010823347506765,20.0,20.0
12587,1,2587,[ 88 546 238  56 483],151,4,10380,4.0108191653786704,0.0,0.0
12588,1,2588,[318  97 435  50 748],450,5,10385,4.011201235998455,20.0,20.0
12589,1,2589,[427  98  79 588 127],716,5,10390,4.011583011583012,20.0,20.0
12590,1,2590,[427  98  79 588 127],450,5,10395,4.011964492473949,20.0,20.0
12591,1,2591,[191 174 288 186 187],450,3,10398,4.011574074074074,0.0,0.0
12592,1,2592,[427  98  79 588 127],18,5,10403,4.011955264172773,20.0,20.0
12593,1,2593,[427  98  79 588 127],796,5,10408,4.012336160370085,20.0,20.0
12594,1,2594,[427  98  79 588 127],389,5,10413,4.0127167630057805,20.0,20.0
12595,1,2595,[  9 176  69 135 195],457,5,10418,4.013097072419106,0.0,0.0
12596,1,2596,[427  98  79 588 127],18,5,10423,4.013477088948787,20.0,20.0
12597,1,2597,[195 185 196 318 127],236,3,10426,4.013086989992302,20.0,20.0
12598,1,2598,[427  98  79 588 127],796,5,10431,4.013466717968449,20.0,20.0
12599,1,2599,[ 88 174 742 132 143],655,1,10432,4.012307692307692,0.0,0.0
12600,1,2600,[ 79  88 403 180 215],693,2,10434,4.011534025374856,0.0,0.0
12601,1,2601,[ 70 405 204  12 403],457,5,10439,4.011913912375096,0.0,0.0
12602,1,2602,[121 143  64 269 271],655,2,10441,4.011140991164042,20.0,0.0
12603,1,2603,[427  98  79 588 127],796,5,10446,4.011520737327189,20.0,20.0
12604,1,2604,[427  98  79 588 127],796,5,10451,4.0119001919385795,20.0,20.0
12605,1,2605,[300 111 496 597 117],796,5,10456,4.012279355333845,20.0,0.0
12606,1,2606,[125 216  95  89 211],18,3,10459,4.011891062523974,0.0,0.0
12607,1,2607,[56  7 98 79  1],535,1,10460,4.0107361963190185,0.0,0.0
12608,1,2608,[118  25 269 182  56],450,3,10463,4.010348792640858,0.0,0.0
12609,1,2609,[197 181  82 427 180],716,4,10467,4.010344827586207,20.0,0.0
12610,1,2610,[427  98  79 588 127],18,5,10472,4.010723860589812,20.0,20.0
12611,1,2611,[427  98  79 588 127],716,5,10477,4.011102603369066,20.0,20.0
12612,1,2612,[427  98  79 588 127],796,5,10482,4.011481056257176,20.0,20.0
12613,1,2613,[427  98  79 588 127],716,5,10487,4.01185921958684,20.0,20.0
12614,1,2614,[286 234 275 222 210],623,4,10491,4.0118546845124285,0.0,40.0
12615,1,2615,[427  98  79 588 127],389,5,10496,4.01223241590214,20.0,20.0
12616,1,2616,[245 151 179 258 235],450,4,10500,4.012227741688957,0.0,0.0
12617,1,2617,[427  98  79 588 127],796,5,10505,4.012605042016807,20.0,20.0
12618,1,2618,[427  98  79 588 127],450,5,10510,4.012982054219168,20.0,20.0
12619,1,2619,[427  98  79 588 127],450,5,10515,4.013358778625954,20.0,20.0
12620,1,2620,[  9 183 144 228 181],655,1,10516,4.012209080503625,0.0,0.0
12621,1,2621,[111 276 234 117 496],280,4,10520,4.012204424103738,20.0,0.0
12622,1,2622,[ 22 328 194 183  82],796,4,10524,4.012199771254289,0.0,0.0
12623,1,2623,[427  98  79 588 127],18,5,10529,4.012576219512195,20.0,20.0
12624,1,2624,[222 286 186 471 597],450,3,10532,4.012190476190476,0.0,20.0
12625,1,2625,[427  98  79 588 127],18,5,10537,4.012566641279513,20.0,20.0
12626,1,2626,[568 196 185 294  71],796,4,10541,4.012561857632281,0.0,0.0
12627,1,2627,[200  25  15 603 135],655,3,10544,4.012176560121766,20.0,0.0
12628,1,2628,[ 64 117 222 200 172],716,5,10549,4.01255230125523,20.0,0.0
12629,1,2629,[322 496 301 245 173],344,3,10552,4.012167300380228,20.0,0.0
12630,1,2630,[427  98  79 588 127],716,5,10557,4.0125427594070695,20.0,20.0
12631,1,2631,[215   7 194 234 181],450,4,10561,4.012537993920972,0.0,0.0
12632,1,2632,[427  98  79 588 127],796,5,10566,4.012913026965439,20.0,20.0
12633,1,2633,[427  98  79 588 127],716,5,10571,4.013287775246773,20.0,20.0
12634,1,2634,[ 79 603   7 100 238],421,4,10575,4.013282732447818,20.0,20.0
12635,1,2635,[475 405 282 237 265],655,0,10575,4.011760242792109,0.0,0.0
12636,1,2636,[427  98  79 588 127],716,5,10580,4.012135001896094,20.0,20.0
12637,1,2637,[238 132  97 237 187],18,4,10584,4.012130401819561,0.0,0.0
12638,1,2638,[427  98  79 588 127],389,5,10589,4.012504736642668,20.0,20.0
12639,1,2639,[173 121 496 191 357],450,4,10593,4.0125,20.0,0.0
12640,1,2640,[427  98  79 588 127],389,5,10598,4.012873911397198,20.0,20.0
12641,1,2641,[405 588 742 286 196],344,2,10600,4.012112036336109,0.0,20.0
12642,1,2642,[125 403 161 235 234],280,2,10602,4.011350737797957,0.0,0.0
12643,1,2643,[269   9 144 121 197],655,0,10602,4.00983358547655,0.0,0.0
12644,1,2644,[427  98  79 588 127],796,5,10607,4.010207939508507,20.0,20.0
12645,1,2645,[427  98  79 588 127],716,5,10612,4.01058201058201,20.0,20.0
12646,1,2646,[427  98  79 588 127],18,5,10617,4.010955799017756,20.0,20.0
12647,1,2647,[427  98  79 588 127],716,5,10622,4.011329305135952,20.0,20.0
12648,1,2648,[180 275 153 423   1],535,4,10626,4.011325028312571,0.0,20.0
12649,1,2649,[603 318 153 234  82],151,3,10629,4.010943396226415,40.0,0.0
12650,1,2650,[427  98  79 588 127],716,5,10634,4.01131648434553,20.0,20.0
12651,1,2651,[427  98  79 588 127],389,5,10639,4.011689291101056,20.0,20.0
12652,1,2652,[427  98  79 588 127],796,5,10644,4.0120618168111575,20.0,20.0
12653,1,2653,[ 15 423  89 286 181],796,4,10648,4.012057272042201,0.0,20.0
12654,1,2654,[427  98  79 588 127],450,5,10653,4.012429378531073,20.0,20.0
12655,1,2655,[ 98 427 175 385 475],655,2,10655,4.011671686746988,20.0,0.0
12656,1,2656,[  8 435 483 318  71],807,4,10659,4.011667293940534,20.0,0.0
12657,1,2657,[427  98  79 588 127],796,5,10664,4.0120391271632805,20.0,20.0
12658,1,2658,[194 301 318 191  98],11,4,10668,4.012034599473486,20.0,0.0
12659,1,2659,[427  79  98 588 127],716,5,10673,4.012406015037594,20.0,20.0
12660,1,2660,[ 56 286 195 185  98],796,4,10677,4.012401352874859,0.0,20.0
12661,1,2661,[655 603 174 194 265],72,5,10682,4.012772351615327,20.0,0.0
12662,1,2662,[471 180 403  69 294],457,4,10686,4.01276755538866,0.0,0.0
12663,1,2663,[427  79  98 588 127],796,5,10691,4.013138138138138,20.0,20.0
12664,1,2664,[427  79  98 588 127],796,5,10696,4.013508442776735,20.0,20.0
12665,1,2665,[427  79  98 588 127],796,5,10701,4.013878469617405,20.0,20.0
12666,1,2666,[173 234 100  82 117],786,4,10705,4.01387326584177,0.0,20.0
12667,1,2667,[427  79  98 588 127],796,5,10710,4.01424287856072,20.0,20.0
12668,1,2668,[742 183 151  79 195],796,4,10714,4.014237542150618,0.0,0.0
12669,1,2669,[300 183 191 194 117],716,4,10718,4.014232209737828,0.0,0.0
12670,1,2670,[191 294 323   8  28],796,2,10720,4.013478098090602,0.0,0.0
12671,1,2671,[  7  98 318 235 125],280,4,10724,4.013473053892215,20.0,0.0
12672,1,2672,[427  79  98 588 127],18,5,10729,4.013842124953236,20.0,20.0
12673,1,2673,[235 210 186 187 435],269,1,10730,4.012715033657442,0.0,0.0
12674,1,2674,[427  79  98 588 127],389,5,10735,4.013084112149532,20.0,20.0
12675,1,2675,[  8 318 235 143 168],269,2,10737,4.012331838565022,20.0,0.0
12676,1,2676,[143  89   7  56 111],269,1,10738,4.011206574523721,0.0,0.0
12677,1,2677,[427  79  98 588 127],450,5,10743,4.011575802837939,20.0,20.0
12678,1,2678,[228 265 204 496 182],450,5,10748,4.011944755505786,20.0,0.0
12679,1,2679,[427  79  98 588 127],796,5,10753,4.012313432835821,20.0,20.0
12680,1,2680,[483 144 603 385 186],796,4,10757,4.012308839985081,20.0,0.0
12681,1,2681,[245 182 135 333 275],629,4,10761,4.012304250559284,0.0,20.0
12682,1,2682,[427  79  98 588 127],716,5,10766,4.012672381662318,20.0,20.0
12683,1,2683,[427  79  98 588 127],796,5,10771,4.013040238450075,20.0,20.0
12684,1,2684,[427  79  98 588 127],389,5,10776,4.01340782122905,20.0,20.0
12685,1,2685,[121 403 294 385   7],457,4,10780,4.013402829486225,0.0,0.0
12686,1,2686,[ 15 118  69   8 496],796,5,10785,4.013770003721623,20.0,0.0
12687,1,2687,[427  79  98 588 127],716,5,10790,4.014136904761905,20.0,20.0
12688,1,2688,[172  50 427 168 100],535,4,10794,4.014131647452585,20.0,40.0
12689,1,2689,[181 483 151   9 265],457,5,10799,4.014498141263941,0.0,0.0
12690,1,2690,[427  79  98 588 127],716,5,10804,4.014864362690449,20.0,20.0
12691,1,2691,[427  79  98 588 127],18,5,10809,4.015230312035661,20.0,20.0
12692,1,2692,[427  79  98 588 127],796,5,10814,4.015595989602674,20.0,20.0
12693,1,2693,[ 25 179   4 194 204],264,5,10819,4.015961395694135,0.0,0.0
12694,1,2694,[ 97 294 286 191 318],224,4,10823,4.01595547309833,20.0,20.0
12695,1,2695,[  8 282 194 286 603],535,3,10826,4.015578635014837,20.0,20.0
12696,1,2696,[427  79  98 588 127],18,5,10831,4.015943641082685,20.0,20.0
12697,1,2697,[125 204 275 288 185],457,5,10836,4.016308376575241,0.0,20.0
12698,1,2698,[ 11  50 257 174  79],457,4,10840,4.016302334197851,0.0,20.0
12699,1,2699,[269 200 313 294 275],655,3,10843,4.015925925925926,0.0,20.0
12700,1,2700,[173 132  69  50 111],577,5,10848,4.016290262865605,0.0,20.0
12701,1,2701,[427  79  98 588 127],450,5,10853,4.016654330125832,20.0,20.0
12702,1,2702,[427  79  98 588 127],389,5,10858,4.017018128005919,20.0,20.0
12703,1,2703,[ 97 286 168   4 435],535,3,10861,4.016642011834319,0.0,20.0
12704,1,2704,[427  79  98 588 127],389,5,10866,4.017005545286507,20.0,20.0
12705,1,2705,[427  79  98 588 127],18,5,10871,4.017368810051737,20.0,20.0
12706,1,2706,[427  79  98 588 127],389,5,10876,4.01773180642778,20.0,20.0
12707,1,2707,[210 180 269 423 195],535,5,10881,4.018094534711965,0.0,0.0
12708,1,2708,[271 196 357 187 153],655,2,10883,4.01734957548911,0.0,0.0
12709,1,2709,[427  79  98 588 127],450,5,10888,4.017712177121771,20.0,20.0
12710,1,2710,[294 333 237 200 328],796,4,10892,4.017705643673921,0.0,0.0
12711,1,2711,[294 132  50 234 318],450,4,10896,4.017699115044247,20.0,20.0
12712,1,2712,[475  88  82 265 257],655,0,10896,4.016218208625138,0.0,0.0
12713,1,2713,[427  79  98 588 127],796,5,10901,4.016580692704495,20.0,20.0
12714,1,2714,[427  79  98 588 127],18,5,10906,4.016942909760589,20.0,20.0
12715,1,2715,[153 196   1  25 125],450,4,10910,4.016936671575847,0.0,0.0
12716,1,2716,[427  79  98 588 127],716,5,10915,4.017298490982702,20.0,20.0
12717,1,2717,[427  79  98 588 127],796,5,10920,4.0176600441501105,20.0,20.0
12718,1,2718,[257 117 515 215  56],716,5,10925,4.018021331371828,0.0,0.0
12719,1,2719,[357 273 185 111  64],796,4,10929,4.0180147058823525,20.0,0.0
12720,1,2720,[423   1  82 153  64],655,1,10930,4.016905549430357,20.0,0.0
12721,1,2721,[427  79  98 588 127],389,5,10935,4.0172667156502575,20.0,20.0
12722,1,2722,[427  79  98 588 127],450,5,10940,4.017627616599339,20.0,20.0
12723,1,2723,[427  79  98 588 127],716,5,10945,4.017988252569751,20.0,20.0
12724,1,2724,[427  79  98 588 127],18,5,10950,4.018348623853211,20.0,20.0
12725,1,2725,[427  79  98 588 127],450,5,10955,4.018708730741013,20.0,20.0
12726,1,2726,[151 211 135 185 275],389,4,10959,4.0187018701870185,0.0,20.0
12727,1,2727,[196 403  96 175 179],269,2,10961,4.017961876832844,0.0,0.0
12728,1,2728,[197 483 111   8 508],280,3,10964,4.017588860388421,0.0,0.0
12729,1,2729,[ 69 289 423   1 173],807,4,10968,4.0175824175824175,0.0,0.0
12730,1,2730,[427  79  98 588 127],796,5,10973,4.017942145734163,20.0,20.0
12731,1,2731,[187  15 318   4 603],450,3,10976,4.0175695461200585,40.0,0.0
12732,1,2732,[427  79  98 588 127],716,5,10981,4.0179290157336265,20.0,20.0
12733,1,2733,[216 238 173 318 603],11,3,10984,4.017556693489393,40.0,0.0
12734,1,2734,[300 435 568 161 294],716,4,10988,4.0175502742230345,0.0,0.0
12735,1,2735,[282  88 655 275  97],796,3,10991,4.017178362573099,0.0,20.0
12736,1,2736,[202 180 182 265 204],457,5,10996,4.017537449762513,0.0,0.0
12737,1,2737,[ 11 273 403 301  22],450,4,11000,4.017531044558072,0.0,0.0
12738,1,2738,[200 742  69 202 300],450,4,11004,4.017524644030668,0.0,0.0
12739,1,2739,[ 96 182  97 181  64],457,5,11009,4.017883211678832,20.0,0.0
12740,1,2740,[427  79  98 588 127],389,5,11014,4.018241517694272,20.0,20.0
12741,1,2741,[427  79  98 588 127],18,5,11019,4.018599562363239,20.0,20.0
12742,1,2742,[427  79  98 588 127],796,5,11024,4.018957345971564,20.0,20.0
12743,1,2743,[237  22 202 204 121],344,2,11026,4.0182215743440235,0.0,0.0
12744,1,2744,[427  79  98 588 127],450,5,11031,4.018579234972678,20.0,20.0
12745,1,2745,[427  79  98 588 127],389,5,11036,4.018936635105608,20.0,20.0
12746,1,2746,[111 174  96 186 234],655,0,11036,4.017473607571897,0.0,0.0
12747,1,2747,[423  79  50  89 288],457,5,11041,4.01783114992722,0.0,20.0
12748,1,2748,[  1   8 135 237  95],330,4,11045,4.017824663514005,0.0,0.0
12749,1,2749,[ 88  64 168  96 597],457,4,11049,4.017818181818182,20.0,0.0
12750,1,2750,[427  79  98 588 127],450,5,11054,4.018175209014903,20.0,20.0
12751,1,2751,[742 132 153   1 127],280,5,11059,4.018531976744186,0.0,20.0
12752,1,2752,[427  79  98 588 127],796,5,11064,4.018888485288776,20.0,20.0
12753,1,2753,[118 655 568 161 405],593,3,11067,4.018518518518518,0.0,0.0
12754,1,2754,[603 153 127   7 174],269,2,11069,4.017785843920145,20.0,20.0
12755,1,2755,[ 25  98 508 143  64],693,3,11072,4.017416545718432,20.0,0.0
12756,1,2756,[427  79  98 588 127],18,5,11077,4.017772941603192,20.0,20.0
12757,1,2757,[135 423 151  15  96],457,5,11082,4.018129079042785,0.0,0.0
12758,1,2758,[125 187 294 111  82],655,1,11083,4.017035157665821,0.0,0.0
12759,1,2759,[ 82 204  56 357 568],796,4,11087,4.017028985507246,0.0,0.0
12760,1,2760,[  8  28 405 194 235],23,3,11090,4.016660630206447,0.0,0.0
12761,1,2761,[257 265  96  71   9],796,4,11094,4.016654598117307,0.0,0.0
12762,1,2762,[427  79  98 588 127],450,5,11099,4.017010495837857,20.0,20.0
12763,1,2763,[322 238 195 222 202],796,3,11102,4.016642547033285,0.0,0.0
12764,1,2764,[427  79  98 588 127],450,5,11107,4.016998191681736,20.0,20.0
12765,1,2765,[427  79  98 588 127],450,5,11112,4.017353579175705,20.0,20.0
12766,1,2766,[427  79  98 588 127],796,5,11117,4.017708709794,20.0,20.0
12767,1,2767,[427  79  98 588 127],450,5,11122,4.018063583815029,20.0,20.0
12768,1,2768,[228 275 238 153  25],716,5,11127,4.018418201516793,0.0,20.0
12769,1,2769,[427  79  98 588 127],389,5,11132,4.018772563176896,20.0,20.0
12770,1,2770,[276 742   8 222 216],457,5,11137,4.019126669072537,0.0,0.0
12771,1,2771,[238 496 282 144 271],796,4,11141,4.0191197691197695,20.0,0.0
12772,1,2772,[300 318 237  69 185],450,5,11146,4.019473494410386,20.0,0.0
12773,1,2773,[  9 265 483 288 427],655,2,11148,4.018745493871665,20.0,0.0
12774,1,2774,[568  15 182  56 268],269,3,11151,4.018378378378379,0.0,0.0
12775,1,2775,[ 69 257 185  50 228],796,5,11156,4.018731988472623,0.0,20.0
12776,1,2776,[180  22 161 144  56],796,4,11160,4.018725243068059,0.0,0.0
12777,1,2777,[427  79  98 588 127],796,5,11165,4.019078473722102,20.0,20.0
12778,1,2778,[427  79  98 588 127],18,5,11170,4.019431450161929,20.0,20.0
12779,1,2779,[ 71 196 191 228  79],577,4,11174,4.0194244604316545,0.0,0.0
12780,1,2780,[568 173 423 187 322],450,5,11179,4.01977705861201,0.0,0.0
12781,1,2781,[ 97 174 127 176 238],796,3,11182,4.01941049604601,0.0,20.0
12782,1,2782,[196 151 257 161 202],716,4,11186,4.019403521379806,0.0,0.0
12783,1,2783,[ 15 153 405 117 151],330,5,11191,4.019755747126437,0.0,0.0
12784,1,2784,[257 515 172  70 132],716,5,11196,4.020107719928187,0.0,0.0
12785,1,2785,[427  79  98 588 127],389,5,11201,4.02045944005743,20.0,20.0
12786,1,2786,[168 161 173 282 235],450,4,11205,4.020452099031217,0.0,0.0
12787,1,2787,[117  69 183 100  79],593,5,11210,4.020803443328551,0.0,20.0
12788,1,2788,[508 200 127 195 294],655,2,11212,4.02007888131947,0.0,20.0
12789,1,2789,[427  79  98 588 127],389,5,11217,4.020430107526882,20.0,20.0
12790,1,2790,[ 88 182 403 333  96],655,1,11218,4.019347903977069,0.0,0.0
12791,1,2791,[427  79  98 588 127],18,5,11223,4.019699140401146,20.0,20.0
12792,1,2792,[427  79  98 588 127],389,5,11228,4.020050125313284,20.0,20.0
12793,1,2793,[204  70 132 197  96],504,3,11231,4.019685039370079,0.0,0.0
12794,1,2794,[282 144 215 195 313],280,0,11231,4.01824686940966,0.0,0.0
12795,1,2795,[427  79  98 588 127],389,5,11236,4.0185979971387695,20.0,20.0
12796,1,2796,[427  79  98 588 127],389,5,11241,4.01894887379335,20.0,20.0
12797,1,2797,[185 195  25 215  28],330,4,11245,4.0189421015010725,0.0,0.0
12798,1,2798,[427  79  98 588 127],796,5,11250,4.019292604501608,20.0,20.0
12799,1,2799,[237 435 135 153   9],655,1,11251,4.0182142857142855,0.0,0.0
12800,1,2800,[161 143 210 228 195],807,4,11255,4.018207782934666,0.0,0.0
12801,1,2801,[427  79  98 588 127],796,5,11260,4.018558172733762,20.0,20.0
12802,1,2802,[161 403 568 186 257],796,4,11264,4.018551551908669,0.0,0.0
12803,1,2803,[427  79  98 588 127],18,5,11269,4.018901569186876,20.0,20.0
12804,1,2804,[153 210  22 301 100],796,2,11271,4.0181818181818185,0.0,20.0
12805,1,2805,[282 275 228  15 515],296,4,11275,4.018175338560228,0.0,20.0
12806,1,2806,[132 202 215 588   4],344,4,11279,4.018168863555397,0.0,0.0
12807,1,2807,[588  82 182  56 194],18,3,11282,4.017806267806268,0.0,0.0
12808,1,2808,[427  79  98 588 127],18,5,11287,4.018155927376291,20.0,20.0
12809,1,2809,[427  79  98 588 127],716,5,11292,4.018505338078292,20.0,20.0
12810,1,2810,[427  79  98 588 127],389,5,11297,4.018854500177873,20.0,20.0
12811,1,2811,[427  79  98 588 127],450,5,11302,4.019203413940256,20.0,20.0
12812,1,2812,[568 161 318  97 100],457,5,11307,4.019552079630288,20.0,20.0
12813,1,2813,[427  79  98 588 127],796,5,11312,4.019900497512438,20.0,20.0
12814,1,2814,[427  79  98 588 127],389,5,11317,4.020248667850799,20.0,20.0
12815,1,2815,[427  79  98 588 127],18,5,11322,4.020596590909091,20.0,20.0
12816,1,2816,[427  79  98 588 127],18,5,11327,4.020944266950656,20.0,20.0
12817,1,2817,[ 15 183 300 286 318],655,2,11329,4.020227111426544,20.0,20.0
12818,1,2818,[427  79  98 588 127],796,5,11334,4.020574671869457,20.0,20.0
12819,1,2819,[258 300 301  88 742],450,5,11339,4.020921985815603,0.0,0.0
12820,1,2820,[125  64 195 183 568],796,5,11344,4.021269053527118,20.0,0.0
12821,1,2821,[546  69 282 245 180],280,3,11347,4.020907158043941,0.0,0.0
12822,1,2822,[100 385 204 176 117],504,3,11350,4.0205455189514705,0.0,20.0
12823,1,2823,[135   7  82 121 276],655,2,11352,4.019830028328612,0.0,0.0
12824,1,2824,[ 64 143 111  15 216],389,1,11353,4.018761061946902,20.0,0.0
12825,1,2825,[ 28 176   4 161 125],655,0,11353,4.017338995046002,0.0,0.0
12826,1,2826,[ 56  88  15 313 143],236,4,11357,4.017332861690838,0.0,0.0
12827,1,2827,[427  79  98 588 127],716,5,11362,4.017680339462518,20.0,20.0
12828,1,2828,[111 403 423  22 144],796,5,11367,4.018027571580063,0.0,0.0
12829,1,2829,[427  79  98 588 127],18,5,11372,4.018374558303887,20.0,20.0
12830,1,2830,[183 435 269 403 117],655,1,11373,4.017308371600142,0.0,0.0
12831,1,2831,[427  79  98 588 127],796,5,11378,4.017655367231638,20.0,20.0
12832,1,2832,[427  79  98 588 127],18,5,11383,4.0180021178962235,20.0,20.0
12833,1,2833,[179 143 210 181 234],269,1,11384,4.016937191249117,0.0,0.0
12834,1,2834,[318  95 228  70 286],330,5,11389,4.017283950617284,20.0,20.0
12835,1,2835,[427  79  98 588 127],18,5,11394,4.017630465444288,20.0,20.0
12836,1,2836,[  7   9 174 322 265],280,4,11398,4.017624250969334,0.0,0.0
12837,1,2837,[427  79  98 588 127],18,5,11403,4.017970401691332,20.0,20.0
12838,1,2838,[286 125 423 132 215],152,5,11408,4.018316308559352,0.0,20.0
12839,1,2839,[258 132 127 568 135],693,5,11413,4.018661971830986,0.0,20.0
12840,1,2840,[ 64 118  70   4 176],716,2,11415,4.017951425554382,20.0,0.0
12841,1,2841,[174 194 118 603  95],716,4,11419,4.017945109078114,20.0,0.0
12842,1,2842,[200 282 210 121 215],457,5,11424,4.018290538163911,0.0,0.0
12843,1,2843,[179 597 215 234 143],457,4,11428,4.018284106891702,0.0,0.0
12844,1,2844,[427  79  98 588 127],18,5,11433,4.0186291739894555,20.0,20.0
12845,1,2845,[204  50 172 318  88],593,5,11438,4.018973998594519,20.0,20.0
12846,1,2846,[427  79  98 588 127],716,5,11443,4.019318580962417,20.0,20.0
12847,1,2847,[427  79  98 588 127],450,5,11448,4.019662921348314,20.0,20.0
12848,1,2848,[172 237 194   9 183],269,2,11450,4.018954018954019,0.0,0.0
12849,1,2849,[427  79  98 588 127],450,5,11455,4.019298245614035,20.0,20.0
12850,1,2850,[427  79  98 588 127],716,5,11460,4.019642230796212,20.0,20.0
12851,1,2851,[  9 179 568 235 508],269,3,11463,4.019284712482468,0.0,0.0
12852,1,2852,[196  96 237 483 186],716,3,11466,4.018927444794953,0.0,0.0
12853,1,2853,[427  79  98 588 127],450,5,11471,4.01927119831815,20.0,20.0
12854,1,2854,[286 234 546 125 151],450,4,11475,4.019264448336252,0.0,20.0
12855,1,2855,[427  79  98 588 127],18,5,11480,4.019607843137255,20.0,20.0
12856,1,2856,[357  82 496 111 273],450,3,11483,4.019250962548127,20.0,0.0
12857,1,2857,[427  79  98 588 127],450,5,11488,4.019594121763471,20.0,20.0
12858,1,2858,[427  79  98 588 127],796,5,11493,4.019937040923399,20.0,20.0
12859,1,2859,[427  79  98 588 127],716,5,11498,4.020279720279721,20.0,20.0
12860,1,2860,[211 172 237 268  12],655,1,11499,4.019224047535826,0.0,0.0
12861,1,2861,[427  79  98 588 127],389,5,11504,4.019566736547868,20.0,20.0
12862,1,2862,[427  79  98 588 127],450,5,11509,4.019909186168355,20.0,20.0
12863,1,2863,[302   4  56 117 655],655,1,11510,4.018854748603352,0.0,0.0
12864,1,2864,[121 153 173 357   4],796,5,11515,4.019197207678883,0.0,0.0
12865,1,2865,[187 318 333 483 135],693,2,11517,4.018492672714585,20.0,0.0
12866,1,2866,[427  79  98 588 127],389,5,11522,4.018835019183816,20.0,20.0
12867,1,2867,[182 186 127 183  96],796,4,11526,4.018828451882845,0.0,20.0
12868,1,2868,[427  79  98 588 127],716,5,11531,4.019170442662949,20.0,20.0
12869,1,2869,[197 127 322 678  98],504,5,11536,4.019512195121951,0.0,20.0
12870,1,2870,[ 95 100  71  56 183],796,4,11540,4.019505398815744,0.0,20.0
12871,1,2871,[238  88 483 127 179],655,3,11543,4.019150417827298,0.0,20.0
12872,1,2872,[427  79  98 588 127],18,5,11548,4.019491820396798,20.0,20.0
12873,1,2873,[427  79  98 588 127],18,5,11553,4.019832985386222,20.0,20.0
12874,1,2874,[427  79  98 588 127],18,5,11558,4.020173913043478,20.0,20.0
12875,1,2875,[204 151 181  56 185],18,1,11559,4.019123783031989,0.0,0.0
12876,1,2876,[427  79  98 588 127],796,5,11564,4.019464720194647,20.0,20.0
12877,1,2877,[427  79  98 588 127],18,5,11569,4.019805420430854,20.0,20.0
12878,1,2878,[427  79  98 588 127],18,5,11574,4.020145883987496,20.0,20.0
12879,1,2879,[313 196 117 187  56],450,5,11579,4.020486111111111,0.0,0.0
12880,1,2880,[427  79  98 588 127],716,5,11584,4.0208261020479,20.0,20.0
12881,1,2881,[175  98 180 151  89],457,5,11589,4.021165857043719,0.0,0.0
12882,1,2882,[144 132  88 655  82],796,3,11592,4.020811654526534,0.0,0.0
12883,1,2883,[  9 427 211 127 200],18,4,11596,4.020804438280167,20.0,20.0
12884,1,2884,[427  79  98 588 127],389,5,11601,4.021143847487002,20.0,20.0
12885,1,2885,[202 496 161 111 173],389,2,11603,4.0204435204435205,20.0,0.0
12886,1,2886,[427  79  98 588 127],18,5,11608,4.02078281953585,20.0,20.0
12887,1,2887,[427  79  98 588 127],389,5,11613,4.02112188365651,20.0,20.0
12888,1,2888,[111 175 496   4 237],18,2,11615,4.020422291450329,20.0,0.0
12889,1,2889,[427  79  98 588 127],450,5,11620,4.02076124567474,20.0,20.0
12890,1,2890,[427  79  98 588 127],18,5,11625,4.021099965409893,20.0,20.0
12891,1,2891,[  1 276 121 496 385],344,2,11627,4.0204011065006915,20.0,0.0
12892,1,2892,[132 191   7 294 135],629,2,11629,4.019702730729347,0.0,0.0
12893,1,2893,[234 655 294  79  97],796,1,11630,4.018659295093297,0.0,0.0
12894,1,2894,[427  79  98 588 127],389,5,11635,4.018998272884283,20.0,20.0
12895,1,2895,[ 95  69  71 172 174],796,5,11640,4.019337016574585,0.0,0.0
12896,1,2896,[323 265 282 597 172],256,3,11643,4.018985157059027,0.0,0.0
12897,1,2897,[127 143  89 100 268],655,3,11646,4.0186335403726705,0.0,40.0
12898,1,2898,[508 222 403 111 313],280,1,11647,4.017592273197654,0.0,0.0
12899,1,2899,[  1 100 174  69 181],593,4,11651,4.017586206896552,0.0,20.0
12900,1,2900,[216  97 238 275 546],593,3,11654,4.0172354360565325,0.0,20.0
12901,1,2901,[174 200 211 216   7],786,5,11659,4.017574086836665,0.0,0.0
12902,1,2902,[ 71 180  82 603 294],796,2,11661,4.0168790905959355,20.0,0.0
12903,1,2903,[  4 127 132  15 216],450,3,11664,4.016528925619835,0.0,20.0
12904,1,2904,[427  79  98 588 127],796,5,11669,4.016867469879518,20.0,20.0
12905,1,2905,[  1 328 125 176 191],450,5,11674,4.017205781142464,0.0,0.0
12906,1,2906,[153 196 132 238  88],269,2,11676,4.016511867905057,0.0,0.0
12907,1,2907,[427  79  98 588 127],450,5,11681,4.016850068775791,20.0,20.0
12908,1,2908,[427 179 313 143 357],655,5,11686,4.01718803712616,20.0,0.0
12909,1,2909,[427  79  98 588 127],796,5,11691,4.017525773195876,20.0,20.0
12910,1,2910,[427  79  98 588 127],18,5,11696,4.017863277224322,20.0,20.0
12911,1,2911,[427  79  98 588 127],796,5,11701,4.018200549450549,20.0,20.0
12912,1,2912,[597  97 655 196 546],450,5,11706,4.018537590113286,0.0,0.0
12913,1,2913,[427  79  98 588 127],450,5,11711,4.018874399450927,20.0,20.0
12914,1,2914,[427  79  98 588 127],716,5,11716,4.019210977701544,20.0,20.0
12915,1,2915,[323 100 322 202 655],796,1,11717,4.018175582990398,0.0,20.0
12916,1,2916,[427  79  98 588 127],389,5,11722,4.0185121700377096,20.0,20.0
12917,1,2917,[286 597 301 151   4],450,4,11726,4.018505825908156,0.0,20.0
12918,1,2918,[427  79  98 588 127],18,5,11731,4.018842069201781,20.0,20.0
12919,1,2919,[427  79  98 588 127],450,5,11736,4.019178082191781,20.0,20.0
12920,1,2920,[269 234 187  64 258],796,3,11739,4.018829168093119,20.0,0.0
12921,1,2921,[423 210 215 318  28],457,5,11744,4.0191649555099245,20.0,0.0
12922,1,2922,[ 56 588 222 228 302],450,4,11748,4.019158398905234,0.0,0.0
12923,1,2923,[427  79  98 588 127],450,5,11753,4.019493844049248,20.0,20.0
12924,1,2924,[237 125 132 173   7],450,5,11758,4.01982905982906,0.0,0.0
12925,1,2925,[117 127 289 228 118],807,4,11762,4.0198222829801775,0.0,20.0
12926,1,2926,[210  15 403 423 174],330,5,11767,4.0201571574991455,0.0,0.0
12927,1,2927,[496 403 286 288 275],450,4,11771,4.0201502732240435,20.0,40.0
12928,1,2928,[597 313 222 132  95],450,3,11774,4.01980198019802,0.0,0.0
12929,1,2929,[427  79  98 588 127],18,5,11779,4.020136518771331,20.0,20.0
12930,1,2930,[405 204 172 186 742],450,4,11783,4.020129648584101,0.0,0.0
12931,1,2931,[196  70 195 118 405],450,4,11787,4.020122783083219,0.0,0.0
12932,1,2932,[427  79  98 588 127],796,5,11792,4.020456870098875,20.0,20.0
12933,1,2933,[427 144 603  64 245],796,4,11796,4.020449897750511,60.0,0.0
12934,1,2934,[237 678 286 235 204],401,1,11797,4.019420783645656,0.0,20.0
12935,1,2935,[195 191 144  56  28],457,5,11802,4.019754768392371,0.0,0.0
12936,1,2936,[216 276 181  22 568],457,5,11807,4.0200885257065035,0.0,0.0
12937,1,2937,[ 88 200 216  50  70],280,3,11810,4.019741320626276,0.0,20.0
12938,1,2938,[427  79  98 588 127],18,5,11815,4.020074855392991,20.0,20.0
12939,1,2939,[427  79  98 588 127],389,5,11820,4.020408163265306,20.0,20.0
12940,1,2940,[427  79  98 588 127],18,5,11825,4.020741244474668,20.0,20.0
12941,1,2941,[216 204 153 405 173],401,2,11827,4.020054384772264,0.0,0.0
12942,1,2942,[111  15 210 202  97],457,4,11831,4.020047570506286,0.0,0.0
12943,1,2943,[100 271 222 234  22],655,0,11831,4.018682065217392,0.0,20.0
12944,1,2944,[427  79  98 588 127],18,5,11836,4.019015280135823,20.0,20.0
12945,1,2945,[427  79  98 588 127],389,5,11841,4.019348268839104,20.0,20.0
12946,1,2946,[ 28  11 132  95 238],450,4,11845,4.019341703427214,0.0,0.0
12947,1,2947,[ 69 121  25 183 174],344,3,11848,4.01899592944369,0.0,0.0
12948,1,2948,[427  79  98 588 127],18,5,11853,4.019328585961343,20.0,20.0
12949,1,2949,[186 144 204 197 182],655,1,11854,4.018305084745763,0.0,0.0
12950,1,2950,[597 235 228  69 238],450,4,11858,4.018298881735005,0.0,0.0
12951,1,2951,[182 187 385 546 216],256,4,11862,4.0182926829268295,0.0,0.0
12952,1,2952,[  8 271 546  95  89],796,5,11867,4.018625126989503,0.0,0.0
12953,1,2953,[427  79  98 588 127],18,5,11872,4.018957345971564,20.0,20.0
12954,1,2954,[ 15 202 179  50 357],269,2,11874,4.018274111675127,0.0,20.0
12955,1,2955,[202  97  28 216 186],457,5,11879,4.0186062246278755,0.0,0.0
12956,1,2956,[234   8  28 202 435],18,2,11881,4.017923571187014,0.0,0.0
12957,1,2957,[427  79  98 588 127],450,5,11886,4.0182555780933065,20.0,20.0
12958,1,2958,[ 64 288 172 196 174],450,4,11890,4.018249408583981,20.0,0.0
12959,1,2959,[427  79  98 588 127],716,5,11895,4.018581081081081,20.0,20.0
12960,1,2960,[427  79  98 588 127],18,5,11900,4.0189125295508275,20.0,20.0
12961,1,2961,[427  79  98 588 127],796,5,11905,4.019243754220121,20.0,20.0
12962,1,2962,[222 175 275  25 196],151,5,11910,4.019574755315559,0.0,20.0
12963,1,2963,[427  79  98 588 127],450,5,11915,4.019905533063428,20.0,20.0
12964,1,2964,[427  79  98 588 127],716,5,11920,4.020236087689713,20.0,20.0
12965,1,2965,[ 56 111 265 748 435],151,4,11924,4.020229265003372,0.0,0.0
12966,1,2966,[121 100  69 427 135],72,4,11928,4.020222446916077,20.0,20.0
12967,1,2967,[603  25 125 302 237],450,4,11932,4.020215633423181,20.0,0.0
12968,1,2968,[100  11  22 153   8],269,1,11933,4.019198383294039,0.0,20.0
12969,1,2969,[144 117 183 187 237],796,5,11938,4.01952861952862,0.0,0.0
12970,1,2970,[427  79  98 588 127],450,5,11943,4.0198586334567485,20.0,20.0
12971,1,2971,[222  25 234 228 483],450,1,11944,4.018842530282638,0.0,0.0
12972,1,2972,[427  79  98 588 127],389,5,11949,4.019172552976791,20.0,20.0
12973,1,2973,[427  79  98 588 127],716,5,11954,4.019502353732347,20.0,20.0
12974,1,2974,[427  79  98 588 127],389,5,11959,4.019831932773109,20.0,20.0
12975,1,2975,[427  79  98 588 127],389,5,11964,4.020161290322581,20.0,20.0
12976,1,2976,[427  79  98 588 127],18,5,11969,4.020490426603963,20.0,20.0
12977,1,2977,[403 286 328 222 135],224,3,11972,4.020147750167898,0.0,20.0
12978,1,2978,[427  79  98 588 127],716,5,11977,4.0204766700234975,20.0,20.0
12979,1,2979,[183 597 117 196 403],796,5,11982,4.020805369127517,0.0,0.0
12980,1,2980,[333 200 265  56 179],236,1,11983,4.019792016101979,0.0,0.0
12981,1,2981,[194 216   9 168 125],401,2,11985,4.019114688128773,0.0,0.0
12982,1,2982,[427  79  98 588 127],716,5,11990,4.019443513241703,20.0,20.0
12983,1,2983,[237 125  69 182 427],655,2,11992,4.018766756032171,20.0,0.0
12984,1,2984,[427  79  98 588 127],796,5,11997,4.0190954773869345,20.0,20.0
12985,1,2985,[ 97 301 258 265  56],535,3,12000,4.018754186202277,0.0,0.0
12986,1,2986,[427  79  98 588 127],389,5,12005,4.019082691663876,20.0,20.0
12987,1,2987,[153   7 318 234 282],280,3,12008,4.018741633199465,20.0,0.0
12988,1,2988,[185  25 318 475 275],503,4,12012,4.018735362997658,20.0,20.0
12989,1,2989,[427  79  98 588 127],796,5,12017,4.019063545150502,20.0,20.0
12990,1,2990,[194 100 286 288 301],629,4,12021,4.019057171514544,0.0,40.0
12991,1,2991,[ 98 423  79  25 546],503,5,12026,4.019385026737968,0.0,0.0
12992,1,2992,[151 183 403   9 322],796,3,12029,4.019044437019713,0.0,0.0
12993,1,2993,[427  79  98 588 127],18,5,12034,4.01937207748831,20.0,20.0
12994,1,2994,[194 423 117 211 322],504,4,12038,4.019365609348915,0.0,0.0
12995,1,2995,[ 96 265  22  28 202],457,5,12043,4.019692923898531,0.0,0.0
12996,1,2996,[427  79  98 588 127],796,5,12048,4.02002002002002,20.0,20.0
12997,1,2997,[194   4 196  22   7],577,4,12052,4.020013342228152,0.0,0.0
12998,1,2998,[301 173 427   8  56],796,4,12056,4.02000666888963,20.0,0.0
12999,1,2999,[427  79  98 588 127],450,5,12061,4.020333333333333,20.0,20.0
13000,1,3000,[427  79  98 588 127],18,5,12066,4.020659780073309,20.0,20.0
13001,1,3001,[202 174 655 179 234],786,4,12070,4.020652898067954,0.0,0.0
13002,1,3002,[127  96 276  22 216],256,4,12074,4.020646020646021,0.0,20.0
13003,1,3003,[427  79  98 588 127],389,5,12079,4.020972037283622,20.0,20.0
13004,1,3004,[427  79  98 588 127],389,5,12084,4.021297836938436,20.0,20.0
13005,1,3005,[ 28 153 597 271 357],796,4,12088,4.021290751829674,0.0,0.0
13006,1,3006,[ 56 151 132  69 357],504,4,12092,4.021283671433323,0.0,0.0
13007,1,3007,[427  79  98 588 127],450,5,12097,4.021609042553192,20.0,20.0
13008,1,3008,[186 176 187 268  97],655,1,12098,4.020604852110336,0.0,0.0
13009,1,3009,[427  79  98 588 127],389,5,12103,4.02093023255814,20.0,20.0
13010,1,3010,[427  79  98 588 127],716,5,12108,4.0212553968781135,20.0,20.0
13011,1,3011,[257 121 195 179  89],655,2,12110,4.02058432934927,0.0,0.0
13012,1,3012,[427 161 323  95 294],796,3,12113,4.020245602389645,20.0,0.0
13013,1,3013,[ 64 222 204 234  25],450,2,12115,4.019575315195753,20.0,0.0
13014,1,3014,[427  79  98 588 127],450,5,12120,4.019900497512438,20.0,20.0
13015,1,3015,[ 15  69 483   1 111],389,3,12123,4.019562334217507,0.0,0.0
13016,1,3016,[257 265   4  22 294],716,4,12127,4.0195558501823,0.0,0.0
13017,1,3017,[181   7  11 216  71],450,4,12131,4.019549370444003,0.0,0.0
13018,1,3018,[318  28 289 286 135],236,4,12135,4.019542894998343,20.0,20.0
13019,1,3019,[172 175 185 603 215],716,4,12139,4.01953642384106,20.0,0.0
13020,1,3020,[168 204 176 228 269],796,4,12143,4.019529956967891,0.0,0.0
13021,1,3021,[427  79  98 588 127],450,5,12148,4.019854401058901,20.0,20.0
13022,1,3022,[427  79  98 588 127],450,5,12153,4.020178630499504,20.0,20.0
13023,1,3023,[  9 127 286 210  88],18,4,12157,4.020171957671957,0.0,40.0
13024,1,3024,[187 742 202  88 234],504,1,12158,4.019173553719008,0.0,0.0
13025,1,3025,[427  79  98 588 127],450,5,12163,4.019497686715136,20.0,20.0
13026,1,3026,[427  79  98 588 127],450,5,12168,4.0198216055500495,20.0,20.0
13027,1,3027,[ 82 546  95 471 118],716,2,12170,4.019154557463672,0.0,0.0
13028,1,3028,[294 181 257 161 100],457,3,12173,4.018818091779465,0.0,20.0
13029,1,3029,[427  79  98 588 127],389,5,12178,4.019141914191419,20.0,20.0
13030,1,3030,[427  79  98 588 127],796,5,12183,4.0194655229297265,20.0,20.0
13031,1,3031,[427  79  98 588 127],389,5,12188,4.019788918205805,20.0,20.0
13032,1,3032,[427  79  98 588 127],716,5,12193,4.0201121002307945,20.0,20.0
13033,1,3033,[427  79  98 588 127],18,5,12198,4.020435069215557,20.0,20.0
13034,1,3034,[427  79  98 588 127],716,5,12203,4.0207578253706755,20.0,20.0
13035,1,3035,[427  79  98 588 127],389,5,12208,4.021080368906456,20.0,20.0
13036,1,3036,[423  56 496  88 357],151,5,12213,4.021402700032927,20.0,0.0
13037,1,3037,[427  79  98 588 127],796,5,12218,4.021724818959842,20.0,20.0
13038,1,3038,[238 318 181  25 180],504,3,12221,4.02138861467588,20.0,0.0
13039,1,3039,[ 69  97 202 475 742],655,0,12221,4.020065789473684,0.0,0.0
13040,1,3040,[427  79  98 588 127],450,5,12226,4.020388030253206,20.0,20.0
13041,1,3041,[427  79  98 588 127],450,5,12231,4.020710059171598,20.0,20.0
13042,1,3042,[210 234 153 385 196],655,0,12231,4.019388761091029,0.0,0.0
13043,1,3043,[427  79  98 588 127],450,5,12236,4.019710906701708,20.0,20.0
13044,1,3044,[427  79  98 588 127],796,5,12241,4.020032840722496,20.0,20.0
13045,1,3045,[194   9 127  69 515],72,5,12246,4.020354563361786,0.0,20.0
13046,1,3046,[210  96 204 234 403],450,3,12249,4.020019691499836,0.0,0.0
13047,1,3047,[427  79  98 588 127],18,5,12254,4.020341207349081,20.0,20.0
13048,1,3048,[222   4 211 100 180],796,2,12256,4.019678583142014,0.0,20.0
13049,1,3049,[427  79  98 588 127],796,5,12261,4.02,20.0,20.0
13050,1,3050,[ 96 210 187 245 174],256,4,12265,4.019993444772206,0.0,0.0
13051,1,3051,[568 121 405 117 515],72,3,12268,4.019659239842726,0.0,0.0
13052,1,3052,[191  79 318 176  22],577,5,12273,4.019980347199476,20.0,0.0
13053,1,3053,[427  79  98 588 127],389,5,12278,4.0203012442698105,20.0,20.0
13054,1,3054,[195 655  70 471 276],457,5,12283,4.020621931260229,0.0,0.0
13055,1,3055,[427  79  98 588 127],796,5,12288,4.020942408376963,20.0,20.0
13056,1,3056,[  1 216 496 282 211],593,4,12292,4.020935557736343,20.0,0.0
13057,1,3057,[187  70 181 194 546],450,5,12297,4.021255722694572,0.0,0.0
13058,1,3058,[427  79  98 588 127],389,5,12302,4.021575678326251,20.0,20.0
13059,1,3059,[117 357 385  56  82],716,4,12306,4.02156862745098,0.0,0.0
13060,1,3060,[ 69  89  96  97 121],796,4,12310,4.02156158118262,0.0,0.0
13061,1,3061,[427  79  98 588 127],18,5,12315,4.021881123448726,20.0,20.0
13062,1,3062,[427  79  98 588 127],389,5,12320,4.022200457068234,20.0,20.0
13063,1,3063,[427  79  98 588 127],796,5,12325,4.0225195822454305,20.0,20.0
13064,1,3064,[427  79  98 588 127],18,5,12330,4.022838499184339,20.0,20.0
13065,1,3065,[118 245  98 276   4],593,3,12333,4.022504892367906,0.0,0.0
13066,1,3066,[427  79  98 588 127],389,5,12338,4.022823606129768,20.0,20.0
13067,1,3067,[176 153 546 175 173],23,3,12341,4.022490221642764,0.0,0.0
13068,1,3068,[118 121 238 215 182],655,1,12342,4.021505376344086,0.0,0.0
13069,1,3069,[  7 204 588 508 403],280,2,12344,4.020846905537459,0.0,0.0
13070,1,3070,[427  79  98 588 127],716,5,12349,4.021165744057311,20.0,20.0
13071,1,3071,[ 50 568 471  56 194],577,2,12351,4.0205078125,0.0,20.0
13072,1,3072,[427  79  98 588 127],18,5,12356,4.020826553856167,20.0,20.0
13073,1,3073,[269 483 168 228 118],450,3,12359,4.020494469746259,0.0,0.0
13074,1,3074,[172  71 118  50 176],280,1,12360,4.019512195121951,0.0,20.0
13075,1,3075,[427  79  98 588 127],716,5,12365,4.019830949284786,20.0,20.0
13076,1,3076,[427  79  98 588 127],450,5,12370,4.020149496262594,20.0,20.0
13077,1,3077,[194  69 496 655 125],731,3,12373,4.019818063677713,20.0,0.0
13078,1,3078,[427 328 181  70 186],151,4,12377,4.019811627151673,20.0,0.0
13079,1,3079,[182 222 197 403 216],280,1,12378,4.018831168831169,0.0,0.0
13080,1,3080,[173  96 100 191 204],457,5,12383,4.019149626744563,0.0,20.0
13081,1,3081,[ 82 235 202 546 121],716,3,12386,4.018818948734588,0.0,0.0
13082,1,3082,[427  79  98 588 127],450,5,12391,4.019137204022057,20.0,20.0
13083,1,3083,[427  79  98 588 127],796,5,12396,4.019455252918288,20.0,20.0
13084,1,3084,[144  50 496 234 313],593,4,12400,4.019448946515397,20.0,20.0
13085,1,3085,[328 568 234 121 186],796,3,12403,4.019118600129618,0.0,0.0
13086,1,3086,[318 568  82 191  50],457,5,12408,4.019436345966958,20.0,20.0
13087,1,3087,[427  79  98 588 127],796,5,12413,4.0197538860103625,20.0,20.0
13088,1,3088,[427  79  98 588 127],389,5,12418,4.020071220459696,20.0,20.0
13089,1,3089,[427  79  98 588 127],796,5,12423,4.020388349514563,20.0,20.0
13090,1,3090,[427  79  98 588 127],716,5,12428,4.020705273374313,20.0,20.0
13091,1,3091,[427  79  98 588 127],716,5,12433,4.021021992238033,20.0,20.0
13092,1,3092,[427  79  98 588 127],18,5,12438,4.021338506304558,20.0,20.0
13093,1,3093,[ 89 132 238 603 168],796,4,12442,4.021331609566904,20.0,0.0
13094,1,3094,[176 191 100 237 603],796,4,12446,4.021324717285945,20.0,20.0
13095,1,3095,[427  79  98 588 127],796,5,12451,4.021640826873385,20.0,20.0
13096,1,3096,[181 174  50 202 125],504,2,12453,4.020988052954472,0.0,20.0
13097,1,3097,[427  79  98 588 127],716,5,12458,4.021304067140091,20.0,20.0
13098,1,3098,[ 28  96  82 161 294],577,5,12463,4.0216198773798,0.0,0.0
13099,1,3099,[222   1 265 288 216],450,3,12466,4.021290322580645,0.0,0.0
13100,1,3100,[427  79  98 588 127],716,5,12471,4.021605933569816,20.0,20.0
13101,1,3101,[300 186 273 195 471],450,3,12474,4.0212765957446805,0.0,0.0
13102,1,3102,[ 95 237 202 471  12],577,4,12478,4.021269738962294,0.0,0.0
13103,1,3103,[237 275 204 276   7],344,4,12482,4.021262886597938,0.0,20.0
13104,1,3104,[427  79  98 588 127],716,5,12487,4.021578099838969,20.0,20.0
13105,1,3105,[427  79  98 588 127],389,5,12492,4.021893110109466,20.0,20.0
13106,1,3106,[427  79  98 588 127],389,5,12497,4.0222079176054075,20.0,20.0
13107,1,3107,[161 275   9  97 100],786,5,12502,4.0225225225225225,0.0,40.0
13108,1,3108,[168  79 135   7 328],151,4,12506,4.0225152782245095,0.0,0.0
13109,1,3109,[427  79  98 588 127],796,5,12511,4.0228295819935695,20.0,20.0
13110,1,3110,[  8 173  96 143 496],577,4,12515,4.022822243651559,20.0,0.0
13111,1,3111,[427  79  98 588 127],389,5,12520,4.023136246786632,20.0,20.0
13112,1,3112,[132 161 100 483 597],796,4,12524,4.023128814648249,0.0,20.0
13113,1,3113,[234 161 423 318  50],693,1,12525,4.0221579961464355,20.0,20.0
13114,1,3114,[427  79  98 588 127],389,5,12530,4.022471910112359,20.0,20.0
13115,1,3115,[ 12 179 117  28  82],577,4,12534,4.022464698331194,0.0,0.0
13116,1,3116,[174  89 483 496   8],796,5,12539,4.022778312479948,20.0,0.0
13117,1,3117,[186  11 215  25 196],577,4,12543,4.022771007055805,0.0,0.0
13118,1,3118,[427  79  98 588 127],18,5,12548,4.023084321898044,20.0,20.0
13119,1,3119,[ 25 357 161 568 588],330,5,12553,4.023397435897436,0.0,0.0
13120,1,3120,[427  79  98 588 127],18,5,12558,4.023710349247036,20.0,20.0
13121,1,3121,[210 423 357 471 181],457,5,12563,4.024023062139654,0.0,0.0
13122,1,3122,[515 183 132  64  70],269,3,12566,4.02369516490554,20.0,0.0
13123,1,3123,[427  79  98 588 127],450,5,12571,4.024007682458387,20.0,20.0
13124,1,3124,[427  79  98 588 127],389,5,12576,4.02432,20.0,20.0
13125,1,3125,[655 496 282 294 180],796,2,12578,4.023672424824056,20.0,0.0
13126,1,3126,[427  79  98 588 127],18,5,12583,4.023984649824112,20.0,20.0
13127,1,3127,[ 28   9 111 135  50],236,3,12586,4.023657289002558,0.0,20.0
13128,1,3128,[427  79  98 588 127],18,5,12591,4.023969319271333,20.0,20.0
13129,1,3129,[427  79  98 588 127],18,5,12596,4.024281150159744,20.0,20.0
13130,1,3130,[427  79  98 588 127],716,5,12601,4.024592781858831,20.0,20.0
13131,1,3131,[427  79  98 588 127],389,5,12606,4.024904214559387,20.0,20.0
13132,1,3132,[427  79  98 588 127],389,5,12611,4.025215448451963,20.0,20.0
13133,1,3133,[427  79  98 588 127],389,5,12616,4.025526483726867,20.0,20.0
13134,1,3134,[111  97 210 215  88],716,5,12621,4.025837320574163,0.0,0.0
13135,1,3135,[427  79  98 588 127],796,5,12626,4.026147959183674,20.0,20.0
13136,1,3136,[427  79  98 588 127],796,5,12631,4.026458399744979,20.0,20.0
13137,1,3137,[182 268  96 118   7],655,1,12632,4.025493945188018,0.0,0.0
13138,1,3138,[175 435 172 403 179],18,3,12635,4.025167250716788,0.0,0.0
13139,1,3139,[427  79  98 588 127],389,5,12640,4.025477707006369,20.0,20.0
13140,1,3140,[318 183 100  88 234],786,4,12644,4.0254695956701685,20.0,20.0
13141,1,3141,[ 96 172  64  25 323],256,4,12648,4.025461489497135,20.0,0.0
13142,1,3142,[181 204 237 471 222],344,2,12650,4.024817053770283,0.0,0.0
13143,1,3143,[174 125 121 187  98],450,4,12654,4.0248091603053435,0.0,0.0
13144,1,3144,[ 22 300 196 202 151],796,5,12659,4.025119236883943,0.0,0.0
13145,1,3145,[427  79  98 588 127],450,5,12664,4.025429116338207,20.0,20.0
13146,1,3146,[427  79  98 588 127],18,5,12669,4.025738798856054,20.0,20.0
13147,1,3147,[427  79  98 588 127],796,5,12674,4.026048284625158,20.0,20.0
13148,1,3148,[151 269 288 200 318],450,3,12677,4.025722451571927,20.0,0.0
13149,1,3149,[282 151  56 237 210],457,5,12682,4.026031746031746,0.0,0.0
13150,1,3150,[748 176 423 275 294],796,4,12686,4.026023484608061,0.0,20.0
13151,1,3151,[405 216 187 286   7],655,2,12688,4.025380710659898,0.0,20.0
13152,1,3152,[ 89 185 196  22 742],457,5,12693,4.0256898192197905,0.0,0.0
13153,1,3153,[181 117 172 435  96],296,4,12697,4.02568167406468,0.0,0.0
13154,1,3154,[427  79  98 588 127],796,5,12702,4.025990491283677,20.0,20.0
13155,1,3155,[483 423 318 588 427],450,4,12706,4.025982256020279,40.0,0.0
13156,1,3156,[135 161 153 186 202],269,1,12707,4.025023756731073,0.0,0.0
13157,1,3157,[435  28   8  95 211],389,4,12711,4.025015832805573,0.0,0.0
13158,1,3158,[427  79  98 588 127],796,5,12716,4.025324469768914,20.0,20.0
13159,1,3159,[328 276 144   4 237],655,1,12717,4.024367088607595,0.0,0.0
13160,1,3160,[427  79  98 588 127],389,5,12722,4.024675735526732,20.0,20.0
13161,1,3161,[427  79  98 588 127],389,5,12727,4.024984187223277,20.0,20.0
13162,1,3162,[300 655 273  70 135],450,3,12730,4.02466013278533,0.0,0.0
13163,1,3163,[427  79  98 588 127],389,5,12735,4.024968394437421,20.0,20.0
13164,1,3164,[427  79  98 588 127],18,5,12740,4.025276461295419,20.0,20.0
13165,1,3165,[427  79  98 588 127],716,5,12745,4.025584333543904,20.0,20.0
13166,1,3166,[427  79  98 588 127],389,5,12750,4.025892011367224,20.0,20.0
13167,1,3167,[427  79  98 588 127],18,5,12755,4.026199494949495,20.0,20.0
13168,1,3168,[427  79  98 588 127],450,5,12760,4.026506784474598,20.0,20.0
13169,1,3169,[175 174 268 121 200],269,3,12763,4.026182965299684,0.0,0.0
13170,1,3170,[427  79  98 588 127],796,5,12768,4.026490066225166,20.0,20.0
13171,1,3171,[427  79  98 588 127],716,5,12773,4.026796973518285,20.0,20.0
13172,1,3172,[427  79  98 588 127],18,5,12778,4.027103687362118,20.0,20.0
13173,1,3173,[427  79  98 588 127],796,5,12783,4.027410207939509,20.0,20.0
13174,1,3174,[427  79  98 588 127],18,5,12788,4.027716535433071,20.0,20.0
13175,1,3175,[427  79  98 588 127],796,5,12793,4.028022670025189,20.0,20.0
13176,1,3176,[301 234 222  22 127],655,1,12794,4.027069562480327,0.0,20.0
13177,1,3177,[483 318 678 181 471],280,2,12796,4.026431718061674,20.0,0.0
13178,1,3178,[202  89 238 496 318],18,3,12799,4.0261088392576285,40.0,0.0
13179,1,3179,[ 11 125 216 181 302],655,2,12801,4.025471698113208,0.0,0.0
13180,1,3180,[258 275 423   7 197],535,5,12806,4.025778057214712,0.0,20.0
13181,1,3181,[294  22 603 405 111],450,5,12811,4.026084223758643,20.0,0.0
13182,1,3182,[405 215 175 258 269],344,2,12813,4.025447690857681,0.0,0.0
13183,1,3183,[427  79  98 588 127],450,5,12818,4.025753768844221,20.0,20.0
13184,1,3184,[427  79  98 588 127],18,5,12823,4.026059654631084,20.0,20.0
13185,1,3185,[427  79  98 588 127],796,5,12828,4.0263653483992465,20.0,20.0
13186,1,3186,[222 403  79 301 265],655,1,12829,4.02541575149043,0.0,0.0
13187,1,3187,[427  79  98 588 127],18,5,12834,4.025721455457967,20.0,20.0
13188,1,3188,[427  79  98 588 127],18,5,12839,4.0260269677014735,20.0,20.0
13189,1,3189,[427  79  98 588 127],796,5,12844,4.026332288401254,20.0,20.0
13190,1,3190,[181   9 655 403 216],796,3,12847,4.026010654967095,0.0,0.0
13191,1,3191,[  1 742 211 196 204],450,5,12852,4.026315789473684,0.0,0.0
13192,1,3192,[238 174  98  50 204],457,5,12857,4.026620732853116,0.0,20.0
13193,1,3193,[423   1 186 127 197],655,1,12858,4.025673137132123,0.0,20.0
13194,1,3194,[427  79  98 588 127],796,5,12863,4.025978090766823,20.0,20.0
13195,1,3195,[216  11 508 173 195],269,1,12864,4.025031289111389,0.0,0.0
13196,1,3196,[427  79  98 588 127],389,5,12869,4.025336252736941,20.0,20.0
13197,1,3197,[ 88 195 318 238 183],716,3,12872,4.025015634771733,20.0,0.0
13198,1,3198,[427  79  98 588 127],450,5,12877,4.025320412628947,20.0,20.0
13199,1,3199,[117 276 197 282  25],401,3,12880,4.025,0.0,0.0
13200,1,3200,[  4 258 215 273 153],655,1,12881,4.024054982817869,0.0,0.0
13201,1,3201,[135 174 127  25 313],693,5,12886,4.024359775140537,0.0,20.0
13202,1,3202,[ 79 197  95  56 265],716,5,12891,4.024664377146426,0.0,0.0
13203,1,3203,[385 186 168  89 276],457,5,12896,4.024968789013733,0.0,0.0
13204,1,3204,[427  79  98 588 127],796,5,12901,4.025273010920436,20.0,20.0
13205,1,3205,[257 168 181  50 258],796,5,12906,4.025577043044292,0.0,20.0
13206,1,3206,[427  79  98 588 127],796,5,12911,4.025880885562831,20.0,20.0
13207,1,3207,[427  79  98 588 127],18,5,12916,4.026184538653367,20.0,20.0
13208,1,3208,[427  79  98 588 127],389,5,12921,4.0264880024929885,20.0,20.0
13209,1,3209,[427  79  98 588 127],796,5,12926,4.026791277258567,20.0,20.0
13210,1,3210,[427  79  98 588 127],450,5,12931,4.027094363126752,20.0,20.0
13211,1,3211,[427  79  98 588 127],389,5,12936,4.027397260273973,20.0,20.0
13212,1,3212,[471 196 135 405 127],450,4,12940,4.027388733271086,0.0,20.0
13213,1,3213,[748 328 215 228 117],796,5,12945,4.027691350342253,0.0,0.0
13214,1,3214,[427  79  98 588 127],796,5,12950,4.0279937791601865,20.0,20.0
13215,1,3215,[427  79  98 588 127],18,5,12955,4.028296019900497,20.0,20.0
13216,1,3216,[427  79  98 588 127],796,5,12960,4.028598072738577,20.0,20.0
13217,1,3217,[427  79  98 588 127],796,5,12965,4.028899937849596,20.0,20.0
13218,1,3218,[427  79  98 588 127],796,5,12970,4.029201615408512,20.0,20.0
13219,1,3219,[427  79  98 588 127],796,5,12975,4.029503105590062,20.0,20.0
13220,1,3220,[ 25 168 301  98 135],11,2,12977,4.028873020800994,0.0,0.0
13221,1,3221,[427  79 588  98 127],716,5,12982,4.029174425822471,20.0,20.0
13222,1,3222,[197 172 357 179   4],457,5,12987,4.029475643810115,0.0,0.0
13223,1,3223,[427  79 588  98 127],389,5,12992,4.029776674937965,20.0,20.0
13224,1,3224,[427  79 588  98 127],389,5,12997,4.030077519379845,20.0,20.0
13225,1,3225,[603  22 275 186 286],655,2,12999,4.029448233106014,20.0,40.0
13226,1,3226,[  1 237  98 210 216],280,3,13002,4.02912922218779,0.0,0.0
13227,1,3227,[405  22 237 118 568],577,2,13004,4.028500619578686,0.0,0.0
13228,1,3228,[275 655 175  82 423],716,4,13008,4.0284917931248065,0.0,20.0
13229,1,3229,[ 98 568  71 742 318],577,4,13012,4.0284829721362225,20.0,0.0
13230,1,3230,[187  25 179 121 423],504,3,13015,4.028164654905602,0.0,0.0
13231,1,3231,[427  79 588  98 127],796,5,13020,4.028465346534653,20.0,20.0
13232,1,3232,[427  79 588  98 127],796,5,13025,4.028765852149706,20.0,20.0
13233,1,3233,[427  79 588  98 127],450,5,13030,4.029066171923315,20.0,20.0
13234,1,3234,[195 215 135  22 265],450,4,13034,4.029057187017002,0.0,0.0
13235,1,3235,[172  98 423 125 210],18,3,13037,4.028739184177997,0.0,0.0
13236,1,3236,[427  79 588  98 127],18,5,13042,4.029039233858511,20.0,20.0
13237,1,3237,[427  79 588  98 127],796,5,13047,4.029339098208771,20.0,20.0
13238,1,3238,[427  79 588  98 127],18,5,13052,4.029638777400432,20.0,20.0
13239,1,3239,[427  79 588  98 127],796,5,13057,4.029938271604938,20.0,20.0
13240,1,3240,[427  79 588  98 127],18,5,13062,4.0302375809935205,20.0,20.0
13241,1,3241,[427  79 588  98 127],716,5,13067,4.030536705737199,20.0,20.0
13242,1,3242,[471 175  22 210 546],344,2,13069,4.02991057662658,0.0,0.0
13243,1,3243,[ 64 117 191  95 322],450,4,13073,4.029901356350185,20.0,0.0
13244,1,3244,[427  79 588  98 127],450,5,13078,4.0302003081664095,20.0,20.0
13245,1,3245,[153 204 405 210 286],450,4,13082,4.030191004313001,0.0,20.0
13246,1,3246,[194 144 238 427 135],535,3,13085,4.0298737295965505,20.0,0.0
13247,1,3247,[427 186 100 216  22],450,4,13089,4.029864532019705,20.0,20.0
13248,1,3248,[176  69 322 546 588],796,4,13093,4.029855340104648,0.0,0.0
13249,1,3249,[427  79 588  98 127],389,5,13098,4.030153846153846,20.0,20.0
13250,1,3250,[427  79 588  98 127],389,5,13103,4.030452168563519,20.0,20.0
13251,1,3251,[427  79 588  98 127],18,5,13108,4.030750307503075,20.0,20.0
13252,1,3252,[196 127 258 588  64],796,5,13113,4.031048263141716,20.0,20.0
13253,1,3253,[275 168  25 181 483],457,5,13118,4.031346035648433,0.0,20.0
13254,1,3254,[215 186 435 322  79],151,3,13121,4.0310291858678955,0.0,0.0
13255,1,3255,[427  79 588  98 127],389,5,13126,4.031326781326781,20.0,20.0
13256,1,3256,[427  79 588  98 127],18,5,13131,4.031624194043599,20.0,20.0
13257,1,3257,[655 483 508 168 282],535,4,13135,4.031614487415593,0.0,0.0
13258,1,3258,[210 300 257 405 194],716,5,13140,4.031911629334152,0.0,0.0
13259,1,3259,[427  79 588  98 127],716,5,13145,4.032208588957055,20.0,20.0
13260,1,3260,[234 176 183 357 405],796,4,13149,4.032198712051518,0.0,0.0
13261,1,3261,[195 135 257 127 597],807,3,13152,4.031882280809319,0.0,20.0
13262,1,3262,[318  97 245 174 313],593,4,13156,4.031872509960159,20.0,0.0
13263,1,3263,[427  79 588  98 127],18,5,13161,4.032169117647059,20.0,20.0
13264,1,3264,[  1 228 181 237 161],457,5,13166,4.032465543644717,0.0,0.0
13265,1,3265,[742 271 245 143 269],796,2,13168,4.031843233312921,0.0,0.0
13266,1,3266,[313 153 265 322 568],280,3,13171,4.031527395163759,0.0,0.0
13267,1,3267,[427  79 588  98 127],796,5,13176,4.031823745410037,20.0,20.0
13268,1,3268,[546 289 655 183 222],236,3,13179,4.031508106454574,0.0,0.0
13269,1,3269,[269 121 204 172 483],535,4,13183,4.031498470948012,0.0,0.0
13270,1,3270,[ 25 276 245 385 153],593,2,13185,4.030877407520636,0.0,0.0
13271,1,3271,[427  79 588  98 127],18,5,13190,4.03117359413203,20.0,20.0
13272,1,3272,[427  79 588  98 127],18,5,13195,4.031469599755576,20.0,20.0
13273,1,3273,[427  79 588  98 127],18,5,13200,4.031765424557117,20.0,20.0
13274,1,3274,[275 132 276  97 423],457,5,13205,4.03206106870229,0.0,20.0
13275,1,3275,[143 127  56 202 515],716,5,13210,4.032356532356532,0.0,20.0
13276,1,3276,[288 228 655 181   7],655,0,13210,4.031126029905401,0.0,0.0
13277,1,3277,[427  79 588  98 127],796,5,13215,4.031421598535693,20.0,20.0
13278,1,3278,[234 385  70 173 194],23,3,13218,4.031107044830741,0.0,0.0
13279,1,3279,[427  79 588  98 127],796,5,13223,4.03140243902439,20.0,20.0
13280,1,3280,[237 100 318 234 211],796,2,13225,4.030783297775068,20.0,20.0
13281,1,3281,[471 111   7 405 210],655,0,13225,4.029555149299208,0.0,0.0
13282,1,3282,[222 313 427 121 435],450,3,13228,4.029241547365214,20.0,0.0
13283,1,3283,[286 302 301  82 235],450,3,13231,4.028928136419001,0.0,20.0
13284,1,3284,[427  79 588  98 127],389,5,13236,4.029223744292238,20.0,20.0
13285,1,3285,[100 483 603 200  11],655,3,13239,4.028910529519172,20.0,20.0
13286,1,3286,[117  25   7 216  70],450,4,13243,4.028901734104046,0.0,0.0
13287,1,3287,[427 271 185 275  69],655,3,13246,4.028588807785888,20.0,20.0
13288,1,3288,[100   1  89 204 210],18,3,13249,4.028276071754332,0.0,20.0
13289,1,3289,[194 603 125 132 186],151,5,13254,4.0285714285714285,20.0,0.0
13290,1,3290,[135  11 144 508 185],535,3,13257,4.028258887876025,0.0,0.0
13291,1,3291,[427  79 588  98 127],450,5,13262,4.028554070473876,20.0,20.0
13292,1,3292,[234   1  71 597 483],23,2,13264,4.0279380504099604,0.0,0.0
13293,1,3293,[427  79 588  98 127],716,5,13269,4.028233151183971,20.0,20.0
13294,1,3294,[427  79 588  98 127],716,5,13274,4.0285280728376325,20.0,20.0
13295,1,3295,[427  79 588  98 127],389,5,13279,4.028822815533981,20.0,20.0
13296,1,3296,[118  25 403   9 405],655,0,13279,4.0276008492569,0.0,0.0
13297,1,3297,[471 385 204  25  56],457,5,13284,4.027895694360218,0.0,0.0
13298,1,3298,[ 89 174 568  82 385],655,1,13285,4.026977872082449,0.0,0.0
13299,1,3299,[427  79 588  98 127],796,5,13290,4.027272727272727,20.0,20.0
13300,1,3300,[176  96 568  11 132],693,4,13294,4.027264465313541,0.0,0.0
13301,1,3301,[427  79 588  98 127],18,5,13299,4.02755905511811,20.0,20.0
13302,1,3302,[ 64 172 328  89 405],796,5,13304,4.027853466545564,20.0,0.0
13303,1,3303,[271 127 265  88  25],655,1,13305,4.026937046004843,0.0,20.0
13304,1,3304,[ 25 322 742 588 180],450,4,13309,4.026928895612708,0.0,0.0
13305,1,3305,[  9 183  95 328 187],796,4,13313,4.02692075015124,0.0,0.0
13306,1,3306,[237 496  95 179  11],577,3,13316,4.026610220743876,20.0,0.0
13307,1,3307,[204  56 216  12 181],655,1,13317,4.025695284159613,0.0,0.0
13308,1,3308,[427  79 588  98 127],18,5,13322,4.025989724992445,20.0,20.0
13309,1,3309,[ 15 143 197 117  69],655,1,13323,4.025075528700906,0.0,0.0
13310,1,3310,[427  79 588  98 127],796,5,13328,4.025369978858351,20.0,20.0
13311,1,3311,[132 385  11  25 181],330,5,13333,4.025664251207729,0.0,0.0
13312,1,3312,[161 196 655 515 435],72,5,13338,4.025958345910051,0.0,0.0
13313,1,3313,[427  79 588  98 127],389,5,13343,4.026252263126132,20.0,20.0
13314,1,3314,[568  25 182 471  82],655,1,13344,4.025339366515837,0.0,0.0
13315,1,3315,[427  79 588  98 127],796,5,13349,4.025633293124246,20.0,20.0
13316,1,3316,[204 271 603 403 196],796,5,13354,4.0259270425082905,20.0,0.0
13317,1,3317,[427  79 588  98 127],796,5,13359,4.02622061482821,20.0,20.0
13318,1,3318,[423 483  82 405 132],716,5,13364,4.02651401024405,0.0,0.0
13319,1,3319,[197 423 204 322 328],151,3,13367,4.026204819277108,0.0,0.0
13320,1,3320,[234 151 143 173 176],796,4,13371,4.026196928635953,0.0,0.0
13321,1,3321,[151 195 597 176 125],457,4,13375,4.026189042745334,0.0,0.0
13322,1,3322,[197 258 117 286 234],629,5,13380,4.026482094492928,0.0,20.0
13323,1,3323,[237 301 268 286 216],655,1,13381,4.0255716004813475,0.0,20.0
13324,1,3324,[121 186  70   9 196],457,5,13386,4.025864661654135,0.0,0.0
13325,1,3325,[100  56 216   4 204],389,4,13390,4.025856885147324,0.0,20.0
13326,1,3326,[427  79 588  98 127],389,5,13395,4.026149684400361,20.0,20.0
13327,1,3327,[135 258  25   9 127],693,4,13399,4.026141826923077,0.0,20.0
13328,1,3328,[275 211 191 161 176],796,4,13403,4.026133974166417,0.0,20.0
13329,1,3329,[282 197 185  25 655],535,4,13407,4.026126126126126,0.0,0.0
13330,1,3330,[427  79 588  98 127],450,5,13412,4.026418492945061,20.0,20.0
13331,1,3331,[118 181 286  25  56],151,4,13416,4.02641056422569,0.0,20.0
13332,1,3332,[427  79 588  98 127],796,5,13421,4.026702670267027,20.0,20.0
13333,1,3333,[603 135 568 204  79],389,3,13424,4.026394721055789,20.0,0.0
13334,1,3334,[111 211 237 288 515],655,1,13425,4.0254872563718145,0.0,0.0
13335,1,3335,[655 210 405 423  79],796,3,13428,4.025179856115108,0.0,0.0
13336,1,3336,[405 403 202 423 143],798,3,13431,4.024872640095895,0.0,0.0
13337,1,3337,[427  79 588  98 127],450,5,13436,4.025164769322948,20.0,20.0
13338,1,3338,[196 405 173 161 211],269,1,13437,4.024258760107816,0.0,0.0
13339,1,3339,[132   9 197 318 742],504,5,13442,4.024550898203593,20.0,0.0
13340,1,3340,[427  79 588  98 127],796,5,13447,4.024842861418737,20.0,20.0
13341,1,3341,[269 385 483 302  64],655,3,13450,4.024536205864751,20.0,0.0
13342,1,3342,[257 385  69 508 435],401,1,13451,4.0236314687406525,0.0,0.0
13343,1,3343,[427  79 588  98 127],18,5,13456,4.023923444976076,20.0,20.0
13344,1,3344,[603  97 597 496  95],796,4,13460,4.023916292974589,40.0,0.0
13345,1,3345,[427  79 588  98 127],716,5,13465,4.024208009563658,20.0,20.0
13346,1,3346,[427  79 588  98 127],18,5,13470,4.024499551837466,20.0,20.0
13347,1,3347,[427  79 588  98 127],18,5,13475,4.02479091995221,20.0,20.0
13348,1,3348,[427  79 588  98 127],18,5,13480,4.0250821140639,20.0,20.0
13349,1,3349,[181 153 427 257 328],655,1,13481,4.024179104477612,20.0,0.0
13350,1,3350,[427  79 588  98 127],450,5,13486,4.024470307370934,20.0,20.0
13351,1,3351,[427  79 588  98 127],716,5,13491,4.024761336515513,20.0,20.0
13352,1,3352,[427  79 588  98 127],389,5,13496,4.025052192066806,20.0,20.0
13353,1,3353,[427  79 588  98 127],389,5,13501,4.025342874180083,20.0,20.0
13354,1,3354,[195 228 185 200 132],450,4,13505,4.0253353204172875,0.0,0.0
13355,1,3355,[427  79 588  98 127],796,5,13510,4.0256257449344455,20.0,20.0
13356,1,3356,[405  88 238 301 216],796,3,13513,4.025320226392613,0.0,0.0
13357,1,3357,[742  12 176 180 222],693,1,13514,4.024419297200715,0.0,0.0
13358,1,3358,[257 405  82  69  98],796,4,13518,4.024412027389104,0.0,0.0
13359,1,3359,[568 180  64   1 204],450,5,13523,4.024702380952381,20.0,0.0
13360,1,3360,[597 302 216   8 385],344,3,13526,4.024397500743826,0.0,0.0
13361,1,3361,[186 427 161 191 300],450,4,13530,4.024390243902439,20.0,0.0
13362,1,3362,[427  79 588  98 127],389,5,13535,4.024680344930122,20.0,20.0
13363,1,3363,[427  79 588  98 127],796,5,13540,4.024970273483948,20.0,20.0
13364,1,3364,[183  50 269 655   4],655,2,13542,4.024368499257058,0.0,20.0
13365,1,3365,[427  79 588  98 127],450,5,13547,4.02465834818776,20.0,20.0
13366,1,3366,[202 183 546  69 286],796,4,13551,4.024651024651025,0.0,20.0
13367,1,3367,[275 403 216 132   1],330,5,13556,4.024940617577197,0.0,20.0
13368,1,3368,[427  79 588  98 127],18,5,13561,4.025230038587118,20.0,20.0
13369,1,3369,[286 496 211  88 202],18,3,13564,4.024925816023739,20.0,20.0
13370,1,3370,[427  79 588  98 127],18,5,13569,4.025215069712251,20.0,20.0
13371,1,3371,[427  79 588  98 127],18,5,13574,4.025504151838671,20.0,20.0
13372,1,3372,[275 210  25 546  96],716,3,13577,4.025200118588794,0.0,20.0
13373,1,3373,[427  79 588  98 127],450,5,13582,4.025489033787789,20.0,20.0
13374,1,3374,[427  79 588  98 127],796,5,13587,4.025777777777778,20.0,20.0
13375,1,3375,[427  79 588  98 127],716,5,13592,4.0260663507109005,20.0,20.0
13376,1,3376,[427  79 588  98 127],18,5,13597,4.026354752739118,20.0,20.0
13377,1,3377,[427  79 588  98 127],450,5,13602,4.0266429840142095,20.0,20.0
13378,1,3378,[427  79 588  98 127],389,5,13607,4.026931044687777,20.0,20.0
13379,1,3379,[427  79 588  98 127],18,5,13612,4.027218934911242,20.0,20.0
13380,1,3380,[183  50 161  64 191],269,2,13614,4.026619343389529,20.0,20.0
13381,1,3381,[161 273 275 276  64],655,4,13618,4.026611472501479,20.0,20.0
13382,1,3382,[427  79 588  98 127],18,5,13623,4.026899201891812,20.0,20.0
13383,1,3383,[182 294 228  50   1],256,3,13626,4.026595744680851,0.0,20.0
13384,1,3384,[427  79 588  98 127],796,5,13631,4.026883308714919,20.0,20.0
13385,1,3385,[ 25   9  89 135  82],655,2,13633,4.026284701712935,0.0,0.0
13386,1,3386,[294 135 275 216 313],655,4,13637,4.02627694124594,0.0,20.0
13387,1,3387,[427  79 588  98 127],18,5,13642,4.026564344746163,20.0,20.0
13388,1,3388,[427  79 588  98 127],796,5,13647,4.026851578636766,20.0,20.0
13389,1,3389,[427  79 588  98 127],716,5,13652,4.027138643067847,20.0,20.0
13390,1,3390,[211 588 269   8  22],796,3,13655,4.0268357416691245,0.0,0.0
13391,1,3391,[ 82 186 300  69 318],716,4,13659,4.0268278301886795,20.0,0.0
13392,1,3392,[471 385 245 118 117],280,2,13661,4.026230474506336,0.0,0.0
13393,1,3393,[143 238 271 186 200],655,2,13663,4.025633470830878,0.0,0.0
13394,1,3394,[427  79 588  98 127],716,5,13668,4.025920471281296,20.0,20.0
13395,1,3395,[427  79 588  98 127],389,5,13673,4.02620730270907,20.0,20.0
13396,1,3396,[427  79 588  98 127],18,5,13678,4.026493965263468,20.0,20.0
13397,1,3397,[427  79 588  98 127],18,5,13683,4.026780459093584,20.0,20.0
13398,1,3398,[427  79 588  98 127],450,5,13688,4.027066784348338,20.0,20.0
13399,1,3399,[200 215 273 117 423],796,4,13692,4.027058823529412,0.0,0.0
13400,1,3400,[273 597 427 204 196],796,4,13696,4.027050867391943,20.0,0.0
13401,1,3401,[427  79 588  98 127],18,5,13701,4.027336860670194,20.0,20.0
13402,1,3402,[427  79 588  98 127],716,5,13706,4.0276226858654125,20.0,20.0
13403,1,3403,[427  79 588  98 127],716,5,13711,4.027908343125734,20.0,20.0
13404,1,3404,[ 70 286 204 173  25],450,4,13715,4.027900146842878,0.0,20.0
13405,1,3405,[  9  69 655 357 216],655,2,13717,4.02730475631239,0.0,0.0
13406,1,3406,[427  79 588  98 127],389,5,13722,4.0275902553566185,20.0,20.0
13407,1,3407,[496 172 211 357 173],450,5,13727,4.02787558685446,20.0,0.0
13408,1,3408,[200 132  96 405 238],655,1,13728,4.026987386330302,0.0,0.0
13409,1,3409,[357  50 194 258 313],450,5,13733,4.027272727272727,0.0,20.0
13410,1,3410,[183 127  64  11 238],655,3,13736,4.026971562591616,20.0,20.0
13411,1,3411,[427  79 588  98 127],716,5,13741,4.02725674091442,20.0,20.0
13412,1,3412,[ 50 483 515 211 357],716,5,13746,4.027541752124231,0.0,20.0
13413,1,3413,[276 143 111 180 100],786,4,13750,4.0275336848271825,0.0,20.0
13414,1,3414,[ 96 187  22 180 173],716,2,13752,4.026939970717423,0.0,0.0
13415,1,3415,[ 89 182 235 200 385],450,3,13755,4.026639344262295,0.0,0.0
13416,1,3416,[181 322 121  15 176],151,3,13758,4.026338893766462,0.0,0.0
13417,1,3417,[427  79 588  98 127],716,5,13763,4.026623756582797,20.0,20.0
13418,1,3418,[191 161 204 286   4],796,4,13767,4.026615969581749,0.0,20.0
13419,1,3419,[427  79 588  98 127],716,5,13772,4.026900584795322,20.0,20.0
13420,1,3420,[475 313 294 191  25],655,2,13774,4.026308097047647,0.0,0.0
13421,1,3421,[273 568 300 257   1],655,1,13775,4.02542372881356,0.0,0.0
13422,1,3422,[ 25 228 153 144 435],5,3,13778,4.025124160093485,0.0,0.0
13423,1,3423,[238 742 191 423 144],450,5,13783,4.025408878504673,0.0,0.0
13424,1,3424,[257 144 301 127 313],796,4,13787,4.025401459854015,0.0,20.0
13425,1,3425,[ 25 127 179 111 191],450,4,13791,4.025394045534151,0.0,20.0
13426,1,3426,[427  79 588  98 127],389,5,13796,4.025678435949811,20.0,20.0
13427,1,3427,[333  96 186   1 496],796,3,13799,4.025379229871645,20.0,0.0
13428,1,3428,[181 191   7 655   1],72,3,13802,4.025080198308545,0.0,0.0
13429,1,3429,[235 210   8  82 313],807,4,13806,4.025072886297376,0.0,0.0
13430,1,3430,[427  79 588  98 127],389,5,13811,4.025357038764208,20.0,20.0
13431,1,3431,[125 180 257   9 265],796,3,13814,4.025058275058275,0.0,0.0
13432,1,3432,[427  79 588  98 127],389,5,13819,4.0253422662394405,20.0,20.0
13433,1,3433,[100 313   4 483 180],280,2,13821,4.024752475247524,0.0,20.0
13434,1,3434,[121  56 301 333 435],655,0,13821,4.0235807860262005,0.0,0.0
13435,1,3435,[483 132 197  22 181],716,5,13826,4.023864959254948,0.0,0.0
13436,1,3436,[427  79 588  98 127],18,5,13831,4.024148967122491,20.0,20.0
13437,1,3437,[427   7 187 176 153],655,2,13833,4.023560209424084,20.0,0.0
13438,1,3438,[427  79 588  98 127],18,5,13838,4.0238441407385865,20.0,20.0
13439,1,3439,[ 88  50 185  96 257],504,3,13841,4.023546511627907,0.0,20.0
13440,1,3440,[427  79 588  98 127],18,5,13846,4.023830281894798,20.0,20.0
13441,1,3441,[427  79 588  98 127],389,5,13851,4.02411388727484,20.0,20.0
13442,1,3442,[427  79 588  98 127],18,5,13856,4.024397327911705,20.0,20.0
13443,1,3443,[427  79 588  98 127],716,5,13861,4.024680603948896,20.0,20.0
13444,1,3444,[655 202 200 588 187],450,4,13865,4.0246734397677795,0.0,0.0
13445,1,3445,[161 322 508 135 471],401,1,13866,4.023795705165409,0.0,0.0
13446,1,3446,[282 655 405 197 234],796,2,13868,4.023208587177256,0.0,0.0
13447,1,3447,[127 222 568 216 151],344,5,13873,4.023491879350348,0.0,20.0
13448,1,3448,[655   4 183 385 318],457,5,13878,4.023775007248478,20.0,0.0
13449,1,3449,[125  64 127  12 151],450,5,13883,4.024057971014493,20.0,20.0
13450,1,3450,[318  69 603 143 197],655,3,13886,4.0237612286293825,40.0,0.0
13451,1,3451,[427  79 588  98 127],796,5,13891,4.02404403244496,20.0,20.0
13452,1,3452,[427  79 588  98 127],450,5,13896,4.024326672458732,20.0,20.0
13453,1,3453,[ 97  15 118 185 423],796,4,13900,4.024319629415171,0.0,0.0
13454,1,3454,[ 28 238  22 100 168],796,2,13902,4.023733719247468,0.0,20.0
13455,1,3455,[427  79 588  98 127],796,5,13907,4.024016203703703,20.0,20.0
13456,1,3456,[427  79 588  98 127],716,5,13912,4.024298524732427,20.0,20.0
13457,1,3457,[427  79 588  98 127],716,5,13917,4.02458068247542,20.0,20.0
13458,1,3458,[427  79 588  98 127],389,5,13922,4.024862677074299,20.0,20.0
13459,1,3459,[496 183 191 237  50],796,5,13927,4.02514450867052,20.0,20.0
13460,1,3460,[427  79 588  98 127],796,5,13932,4.025426177405374,20.0,20.0
13461,1,3461,[427  79 588  98 127],450,5,13937,4.025707683419989,20.0,20.0
13462,1,3462,[742 175 151 121  11],457,5,13942,4.025989026855328,0.0,0.0
13463,1,3463,[427  79 588  98 127],450,5,13947,4.026270207852194,20.0,20.0
13464,1,3464,[427  79 588  98 127],716,5,13952,4.026551226551226,20.0,20.0
13465,1,3465,[427  79 588  98 127],450,5,13957,4.026832083092902,20.0,20.0
13466,1,3466,[427  79 588  98 127],18,5,13962,4.027112777617536,20.0,20.0
13467,1,3467,[427  79 588  98 127],389,5,13967,4.027393310265283,20.0,20.0
13468,1,3468,[483 211 423 403 135],450,3,13970,4.027097146151629,0.0,0.0
13469,1,3469,[210 194 111 215 179],639,1,13971,4.026224783861672,0.0,0.0
13470,1,3470,[211  88 168 111 318],151,5,13976,4.026505329876116,20.0,0.0
13471,1,3471,[427  79 588  98 127],389,5,13981,4.026785714285714,20.0,20.0
13472,1,3472,[427  79 588  98 127],450,5,13986,4.02706593723006,20.0,20.0
13473,1,3473,[275  89   4 151 328],450,4,13990,4.02705814622913,0.0,20.0
13474,1,3474,[435 111  71 301 172],389,4,13994,4.02705035971223,0.0,0.0
13475,1,3475,[427  79 588  98 127],716,5,13999,4.027330264672037,20.0,20.0
13476,1,3476,[427  79 588  98 127],389,5,14004,4.027610008628128,20.0,20.0
13477,1,3477,[357 197   1  98 257],330,5,14009,4.027889591719379,0.0,0.0
13478,1,3478,[ 15 185 603   4 168],707,1,14010,4.027019258407589,20.0,0.0
13479,1,3479,[546   9 313  89 210],344,3,14013,4.026724137931034,0.0,0.0
13480,1,3480,[427  79 588  98 127],796,5,14018,4.027003734559035,20.0,20.0
13481,1,3481,[427  79 588  98 127],796,5,14023,4.027283170591614,20.0,20.0
13482,1,3482,[333 197 111  50 475],655,1,14024,4.026414010910135,0.0,20.0
13483,1,3483,[427  79 588  98 127],716,5,14029,4.0266934557979335,20.0,20.0
13484,1,3484,[202 228 258 132 191],457,5,14034,4.026972740315639,0.0,0.0
13485,1,3485,[385  98 328 182 273],450,4,14038,4.026965002868617,0.0,0.0
13486,1,3486,[313 111 211 204 173],796,4,14042,4.026957269859478,0.0,0.0
13487,1,3487,[427  79 588  98 127],389,5,14047,4.02723623853211,20.0,20.0
13488,1,3488,[427  79 588  98 127],450,5,14052,4.027515047291487,20.0,20.0
13489,1,3489,[265 216  88  71 111],236,2,14054,4.026934097421203,0.0,0.0
13490,1,3490,[427  79 588  98 127],796,5,14059,4.02721283299914,20.0,20.0
13491,1,3491,[427  79 588  98 127],796,5,14064,4.027491408934708,20.0,20.0
13492,1,3492,[427  79 588  98 127],389,5,14069,4.027769825365016,20.0,20.0
13493,1,3493,[471 318 186 173 357],535,4,14073,4.027761877504293,20.0,0.0
13494,1,3494,[ 98 742 228 333 655],796,3,14076,4.0274678111587985,0.0,0.0
13495,1,3495,[427  79 588  98 127],18,5,14081,4.0277459954233406,20.0,20.0
13496,1,3496,[427  79 588  98 127],389,5,14086,4.0280240205890765,20.0,20.0
13497,1,3497,[427  79 588  98 127],18,5,14091,4.028301886792453,20.0,20.0
13498,1,3498,[ 22 151 195 144 357],457,5,14096,4.028579594169763,0.0,0.0
13499,1,3499,[427  79 588  98 127],716,5,14101,4.0288571428571425,20.0,20.0
13500,1,3500,[183  50 121 196 216],344,4,14105,4.028848900314196,0.0,20.0
13501,1,3501,[427  79 588  98 127],716,5,14110,4.029126213592233,20.0,20.0
13502,1,3502,[427  79 588  98 127],716,5,14115,4.02940336854125,20.0,20.0
13503,1,3503,[427  79 588  98 127],18,5,14120,4.029680365296803,20.0,20.0
13504,1,3504,[427  79 588  98 127],389,5,14125,4.029957203994294,20.0,20.0
13505,1,3505,[427  79 588  98 127],450,5,14130,4.030233884768967,20.0,20.0
13506,1,3506,[ 98 151 588 216 301],389,4,14134,4.030225263758198,0.0,0.0
13507,1,3507,[427  79 588  98 127],450,5,14139,4.030501710376282,20.0,20.0
13508,1,3508,[174 748 597  56 228],256,3,14142,4.030208036477629,0.0,0.0
13509,1,3509,[427  79 588  98 127],796,5,14147,4.03048433048433,20.0,20.0
13510,1,3510,[435  88 546 258 286],151,4,14151,4.030475647963543,0.0,20.0
13511,1,3511,[211 117   8  97 195],796,3,14154,4.030182232346242,0.0,0.0
13512,1,3512,[427  79 588  98 127],450,5,14159,4.03045829775121,20.0,20.0
13513,1,3513,[172  25 276   1 403],457,5,14164,4.030734206033011,0.0,0.0
13514,1,3514,[427  79 588  98 127],389,5,14169,4.031009957325747,20.0,20.0
13515,1,3515,[100 204  98 144   1],5,3,14172,4.030716723549488,0.0,20.0
13516,1,3516,[427  79 588  98 127],389,5,14177,4.030992323002559,20.0,20.0
13517,1,3517,[427  79 588  98 127],450,5,14182,4.031267765776009,20.0,20.0
13518,1,3518,[186 191 288 302 742],655,2,14184,4.030690537084399,0.0,0.0
13519,1,3519,[427  79 588  98 127],796,5,14189,4.030965909090909,20.0,20.0
13520,1,3520,[301 273 655  28 185],450,4,14193,4.03095711445612,0.0,0.0
13521,1,3521,[265 405 427 204 186],655,1,14194,4.030096536059057,20.0,0.0
13522,1,3522,[427  79 588  98 127],716,5,14199,4.03037184217996,20.0,20.0
13523,1,3523,[427  79 588  98 127],18,5,14204,4.030646992054484,20.0,20.0
13524,1,3524,[286 313 423 215  50],450,5,14209,4.030921985815603,0.0,40.0
13525,1,3525,[427  79 588  98 127],716,5,14214,4.031196823596143,20.0,20.0
13526,1,3526,[ 25 173 222  15 197],151,5,14219,4.031471505528778,0.0,0.0
13527,1,3527,[202  12 210 403 237],280,1,14220,4.030612244897959,0.0,0.0
13528,1,3528,[143  11   9 423 118],174,3,14223,4.030320204023803,0.0,0.0
13529,1,3529,[282 111 568 286 195],280,2,14225,4.029745042492918,0.0,20.0
13530,1,3530,[427  79 588  98 127],450,5,14230,4.0300198244123475,20.0,20.0
13531,1,3531,[427  79 588  98 127],18,5,14235,4.030294450736127,20.0,20.0
13532,1,3532,[ 25 174 276  64  11],401,3,14238,4.030002830455703,20.0,0.0
13533,1,3533,[121 300 197 403  28],655,0,14238,4.028862478777589,0.0,0.0
13534,1,3534,[175  82 185 121 202],716,4,14242,4.028854314002829,0.0,0.0
13535,1,3535,[427  79 588  98 127],18,5,14247,4.029128959276018,20.0,20.0
13536,1,3536,[742  28 282 588  97],796,2,14249,4.028555272830082,0.0,0.0
13537,1,3537,[ 11 742 100 471  56],450,5,14254,4.028829847371396,0.0,20.0
13538,1,3538,[202  70 385 300 135],655,1,14255,4.0279740039559195,0.0,0.0
13539,1,3539,[202 174   7 204 196],457,5,14260,4.028248587570621,0.0,0.0
13540,1,3540,[475 328 172 357   7],655,2,14262,4.027675797797232,0.0,0.0
13541,1,3541,[228 144  50 153 483],23,4,14266,4.027667984189724,0.0,20.0
13542,1,3542,[286 435 357 515 211],401,4,14270,4.027660174992944,0.0,20.0
13543,1,3543,[427  79 588  98 127],18,5,14275,4.0279345372460496,20.0,20.0
13544,1,3544,[132 286 100 121 191],344,3,14278,4.027644569816643,0.0,40.0
13545,1,3545,[427  79 588  98 127],796,5,14283,4.027918781725888,20.0,20.0
13546,1,3546,[ 11 568 471  69 357],344,2,14285,4.027347053848323,0.0,0.0
13547,1,3547,[427  79 588  98 127],389,5,14290,4.027621195039459,20.0,20.0
13548,1,3548,[403 200 143 588 132],18,3,14293,4.027331642716258,0.0,0.0
13549,1,3549,[ 79  56 318 742 125],457,5,14298,4.027605633802817,20.0,0.0
13550,1,3550,[588 210 197 172  50],786,4,14302,4.027597859757814,0.0,20.0
13551,1,3551,[427  79 588  98 127],389,5,14307,4.027871621621622,20.0,20.0
13552,1,3552,[427  79 588  98 127],716,5,14312,4.028145229383619,20.0,20.0
13553,1,3553,[427  79 588  98 127],716,5,14317,4.028418683173888,20.0,20.0
13554,1,3554,[515  15   4 200 175],655,2,14319,4.027848101265823,0.0,0.0
13555,1,3555,[ 28 222  98  56 135],450,3,14322,4.02755905511811,0.0,0.0
13556,1,3556,[286 183 655   1  15],593,3,14325,4.027270171492831,0.0,20.0
13557,1,3557,[153 322 211  70 125],151,3,14328,4.0269814502529515,0.0,0.0
13558,1,3558,[427  79 588  98 127],18,5,14333,4.0272548468670974,20.0,20.0
13559,1,3559,[ 88 180 175  98 568],716,3,14336,4.026966292134832,0.0,0.0
13560,1,3560,[427  79 588  98 127],716,5,14341,4.027239539455209,20.0,20.0
13561,1,3561,[258 181  96 427 271],796,5,14346,4.02751263335205,20.0,0.0
13562,1,3562,[427  79 588  98 127],796,5,14351,4.0277855739545325,20.0,20.0
13563,1,3563,[328 318 403  64 180],450,5,14356,4.028058361391695,40.0,0.0
13564,1,3564,[427  79 588  98 127],389,5,14361,4.028330995792427,20.0,20.0
13565,1,3565,[ 71  22 603 288 183],450,3,14364,4.028042624789681,20.0,0.0
13566,1,3566,[597 286  96 357 180],796,3,14367,4.027754415475189,0.0,20.0
13567,1,3567,[427  79 588  98 127],450,5,14372,4.028026905829597,20.0,20.0
13568,1,3568,[151 172 168 258  71],535,4,14376,4.02801905295601,0.0,0.0
13569,1,3569,[427  79 588  98 127],450,5,14381,4.0282913165266105,20.0,20.0
13570,1,3570,[427  79 588  98 127],18,5,14386,4.028563427611314,20.0,20.0
13571,1,3571,[196  69 175 172  28],716,4,14390,4.028555431131019,0.0,0.0
13572,1,3572,[ 88 172 318 301 125],796,4,14394,4.028547439126784,20.0,0.0
13573,1,3573,[427  79 588  98 127],18,5,14399,4.028819250139899,20.0,20.0
13574,1,3574,[151 216 269 197 588],796,3,14402,4.028531468531469,0.0,0.0
13575,1,3575,[427  79 588  98 127],450,5,14407,4.028803131991052,20.0,20.0
13576,1,3576,[210 153  96 237 202],796,4,14411,4.028795079675706,0.0,0.0
13577,1,3577,[276 568 176 143 603],269,2,14413,4.028228060368921,20.0,0.0
13578,1,3578,[168   7 423 210 655],269,3,14416,4.027940765576977,0.0,0.0
13579,1,3579,[427  79 588  98 127],796,5,14421,4.028212290502793,20.0,20.0
13580,1,3580,[427  79 588  98 127],389,5,14426,4.028483663781067,20.0,20.0
13581,1,3581,[423  98 202 258 237],450,5,14431,4.028754885538805,0.0,0.0
13582,1,3582,[427  79 588  98 127],389,5,14436,4.029025955902875,20.0,20.0
13583,1,3583,[427  79 588  98 127],716,5,14441,4.029296875,20.0,20.0
13584,1,3584,[427  82 144 328 234],655,1,14442,4.0284518828451885,20.0,0.0
13585,1,3585,[191 655 508 237 222],655,1,14443,4.02760736196319,0.0,0.0
13586,1,3586,[427  79 588  98 127],716,5,14448,4.027878449958182,20.0,20.0
13587,1,3587,[ 82 228 471 385 546],457,4,14452,4.027870680044593,0.0,0.0
13588,1,3588,[180 289 222 234  11],693,1,14453,4.027027027027027,0.0,0.0
13589,1,3589,[427  79 588  98 127],389,5,14458,4.027298050139276,20.0,20.0
13590,1,3590,[427  79 588  98 127],716,5,14463,4.027568922305765,20.0,20.0
13591,1,3591,[427  79 588  98 127],796,5,14468,4.027839643652562,20.0,20.0
13592,1,3592,[234 117 187 271   9],629,5,14473,4.0281102143055945,0.0,0.0
13593,1,3593,[427  79 588  98 127],18,5,14478,4.028380634390651,20.0,20.0
13594,1,3594,[427  79 588  98 127],716,5,14483,4.0286509040333796,20.0,20.0
13595,1,3595,[175 151 435 111 300],151,5,14488,4.028921023359288,0.0,0.0
13596,1,3596,[271  69 238 258 328],655,0,14488,4.027800945232138,0.0,0.0
13597,1,3597,[238 216   1 202 333],655,1,14489,4.026959421901056,0.0,0.0
13598,1,3598,[435 228  11 471 423],655,0,14489,4.025840511253126,0.0,0.0
13599,1,3599,[117  95 172  28   1],716,5,14494,4.026111111111111,0.0,0.0
13600,1,3600,[427  79 588  98 127],716,5,14499,4.0263815606775895,20.0,20.0
13601,1,3601,[427  79 588  98 127],18,5,14504,4.026651860077735,20.0,20.0
13602,1,3602,[183  56  22 211 237],269,2,14506,4.02608936996947,0.0,0.0
13603,1,3603,[427  79 588  98 127],18,5,14511,4.026359600443951,20.0,20.0
13604,1,3604,[294 237 742 222  97],256,4,14515,4.026352288488211,0.0,0.0
13605,1,3605,[ 15 471 238  79 222],450,3,14518,4.026067665002773,0.0,0.0
13606,1,3606,[ 96 173 496 322  12],450,5,14523,4.026337676739673,20.0,0.0
13607,1,3607,[427  79 588  98 127],796,5,14528,4.0266075388026605,20.0,20.0
13608,1,3608,[  1 238 200 210  98],716,5,14533,4.026877251316154,0.0,0.0
13609,1,3609,[180  64 403 196 655],269,2,14535,4.026315789473684,20.0,0.0
13610,1,3610,[196 435 210 183  11],716,4,14539,4.026308501800055,0.0,0.0
13611,1,3611,[427  79 588  98 127],796,5,14544,4.026578073089701,20.0,20.0
13612,1,3612,[427  79 588  98 127],716,5,14549,4.02684749515638,20.0,20.0
13613,1,3613,[427  79 588  98 127],450,5,14554,4.027116768123962,20.0,20.0
13614,1,3614,[546 211 323  22 176],796,3,14557,4.026832641770401,0.0,0.0
13615,1,3615,[427  79 588  98 127],389,5,14562,4.027101769911504,20.0,20.0
13616,1,3616,[234  82  97  12 357],457,5,14567,4.027370749239702,0.0,0.0
13617,1,3617,[427  79 588  98 127],450,5,14572,4.027639579878386,20.0,20.0
13618,1,3618,[546 117  88 118  28],693,1,14573,4.026802984249793,0.0,0.0
13619,1,3619,[508 385 301 117 121],655,0,14573,4.0256906077348065,0.0,0.0
13620,1,3620,[313 568 168  56 202],450,5,14578,4.0259596796465065,0.0,0.0
13621,1,3621,[568 111 125 118 269],450,4,14582,4.025952512424075,0.0,0.0
13622,1,3622,[427  79 588  98 127],716,5,14587,4.026221363510903,20.0,20.0
13623,1,3623,[496 318 273  95 568],796,4,14591,4.0262141280353205,40.0,0.0
13624,1,3624,[427  79 588  98 127],18,5,14596,4.0264827586206895,20.0,20.0
13625,1,3625,[427  79 588  98 127],389,5,14601,4.026751241036956,20.0,20.0
13626,1,3626,[269 222 313 118 191],450,3,14604,4.026468155500414,0.0,0.0
13627,1,3627,[ 28 182 302 215 273],450,4,14608,4.0264608599779494,0.0,0.0
13628,1,3628,[197 179 127   8  98],269,4,14612,4.026453568476164,0.0,20.0
13629,1,3629,[427  79 588  98 127],450,5,14617,4.0267217630853995,20.0,20.0
13630,1,3630,[427  79 588  98 127],796,5,14622,4.026989809969705,20.0,20.0
13631,1,3631,[427  79 588  98 127],389,5,14627,4.027257709251101,20.0,20.0
13632,1,3632,[237 182  70 127 222],280,2,14629,4.026699697219929,0.0,20.0
13633,1,3633,[ 71  69  82 238  64],18,3,14632,4.026417171161254,20.0,0.0
13634,1,3634,[183 405  98 182 318],503,3,14635,4.0261348005502064,20.0,0.0
13635,1,3635,[427  79 588  98 127],716,5,14640,4.026402640264027,20.0,20.0
13636,1,3636,[427  79 588  98 127],389,5,14645,4.026670332691779,20.0,20.0
13637,1,3637,[  4 301 302 181  28],655,1,14646,4.02583837273227,0.0,0.0
13638,1,3638,[273  96 568 300 288],693,2,14648,4.0252816707886785,0.0,0.0
13639,1,3639,[ 96 742 471 508  12],655,0,14648,4.024175824175824,0.0,0.0
13640,1,3640,[427  79 588  98 127],389,5,14653,4.024443834111508,20.0,20.0
13641,1,3641,[168 181 257 117  71],504,4,14657,4.024437122460187,0.0,0.0
13642,1,3642,[216 151 161 197 357],269,3,14660,4.024155915454296,0.0,0.0
13643,1,3643,[403 111 275  89 117],756,3,14663,4.023874862788145,0.0,20.0
13644,1,3644,[210  22 161 181 288],655,0,14663,4.022770919067216,0.0,0.0
13645,1,3645,[427  79 588  98 127],450,5,14668,4.0230389467910035,20.0,20.0
13646,1,3646,[117 125 483 385 275],401,2,14670,4.022484233616671,0.0,20.0
13647,1,3647,[603 235 176  95 161],716,2,14672,4.021929824561403,20.0,0.0
13648,1,3648,[427  79 588  98 127],450,5,14677,4.0221978624280625,20.0,20.0
13649,1,3649,[427  79 588  98 127],389,5,14682,4.022465753424657,20.0,20.0
13650,1,3650,[151 273 546 121 237],733,2,14684,4.021911804984936,0.0,0.0
13651,1,3651,[427  79 588  98 127],796,5,14689,4.022179627601314,20.0,20.0
13652,1,3652,[ 15 194 117 471 588],577,3,14692,4.021899808376677,0.0,0.0
13653,1,3653,[427  79 588  98 127],450,5,14697,4.022167487684729,20.0,20.0
13654,1,3654,[427 294 245 597 161],450,5,14702,4.022435020519836,20.0,0.0
13655,1,3655,[427  79 588  98 127],716,5,14707,4.022702407002188,20.0,20.0
13656,1,3656,[427  79 588  98 127],389,5,14712,4.022969647251846,20.0,20.0
13657,1,3657,[300 127 603 275  79],716,5,14717,4.023236741388737,20.0,40.0
13658,1,3658,[427  79 588  98 127],450,5,14722,4.023503689532659,20.0,20.0
13659,1,3659,[168  97 237 100 195],504,4,14726,4.023497267759563,0.0,20.0
13660,1,3660,[195 286 427 191 176],236,3,14729,4.023217700081945,20.0,20.0
13661,1,3661,[403 195 210  25 423],72,4,14733,4.023211359912616,0.0,0.0
13662,1,3662,[483 182  79 258   8],457,5,14738,4.023478023478024,0.0,0.0
13663,1,3663,[427  79 588  98 127],716,5,14743,4.023744541484716,20.0,20.0
13664,1,3664,[427  79 588  98 127],18,5,14748,4.024010914051842,20.0,20.0
13665,1,3665,[216  97 333 423 568],655,1,14749,4.023186033824332,0.0,0.0
13666,1,3666,[  4  89 185 273 245],450,3,14752,4.022907008453777,0.0,0.0
13667,1,3667,[ 15 202 176 174 144],655,0,14752,4.021810250817884,0.0,0.0
13668,1,3668,[427  79 588  98 127],450,5,14757,4.022076860179886,20.0,20.0
13669,1,3669,[ 12   1 333 200 153],655,1,14758,4.021253405994551,0.0,0.0
13670,1,3670,[ 97 357 655 186 318],450,4,14762,4.021247616453283,20.0,0.0
13671,1,3671,[427  79 588  98 127],18,5,14767,4.021514161220043,20.0,20.0
13672,1,3672,[427  79 588  98 127],716,5,14772,4.021780560849442,20.0,20.0
13673,1,3673,[427  79 588  98 127],716,5,14777,4.022046815459989,20.0,20.0
13674,1,3674,[215 168  69 179   4],504,4,14781,4.02204081632653,0.0,0.0
13675,1,3675,[427  79 588  98 127],389,5,14786,4.022306855277476,20.0,20.0
13676,1,3676,[200 237 211 185 176],236,2,14788,4.021756867011151,0.0,0.0
13677,1,3677,[357  82 173 427 132],269,3,14791,4.021479064709081,20.0,0.0
13678,1,3678,[228  64 172  56 496],716,5,14796,4.021745039412884,40.0,0.0
13679,1,3679,[427  79 588  98 127],18,5,14801,4.022010869565217,20.0,20.0
13680,1,3680,[ 96 427  98 125   1],655,2,14803,4.02146155935887,20.0,0.0
13681,1,3681,[127 202 323 195 183],504,3,14806,4.021184139054862,0.0,20.0
13682,1,3682,[427  79 588  98 127],18,5,14811,4.021449904968775,20.0,20.0
13683,1,3683,[427  79 588  98 127],450,5,14816,4.02171552660152,20.0,20.0
13684,1,3684,[300 265  88 176  82],450,4,14820,4.021709633649932,0.0,0.0
13685,1,3685,[202  97  69 245 179],504,3,14823,4.0214324470971246,0.0,0.0
13686,1,3686,[427  79 588  98 127],450,5,14828,4.021697857336588,20.0,20.0
13687,1,3687,[228 748 215  56 245],280,1,14829,4.02087852494577,0.0,0.0
13688,1,3688,[234  69 118 405 301],593,3,14832,4.020601789102738,0.0,0.0
13689,1,3689,[357  89 195   4  50],18,2,14834,4.020054200542005,0.0,20.0
13690,1,3690,[269 237 216 187  70],503,5,14839,4.020319696559198,0.0,0.0
13691,1,3691,[ 82 210 318  98 197],450,3,14842,4.020043336944745,20.0,0.0
13692,1,3692,[172 258  98 191 195],629,4,14846,4.020037909558624,0.0,0.0
13693,1,3693,[427  79 588  98 127],796,5,14851,4.020303194369247,20.0,20.0
13694,1,3694,[546  56  70 111  11],457,3,14854,4.020027063599459,0.0,0.0
13695,1,3695,[427  79 588  98 127],18,5,14859,4.020292207792208,20.0,20.0
13696,1,3696,[427  79 588  98 127],796,5,14864,4.020557208547471,20.0,20.0
13697,1,3697,[215 127 237 294 210],835,4,14868,4.020551649540292,0.0,20.0
13698,1,3698,[ 82 172 222 117 289],786,5,14873,4.020816436874831,0.0,0.0
13699,1,3699,[546 210 588 234 118],450,2,14875,4.02027027027027,0.0,0.0
13700,1,3700,[168 174 197 318 357],18,4,14879,4.020264793299108,20.0,0.0
13701,1,3701,[237 245 258  28 323],504,4,14883,4.020259319286872,0.0,0.0
13702,1,3702,[200 742 294 144  97],450,4,14887,4.020253848231164,0.0,0.0
13703,1,3703,[427  79 588  98 127],389,5,14892,4.020518358531318,20.0,20.0
13704,1,3704,[111 742 100 269 471],174,5,14897,4.020782726045884,0.0,20.0
13705,1,3705,[204  15 187 121 144],796,5,14902,4.021046950890448,0.0,0.0
13706,1,3706,[427  79 588  98 127],716,5,14907,4.02131103318047,20.0,20.0
13707,1,3707,[161 234 210 127 423],457,5,14912,4.021574973031283,0.0,20.0
13708,1,3708,[144 179  50 174 258],655,2,14914,4.021029927204098,0.0,20.0
13709,1,3709,[185  96  25 655 742],504,5,14919,4.021293800539084,0.0,0.0
13710,1,3710,[427  79 588  98 127],450,5,14924,4.021557531662625,20.0,20.0
13711,1,3711,[273 318 288 423  71],450,2,14926,4.021012931034483,20.0,0.0
13712,1,3712,[ 64 257 125 228  28],655,1,14927,4.020199299757609,20.0,0.0
13713,1,3713,[427  79 588  98 127],389,5,14932,4.020463112547119,20.0,20.0
13714,1,3714,[427  79 588  98 127],716,5,14937,4.020726783310902,20.0,20.0
13715,1,3715,[427  79 588  98 127],716,5,14942,4.020990312163617,20.0,20.0
13716,1,3716,[118 197 215 180 318],280,2,14944,4.020446596717783,20.0,0.0
13717,1,3717,[427  79 588  98 127],389,5,14949,4.020710059171598,20.0,20.0
13718,1,3718,[143 546 238 655  71],504,4,14953,4.020704490454423,0.0,0.0
13719,1,3719,[ 95 216 185 235 187],450,3,14956,4.020430107526882,0.0,0.0
13720,1,3720,[427  79 588  98 127],389,5,14961,4.020693361999463,20.0,20.0
13721,1,3721,[546 742 100 215 286],280,3,14964,4.020419129500269,0.0,40.0
13722,1,3722,[202  25 235 286 423],450,3,14967,4.020145044319097,0.0,20.0
13723,1,3723,[  1 276  50 195 202],256,3,14970,4.019871106337272,0.0,20.0
13724,1,3724,[427  79 588  98 127],389,5,14975,4.02013422818792,20.0,20.0
13725,1,3725,[427  79 588  98 127],389,5,14980,4.020397208803006,20.0,20.0
13726,1,3726,[427  79 588  98 127],18,5,14985,4.020660048296217,20.0,20.0
13727,1,3727,[288 196 153 403 191],450,4,14989,4.020654506437769,0.0,0.0
13728,1,3728,[215 187 172 286 216],655,3,14992,4.020380799141861,0.0,20.0
13729,1,3729,[427  79 588  98 127],18,5,14997,4.0206434316353885,20.0,20.0
13730,1,3730,[568 204 427 257  28],655,1,14998,4.019833824711873,20.0,0.0
13731,1,3731,[427  79 588  98 127],389,5,15003,4.020096463022508,20.0,20.0
13732,1,3732,[427  79 588  98 127],389,5,15008,4.0203589606214845,20.0,20.0
13733,1,3733,[194  22  70 176 318],11,4,15012,4.0203535083020885,20.0,0.0
13734,1,3734,[ 50 183 435 496 235],450,4,15016,4.020348058902276,20.0,20.0
13735,1,3735,[427  79 588  98 127],450,5,15021,4.020610278372591,20.0,20.0
13736,1,3736,[323 125 403 322   4],280,1,15022,4.01980198019802,0.0,0.0
13737,1,3737,[427  79 588  98 127],796,5,15027,4.020064205457464,20.0,20.0
13738,1,3738,[300 211 269 204 118],450,4,15031,4.020058839261835,0.0,0.0
13739,1,3739,[323 294 151 117 176],796,3,15034,4.019786096256684,0.0,0.0
13740,1,3740,[173 181 234 282  50],457,5,15039,4.020048115477145,0.0,20.0
13741,1,3741,[228 222 275 173 172],23,5,15044,4.020309994655265,0.0,20.0
13742,1,3742,[427  79 588  98 127],796,5,15049,4.020571733903286,20.0,20.0
13743,1,3743,[294 121 117 144   4],450,3,15052,4.020299145299146,0.0,0.0
13744,1,3744,[288 161 195 143 211],504,5,15057,4.020560747663551,0.0,0.0
13745,1,3745,[427  79 588  98 127],389,5,15062,4.020822210357715,20.0,20.0
13746,1,3746,[111  69 168 211 588],796,4,15066,4.020816653322658,0.0,0.0
13747,1,3747,[427  79 588  98 127],450,5,15071,4.021077908217716,20.0,20.0
13748,1,3748,[427  79 588  98 127],18,5,15076,4.021339023739664,20.0,20.0
13749,1,3749,[  4 258 294  12 323],796,3,15079,4.021066666666667,0.0,0.0
13750,1,3750,[427  79 588  98 127],450,5,15084,4.021327645961077,20.0,20.0
13751,1,3751,[222 286 117 125 678],344,1,15085,4.020522388059701,0.0,20.0
13752,1,3752,[258 191 423 496 125],450,5,15090,4.0207833733013585,20.0,0.0
13753,1,3753,[427  79 588  98 127],450,5,15095,4.021044219499201,20.0,20.0
13754,1,3754,[748 269  28 258 655],450,5,15100,4.021304926764314,0.0,0.0
13755,1,3755,[210 118 222 275  82],457,5,15105,4.021565495207668,0.0,20.0
13756,1,3756,[427  79 588  98 127],18,5,15110,4.021825924940112,20.0,20.0
13757,1,3757,[ 56 403   4 228 258],450,4,15114,4.021820117083555,0.0,0.0
13758,1,3758,[210 211 328  97  79],796,2,15116,4.021282255919127,0.0,0.0
13759,1,3759,[427  79 588  98 127],796,5,15121,4.021542553191489,20.0,20.0
13760,1,3760,[427  79 588  98 127],389,5,15126,4.021802712044669,20.0,20.0
13761,1,3761,[471 118  88 179 742],577,1,15127,4.020999468367889,0.0,0.0
13762,1,3762,[427  79 588  98 127],18,5,15132,4.021259633271326,20.0,20.0
13763,1,3763,[289 183 210  50 300],655,2,15134,4.020722635494155,0.0,20.0
13764,1,3764,[427  79 588  98 127],796,5,15139,4.020982735723772,20.0,20.0
13765,1,3765,[313 300 197 172 275],796,4,15143,4.020977164099841,0.0,20.0
13766,1,3766,[427  79 588  98 127],18,5,15148,4.021237058667374,20.0,20.0
13767,1,3767,[151 597 117  25  98],450,4,15152,4.021231422505308,0.0,0.0
13768,1,3768,[427  79 588  98 127],18,5,15157,4.021491111700716,20.0,20.0
13769,1,3769,[118 196  56  82 143],457,5,15162,4.021750663129973,0.0,0.0
13770,1,3770,[127 294  56 273 276],629,3,15165,4.021479713603819,0.0,20.0
13771,1,3771,[216   1 237 204 423],655,1,15166,4.02067868504772,0.0,0.0
13772,1,3772,[742 603 496 204 333],796,4,15170,4.020673204346673,40.0,0.0
13773,1,3773,[427  79 588  98 127],716,5,15175,4.0209326974032855,20.0,20.0
13774,1,3774,[ 11   7 183 187 180],450,5,15180,4.021192052980132,0.0,0.0
13775,1,3775,[234 301  50 151 275],796,3,15183,4.020921610169491,0.0,40.0
13776,1,3776,[427  79 588  98 127],389,5,15188,4.02118083134763,20.0,20.0
13777,1,3777,[195 228 117 286 182],655,1,15189,4.020381154049762,0.0,20.0
13778,1,3778,[318  96   7 216 237],450,5,15194,4.020640381053188,20.0,0.0
13779,1,3779,[427  79 588  98 127],450,5,15199,4.0208994708994705,20.0,20.0
13780,1,3780,[427  79 588  98 127],450,5,15204,4.021158423697434,20.0,20.0
13781,1,3781,[268 204 238 111   9],174,5,15209,4.021417239555791,0.0,0.0
13782,1,3782,[100 245 313 117 508],280,1,15210,4.020618556701031,0.0,20.0
13783,1,3783,[257  56  96 222 423],457,4,15214,4.0206131078224105,0.0,0.0
13784,1,3784,[427  79 588  98 127],450,5,15219,4.0208718626155875,20.0,20.0
13785,1,3785,[427  79 588  98 127],18,5,15224,4.021130480718436,20.0,20.0
13786,1,3786,[427  79 588  98 127],450,5,15229,4.021388962239239,20.0,20.0
13787,1,3787,[179 211 301 196  71],535,5,15234,4.021647307286167,0.0,0.0
13788,1,3788,[427  79 588  98 127],796,5,15239,4.021905515967274,20.0,20.0
13789,1,3789,[301 143 172 258  15],450,4,15243,4.021899736147757,0.0,0.0
13790,1,3790,[427  79 588  98 127],716,5,15248,4.022157742020575,20.0,20.0
13791,1,3791,[132  71 202 185 143],23,2,15250,4.02162447257384,0.0,0.0
13792,1,3792,[427  79 588  98 127],18,5,15255,4.021882414974954,20.0,20.0
13793,1,3793,[427  79 588  98 127],450,5,15260,4.022140221402214,20.0,20.0
13794,1,3794,[427  25 328 191 322],450,4,15264,4.0221343873517785,20.0,0.0
13795,1,3795,[427  79 588  98 127],18,5,15269,4.022391991570074,20.0,20.0
13796,1,3796,[427  79 588  98 127],450,5,15274,4.022649460100079,20.0,20.0
13797,1,3797,[427  79 588  98 127],18,5,15279,4.022906793048973,20.0,20.0
13798,1,3798,[191 118 515 282  11],716,3,15282,4.022637536193735,0.0,0.0
13799,1,3799,[215 288 313 200 265],655,2,15284,4.022105263157894,0.0,0.0
13800,1,3800,[427  79 588  98 127],716,5,15289,4.022362536174691,20.0,20.0
13801,1,3801,[427  79 588  98 127],18,5,15294,4.022619673855865,20.0,20.0
13802,1,3802,[288  12 423 385 286],280,5,15299,4.022876676308178,0.0,20.0
13803,1,3803,[427 143  79 238 385],23,4,15303,4.0228706624605675,20.0,0.0
13804,1,3804,[ 22 200 210  50 132],655,2,15305,4.02233902759527,0.0,20.0
13805,1,3805,[  4 483 111 143 179],450,3,15308,4.0220704151339985,0.0,0.0
13806,1,3806,[179 132 216 268 168],269,4,15312,4.022064617809298,0.0,0.0
13807,1,3807,[655 202 288 187 357],655,2,15314,4.021533613445378,0.0,0.0
13808,1,3808,[427  79 588  98 127],716,5,15319,4.021790496193226,20.0,20.0
13809,1,3809,[179 546  28  88 132],577,2,15321,4.021259842519685,0.0,0.0
13810,1,3810,[195 427 496  98 597],796,5,15326,4.021516662293362,40.0,0.0
13811,1,3811,[427  79 588  98 127],796,5,15331,4.021773347324239,20.0,20.0
13812,1,3812,[234 322 475 435 135],629,4,15335,4.021767637031209,0.0,0.0
13813,1,3813,[427  79 588  98 127],450,5,15340,4.022024121657053,20.0,20.0
13814,1,3814,[427  79 588  98 127],389,5,15345,4.022280471821756,20.0,20.0
13815,1,3815,[ 25 238   1  71 427],18,4,15349,4.02227463312369,20.0,0.0
13816,1,3816,[427  79 588  98 127],796,5,15354,4.0225307833377,20.0,20.0
13817,1,3817,[427  79 588  98 127],796,5,15359,4.022786799371398,20.0,20.0
13818,1,3818,[427  79 588  98 127],389,5,15364,4.023042681330191,20.0,20.0
13819,1,3819,[655 200 546 127 748],436,2,15366,4.022513089005235,0.0,20.0
13820,1,3820,[427  79 588  98 127],18,5,15371,4.022768908662654,20.0,20.0
13821,1,3821,[ 82 174 211 423  50],18,4,15375,4.02276295133438,0.0,20.0
13822,1,3822,[222 588 173 121 603],796,5,15380,4.0230185718022495,20.0,0.0
13823,1,3823,[427  79 588  98 127],716,5,15385,4.023274058577406,20.0,20.0
13824,1,3824,[ 15 202 180 275  11],457,5,15390,4.023529411764706,0.0,20.0
13825,1,3825,[210 515 172 174 222],655,2,15392,4.023000522739153,0.0,0.0
13826,1,3826,[121 234 179 588 294],457,4,15396,4.022994512673112,0.0,0.0
13827,1,3827,[ 95 121 100  79  82],796,3,15399,4.0227272727272725,0.0,20.0
13828,1,3828,[427  79 588  98 127],389,5,15404,4.022982501958736,20.0,20.0
13829,1,3829,[117 322 318 118 210],593,3,15407,4.022715404699739,20.0,0.0
13830,1,3830,[318 132 423 216 235],280,5,15412,4.022970503784912,20.0,0.0
13831,1,3831,[ 98  25 655 182 301],593,2,15414,4.022442588726514,0.0,0.0
13832,1,3832,[  4  98 216 265 385],786,5,15419,4.022697625880511,0.0,0.0
13833,1,3833,[143 153 222  82 182],655,2,15421,4.022170057381325,0.0,0.0
13834,1,3834,[427  79 588  98 127],716,5,15426,4.0224250325945246,20.0,20.0
13835,1,3835,[427  79 588  98 127],796,5,15431,4.022679874869656,20.0,20.0
13836,1,3836,[176 132 515 403  56],269,3,15434,4.022413343758144,0.0,0.0
13837,1,3837,[427  79 588  98 127],18,5,15439,4.022668056279312,20.0,20.0
13838,1,3838,[257 405 258 172 289],798,4,15443,4.022662151601979,0.0,0.0
13839,1,3839,[471  50  79 301 403],655,2,15445,4.022135416666667,0.0,20.0
13840,1,3840,[111 210 235 288  15],450,1,15446,4.021348607133559,0.0,0.0
13841,1,3841,[427  79 588  98 127],389,5,15451,4.021603331598126,20.0,20.0
13842,1,3842,[ 28 323   4 313 234],796,2,15453,4.021077283372366,0.0,0.0
13843,1,3843,[427  79 588  98 127],450,5,15458,4.021331945889698,20.0,20.0
13844,1,3844,[427  79 588  98 127],450,5,15463,4.021586475942783,20.0,20.0
13845,1,3845,[427  79 588  98 127],389,5,15468,4.021840873634946,20.0,20.0
13846,1,3846,[200   1 211 173  89],5,4,15472,4.0218351962568235,0.0,0.0
13847,1,3847,[186 234 300 191  11],693,1,15473,4.021049896049896,0.0,0.0
13848,1,3848,[322 655 405 197  71],450,4,15477,4.021044427123928,0.0,0.0
13849,1,3849,[117 234  50   9  11],457,5,15482,4.021298701298702,0.0,20.0
13850,1,3850,[427  79 588  98 127],796,5,15487,4.021552843417294,20.0,20.0
13851,1,3851,[427  79 588  98 127],716,5,15492,4.021806853582555,20.0,20.0
13852,1,3852,[427  79 588  98 127],716,5,15497,4.022060731897223,20.0,20.0
13853,1,3853,[427  79 588  98 127],796,5,15502,4.022314478463934,20.0,20.0
13854,1,3854,[237  25  50 289 179],655,2,15504,4.021789883268482,0.0,20.0
13855,1,3855,[427  89   4 228 496],450,4,15508,4.021784232365145,40.0,0.0
13856,1,3856,[427  79 588  98 127],796,5,15513,4.022037853253824,20.0,20.0
13857,1,3857,[222 483 215 172 228],280,1,15514,4.021254536029031,0.0,0.0
13858,1,3858,[181 118 235 471  22],344,0,15514,4.020212490282456,0.0,0.0
13859,1,3859,[216 191 185 215 202],796,5,15519,4.020466321243523,0.0,0.0
13860,1,3860,[ 98 597 294 228 127],457,3,15522,4.02020202020202,0.0,20.0
13861,1,3861,[202 132  12 174 172],344,5,15527,4.020455722423614,0.0,0.0
13862,1,3862,[ 50 235 153 172  89],23,4,15531,4.020450427129174,0.0,20.0
13863,1,3863,[427  79 588  98 127],18,5,15536,4.020703933747412,20.0,20.0
13864,1,3864,[427  79 588  98 127],716,5,15541,4.020957309184993,20.0,20.0
13865,1,3865,[195  69 357   1  28],330,4,15545,4.0209518882565956,0.0,0.0
13866,1,3866,[ 22 196 282  96  15],796,5,15550,4.021205068528575,0.0,0.0
13867,1,3867,[427  79 588  98 127],716,5,15555,4.021458117890383,20.0,20.0
13868,1,3868,[191  97 172 427 357],151,4,15559,4.02145257172396,20.0,0.0
13869,1,3869,[135 174 185  71 186],389,3,15562,4.021188630490956,0.0,0.0
13870,1,3870,[ 79 202 135 185 168],716,4,15566,4.021183156807027,0.0,0.0
13871,1,3871,[427  79 588  98 127],18,5,15571,4.021435950413223,20.0,20.0
13872,1,3872,[427  79 588  98 127],18,5,15576,4.021688613477924,20.0,20.0
13873,1,3873,[427  79 588  98 127],450,5,15581,4.02194114610222,20.0,20.0
13874,1,3874,[483 237  70 151 132],535,5,15586,4.022193548387097,0.0,0.0
13875,1,3875,[427  79 588  98 127],796,5,15591,4.022445820433436,20.0,20.0
13876,1,3876,[427  79 588  98 127],389,5,15596,4.022697962342017,20.0,20.0
13877,1,3877,[427  79 588  98 127],18,5,15601,4.022949974213512,20.0,20.0
13878,1,3878,[238 515 118 161  69],716,3,15604,4.022686259345192,0.0,0.0
13879,1,3879,[427  79 588  98 127],796,5,15609,4.022938144329897,20.0,20.0
13880,1,3880,[427  79 588  98 127],450,5,15614,4.023189899510435,20.0,20.0
13881,1,3881,[323 121 125 181 196],796,4,15618,4.023183925811438,0.0,0.0
13882,1,3882,[427  79 588  98 127],18,5,15623,4.023435488024723,20.0,20.0
13883,1,3883,[427  79 588  98 127],18,5,15628,4.0236869207003085,20.0,20.0
13884,1,3884,[427  79 588  98 127],389,5,15633,4.023938223938224,20.0,20.0
13885,1,3885,[  7  69 237  89 268],344,2,15635,4.023417395779722,0.0,0.0
13886,1,3886,[  1 121 483  97 143],457,5,15640,4.023668639053255,0.0,0.0
13887,1,3887,[427  79 588  98 127],450,5,15645,4.02391975308642,20.0,20.0
13888,1,3888,[ 70 173 174 423 181],503,5,15650,4.024170737978915,0.0,0.0
13889,1,3889,[427  79 588  98 127],450,5,15655,4.0244215938303345,20.0,20.0
13890,1,3890,[427  79 588  98 127],450,5,15660,4.024672320740169,20.0,20.0
13891,1,3891,[196 496 483  89 151],796,5,15665,4.024922918807811,20.0,0.0
13892,1,3892,[427  79 588  98 127],796,5,15670,4.025173388132545,20.0,20.0
13893,1,3893,[161  56 196  88 742],450,5,15675,4.02542372881356,0.0,0.0
13894,1,3894,[127 117 222 187  97],450,4,15679,4.025417201540437,0.0,20.0
13895,1,3895,[ 96 174 191 742 210],577,4,15683,4.02541067761807,0.0,0.0
13896,1,3896,[265 405 235 216  50],716,4,15687,4.02540415704388,0.0,20.0
13897,1,3897,[427  79 588  98 127],389,5,15692,4.025654181631606,20.0,20.0
13898,1,3898,[204 111 182 268 195],269,2,15694,4.025134649910234,0.0,0.0
13899,1,3899,[427  79 588  98 127],716,5,15699,4.025384615384615,20.0,20.0
13900,1,3900,[234 276 181  71  79],280,3,15702,4.025121763650346,0.0,0.0
13901,1,3901,[216  64 168 423 118],457,5,15707,4.025371604305485,20.0,0.0
13902,1,3902,[151 153 200 111 143],269,2,15709,4.02485267742762,0.0,0.0
13903,1,3903,[117  25 300 187 302],450,4,15713,4.02484631147541,0.0,0.0
13904,1,3904,[427  79 588  98 127],716,5,15718,4.025096030729833,20.0,20.0
13905,1,3905,[234  25 269   8 181],655,0,15718,4.024065540194573,0.0,0.0
13906,1,3906,[427  79 588  98 127],450,5,15723,4.024315331456361,20.0,20.0
13907,1,3907,[427  79 588  98 127],389,5,15728,4.024564994882293,20.0,20.0
13908,1,3908,[427  79 588  98 127],450,5,15733,4.024814530570478,20.0,20.0
13909,1,3909,[161  82 185  12 275],796,4,15737,4.024808184143223,0.0,20.0
13910,1,3910,[ 95 151 496 215 127],344,4,15741,4.024801840961391,20.0,20.0
13911,1,3911,[427  79 588  98 127],18,5,15746,4.025051124744376,20.0,20.0
13912,1,3912,[  4 194 288  12 546],457,4,15750,4.025044722719142,0.0,0.0
13913,1,3913,[153 234 181 237 202],18,1,15751,4.024271844660194,0.0,0.0
13914,1,3914,[427  79 588  98 127],796,5,15756,4.024521072796935,20.0,20.0
13915,1,3915,[161  11 202 197 204],716,4,15760,4.024514811031665,0.0,0.0
13916,1,3916,[427  79 588  98 127],389,5,15765,4.024763849885116,20.0,20.0
13917,1,3917,[427  79 588  98 127],389,5,15770,4.025012761613068,20.0,20.0
13918,1,3918,[483 323   9  50  69],280,3,15773,4.024751212043888,0.0,20.0
13919,1,3919,[427  79 588  98 127],796,5,15778,4.025,20.0,20.0
13920,1,3920,[427  79 588  98 127],716,5,15783,4.025248661055853,20.0,20.0
13921,1,3921,[300 742  88 273 357],450,4,15787,4.025242223355431,0.0,0.0
13922,1,3922,[216  11 173 191  95],344,4,15791,4.025235788937038,0.0,0.0
13923,1,3923,[300 172 191 215 185],655,3,15794,4.024974515800204,0.0,0.0
13924,1,3924,[427  79 588  98 127],18,5,15799,4.025222929936306,20.0,20.0
13925,1,3925,[427  79 588  98 127],716,5,15804,4.025471217524197,20.0,20.0
13926,1,3926,[286 385 427 144 655],796,3,15807,4.025210084033613,20.0,20.0
13927,1,3927,[427  79 588  98 127],389,5,15812,4.025458248472505,20.0,20.0
13928,1,3928,[427  79 588  98 127],796,5,15817,4.025706286586918,20.0,20.0
13929,1,3929,[  9  12 322 132 282],796,3,15820,4.025445292620865,0.0,0.0
13930,1,3930,[427  79 588  98 127],796,5,15825,4.025693207835157,20.0,20.0
13931,1,3931,[211 132 405 111 234],450,4,15829,4.025686673448627,0.0,0.0
13932,1,3932,[427  79 588  98 127],18,5,15834,4.025934401220442,20.0,20.0
13933,1,3933,[  9  15   4 385 258],655,0,15834,4.02491103202847,0.0,0.0
13934,1,3934,[427  79 588  98 127],796,5,15839,4.025158831003812,20.0,20.0
13935,1,3935,[427  79 588  98 127],796,5,15844,4.025406504065041,20.0,20.0
13936,1,3936,[204 435  89 301 161],655,1,15845,4.024638049276098,0.0,0.0
13937,1,3937,[143 118  12 151 357],796,5,15850,4.0248857287963435,0.0,0.0
13938,1,3938,[546 197 238 111 655],174,4,15854,4.024879411018025,0.0,0.0
13939,1,3939,[210  82 176 200 197],504,4,15858,4.024873096446701,0.0,0.0
13940,1,3940,[127 195 568 313 288],344,4,15862,4.024866785079929,0.0,20.0
13941,1,3941,[ 88 196  69 127 435],18,2,15864,4.024353120243531,0.0,20.0
13942,1,3942,[237  56 238  88 168],18,2,15866,4.02383971595232,0.0,0.0
13943,1,3943,[471 172   7 132 222],280,2,15868,4.023326572008114,0.0,0.0
13944,1,3944,[427  79 588  98 127],716,5,15873,4.023574144486692,20.0,20.0
13945,1,3945,[603  95 423 275 100],330,5,15878,4.023821591485048,20.0,40.0
13946,1,3946,[427  79 588  98 127],450,5,15883,4.024068913098556,20.0,20.0
13947,1,3947,[ 70 257 286 568 172],330,5,15888,4.024316109422492,0.0,20.0
13948,1,3948,[ 82 172 258   7 153],655,1,15889,4.023550265890099,0.0,0.0
13949,1,3949,[427  79 588  98 127],450,5,15894,4.02379746835443,20.0,20.0
13950,1,3950,[143 235  97  50 185],716,4,15898,4.023791445203746,0.0,20.0
13951,1,3951,[427  79 588  98 127],389,5,15903,4.024038461538462,20.0,20.0
13952,1,3952,[427  79 588  98 127],389,5,15908,4.024285352896534,20.0,20.0
13953,1,3953,[427  79 588  98 127],796,5,15913,4.024532119372787,20.0,20.0
13954,1,3954,[174 173 483 176 202],389,4,15917,4.0245259165613145,0.0,0.0
13955,1,3955,[403 385  56 222 597],457,4,15921,4.024519716885743,0.0,0.0
13956,1,3956,[161 385 191  98  22],796,5,15926,4.024766237048269,0.0,0.0
13957,1,3957,[427  79 588  98 127],716,5,15931,4.025012632642749,20.0,20.0
13958,1,3958,[172  82 210 127 742],655,2,15933,4.024501136650669,0.0,20.0
13959,1,3959,[427  79 588  98 127],450,5,15938,4.024747474747475,20.0,20.0
13960,1,3960,[427  79 588  98 127],389,5,15943,4.0249936884625095,20.0,20.0
13961,1,3961,[427  79 588  98 127],389,5,15948,4.025239777889954,20.0,20.0
13962,1,3962,[427  79 588  98 127],18,5,15953,4.025485743123896,20.0,20.0
13963,1,3963,[427  79 588  98 127],450,5,15958,4.025731584258325,20.0,20.0
13964,1,3964,[427  79 588  98 127],389,5,15963,4.025977301387138,20.0,20.0
13965,1,3965,[153 357  12 173 111],639,0,15963,4.024962178517398,0.0,0.0
13966,1,3966,[ 89 117 204 475 301],296,4,15967,4.0249558860599945,0.0,0.0
13967,1,3967,[204 176 300 294  96],716,3,15970,4.024697580645161,0.0,0.0
13968,1,3968,[273 222 403 748 125],450,3,15973,4.024439405391786,0.0,0.0
13969,1,3969,[427  79 588  98 127],450,5,15978,4.024685138539043,20.0,20.0
13970,1,3970,[204 588 286 234 471],280,2,15980,4.024175270712667,0.0,20.0
13971,1,3971,[234 328 186 245 183],450,3,15983,4.0239174219536755,0.0,0.0
13972,1,3972,[427  79 588  98 127],796,5,15988,4.024163100931286,20.0,20.0
13973,1,3973,[427  79 588  98 127],389,5,15993,4.024408656265727,20.0,20.0
13974,1,3974,[427  79 588  98 127],389,5,15998,4.0246540880503145,20.0,20.0
13975,1,3975,[234 423 427 143 176],151,4,16002,4.024647887323944,20.0,0.0
13976,1,3976,[216 111 121 202  97],65,5,16007,4.024893135529293,0.0,0.0
13977,1,3977,[ 22 132 182 183 100],280,2,16009,4.024384112619407,0.0,20.0
13978,1,3978,[427  79 588  98 127],716,5,16014,4.024629303845187,20.0,20.0
13979,1,3979,[100 151 173 568 186],450,4,16018,4.0246231155778895,0.0,20.0
13980,1,3980,[  1 118 245  56 294],796,2,16020,4.024114544084401,0.0,0.0
13981,1,3981,[427  79 588  98 127],796,5,16025,4.02435961828227,20.0,20.0
13982,1,3982,[427  79 588  98 127],18,5,16030,4.024604569420035,20.0,20.0
13983,1,3983,[180 235 161  11   8],280,5,16035,4.024849397590361,0.0,0.0
13984,1,3984,[197 151 302 117 196],401,2,16037,4.0243412797992475,0.0,0.0
13985,1,3985,[427  79 588  98 127],450,5,16042,4.024586051179127,20.0,20.0
13986,1,3986,[427  79 588  98 127],796,5,16047,4.024830699774267,20.0,20.0
13987,1,3987,[176 182 210 216 186],457,5,16052,4.025075225677031,0.0,0.0
13988,1,3988,[173 423 168 210  79],535,4,16056,4.025068939583855,0.0,0.0
13989,1,3989,[118  88 100 471 183],655,1,16057,4.024310776942356,0.0,20.0
13990,1,3990,[ 11 173 405 318 508],280,2,16059,4.023803558005512,20.0,0.0
13991,1,3991,[427 588  79  98 127],796,5,16064,4.024048096192384,20.0,20.0
13992,1,3992,[427 588  79  98 127],18,5,16069,4.024292511895817,20.0,20.0
13993,1,3993,[403 153 318  70  96],269,1,16070,4.023535302954432,20.0,0.0
13994,1,3994,[427 588  79  98 127],716,5,16075,4.02377972465582,20.0,20.0
13995,1,3995,[427 588  79  98 127],796,5,16080,4.024024024024024,20.0,20.0
13996,1,3996,[427 588  79  98 127],450,5,16085,4.024268201150863,20.0,20.0
13997,1,3997,[427 588  79  98 127],716,5,16090,4.024512256128064,20.0,20.0
13998,1,3998,[427 588  79  98 127],389,5,16095,4.024756189047261,20.0,20.0
13999,1,3999,[  7   9 318 125 202],65,4,16099,4.02475,20.0,0.0
14000,1,4000,[427 588  79  98 127],450,5,16104,4.02499375156211,20.0,20.0
14001,1,4001,[427 588  79  98 127],796,5,16109,4.025237381309346,20.0,20.0
14002,1,4002,[427 588  79  98 127],389,5,16114,4.025480889333,20.0,20.0
14003,1,4003,[258 483 282 182 322],796,4,16118,4.025474525474525,0.0,0.0
14004,1,4004,[427 588  79  98 127],716,5,16123,4.025717852684145,20.0,20.0
14005,1,4005,[ 97 111 174  12 238],450,5,16128,4.025961058412381,0.0,0.0
14006,1,4006,[302 185 235 318 471],450,4,16132,4.0259545794859,20.0,0.0
14007,1,4007,[125 273 132 423 182],436,4,16136,4.025948103792415,0.0,0.0
14008,1,4008,[427 588  79  98 127],18,5,16141,4.026191070092293,20.0,20.0
14009,1,4009,[191 483  22 100 276],316,4,16145,4.026184538653367,0.0,20.0
14010,1,4010,[385 121 182 282   9],796,4,16149,4.026178010471204,0.0,0.0
14011,1,4011,[197  96 100 323 202],280,1,16150,4.02542372881356,0.0,20.0
14012,1,4012,[257 183 135 179 357],457,4,16154,4.025417393471218,0.0,0.0
14013,1,4013,[100 655 357 197 496],269,5,16159,4.025660189337319,20.0,20.0
14014,1,4014,[  7  98  89 318 100],269,3,16162,4.025404732254048,20.0,20.0
14015,1,4015,[175 234 182 276  56],269,4,16166,4.025398406374502,0.0,0.0
14016,1,4016,[427 588  79  98 127],450,5,16171,4.0256410256410255,20.0,20.0
14017,1,4017,[427 588  79  98 127],796,5,16176,4.0258835241413635,20.0,20.0
14018,1,4018,[427 588  79  98 127],716,5,16181,4.0261259019656634,20.0,20.0
14019,1,4019,[204 385 127 173 100],450,5,16186,4.02636815920398,0.0,40.0
14020,1,4020,[427 588  79  98 127],18,5,16191,4.026610295946282,20.0,20.0
14021,1,4021,[143 186 181 216 121],693,2,16193,4.026106414719045,0.0,0.0
14022,1,4022,[427 588  79  98 127],450,5,16198,4.026348496147154,20.0,20.0
14023,1,4023,[121 210 100 228  11],457,5,16203,4.026590457256461,0.0,20.0
14024,1,4024,[405 191 144 196 210],450,4,16207,4.026583850931677,0.0,0.0
14025,1,4025,[427 588  79  98 127],796,5,16212,4.026825633383011,20.0,20.0
14026,1,4026,[597 111 405 238   8],593,2,16214,4.026322324310901,0.0,0.0
14027,1,4027,[483 144 282 403 161],450,4,16218,4.026315789473684,0.0,0.0
14028,1,4028,[435   4  64  25 111],151,5,16223,4.026557458426408,20.0,0.0
14029,1,4029,[427 588  79  98 127],450,5,16228,4.026799007444168,20.0,20.0
14030,1,4030,[ 97  12 597  96 125],796,4,16232,4.026792359216075,0.0,0.0
14031,1,4031,[427 588  79  98 127],716,5,16237,4.02703373015873,20.0,20.0
14032,1,4032,[427 588  79  98 127],389,5,16242,4.027274981403422,20.0,20.0
14033,1,4033,[100 546 435 194 197],450,5,16247,4.027516113039167,0.0,20.0
14034,1,4034,[322 300 204 568 405],450,5,16252,4.027757125154895,0.0,0.0
14035,1,4035,[204  97   7   1 302],655,1,16253,4.027006937561943,0.0,0.0
14036,1,4036,[427 588  79  98 127],796,5,16258,4.0272479564032695,20.0,20.0
14037,1,4037,[238  88 179  12 151],457,5,16263,4.027488855869242,0.0,0.0
14038,1,4038,[180 288  89 174 132],457,5,16268,4.027729636048527,0.0,0.0
14039,1,4039,[427 588  79  98 127],716,5,16273,4.027970297029703,20.0,20.0
14040,1,4040,[427 588  79  98 127],716,5,16278,4.028210838901262,20.0,20.0
14041,1,4041,[117 144 195 300 127],292,5,16283,4.028451261751608,0.0,20.0
14042,1,4042,[ 50  56 187 186 194],535,3,16286,4.02819688350235,0.0,20.0
14043,1,4043,[185 294 172 258 234],23,3,16289,4.027942631058358,0.0,0.0
14044,1,4044,[ 15  12 185 508 187],655,2,16291,4.027441285537701,0.0,0.0
14045,1,4045,[427 588  79  98 127],796,5,16296,4.027681660899654,20.0,20.0
14046,1,4046,[  4 405 423 258 655],655,0,16296,4.026686434395849,0.0,0.0
14047,1,4047,[117   1 111  28 132],450,5,16301,4.0269268774703555,0.0,0.0
14048,1,4048,[318  22 121  56 423],11,4,16305,4.026920227216596,20.0,0.0
14049,1,4049,[185  50 179 100 143],457,5,16310,4.027160493827161,0.0,40.0
14050,1,4050,[153  69 403 204 286],655,0,16310,4.026166378671933,0.0,20.0
14051,1,4051,[151 100 197  98 405],151,3,16313,4.025913129318855,0.0,20.0
14052,1,4052,[313 204 181 172 200],280,1,16314,4.025166543301259,0.0,0.0
14053,1,4053,[ 50 282 235 588 168],401,0,16314,4.024173655648742,0.0,20.0
14054,1,4054,[258 435 271 301 186],655,0,16314,4.023181257706535,0.0,0.0
14055,1,4055,[748 200 111 175 100],151,2,16316,4.022682445759369,0.0,20.0
14056,1,4056,[195 235 202 228  71],450,3,16319,4.022430367266453,0.0,0.0
14057,1,4057,[245 405 186  28  96],450,4,16323,4.022424839822572,0.0,0.0
14058,1,4058,[211 180 196 181 546],786,5,16328,4.022665681202267,0.0,0.0
14059,1,4059,[427  79 588  98 127],18,5,16333,4.022906403940887,20.0,20.0
14060,1,4060,[427  79 588  98 127],389,5,16338,4.023147008126077,20.0,20.0
14061,1,4061,[ 56 318 118 187 271],655,2,16340,4.022648941408173,20.0,0.0
14062,1,4062,[427  79 588  98 127],389,5,16345,4.022889490524244,20.0,20.0
14063,1,4063,[427  79 588  98 127],389,5,16350,4.023129921259843,20.0,20.0
14064,1,4064,[427  79 588  98 127],450,5,16355,4.023370233702337,20.0,20.0
14065,1,4065,[ 22  88 183  79  15],450,4,16359,4.0233644859813085,0.0,0.0
14066,1,4066,[427  79 588  98 127],796,5,16364,4.02360462257192,20.0,20.0
14067,1,4067,[215  71   8 151 125],152,5,16369,4.023844641101278,0.0,0.0
14068,1,4068,[118 237 181  28  95],577,4,16373,4.02383878102728,0.0,0.0
14069,1,4069,[427  79 588  98 127],18,5,16378,4.024078624078624,20.0,20.0
14070,1,4070,[ 95  12 588 183 742],344,4,16382,4.024072709408008,0.0,0.0
14071,1,4071,[191 168 302 132 603],269,4,16386,4.024066797642436,20.0,0.0
14072,1,4072,[427  79 588  98 127],796,5,16391,4.024306408053032,20.0,20.0
14073,1,4073,[202 210 655  22 423],716,5,16396,4.0245459008345605,0.0,0.0
14074,1,4074,[427  79 588  98 127],18,5,16401,4.02478527607362,20.0,20.0
14075,1,4075,[427  79 588  98 127],796,5,16406,4.0250245338567225,20.0,20.0
14076,1,4076,[ 50  12 191 215 318],655,3,16409,4.024773117488349,20.0,20.0
14077,1,4077,[427  79 588  98 127],450,5,16414,4.025012260912212,20.0,20.0
14078,1,4078,[ 97 215   4 195 228],655,0,16414,4.024025496445208,0.0,0.0
14079,1,4079,[427  79 588  98 127],450,5,16419,4.024264705882353,20.0,20.0
14080,1,4080,[427  79 588  98 127],389,5,16424,4.024503798088704,20.0,20.0
14081,1,4081,[385 117 161 211  56],450,5,16429,4.024742773150416,0.0,0.0
14082,1,4082,[427  79 588  98 127],18,5,16434,4.0249816311535636,20.0,20.0
14083,1,4083,[427  79 588  98 127],389,5,16439,4.025220372184133,20.0,20.0
14084,1,4084,[471 322   1   9 357],401,2,16441,4.024724602203182,0.0,0.0
14085,1,4085,[313 496 234 238 275],796,3,16444,4.024473813020069,20.0,20.0
14086,1,4086,[100  56 211 195 121],450,4,16448,4.024467824810374,0.0,20.0
14087,1,4087,[427  79 588  98 127],450,5,16453,4.024706457925636,20.0,20.0
14088,1,4088,[427  79 588  98 127],716,5,16458,4.02494497432135,20.0,20.0
14089,1,4089,[427  79 588  98 127],450,5,16463,4.02518337408313,20.0,20.0
14090,1,4090,[427  79 588  98 127],716,5,16468,4.025421657296505,20.0,20.0
14091,1,4091,[ 22 302 181 288 100],655,1,16469,4.024682306940371,0.0,20.0
14092,1,4092,[111 191 235 222 655],716,4,16473,4.024676276569753,0.0,0.0
14093,1,4093,[ 98 185   7 508 125],655,2,16475,4.0241817293600395,0.0,0.0
14094,1,4094,[427  79 588  98 127],18,5,16480,4.024420024420024,20.0,20.0
14095,1,4095,[427  79 588  98 127],389,5,16485,4.024658203125,20.0,20.0
14096,1,4096,[ 82 210 175 333 568],655,0,16485,4.023675860385648,0.0,0.0
14097,1,4097,[427  79 588  98 127],450,5,16490,4.023914104441191,20.0,20.0
14098,1,4098,[288 194  71 313 282],450,3,16493,4.023664308367895,0.0,0.0
14099,1,4099,[427  79 588  98 127],18,5,16498,4.02390243902439,20.0,20.0
14100,1,4100,[  4   8  96 182 234],280,2,16500,4.023408924652524,0.0,0.0
14101,1,4101,[423 195 187 322 174],450,5,16505,4.0236470014627015,0.0,0.0
14102,1,4102,[427  79 588  98 127],796,5,16510,4.0238849622227635,20.0,20.0
14103,1,4103,[ 11 257 215  95 275],330,5,16515,4.024122807017544,0.0,20.0
14104,1,4104,[427  79 588  98 127],389,5,16520,4.02436053593179,20.0,20.0
14105,1,4105,[427  79 588  98 127],796,5,16525,4.0245981490501705,20.0,20.0
14106,1,4106,[300 265  22 483 515],807,5,16530,4.024835646457268,0.0,0.0
14107,1,4107,[427  79 588  98 127],450,5,16535,4.0250730282375855,20.0,20.0
14108,1,4108,[471 182 172  97 191],450,5,16540,4.025310294475542,0.0,0.0
14109,1,4109,[111 302 121 135   1],401,1,16541,4.024574209245742,0.0,0.0
14110,1,4110,[427  79 588  98 127],716,5,16546,4.024811481391389,20.0,20.0
14111,1,4111,[111 273 191 597  96],344,4,16550,4.0248054474708175,0.0,0.0
14112,1,4112,[427  79 588  98 127],450,5,16555,4.025042548018478,20.0,20.0
14113,1,4113,[427  79 588  98 127],450,5,16560,4.025279533300924,20.0,20.0
14114,1,4114,[  4 185 588   1 357],716,4,16564,4.025273390036452,0.0,0.0
14115,1,4115,[ 69 183 180  79 174],716,3,16567,4.025024295432459,0.0,0.0
14116,1,4116,[222 195 237 196 111],786,5,16572,4.025261112460529,0.0,0.0
14117,1,4117,[427  79 588  98 127],450,5,16577,4.025497814473045,20.0,20.0
14118,1,4118,[ 70   4 125 742 403],280,2,16579,4.025006069434329,0.0,0.0
14119,1,4119,[427  79 588  98 127],18,5,16584,4.025242718446602,20.0,20.0
14120,1,4120,[427  79 588  98 127],716,5,16589,4.02547925260859,20.0,20.0
14121,1,4121,[471 597 318 269 191],450,5,16594,4.025715672003882,20.0,0.0
14122,1,4122,[  7  69  88  96 200],655,1,16595,4.024981809362115,0.0,0.0
14123,1,4123,[427  79 588  98 127],796,5,16600,4.025218234723569,20.0,20.0
14124,1,4124,[427  79 588  98 127],18,5,16605,4.025454545454545,20.0,20.0
14125,1,4125,[179  12 215 168 471],450,5,16610,4.025690741638391,0.0,0.0
14126,1,4126,[427  79 588  98 127],716,5,16615,4.025926823358372,20.0,20.0
14127,1,4127,[144 132 121 222  64],655,1,16616,4.025193798449612,20.0,0.0
14128,1,4128,[427  79 588  98 127],716,5,16621,4.025429886170985,20.0,20.0
14129,1,4129,[ 50 195 546 183 294],457,3,16624,4.025181598062954,0.0,20.0
14130,1,4130,[427  79 588  98 127],450,5,16629,4.025417574437182,20.0,20.0
14131,1,4131,[286 289 275 200 117],655,2,16631,4.0249273959341725,0.0,40.0
14132,1,4132,[427  79 588  98 127],450,5,16636,4.02516331962255,20.0,20.0
14133,1,4133,[427  79 588  98 127],450,5,16641,4.0253991291727145,20.0,20.0
14134,1,4134,[121 195 210 302 568],269,0,16641,4.024425634824667,0.0,0.0
14135,1,4135,[427  79 588  98 127],450,5,16646,4.024661508704062,20.0,20.0
14136,1,4136,[427  79 588  98 127],450,5,16651,4.024897268552091,20.0,20.0
14137,1,4137,[475 222 153   7 168],264,5,16656,4.025132914451426,0.0,0.0
14138,1,4138,[427  79 588  98 127],389,5,16661,4.025368446484658,20.0,20.0
14139,1,4139,[282 237 210 216  12],655,1,16662,4.024637681159421,0.0,0.0
14140,1,4140,[427  79 588  98 127],716,5,16667,4.02487321902922,20.0,20.0
14141,1,4141,[427  79 588  98 127],716,5,16672,4.025108643167552,20.0,20.0
14142,1,4142,[182 210 603  25 276],655,3,16675,4.024861211682356,20.0,0.0
14143,1,4143,[322 215 403 300 143],504,4,16679,4.024855212355212,0.0,0.0
14144,1,4144,[427  79 588  98 127],389,5,16684,4.025090470446321,20.0,20.0
14145,1,4145,[273  12 328 333 222],655,1,16685,4.0243608297153886,0.0,0.0
14146,1,4146,[427  79 588  98 127],450,5,16690,4.024596093561611,20.0,20.0
14147,1,4147,[427  79 588  98 127],389,5,16695,4.024831243972999,20.0,20.0
14148,1,4148,[496 204 245 483  98],280,3,16698,4.024584237165582,20.0,0.0
14149,1,4149,[427  79 588  98 127],389,5,16703,4.024819277108434,20.0,20.0
14150,1,4150,[ 50 144 185  70 588],716,4,16707,4.024813298000482,0.0,20.0
14151,1,4151,[228 182   4 546 195],280,1,16708,4.024084778420039,0.0,0.0
14152,1,4152,[222 228 275  11  22],344,3,16711,4.0238381892607755,0.0,20.0
14153,1,4153,[ 96 228  95  71  69],344,3,16714,4.023591718825228,0.0,0.0
14154,1,4154,[215 174 423  89 286],18,3,16717,4.0233453670276775,0.0,20.0
14155,1,4155,[427  79 588  98 127],389,5,16722,4.023580365736285,20.0,20.0
14156,1,4156,[200 300  89   1 125],796,4,16726,4.023574693288429,0.0,0.0
14157,1,4157,[173 197 323 174 135],562,4,16730,4.023569023569023,0.0,0.0
14158,1,4158,[568 257 603   4  88],796,5,16735,4.023803798990142,20.0,0.0
14159,1,4159,[265 385 111 597 322],450,5,16740,4.024038461538462,0.0,0.0
14160,1,4160,[153 211 222  69  50],655,1,16741,4.023311703917328,0.0,20.0
14161,1,4161,[275 427 210 175 257],716,4,16745,4.023306102835176,20.0,20.0
14162,1,4162,[ 12  64 118  15 143],457,5,16750,4.02354071582993,20.0,0.0
14163,1,4163,[187 118 742 182 302],450,4,16754,4.0235350624399615,0.0,0.0
14164,1,4164,[318 603  88  97  25],503,4,16758,4.023529411764706,40.0,0.0
14165,1,4165,[427  79 588  98 127],389,5,16763,4.023763802208354,20.0,20.0
14166,1,4166,[ 69 403  88 194 210],269,1,16764,4.023038156947444,0.0,0.0
14167,1,4167,[427  79 588  98 127],450,5,16769,4.0232725527831095,20.0,20.0
14168,1,4168,[286 423  70 237 301],535,4,16773,4.023266970496522,0.0,20.0
14169,1,4169,[276  82 322 265 195],786,3,16776,4.023021582733813,0.0,0.0
14170,1,4170,[194  15 318 161  98],577,4,16780,4.0230160632941745,20.0,0.0
14171,1,4171,[427  79 588  98 127],796,5,16785,4.023250239693192,20.0,20.0
14172,1,4172,[423 202  50 276 191],786,4,16789,4.023244668104481,0.0,20.0
14173,1,4173,[427  79 588  98 127],796,5,16794,4.023478677527551,20.0,20.0
14174,1,4174,[161 151 235  22 483],457,4,16798,4.023473053892215,0.0,0.0
14175,1,4175,[302 100 403 483 210],450,3,16801,4.023227969348659,0.0,20.0
14176,1,4176,[174 496 183 176 483],911,3,16804,4.022983002154657,20.0,0.0
14177,1,4177,[185 153 176 151 181],389,4,16808,4.022977501196745,0.0,0.0
14178,1,4178,[427  79 588  98 127],18,5,16813,4.023211294568078,20.0,20.0
14179,1,4179,[427  79 588  98 127],450,5,16818,4.023444976076555,20.0,20.0
14180,1,4180,[ 71 216 357 187 423],504,4,16822,4.023439368572112,0.0,0.0
14181,1,4181,[427  79 588  98 127],18,5,16827,4.023672883787661,20.0,20.0
14182,1,4182,[427  79 588  98 127],18,5,16832,4.023906287353574,20.0,20.0
14183,1,4183,[427  79 588  98 127],796,5,16837,4.024139579349904,20.0,20.0
14184,1,4184,[ 98 275 204 211 132],18,4,16841,4.024133811230586,0.0,20.0
14185,1,4185,[ 22 211 318 191 496],450,5,16846,4.024366937410416,40.0,0.0
14186,1,4186,[222 603 183 568 185],655,3,16849,4.024122283257703,20.0,0.0
14187,1,4187,[ 11 328 282 300 288],655,0,16849,4.023161413562559,0.0,0.0
14188,1,4188,[175 204 172 100  98],457,5,16854,4.023394604917641,0.0,20.0
14189,1,4189,[427  79 588  98 127],18,5,16859,4.0236276849642,20.0,20.0
14190,1,4190,[427  79 588  98 127],796,5,16864,4.023860653781914,20.0,20.0
14191,1,4191,[197 271 405 294   4],796,3,16867,4.02361641221374,0.0,0.0
14192,1,4192,[301 194 197 427 196],338,3,16870,4.023372287145242,20.0,0.0
14193,1,4193,[427 271 187 257 168],796,5,16875,4.023605150214593,20.0,0.0
14194,1,4194,[427  79 588  98 127],450,5,16880,4.023837902264601,20.0,20.0
14195,1,4195,[ 82  71 210 238  11],330,5,16885,4.024070543374642,0.0,0.0
14196,1,4196,[427  79 588  98 127],18,5,16890,4.024303073624017,20.0,20.0
14197,1,4197,[427  79 588  98 127],716,5,16895,4.024535493091949,20.0,20.0
14198,1,4198,[427  79 588  98 127],796,5,16900,4.024767801857585,20.0,20.0
14199,1,4199,[143 603 144 194   1],796,4,16904,4.024761904761904,20.0,0.0
14200,1,4200,[427  79 588  98 127],716,5,16909,4.024994049035944,20.0,20.0
14201,1,4201,[427  79 588  98 127],389,5,16914,4.0252260828177056,20.0,20.0
14202,1,4202,[265 100 210 483 427],796,3,16917,4.024982155603141,20.0,20.0
14203,1,4203,[197 228 200 286 132],786,4,16921,4.024976213130352,0.0,20.0
14204,1,4204,[ 56 185 182 597  28],796,4,16925,4.024970273483948,0.0,0.0
14205,1,4205,[427  79 588  98 127],716,5,16930,4.025202092249168,20.0,20.0
14206,1,4206,[427  79 588  98 127],450,5,16935,4.025433800808177,20.0,20.0
14207,1,4207,[161 202 483 588 546],796,5,16940,4.025665399239544,0.0,0.0
14208,1,4208,[427  79 588  98 127],18,5,16945,4.025896887621763,20.0,20.0
14209,1,4209,[427  79 588  98 127],716,5,16950,4.026128266033254,20.0,20.0
14210,1,4210,[427  79 588  98 127],389,5,16955,4.026359534552363,20.0,20.0
14211,1,4211,[ 64  88 237 118 195],330,4,16959,4.0263532763532766,20.0,0.0
14212,1,4212,[427  79 588  98 127],450,5,16964,4.026584381675765,20.0,20.0
14213,1,4213,[179  97  82 258   7],450,4,16968,4.026578073089701,0.0,0.0
14214,1,4214,[427  79 588  98 127],796,5,16973,4.026809015421115,20.0,20.0
14215,1,4215,[172 215 125 183  82],151,2,16975,4.026328273244782,0.0,0.0
14216,1,4216,[427  79 588  98 127],796,5,16980,4.026559165283377,20.0,20.0
14217,1,4217,[  4 238  25 168 471],457,5,16985,4.0267899478425795,0.0,0.0
14218,1,4218,[211 435 185  56 234],269,3,16988,4.026546575017777,0.0,0.0
14219,1,4219,[197 288 257 187  25],504,4,16992,4.026540284360189,0.0,0.0
14220,1,4220,[427  79 588  98 127],796,5,16997,4.026770907367922,20.0,20.0
14221,1,4221,[427  79 588  98 127],796,5,17002,4.027001421127427,20.0,20.0
14222,1,4222,[427  79 588  98 127],389,5,17007,4.027231825716315,20.0,20.0
14223,1,4223,[427  79 588  98 127],796,5,17012,4.027462121212121,20.0,20.0
14224,1,4224,[427  79 588  98 127],796,5,17017,4.027692307692308,20.0,20.0
14225,1,4225,[ 50  69 195 286 603],655,2,17019,4.027212494084241,20.0,40.0
14226,1,4226,[427  79 588  98 127],389,5,17024,4.027442630707357,20.0,20.0
14227,1,4227,[427  79 588  98 127],389,5,17029,4.0276726584673606,20.0,20.0
14228,1,4228,[210 288 483 357 183],457,5,17034,4.027902577441475,0.0,0.0
14229,1,4229,[427  79 588  98 127],450,5,17039,4.028132387706856,20.0,20.0
14230,1,4230,[127   9  15 216  69],786,4,17043,4.028125738596077,0.0,20.0
14231,1,4231,[427  79 588  98 127],716,5,17048,4.0283553875236295,20.0,20.0
14232,1,4232,[ 96 597   4 174 258],344,3,17051,4.028112449799197,0.0,0.0
14233,1,4233,[427  79 588  98 127],389,5,17056,4.028341993386868,20.0,20.0
14234,1,4234,[427  79 588  98 127],389,5,17061,4.0285714285714285,20.0,20.0
14235,1,4235,[427  79 588  98 127],450,5,17066,4.028800755429651,20.0,20.0
14236,1,4236,[153  96 318 181 176],796,5,17071,4.0290299740382345,20.0,0.0
14237,1,4237,[323 588 597 204  15],796,4,17075,4.029023124115149,0.0,0.0
14238,1,4238,[655 405 174 237 228],450,5,17080,4.029252182118424,0.0,0.0
14239,1,4239,[216 215 197  12  79],450,5,17085,4.029481132075472,0.0,0.0
14240,1,4240,[234   7 546 282   4],457,4,17089,4.029474180617779,0.0,0.0
14241,1,4241,[427  79 588  98 127],389,5,17094,4.02970297029703,20.0,20.0
14242,1,4242,[191 258  64 318 603],151,4,17098,4.029695969832666,60.0,0.0
14243,1,4243,[427  79 588  98 127],796,5,17103,4.029924599434496,20.0,20.0
14244,1,4244,[427  79 588  98 127],389,5,17108,4.0301531213191994,20.0,20.0
14245,1,4245,[427  79 588  98 127],389,5,17113,4.030381535562883,20.0,20.0
14246,1,4246,[222  82 191  89 496],151,3,17116,4.030138921591711,20.0,0.0
14247,1,4247,[ 50 211 228 216 204],5,4,17120,4.0301318267419965,0.0,20.0
14248,1,4248,[161  79 182 168 282],796,5,17125,4.030360084725817,0.0,0.0
14249,1,4249,[238 183 127   1 144],796,3,17128,4.030117647058823,0.0,20.0
14250,1,4250,[196 121   1 276 172],786,3,17131,4.029875323453305,0.0,0.0
14251,1,4251,[210 117 286  96 568],796,3,17134,4.029633113828787,0.0,20.0
14252,1,4252,[234 121  88 471 125],457,5,17139,4.029861274394545,0.0,0.0
14253,1,4253,[588  97 318 282 168],457,5,17144,4.030089327691584,20.0,0.0
14254,1,4254,[655  11 186  50 288],457,5,17149,4.030317273795535,0.0,20.0
14255,1,4255,[ 56 132 288  11 222],450,3,17152,4.030075187969925,0.0,0.0
14256,1,4256,[427  79 588  98 127],389,5,17157,4.03030303030303,20.0,20.0
14257,1,4257,[427  79 588  98 127],716,5,17162,4.0305307656176605,20.0,20.0
14258,1,4258,[237 183 546 483  25],457,4,17166,4.030523597088519,0.0,0.0
14259,1,4259,[ 88   1 195 228 118],151,3,17169,4.030281690140845,0.0,0.0
14260,1,4260,[237  64 496 173 174],796,5,17174,4.030509270124384,40.0,0.0
14261,1,4261,[ 56  98 475 153 742],655,1,17175,4.029798216799625,0.0,0.0
14262,1,4262,[ 79  50 125 275 475],296,5,17180,4.030025803424818,0.0,40.0
14263,1,4263,[427  79 588  98 127],716,5,17185,4.030253283302064,20.0,20.0
14264,1,4264,[427  79 588  98 127],18,5,17190,4.030480656506448,20.0,20.0
14265,1,4265,[427  79 588  98 127],450,5,17195,4.0307079231129865,20.0,20.0
14266,1,4266,[ 50 496 286 187 151],389,4,17199,4.030700726505742,20.0,40.0
14267,1,4267,[ 98 234 181 111   1],450,4,17203,4.030693533270853,0.0,0.0
14268,1,4268,[427  79 588  98 127],716,5,17208,4.030920590302179,20.0,20.0
14269,1,4269,[427  79 588  98 127],796,5,17213,4.031147540983606,20.0,20.0
14270,1,4270,[427  79 588  98 127],18,5,17218,4.031374385389839,20.0,20.0
14271,1,4271,[427  79 588  98 127],450,5,17223,4.031601123595506,20.0,20.0
14272,1,4272,[282  28 191  79  56],716,4,17227,4.031593728059911,0.0,0.0
14273,1,4273,[427  79 588  98 127],450,5,17232,4.031820308844174,20.0,20.0
14274,1,4274,[427  79 588  98 127],796,5,17237,4.032046783625731,20.0,20.0
14275,1,4275,[ 96 153 172 475  11],296,5,17242,4.032273152478952,0.0,0.0
14276,1,4276,[202 174 655  97  56],577,4,17246,4.0322656067336915,0.0,0.0
14277,1,4277,[294 185  71 194  56],504,2,17248,4.031790556334736,0.0,0.0
14278,1,4278,[144 222 235 186  69],807,4,17252,4.031783126898808,0.0,0.0
14279,1,4279,[427  79 588  98 127],716,5,17257,4.032009345794393,20.0,20.0
14280,1,4280,[ 12  89 678  11 127],344,3,17260,4.031768278439617,0.0,20.0
14281,1,4281,[427  79 588  98 127],450,5,17265,4.031994395142457,20.0,20.0
14282,1,4282,[282 588 125 568 216],457,5,17270,4.032220406257296,0.0,0.0
14283,1,4283,[427  79 588  98 127],389,5,17275,4.0324463118580764,20.0,20.0
14284,1,4284,[427  79 588  98 127],18,5,17280,4.03267211201867,20.0,20.0
14285,1,4285,[427  79 588  98 127],389,5,17285,4.032897806812879,20.0,20.0
14286,1,4286,[427  79 588  98 127],389,5,17290,4.033123396314439,20.0,20.0
14287,1,4287,[427  79 588  98 127],18,5,17295,4.033348880597015,20.0,20.0
14288,1,4288,[427  79 588  98 127],450,5,17300,4.033574259734204,20.0,20.0
14289,1,4289,[294 215 132 211 118],796,3,17303,4.033333333333333,0.0,0.0
14290,1,4290,[179 197 588   8 175],457,5,17308,4.033558611046376,0.0,0.0
14291,1,4291,[427  79 588  98 127],796,5,17313,4.033783783783784,20.0,20.0
14292,1,4292,[ 69  79 132 111 174],236,4,17317,4.033775914279059,0.0,0.0
14293,1,4293,[ 64 187 271   4 435],655,2,17319,4.033302282254309,20.0,0.0
14294,1,4294,[182 483  97 275 318],450,4,17323,4.0332945285215365,20.0,20.0
14295,1,4295,[ 56 228 183 333 257],655,1,17324,4.032588454376164,0.0,0.0
14296,1,4296,[ 79 111  88 121 483],151,5,17329,4.032813590877356,0.0,0.0
14297,1,4297,[168 211 194 235 568],716,4,17333,4.032805956258725,0.0,0.0
14298,1,4298,[313 179  12 471 483],655,3,17336,4.032565712956502,0.0,0.0
14299,1,4299,[  9 655 271 385  69],655,0,17336,4.031627906976744,0.0,0.0
14300,1,4300,[191 195 286  71 210],786,5,17341,4.031853057428505,0.0,20.0
14301,1,4301,[328 181 179 202 200],450,4,17345,4.031845653184566,0.0,0.0
14302,1,4302,[211 118 176  28 196],389,3,17348,4.0316058563792705,0.0,0.0
14303,1,4303,[427  79 588  98 127],796,5,17353,4.031830855018588,20.0,20.0
14304,1,4304,[427  79 588  98 127],389,5,17358,4.0320557491289195,20.0,20.0
14305,1,4305,[427  79 588  98 127],450,5,17363,4.032280538783094,20.0,20.0
14306,1,4306,[121  82 568  98  89],269,1,17364,4.031576503366613,0.0,0.0
14307,1,4307,[ 15 197  98 475 427],655,2,17366,4.031104921077066,20.0,0.0
14308,1,4308,[181 153 275 405 235],401,1,17367,4.030401485263402,0.0,20.0
14309,1,4309,[210 125 237 269 117],296,3,17370,4.03016241299304,0.0,0.0
14310,1,4310,[ 28 143  95 603 427],450,4,17374,4.030155416376711,40.0,0.0
14311,1,4311,[427  79 588  98 127],389,5,17379,4.030380333951762,20.0,20.0
14312,1,4312,[427  79 588  98 127],450,5,17384,4.0306051472293065,20.0,20.0
14313,1,4313,[427  79 588  98 127],18,5,17389,4.030829856281873,20.0,20.0
14314,1,4314,[427  79 588  98 127],796,5,17394,4.031054461181924,20.0,20.0
14315,1,4315,[ 79 180 322 245 117],450,5,17399,4.031278962001854,0.0,0.0
14316,1,4316,[546 323 403 228 174],280,1,17400,4.030576789437109,0.0,0.0
14317,1,4317,[181 143 282 302   4],450,4,17404,4.03056970819824,0.0,0.0
14318,1,4318,[182 125  50 435 185],18,3,17407,4.030331095160917,0.0,20.0
14319,1,4319,[427  79 588  98 127],450,5,17412,4.030555555555556,20.0,20.0
14320,1,4320,[427  50 258 194  97],535,5,17417,4.030779912057394,20.0,20.0
14321,1,4321,[427  79 588  98 127],18,5,17422,4.031004164738547,20.0,20.0
14322,1,4322,[427  79 588  98 127],796,5,17427,4.031228313671062,20.0,20.0
14323,1,4323,[135 427 196 180 216],269,2,17429,4.030758556891767,20.0,0.0
14324,1,4324,[174 176 385  89 288],457,5,17434,4.0309826589595374,0.0,0.0
14325,1,4325,[427  79 588  98 127],796,5,17439,4.03120665742025,20.0,20.0
14326,1,4326,[427  79 588  98 127],716,5,17444,4.031430552345736,20.0,20.0
14327,1,4327,[172  64 211   4 143],151,5,17449,4.031654343807763,20.0,0.0
14328,1,4328,[427  79 588  98 127],389,5,17454,4.031878031878032,20.0,20.0
14329,1,4329,[427  79 588  98 127],389,5,17459,4.032101616628175,20.0,20.0
14330,1,4330,[322 271 117  12 172],796,4,17463,4.032094204571693,0.0,0.0
14331,1,4331,[286 144 276 211 194],401,4,17467,4.032086795937212,0.0,20.0
14332,1,4332,[405 265 215 195 269],655,0,17467,4.031156242787906,0.0,0.0
14333,1,4333,[427  79 588  98 127],389,5,17472,4.0313797877249655,20.0,20.0
14334,1,4334,[427  79 588  98 127],18,5,17477,4.031603229527105,20.0,20.0
14335,1,4335,[427  79 588  98 127],716,5,17482,4.031826568265683,20.0,20.0
14336,1,4336,[427  79 588  98 127],796,5,17487,4.03204980401199,20.0,20.0
14337,1,4337,[228 269 357 175 144],23,3,17490,4.031811894882434,0.0,0.0
14338,1,4338,[ 71 238 168 195  69],330,3,17493,4.031574095413689,0.0,0.0
14339,1,4339,[258 655 742 143 289],655,1,17494,4.030875576036866,0.0,0.0
14340,1,4340,[427  79 588  98 127],716,5,17499,4.031098825155494,20.0,20.0
14341,1,4341,[678  50 222 405 235],256,4,17503,4.03109166282819,0.0,20.0
14342,1,4342,[427  79 588  98 127],716,5,17508,4.031314759382915,20.0,20.0
14343,1,4343,[ 64 135 385 483 403],457,5,17513,4.031537753222836,20.0,0.0
14344,1,4344,[427  79 588  98 127],796,5,17518,4.031760644418872,20.0,20.0
14345,1,4345,[  9 603 191 228 423],655,2,17520,4.03129314312011,20.0,0.0
14346,1,4346,[196 475 216 100 179],655,2,17522,4.030825856912814,0.0,20.0
14347,1,4347,[427  79 588  98 127],389,5,17527,4.031048758049678,20.0,20.0
14348,1,4348,[427  79 588  98 127],450,5,17532,4.031271556679696,20.0,20.0
14349,1,4349,[ 89 228 265 180  69],457,5,17537,4.031494252873563,0.0,0.0
14350,1,4350,[ 98  71 125 245 588],344,2,17539,4.031027350034475,0.0,0.0
14351,1,4351,[427  79 588  98 127],18,5,17544,4.03125,20.0,20.0
14352,1,4352,[191 268 301  70 357],344,3,17547,4.031013094417643,0.0,0.0
14353,1,4353,[427  79 588  98 127],389,5,17552,4.031235645383555,20.0,20.0
14354,1,4354,[427  79 588  98 127],796,5,17557,4.031458094144662,20.0,20.0
14355,1,4355,[423 258 144 405 185],796,5,17562,4.03168044077135,0.0,0.0
14356,1,4356,[385 328   1 568 286],450,5,17567,4.031902685333946,0.0,20.0
14357,1,4357,[313 258  64 427  71],450,4,17571,4.031895364846259,40.0,0.0
14358,1,4358,[174 357 385 186 271],655,1,17572,4.031199816471668,0.0,0.0
14359,1,4359,[222 215 186 302 183],655,2,17574,4.030733944954129,0.0,0.0
14360,1,4360,[168 135  97 121 405],450,3,17577,4.030497592295345,0.0,0.0
14361,1,4361,[427  79 588  98 127],716,5,17582,4.030719853278312,20.0,20.0
14362,1,4362,[427  79 588  98 127],450,5,17587,4.030942012376805,20.0,20.0
14363,1,4363,[121   1   7 258 151],344,2,17589,4.030476626947754,0.0,0.0
14364,1,4364,[427  79 588  98 127],450,5,17594,4.03069873997709,20.0,20.0
14365,1,4365,[427  79 588  98 127],716,5,17599,4.0309207512597345,20.0,20.0
14366,1,4366,[127  98 403  69 385],450,5,17604,4.031142660865583,0.0,20.0
14367,1,4367,[121 496 176 234 132],450,3,17607,4.030906593406593,20.0,0.0
14368,1,4368,[427  79 588  98 127],389,5,17612,4.031128404669261,20.0,20.0
14369,1,4369,[100  64 423 568 427],450,5,17617,4.031350114416476,40.0,20.0
14370,1,4370,[ 88 258  15   9 603],655,1,17618,4.030656600320293,20.0,0.0
14371,1,4371,[655 196   1 210  69],72,5,17623,4.030878316559927,0.0,0.0
14372,1,4372,[403 197 176 202 100],457,5,17628,4.03109993139721,0.0,20.0
14373,1,4373,[427  79 588  98 127],450,5,17633,4.031321444901692,20.0,20.0
14374,1,4374,[427  79 588  98 127],450,5,17638,4.031542857142857,20.0,20.0
14375,1,4375,[245 328 183 228 282],796,4,17642,4.031535648994516,0.0,0.0
14376,1,4376,[ 96 403 483 238  15],269,2,17644,4.031071510166781,0.0,0.0
14377,1,4377,[427  79 588  98 127],450,5,17649,4.03129282777524,20.0,20.0
14378,1,4378,[471 282 275 143 222],716,3,17652,4.031057319022608,0.0,20.0
14379,1,4379,[385  70 191 143 185],457,5,17657,4.031278538812785,0.0,0.0
14380,1,4380,[427  79 588  98 127],18,5,17662,4.031499657612417,20.0,20.0
14381,1,4381,[427  79 588  98 127],716,5,17667,4.031720675490644,20.0,20.0
14382,1,4382,[187 257 258 318 174],504,4,17671,4.03171343828428,20.0,0.0
14383,1,4383,[427  79 588  98 127],18,5,17676,4.031934306569343,20.0,20.0
14384,1,4384,[427  79 588  98 127],796,5,17681,4.0321550741163055,20.0,20.0
14385,1,4385,[182 748 546 127 742],436,3,17684,4.0319197446420425,0.0,20.0
14386,1,4386,[427  79 588  98 127],450,5,17689,4.032140414862092,20.0,20.0
14387,1,4387,[427  79 588  98 127],450,5,17694,4.032360984503191,20.0,20.0
14388,1,4388,[ 70 496  96 202 385],450,5,17699,4.032581453634085,20.0,0.0
14389,1,4389,[143 546 121  98 265],577,3,17702,4.032346241457859,0.0,0.0
14390,1,4390,[427  79 588  98 127],716,5,17707,4.0325666135276705,20.0,20.0
14391,1,4391,[ 64 132 100 194  82],796,3,17710,4.0323315118397085,20.0,20.0
14392,1,4392,[427  79 588  98 127],18,5,17715,4.032551786933758,20.0,20.0
14393,1,4393,[427  79 588  98 127],18,5,17720,4.032771961766045,20.0,20.0
14394,1,4394,[181 121 173 318 496],807,4,17724,4.032764505119454,40.0,0.0
14395,1,4395,[176 174  28 111 173],389,3,17727,4.03252957233849,0.0,0.0
14396,1,4396,[179 173 269  12 748],450,5,17732,4.032749602001364,0.0,0.0
14397,1,4397,[125 271 153 238 175],655,0,17732,4.031832651205093,0.0,0.0
14398,1,4398,[301  88 385 515   1],655,1,17733,4.0311434416912935,0.0,0.0
14399,1,4399,[289 191 185 111 282],236,5,17738,4.031363636363636,0.0,0.0
14400,1,4400,[151 427 357  50 204],23,2,17740,4.030902067711883,20.0,20.0
14401,1,4401,[183 187   1 132 237],796,4,17744,4.030895047705588,0.0,0.0
14402,1,4402,[117  22 286 275  97],330,5,17749,4.031115148762208,0.0,40.0
14403,1,4403,[427  79 588  98 127],389,5,17754,4.03133514986376,20.0,20.0
14404,1,4404,[427  79 588  98 127],796,5,17759,4.03155505107832,20.0,20.0
14405,1,4405,[427  79 588  98 127],716,5,17764,4.031774852473899,20.0,20.0
14406,1,4406,[ 11  56 117 435 655],629,4,17768,4.031767642387112,0.0,0.0
14407,1,4407,[ 22 180 144 135 318],280,4,17772,4.031760435571688,20.0,0.0
14408,1,4408,[427  79 588  98 127],389,5,17777,4.031980040825584,20.0,20.0
14409,1,4409,[427  79 588  98 127],389,5,17782,4.032199546485261,20.0,20.0
14410,1,4410,[427  79 588  98 127],450,5,17787,4.032418952618454,20.0,20.0
14411,1,4411,[427  79 588  98 127],716,5,17792,4.032638259292837,20.0,20.0
14412,1,4412,[427  79 588  98 127],450,5,17797,4.032857466576026,20.0,20.0
14413,1,4413,[ 79 144 427   4  69],716,3,17800,4.032623470774808,20.0,0.0
14414,1,4414,[385  98  89 191 117],655,3,17803,4.032389580973953,0.0,0.0
14415,1,4415,[ 82 237  25 118   4],256,5,17808,4.032608695652174,0.0,0.0
14416,1,4416,[427  79 588  98 127],796,5,17813,4.032827711116142,20.0,20.0
14417,1,4417,[427  79 588  98 127],716,5,17818,4.033046627433228,20.0,20.0
14418,1,4418,[173 216 100 153 423],280,3,17821,4.032812853586784,0.0,20.0
14419,1,4419,[427  79 588  98 127],389,5,17826,4.033031674208145,20.0,20.0
14420,1,4420,[427  79 588  98 127],18,5,17831,4.033250395838046,20.0,20.0
14421,1,4421,[427  79 588  98 127],18,5,17836,4.033469018543645,20.0,20.0
14422,1,4422,[471 301 195 191  56],655,1,17837,4.032783178837893,0.0,0.0
14423,1,4423,[202  64 132 471 302],450,5,17842,4.033001808318264,20.0,0.0
14424,1,4424,[210 385 294 195   1],716,3,17845,4.032768361581921,0.0,0.0
14425,1,4425,[427  79 588  98 127],796,5,17850,4.032986895616809,20.0,20.0
14426,1,4426,[427  79 588  98 127],796,5,17855,4.0332053309238765,20.0,20.0
14427,1,4427,[357 546 322 301  88],344,2,17857,4.032746160794941,0.0,0.0
14428,1,4428,[427  79 588  98 127],389,5,17862,4.032964551817566,20.0,20.0
14429,1,4429,[427  79 588  98 127],796,5,17867,4.033182844243792,20.0,20.0
14430,1,4430,[427  79 588  98 127],450,5,17872,4.033401038140375,20.0,20.0
14431,1,4431,[ 50 174 265 603 121],151,5,17877,4.033619133574007,20.0,20.0
14432,1,4432,[234 168  82 196 357],457,5,17882,4.0338371306113245,0.0,0.0
14433,1,4433,[322  98 191 194 144],796,4,17886,4.03382949932341,0.0,0.0
14434,1,4434,[427  79 588  98 127],716,5,17891,4.034047350620067,20.0,20.0
14435,1,4435,[427  79 588  98 127],796,5,17896,4.034265103697025,20.0,20.0
14436,1,4436,[427  79 588  98 127],18,5,17901,4.0344827586206895,20.0,20.0
14437,1,4437,[ 89 678  11 748 597],256,5,17906,4.034700315457413,0.0,0.0
14438,1,4438,[427  79 588  98 127],716,5,17911,4.034917774273485,20.0,20.0
14439,1,4439,[427  79 588  98 127],18,5,17916,4.035135135135135,20.0,20.0
14440,1,4440,[ 96 568 151 153  79],796,5,17921,4.035352398108534,0.0,0.0
14441,1,4441,[191 202  15 183 216],269,1,17922,4.034669067987393,0.0,0.0
14442,1,4442,[427  79 588  98 127],18,5,17927,4.034886338059869,20.0,20.0
14443,1,4443,[427  79 588  98 127],450,5,17932,4.0351035103510355,20.0,20.0
14444,1,4444,[186 483 302 174 471],535,4,17936,4.035095613048369,0.0,0.0
14445,1,4445,[427  79 588  98 127],389,5,17941,4.035312640575799,20.0,20.0
14446,1,4446,[181 265  70 597 215],457,4,17945,4.035304699797616,0.0,0.0
14447,1,4447,[483  12 191 176  25],450,3,17948,4.035071942446043,0.0,0.0
14448,1,4448,[333 176 403   7 179],655,1,17949,4.034389750505731,0.0,0.0
14449,1,4449,[427  79 588  98 127],389,5,17954,4.034606741573033,20.0,20.0
14450,1,4450,[427  79 588  98 127],716,5,17959,4.034823635138171,20.0,20.0
14451,1,4451,[427  79 588  98 127],18,5,17964,4.035040431266847,20.0,20.0
14452,1,4452,[ 15  22 357 176 568],269,1,17965,4.034358859196048,0.0,0.0
14453,1,4453,[427  79 588  98 127],716,5,17970,4.034575662325999,20.0,20.0
14454,1,4454,[180 385 301  69  56],796,3,17973,4.034343434343435,0.0,0.0
14455,1,4455,[301 318 508 196 237],535,5,17978,4.034560143626571,20.0,0.0
14456,1,4456,[222 179 176 288 435],450,3,17981,4.034328023334081,0.0,0.0
14457,1,4457,[  1  98 234 118 603],389,4,17985,4.034320323014805,20.0,0.0
14458,1,4458,[216 288 176 238  69],457,5,17990,4.034536891679749,0.0,0.0
14459,1,4459,[423 127  64 568 117],796,5,17995,4.0347533632287,20.0,20.0
14460,1,4460,[ 97 132 196 100 435],151,4,17999,4.034745572741538,0.0,20.0
14461,1,4461,[ 50 328 333  15 132],796,5,18004,4.034961900493053,0.0,20.0
14462,1,4462,[175 405 161 181 197],269,2,18006,4.034505937710061,0.0,0.0
14463,1,4463,[187 357  69  15  71],450,3,18009,4.034274193548387,0.0,0.0
14464,1,4464,[405 196 265  69  88],716,5,18014,4.0344904815229565,0.0,0.0
14465,1,4465,[427  79 588  98 127],716,5,18019,4.034706672637707,20.0,20.0
14466,1,4466,[427  79 588  98 127],450,5,18024,4.03492276695769,20.0,20.0
14467,1,4467,[172 471 318 258 222],655,2,18026,4.034467323187108,20.0,0.0
14468,1,4468,[427  79 588  98 127],716,5,18031,4.034683374356679,20.0,20.0
14469,1,4469,[ 28 423 322 111 245],796,2,18033,4.034228187919463,0.0,0.0
14470,1,4470,[  7 172 483  98 286],280,4,18037,4.034220532319392,0.0,20.0
14471,1,4471,[127 191 183  79 172],344,5,18042,4.034436493738819,0.0,20.0
14472,1,4472,[151 258 132 245  50],796,4,18046,4.034428794992175,0.0,20.0
14473,1,4473,[202 195  50 471 357],716,3,18049,4.034197586052749,0.0,20.0
14474,1,4474,[427  79 588  98 127],389,5,18054,4.034413407821229,20.0,20.0
14475,1,4475,[ 97 301 197 132 127],796,2,18056,4.033958891867739,0.0,20.0
14476,1,4476,[121  56  97 385   7],450,4,18060,4.0339513066785795,0.0,0.0
14477,1,4477,[215 185  28 172 273],693,2,18062,4.033497096918267,0.0,0.0
14478,1,4478,[ 97 228 191  28  50],693,1,18063,4.032819825853985,0.0,20.0
14479,1,4479,[211  97  25  12 210],450,3,18066,4.032589285714286,0.0,0.0
14480,1,4480,[427  79 588  98 127],796,5,18071,4.032805177415756,20.0,20.0
14481,1,4481,[176 125 234 185 181],503,4,18075,4.032797858099063,0.0,0.0
14482,1,4482,[427  79 588  98 127],389,5,18080,4.033013606959625,20.0,20.0
14483,1,4483,[173 127 132 222 245],280,2,18082,4.032560214094558,0.0,20.0
14484,1,4484,[427  79 588  98 127],389,5,18087,4.032775919732441,20.0,20.0
14485,1,4485,[118 174 127  56  82],504,3,18090,4.03254569772626,0.0,20.0
14486,1,4486,[427  79 588  98 127],450,5,18095,4.032761310452418,20.0,20.0
14487,1,4487,[427  79 588  98 127],796,5,18100,4.032976827094474,20.0,20.0
14488,1,4488,[427  79 588  98 127],716,5,18105,4.033192247716641,20.0,20.0
14489,1,4489,[ 56 286 176 204 423],236,3,18108,4.032962138084632,0.0,20.0
14490,1,4490,[427  79 588  98 127],796,5,18113,4.033177466043197,20.0,20.0
14491,1,4491,[211 173 245 216 568],796,3,18116,4.032947462154942,0.0,0.0
14492,1,4492,[215 258  88 496 257],796,5,18121,4.03316269752949,20.0,0.0
14493,1,4493,[678  96 196 132 655],504,5,18126,4.033377837116155,0.0,0.0
14494,1,4494,[427  79 588  98 127],389,5,18131,4.0335928809788655,20.0,20.0
14495,1,4495,[427  79 588  98 127],18,5,18136,4.0338078291814945,20.0,20.0
14496,1,4496,[196  22 265 182 483],796,5,18141,4.034022681787858,0.0,0.0
14497,1,4497,[427  79 588  98 127],450,5,18146,4.034237438861716,20.0,20.0
14498,1,4498,[427  79 588  98 127],18,5,18151,4.034452100466771,20.0,20.0
14499,1,4499,[143 210 318 197  96],655,2,18153,4.034,20.0,0.0
14500,1,4500,[301 282  89  22 182],655,2,18155,4.033548100422128,0.0,0.0
14501,1,4501,[143 588 258  89 191],796,5,18160,4.033762772101288,0.0,0.0
14502,1,4502,[282 179 176 302 301],450,5,18165,4.0339773484343775,0.0,0.0
14503,1,4503,[318   7 200 100 132],577,3,18168,4.033747779751332,20.0,20.0
14504,1,4504,[  7 483 161 121 197],457,5,18173,4.033962264150944,0.0,0.0
14505,1,4505,[228 187  70 403 121],72,2,18175,4.033510874389703,0.0,0.0
14506,1,4506,[183 204  69 121 742],655,1,18176,4.032837807854449,0.0,0.0
14507,1,4507,[ 28   4 211 179  79],389,5,18181,4.033052351375333,0.0,0.0
14508,1,4508,[427  79 588  98 127],389,5,18186,4.033266799733866,20.0,20.0
14509,1,4509,[276  96 286 161 238],655,1,18187,4.032594235033259,0.0,20.0
14510,1,4510,[403 172 117 194 271],72,2,18189,4.032143648858346,0.0,0.0
14511,1,4511,[427  79 588  98 127],389,5,18194,4.032358156028369,20.0,20.0
14512,1,4512,[216 204 181 385 423],450,5,18199,4.032572568136494,0.0,0.0
14513,1,4513,[427  79 588  98 127],716,5,18204,4.032786885245901,20.0,20.0
14514,1,4514,[427  79 588  98 127],389,5,18209,4.033001107419712,20.0,20.0
14515,1,4515,[234 153   4 194 174],629,4,18213,4.032993799822852,0.0,0.0
14516,1,4516,[427  79 588  98 127],18,5,18218,4.03320788133717,20.0,20.0
14517,1,4517,[276 194 132 181 258],457,5,18223,4.033421868083223,0.0,0.0
14518,1,4518,[ 88 117  98 301 187],655,2,18225,4.032971896437265,0.0,0.0
14519,1,4519,[258  69 135  15 216],457,5,18230,4.033185840707965,0.0,0.0
14520,1,4520,[  8 597 204 127 269],344,4,18234,4.033178500331785,0.0,20.0
14521,1,4521,[427  79 588  98 127],716,5,18239,4.033392304290137,20.0,20.0
14522,1,4522,[318 265 100 179  89],457,5,18244,4.0336060137077165,20.0,20.0
14523,1,4523,[204 742   1 195 117],344,2,18246,4.0331564986737405,0.0,0.0
14524,1,4524,[427  79 588  98 127],450,5,18251,4.033370165745857,20.0,20.0
14525,1,4525,[603  56 200 151 318],716,5,18256,4.0335837384003534,40.0,0.0
14526,1,4526,[427  79 588  98 127],450,5,18261,4.033797216699801,20.0,20.0
14527,1,4527,[100 185 194 322 180],796,2,18263,4.033348056537102,0.0,20.0
14528,1,4528,[ 98   8 265 234 435],655,1,18264,4.032678295429455,0.0,0.0
14529,1,4529,[300 357 435  11 235],716,4,18268,4.032671081677704,0.0,0.0
14530,1,4530,[288 328  11 215 100],450,4,18272,4.03266387111013,0.0,20.0
14531,1,4531,[427  79 588  98 127],796,5,18277,4.032877316857899,20.0,20.0
14532,1,4532,[288  79 132 186  25],655,1,18278,4.032208250606662,0.0,0.0
14533,1,4533,[179  97  56 174  15],457,5,18283,4.0324217026907805,0.0,0.0
14534,1,4534,[286   1 234  97 228],786,4,18287,4.032414553472988,0.0,20.0
14535,1,4535,[427  79 588  98 127],389,5,18292,4.032627865961199,20.0,20.0
14536,1,4536,[427  79 588  98 127],716,5,18297,4.032841084417016,20.0,20.0
14537,1,4537,[185 151 194  25 181],457,5,18302,4.0330542089026,0.0,0.0
14538,1,4538,[405 271 172  79 202],655,2,18304,4.032606300947346,0.0,0.0
14539,1,4539,[100 195 172 357 423],535,3,18307,4.03237885462555,0.0,20.0
14540,1,4540,[427  79 588  98 127],18,5,18312,4.032591940101299,20.0,20.0
14541,1,4541,[427  79 588  98 127],716,5,18317,4.032804931748129,20.0,20.0
14542,1,4542,[135 357  71 318 186],18,4,18321,4.032797710763813,20.0,0.0
14543,1,4543,[427  79 588  98 127],18,5,18326,4.033010563380282,20.0,20.0
14544,1,4544,[427  79 588  98 127],18,5,18331,4.033223322332233,20.0,20.0
14545,1,4545,[427  79 588  98 127],389,5,18336,4.033435987681478,20.0,20.0
14546,1,4546,[427  79 588  98 127],389,5,18341,4.033648559489773,20.0,20.0
14547,1,4547,[427  79 588  98 127],389,5,18346,4.033861037818822,20.0,20.0
14548,1,4548,[286 258 301   9 655],655,0,18346,4.032974280061552,0.0,20.0
14549,1,4549,[603 143 195 237  89],269,1,18347,4.032307692307692,20.0,0.0
14550,1,4550,[427  79 588  98 127],716,5,18352,4.032520325203252,20.0,20.0
14551,1,4551,[427  79 588  98 127],716,5,18357,4.032732864674868,20.0,20.0
14552,1,4552,[210 275 182   4 200],450,2,18359,4.032286404568416,0.0,20.0
14553,1,4553,[237 597 187  12 228],450,5,18364,4.03249890206412,0.0,0.0
14554,1,4554,[  4 234 195 174  69],655,0,18364,4.031613611416026,0.0,0.0
14555,1,4555,[427  79 588  98 127],450,5,18369,4.031826163301141,20.0,20.0
14556,1,4556,[  4 168  89 181 471],450,4,18373,4.031819179284617,0.0,0.0
14557,1,4557,[222  50 211  97 302],151,4,18377,4.031812198332602,0.0,20.0
14558,1,4558,[197 100  82 174 655],280,0,18377,4.030927835051546,0.0,20.0
14559,1,4559,[100 172 191  79 196],23,3,18380,4.030701754385965,0.0,20.0
14560,1,4560,[318  15  89  50 655],786,4,18384,4.030695023021267,20.0,20.0
14561,1,4561,[427  79 588  98 127],18,5,18389,4.0309074967119685,20.0,20.0
14562,1,4562,[427  79 588  98 127],450,5,18394,4.031119877273723,20.0,20.0
14563,1,4563,[ 22  56 127  88   8],655,1,18395,4.03045574057844,0.0,20.0
14564,1,4564,[273  89 245 237 385],344,2,18397,4.030010952902519,0.0,0.0
14565,1,4565,[300  69 603  50 135],704,3,18400,4.029785370127025,20.0,20.0
14566,1,4566,[427  79 588  98 127],18,5,18405,4.029997810378805,20.0,20.0
14567,1,4567,[427  79 588  98 127],796,5,18410,4.030210157618214,20.0,20.0
14568,1,4568,[269 275 405 235  70],450,4,18414,4.030203545633618,0.0,20.0
14569,1,4569,[427  79 588  98 127],716,5,18419,4.030415754923413,20.0,20.0
14570,1,4570,[210   8 273 183 215],344,4,18423,4.030409100853205,0.0,0.0
14571,1,4571,[471  28 275 655 483],450,4,18427,4.0304024496937885,0.0,20.0
14572,1,4572,[ 82 405  69 276 181],269,1,18428,4.029739776951673,0.0,0.0
14573,1,4573,[427  79 588  98 127],450,5,18433,4.029951902055094,20.0,20.0
14574,1,4574,[427  79 588  98 127],450,5,18438,4.03016393442623,20.0,20.0
14575,1,4575,[427  79 588  98 127],18,5,18443,4.030375874125874,20.0,20.0
14576,1,4576,[427  79 588  98 127],389,5,18448,4.030587721214769,20.0,20.0
14577,1,4577,[427  79 588  98 127],450,5,18453,4.0307994757536045,20.0,20.0
14578,1,4578,[427  79 588  98 127],389,5,18458,4.031011137803014,20.0,20.0
14579,1,4579,[322 176  95 286 301],450,4,18462,4.031004366812227,0.0,20.0
14580,1,4580,[ 79  56 318  28 181],693,3,18465,4.030779305828422,20.0,0.0
14581,1,4581,[202 423  12 173  56],457,5,18470,4.030990833697076,0.0,0.0
14582,1,4582,[235 144 100 385  70],450,4,18474,4.030984071568842,0.0,20.0
14583,1,4583,[202 151 216  71 196],796,5,18479,4.031195462478185,0.0,0.0
14584,1,4584,[211 328 568 172 100],796,3,18482,4.030970556161396,0.0,20.0
14585,1,4585,[427  79 588  98 127],796,5,18487,4.031181857828173,20.0,20.0
14586,1,4586,[211 183 496 172  95],786,5,18492,4.031393067364291,20.0,0.0
14587,1,4587,[174 215 234 118 475],655,0,18492,4.030514385353095,0.0,0.0
14588,1,4588,[276 286 151  70 196],18,3,18495,4.030289823490957,0.0,20.0
14589,1,4589,[427  79 588  98 127],716,5,18500,4.030501089324619,20.0,20.0
14590,1,4590,[427  79 588  98 127],389,5,18505,4.030712263123503,20.0,20.0
14591,1,4591,[427  79 588  98 127],18,5,18510,4.030923344947735,20.0,20.0
14592,1,4592,[ 79 143 427 546 161],693,3,18513,4.030698889614631,20.0,0.0
14593,1,4593,[175 235 216 508 546],344,3,18516,4.030474531998259,0.0,0.0
14594,1,4594,[427  79 588  98 127],389,5,18521,4.0306855277475515,20.0,20.0
14595,1,4595,[ 98 265 194 318 423],535,3,18524,4.030461270670148,20.0,0.0
14596,1,4596,[427  79 588  98 127],796,5,18529,4.0306721775070695,20.0,20.0
14597,1,4597,[275 100 245   9  82],756,1,18530,4.030013049151805,0.0,40.0
14598,1,4598,[427  79 588  98 127],389,5,18535,4.030223961730811,20.0,20.0
14599,1,4599,[427  79 588  98 127],18,5,18540,4.030434782608696,20.0,20.0
14600,1,4600,[180 588 172  97 215],716,4,18544,4.030428167789611,0.0,0.0
14601,1,4601,[  8  56 282 742 161],796,4,18548,4.030421555845285,0.0,0.0
14602,1,4602,[153 282  98 195 200],716,3,18551,4.03019769715403,0.0,0.0
14603,1,4603,[427  79 588  98 127],389,5,18556,4.030408340573414,20.0,20.0
14604,1,4604,[427  79 588  98 127],716,5,18561,4.030618892508143,20.0,20.0
14605,1,4605,[333 423 357 273 228],655,2,18563,4.030178028658272,0.0,0.0
14606,1,4606,[427 357 269 186   4],535,3,18566,4.029954417191231,20.0,0.0
14607,1,4607,[216  82 655 151 215],577,5,18571,4.030164930555555,0.0,0.0
14608,1,4608,[427  79 588  98 127],716,5,18576,4.030375352571057,20.0,20.0
14609,1,4609,[427  79 588  98 127],796,5,18581,4.03058568329718,20.0,20.0
14610,1,4610,[181  95 127 132  56],280,4,18585,4.030579050097593,0.0,20.0
14611,1,4611,[ 12   1 197 603 269],18,4,18589,4.030572419774502,20.0,0.0
14612,1,4612,[427  79 588  98 127],450,5,18594,4.030782570995014,20.0,20.0
14613,1,4613,[194 132  79 423 215],151,4,18598,4.030775899436498,0.0,0.0
14614,1,4614,[  8  96 403 181 179],269,1,18599,4.03011917659805,0.0,0.0
14615,1,4615,[ 82 211 216 111 471],786,5,18604,4.030329289428076,0.0,0.0
14616,1,4616,[185 194 100 328 546],450,5,18609,4.030539311241066,0.0,20.0
14617,1,4617,[282  79 318  28  50],457,5,18614,4.030749242096146,20.0,20.0
14618,1,4618,[153 238 200 357   4],504,3,18617,4.0305260878978135,0.0,0.0
14619,1,4619,[313 181 435 328 210],450,4,18621,4.03051948051948,0.0,0.0
14620,1,4620,[265 300  98 427  50],655,3,18624,4.030296472624973,20.0,20.0
14621,1,4621,[200 234 742 216 273],796,2,18626,4.029857204673301,0.0,0.0
14622,1,4622,[186 603 100 423  25],503,4,18630,4.029850746268656,20.0,20.0
14623,1,4623,[427  79 588  98 127],450,5,18635,4.030060553633218,20.0,20.0
14624,1,4624,[ 50  25  96 222 127],72,3,18638,4.029837837837838,0.0,40.0
14625,1,4625,[286 191 185 135 269],704,4,18642,4.029831387808041,0.0,20.0
14626,1,4626,[435 204  28  89   7],151,5,18647,4.030041063323968,0.0,0.0
14627,1,4627,[427  79 588  98 127],389,5,18652,4.030250648228177,20.0,20.0
14628,1,4628,[111 427  71 168 180],450,4,18656,4.030244113199395,20.0,0.0
14629,1,4629,[427  79 588  98 127],389,5,18661,4.030453563714903,20.0,20.0
14630,1,4630,[  9 265 175  64 275],457,5,18666,4.030662923774563,20.0,20.0
14631,1,4631,[427  79 588  98 127],18,5,18671,4.03087219343696,20.0,20.0
14632,1,4632,[238 125 210 357 423],593,4,18675,4.030865529894237,0.0,0.0
14633,1,4633,[742 111 176  64   1],344,3,18678,4.030643072939146,20.0,0.0
14634,1,4634,[427  79 588  98 127],389,5,18683,4.030852211434736,20.0,20.0
14635,1,4635,[211  70 132 496 186],786,5,18688,4.031061259706644,20.0,0.0
14636,1,4636,[427  79 588  98 127],389,5,18693,4.031270217813241,20.0,20.0
14637,1,4637,[427  79 588  98 127],18,5,18698,4.03147908581285,20.0,20.0
14638,1,4638,[427  79 588  98 127],716,5,18703,4.031687863763742,20.0,20.0
14639,1,4639,[427  79 588  98 127],796,5,18708,4.031896551724138,20.0,20.0
14640,1,4640,[ 98 176 357 132  88],151,4,18712,4.031889678948502,0.0,0.0
14641,1,4641,[427 194  96 168 121],577,5,18717,4.032098233520035,20.0,0.0
14642,1,4642,[ 64 318 173 655 197],535,5,18722,4.0323066982554385,40.0,0.0
14643,1,4643,[385  64 143 318 678],401,2,18724,4.031869078380706,40.0,0.0
14644,1,4644,[427  79 588  98 127],450,5,18729,4.032077502691066,20.0,20.0
14645,1,4645,[175  79  69 153 161],716,3,18732,4.031855359448988,0.0,0.0
14646,1,4646,[182 678   7 405 117],280,2,18734,4.031418119216699,0.0,0.0
14647,1,4647,[238 215  28 234 161],450,4,18738,4.031411359724613,0.0,0.0
14648,1,4648,[  4 258  56 151  96],450,4,18742,4.0314046031404605,0.0,0.0
14649,1,4649,[427  79 588  98 127],389,5,18747,4.031612903225806,20.0,20.0
14650,1,4650,[427  79 588  98 127],796,5,18752,4.031821113738981,20.0,20.0
14651,1,4651,[427  79 588  98 127],450,5,18757,4.032029234737747,20.0,20.0
14652,1,4652,[427  79 588  98 127],450,5,18762,4.03223726627982,20.0,20.0
14653,1,4653,[125 423 294 655 257],655,0,18762,4.031370863773098,0.0,0.0
14654,1,4654,[238 202 222 196 655],796,3,18765,4.031149301825994,0.0,0.0
14655,1,4655,[172 265 228  70  25],72,3,18768,4.030927835051546,0.0,0.0
14656,1,4656,[ 22  56  12 191 117],655,1,18769,4.030277002362036,0.0,0.0
14657,1,4657,[427  79 588  98 127],389,5,18774,4.03048518677544,20.0,20.0
14658,1,4658,[168 288   9 111 742],174,3,18777,4.03026400515132,0.0,0.0
14659,1,4659,[427  79 588  98 127],796,5,18782,4.030472103004292,20.0,20.0
14660,1,4660,[427  79 588  98 127],796,5,18787,4.030680111564042,20.0,20.0
14661,1,4661,[427  79 588  98 127],389,5,18792,4.030888030888031,20.0,20.0
14662,1,4662,[427  79 588  98 127],18,5,18797,4.031095861033669,20.0,20.0
14663,1,4663,[427  79 588  98 127],18,5,18802,4.031303602058319,20.0,20.0
14664,1,4664,[403 118  25 132 427],577,4,18806,4.031296891747052,20.0,0.0
14665,1,4665,[427  79 588  98 127],796,5,18811,4.031504500642949,20.0,20.0
14666,1,4666,[427  79 588  98 127],796,5,18816,4.03171202056996,20.0,20.0
14667,1,4667,[153  12 204  56 496],18,4,18820,4.031705227077977,20.0,0.0
14668,1,4668,[427  79 588  98 127],716,5,18825,4.031912615121011,20.0,20.0
14669,1,4669,[300 125 135 265  88],450,4,18829,4.031905781584582,0.0,0.0
14670,1,4670,[ 22   1 153 215 237],280,3,18832,4.031684864054807,0.0,0.0
14671,1,4671,[427  79 588  98 127],18,5,18837,4.031892123287672,20.0,20.0
14672,1,4672,[427  79 588  98 127],450,5,18842,4.032099293815536,20.0,20.0
14673,1,4673,[ 88 234 237 182 288],256,5,18847,4.032306375695336,0.0,0.0
14674,1,4674,[427  79 588  98 127],18,5,18852,4.032513368983957,20.0,20.0
14675,1,4675,[427  79 588  98 127],389,5,18857,4.032720273738238,20.0,20.0
14676,1,4676,[427  79 588  98 127],796,5,18862,4.032927090014967,20.0,20.0
14677,1,4677,[427  79 588  98 127],716,5,18867,4.033133817870885,20.0,20.0
14678,1,4678,[ 22  70 302 405 294],450,5,18872,4.0333404573626845,0.0,0.0
14679,1,4679,[238  28 196 234 265],457,5,18877,4.033547008547009,0.0,0.0
14680,1,4680,[427  79 588  98 127],18,5,18882,4.033753471480453,20.0,20.0
14681,1,4681,[204 111 405 215 197],796,4,18886,4.033746262281077,0.0,0.0
14682,1,4682,[121 118  98 125 328],796,5,18891,4.033952594490711,0.0,0.0
14683,1,4683,[210 333 257 181  22],655,0,18891,4.033091374893254,0.0,0.0
14684,1,4684,[294 508 191  82 118],655,1,18892,4.032443970117396,0.0,0.0
14685,1,4685,[496 234 423 483 118],151,4,18896,4.0324370465215535,20.0,0.0
14686,1,4686,[427  79 588  98 127],18,5,18901,4.0326434819714105,20.0,20.0
14687,1,4687,[427  79 588  98 127],450,5,18906,4.032849829351536,20.0,20.0
14688,1,4688,[ 69 222   4 275   1],457,5,18911,4.0330560887182765,0.0,20.0
14689,1,4689,[427  79 588  98 127],389,5,18916,4.033262260127932,20.0,20.0
14690,1,4690,[427  79 588  98 127],796,5,18921,4.033468343636751,20.0,20.0
14691,1,4691,[427  79 588  98 127],796,5,18926,4.033674339300938,20.0,20.0
14692,1,4692,[191 483 546  97  96],457,4,18930,4.03366716386107,0.0,0.0
14693,1,4693,[210 187 196  98 471],450,4,18934,4.033659991478483,0.0,0.0
14694,1,4694,[597  50  82 168  11],450,4,18938,4.0336528221512244,0.0,20.0
14695,1,4695,[228 302 125 216 603],450,5,18943,4.03385860306644,20.0,0.0
14696,1,4696,[427  79 588  98 127],450,5,18948,4.034064296359379,20.0,20.0
14697,1,4697,[427  79 588  98 127],450,5,18953,4.0342699020859945,20.0,20.0
14698,1,4698,[ 64 194 603 328 222],151,4,18957,4.034262609065759,40.0,0.0
14699,1,4699,[200 275 111 180 427],450,4,18961,4.0342553191489365,20.0,20.0
14700,1,4700,[427  79 588  98 127],716,5,18966,4.03446075303127,20.0,20.0
14701,1,4701,[427  79 588  98 127],389,5,18971,4.034666099532114,20.0,20.0
14702,1,4702,[ 82 216 265  98 186],796,3,18974,4.034446098235169,0.0,0.0
14703,1,4703,[  8 161  97 187 435],655,1,18975,4.033801020408164,0.0,0.0
14704,1,4704,[427  79 588  98 127],389,5,18980,4.034006376195537,20.0,20.0
14705,1,4705,[ 96 143 176 435 301],655,1,18981,4.033361665958351,0.0,0.0
14706,1,4706,[427  79 588  98 127],796,5,18986,4.03356702783089,20.0,20.0
14707,1,4707,[276  50 286 385 273],401,1,18987,4.032922684791844,0.0,40.0
14708,1,4708,[403 271  28 300 174],655,0,18987,4.03206625610533,0.0,0.0
14709,1,4709,[427  79 588  98 127],389,5,18992,4.032271762208068,20.0,20.0
14710,1,4710,[427  79 588  98 127],450,5,18997,4.032477181065591,20.0,20.0
14711,1,4711,[427  79 588  98 127],716,5,19002,4.032682512733446,20.0,20.0
14712,1,4712,[427  79 588  98 127],18,5,19007,4.032887757267133,20.0,20.0
14713,1,4713,[427  79 588  98 127],389,5,19012,4.033092914722104,20.0,20.0
14714,1,4714,[496 173  25 435 483],535,5,19017,4.033297985153765,20.0,0.0
14715,1,4715,[153   9 197 215 180],18,4,19021,4.033290924512299,0.0,0.0
14716,1,4716,[427  79 588  98 127],389,5,19026,4.033495866016536,20.0,20.0
14717,1,4717,[ 50 228  22 174 181],796,5,19031,4.033700720644341,0.0,20.0
14718,1,4718,[427  79 588  98 127],450,5,19036,4.033905488450943,20.0,20.0
14719,1,4719,[187 333 176  11 289],655,1,19037,4.033262711864407,0.0,0.0
14720,1,4720,[196 111 127 211   7],786,5,19042,4.0334674857021815,0.0,20.0
14721,1,4721,[ 64 121  28  69 100],796,3,19045,4.033248623464633,20.0,20.0
14722,1,4722,[427  79 588  98 127],716,5,19050,4.033453313571882,20.0,20.0
14723,1,4723,[187   4 322  50 216],796,4,19054,4.033446232006774,0.0,20.0
14724,1,4724,[748 118 211 161 322],796,3,19057,4.033227513227513,0.0,0.0
14725,1,4725,[ 82  28 127 282  88],457,5,19062,4.033432077867118,0.0,20.0
14726,1,4726,[197 323 427 678 183],316,2,19064,4.033001903955998,20.0,0.0
14727,1,4727,[333 276 100 132  50],655,2,19066,4.032571912013537,0.0,40.0
14728,1,4728,[187 121 405 182  12],503,1,19067,4.031930640727427,0.0,0.0
14729,1,4729,[427  79 588  98 127],716,5,19072,4.032135306553911,20.0,20.0
14730,1,4730,[427  79 588  98 127],716,5,19077,4.032339885859226,20.0,20.0
14731,1,4731,[  1  50 385 215 269],344,2,19079,4.031910397295013,0.0,20.0
14732,1,4732,[748 195 294 222  88],796,4,19083,4.031903655186985,0.0,0.0
14733,1,4733,[ 88  82 117 423  96],756,2,19085,4.031474440219688,0.0,0.0
14734,1,4734,[  1  12 546 265 181],151,4,19089,4.031467793030623,0.0,0.0
14735,1,4735,[288 222 200 125 313],450,2,19091,4.031038851351352,0.0,0.0
14736,1,4736,[427  79 588  98 127],18,5,19096,4.031243402997678,20.0,20.0
14737,1,4737,[300 185 427 515 144],655,3,19099,4.031025749261292,20.0,0.0
14738,1,4738,[286 237 111 742 258],839,3,19102,4.030808187381304,0.0,20.0
14739,1,4739,[427  79 588  98 127],716,5,19107,4.031012658227848,20.0,20.0
14740,1,4740,[289 187 183 179 265],236,1,19108,4.030373338958026,0.0,0.0
14741,1,4741,[427  79 588  98 127],450,5,19113,4.0305778152678196,20.0,20.0
14742,1,4742,[174 135  69 427 269],655,2,19115,4.030149694286317,20.0,0.0
14743,1,4743,[288  71 202   7 210],450,2,19117,4.0297217537942664,0.0,0.0
14744,1,4744,[427  79 588  98 127],389,5,19122,4.029926238145416,20.0,20.0
14745,1,4745,[191 204 211 427 135],151,4,19126,4.0299199325748,20.0,0.0
14746,1,4746,[427  79 588  98 127],18,5,19131,4.030124289024648,20.0,20.0
14747,1,4747,[ 96 435 216 357 196],450,5,19136,4.030328559393428,0.0,0.0
14748,1,4748,[435 603 471   1 143],389,4,19140,4.030322173089071,20.0,0.0
14749,1,4749,[427  79 588  98 127],796,5,19145,4.030526315789474,20.0,20.0
14750,1,4750,[294 181 127 515 427],716,5,19150,4.030730372553147,20.0,20.0
14751,1,4751,[204 186 132 546 496],503,4,19154,4.030723905723906,20.0,0.0
14752,1,4752,[427  79 588  98 127],716,5,19159,4.030927835051546,20.0,20.0
14753,1,4753,[427  79 588  98 127],18,5,19164,4.031131678586454,20.0,20.0
14754,1,4754,[215  22 186 180  82],450,3,19167,4.030914826498423,0.0,0.0
14755,1,4755,[186 234 185 282  70],716,3,19170,4.030698065601346,0.0,0.0
14756,1,4756,[222   9  50 265  98],796,4,19174,4.030691612360732,0.0,20.0
14757,1,4757,[427  79 588  98 127],18,5,19179,4.030895334174023,20.0,20.0
14758,1,4758,[427  79 588  98 127],450,5,19184,4.031098970371927,20.0,20.0
14759,1,4759,[127 427 187 179 172],269,4,19188,4.03109243697479,20.0,20.0
14760,1,4760,[ 71 211  64 195 357],18,4,19192,4.031085906322201,20.0,0.0
14761,1,4761,[405 174  64 273  25],450,3,19195,4.030869382612348,20.0,0.0
14762,1,4762,[427  79 588  98 127],389,5,19200,4.031072853243754,20.0,20.0
14763,1,4763,[ 69 185 176 328 289],236,4,19204,4.031066330814442,0.0,0.0
14764,1,4764,[ 25 144 385  69 211],655,0,19204,4.0302203567681,0.0,0.0
14765,1,4765,[427  79 588  98 127],796,5,19209,4.030423835501469,20.0,20.0
14766,1,4766,[427  79 588  98 127],450,5,19214,4.030627228865114,20.0,20.0
14767,1,4767,[427  79 588  98 127],389,5,19219,4.0308305369127515,20.0,20.0
14768,1,4768,[427  79 588  98 127],450,5,19224,4.03103375969805,20.0,20.0
14769,1,4769,[282 302 475 300 288],655,1,19225,4.030398322851153,0.0,0.0
14770,1,4770,[172 238 211  97   9],786,5,19230,4.030601551037519,0.0,0.0
14771,1,4771,[ 50 181 475 215 175],655,1,19231,4.029966471081307,0.0,20.0
14772,1,4772,[427  79 588  98 127],389,5,19236,4.030169704588309,20.0,20.0
14773,1,4773,[  8  15 196 117  50],655,1,19237,4.029534981147885,0.0,20.0
14774,1,4774,[427  79 588  98 127],796,5,19242,4.029738219895288,20.0,20.0
14775,1,4775,[427  79 588  98 127],18,5,19247,4.029941373534339,20.0,20.0
14776,1,4776,[ 69 196 175 515 161],716,3,19250,4.029725769311283,0.0,0.0
14777,1,4777,[202 318 471 289  28],655,1,19251,4.029091670154877,20.0,0.0
14778,1,4778,[153 427 196 100 515],269,3,19254,4.02887633396108,20.0,20.0
14779,1,4779,[427  79 588  98 127],389,5,19259,4.02907949790795,20.0,20.0
14780,1,4780,[176 655 118 234 168],504,2,19261,4.028655093076762,0.0,0.0
14781,1,4781,[427  79 588  98 127],716,5,19266,4.028858218318695,20.0,20.0
14782,1,4782,[179  88 483 289   9],655,2,19268,4.028434037215137,0.0,0.0
14783,1,4783,[179   8 234 546  50],577,2,19270,4.028010033444816,0.0,20.0
14784,1,4784,[234 151 678 300 100],504,4,19274,4.028004179728318,0.0,20.0
14785,1,4785,[427  79 588  98 127],796,5,19279,4.028207271207689,20.0,20.0
14786,1,4786,[483 111 546 313 385],796,5,19284,4.028410277835805,0.0,0.0
14787,1,4787,[  4 179  50  89   8],18,3,19287,4.0281954887218046,0.0,20.0
14788,1,4788,[118   1 143 483 323],796,3,19290,4.027980789308833,0.0,0.0
14789,1,4789,[ 98 121  82 568 173],798,4,19294,4.027974947807933,0.0,0.0
14790,1,4790,[ 88 117 144 288  97],457,5,19299,4.028177833437696,0.0,0.0
14791,1,4791,[655  71  28 143 318],236,3,19302,4.027963272120201,20.0,0.0
14792,1,4792,[427  79 588  98 127],18,5,19307,4.02816607552681,20.0,20.0
14793,1,4793,[427  79 588  98 127],18,5,19312,4.028368794326241,20.0,20.0
14794,1,4794,[427  79 588  98 127],796,5,19317,4.0285714285714285,20.0,20.0
14795,1,4795,[427  79 588  98 127],18,5,19322,4.028773978315263,20.0,20.0
14796,1,4796,[427  79 588  98 127],716,5,19327,4.02897644361059,20.0,20.0
14797,1,4797,[ 89 515 302 258 182],655,4,19331,4.02897040433514,0.0,0.0
14798,1,4798,[100 508  11 357   9],535,4,19335,4.028964367576578,0.0,20.0
14799,1,4799,[427  79 588  98 127],796,5,19340,4.029166666666667,20.0,20.0
14800,1,4800,[427  79 588  98 127],18,5,19345,4.029368881483024,20.0,20.0
14801,1,4801,[ 15  88 143 121 161],796,5,19350,4.029571012078301,0.0,0.0
14802,1,4802,[238  64 202  88 216],796,4,19354,4.029564855298772,20.0,0.0
14803,1,4803,[ 12 172 168  70 215],151,4,19358,4.029558701082431,0.0,0.0
14804,1,4804,[185  71  64 237 204],236,3,19361,4.029344432882414,20.0,0.0
14805,1,4805,[ 56 237 265 144  71],796,5,19366,4.029546400332917,0.0,0.0
14806,1,4806,[427  79 588  98 127],450,5,19371,4.02974828375286,20.0,20.0
14807,1,4807,[181 275 245  96 483],796,4,19375,4.0297420965058235,0.0,20.0
14808,1,4808,[ 15 257 568  64  88],655,1,19376,4.029112081513828,20.0,0.0
14809,1,4809,[427  79 588  98 127],796,5,19381,4.029313929313929,20.0,20.0
14810,1,4810,[435 132 234 186  79],807,3,19384,4.0290999792143,0.0,0.0
14811,1,4811,[427  79 588  98 127],796,5,19389,4.029301745635911,20.0,20.0
14812,1,4812,[276 197 200  11 265],655,2,19391,4.028880116351548,0.0,0.0
14813,1,4813,[427  79 588  98 127],716,5,19396,4.029081844619859,20.0,20.0
14814,1,4814,[427  79 588  98 127],716,5,19401,4.029283489096573,20.0,20.0
14815,1,4815,[742 144 100   1   9],655,0,19401,4.02844684385382,0.0,20.0
14816,1,4816,[282 121   4 161 180],796,4,19405,4.028440938343367,0.0,0.0
14817,1,4817,[427  79 588  98 127],389,5,19410,4.028642590286426,20.0,20.0
14818,1,4818,[427  79 588  98 127],18,5,19415,4.028844158539116,20.0,20.0
14819,1,4819,[153 215 144  50  70],535,4,19419,4.028838174273859,0.0,20.0
14820,1,4820,[ 25  11 121 568 427],716,5,19424,4.029039618336444,20.0,0.0
14821,1,4821,[161  79  97 111 568],457,4,19428,4.02903359601825,0.0,0.0
14822,1,4822,[427  79 588  98 127],389,5,19433,4.029234916027369,20.0,20.0
14823,1,4823,[179  82 603  70 403],269,2,19435,4.028814262023217,20.0,0.0
14824,1,4824,[313  71 181 216 678],344,1,19436,4.028186528497409,0.0,0.0
14825,1,4825,[427  79 588  98 127],389,5,19441,4.028387898881061,20.0,20.0
14826,1,4826,[237  98   1 182 216],256,5,19446,4.028589185829708,0.0,0.0
14827,1,4827,[427  79 588  98 127],450,5,19451,4.028790389395195,20.0,20.0
14828,1,4828,[427  79 588  98 127],389,5,19456,4.028991509629323,20.0,20.0
14829,1,4829,[197 173 179  22 191],269,3,19459,4.028778467908903,0.0,0.0
14830,1,4830,[427  79 588  98 127],796,5,19464,4.028979507348375,20.0,20.0
14831,1,4831,[427  79 588  98 127],18,5,19469,4.029180463576159,20.0,20.0
14832,1,4832,[173 234  69 172 127],796,4,19473,4.029174425822471,0.0,20.0
14833,1,4833,[427  79 588  98 127],18,5,19478,4.029375258585023,20.0,20.0
14834,1,4834,[427  79 588  98 127],18,5,19483,4.029576008273009,20.0,20.0
14835,1,4835,[427  79 588  98 127],18,5,19488,4.029776674937965,20.0,20.0
14836,1,4836,[427  79 588  98 127],389,5,19493,4.029977258631383,20.0,20.0
14837,1,4837,[427  79 588  98 127],389,5,19498,4.030177759404713,20.0,20.0
14838,1,4838,[210 204 294  64 234],450,3,19501,4.02996486877454,20.0,0.0
14839,1,4839,[427  79 588  98 127],796,5,19506,4.030165289256199,20.0,20.0
14840,1,4840,[176 322  56 603   1],450,5,19511,4.030365626936583,20.0,0.0
14841,1,4841,[ 11 286 288 423 268],174,3,19514,4.030152829409335,0.0,20.0
14842,1,4842,[427  79 588  98 127],389,5,19519,4.030353086929589,20.0,20.0
14843,1,4843,[427  79 588  98 127],450,5,19524,4.0305532617671345,20.0,20.0
14844,1,4844,[427  79 588  98 127],796,5,19529,4.030753353973168,20.0,20.0
14845,1,4845,[  1 603 435  82  79],716,5,19534,4.030953363598845,20.0,0.0
14846,1,4846,[427  79 588  98 127],450,5,19539,4.031153290695276,20.0,20.0
14847,1,4847,[471 282 483 175 200],655,2,19541,4.030734323432343,0.0,0.0
14848,1,4848,[427  79 588  98 127],18,5,19546,4.030934213239843,20.0,20.0
14849,1,4849,[427  79 588  98 127],716,5,19551,4.031134020618556,20.0,20.0
14850,1,4850,[194 127 427 181 187],236,3,19554,4.030921459492888,20.0,20.0
14851,1,4851,[216  79  95 286 174],18,5,19559,4.031121187139324,0.0,20.0
14852,1,4852,[ 22  50 471 385 168],716,3,19562,4.030908716257985,0.0,20.0
14853,1,4853,[ 70 286 405 288 546],593,3,19565,4.030696332921302,0.0,20.0
14854,1,4854,[475 568  96 238 289],655,0,19565,4.029866117404738,0.0,0.0
14855,1,4855,[427  79 588  98 127],796,5,19570,4.03006589785832,20.0,20.0
14856,1,4856,[183 302 237   4 181],450,4,19574,4.03005970763846,0.0,0.0
14857,1,4857,[471 302 301 546 269],450,5,19579,4.030259365994237,0.0,0.0
14858,1,4858,[265  25 181  70 210],151,5,19584,4.0304589421691706,0.0,0.0
14859,1,4859,[257 151 143 237 118],504,3,19587,4.030246913580247,0.0,0.0
14860,1,4860,[496 234 200 301 546],450,3,19590,4.030034972227937,20.0,0.0
14861,1,4861,[427  79 588  98 127],18,5,19595,4.030234471410942,20.0,20.0
14862,1,4862,[403 118 357 742 181],457,5,19600,4.030433888546165,0.0,0.0
14863,1,4863,[117  98  69 135 273],693,3,19603,4.030222039473684,0.0,0.0
14864,1,4864,[427  79 588  98 127],796,5,19608,4.030421377183967,20.0,20.0
14865,1,4865,[427  79 588  98 127],716,5,19613,4.030620632963419,20.0,20.0
14866,1,4866,[197 742 117   9  71],756,1,19614,4.029997945346209,0.0,0.0
14867,1,4867,[121 202 269 187  96],796,4,19618,4.029991783073131,0.0,0.0
14868,1,4868,[427  79 588  98 127],716,5,19623,4.030191004313001,20.0,20.0
14869,1,4869,[161 301 111  79 273],655,2,19625,4.029774127310062,0.0,0.0
14870,1,4870,[100 301  64 357 172],655,3,19628,4.0295627181276945,20.0,20.0
14871,1,4871,[ 70 257 235 323 172],23,1,19629,4.028940886699507,0.0,0.0
14872,1,4872,[ 28 496  70  69 405],786,5,19634,4.029140160065668,20.0,0.0
14873,1,4873,[427  79 588  98 127],716,5,19639,4.029339351661879,20.0,20.0
14874,1,4874,[197 153 427  50  64],151,4,19643,4.029333333333334,40.0,20.0
14875,1,4875,[546 357 302  56 427],151,3,19646,4.029122231337162,20.0,0.0
14876,1,4876,[427  79 588  98 127],389,5,19651,4.029321304080377,20.0,20.0
14877,1,4877,[483   1 215 173  79],535,3,19654,4.029110291102911,0.0,0.0
14878,1,4878,[ 88  50 276 333 546],174,4,19658,4.029104324656692,0.0,20.0
14879,1,4879,[322 235 174 185  69],450,4,19662,4.029098360655738,0.0,0.0
14880,1,4880,[  4 275 265 174 357],535,2,19664,4.028682646998566,0.0,20.0
14881,1,4881,[427 588  79  98 127],450,5,19669,4.028881605899222,20.0,20.0
14882,1,4882,[427 588  79  98 127],18,5,19674,4.029080483309441,20.0,20.0
14883,1,4883,[427 588  79  98 127],389,5,19679,4.0292792792792795,20.0,20.0
14884,1,4884,[238 216  88   8  25],655,1,19680,4.028659160696008,0.0,0.0
14885,1,4885,[427 588  79  98 127],18,5,19685,4.028857961522718,20.0,20.0
14886,1,4886,[161  56 357  98 202],457,5,19690,4.029056680990383,0.0,0.0
14887,1,4887,[186 125 181 471 215],450,4,19694,4.029050736497545,0.0,0.0
14888,1,4888,[176 135  15 143 121],457,5,19699,4.029249335242381,0.0,0.0
14889,1,4889,[197 222 215 100   7],655,0,19699,4.0284253578732105,0.0,20.0
14890,1,4890,[176  98  71  96 318],796,5,19704,4.0286240032713145,20.0,0.0
14891,1,4891,[183 276 333  89 258],655,3,19707,4.028413736713,0.0,0.0
14892,1,4892,[222 655 269   8 161],655,0,19707,4.027590435315757,0.0,0.0
14893,1,4893,[211  25 237 294 318],716,5,19712,4.027789129546384,20.0,0.0
14894,1,4894,[427 588  79  98 127],450,5,19717,4.027987742594484,20.0,20.0
14895,1,4895,[  9 228 144 238 655],655,0,19717,4.027165032679738,0.0,0.0
14896,1,4896,[143 161 257 318 202],457,4,19721,4.027159485399224,20.0,0.0
14897,1,4897,[215 204 151 175 196],151,4,19725,4.027153940383831,0.0,0.0
14898,1,4898,[ 79 117 144 183 111],457,4,19729,4.02714839763217,0.0,0.0
14899,1,4899,[427 588  79  98 127],716,5,19734,4.02734693877551,20.0,20.0
14900,1,4900,[ 96 135 153 161 180],450,4,19738,4.027341358906345,0.0,0.0
14901,1,4901,[427 588  79  98 127],389,5,19743,4.027539779681763,20.0,20.0
14902,1,4902,[211 181  50 423 118],655,1,19744,4.026922292473995,0.0,20.0
14903,1,4903,[ 95 237 302 288 655],450,3,19747,4.026712887438825,0.0,0.0
14904,1,4904,[245 216 215 228 568],450,5,19752,4.0269113149847096,0.0,0.0
14905,1,4905,[427 588  79  98 127],389,5,19757,4.02710966163881,20.0,20.0
14906,1,4906,[289  28 132 174  98],655,1,19758,4.026492765437131,0.0,0.0
14907,1,4907,[427 588  79  98 127],389,5,19763,4.026691116544417,20.0,20.0
14908,1,4908,[202  15 603 333 403],796,5,19768,4.026889386840497,20.0,0.0
14909,1,4909,[471 100 294 173 276],280,1,19769,4.026272912423625,0.0,20.0
14910,1,4910,[483 215 405 275  50],23,4,19773,4.026267562614539,0.0,40.0
14911,1,4911,[427 588  79  98 127],18,5,19778,4.026465798045603,20.0,20.0
14912,1,4912,[172 238 435 194 132],18,3,19781,4.026256869529819,0.0,0.0
14913,1,4913,[742 222 174 172 197],655,1,19782,4.0256410256410255,0.0,0.0
14914,1,4914,[427 588  79  98 127],796,5,19787,4.025839267548322,20.0,20.0
14915,1,4915,[173 237  64 144 655],535,4,19791,4.0258340113913755,20.0,0.0
14916,1,4916,[427 588  79  98 127],450,5,19796,4.026032133414684,20.0,20.0
14917,1,4917,[427 588  79  98 127],796,5,19801,4.026230174867832,20.0,20.0
14918,1,4918,[748 172  70 568  56],450,5,19806,4.026428135799959,0.0,0.0
14919,1,4919,[427 588  79  98 127],796,5,19811,4.026626016260162,20.0,20.0
14920,1,4920,[174 204  82  98 143],151,4,19815,4.026620605567974,0.0,0.0
14921,1,4921,[427 588  79  98 127],716,5,19820,4.026818366517675,20.0,20.0
14922,1,4922,[427 588  79  98 127],450,5,19825,4.027016047125736,20.0,20.0
14923,1,4923,[427 588  79  98 127],389,5,19830,4.027213647441105,20.0,20.0
14924,1,4924,[427 588  79  98 127],450,5,19835,4.027411167512691,20.0,20.0
14925,1,4925,[427 588  79  98 127],18,5,19840,4.027608607389363,20.0,20.0
14926,1,4926,[ 12  15 215 196 173],577,4,19844,4.027603003856302,0.0,0.0
14927,1,4927,[427 588  79  98 127],18,5,19849,4.027800324675325,20.0,20.0
14928,1,4928,[427 588  79  98 127],796,5,19854,4.027997565429093,20.0,20.0
14929,1,4929,[588 210  22 117  71],577,4,19858,4.027991886409736,0.0,0.0
14930,1,4930,[ 82 328 742 111 180],796,2,19860,4.027580612451835,0.0,0.0
14931,1,4931,[427 588  79  98 127],18,5,19865,4.027777777777778,20.0,20.0
14932,1,4932,[153  95  12 144  15],450,3,19868,4.027569430366917,0.0,0.0
14933,1,4933,[265 179 121 496  15],577,3,19871,4.0273611674098095,20.0,0.0
14934,1,4934,[427 588  79  98 127],389,5,19876,4.0275582573454916,20.0,20.0
14935,1,4935,[427 588  79  98 127],450,5,19881,4.027755267423014,20.0,20.0
14936,1,4936,[118 215  70 357 300],450,4,19885,4.027749645533725,0.0,0.0
14937,1,4937,[  9 318 228 143  70],655,2,19887,4.0273390036452,20.0,0.0
14938,1,4938,[202  22 211   9 187],655,1,19888,4.026726057906459,0.0,0.0
14939,1,4939,[127 180 475 508 237],296,5,19893,4.026923076923077,0.0,20.0
14940,1,4940,[427 588  79  98 127],716,5,19898,4.027120016191055,20.0,20.0
14941,1,4941,[427 588  79  98 127],796,5,19903,4.027316875758802,20.0,20.0
14942,1,4942,[427 588  79  98 127],18,5,19908,4.027513655674691,20.0,20.0
14943,1,4943,[197 172 265  50 271],629,5,19913,4.027710355987055,0.0,20.0
14944,1,4944,[427 588  79  98 127],389,5,19918,4.027906976744186,20.0,20.0
14945,1,4945,[289 258  12 200 176],655,1,19919,4.027294783663566,0.0,0.0
14946,1,4946,[427 588  79  98 127],796,5,19924,4.027491408934708,20.0,20.0
14947,1,4947,[427 588  79  98 127],716,5,19929,4.027687954729184,20.0,20.0
14948,1,4948,[427 588  79  98 127],450,5,19934,4.0278844210951705,20.0,20.0
14949,1,4949,[427 588  79  98 127],389,5,19939,4.028080808080808,20.0,20.0
14950,1,4950,[127 151 282 182  95],450,4,19943,4.028075136336094,0.0,20.0
14951,1,4951,[427 588  79  98 127],796,5,19948,4.02827140549273,20.0,20.0
14952,1,4952,[427 588  79  98 127],716,5,19953,4.028467595396729,20.0,20.0
14953,1,4953,[ 82 423 100 197  12],450,4,19957,4.0284618490109,0.0,20.0
14954,1,4954,[427 588  79  98 127],796,5,19962,4.028657921291624,20.0,20.0
14955,1,4955,[427 588  79  98 127],18,5,19967,4.028853914447135,20.0,20.0
14956,1,4956,[187 385  98 153 238],796,4,19971,4.028848093605003,0.0,0.0
14957,1,4957,[427 588  79  98 127],716,5,19976,4.029043969342477,20.0,20.0
14958,1,4958,[427 588  79  98 127],796,5,19981,4.029239766081871,20.0,20.0
14959,1,4959,[197  82 238 403 118],457,5,19986,4.029435483870968,0.0,0.0
14960,1,4960,[427 588  79  98 127],450,5,19991,4.029631122757508,20.0,20.0
14961,1,4961,[ 28  88 151   4 121],577,4,19995,4.02962515114873,0.0,0.0
14962,1,4962,[427 588  79  98 127],389,5,20000,4.029820672980052,20.0,20.0
14963,1,4963,[427 588  79  98 127],796,5,20005,4.030016116035455,20.0,20.0
14964,1,4964,[194 245 357  25 403],450,4,20009,4.0300100704934545,0.0,0.0
14965,1,4965,[427 588  79  98 127],450,5,20014,4.030205396697543,20.0,20.0
14966,1,4966,[655 742   4 323 357],796,2,20016,4.02979665794242,0.0,0.0
14967,1,4967,[427 588  79  98 127],18,5,20021,4.029991948470209,20.0,20.0
14968,1,4968,[427 588  79  98 127],450,5,20026,4.030187160394446,20.0,20.0
14969,1,4969,[427 588  79  98 127],18,5,20031,4.0303822937625755,20.0,20.0
14970,1,4970,[173 121   8  88 258],796,5,20036,4.030577348622008,0.0,0.0
14971,1,4971,[ 79 222 132  82 100],280,2,20038,4.03016894609815,0.0,20.0
14972,1,4972,[427 588  79  98 127],796,5,20043,4.0303639654132315,20.0,20.0
14973,1,4973,[427 588  79  98 127],389,5,20048,4.030558906312827,20.0,20.0
14974,1,4974,[  8 588 168 655 234],577,4,20052,4.030552763819095,0.0,0.0
14975,1,4975,[100  70 405 268 313],655,1,20053,4.029943729903537,0.0,20.0
14976,1,4976,[546 275 288 174 265],457,4,20057,4.029937713482017,0.0,20.0
14977,1,4977,[265 151 200 269  82],796,3,20060,4.029730815588589,0.0,0.0
14978,1,4978,[427 588  79  98 127],716,5,20065,4.0299256878891345,20.0,20.0
14979,1,4979,[ 95  79 216 100 125],796,4,20069,4.029919678714859,0.0,20.0
14980,1,4980,[ 89 678 127 318  79],807,3,20072,4.029712909054407,20.0,20.0
14981,1,4981,[268 195 117 275  11],629,4,20076,4.029706945002007,0.0,20.0
14982,1,4982,[135 271 172 195 215],655,2,20078,4.029299618703592,0.0,0.0
14983,1,4983,[427 588  79  98 127],18,5,20083,4.029494382022472,20.0,20.0
14984,1,4984,[427 588  79  98 127],18,5,20088,4.029689067201605,20.0,20.0
14985,1,4985,[121 216 135   7 182],269,2,20090,4.029281989570798,0.0,0.0
14986,1,4986,[427 588  79  98 127],450,5,20095,4.029476639262081,20.0,20.0
14987,1,4987,[427 588  79  98 127],796,5,20100,4.029671210906175,20.0,20.0
14988,1,4988,[603 161 151 588 323],756,3,20103,4.029464822609741,20.0,0.0
14989,1,4989,[427 588  79  98 127],18,5,20108,4.0296593186372744,20.0,20.0
14990,1,4990,[427 588  79  98 127],796,5,20113,4.029853736726107,20.0,20.0
14991,1,4991,[427 588  79  98 127],796,5,20118,4.030048076923077,20.0,20.0
14992,1,4992,[427 588  79  98 127],450,5,20123,4.030242339274985,20.0,20.0
14993,1,4993,[427 588  79  98 127],389,5,20128,4.030436523828595,20.0,20.0
14994,1,4994,[423 588 100  22 273],796,3,20131,4.03023023023023,0.0,20.0
14995,1,4995,[216 471 655 132  50],655,2,20133,4.02982385908727,0.0,20.0
14996,1,4996,[121 196 655 187  89],72,3,20136,4.029617770662397,0.0,0.0
14997,1,4997,[427 588  79  98 127],796,5,20141,4.029811924769908,20.0,20.0
14998,1,4998,[427 588  79  98 127],796,5,20146,4.03000600120024,20.0,20.0
14999,1,4999,[182 200 273 238 125],436,3,20149,4.0298,0.0,0.0
15000,1,5000,[427 588  79  98 127],389,5,20154,4.02999400119976,20.0,20.0
15001,1,5001,[187 153 179  98 435],269,3,20157,4.029788084766094,0.0,0.0
15002,1,5002,[215 200  98  11   4],450,3,20160,4.02958225064961,0.0,0.0
15003,1,5003,[427 588  79  98 127],796,5,20165,4.029776179056754,20.0,20.0
15004,1,5004,[222 151 655 161 175],23,2,20167,4.0293706293706295,0.0,0.0
15005,1,5005,[234 191   4  28 357],655,2,20169,4.028965241709948,0.0,0.0
15006,1,5006,[427 588  79  98 127],18,5,20174,4.029159177151987,20.0,20.0
15007,1,5007,[655 200 191  22 111],655,2,20176,4.0287539936102235,0.0,0.0
15008,1,5008,[427 588  79  98 127],18,5,20181,4.028947893791176,20.0,20.0
15009,1,5009,[427 588  79  98 127],716,5,20186,4.029141716566866,20.0,20.0
15010,1,5010,[ 69 318 483 313  25],693,3,20189,4.028936340051886,20.0,0.0
15011,1,5011,[151 181 294 222 172],457,4,20193,4.028930566640064,0.0,0.0
15012,1,5012,[172 282 179  82 191],457,5,20198,4.029124276880112,0.0,0.0
15013,1,5013,[427 588  79  98 127],389,5,20203,4.029317909852414,20.0,20.0
15014,1,5014,[427 588  79  98 127],450,5,20208,4.02951146560319,20.0,20.0
15015,1,5015,[427 588  79  98 127],389,5,20213,4.029704944178628,20.0,20.0
15016,1,5016,[318  95  28 603  98],716,5,20218,4.029898345624876,40.0,0.0
15017,1,5017,[275 655  15 202 100],450,4,20222,4.029892387405341,0.0,40.0
15018,1,5018,[427 588  79  98 127],716,5,20227,4.030085674437139,20.0,20.0
15019,1,5019,[ 22 172 515 228 471],807,5,20232,4.0302788844621515,0.0,0.0
15020,1,5020,[427 588  79  98 127],389,5,20237,4.030472017526389,20.0,20.0
15021,1,5021,[427 588  79  98 127],450,5,20242,4.030665073675826,20.0,20.0
15022,1,5022,[427 588  79  98 127],796,5,20247,4.0308580529564,20.0,20.0
15023,1,5023,[427 588  79  98 127],716,5,20252,4.031050955414012,20.0,20.0
15024,1,5024,[117 186 127 143 204],450,4,20256,4.031044776119403,0.0,20.0
15025,1,5025,[235 200 258 151 282],457,4,20260,4.0310385992837245,0.0,0.0
15026,1,5026,[385 238 328  22 153],450,5,20265,4.031231350706187,0.0,0.0
15027,1,5027,[427 588  79  98 127],18,5,20270,4.031424025457438,20.0,20.0
15028,1,5028,[427 588  79  98 127],18,5,20275,4.031616623583218,20.0,20.0
15029,1,5029,[118 100  56 182 423],593,4,20279,4.031610337972167,0.0,20.0
15030,1,5030,[427 588  79  98 127],796,5,20284,4.031802822500497,20.0,20.0
15031,1,5031,[568 265  25 385  56],457,5,20289,4.031995230524642,0.0,0.0
15032,1,5032,[427 588  79  98 127],18,5,20294,4.032187562090205,20.0,20.0
15033,1,5033,[180 151 282 257 118],716,2,20296,4.031783869686135,0.0,0.0
15034,1,5034,[ 50 228 143 135 183],5,4,20300,4.031777557100298,0.0,20.0
15035,1,5035,[195 121 100 181  71],344,2,20302,4.031374106433677,0.0,20.0
15036,1,5036,[151 273 216 483 185],236,3,20305,4.031169346833432,0.0,0.0
15037,1,5037,[427 588  79  98 127],716,5,20310,4.031361651448988,20.0,20.0
15038,1,5038,[427 588  79  98 127],18,5,20315,4.031553879738043,20.0,20.0
15039,1,5039,[ 64  50 195 471 301],450,5,20320,4.031746031746032,20.0,20.0
15040,1,5040,[195 100 191 179 318],269,4,20324,4.031739734179726,20.0,20.0
15041,1,5041,[173  82 121  12 568],450,3,20327,4.031535105117017,0.0,0.0
15042,1,5042,[427 588  79  98 127],450,5,20332,4.031727146539758,20.0,20.0
15043,1,5043,[427 588  79  98 127],796,5,20337,4.031919111816019,20.0,20.0
15044,1,5044,[196  71 234 132  50],796,4,20341,4.03191278493558,0.0,20.0
15045,1,5045,[275 588 187 568 135],389,3,20344,4.03170828378914,0.0,20.0
15046,1,5046,[427  89 185 603 238],421,5,20349,4.031900138696256,40.0,0.0
15047,1,5047,[427 588  79  98 127],18,5,20354,4.032091917591125,20.0,20.0
15048,1,5048,[427 588  79  98 127],450,5,20359,4.032283620518915,20.0,20.0
15049,1,5049,[427  64 204 174 202],18,3,20362,4.032079207920792,40.0,0.0
15050,1,5050,[427 588  79  98 127],18,5,20367,4.032270837457929,20.0,20.0
15051,1,5051,[427 588  79  98 127],796,5,20372,4.032462391132225,20.0,20.0
15052,1,5052,[427 588  79  98 127],18,5,20377,4.03265386898872,20.0,20.0
15053,1,5053,[427 588  79  98 127],389,5,20382,4.032845271072418,20.0,20.0
15054,1,5054,[222  96 197 172 125],457,5,20387,4.033036597428289,0.0,0.0
15055,1,5055,[427 588  79  98 127],716,5,20392,4.033227848101266,20.0,20.0
15056,1,5056,[655 237 508 194  96],269,3,20395,4.033023531738185,0.0,0.0
15057,1,5057,[427 588  79  98 127],796,5,20400,4.033214709371293,20.0,20.0
15058,1,5058,[385  70 181 210 258],344,1,20401,4.032615141332279,0.0,0.0
15059,1,5059,[100 603 173 153  96],450,5,20406,4.0328063241106715,20.0,20.0
15060,1,5060,[100 258 196  64 132],457,5,20411,4.03299743133768,20.0,20.0
15061,1,5061,[265  12 235 423 200],280,5,20416,4.03318846305808,0.0,0.0
15062,1,5062,[427 588  79  98 127],18,5,20421,4.033379419316611,20.0,20.0
15063,1,5063,[211  15 100 228  88],655,0,20421,4.032582938388626,0.0,20.0
15064,1,5064,[237 258 187 322 180],796,3,20424,4.032379072063178,0.0,0.0
15065,1,5065,[427 588  79  98 127],796,5,20429,4.03257007500987,20.0,20.0
15066,1,5066,[197 121 748 294 210],401,2,20431,4.032168936254194,0.0,0.0
15067,1,5067,[427 588  79  98 127],18,5,20436,4.032359905288082,20.0,20.0
15068,1,5068,[427 588  79  98 127],796,5,20441,4.032550798974157,20.0,20.0
15069,1,5069,[508  56 174  69 194],269,3,20444,4.032347140039448,0.0,0.0
15070,1,5070,[427 588  79  98 127],389,5,20449,4.032537960954447,20.0,20.0
15071,1,5071,[235 588 496 385 294],450,4,20453,4.032531545741325,20.0,0.0
15072,1,5072,[427 588  79  98 127],18,5,20458,4.032722255075892,20.0,20.0
15073,1,5073,[427 588  79  98 127],716,5,20463,4.032912889239259,20.0,20.0
15074,1,5074,[181 742  69 186 117],504,3,20466,4.032709359605911,0.0,0.0
15075,1,5075,[515 210 385 471 182],655,2,20468,4.03230890464933,0.0,0.0
15076,1,5076,[ 64 301  96  70  28],450,5,20473,4.032499507583219,20.0,0.0
15077,1,5077,[323  82 238 127 328],796,2,20475,4.032099251673888,0.0,20.0
15078,1,5078,[273 168 118  12 245],796,3,20478,4.031896042528056,0.0,0.0
15079,1,5079,[427 588  79  98 127],716,5,20483,4.032086614173228,20.0,20.0
15080,1,5080,[ 12 196  69 273  64],796,4,20487,4.0320802991537095,20.0,0.0
15081,1,5081,[427 588  79  98 127],389,5,20492,4.032270759543487,20.0,20.0
15082,1,5082,[357 546  82 216 143],450,4,20496,4.032264410781035,0.0,0.0
15083,1,5083,[ 64  88 269 204 546],344,3,20499,4.032061369000787,20.0,0.0
15084,1,5084,[427 588  79  98 127],716,5,20504,4.032251720747296,20.0,20.0
15085,1,5085,[427 588  79  98 127],716,5,20509,4.032441997640582,20.0,20.0
15086,1,5086,[ 22  70  11 175   7],344,2,20511,4.032042461175545,0.0,0.0
15087,1,5087,[288 588 180 143 483],457,5,20516,4.0322327044025155,0.0,0.0
15088,1,5088,[427 588  79  98 127],716,5,20521,4.032422872863038,20.0,20.0
15089,1,5089,[ 12 318 286 258 181],655,1,20522,4.031827111984283,20.0,20.0
15090,1,5090,[427 588  79  98 127],716,5,20527,4.032017285405618,20.0,20.0
15091,1,5091,[427 588  79  98 127],796,5,20532,4.032207384131972,20.0,20.0
15092,1,5092,[111 286 125 176 357],151,4,20536,4.032201060278814,0.0,20.0
15093,1,5093,[ 64 748 238 322 175],151,3,20539,4.031998429524931,20.0,0.0
15094,1,5094,[286 300 168 318 111],450,5,20544,4.032188420019627,20.0,20.0
15095,1,5095,[ 71 194 121 333 385],796,5,20549,4.0323783359497645,0.0,0.0
15096,1,5096,[427 588  79  98 127],450,5,20554,4.032568177359231,20.0,20.0
15097,1,5097,[200 185 195 403 568],457,5,20559,4.0327579442918795,0.0,0.0
15098,1,5098,[403 483 100 194 237],796,4,20563,4.032751519905864,0.0,20.0
15099,1,5099,[427 588  79  98 127],450,5,20568,4.0329411764705885,20.0,20.0
15100,1,5100,[ 15 228 435 121 234],623,4,20572,4.032934718682611,0.0,0.0
15101,1,5101,[427 588  79  98 127],796,5,20577,4.03312426499412,20.0,20.0
15102,1,5102,[ 56   9 211 200 257],655,1,20578,4.032529884381736,0.0,0.0
15103,1,5103,[427 588  79  98 127],389,5,20583,4.032719435736677,20.0,20.0
15104,1,5104,[216 161 258 276 294],504,3,20586,4.032517140058766,0.0,0.0
15105,1,5105,[135  50 151 117 423],457,5,20591,4.032706619663141,0.0,20.0
15106,1,5106,[181 185 655 471 197],655,1,20592,4.032112786371647,0.0,0.0
15107,1,5107,[427 588  79  98 127],18,5,20597,4.032302270947533,20.0,20.0
15108,1,5108,[427 588  79  98 127],18,5,20602,4.032491681346643,20.0,20.0
15109,1,5109,[423 161  15 118  69],577,3,20605,4.032289628180039,0.0,0.0
15110,1,5110,[427 588  79  98 127],389,5,20610,4.032478966934064,20.0,20.0
15111,1,5111,[135 204 271 302 286],655,2,20612,4.032081377151799,0.0,20.0
15112,1,5112,[427 588  79  98 127],450,5,20617,4.032270682573832,20.0,20.0
15113,1,5113,[427 588  79  98 127],389,5,20622,4.032459913961674,20.0,20.0
15114,1,5114,[204 211 180 435 235],269,1,20623,4.03186705767351,0.0,0.0
15115,1,5115,[427 588  79  98 127],716,5,20628,4.032056293979672,20.0,20.0
15116,1,5116,[427 588  79  98 127],796,5,20633,4.032245456322063,20.0,20.0
15117,1,5117,[427 588  79  98 127],389,5,20638,4.03243454474404,20.0,20.0
15118,1,5118,[427 588  79  98 127],796,5,20643,4.032623559288924,20.0,20.0
15119,1,5119,[427 588  79  98 127],450,5,20648,4.0328125,20.0,20.0
15120,1,5120,[ 69 222 427  96  22],807,4,20652,4.032806092560047,20.0,0.0
15121,1,5121,[435  98 174 238  25],716,5,20657,4.032994923857868,0.0,0.0
15122,1,5122,[427 588  79  98 127],18,5,20662,4.033183681436658,20.0,20.0
15123,1,5123,[427 588  79  98 127],796,5,20667,4.033372365339578,20.0,20.0
15124,1,5124,[427 588  79  98 127],18,5,20672,4.033560975609756,20.0,20.0
15125,1,5125,[427 588  79  98 127],18,5,20677,4.033749512290285,20.0,20.0
15126,1,5126,[125 289 405 100 210],655,0,20677,4.032962746245368,0.0,20.0
15127,1,5127,[197 173 328 435 111],629,4,20681,4.03295631825273,0.0,0.0
15128,1,5128,[127 185 222 175 603],655,3,20684,4.032754922986937,20.0,20.0
15129,1,5129,[427 588  79  98 127],450,5,20689,4.032943469785575,20.0,20.0
15130,1,5130,[427 588  79  98 127],796,5,20694,4.033131943091015,20.0,20.0
15131,1,5131,[427 588  79  98 127],796,5,20699,4.03332034294622,20.0,20.0
15132,1,5132,[427 194 183 515  79],908,4,20703,4.033313851548802,20.0,0.0
15133,1,5133,[179 195 403 185 269],18,2,20705,4.032917802882743,0.0,0.0
15134,1,5134,[ 22 748  12 176 127],280,3,20708,4.03271665043817,0.0,20.0
15135,1,5135,[187 742 357 403 216],655,3,20711,4.032515576323988,0.0,0.0
15136,1,5136,[427 588  79  98 127],389,5,20716,4.032703912789566,20.0,20.0
15137,1,5137,[125  11 405 211  64],450,5,20721,4.032892175943947,20.0,0.0
15138,1,5138,[427 588  79  98 127],450,5,20726,4.033080365829928,20.0,20.0
15139,1,5139,[216   4 301 194 483],796,4,20730,4.033073929961089,0.0,0.0
15140,1,5140,[427 588  79  98 127],796,5,20735,4.033262011281852,20.0,20.0
15141,1,5141,[176   9 191 121   4],344,4,20739,4.033255542590432,0.0,0.0
15142,1,5142,[222 235 655 228 182],457,4,20743,4.033249076414544,0.0,0.0
15143,1,5143,[132 125 357  89 135],151,5,20748,4.033437013996889,0.0,0.0
15144,1,5144,[ 88  97 172  11 268],344,1,20749,4.032847424684159,0.0,0.0
15145,1,5145,[427 588  79  98 127],796,5,20754,4.033035367275554,20.0,20.0
15146,1,5146,[427 588  79  98 127],796,5,20759,4.033223236836992,20.0,20.0
15147,1,5147,[496 194 151 185  22],269,4,20763,4.033216783216783,20.0,0.0
15148,1,5148,[121 183 187  25 483],693,1,20764,4.032627694697999,0.0,0.0
15149,1,5149,[  8 211 742  89   9],655,1,20765,4.032038834951456,0.0,0.0
15150,1,5150,[313  15  98 211 183],450,4,20769,4.032032615026209,0.0,0.0
15151,1,5151,[427 588  79  98 127],716,5,20774,4.03222049689441,20.0,20.0
15152,1,5152,[427 588  79  98 127],389,5,20779,4.032408305841257,20.0,20.0
15153,1,5153,[515   4 204 655  97],535,3,20782,4.03220799379123,0.0,0.0
15154,1,5154,[257 496 127 194 176],796,5,20787,4.032395732298739,20.0,20.0
15155,1,5155,[427 588  79  98 127],18,5,20792,4.032583397982933,20.0,20.0
15156,1,5156,[427 588  79  98 127],450,5,20797,4.032770990886174,20.0,20.0
15157,1,5157,[427 588  79  98 127],716,5,20802,4.032958511050795,20.0,20.0
15158,1,5158,[275 151 357 173 210],796,4,20806,4.032952122504361,0.0,20.0
15159,1,5159,[427 588  79  98 127],18,5,20811,4.033139534883721,20.0,20.0
15160,1,5160,[427 588  79  98 127],389,5,20816,4.033326874636698,20.0,20.0
15161,1,5161,[427 588  79  98 127],716,5,20821,4.033514141805502,20.0,20.0
15162,1,5162,[ 88 322 204 496 185],450,5,20826,4.033701336432307,20.0,0.0
15163,1,5163,[403  56 183 302 471],655,2,20828,4.033307513555384,0.0,0.0
15164,1,5164,[258 286 173 275  25],151,5,20833,4.0334946757018395,0.0,40.0
15165,1,5165,[427 588  79  98 127],450,5,20838,4.033681765389082,20.0,20.0
15166,1,5166,[ 22 174 135  11  64],655,2,20840,4.033288174956454,20.0,0.0
15167,1,5167,[265  50 318 210 385],786,5,20845,4.033475232198143,20.0,20.0
15168,1,5168,[427 588  79  98 127],18,5,20850,4.033662217063262,20.0,20.0
15169,1,5169,[427 588  79  98 127],18,5,20855,4.03384912959381,20.0,20.0
15170,1,5170,[275  82 196 286 111],796,3,20858,4.0336491974473025,0.0,40.0
15171,1,5171,[427 588  79  98 127],716,5,20863,4.033836040216551,20.0,20.0
15172,1,5172,[121 237 222 496 173],344,3,20866,4.033636187898705,20.0,0.0
15173,1,5173,[508 117  12 176  50],693,2,20868,4.033243138770777,0.0,20.0
15174,1,5174,[427 588  79  98 127],796,5,20873,4.033429951690821,20.0,20.0
15175,1,5175,[427 588  79  98 127],18,5,20878,4.033616692426584,20.0,20.0
15176,1,5176,[427 588  79  98 127],450,5,20883,4.033803361019896,20.0,20.0
15177,1,5177,[427 588  79  98 127],716,5,20888,4.033989957512553,20.0,20.0
15178,1,5178,[  7 508 144 125 143],655,1,20889,4.033404132071828,0.0,0.0
15179,1,5179,[427 588  79  98 127],18,5,20894,4.033590733590733,20.0,20.0
15180,1,5180,[427 588  79  98 127],716,5,20899,4.033777263076626,20.0,20.0
15181,1,5181,[ 82 238 357  64 179],18,4,20903,4.033770744886144,20.0,0.0
15182,1,5182,[742 180 210 191 234],693,0,20903,4.032992475400348,0.0,0.0
15183,1,5183,[200 202 174 153 483],450,3,20906,4.0327932098765435,0.0,0.0
15184,1,5184,[ 28 357  96 197 222],450,4,20910,4.032786885245901,0.0,0.0
15185,1,5185,[427 588  79  98 127],18,5,20915,4.032973389895873,20.0,20.0
15186,1,5186,[202  22  88 195   1],655,0,20915,4.032195874301137,0.0,0.0
15187,1,5187,[ 96   7  89 235 603],269,1,20916,4.031611410948343,20.0,0.0
15188,1,5188,[197  96 318 161  56],280,4,20920,4.03160531894392,20.0,0.0
15189,1,5189,[427 588  79  98 127],796,5,20925,4.031791907514451,20.0,20.0
15190,1,5190,[427 588  79  98 127],389,5,20930,4.0319784241957235,20.0,20.0
15191,1,5191,[195 238  97 176 588],796,3,20933,4.031779661016949,0.0,0.0
15192,1,5192,[748 423  98 222  82],450,3,20936,4.0315809743886,0.0,0.0
15193,1,5193,[135 197  98  70  69],65,3,20939,4.031382364266461,0.0,0.0
15194,1,5194,[427 588  79  98 127],716,5,20944,4.031568816169393,20.0,20.0
15195,1,5195,[222 153  79 183 117],716,4,20948,4.031562740569669,0.0,0.0
15196,1,5196,[427 588  79  98 127],389,5,20953,4.03174908601116,20.0,20.0
15197,1,5197,[427 588  79  98 127],389,5,20958,4.031935359753751,20.0,20.0
15198,1,5198,[427 588  79  98 127],450,5,20963,4.0321215618388155,20.0,20.0
15199,1,5199,[121 282 301 427 191],796,4,20967,4.032115384615385,20.0,0.0
15200,1,5200,[427 588  79  98 127],18,5,20972,4.032301480484522,20.0,20.0
15201,1,5201,[211 181 168  56 215],535,4,20976,4.0322952710495965,0.0,0.0
15202,1,5202,[427  79 100  96 515],908,5,20981,4.03248126081107,20.0,20.0
15203,1,5203,[427 588  79  98 127],18,5,20986,4.032667179093005,20.0,20.0
15204,1,5204,[427 588  79  98 127],18,5,20991,4.0328530259366,20.0,20.0
15205,1,5205,[427 588  79  98 127],450,5,20996,4.03303880138302,20.0,20.0
15206,1,5206,[427 588  79  98 127],18,5,21001,4.0332245054734015,20.0,20.0
15207,1,5207,[588  22  71 186 121],796,4,21005,4.033218125960062,0.0,0.0
15208,1,5208,[238 294 151  64 202],450,5,21010,4.0334037243232865,20.0,0.0
15209,1,5209,[427 588  79  98 127],716,5,21015,4.0335892514395395,20.0,20.0
15210,1,5210,[427 588  79  98 127],18,5,21020,4.033774707349837,20.0,20.0
15211,1,5211,[427 588  79  98 127],450,5,21025,4.033960092095165,20.0,20.0
15212,1,5212,[ 71  82 185 271 257],796,4,21029,4.033953577594476,0.0,0.0
15213,1,5213,[427 588  79  98 127],796,5,21034,4.034138856923667,20.0,20.0
15214,1,5214,[204  79 385 269 172],796,4,21038,4.034132310642378,0.0,0.0
15215,1,5215,[603  56 275  71 204],23,3,21041,4.033934049079755,20.0,20.0
15216,1,5216,[427 588  79  98 127],796,5,21046,4.034119225608587,20.0,20.0
15217,1,5217,[  1 132  88  28 568],457,5,21051,4.034304331161365,0.0,0.0
15218,1,5218,[427 588  79  98 127],716,5,21056,4.034489365778885,20.0,20.0
15219,1,5219,[322 135 678 496 258],942,2,21058,4.034099616858238,20.0,0.0
15220,1,5220,[427 588  79  98 127],796,5,21063,4.034284619804635,20.0,20.0
15221,1,5221,[427 588  79  98 127],389,5,21068,4.034469551895826,20.0,20.0
15222,1,5222,[289  71 333 210 111],236,2,21070,4.034080030633735,0.0,0.0
15223,1,5223,[ 64 313  96 357   1],655,3,21073,4.033882082695253,20.0,0.0
15224,1,5224,[483 111  22  28  79],450,4,21077,4.033875598086125,0.0,0.0
15225,1,5225,[191 143 237 196 313],835,5,21082,4.034060466896288,0.0,0.0
15226,1,5226,[427 588  79  98 127],716,5,21087,4.034245264970346,20.0,20.0
15227,1,5227,[  8   7 125 202  95],344,4,21091,4.034238714613619,0.0,0.0
15228,1,5228,[215  50 588 275 655],716,5,21096,4.034423407917384,0.0,40.0
15229,1,5229,[257 269 483 288 132],655,1,21097,4.033843212237094,0.0,0.0
15230,1,5230,[403 222 435   7 258],450,4,21101,4.033836742496654,0.0,0.0
15231,1,5231,[153 748 496 121 183],151,2,21103,4.033448012232416,20.0,0.0
15232,1,5232,[197 195  50   1 405],655,1,21104,4.032868335562775,0.0,20.0
15233,1,5233,[427 588  79  98 127],796,5,21109,4.0330531142529615,20.0,20.0
15234,1,5234,[427 588  79  98 127],18,5,21114,4.03323782234957,20.0,20.0
15235,1,5235,[286 174 144   1 405],280,2,21116,4.032849503437738,0.0,20.0
15236,1,5236,[234  28 300 211 323],504,4,21120,4.032843230857361,0.0,0.0
15237,1,5237,[118 286 357  89 180],796,3,21123,4.0326460481099655,0.0,20.0
15238,1,5238,[427 588  79  98 127],716,5,21128,4.032830692880321,20.0,20.0
15239,1,5239,[257  79  89 508 300],655,2,21130,4.032442748091603,0.0,0.0
15240,1,5240,[151 173  88 588 568],716,5,21135,4.032627361190612,0.0,0.0
15241,1,5241,[215   1 153 318 228],330,5,21140,4.032811903853491,20.0,0.0
15242,1,5242,[228 181 322 276 234],786,2,21142,4.032424184627122,0.0,0.0
15243,1,5243,[427 588  79  98 127],389,5,21147,4.032608695652174,20.0,20.0
15244,1,5244,[183  96  56 288 275],655,2,21149,4.032221163012393,0.0,20.0
15245,1,5245,[427 588  79  98 127],450,5,21154,4.032405642394205,20.0,20.0
15246,1,5246,[427 588  79  98 127],716,5,21159,4.0325900514579756,20.0,20.0
15247,1,5247,[ 12 357  15 185 210],796,4,21163,4.032583841463414,0.0,0.0
15248,1,5248,[427 588  79  98 127],796,5,21168,4.032768146313583,20.0,20.0
15249,1,5249,[427 588  79  98 127],18,5,21173,4.032952380952381,20.0,20.0
15250,1,5250,[197 357 111 318  82],450,4,21177,4.032946105503713,20.0,0.0
15251,1,5251,[191 483 127 195  69],693,2,21179,4.032559025133282,0.0,20.0
15252,1,5252,[427 588  79  98 127],716,5,21184,4.032743194365125,20.0,20.0
15253,1,5253,[748 127 117 423 222],450,4,21188,4.032736962314427,0.0,20.0
15254,1,5254,[121  25  64 216 318],151,5,21193,4.032921027592769,40.0,0.0
15255,1,5255,[265  25 186 318 100],655,1,21194,4.03234398782344,20.0,20.0
15256,1,5256,[427 588  79  98 127],796,5,21199,4.032528057827658,20.0,20.0
15257,1,5257,[ 98   4  96 483   1],457,5,21204,4.03271205781666,0.0,0.0
15258,1,5258,[427 588  79  98 127],389,5,21209,4.032895987830386,20.0,20.0
15259,1,5259,[655   8 234 235 216],280,3,21212,4.032699619771863,0.0,0.0
15260,1,5260,[427 588  79  98 127],716,5,21217,4.032883482227714,20.0,20.0
15261,1,5261,[427 588  79  98 127],450,5,21222,4.033067274800456,20.0,20.0
15262,1,5262,[ 12  98 132 215  97],577,5,21227,4.033250997529926,0.0,0.0
15263,1,5263,[568 100 237 257 118],796,4,21231,4.033244680851064,0.0,20.0
15264,1,5264,[742   9 234 288 197],457,5,21236,4.0334283000949664,0.0,0.0
15265,1,5265,[427 588  79  98 127],389,5,21241,4.033611849601216,20.0,20.0
15266,1,5266,[427 588  79  98 127],18,5,21246,4.033795329409531,20.0,20.0
15267,1,5267,[  4 301  25  95 302],344,5,21251,4.033978739559605,0.0,0.0
15268,1,5268,[403 471 313 603 202],655,2,21253,4.033592712089581,20.0,0.0
15269,1,5269,[132 187  71 161 222],450,3,21256,4.0333965844402275,0.0,0.0
15270,1,5270,[427 588  79  98 127],389,5,21261,4.033579965850882,20.0,20.0
15271,1,5271,[132 194  22 435 181],18,3,21264,4.033383915022762,0.0,0.0
15272,1,5272,[427 588  79  98 127],389,5,21269,4.033567229281244,20.0,20.0
15273,1,5273,[ 79 187 588 483 204],450,4,21273,4.033560864618885,0.0,0.0
15274,1,5274,[385 748 603 328 286],151,2,21275,4.033175355450237,20.0,20.0
15275,1,5275,[ 56 313 127  96 258],796,5,21280,4.033358605003791,0.0,20.0
15276,1,5276,[144 655  70 568   9],280,2,21282,4.032973280272882,0.0,0.0
15277,1,5277,[427 588  79  98 127],796,5,21287,4.0331564986737405,20.0,20.0
15278,1,5278,[427 588  79  98 127],389,5,21292,4.033339647660542,20.0,20.0
15279,1,5279,[435 143  79 508  28],655,2,21294,4.032954545454546,0.0,0.0
15280,1,5280,[427 588  79  98 127],716,5,21299,4.033137663321341,20.0,20.0
15281,1,5281,[427 588  79  98 127],18,5,21304,4.033320711851571,20.0,20.0
15282,1,5282,[427 588  79  98 127],450,5,21309,4.033503691084611,20.0,20.0
15283,1,5283,[427 588  79  98 127],389,5,21314,4.033686601059803,20.0,20.0
15284,1,5284,[ 69 176 211  97 121],151,4,21318,4.033680227057711,0.0,0.0
15285,1,5285,[  8 216   7 161 196],23,3,21321,4.0334846765039725,0.0,0.0
15286,1,5286,[294 385 435 195  11],655,0,21321,4.032721770380178,0.0,0.0
15287,1,5287,[427 588  79  98 127],18,5,21326,4.032904689863843,20.0,20.0
15288,1,5288,[427 588  79  98 127],450,5,21331,4.0330875401777275,20.0,20.0
15289,1,5289,[111 180 100  89 185],796,3,21334,4.03289224952741,0.0,20.0
15290,1,5290,[294 181 471 202  64],401,2,21336,4.032508032508033,20.0,0.0
15291,1,5291,[ 11  25 357 121 276],344,3,21339,4.032312925170068,0.0,0.0
15292,1,5292,[427 588  79  98 127],389,5,21344,4.032495749102588,20.0,20.0
15293,1,5293,[ 95 215  96 282 483],450,3,21347,4.032300717793729,0.0,0.0
15294,1,5294,[427 588  79  98 127],796,5,21352,4.0324834749763925,20.0,20.0
15295,1,5295,[135 183 127 423 288],693,2,21354,4.032099697885196,0.0,20.0
15296,1,5296,[322 678 172 127 174],280,2,21356,4.031716065697565,0.0,20.0
15297,1,5297,[427 588  79  98 127],18,5,21361,4.031898829747075,20.0,20.0
15298,1,5298,[ 88  22 196 423 235],269,1,21362,4.031326665408567,0.0,0.0
15299,1,5299,[168 183   1  71 483],450,3,21365,4.031132075471698,0.0,0.0
15300,1,5300,[ 28 151 294  89 385],796,3,21368,4.030937558951141,0.0,0.0
15301,1,5301,[427 588  79  98 127],389,5,21373,4.031120331950207,20.0,20.0
15302,1,5302,[427 588  79  98 127],18,5,21378,4.0313030360173485,20.0,20.0
15303,1,5303,[427 588  79  98 127],389,5,21383,4.031485671191554,20.0,20.0
15304,1,5304,[427 588  79  98 127],389,5,21388,4.031668237511782,20.0,20.0
15305,1,5305,[427 588  79  98 127],716,5,21393,4.031850735016962,20.0,20.0
15306,1,5306,[427 588  79  98 127],389,5,21398,4.032033163745996,20.0,20.0
15307,1,5307,[655 405 215  28  98],655,1,21399,4.031461944235117,0.0,0.0
15308,1,5308,[318 322 286 216 471],786,4,21403,4.031456018082501,20.0,20.0
15309,1,5309,[268 195   8  50 111],269,1,21404,4.030885122410546,0.0,20.0
15310,1,5310,[222 210 196 568 403],693,1,21405,4.030314441724722,0.0,0.0
15311,1,5311,[  8 302 187 143 210],389,3,21408,4.030120481927711,0.0,0.0
15312,1,5312,[127  70  50 403 204],18,3,21411,4.029926595143986,0.0,40.0
15313,1,5313,[427 588  79  98 127],716,5,21416,4.030109145652992,20.0,20.0
15314,1,5314,[322 117  79 204  12],344,3,21419,4.029915333960489,0.0,0.0
15315,1,5315,[427 588  79  98 127],796,5,21424,4.030097817908202,20.0,20.0
15316,1,5316,[427 588  79  98 127],796,5,21429,4.030280233214219,20.0,20.0
15317,1,5317,[427 588  79  98 127],796,5,21434,4.030462579917262,20.0,20.0
15318,1,5318,[143 228  50  89 423],796,5,21439,4.030644858056026,0.0,20.0
15319,1,5319,[427 588  79  98 127],389,5,21444,4.030827067669173,20.0,20.0
15320,1,5320,[427 588  79  98 127],716,5,21449,4.031009208795339,20.0,20.0
15321,1,5321,[ 88  82 204 385  22],457,5,21454,4.031191281473131,0.0,0.0
15322,1,5322,[294  97 195 161  98],716,3,21457,4.030997557768176,0.0,0.0
15323,1,5323,[ 11   9 176 603 211],269,3,21460,4.030803906836964,20.0,0.0
15324,1,5324,[427 588  79  98 127],796,5,21465,4.030985915492958,20.0,20.0
15325,1,5325,[483  69 181 427 174],693,2,21467,4.030604581299286,20.0,0.0
15326,1,5326,[427 588  79  98 127],450,5,21472,4.030786559038859,20.0,20.0
15327,1,5327,[427 588  79  98 127],450,5,21477,4.030968468468468,20.0,20.0
15328,1,5328,[ 15  50 143  71 195],330,4,21481,4.030962657158941,0.0,20.0
15329,1,5329,[427 588  79  98 127],450,5,21486,4.031144465290807,20.0,20.0
15330,1,5330,[ 25   1 195 234 588],450,3,21489,4.030951041080472,0.0,0.0
15331,1,5331,[258 172 313 282 235],450,4,21493,4.030945236309077,0.0,0.0
15332,1,5332,[427 588  79  98 127],716,5,21498,4.03112694543409,20.0,20.0
15333,1,5333,[357 187 234 197  79],655,3,21501,4.030933633295838,0.0,0.0
15334,1,5334,[200 294 597 196 215],457,3,21504,4.030740393626991,0.0,0.0
15335,1,5335,[216 172 132  98 168],716,5,21509,4.03092203898051,0.0,0.0
15336,1,5336,[135 588 195 211  50],18,3,21512,4.030728873899195,0.0,20.0
15337,1,5337,[427 588  79  98 127],796,5,21517,4.030910453353316,20.0,20.0
15338,1,5338,[427 588  79  98 127],450,5,21522,4.0310919647874135,20.0,20.0
15339,1,5339,[427 588  79  98 127],450,5,21527,4.0312734082397,20.0,20.0
15340,1,5340,[427 588  79  98 127],450,5,21532,4.031454783748361,20.0,20.0
15341,1,5341,[427 588  79  98 127],716,5,21537,4.031636091351554,20.0,20.0
15342,1,5342,[427 588  79  98 127],18,5,21542,4.031817331087404,20.0,20.0
15343,1,5343,[427 588  79  98 127],389,5,21547,4.031998502994012,20.0,20.0
15344,1,5344,[427 588  79  98 127],389,5,21552,4.032179607109448,20.0,20.0
15345,1,5345,[427 588  79  98 127],18,5,21557,4.032360643471755,20.0,20.0
15346,1,5346,[655 435  50  56 125],450,5,21562,4.032541612118945,0.0,20.0
15347,1,5347,[427 588  79  98 127],389,5,21567,4.032722513089006,20.0,20.0
15348,1,5348,[  9 323 215 546  71],280,3,21570,4.03252944475603,0.0,0.0
15349,1,5349,[427 588  79  98 127],18,5,21575,4.0327102803738315,20.0,20.0
15350,1,5350,[ 97 257 187 742 318],655,2,21577,4.032330405531677,20.0,0.0
15351,1,5351,[153 322 234 211 182],450,4,21581,4.0323243647234674,0.0,0.0
15352,1,5352,[427 588  79  98 127],18,5,21586,4.032505137306184,20.0,20.0
15353,1,5353,[427 588  79  98 127],18,5,21591,4.032685842360852,20.0,20.0
15354,1,5354,[427 588  79  98 127],716,5,21596,4.032866479925303,20.0,20.0
15355,1,5355,[ 69  12 318 175 194],18,3,21599,4.032673637042569,20.0,0.0
15356,1,5356,[143  12 318 111 132],796,5,21604,4.032854209445585,20.0,0.0
15357,1,5357,[483 173  11  71 508],401,1,21605,4.032288167226577,0.0,0.0
15358,1,5358,[333 301  98 153 275],629,4,21609,4.032282142190708,0.0,20.0
15359,1,5359,[172 176   1 180   4],716,2,21611,4.031902985074627,0.0,0.0
15360,1,5360,[127 187  88  15 172],796,5,21616,4.0320835664987875,0.0,20.0
15361,1,5361,[282 173 294 273   7],450,4,21620,4.0320775829914215,0.0,0.0
15362,1,5362,[427 588  79  98 127],716,5,21625,4.032258064516129,20.0,20.0
15363,1,5363,[ 97  12 322 496 483],450,4,21629,4.0322520507084265,20.0,0.0
15364,1,5364,[175 294 187 282 588],716,2,21631,4.0318732525629075,0.0,0.0
15365,1,5365,[427 588  79  98 127],450,5,21636,4.032053671263511,20.0,20.0
15366,1,5366,[427 588  79  98 127],18,5,21641,4.032234022731507,20.0,20.0
15367,1,5367,[196 742 328 301 318],450,5,21646,4.032414307004471,20.0,0.0
15368,1,5368,[427 588  79  98 127],18,5,21651,4.032594524119948,20.0,20.0
15369,1,5369,[318 118  11 265 204],716,4,21655,4.032588454376164,20.0,0.0
15370,1,5370,[427 588  79  98 127],450,5,21660,4.032768571960529,20.0,20.0
15371,1,5371,[204  25   4 508  71],344,4,21664,4.032762472077438,0.0,0.0
15372,1,5372,[ 69 288 111 471  70],344,2,21666,4.032384142936907,0.0,0.0
15373,1,5373,[143 588 196 515 135],716,4,21670,4.0323781168589505,0.0,0.0
15374,1,5374,[427 588  79  98 127],450,5,21675,4.032558139534884,20.0,20.0
15375,1,5375,[427 588  79  98 127],716,5,21680,4.032738095238095,20.0,20.0
15376,1,5376,[427 588  79  98 127],389,5,21685,4.032917984005952,20.0,20.0
15377,1,5377,[318  69 196 211 216],693,2,21687,4.032539977686873,20.0,0.0
15378,1,5378,[427 588  79  98 127],450,5,21692,4.032719836400818,20.0,20.0
15379,1,5379,[427 588  79  98 127],796,5,21697,4.032899628252788,20.0,20.0
15380,1,5380,[427 588  79  98 127],796,5,21702,4.033079353280059,20.0,20.0
15381,1,5381,[385 125 111  69   4],786,5,21707,4.033259011519881,0.0,0.0
15382,1,5382,[ 82 127 100 117 200],421,4,21711,4.033252832992755,0.0,40.0
15383,1,5383,[427 588  79  98 127],450,5,21716,4.0334323922734026,20.0,20.0
15384,1,5384,[427 588  79  98 127],450,5,21721,4.033611884865366,20.0,20.0
15385,1,5385,[  8 161 423 183  28],796,4,21725,4.033605644262904,0.0,0.0
15386,1,5386,[288 121  88 597 237],593,4,21729,4.033599405977353,0.0,0.0
15387,1,5387,[427 588  79  98 127],450,5,21734,4.033778767631774,20.0,20.0
15388,1,5388,[427 588  79  98 127],18,5,21739,4.033958062720356,20.0,20.0
15389,1,5389,[185  56 568  50   8],457,5,21744,4.034137291280149,0.0,20.0
15390,1,5390,[ 97 197 405 237 143],457,5,21749,4.034316453348173,0.0,0.0
15391,1,5391,[111 210 173  64 204],577,4,21753,4.034310089020772,20.0,0.0
15392,1,5392,[427 588  79  98 127],716,5,21758,4.034489152605229,20.0,20.0
15393,1,5393,[238  88 215 568 265],796,4,21762,4.0344827586206895,0.0,0.0
15394,1,5394,[ 11 258 187 222  56],693,3,21765,4.034291010194624,0.0,0.0
15395,1,5395,[427 588  79  98 127],450,5,21770,4.0344699777613044,20.0,20.0
15396,1,5396,[210 655  22   7  64],457,5,21775,4.0346488790068555,20.0,0.0
15397,1,5397,[427 588  79  98 127],389,5,21780,4.034827713968136,20.0,20.0
15398,1,5398,[265 258 300  97 174],535,3,21783,4.0346360437117985,0.0,0.0
15399,1,5399,[427 588  79  98 127],796,5,21788,4.034814814814815,20.0,20.0
15400,1,5400,[427 588  79  98 127],450,5,21793,4.0349935197185705,20.0,20.0
15401,1,5401,[127 196  97 427 194],796,4,21797,4.034987041836357,20.0,20.0
15402,1,5402,[742 204  88 228  28],796,3,21800,4.034795483990376,0.0,0.0
15403,1,5403,[427 588  79  98 127],389,5,21805,4.034974093264249,20.0,20.0
15404,1,5404,[357 168  22 195 237],18,2,21807,4.034597594819611,0.0,0.0
15405,1,5405,[423 301 172  15 211],796,3,21810,4.034406215316316,0.0,0.0
15406,1,5406,[172 196 210 588  79],716,5,21815,4.034584797484742,0.0,0.0
15407,1,5407,[333 234  25 258 289],693,2,21817,4.034208579881657,0.0,0.0
15408,1,5408,[ 88 204 173 151 161],389,2,21819,4.033832501386578,0.0,0.0
15409,1,5409,[258 273 179 132   1],655,2,21821,4.033456561922366,0.0,0.0
15410,1,5410,[655  89 185 174 423],23,3,21824,4.03326557013491,0.0,0.0
15411,1,5411,[427 588  79  98 127],716,5,21829,4.033444198078344,20.0,20.0
15412,1,5412,[427 588  79  98 127],18,5,21834,4.033622760022169,20.0,20.0
15413,1,5413,[427 588  79  98 127],450,5,21839,4.033801256002955,20.0,20.0
15414,1,5414,[427 588  79  98 127],18,5,21844,4.033979686057249,20.0,20.0
15415,1,5415,[427 588  79  98 127],796,5,21849,4.034158050221566,20.0,20.0
15416,1,5416,[121 423 118 568 742],756,0,21849,4.0334133284105596,0.0,0.0
15417,1,5417,[427 588  79  98 127],796,5,21854,4.03359173126615,20.0,20.0
15418,1,5418,[125 237 423  95 197],18,3,21857,4.0334009964938184,0.0,0.0
15419,1,5419,[183 132 176  50 300],655,2,21859,4.033025830258302,0.0,20.0
15420,1,5420,[427 588  79  98 127],18,5,21864,4.033204205866077,20.0,20.0
15421,1,5421,[181 235 151 245 405],256,4,21868,4.033198081888602,0.0,0.0
15422,1,5422,[118 655 228 197  88],457,5,21873,4.033376359948368,0.0,0.0
15423,1,5423,[435 603 135 186  56],716,3,21876,4.033185840707965,20.0,0.0
15424,1,5424,[427 588  79  98 127],18,5,21881,4.033364055299539,20.0,20.0
15425,1,5425,[ 88 121 238 194  11],716,5,21886,4.03354220420199,0.0,0.0
15426,1,5426,[427 588  79  98 127],450,5,21891,4.033720287451631,20.0,20.0
15427,1,5427,[ 79 181  97  89 275],655,3,21894,4.033529845246868,0.0,20.0
15428,1,5428,[176 515 603 742 187],655,3,21897,4.033339473199484,20.0,0.0
15429,1,5429,[385 655 181 234 286],655,0,21897,4.032596685082873,0.0,20.0
15430,1,5430,[427 588  79  98 127],716,5,21902,4.032774811268643,20.0,20.0
15431,1,5431,[187 748  56 275 286],450,5,21907,4.032952871870398,0.0,40.0
15432,1,5432,[ 79 568  12 237 302],655,2,21909,4.032578685808946,0.0,0.0
15433,1,5433,[496 173 174 127 322],796,4,21913,4.032572690467427,20.0,20.0
15434,1,5434,[568  89 546 151 655],796,4,21917,4.032566697332107,0.0,0.0
15435,1,5435,[135 245 546 597   1],450,4,21921,4.032560706401766,0.0,0.0
15436,1,5436,[427 588  79  98 127],389,5,21926,4.032738642633805,20.0,20.0
15437,1,5437,[427 588  79  98 127],389,5,21931,4.032916513424053,20.0,20.0
15438,1,5438,[427 588  79  98 127],389,5,21936,4.033094318808605,20.0,20.0
15439,1,5439,[655   9 238  64 496],796,2,21938,4.032720588235295,40.0,0.0
15440,1,5440,[427 588  79  98 127],450,5,21943,4.032898364271274,20.0,20.0
15441,1,5441,[161 118 300 289 471],655,0,21943,4.032157295112091,0.0,0.0
15442,1,5442,[132 111   1   8 195],18,3,21946,4.0319676648906855,0.0,0.0
15443,1,5443,[427 588  79  98 127],796,5,21951,4.032145481263776,20.0,20.0
15444,1,5444,[427 588  79  98 127],18,5,21956,4.0323232323232325,20.0,20.0
15445,1,5445,[427 588  79  98 127],796,5,21961,4.032500918105031,20.0,20.0
15446,1,5446,[435 302 135 211 496],269,3,21964,4.032311364053608,20.0,0.0
15447,1,5447,[483 175 100 174 182],457,5,21969,4.032488986784141,0.0,20.0
15448,1,5448,[427 588  79  98 127],18,5,21974,4.032666544320059,20.0,20.0
15449,1,5449,[200  50 471  88  64],655,3,21977,4.032477064220184,20.0,20.0
15450,1,5450,[237  82 196 235 204],716,4,21981,4.032471106219043,0.0,0.0
15451,1,5451,[427 588  79  98 127],450,5,21986,4.0326485693323555,20.0,20.0
15452,1,5452,[427 588  79  98 127],450,5,21991,4.032825967357418,20.0,20.0
15453,1,5453,[427 588  79  98 127],450,5,21996,4.033003300330033,20.0,20.0
15454,1,5454,[ 69 132 405 135 257],835,3,21999,4.032813932172319,0.0,0.0
15455,1,5455,[427 588  79  98 127],18,5,22004,4.032991202346041,20.0,20.0
15456,1,5456,[427 588  79  98 127],796,5,22009,4.033168407549936,20.0,20.0
15457,1,5457,[301 143 175 471 302],655,2,22011,4.032795895932576,0.0,0.0
15458,1,5458,[ 28 182 546 483 151],796,4,22015,4.0327898882579225,0.0,0.0
15459,1,5459,[288 328 151 210 161],450,3,22018,4.0326007326007325,0.0,0.0
15460,1,5460,[427 588  79  98 127],716,5,22023,4.032777879509247,20.0,20.0
15461,1,5461,[  4 588  69 403 235],457,4,22027,4.032771878432809,0.0,0.0
15462,1,5462,[427 588  79  98 127],18,5,22032,4.032948929159803,20.0,20.0
15463,1,5463,[313 515 568 176 275],655,3,22035,4.0327598828696924,0.0,20.0
15464,1,5464,[427 588  79  98 127],716,5,22040,4.032936870997255,20.0,20.0
15465,1,5465,[111  64 216 191 179],457,4,22044,4.032930845225027,20.0,0.0
15466,1,5466,[282 204  70 222 385],450,4,22048,4.032924821657216,0.0,0.0
15467,1,5467,[210   9  50 151   1],344,4,22052,4.032918800292611,0.0,20.0
15468,1,5468,[427 588  79  98 127],389,5,22057,4.033095629914061,20.0,20.0
15469,1,5469,[427 588  79  98 127],18,5,22062,4.03327239488117,20.0,20.0
15470,1,5470,[427 588  79  98 127],389,5,22067,4.0334490952293915,20.0,20.0
15471,1,5471,[357 322 269 194 204],629,3,22070,4.033260233918129,0.0,0.0
15472,1,5472,[403 568  12  82 215],457,5,22075,4.033436871916682,0.0,0.0
15473,1,5473,[427 588  79  98 127],18,5,22080,4.033613445378151,20.0,20.0
15474,1,5474,[427 588  79  98 127],716,5,22085,4.0337899543379,20.0,20.0
15475,1,5475,[313 288 144 127   7],280,3,22088,4.033601168736304,0.0,20.0
15476,1,5476,[175 238 135  98  25],655,2,22090,4.0332298703669895,0.0,0.0
15477,1,5477,[186  69 191 173 182],269,2,22092,4.032858707557502,0.0,0.0
15478,1,5478,[496 183 151 435 237],236,2,22094,4.032487680233619,20.0,0.0
15479,1,5479,[ 98 588 172 181 748],450,5,22099,4.032664233576642,0.0,0.0
15480,1,5480,[174 111 117 186 289],655,0,22099,4.031928480204343,0.0,0.0
15481,1,5481,[427 588  79  98 127],796,5,22104,4.032105071141919,20.0,20.0
15482,1,5482,[269 172  28  97  89],450,5,22109,4.032281597665512,0.0,0.0
15483,1,5483,[183  25  79 118  15],655,2,22111,4.0319110138584975,0.0,0.0
15484,1,5484,[286 322 405   9 186],796,1,22112,4.031358249772106,0.0,20.0
15485,1,5485,[172  82 234 176 515],269,1,22113,4.030805687203792,0.0,0.0
15486,1,5486,[191 742 172 313 282],450,5,22118,4.030982321851649,0.0,0.0
15487,1,5487,[427 588  79  98 127],389,5,22123,4.03115889212828,20.0,20.0
15488,1,5488,[ 98  70 748  88 238],450,5,22128,4.031335398068865,0.0,0.0
15489,1,5489,[200 423  82 132 300],716,5,22133,4.031511839708561,0.0,0.0
15490,1,5490,[  7 742 196 135 300],693,2,22135,4.031141868512111,0.0,0.0
15491,1,5491,[191 313  22 742 194],796,4,22139,4.031136198106337,0.0,0.0
15492,1,5492,[427 588  79  98 127],450,5,22144,4.031312579646824,20.0,20.0
15493,1,5493,[ 82   4   7 121 568],577,3,22147,4.031124863487441,0.0,0.0
15494,1,5494,[210 286  25 143 546],151,4,22151,4.031119199272066,0.0,20.0
15495,1,5495,[200 118 194 748 237],450,3,22154,4.0309315866084425,0.0,0.0
15496,1,5496,[117 211 200 275 187],786,5,22159,4.031107877023831,0.0,20.0
15497,1,5497,[202 275  69 210 234],18,2,22161,4.03073845034558,0.0,20.0
15498,1,5498,[ 96 357 144 294 179],457,4,22165,4.030732860520095,0.0,0.0
15499,1,5499,[427 588  79  98 127],389,5,22170,4.030909090909091,20.0,20.0
15500,1,5500,[427 588  79  98 127],450,5,22175,4.031085257225959,20.0,20.0
15501,1,5501,[427 588  79  98 127],389,5,22180,4.031261359505634,20.0,20.0
15502,1,5502,[328  12  69  98 216],655,2,22182,4.030892240596039,0.0,0.0
15503,1,5503,[385  82 357 748 742],796,3,22185,4.030704941860465,0.0,0.0
15504,1,5504,[427 588  79  98 127],716,5,22190,4.030881017257039,20.0,20.0
15505,1,5505,[427 588  79  98 127],389,5,22195,4.031057028695968,20.0,20.0
15506,1,5506,[427 588  79  98 127],796,5,22200,4.0312329762120935,20.0,20.0
15507,1,5507,[257 118 234  95 748],796,4,22204,4.03122730573711,0.0,0.0
15508,1,5508,[173   8 483  82 678],807,3,22207,4.031040116173534,0.0,0.0
15509,1,5509,[121 423  28 282 215],504,5,22212,4.031215970961887,0.0,0.0
15510,1,5510,[427 588  79  98 127],450,5,22217,4.031391761930684,20.0,20.0
15511,1,5511,[168 117  69  64  95],577,5,22222,4.031567489114659,20.0,0.0
15512,1,5512,[ 50 568 117  96 237],655,1,22223,4.031017594775984,0.0,20.0
15513,1,5513,[568  79 302  89 238],655,3,22226,4.030830612985128,0.0,0.0
15514,1,5514,[301 318 265 357 603],655,3,22229,4.03064369900272,40.0,0.0
15515,1,5515,[238 427 143 273  98],796,3,22232,4.030456852791878,20.0,0.0
15516,1,5516,[  1  56  69 174 153],18,4,22236,4.030451332245786,0.0,0.0
15517,1,5517,[  7 257  15 121 273],277,2,22238,4.030083363537513,0.0,0.0
15518,1,5518,[216   7 475  64 258],655,2,22240,4.0297155281753945,20.0,0.0
15519,1,5519,[427 588  79  98 127],450,5,22245,4.029891304347826,20.0,20.0
15520,1,5520,[427 588  79  98 127],450,5,22250,4.030067016844774,20.0,20.0
15521,1,5521,[427 588  79  98 127],389,5,22255,4.0302426657008334,20.0,20.0
15522,1,5522,[546 508 196 187 655],693,0,22255,4.029512945862756,0.0,0.0
15523,1,5523,[ 12 269 245 196 385],450,5,22260,4.029688631426502,0.0,0.0
15524,1,5524,[427 588  79  98 127],796,5,22265,4.029864253393665,20.0,20.0
15525,1,5525,[427 588  79  98 127],389,5,22270,4.030039811798769,20.0,20.0
15526,1,5526,[496  64 302 202  28],389,5,22275,4.0302153066763164,40.0,0.0
15527,1,5527,[427 588  79  98 127],389,5,22280,4.030390738060781,20.0,20.0
15528,1,5528,[ 11 265 275  64 173],629,4,22284,4.030385241454151,20.0,20.0
15529,1,5529,[186  98  56 117  71],504,3,22287,4.030198915009041,0.0,0.0
15530,1,5530,[427 588  79  98 127],796,5,22292,4.03037425420358,20.0,20.0
15531,1,5531,[427 588  79  98 127],18,5,22297,4.030549530007231,20.0,20.0
15532,1,5532,[427 588  79  98 127],18,5,22302,4.030724742454365,20.0,20.0
15533,1,5533,[427 588  79  98 127],796,5,22307,4.0308998915793275,20.0,20.0
15534,1,5534,[ 50 151 546  25 328],450,4,22311,4.03089430894309,0.0,20.0
15535,1,5535,[ 56 195 288  96 515],908,5,22316,4.03106936416185,0.0,0.0
15536,1,5536,[427 588  79  98 127],389,5,22321,4.031244356149539,20.0,20.0
15537,1,5537,[427 588  79  98 127],796,5,22326,4.031419284940411,20.0,20.0
15538,1,5538,[ 69   8  82 183 275],796,4,22330,4.031413612565445,0.0,20.0
15539,1,5539,[427 588  79  98 127],796,5,22335,4.031588447653429,20.0,20.0
15540,1,5540,[427 588  79  98 127],389,5,22340,4.031763219635445,20.0,20.0
15541,1,5541,[427 588  79  98 127],796,5,22345,4.031937928545651,20.0,20.0
15542,1,5542,[100  79 194 258 210],457,5,22350,4.032112574418185,0.0,20.0
15543,1,5543,[427 588  79  98 127],716,5,22355,4.032287157287158,20.0,20.0
15544,1,5544,[427 588  79  98 127],389,5,22360,4.032461677186655,20.0,20.0
15545,1,5545,[ 56 301 302 405 180],450,5,22365,4.0326361341507395,0.0,0.0
15546,1,5546,[427 588  79  98 127],389,5,22370,4.0328105282134485,20.0,20.0
15547,1,5547,[151 195 125 181 597],450,5,22375,4.032984859408796,0.0,0.0
15548,1,5548,[427 588  79  98 127],796,5,22380,4.0331591277707695,20.0,20.0
15549,1,5549,[427 588  79  98 127],450,5,22385,4.033333333333333,20.0,20.0
15550,1,5550,[180 135 211 197 742],693,1,22386,4.032786885245901,0.0,0.0
15551,1,5551,[427 588  79  98 127],450,5,22391,4.032961095100864,20.0,20.0
15552,1,5552,[228 153 186   1 275],450,4,22395,4.032955159373311,0.0,20.0
15553,1,5553,[  7 216 655 210 568],457,5,22400,4.033129276197335,0.0,0.0
15554,1,5554,[427 588  79  98 127],796,5,22405,4.033303330333033,20.0,20.0
15555,1,5555,[427 588  79  98 127],389,5,22410,4.033477321814255,20.0,20.0
15556,1,5556,[427 588  79  98 127],796,5,22415,4.033651250674825,20.0,20.0
15557,1,5557,[111 121   7 268 172],296,4,22419,4.03364519611371,0.0,0.0
15558,1,5558,[603 427 172 195  50],269,2,22421,4.033279366792589,40.0,20.0
15559,1,5559,[ 88   4 286 235  71],450,2,22423,4.032913669064748,0.0,20.0
15560,1,5560,[186 100   8 111 301],796,2,22425,4.032548102859198,0.0,20.0
15561,1,5561,[328 258  28 603 496],450,5,22430,4.03272204243078,40.0,0.0
15562,1,5562,[427 588  79  98 127],450,5,22435,4.032895919467913,20.0,20.0
15563,1,5563,[ 79 132 117 161   1],450,5,22440,4.033069734004314,0.0,0.0
15564,1,5564,[427 588  79  98 127],796,5,22445,4.033243486073674,20.0,20.0
15565,1,5565,[196 427 273 237 197],796,3,22448,4.033057851239669,20.0,0.0
15566,1,5566,[328 273 182 151 405],796,4,22452,4.033051913059098,0.0,0.0
15567,1,5567,[211 210 403 228 202],796,3,22455,4.032866379310345,0.0,0.0
15568,1,5568,[427 588  79  98 127],18,5,22460,4.033040043095708,20.0,20.0
15569,1,5569,[186 301 603  12 204],450,4,22464,4.0330341113105925,20.0,0.0
15570,1,5570,[588  15 100 161 117],577,4,22468,4.033028181654999,0.0,20.0
15571,1,5571,[187 423 435 471  64],655,2,22470,4.032663316582915,20.0,0.0
15572,1,5572,[176 276 153  96  70],655,1,22471,4.03211914588193,0.0,0.0
15573,1,5573,[ 79  88 174 302 111],655,2,22473,4.031754574811625,0.0,0.0
15574,1,5574,[258 179 435  25 183],450,4,22477,4.031748878923767,0.0,0.0
15575,1,5575,[427 588  79  98 127],389,5,22482,4.031922525107604,20.0,20.0
15576,1,5576,[427 588  79  98 127],796,5,22487,4.032096109019186,20.0,20.0
15577,1,5577,[427 588  79  98 127],389,5,22492,4.032269630692005,20.0,20.0
15578,1,5578,[200 405 168  50 183],151,2,22494,4.031905359383402,0.0,20.0
15579,1,5579,[405  64 216 161 328],450,5,22499,4.032078853046595,20.0,0.0
15580,1,5580,[427 588  79  98 127],450,5,22504,4.032252284536821,20.0,20.0
15581,1,5581,[211   1 275 216 185],716,5,22509,4.032425653887495,0.0,20.0
15582,1,5582,[427 588  79  98 127],18,5,22514,4.032598961132008,20.0,20.0
15583,1,5583,[ 97  70 179 300 180],450,5,22519,4.032772206303725,0.0,0.0
15584,1,5584,[176 588 275 191 151],450,5,22524,4.032945389435989,0.0,20.0
15585,1,5585,[427 588  79  98 127],716,5,22529,4.03311851056212,20.0,20.0
15586,1,5586,[427 588  79  98 127],389,5,22534,4.033291569715411,20.0,20.0
15587,1,5587,[197 268 276 302 286],655,2,22536,4.032927702219041,0.0,20.0
15588,1,5588,[186 222  56 172 117],450,3,22539,4.032742887815352,0.0,0.0
15589,1,5589,[427 588  79  98 127],716,5,22544,4.032915921288014,20.0,20.0
15590,1,5590,[ 64 183 191 111 282],796,5,22549,4.033088892863531,20.0,0.0
15591,1,5591,[427 588  79  98 127],796,5,22554,4.033261802575107,20.0,20.0
15592,1,5592,[427 588  79  98 127],796,5,22559,4.033434650455927,20.0,20.0
15593,1,5593,[144 288 216 258 183],450,4,22563,4.033428673578834,0.0,0.0
15594,1,5594,[100 228 237 127  70],280,2,22565,4.033065236818588,0.0,40.0
15595,1,5595,[427 588  79  98 127],389,5,22570,4.033238027162259,20.0,20.0
15596,1,5596,[427 588  79  98 127],796,5,22575,4.033410755762016,20.0,20.0
15597,1,5597,[ 82 127 483 655 179],457,5,22580,4.033583422650946,0.0,20.0
15598,1,5598,[427 588  79  98 127],716,5,22585,4.033756027862118,20.0,20.0
15599,1,5599,[ 97   9  11 211  79],535,4,22589,4.03375,0.0,0.0
15600,1,5600,[427 588  79  98 127],450,5,22594,4.033922513836814,20.0,20.0
15601,1,5601,[427 588  79  98 127],450,5,22599,4.034094966083542,20.0,20.0
15602,1,5602,[427 588  79  98 127],18,5,22604,4.0342673567731575,20.0,20.0
15603,1,5603,[ 50  22 117 121 187],296,4,22608,4.034261241970022,0.0,20.0
15604,1,5604,[427 588  79  98 127],389,5,22613,4.034433541480821,20.0,20.0
15605,1,5605,[286  70 173 179 211],450,5,22618,4.034605779521941,0.0,20.0
15606,1,5606,[427 588  79  98 127],18,5,22623,4.034777956126271,20.0,20.0
15607,1,5607,[153 172 475 322 127],629,4,22627,4.034771754636234,0.0,20.0
15608,1,5608,[427 588  79  98 127],18,5,22632,4.03494384025673,20.0,20.0
15609,1,5609,[288  89  98 111 228],457,4,22636,4.0349376114082,0.0,0.0
15610,1,5610,[ 82 286 181 132 135],450,3,22639,4.034753163428979,0.0,20.0
15611,1,5611,[427 588  79  98 127],389,5,22644,4.034925160370634,20.0,20.0
15612,1,5612,[427 588  79  98 127],450,5,22649,4.03509709602708,20.0,20.0
15613,1,5613,[427 588  79  98 127],450,5,22654,4.035268970431066,20.0,20.0
15614,1,5614,[427 588  79  98 127],716,5,22659,4.035440783615316,20.0,20.0
15615,1,5615,[427 588  79  98 127],18,5,22664,4.035612535612535,20.0,20.0
15616,1,5616,[176   4 181 655 568],457,5,22669,4.035784226455403,0.0,0.0
15617,1,5617,[427 588  79  98 127],450,5,22674,4.035955856176575,20.0,20.0
15618,1,5618,[427 588  79  98 127],450,5,22679,4.036127424808685,20.0,20.0
15619,1,5619,[234 357 237 301  88],593,4,22683,4.036120996441281,0.0,0.0
15620,1,5620,[427 588  79  98 127],18,5,22688,4.036292474648639,20.0,20.0
15621,1,5621,[427 588  79  98 127],450,5,22693,4.036463891853433,20.0,20.0
15622,1,5622,[405 183 100 135 238],457,5,22698,4.036635248088209,0.0,20.0
15623,1,5623,[597 483 216  97  89],450,4,22702,4.036628733997155,0.0,0.0
15624,1,5624,[427 588  79  98 127],389,5,22707,4.0368,20.0,20.0
15625,1,5625,[427 588  79  98 127],716,5,22712,4.03697120511909,20.0,20.0
15626,1,5626,[427 588  79  98 127],716,5,22717,4.037142349386885,20.0,20.0
15627,1,5627,[427 588  79  98 127],389,5,22722,4.037313432835821,20.0,20.0
15628,1,5628,[427 588  79  98 127],450,5,22727,4.037484455498312,20.0,20.0
15629,1,5629,[427 588  79  98 127],389,5,22732,4.037655417406749,20.0,20.0
15630,1,5630,[ 82  15 135 151   1],330,4,22736,4.037648730243296,0.0,0.0
15631,1,5631,[ 12 333 234 211 742],693,1,22737,4.037109375,0.0,0.0
15632,1,5632,[427 588  79  98 127],18,5,22742,4.037280312444524,20.0,20.0
15633,1,5633,[  7 222 483  56 294],457,4,22746,4.0372736954206605,0.0,0.0
15634,1,5634,[427 588  79  98 127],389,5,22751,4.0374445430346055,20.0,20.0
15635,1,5635,[427 588  79  98 127],450,5,22756,4.037615330021292,20.0,20.0
15636,1,5636,[568 200 144 161 127],655,2,22758,4.037253858435338,0.0,20.0
15637,1,5637,[742  88 294 202 269],264,2,22760,4.036892515076268,0.0,0.0
15638,1,5638,[427 588  79  98 127],796,5,22765,4.037063309097357,20.0,20.0
15639,1,5639,[237 282 245 357 318],796,4,22769,4.037056737588652,20.0,0.0
15640,1,5640,[204 173  28 202  98],798,3,22772,4.036872894876795,0.0,0.0
15641,1,5641,[222 117 173  96 265],450,4,22776,4.0368663594470044,0.0,0.0
15642,1,5642,[118 143 237 302 301],655,2,22778,4.036505404926458,0.0,0.0
15643,1,5643,[180 151 204 127 111],296,3,22781,4.03632175761871,0.0,20.0
15644,1,5644,[ 28  25 197 238 127],389,4,22785,4.036315323294951,0.0,20.0
15645,1,5645,[204 385 210  79 182],450,4,22789,4.036308891250443,0.0,0.0
15646,1,5646,[427 588  79  98 127],389,5,22794,4.036479546661944,20.0,20.0
15647,1,5647,[168  70  98 357 196],450,5,22799,4.03665014164306,0.0,0.0
15648,1,5648,[200   7 471 294 211],655,1,22800,4.03611258629846,0.0,0.0
15649,1,5649,[ 28 197 471 357 228],693,1,22801,4.035575221238938,0.0,0.0
15650,1,5650,[111 294  69 475 435],655,0,22801,4.034861086533357,0.0,0.0
15651,1,5651,[172 168  56 237 275],450,5,22806,4.035031847133758,0.0,20.0
15652,1,5652,[427 588  79  98 127],450,5,22811,4.035202547320007,20.0,20.0
15653,1,5653,[  1 655 117 215 173],457,5,22816,4.03537318712416,0.0,0.0
15654,1,5654,[427 588  79  98 127],796,5,22821,4.035543766578249,20.0,20.0
15655,1,5655,[183 269 118 117 597],796,4,22825,4.03553748231966,0.0,0.0
15656,1,5656,[427 588  79  98 127],389,5,22830,4.035707972423546,20.0,20.0
15657,1,5657,[603 185 176 318  98],503,4,22834,4.03570166136444,40.0,0.0
15658,1,5658,[276 185 328 471 748],401,4,22838,4.035695352535783,0.0,0.0
15659,1,5659,[427 588  79  98 127],450,5,22843,4.035865724381625,20.0,20.0
15660,1,5660,[135 471 117 187 603],716,2,22845,4.035506094329624,20.0,0.0
15661,1,5661,[568  25 204 117   4],577,4,22849,4.035499823383963,0.0,0.0
15662,1,5662,[238 195 175 176 211],716,2,22851,4.035140384954971,0.0,0.0
15663,1,5663,[132 210 275 135  79],716,4,22855,4.03513418079096,0.0,20.0
15664,1,5664,[234 300 228 357 100],450,4,22859,4.035127978817299,0.0,20.0
15665,1,5665,[515 333 181 294 301],902,1,22860,4.034592304977056,0.0,0.0
15666,1,5666,[427 588  79  98 127],389,5,22865,4.03476266101994,20.0,20.0
15667,1,5667,[191 144 234 300 176],796,4,22869,4.0347565278757935,0.0,0.0
15668,1,5668,[427 588  79  98 127],716,5,22874,4.03492679484918,20.0,20.0
15669,1,5669,[427 588  79  98 127],450,5,22879,4.035097001763669,20.0,20.0
15670,1,5670,[427 588  79  98 127],18,5,22884,4.035267148651031,20.0,20.0
15671,1,5671,[179 568 265 168  11],450,5,22889,4.035437235543018,0.0,0.0
15672,1,5672,[174 471 186 176 173],786,5,22894,4.0356072624713555,0.0,0.0
15673,1,5673,[385 211 269 132  71],450,4,22898,4.0356009869580545,0.0,0.0
15674,1,5674,[238 125 196 655 597],450,5,22903,4.035770925110132,0.0,0.0
15675,1,5675,[294 742 121 313 179],450,4,22907,4.035764622973925,0.0,0.0
15676,1,5676,[ 79 496 135 180 603],535,3,22910,4.0355821736832835,40.0,0.0
15677,1,5677,[ 70 435 185 183 153],655,2,22912,4.035223670306446,0.0,0.0
15678,1,5678,[132 180  56 385 238],450,5,22917,4.035393555203381,0.0,0.0
15679,1,5679,[427  64 117 132 187],796,5,22922,4.03556338028169,40.0,0.0
15680,1,5680,[427 588  79  98 127],450,5,22927,4.035733145572962,20.0,20.0
15681,1,5681,[197 435   4 211 515],716,4,22931,4.035726856740585,0.0,0.0
15682,1,5682,[568 182 333 197 268],655,1,22932,4.035192679922576,0.0,0.0
15683,1,5683,[135 273  97  70  64],655,3,22935,4.035010555946516,20.0,0.0
15684,1,5684,[427 588  79  98 127],450,5,22940,4.035180299032541,20.0,20.0
15685,1,5685,[427 588  79  98 127],450,5,22945,4.035349982412944,20.0,20.0
15686,1,5686,[168 211   4 546 234],450,3,22948,4.035167926850712,0.0,0.0
15687,1,5687,[427 588  79  98 127],18,5,22953,4.035337552742616,20.0,20.0
15688,1,5688,[197 286 204 161 235],280,3,22956,4.035155563367903,0.0,20.0
15689,1,5689,[427 588  79  98 127],796,5,22961,4.035325131810193,20.0,20.0
15690,1,5690,[ 82 210 322 276 748],256,4,22965,4.035318924617818,0.0,0.0
15691,1,5691,[191 357 742 273 275],655,4,22969,4.035312719606465,0.0,20.0
15692,1,5692,[111 179 182  97  79],450,5,22974,4.0354821710873,0.0,0.0
15693,1,5693,[427 588  79  98 127],796,5,22979,4.035651563048823,20.0,20.0
15694,1,5694,[427 588  79  98 127],389,5,22984,4.035820895522388,20.0,20.0
15695,1,5695,[568 282 471 135 180],693,3,22987,4.03563904494382,0.0,0.0
15696,1,5696,[ 69  64  98 275 294],457,4,22991,4.035632789187291,20.0,20.0
15697,1,5697,[282 265 655 322 427],450,5,22996,4.0358020358020354,20.0,0.0
15698,1,5698,[427 588  79  98 127],796,5,23001,4.0359712230215825,20.0,20.0
15699,1,5699,[427 588  79  98 127],389,5,23006,4.036140350877193,20.0,20.0
15700,1,5700,[427 588  79  98 127],450,5,23011,4.036309419400105,20.0,20.0
15701,1,5701,[100 127 405  95   4],344,4,23015,4.036303051560856,0.0,40.0
15702,1,5702,[423  70 200 186  12],151,4,23019,4.036296685954761,0.0,0.0
15703,1,5703,[427 588  79  98 127],796,5,23024,4.036465638148668,20.0,20.0
15704,1,5704,[275 269 403  88 175],655,1,23025,4.0359333917616125,0.0,20.0
15705,1,5705,[427 588  79  98 127],450,5,23030,4.036102348405188,20.0,20.0
15706,1,5706,[655 300 318 132 603],535,4,23034,4.036096022428596,40.0,0.0
15707,1,5707,[427 588  79  98 127],389,5,23039,4.036264891380519,20.0,20.0
15708,1,5708,[153 181  28 127   1],389,4,23043,4.0362585391487125,0.0,20.0
15709,1,5709,[427 588  79  98 127],18,5,23048,4.036427320490367,20.0,20.0
15710,1,5710,[ 95 215  50 125 204],577,5,23053,4.036596042724566,0.0,20.0
15711,1,5711,[603 655 118 176  97],655,1,23054,4.036064425770308,20.0,0.0
15712,1,5712,[427 588  79  98 127],389,5,23059,4.036233152459303,20.0,20.0
15713,1,5713,[427 588  79  98 127],716,5,23064,4.036401820091005,20.0,20.0
15714,1,5714,[258 405 132   7  89],457,5,23069,4.036570428696413,0.0,0.0
15715,1,5715,[204 111 191  69 423],786,5,23074,4.036738978306508,0.0,0.0
15716,1,5716,[427 588  79  98 127],796,5,23079,4.036907468952248,20.0,20.0
15717,1,5717,[125 135 210 385 435],401,2,23081,4.0365512416929,0.0,0.0
15718,1,5718,[  9 237 265  12 475],655,0,23081,4.035845427522294,0.0,0.0
15719,1,5719,[322 117 588  95 100],344,3,23084,4.035664335664336,0.0,20.0
15720,1,5720,[161 385  28   4 322],796,3,23087,4.0354833071141405,0.0,0.0
15721,1,5721,[ 70 588 282 135  12],280,4,23091,4.035477105907026,0.0,0.0
15722,1,5722,[ 95  64 118  50 496],716,4,23095,4.035470906867028,40.0,20.0
15723,1,5723,[427 588  79  98 127],450,5,23100,4.035639412997903,20.0,20.0
15724,1,5724,[427 588  79  98 127],18,5,23105,4.035807860262008,20.0,20.0
15725,1,5725,[423 318  95  69  28],577,5,23110,4.035976248690186,20.0,0.0
15726,1,5726,[427 588  79  98 127],389,5,23115,4.036144578313253,20.0,20.0
15727,1,5727,[427 588  79  98 127],450,5,23120,4.0363128491620115,20.0,20.0
15728,1,5728,[ 50 187 216 211  98],655,4,23124,4.036306510734858,0.0,20.0
15729,1,5729,[427 588  79  98 127],18,5,23129,4.036474694589878,20.0,20.0
15730,1,5730,[427 588  79  98 127],796,5,23134,4.036642819752225,20.0,20.0
15731,1,5731,[427 588  79  98 127],18,5,23139,4.036810886252617,20.0,20.0
15732,1,5732,[168  50 210 172 161],269,1,23140,4.036281179138322,0.0,20.0
15733,1,5733,[427 588  79  98 127],796,5,23145,4.036449250087199,20.0,20.0
15734,1,5734,[427 588  79  98 127],18,5,23150,4.036617262423714,20.0,20.0
15735,1,5735,[427 588  79  98 127],796,5,23155,4.036785216178521,20.0,20.0
15736,1,5736,[222 111 185 483 603],450,3,23158,4.036604497123933,20.0,0.0
15737,1,5737,[ 64  88 483 153 200],707,1,23159,4.03607528755664,20.0,0.0
15738,1,5738,[  9  12 196 111 135],11,4,23163,4.036069001568217,0.0,0.0
15739,1,5739,[172 127  56 132 222],716,5,23168,4.03623693379791,0.0,20.0
15740,1,5740,[427 588  79  98 127],716,5,23173,4.036404807524821,20.0,20.0
15741,1,5741,[  1 181  15  95  82],20,3,23176,4.036224312086381,0.0,0.0
15742,1,5742,[276 294 471 742 228],256,2,23178,4.035869754483719,0.0,0.0
15743,1,5743,[323 237 117  12 132],280,3,23181,4.035689415041783,0.0,0.0
15744,1,5744,[427 588  79  98 127],796,5,23186,4.0358572671888595,20.0,20.0
15745,1,5745,[427 588  79  98 127],716,5,23191,4.036025060911939,20.0,20.0
15746,1,5746,[191 471 655 234 216],693,1,23192,4.03549678092918,0.0,0.0
15747,1,5747,[427 588  79  98 127],796,5,23197,4.035664578983995,20.0,20.0
15748,1,5748,[427 588  79  98 127],716,5,23202,4.035832318664116,20.0,20.0
15749,1,5749,[185 197 234  12 288],693,2,23204,4.035478260869565,0.0,0.0
15750,1,5750,[228 144 187 215  70],655,1,23205,4.034950443401148,0.0,0.0
15751,1,5751,[265 228  98  69 235],280,4,23209,4.034944367176634,0.0,0.0
15752,1,5752,[427 588  79  98 127],450,5,23214,4.035112115418043,20.0,20.0
15753,1,5753,[135 100 180 546 323],280,3,23217,4.034932221063608,0.0,20.0
15754,1,5754,[151 121 385 125 215],450,4,23221,4.034926151172893,0.0,0.0
15755,1,5755,[228  28 357  12  71],450,4,23225,4.034920083391244,0.0,0.0
15756,1,5756,[172 121  69 228 385],716,4,23229,4.034914017717561,0.0,0.0
15757,1,5757,[427 588  79  98 127],796,5,23234,4.035081625564432,20.0,20.0
15758,1,5758,[ 64 515 174 202 328],655,2,23236,4.03472825143254,20.0,0.0
15759,1,5759,[427 588  79  98 127],18,5,23241,4.034895833333334,20.0,20.0
15760,1,5760,[238 222 427 237 172],450,4,23245,4.034889776080542,20.0,0.0
15761,1,5761,[ 97 215  95  88 300],796,4,23249,4.034883720930233,0.0,0.0
15762,1,5762,[ 28 257 423 172 427],807,5,23254,4.0350511886170395,20.0,0.0
15763,1,5763,[ 15 174 111 222 172],798,3,23257,4.034871616932685,0.0,0.0
15764,1,5764,[ 69  25 234 215 185],693,3,23260,4.034692107545533,0.0,0.0
15765,1,5765,[427 588  79  98 127],796,5,23265,4.034859521331946,20.0,20.0
15766,1,5766,[322 180   1 197 204],280,3,23268,4.034680076296167,0.0,0.0
15767,1,5767,[742  22 269 132  28],796,2,23270,4.034327323162275,0.0,0.0
15768,1,5768,[427 588  79  98 127],450,5,23275,4.034494713121858,20.0,20.0
15769,1,5769,[427 588  79  98 127],450,5,23280,4.034662045060658,20.0,20.0
15770,1,5770,[197 318 172 300 222],704,2,23282,4.034309478426616,20.0,0.0
15771,1,5771,[ 28 179  25 300 403],655,1,23283,4.033783783783784,0.0,0.0
15772,1,5772,[300 269 301 135 179],655,2,23285,4.033431491425602,0.0,0.0
15773,1,5773,[427 588  79  98 127],450,5,23290,4.033598891582958,20.0,20.0
15774,1,5774,[ 97 475 268  82 276],655,1,23291,4.033073593073593,0.0,0.0
15775,1,5775,[427 588  79  98 127],450,5,23296,4.033240997229917,20.0,20.0
15776,1,5776,[427 588  79  98 127],450,5,23301,4.033408343430846,20.0,20.0
15777,1,5777,[427 588  79  98 127],18,5,23306,4.033575631706473,20.0,20.0
15778,1,5778,[ 89 210 568 471 196],450,4,23310,4.033569821768472,0.0,0.0
15779,1,5779,[302 173 215 187 181],535,3,23313,4.033391003460207,0.0,0.0
15780,1,5780,[328 273  12 265 403],796,4,23317,4.033385227469296,0.0,0.0
15781,1,5781,[ 25  56 182 173 144],457,5,23322,4.033552404012452,0.0,0.0
15782,1,5782,[174 153   8 603 185],796,5,23327,4.033719522739063,20.0,0.0
15783,1,5783,[427 588  79  98 127],450,5,23332,4.033886583679115,20.0,20.0
15784,1,5784,[318   4 245 748  71],450,3,23335,4.033707865168539,20.0,0.0
15785,1,5785,[427 588  79  98 127],450,5,23340,4.0338748703767715,20.0,20.0
15786,1,5786,[427 588  79  98 127],716,5,23345,4.034041817867634,20.0,20.0
15787,1,5787,[427 588  79  98 127],18,5,23350,4.034208707671043,20.0,20.0
15788,1,5788,[427 588  79  98 127],796,5,23355,4.034375539816894,20.0,20.0
15789,1,5789,[427 588  79  98 127],450,5,23360,4.03454231433506,20.0,20.0
15790,1,5790,[  1 195 237 181 403],796,4,23364,4.0345363495078574,0.0,0.0
15791,1,5791,[427 588  79  98 127],389,5,23369,4.034703038674033,20.0,20.0
15792,1,5792,[ 56 194 258 276 204],504,1,23370,4.034179181771103,0.0,0.0
15793,1,5793,[ 82  11   1 118 144],450,3,23373,4.034000690369347,0.0,0.0
15794,1,5794,[228 181 187 183  88],716,3,23376,4.0338222605694565,0.0,0.0
15795,1,5795,[186 222   7 742 161],457,5,23381,4.033988957902001,0.0,0.0
15796,1,5796,[  4  22 322 181   1],344,1,23382,4.033465585647749,0.0,0.0
15797,1,5797,[333 143  89 483 286],796,4,23386,4.033459813728872,0.0,20.0
15798,1,5798,[ 50 151 235 195  12],256,4,23390,4.033454043800655,0.0,20.0
15799,1,5799,[427 588  79  98 127],716,5,23395,4.033620689655172,20.0,20.0
15800,1,5800,[678 269 276 588 121],344,3,23398,4.033442509912084,0.0,0.0
15801,1,5801,[427 588  79  98 127],796,5,23403,4.033609100310238,20.0,20.0
15802,1,5802,[211 300 132  12 228],450,5,23408,4.033775633293124,0.0,0.0
15803,1,5803,[  8 135 385 546 483],457,4,23412,4.033769813921434,0.0,0.0
15804,1,5804,[174 257 210  98   9],796,3,23415,4.03359173126615,0.0,0.0
15805,1,5805,[210   1 403  95 185],450,3,23418,4.0334137099552185,0.0,0.0
15806,1,5806,[275 234 180 117 588],450,4,23422,4.0334079559152745,0.0,20.0
15807,1,5807,[427 588  79  98 127],389,5,23427,4.033574380165289,20.0,20.0
15808,1,5808,[121 318  82 237 357],504,4,23431,4.033568600447581,20.0,0.0
15809,1,5809,[427 588  79  98 127],796,5,23436,4.033734939759036,20.0,20.0
15810,1,5810,[174 282 328  56 191],655,1,23437,4.033212872139047,0.0,0.0
15811,1,5811,[427 588  79  98 127],18,5,23442,4.03337921541638,20.0,20.0
15812,1,5812,[427 588  79  98 127],18,5,23447,4.03354550146224,20.0,20.0
15813,1,5813,[427 588  79  98 127],389,5,23452,4.033711730306157,20.0,20.0
15814,1,5814,[  9 181 144 288 179],457,5,23457,4.033877901977644,0.0,0.0
15815,1,5815,[222 275 385   1 265],786,5,23462,4.03404401650619,0.0,20.0
15816,1,5816,[427 588  79  98 127],716,5,23467,4.034210073921265,20.0,20.0
15817,1,5817,[427 588  79  98 127],716,5,23472,4.034376074252321,20.0,20.0
15818,1,5818,[427 588  79  98 127],389,5,23477,4.034542017528785,20.0,20.0
15819,1,5819,[427 588  79  98 127],389,5,23482,4.034707903780069,20.0,20.0
15820,1,5820,[222 483 151 405 322],796,4,23486,4.034701941247208,0.0,0.0
15821,1,5821,[427 588  79  98 127],716,5,23491,4.034867743043628,20.0,20.0
15822,1,5822,[172   7 655 182 357],655,3,23494,4.034690022325262,0.0,0.0
15823,1,5823,[ 82   8 153 179  98],18,4,23498,4.034684065934066,0.0,0.0
15824,1,5824,[200   7 597 186  69],269,1,23499,4.0341630901287555,0.0,0.0
15825,1,5825,[427 588  79  98 127],18,5,23504,4.034328870580158,20.0,20.0
15826,1,5826,[322  89  82 111  15],151,3,23507,4.034151364338425,0.0,0.0
15827,1,5827,[318 183 294  79  22],280,3,23510,4.033973919011668,20.0,0.0
15828,1,5828,[313 143 257 127 748],796,5,23515,4.034139646594613,0.0,20.0
15829,1,5829,[427 588  79  98 127],716,5,23520,4.034305317324185,20.0,20.0
15830,1,5830,[427 588  79  98 127],796,5,23525,4.0344709312296345,20.0,20.0
15831,1,5831,[427 588  79  98 127],450,5,23530,4.034636488340192,20.0,20.0
15832,1,5832,[427 588  79  98 127],796,5,23535,4.034801988685068,20.0,20.0
15833,1,5833,[ 22 357  89 318 546],450,5,23540,4.034967432293453,20.0,0.0
15834,1,5834,[185 357 204  79 196],655,3,23543,4.034790059982862,0.0,0.0
15835,1,5835,[ 28 210 175  12 515],18,4,23547,4.034784098697738,0.0,0.0
15836,1,5836,[427 588  79  98 127],796,5,23552,4.034949460339216,20.0,20.0
15837,1,5837,[403 588 603 323 273],796,3,23555,4.034772182254197,20.0,0.0
15838,1,5838,[282 313 294 181  56],280,1,23556,4.034252440486385,0.0,0.0
15839,1,5839,[427 588  79  98 127],796,5,23561,4.034417808219178,20.0,20.0
15840,1,5840,[427 588  79  98 127],389,5,23566,4.034583119328882,20.0,20.0
15841,1,5841,[427 588  79  98 127],389,5,23571,4.0347483738445735,20.0,20.0
15842,1,5842,[427 588  79  98 127],796,5,23576,4.034913571795311,20.0,20.0
15843,1,5843,[427 588  79  98 127],450,5,23581,4.0350787132101305,20.0,20.0
15844,1,5844,[427 588  79  98 127],450,5,23586,4.035243798118049,20.0,20.0
15845,1,5845,[568 282 117 151 275],450,5,23591,4.035408826548067,0.0,20.0
15846,1,5846,[427 588  79  98 127],18,5,23596,4.03557379852916,20.0,20.0
15847,1,5847,[  1 215   4 313  97],655,1,23597,4.035054719562243,0.0,0.0
15848,1,5848,[427 588  79  98 127],450,5,23602,4.035219695674474,20.0,20.0
15849,1,5849,[211 435 216  28 471],65,5,23607,4.035384615384616,0.0,0.0
15850,1,5850,[125 127 118  64 328],796,5,23612,4.035549478721586,20.0,20.0
15851,1,5851,[210 588 176  25 172],344,5,23617,4.035714285714286,0.0,0.0
15852,1,5852,[282 405 234 427 222],796,4,23621,4.0357081838373485,20.0,0.0
15853,1,5853,[191 427 471 357 403],450,5,23626,4.035872907413734,20.0,0.0
15854,1,5854,[282  25 302  79  12],655,2,23628,4.035525192143467,0.0,0.0
15855,1,5855,[427 588  79  98 127],18,5,23633,4.035689890710382,20.0,20.0
15856,1,5856,[427 588  79  98 127],716,5,23638,4.035854533037391,20.0,20.0
15857,1,5857,[427 588  79  98 127],450,5,23643,4.036019119153295,20.0,20.0
15858,1,5858,[200 588 313 301 211],796,3,23646,4.03584229390681,0.0,0.0
15859,1,5859,[427 588  79  98 127],389,5,23651,4.036006825938567,20.0,20.0
15860,1,5860,[151 275  50  98 222],796,5,23656,4.036171301825627,0.0,40.0
15861,1,5861,[427 588  79  98 127],389,5,23661,4.036335721596725,20.0,20.0
15862,1,5862,[216 403  89 118 117],796,5,23666,4.036500085280573,0.0,0.0
15863,1,5863,[ 11  95 168  79 215],577,4,23670,4.036493860845839,0.0,0.0
15864,1,5864,[100 568 202  11 180],280,2,23672,4.03614663256607,0.0,20.0
15865,1,5865,[427 588  79  98 127],796,5,23677,4.0363109444255025,20.0,20.0
15866,1,5866,[427 117 328 186 238],796,3,23680,4.036134310550537,20.0,0.0
15867,1,5867,[427 588  79  98 127],716,5,23685,4.036298568507157,20.0,20.0
15868,1,5868,[427 588  79  98 127],450,5,23690,4.03646277048901,20.0,20.0
15869,1,5869,[228  82  98  95 168],577,4,23694,4.036456558773424,0.0,0.0
15870,1,5870,[427 588  79  98 127],450,5,23699,4.036620677908363,20.0,20.0
15871,1,5871,[294 273 175 269 568],655,1,23700,4.036103542234333,0.0,0.0
15872,1,5872,[318 471  96 228 483],807,4,23704,4.036097394857824,20.0,0.0
15873,1,5873,[427 588  79  98 127],716,5,23709,4.0362614913176715,20.0,20.0
15874,1,5874,[427 588  79  98 127],389,5,23714,4.036425531914894,20.0,20.0
15875,1,5875,[216 118 568 265 127],796,5,23719,4.036589516678013,0.0,20.0
15876,1,5876,[427 588  79  98 127],389,5,23724,4.0367534456355285,20.0,20.0
15877,1,5877,[427 100  88 588 302],389,4,23728,4.036747192922763,20.0,20.0
15878,1,5878,[179 174 143  71 121],593,5,23733,4.036911039292397,0.0,0.0
15879,1,5879,[427 588  79  98 127],389,5,23738,4.0370748299319725,20.0,20.0
15880,1,5880,[427 588  79  98 127],450,5,23743,4.03723856486992,20.0,20.0
15881,1,5881,[427 588  79  98 127],450,5,23748,4.037402244134648,20.0,20.0
15882,1,5882,[197 238  25 127  12],655,1,23749,4.03688594254632,0.0,20.0
15883,1,5883,[357 182 135  97 603],18,3,23752,4.036709721278042,20.0,0.0
15884,1,5884,[245 385 132 257  88],796,4,23756,4.036703483432455,0.0,0.0
15885,1,5885,[496 182 483 202  79],450,4,23760,4.036697247706422,20.0,0.0
15886,1,5886,[427 588  79  98 127],450,5,23765,4.036860879904875,20.0,20.0
15887,1,5887,[181 427  64 143 271],796,5,23770,4.037024456521739,40.0,0.0
15888,1,5888,[742 237 268   7 228],344,2,23772,4.036678553234845,0.0,0.0
15889,1,5889,[427 588  79  98 127],389,5,23777,4.036842105263158,20.0,20.0
15890,1,5890,[427 588  79  98 127],18,5,23782,4.037005601765405,20.0,20.0
15891,1,5891,[161 117 127 403  50],72,3,23785,4.03682959945689,0.0,40.0
15892,1,5892,[180  28 603 471 222],450,4,23789,4.036823349736976,20.0,0.0
15893,1,5893,[202 427 238  64 111],389,4,23793,4.036817102137767,40.0,0.0
15894,1,5894,[496 258 183 197 588],450,5,23798,4.036980491942324,20.0,0.0
15895,1,5895,[125 496 118 318 237],577,4,23802,4.036974219810041,40.0,0.0
15896,1,5896,[  9 228  25 288 318],693,2,23804,4.036628794302188,20.0,0.0
15897,1,5897,[748 546 245 195 313],450,5,23809,4.036792132926416,0.0,0.0
15898,1,5898,[427 588  79  98 127],716,5,23814,4.0369554161722325,20.0,20.0
15899,1,5899,[427 588  79  98 127],796,5,23819,4.037118644067797,20.0,20.0
15900,1,5900,[127  82 117 235  22],807,3,23822,4.036942891035418,0.0,20.0
15901,1,5901,[427 588  79  98 127],796,5,23827,4.037106065740427,20.0,20.0
15902,1,5902,[181 194  70 111 100],151,4,23831,4.037099779772997,0.0,20.0
15903,1,5903,[237 132 215  56  69],504,3,23834,4.036924119241192,0.0,0.0
15904,1,5904,[427 588  79  98 127],716,5,23839,4.037087214225233,20.0,20.0
15905,1,5905,[427 588  79  98 127],716,5,23844,4.037250253979004,20.0,20.0
15906,1,5906,[427 588  79  98 127],389,5,23849,4.037413238530557,20.0,20.0
15907,1,5907,[427 588  79  98 127],389,5,23854,4.037576167907922,20.0,20.0
15908,1,5908,[427 588  79  98 127],796,5,23859,4.03773904213911,20.0,20.0
15909,1,5909,[143  69 186  56   7],885,3,23862,4.037563451776649,0.0,0.0
15910,1,5910,[546 183 194 173 117],796,5,23867,4.037726273050246,0.0,0.0
15911,1,5911,[427 588  79  98 127],796,5,23872,4.037889039242219,20.0,20.0
15912,1,5912,[  1  96 258 603 322],450,5,23877,4.038051750380517,20.0,0.0
15913,1,5913,[427 588  79  98 127],389,5,23882,4.038214406493068,20.0,20.0
15914,1,5914,[427 588  79  98 127],389,5,23887,4.038377007607777,20.0,20.0
15915,1,5915,[427 588  79  98 127],796,5,23892,4.0385395537525355,20.0,20.0
15916,1,5916,[216 289 508 275 204],655,2,23894,4.038195031265844,0.0,20.0
15917,1,5917,[427 588  79  98 127],18,5,23899,4.038357553227442,20.0,20.0
15918,1,5918,[427 588  79  98 127],450,5,23904,4.038520020273695,20.0,20.0
15919,1,5919,[427 588  79  98 127],389,5,23909,4.038682432432433,20.0,20.0
15920,1,5920,[ 98 195  22 161 568],796,5,23914,4.038844789731464,0.0,0.0
15921,1,5921,[427 588  79  98 127],796,5,23919,4.039007092198582,20.0,20.0
15922,1,5922,[427 588  79  98 127],389,5,23924,4.039169339861557,20.0,20.0
15923,1,5923,[121  11 289 222 144],655,0,23924,4.038487508440243,0.0,0.0
15924,1,5924,[427 588  79  98 127],450,5,23929,4.038649789029536,20.0,20.0
15925,1,5925,[427 588  79  98 127],18,5,23934,4.038812014849815,20.0,20.0
15926,1,5926,[427 588  79  98 127],716,5,23939,4.0389741859288,20.0,20.0
15927,1,5927,[144  96  88 276 268],655,1,23940,4.038461538461538,0.0,0.0
15928,1,5928,[210 181 742 222  22],344,2,23942,4.038117726429415,0.0,0.0
15929,1,5929,[427 588  79  98 127],450,5,23947,4.0382799325463745,20.0,20.0
15930,1,5930,[273 182 117 234 276],655,3,23950,4.038104872702748,0.0,0.0
15931,1,5931,[483 357 196 186 328],655,2,23952,4.03776129467296,0.0,0.0
15932,1,5932,[269 313  15 546 111],450,4,23956,4.03775493005225,0.0,0.0
15933,1,5933,[216 174 588 172 204],577,5,23961,4.037917087967644,0.0,0.0
15934,1,5934,[ 88 151 234 172 403],577,3,23964,4.037742207245156,0.0,0.0
15935,1,5935,[427 588  79  98 127],18,5,23969,4.037904312668464,20.0,20.0
15936,1,5936,[237  64 483 322 257],401,1,23970,4.037392622536634,20.0,0.0
15937,1,5937,[405 151 181 403 179],450,5,23975,4.037554732233075,0.0,0.0
15938,1,5938,[423 196 300 234 176],796,4,23979,4.037548408823034,0.0,0.0
15939,1,5939,[427 588  79  98 127],796,5,23984,4.037710437710437,20.0,20.0
15940,1,5940,[ 71 483 195 111 117],236,2,23986,4.037367446557819,0.0,0.0
15941,1,5941,[427 588  79  98 127],716,5,23991,4.037529451363177,20.0,20.0
15942,1,5942,[483 121 257 153  15],296,4,23995,4.037523136463066,0.0,0.0
15943,1,5943,[ 88 435 265 202 172],151,5,24000,4.037685060565276,0.0,0.0
15944,1,5944,[427 588  79  98 127],796,5,24005,4.03784693019344,20.0,20.0
15945,1,5945,[153  69 288  50 328],655,1,24006,4.037336024217962,0.0,20.0
15946,1,5946,[173  95 180  12 273],796,3,24009,4.0371615940810495,0.0,0.0
15947,1,5947,[153 427 185 265  28],151,4,24013,4.037155346334902,20.0,0.0
15948,1,5948,[588 427 318 483 222],716,5,24018,4.0373171961674235,40.0,0.0
15949,1,5949,[427 588  79  98 127],796,5,24023,4.037478991596639,20.0,20.0
15950,1,5950,[174 100 288  56 117],504,4,24027,4.03747269366493,0.0,20.0
15951,1,5951,[385 143 313 196 475],655,2,24029,4.037130376344086,0.0,0.0
15952,1,5952,[427 588  79  98 127],716,5,24034,4.037292121619352,20.0,20.0
15953,1,5953,[427 588  79  98 127],716,5,24039,4.037453812562983,20.0,20.0
15954,1,5954,[238 132 194 185 174],504,3,24042,4.03727959697733,0.0,0.0
15955,1,5955,[427 588  79  98 127],389,5,24047,4.037441235728677,20.0,20.0
15956,1,5956,[179 182 568 496 318],450,5,24052,4.037602820211516,40.0,0.0
15957,1,5957,[172  69 333 238 135],629,5,24057,4.037764350453172,0.0,0.0
15958,1,5958,[100 655 302 603 275],151,3,24060,4.037590199697936,20.0,40.0
15959,1,5959,[215 202 196 403 117],450,5,24065,4.037751677852349,0.0,0.0
15960,1,5960,[427 588  79  98 127],450,5,24070,4.037913101828552,20.0,20.0
15961,1,5961,[186   7 357 268 294],296,3,24073,4.037739013753774,0.0,0.0
15962,1,5962,[210 748 185 275 318],401,4,24077,4.037732684890156,20.0,20.0
15963,1,5963,[427 588  79  98 127],796,5,24082,4.037894030851778,20.0,20.0
15964,1,5964,[275 182  96 282 183],796,5,24087,4.038055322715842,0.0,20.0
15965,1,5965,[ 98 546 216   7 185],151,4,24091,4.038048944016091,0.0,0.0
15966,1,5966,[175 405 357 301 273],344,4,24095,4.038042567454332,0.0,0.0
15967,1,5967,[  9 322 121 117 471],733,0,24095,4.037365951742627,0.0,0.0
15968,1,5968,[427 588  79  98 127],18,5,24100,4.037527223990618,20.0,20.0
15969,1,5969,[195 301 202 357 125],796,4,24104,4.037520938023451,0.0,0.0
15970,1,5970,[ 98 100  69 172  82],280,2,24106,4.03717970189248,0.0,20.0
15971,1,5971,[427 588  79  98 127],18,5,24111,4.037340924313463,20.0,20.0
15972,1,5972,[603 313 301   8 194],796,4,24115,4.037334672693789,20.0,0.0
15973,1,5973,[427 588  79  98 127],389,5,24120,4.037495815199197,20.0,20.0
15974,1,5974,[423 187  50 135 228],655,3,24123,4.037322175732218,0.0,20.0
15975,1,5975,[427 588  79  98 127],389,5,24128,4.037483266398929,20.0,20.0
15976,1,5976,[568 183  22 435 228],655,1,24129,4.036975071105906,0.0,0.0
15977,1,5977,[238 144 483  96 151],716,3,24132,4.0368016058882565,0.0,0.0
15978,1,5978,[234 508 117 288 286],655,0,24132,4.036126442548921,0.0,20.0
15979,1,5979,[ 25 196 258 176 174],450,4,24136,4.036120401337793,0.0,0.0
15980,1,5980,[234 185   1 191 471],450,4,24140,4.036114362146798,0.0,0.0
15981,1,5981,[179  50 200 175 118],457,5,24145,4.036275493146105,0.0,20.0
15982,1,5982,[427 588  79  98 127],450,5,24150,4.036436570282467,20.0,20.0
15983,1,5983,[294 301 257 286  50],796,2,24152,4.036096256684492,0.0,40.0
15984,1,5984,[427 588  79  98 127],450,5,24157,4.03625730994152,20.0,20.0
15985,1,5985,[182 294 271 318 176],796,4,24161,4.036251252923488,20.0,0.0
15986,1,5986,[161 127 328  70 302],401,2,24163,4.035911140805077,0.0,20.0
15987,1,5987,[385   1 222 211  88],151,4,24167,4.035905143620575,0.0,0.0
15988,1,5988,[323  69 258 183 185],504,4,24171,4.035899148438804,0.0,0.0
15989,1,5989,[427 588  79  98 127],716,5,24176,4.036060100166945,20.0,20.0
15990,1,5990,[186  82 294 282 191],655,1,24177,4.035553329994992,0.0,0.0
15991,1,5991,[427 588  79  98 127],796,5,24182,4.035714285714286,20.0,20.0
15992,1,5992,[427 588  79  98 127],716,5,24187,4.0358751877190056,20.0,20.0
15993,1,5993,[237  98 483  22 127],655,3,24190,4.035702369035702,0.0,20.0
15994,1,5994,[427 588  79  98 127],18,5,24195,4.035863219349458,20.0,20.0
15995,1,5995,[318 179   9 245 118],593,3,24198,4.0356904603068715,20.0,0.0
15996,1,5996,[427 588  79  98 127],450,5,24203,4.035851258962815,20.0,20.0
15997,1,5997,[427 588  79  98 127],450,5,24208,4.036012004001334,20.0,20.0
15998,1,5998,[288  97 202 245 294],256,3,24211,4.035839306551092,0.0,0.0
15999,1,5999,[ 70 222 328 245   7],450,4,24215,4.035833333333334,0.0,0.0
16000,1,6000,[427 588  79  98 127],716,5,24220,4.035994000999834,20.0,20.0
16001,1,6001,[175 121 172 183 471],344,3,24223,4.035821392869043,0.0,0.0
16002,1,6002,[427 588  79  98 127],18,5,24228,4.035982008995502,20.0,20.0
16003,1,6003,[333  11  12 357 144],629,4,24232,4.03597601598934,0.0,0.0
16004,1,6004,[427 588  79  98 127],796,5,24237,4.036136552872606,20.0,20.0
16005,1,6005,[194 180 175  50 135],716,2,24239,4.035797535797536,0.0,20.0
16006,1,6006,[200 322 196  70 302],151,2,24241,4.0354586315964704,0.0,0.0
16007,1,6007,[427 588  79  98 127],450,5,24246,4.035619174434088,20.0,20.0
16008,1,6008,[111 235 174   8  69],269,0,24246,4.034947578632052,0.0,0.0
16009,1,6009,[427 588  79  98 127],389,5,24251,4.035108153078203,20.0,20.0
16010,1,6010,[197  11 180  96 117],457,5,24256,4.035268674097488,0.0,0.0
16011,1,6011,[135  79 318 172  71],807,5,24261,4.035429141716567,20.0,0.0
16012,1,6012,[427 588  79  98 127],796,5,24266,4.0355895559620825,20.0,20.0
16013,1,6013,[ 56 294 153 357 195],796,4,24270,4.035583638177585,0.0,0.0
16014,1,6014,[ 98 257 185  25 403],504,4,24274,4.035577722360765,0.0,0.0
16015,1,6015,[427 588  79  98 127],389,5,24279,4.035738031914893,20.0,20.0
16016,1,6016,[258 144 238   4 125],796,4,24283,4.035732092404853,0.0,0.0
16017,1,6017,[ 22 597 483 210  89],269,1,24284,4.035227650382187,0.0,0.0
16018,1,6018,[427 588  79  98 127],18,5,24289,4.035387938195713,20.0,20.0
16019,1,6019,[603 153 333 195 257],655,1,24290,4.034883720930233,20.0,0.0
16020,1,6020,[ 70   1 144 568 181],593,4,24294,4.034877927254609,0.0,0.0
16021,1,6021,[357 211 135  25 202],401,4,24298,4.034872135503155,0.0,0.0
16022,1,6022,[180 143 275 588 515],716,4,24302,4.034866345674913,0.0,20.0
16023,1,6023,[427 588  79  98 127],18,5,24307,4.035026560424967,20.0,20.0
16024,1,6024,[427 588  79  98 127],389,5,24312,4.0351867219917015,20.0,20.0
16025,1,6025,[483 265 423 174 235],450,3,24315,4.035014935280452,0.0,0.0
16026,1,6026,[132 427  96 403 257],807,4,24319,4.03500912560146,20.0,0.0
16027,1,6027,[427 423 121 191 132],655,2,24321,4.0346715328467155,20.0,0.0
16028,1,6028,[427 588  79  98 127],18,5,24326,4.03483164703931,20.0,20.0
16029,1,6029,[427 588  79  98 127],389,5,24331,4.034991708126037,20.0,20.0
16030,1,6030,[427 588  79  98 127],18,5,24336,4.035151716133311,20.0,20.0
16031,1,6031,[ 88 202 173 515 111],401,4,24340,4.0351458885941645,0.0,0.0
16032,1,6032,[174 546 228 568 403],796,5,24345,4.035305818000994,0.0,0.0
16033,1,6033,[202 204 185  22  69],269,1,24346,4.034802784222737,0.0,0.0
16034,1,6034,[ 88 742 176 568 273],655,1,24347,4.0342999171499585,0.0,0.0
16035,1,6035,[427 588  79  98 127],716,5,24352,4.034459907223327,20.0,20.0
16036,1,6036,[318 423  88 181 176],280,2,24354,4.034122908729501,20.0,0.0
16037,1,6037,[427 588  79  98 127],796,5,24359,4.034282875124213,20.0,20.0
16038,1,6038,[238  69 153 275   7],629,4,24363,4.034277198211624,0.0,20.0
16039,1,6039,[ 70  64  12 194 211],18,4,24367,4.034271523178808,20.0,0.0
16040,1,6040,[655 204  69   1 144],280,2,24369,4.033934779010098,0.0,0.0
16041,1,6041,[427 588  79  98 127],389,5,24374,4.034094670638861,20.0,20.0
16042,1,6042,[302 118 237 168  15],450,3,24377,4.033923547906669,0.0,0.0
16043,1,6043,[132 111 282   4  15],457,4,24381,4.03391793514229,0.0,0.0
16044,1,6044,[ 50 173 546  70 197],716,4,24385,4.033912324234905,0.0,20.0
16045,1,6045,[318   4 216 182 568],450,4,24389,4.033906715183592,20.0,0.0
16046,1,6046,[183 597 161 195 403],269,0,24389,4.033239622953531,0.0,0.0
16047,1,6047,[228  97 202 275 118],344,3,24392,4.033068783068783,0.0,20.0
16048,1,6048,[202 483 237 427 127],269,3,24395,4.032897999669367,20.0,20.0
16049,1,6049,[427 588  79  98 127],716,5,24400,4.033057851239669,20.0,20.0
16050,1,6050,[588 405 196   7 273],344,4,24404,4.033052388035036,0.0,0.0
16051,1,6051,[ 98  82 144 405   4],655,1,24405,4.032551222736285,0.0,0.0
16052,1,6052,[427 588  79  98 127],716,5,24410,4.0327110523707255,20.0,20.0
16053,1,6053,[195 294 127 197 111],796,3,24413,4.032540469111331,0.0,20.0
16054,1,6054,[427 588  79  98 127],389,5,24418,4.032700247729149,20.0,20.0
16055,1,6055,[427 588  79  98 127],389,5,24423,4.032859973579921,20.0,20.0
16056,1,6056,[427 588  79  98 127],389,5,24428,4.03301964668978,20.0,20.0
16057,1,6057,[588 269 302 127 268],344,4,24432,4.033014196104324,0.0,20.0
16058,1,6058,[427 588  79  98 127],716,5,24437,4.0331737910546295,20.0,20.0
16059,1,6059,[427 588  79  98 127],450,5,24442,4.033333333333333,20.0,20.0
16060,1,6060,[300 427   7  88 182],655,2,24444,4.032997855139416,20.0,0.0
16061,1,6061,[427 588  79  98 127],450,5,24449,4.033157373804025,20.0,20.0
16062,1,6062,[318  79 483 323 127],280,4,24453,4.033151904997526,20.0,20.0
16063,1,6063,[427 588  79  98 127],18,5,24458,4.033311345646438,20.0,20.0
16064,1,6064,[427 588  79  98 127],389,5,24463,4.033470733718055,20.0,20.0
16065,1,6065,[328 200 197 204 211],450,4,24467,4.033465215957798,0.0,0.0
16066,1,6066,[427 588  79  98 127],716,5,24472,4.033624526124938,20.0,20.0
16067,1,6067,[427 588  79  98 127],389,5,24477,4.033783783783784,20.0,20.0
16068,1,6068,[118 191 333 186 117],796,4,24481,4.03377821716922,0.0,0.0
16069,1,6069,[405 294 179  25 318],655,2,24483,4.033443163097199,20.0,0.0
16070,1,6070,[ 88 144 204 222  25],450,3,24486,4.033272936913193,0.0,0.0
16071,1,6071,[427 588  79  98 127],18,5,24491,4.033432147562582,20.0,20.0
16072,1,6072,[427 588  79  98 127],18,5,24496,4.03359130577968,20.0,20.0
16073,1,6073,[ 96 234 135 187 151],450,3,24499,4.033421139282186,0.0,0.0
16074,1,6074,[427 588  79  98 127],18,5,24504,4.03358024691358,20.0,20.0
16075,1,6075,[427 588  79  98 127],716,5,24509,4.033739302172482,20.0,20.0
16076,1,6076,[427 588  79  98 127],716,5,24514,4.033898305084746,20.0,20.0
16077,1,6077,[294  12 135 174 143],450,4,24518,4.03389272787101,0.0,0.0
16078,1,6078,[427 588  79  98 127],450,5,24523,4.0340516532324395,20.0,20.0
16079,1,6079,[427 588  79  98 127],450,5,24528,4.03421052631579,20.0,20.0
16080,1,6080,[210 125 234 357 228],450,3,24531,4.034040453872718,0.0,0.0
16081,1,6081,[427 588  79  98 127],716,5,24536,4.034199276553765,20.0,20.0
16082,1,6082,[427 588  79  98 127],450,5,24541,4.0343580470162745,20.0,20.0
16083,1,6083,[427 588  79  98 127],389,5,24546,4.034516765285996,20.0,20.0
16084,1,6084,[282 179 187 202 195],655,2,24548,4.0341824157765,0.0,0.0
16085,1,6085,[ 56 258  28 435   1],450,5,24553,4.034341110745975,0.0,0.0
16086,1,6086,[427 588  79  98 127],389,5,24558,4.034499753573189,20.0,20.0
16087,1,6087,[427 588  79  98 127],796,5,24563,4.034658344283837,20.0,20.0
16088,1,6088,[427 588  79  98 127],716,5,24568,4.034816882903597,20.0,20.0
16089,1,6089,[191 182 423 181 211],796,4,24572,4.034811165845649,0.0,0.0
16090,1,6090,[271  69 195 172 194],72,3,24575,4.034641274010836,0.0,0.0
16091,1,6091,[117  79 568   4 288],256,5,24580,4.034799737360473,0.0,0.0
16092,1,6092,[427 588  79  98 127],18,5,24585,4.034958148695224,20.0,20.0
16093,1,6093,[168  50 211 174  89],807,5,24590,4.035116508040696,0.0,20.0
16094,1,6094,[180 328 403  97 300],450,5,24595,4.035274815422477,0.0,0.0
16095,1,6095,[427 588  79  98 127],796,5,24600,4.035433070866142,20.0,20.0
16096,1,6096,[427 588  79  98 127],716,5,24605,4.035591274397245,20.0,20.0
16097,1,6097,[195 655 194 603 302],269,3,24608,4.035421449655625,20.0,0.0
16098,1,6098,[282 427 168 216 546],796,5,24613,4.035579603213642,20.0,0.0
16099,1,6099,[471 427 271   7  11],655,1,24614,4.035081967213115,20.0,0.0
16100,1,6100,[515 181  96 496 211],269,3,24617,4.034912309457466,20.0,0.0
16101,1,6101,[258 546 423 202 234],457,4,24621,4.034906588003933,0.0,0.0
16102,1,6102,[427 588  79  98 127],796,5,24626,4.035064722267737,20.0,20.0
16103,1,6103,[222 151 183  79 258],796,5,24631,4.0352228047182175,0.0,0.0
16104,1,6104,[427 588  79  98 127],716,5,24636,4.035380835380836,20.0,20.0
16105,1,6105,[427 588  79  98 127],796,5,24641,4.035538814281035,20.0,20.0
16106,1,6106,[197  71 357 483 286],18,5,24646,4.035696741444244,0.0,20.0
16107,1,6107,[282 181 153 257 127],296,5,24651,4.035854616895874,0.0,20.0
16108,1,6108,[423 496  22 183 322],280,4,24655,4.035848747749222,20.0,0.0
16109,1,6109,[ 50 288 269 228 194],450,4,24659,4.035842880523732,0.0,20.0
16110,1,6110,[427 588  79  98 127],796,5,24664,4.0360006545573555,20.0,20.0
16111,1,6111,[427 588  79  98 127],450,5,24669,4.036158376963351,20.0,20.0
16112,1,6112,[ 95 234 111 186 313],577,4,24673,4.036152461966301,0.0,0.0
16113,1,6113,[173 258 546  96 197],450,5,24678,4.036310107948969,0.0,0.0
16114,1,6114,[427 588  79  98 127],450,5,24683,4.036467702371218,20.0,20.0
16115,1,6115,[427 588  79  98 127],450,5,24688,4.036625245258339,20.0,20.0
16116,1,6116,[427 588  79  98 127],450,5,24693,4.0367827366356055,20.0,20.0
16117,1,6117,[  9 185 194 174 238],796,3,24696,4.036613272311213,0.0,0.0
16118,1,6118,[237  15 288 318 197],450,3,24699,4.036443863376369,20.0,0.0
16119,1,6119,[427 588  79  98 127],389,5,24704,4.036601307189542,20.0,20.0
16120,1,6120,[143 121 228 423 174],716,5,24709,4.036758699558896,0.0,0.0
16121,1,6121,[427 588  79  98 127],450,5,24714,4.036916040509637,20.0,20.0
16122,1,6122,[427 588  79  98 127],18,5,24719,4.037073330066961,20.0,20.0
16123,1,6123,[427 588  79  98 127],716,5,24724,4.037230568256041,20.0,20.0
16124,1,6124,[258 275 265 127 357],457,5,24729,4.037387755102041,0.0,40.0
16125,1,6125,[427 588  79  98 127],796,5,24734,4.037544890630101,20.0,20.0
16126,1,6126,[427 588  79  98 127],796,5,24739,4.03770197486535,20.0,20.0
16127,1,6127,[427 168 568  22 118],716,4,24743,4.0376958224543085,20.0,0.0
16128,1,6128,[427 588  79  98 127],18,5,24748,4.037852830804373,20.0,20.0
16129,1,6129,[496  82 427 258 273],450,3,24751,4.0376835236541595,40.0,0.0
16130,1,6130,[ 12 228  69 588 180],450,5,24756,4.037840482792367,0.0,0.0
16131,1,6131,[204  97 121  25  50],504,3,24759,4.037671232876712,0.0,20.0
16132,1,6132,[151 185 196 655 275],151,5,24764,4.03782814283385,0.0,20.0
16133,1,6133,[427 588  79  98 127],389,5,24769,4.037985001630258,20.0,20.0
16134,1,6134,[427 588  79  98 127],18,5,24774,4.038141809290954,20.0,20.0
16135,1,6135,[196  25 179 471 191],65,4,24778,4.038135593220339,0.0,0.0
16136,1,6136,[ 11 546 176  98   8],577,3,24781,4.037966433110641,0.0,0.0
16137,1,6137,[322 423  82  56 257],504,4,24785,4.037960247637667,0.0,0.0
16138,1,6138,[405 237 603 286   8],11,4,24789,4.037954064179834,20.0,20.0
16139,1,6139,[275  82   8 435 202],18,3,24792,4.037785016286645,0.0,20.0
16140,1,6140,[111 222 276 151 127],457,4,24796,4.0377788633773,0.0,20.0
16141,1,6141,[427 216 210  22 200],18,4,24800,4.037772712471508,20.0,0.0
16142,1,6142,[427 588  79  98 127],18,5,24805,4.037929350480221,20.0,20.0
16143,1,6143,[427 588  79  98 127],18,5,24810,4.0380859375,20.0,20.0
16144,1,6144,[300 204 196 151 515],716,5,24815,4.038242473555736,0.0,0.0
16145,1,6145,[427 588  79  98 127],18,5,24820,4.038398958672307,20.0,20.0
16146,1,6146,[289 222 187 302 182],655,3,24823,4.038230030909387,0.0,0.0
16147,1,6147,[ 97  50 197 282  88],655,1,24824,4.037735849056604,0.0,20.0
16148,1,6148,[135 186 168 515 121],269,3,24827,4.037567084078712,0.0,0.0
16149,1,6149,[ 11 181 282  79 568],655,1,24828,4.037073170731707,0.0,0.0
16150,1,6150,[427 588  79  98 127],716,5,24833,4.0372297187449195,20.0,20.0
16151,1,6151,[  4 153 135  98 143],18,3,24836,4.037061118335501,0.0,0.0
16152,1,6152,[427 588  79  98 127],796,5,24841,4.037217617422396,20.0,20.0
16153,1,6153,[117  71 483 234 496],807,4,24845,4.037211569710757,20.0,0.0
16154,1,6154,[427 588  79  98 127],389,5,24850,4.037367993501219,20.0,20.0
16155,1,6155,[427 588  79  98 127],796,5,24855,4.037524366471735,20.0,20.0
16156,1,6156,[427 588  79  98 127],18,5,24860,4.037680688647068,20.0,20.0
16157,1,6157,[427 588  79  98 127],796,5,24865,4.037836960051965,20.0,20.0
16158,1,6158,[191  15 194 197 222],798,3,24868,4.037668452670888,0.0,0.0
16159,1,6159,[475 181 111  96 186],296,3,24871,4.0375,0.0,0.0
16160,1,6160,[ 28 132 423 385  98],716,4,24875,4.037493913325759,0.0,0.0
16161,1,6161,[118 273 301 144   1],796,2,24877,4.037163258682246,0.0,0.0
16162,1,6162,[427 588  79  98 127],796,5,24882,4.037319487262697,20.0,20.0
16163,1,6163,[288  25  50 187 496],450,3,24885,4.037151200519143,20.0,20.0
16164,1,6164,[742 508 100 181   7],938,4,24889,4.037145174371452,0.0,20.0
16165,1,6165,[197  15 269 742 237],450,4,24893,4.0371391501783975,0.0,0.0
16166,1,6166,[273 294 568  56 200],655,2,24895,4.0368088211448026,0.0,0.0
16167,1,6167,[ 98 265   7 276  11],629,3,24898,4.036640726329442,0.0,0.0
16168,1,6168,[ 12  71 186 161 181],450,3,24901,4.036472686010699,0.0,0.0
16169,1,6169,[135 322 655 111 174],151,4,24905,4.036466774716369,0.0,0.0
16170,1,6170,[427 588  79  98 127],18,5,24910,4.036622913628261,20.0,20.0
16171,1,6171,[427 588  79  98 127],796,5,24915,4.036779001944264,20.0,20.0
16172,1,6172,[200  22 427 187 301],450,4,24919,4.036773043900858,20.0,0.0
16173,1,6173,[300 234 197 151 125],292,4,24923,4.036767087787496,0.0,0.0
16174,1,6174,[ 71 196 175 496 423],18,4,24927,4.036761133603239,20.0,0.0
16175,1,6175,[ 95 121 385 195 183],716,2,24929,4.036431347150259,0.0,0.0
16176,1,6176,[427 588  79  98 127],18,5,24934,4.03658734013275,20.0,20.0
16177,1,6177,[427 588  79  98 127],389,5,24939,4.036743282615733,20.0,20.0
16178,1,6178,[288 282 275  97 546],457,4,24943,4.0367373361385335,0.0,20.0
16179,1,6179,[427 588  79  98 127],796,5,24948,4.036893203883495,20.0,20.0
16180,1,6180,[427 588  79  98 127],796,5,24953,4.037049021193981,20.0,20.0
16181,1,6181,[ 50  95 173 202 496],786,5,24958,4.037204788094468,20.0,20.0
16182,1,6182,[153 144 423   1  89],5,4,24962,4.037198770823225,0.0,0.0
16183,1,6183,[ 82 211 357 196 435],151,4,24966,4.03719275549806,0.0,0.0
16184,1,6184,[427 588  79  98 127],18,5,24971,4.037348423605497,20.0,20.0
16185,1,6185,[427 588  79  98 127],716,5,24976,4.0375040413837695,20.0,20.0
16186,1,6186,[235  89 405 435 195],269,0,24976,4.0368514627444645,0.0,0.0
16187,1,6187,[427 588  79  98 127],796,5,24981,4.037007110536522,20.0,20.0
16188,1,6188,[187 288 385 191 118],450,3,24984,4.0368395540475035,0.0,0.0
16189,1,6189,[135 238 185 187 471],655,3,24987,4.036672051696284,0.0,0.0
16190,1,6190,[313  50 403 245 294],280,0,24987,4.036020029074463,0.0,20.0
16191,1,6191,[427 588  79  98 127],389,5,24992,4.036175710594315,20.0,20.0
16192,1,6192,[174 195 121 258 385],457,5,24997,4.036331341837559,0.0,0.0
16193,1,6193,[427 588  79  98 127],18,5,25002,4.036486922828543,20.0,20.0
16194,1,6194,[276 678 508  96 204],280,2,25004,4.0361581920903955,0.0,0.0
16195,1,6195,[ 70  64   7 127  25],344,4,25008,4.036152356358941,20.0,20.0
16196,1,6196,[427 588  79  98 127],716,5,25013,4.036307890914959,20.0,20.0
16197,1,6197,[427 588  79  98 127],18,5,25018,4.0364633752823496,20.0,20.0
16198,1,6198,[742 235 172 216 197],457,4,25022,4.036457493144056,0.0,0.0
16199,1,6199,[427 588  79  98 127],716,5,25027,4.036612903225806,20.0,20.0
16200,1,6200,[258 179 172  89 300],450,5,25032,4.036768263183357,0.0,0.0
16201,1,6201,[427 202  98 132 258],450,5,25037,4.036923573040955,20.0,0.0
16202,1,6202,[427 588  79  98 127],450,5,25042,4.037078832822828,20.0,20.0
16203,1,6203,[427 588  79  98 127],18,5,25047,4.037234042553192,20.0,20.0
16204,1,6204,[322 215 195  70 153],151,1,25048,4.0367445608380335,0.0,0.0
16205,1,6205,[228 237 496 282 238],450,5,25053,4.036899774411859,20.0,0.0
16206,1,6206,[427 588  79  98 127],716,5,25058,4.037054937973256,20.0,20.0
16207,1,6207,[427 588  79  98 127],716,5,25063,4.037210051546392,20.0,20.0
16208,1,6208,[328  15 216   9 294],236,4,25067,4.037204058624577,0.0,0.0
16209,1,6209,[151 286   8 234 182],389,4,25071,4.0371980676328505,0.0,20.0
16210,1,6210,[282   7 288 195 222],655,0,25071,4.036548059893737,0.0,0.0
16211,1,6211,[427 588  79  98 127],389,5,25076,4.036703155183516,20.0,20.0
16212,1,6212,[483 121 435 245  89],450,3,25079,4.036536294865605,0.0,0.0
16213,1,6213,[ 25  56 258 204 196],11,3,25082,4.036369488252333,0.0,0.0
16214,1,6214,[187 121 357 322 269],796,3,25085,4.036202735317779,0.0,0.0
16215,1,6215,[427 588  79  98 127],716,5,25090,4.036357786357787,20.0,20.0
16216,1,6216,[427 588  79  98 127],389,5,25095,4.036512787518095,20.0,20.0
16217,1,6217,[ 82  22  88 568 173],716,5,25100,4.036667738822772,0.0,0.0
16218,1,6218,[427 588  79  98 127],450,5,25105,4.036822640295868,20.0,20.0
16219,1,6219,[427 588  79  98 127],18,5,25110,4.036977491961415,20.0,20.0
16220,1,6220,[427 588  79  98 127],389,5,25115,4.037132293843434,20.0,20.0
16221,1,6221,[181 275 228 423 568],798,3,25118,4.036965605914497,0.0,20.0
16222,1,6222,[ 50 228 172 222  96],457,5,25123,4.037120359955006,0.0,20.0
16223,1,6223,[202 322  97  89  56],796,3,25126,4.036953727506427,0.0,0.0
16224,1,6224,[427 588  79  98 127],450,5,25131,4.037108433734939,20.0,20.0
16225,1,6225,[427 588  79  98 127],18,5,25136,4.037263090266624,20.0,20.0
16226,1,6226,[427 588  79  98 127],18,5,25141,4.037417697125422,20.0,20.0
16227,1,6227,[588 179 182  95 143],18,5,25146,4.03757225433526,0.0,0.0
16228,1,6228,[427 588  79  98 127],389,5,25151,4.037726761920052,20.0,20.0
16229,1,6229,[427 588  79  98 127],18,5,25156,4.037881219903692,20.0,20.0
16230,1,6230,[111 181 183 318 423],280,3,25159,4.037714652543733,20.0,0.0
16231,1,6231,[427 588  79  98 127],389,5,25164,4.037869062901155,20.0,20.0
16232,1,6232,[427 588  79  98 127],389,5,25169,4.038023423712498,20.0,20.0
16233,1,6233,[427 588  79  98 127],389,5,25174,4.038177735001604,20.0,20.0
16234,1,6234,[403 275  82   1 385],457,5,25179,4.0383319967923015,0.0,20.0
16235,1,6235,[427 588  79  98 127],450,5,25184,4.038486209108402,20.0,20.0
16236,1,6236,[427 588  79  98 127],389,5,25189,4.038640371973705,20.0,20.0
16237,1,6237,[132 403 125 357 191],796,5,25194,4.038794485411991,0.0,0.0
16238,1,6238,[333 313 127 483 471],655,3,25197,4.038627985254047,0.0,20.0
16239,1,6239,[427 588  79  98 127],796,5,25202,4.038782051282051,20.0,20.0
16240,1,6240,[427 588  79  98 127],796,5,25207,4.03893606793783,20.0,20.0
16241,1,6241,[427 588  79  98 127],450,5,25212,4.039090035245113,20.0,20.0
16242,1,6242,[655  98 286 245  97],450,5,25217,4.039243953227615,0.0,20.0
16243,1,6243,[427 588  79  98 127],716,5,25222,4.0393978219090325,20.0,20.0
16244,1,6244,[496 748  50 655 313],450,5,25227,4.03955164131305,20.0,20.0
16245,1,6245,[161 210 143  71 597],807,5,25232,4.039705411463337,0.0,0.0
16246,1,6246,[427 588  79  98 127],389,5,25237,4.039859132383544,20.0,20.0
16247,1,6247,[427 588  79  98 127],18,5,25242,4.040012804097311,20.0,20.0
16248,1,6248,[ 22  64  50 187  96],256,4,25246,4.040006401024164,20.0,20.0
16249,1,6249,[427 588  79  98 127],796,5,25251,4.04016,20.0,20.0
16250,1,6250,[191 238 183 176 151],450,5,25256,4.040313549832027,0.0,0.0
16251,1,6251,[427 588  79  98 127],450,5,25261,4.040467050543826,20.0,20.0
16252,1,6252,[ 11   4 742 174 427],655,1,25262,4.0399808092115785,20.0,0.0
16253,1,6253,[ 64 132 210 435 748],151,4,25266,4.0399744163735205,20.0,0.0
16254,1,6254,[427 588  79  98 127],18,5,25271,4.040127897681854,20.0,20.0
16255,1,6255,[427 588  79  98 127],716,5,25276,4.040281329923274,20.0,20.0
16256,1,6256,[194 121 427 300 271],796,5,25281,4.0404347131213045,20.0,0.0
16257,1,6257,[423 748 174  95  11],436,3,25284,4.040268456375839,0.0,0.0
16258,1,6258,[427 588  79  98 127],389,5,25289,4.040421792618629,20.0,20.0
16259,1,6259,[427 588  79  98 127],18,5,25294,4.040575079872204,20.0,20.0
16260,1,6260,[111 180 195 234 294],450,4,25298,4.040568599265293,0.0,0.0
16261,1,6261,[427 588  79  98 127],18,5,25303,4.040721814116895,20.0,20.0
16262,1,6262,[176 132 117   4 211],655,0,25303,4.040076640587578,0.0,0.0
16263,1,6263,[211 655 496 143  50],593,4,25307,4.04007024265645,20.0,20.0
16264,1,6264,[204  15 515 234 237],878,2,25309,4.0397446129289705,0.0,0.0
16265,1,6265,[186 176 196 121 125],796,4,25313,4.039738270028726,0.0,0.0
16266,1,6266,[235 215   9 195 546],280,3,25316,4.039572363172172,0.0,0.0
16267,1,6267,[273 121 204 210  96],796,3,25319,4.03940650925335,0.0,0.0
16268,1,6268,[322 471 228 276  79],280,3,25322,4.039240708246929,0.0,0.0
16269,1,6269,[427 173 196 435 182],450,5,25327,4.039393939393939,20.0,0.0
16270,1,6270,[215 269 471 181  79],655,1,25328,4.038909264870036,0.0,0.0
16271,1,6271,[197 100 588 144 151],401,3,25331,4.03874362244898,0.0,20.0
16272,1,6272,[427 588  79  98 127],18,5,25336,4.03889685955683,20.0,20.0
16273,1,6273,[161  69 135 302  82],269,1,25337,4.038412496015301,0.0,0.0
16274,1,6274,[427 588  79  98 127],796,5,25342,4.038565737051793,20.0,20.0
16275,1,6275,[ 97  96 173 118 210],756,2,25344,4.038240917782026,0.0,0.0
16276,1,6276,[ 89 276  50 168  69],269,2,25346,4.037916202007328,0.0,20.0
16277,1,6277,[427 588  79  98 127],450,5,25351,4.0380694488690665,20.0,20.0
16278,1,6278,[427 588  79  98 127],18,5,25356,4.038222646918299,20.0,20.0
16279,1,6279,[210 288 655  96 238],450,3,25359,4.038057324840764,0.0,0.0
16280,1,6280,[265 121 215  97 117],457,5,25364,4.038210476038848,0.0,0.0
16281,1,6281,[  9 275  50 175  64],18,5,25369,4.038363578478192,20.0,40.0
16282,1,6282,[427 588  79  98 127],716,5,25374,4.038516632182079,20.0,20.0
16283,1,6283,[405 257 144   9 286],796,3,25377,4.038351368555061,0.0,20.0
16284,1,6284,[427 588  79  98 127],450,5,25382,4.038504375497215,20.0,20.0
16285,1,6285,[183 515 275 135 483],716,3,25385,4.038339166401527,0.0,20.0
16286,1,6286,[427 588  79  98 127],18,5,25390,4.038492126610466,20.0,20.0
16287,1,6287,[153  96  71 161  79],280,5,25395,4.038645038167939,0.0,0.0
16288,1,6288,[265 435 118 546 187],450,4,25399,4.038638893305772,0.0,0.0
16289,1,6289,[427 588  79  98 127],716,5,25404,4.03879173290938,20.0,20.0
16290,1,6290,[427 588  79  98 127],450,5,25409,4.038944523923065,20.0,20.0
16291,1,6291,[427 588  79  98 127],450,5,25414,4.0390972663699936,20.0,20.0
16292,1,6292,[216 234 118 173 405],151,3,25417,4.0389321468298105,0.0,0.0
16293,1,6293,[216 200  11  56 176],450,4,25421,4.03892596123292,0.0,0.0
16294,1,6294,[427 588  79  98 127],18,5,25426,4.039078633836378,20.0,20.0
16295,1,6295,[132 195 300 748 191],450,5,25431,4.03923125794155,0.0,0.0
16296,1,6296,[196 238  97 265 288],457,5,25436,4.039383833571542,0.0,0.0
16297,1,6297,[191  56  88 435  79],18,4,25440,4.039377580184185,0.0,0.0
16298,1,6298,[427 588  79  98 127],716,5,25445,4.03953008414034,20.0,20.0
16299,1,6299,[125 471 118  15 100],655,0,25445,4.038888888888889,0.0,20.0
16300,1,6300,[427 588  79  98 127],389,5,25450,4.039041421996508,20.0,20.0
16301,1,6301,[427 588  79  98 127],796,5,25455,4.039193906696287,20.0,20.0
16302,1,6302,[276 111 117 318 195],457,4,25459,4.039187688402348,20.0,0.0
16303,1,6303,[427 588  79  98 127],796,5,25464,4.039340101522843,20.0,20.0
16304,1,6304,[427 588  79  98 127],18,5,25469,4.03949246629659,20.0,20.0
16305,1,6305,[427 588  79  98 127],18,5,25474,4.03964478274659,20.0,20.0
16306,1,6306,[427 588  79  98 127],18,5,25479,4.03979705089583,20.0,20.0
16307,1,6307,[427 588  79  98 127],18,5,25484,4.03994927076728,20.0,20.0
16308,1,6308,[427 588  79  98 127],18,5,25489,4.040101442383896,20.0,20.0
16309,1,6309,[427 588  79  98 127],716,5,25494,4.040253565768621,20.0,20.0
16310,1,6310,[ 22 318 427 181 174],878,2,25496,4.039930280462684,40.0,0.0
16311,1,6311,[427 588  79  98 127],796,5,25501,4.040082382762991,20.0,20.0
16312,1,6312,[427 588  79  98 127],389,5,25506,4.040234436876287,20.0,20.0
16313,1,6313,[  8 181  64 483  69],457,5,25511,4.040386442825467,20.0,0.0
16314,1,6314,[427 588  79  98 127],796,5,25516,4.040538400633412,20.0,20.0
16315,1,6315,[427 588  79  98 127],18,5,25521,4.040690310322989,20.0,20.0
16316,1,6316,[ 82 216 403  56 483],280,3,25524,4.040525565933196,0.0,0.0
16317,1,6317,[427 588  79  98 127],389,5,25529,4.040677429566318,20.0,20.0
16318,1,6318,[427 588  79  98 127],389,5,25534,4.0408292451337235,20.0,20.0
16319,1,6319,[568 257   1 655 181],457,4,25538,4.040822784810127,0.0,0.0
16320,1,6320,[427 588  79  98 127],450,5,25543,4.040974529346622,20.0,20.0
16321,1,6321,[427 588  79  98 127],796,5,25548,4.041126225877886,20.0,20.0
16322,1,6322,[151 288  71 161 125],504,5,25553,4.041277874426696,0.0,0.0
16323,1,6323,[215 168  22 200 127],716,5,25558,4.041429475015812,0.0,20.0
16324,1,6324,[427 588  79  98 127],796,5,25563,4.041581027667984,20.0,20.0
16325,1,6325,[202 222  70 288  98],264,5,25568,4.041732532405944,0.0,0.0
16326,1,6326,[427 588  79  98 127],796,5,25573,4.04188398925241,20.0,20.0
16327,1,6327,[427 588  79  98 127],18,5,25578,4.042035398230088,20.0,20.0
16328,1,6328,[210 515  64 294  11],401,2,25580,4.0417127508295145,20.0,0.0
16329,1,6329,[127 211 276  64  11],269,4,25584,4.041706161137441,20.0,20.0
16330,1,6330,[ 12 195 151 228 322],450,5,25589,4.0418575264571155,0.0,0.0
16331,1,6331,[427 588  79  98 127],450,5,25594,4.042008843967151,20.0,20.0
16332,1,6332,[568  97 202 265 275],655,1,25595,4.041528501500079,0.0,20.0
16333,1,6333,[ 95 180 185 357 748],450,4,25599,4.041521945058415,0.0,0.0
16334,1,6334,[245 180 161 181 655],450,5,25604,4.041673243883189,0.0,0.0
16335,1,6335,[100 135  82 385 405],151,1,25605,4.041193181818182,0.0,20.0
16336,1,6336,[427 588  79  98 127],450,5,25610,4.041344484771974,20.0,20.0
16337,1,6337,[173 405  88 215  69],716,5,25615,4.041495739981067,0.0,0.0
16338,1,6338,[427 588  79  98 127],450,5,25620,4.041646947468055,20.0,20.0
16339,1,6339,[135  22 151 318 180],535,3,25623,4.041482649842271,20.0,0.0
16340,1,6340,[427 588  79  98 127],716,5,25628,4.041633811701624,20.0,20.0
16341,1,6341,[ 22 427 151 173 144],807,4,25632,4.04162724692526,20.0,0.0
16342,1,6342,[288 318  25 742 185],457,5,25637,4.041778338325713,20.0,0.0
16343,1,6343,[427 588  79  98 127],796,5,25642,4.041929382093317,20.0,20.0
16344,1,6344,[496  69  28  64 655],577,5,25647,4.042080378250591,40.0,0.0
16345,1,6345,[ 88 180 215 471 183],457,5,25652,4.042231326820044,0.0,0.0
16346,1,6346,[427  71  69 151 117],236,2,25654,4.041909563573341,20.0,0.0
16347,1,6347,[427 588  79  98 127],716,5,25659,4.042060491493384,20.0,20.0
16348,1,6348,[211 204 405 423 197],269,3,25662,4.041896361631753,0.0,0.0
16349,1,6349,[172  12 181  22 191],796,5,25667,4.042047244094488,0.0,0.0
16350,1,6350,[427 588  79  98 127],796,5,25672,4.04219807904267,20.0,20.0
16351,1,6351,[172 423  28 496 275],796,4,25676,4.042191435768262,20.0,20.0
16352,1,6352,[282 151 257  98 121],796,5,25681,4.04234220053518,0.0,0.0
16353,1,6353,[427 588  79  98 127],716,5,25686,4.042492917847025,20.0,20.0
16354,1,6354,[427 588  79  98 127],18,5,25691,4.0426435877262,20.0,20.0
16355,1,6355,[427 588  79  98 127],18,5,25696,4.042794210195091,20.0,20.0
16356,1,6356,[211 132 318 151 186],151,5,25701,4.042944785276074,20.0,0.0
16357,1,6357,[427 588  79  98 127],389,5,25706,4.043095312991507,20.0,20.0
16358,1,6358,[405  96  22 318 273],796,4,25710,4.043088535933323,20.0,0.0
16359,1,6359,[ 79   9   4  25 258],535,3,25713,4.042924528301887,0.0,0.0
16360,1,6360,[427 588  79  98 127],796,5,25718,4.043074988209401,20.0,20.0
16361,1,6361,[427 588  79  98 127],450,5,25723,4.043225400817353,20.0,20.0
16362,1,6362,[427 588  79  98 127],18,5,25728,4.043375766148043,20.0,20.0
16363,1,6363,[427 588  79  98 127],796,5,25733,4.043526084223759,20.0,20.0
16364,1,6364,[427 588  79  98 127],450,5,25738,4.043676355066771,20.0,20.0
16365,1,6365,[300 269 187  64  56],450,5,25743,4.04382657869934,20.0,0.0
16366,1,6366,[ 56 216 200 282 211],716,4,25747,4.0438196953039105,0.0,0.0
16367,1,6367,[197 471 294  64 302],401,2,25749,4.043498743718593,20.0,0.0
16368,1,6368,[427 588  79  98 127],796,5,25754,4.04364892447794,20.0,20.0
16369,1,6369,[427 588  79  98 127],796,5,25759,4.0437990580847725,20.0,20.0
16370,1,6370,[427 588  79  98 127],796,5,25764,4.043949144561293,20.0,20.0
16371,1,6371,[183 179 357 185 302],450,5,25769,4.044099183929692,0.0,0.0
16372,1,6372,[427 588  79  98 127],389,5,25774,4.044249176212145,20.0,20.0
16373,1,6373,[427 588  79  98 127],716,5,25779,4.044399121430812,20.0,20.0
16374,1,6374,[172  70 186 181   1],885,3,25782,4.044235294117647,0.0,0.0
16375,1,6375,[  1 161 173 265  71],796,4,25786,4.044228356336261,0.0,0.0
16376,1,6376,[427 588  79  98 127],450,5,25791,4.044378234279442,20.0,20.0
16377,1,6377,[427 588  79  98 127],450,5,25796,4.044528065224208,20.0,20.0
16378,1,6378,[427 588  79  98 127],716,5,25801,4.044677849192664,20.0,20.0
16379,1,6379,[427 588  79  98 127],716,5,25806,4.044827586206897,20.0,20.0
16380,1,6380,[135 313   4 328  89],450,3,25809,4.044663845792195,0.0,0.0
16381,1,6381,[294 181  88 403 132],450,5,25814,4.0448135380758385,0.0,0.0
16382,1,6382,[427 588  79  98 127],18,5,25819,4.044963183456055,20.0,20.0
16383,1,6383,[483 196 238 100  79],23,4,25823,4.044956140350878,0.0,20.0
16384,1,6384,[427 588  79  98 127],389,5,25828,4.045105716523101,20.0,20.0
16385,1,6385,[  4 405 195 742 191],344,3,25831,4.044942060757908,0.0,0.0
16386,1,6386,[118 174  88 176  97],457,5,25836,4.045091592296853,0.0,0.0
16387,1,6387,[427 588  79  98 127],450,5,25841,4.045241077019411,20.0,20.0
16388,1,6388,[257 181   7 597  71],23,2,25843,4.044920957896385,0.0,0.0
16389,1,6389,[ 79 204 191 118 194],450,4,25847,4.0449139280125195,0.0,0.0
16390,1,6390,[228 183 181 186 111],151,4,25851,4.044906900328587,0.0,0.0
16391,1,6391,[ 89 186 143 483 603],450,3,25854,4.0447434292866085,20.0,0.0
16392,1,6392,[423 210  89 294 273],450,3,25857,4.044580009385265,0.0,0.0
16393,1,6393,[234 271  98 182 289],655,2,25859,4.04426024397873,0.0,0.0
16394,1,6394,[294   8 100 237 186],577,5,25864,4.044409695074277,0.0,20.0
16395,1,6395,[427 588  79  98 127],450,5,25869,4.044559099437148,20.0,20.0
16396,1,6396,[ 28 195  56  71  12],796,4,25873,4.044552133812725,0.0,0.0
16397,1,6397,[ 96 144 174  70 197],280,2,25875,4.044232572678962,0.0,0.0
16398,1,6398,[215   7 117 385  15],655,0,25875,4.043600562587905,0.0,0.0
16399,1,6399,[118  95 546 196 286],344,2,25877,4.04328125,0.0,20.0
16400,1,6400,[427 588  79  98 127],389,5,25882,4.043430713950945,20.0,20.0
16401,1,6401,[427 588  79  98 127],389,5,25887,4.043580131208997,20.0,20.0
16402,1,6402,[588 196 222 161 483],450,3,25890,4.043417148211776,0.0,0.0
16403,1,6403,[427 588  79  98 127],389,5,25895,4.043566520924422,20.0,20.0
16404,1,6404,[144 195 238 276 508],655,1,25896,4.043091334894614,0.0,0.0
16405,1,6405,[427 588  79  98 127],450,5,25901,4.043240711832657,20.0,20.0
16406,1,6406,[118 127 151 161 181],457,5,25906,4.043390042141408,0.0,20.0
16407,1,6407,[427 588  79  98 127],716,5,25911,4.043539325842697,20.0,20.0
16408,1,6408,[ 79 282 143 173  22],796,5,25916,4.04368856295834,0.0,0.0
16409,1,6409,[427 588  79  98 127],716,5,25921,4.04383775351014,20.0,20.0
16410,1,6410,[  8  71  79 245 748],280,3,25924,4.04367493370769,0.0,0.0
16411,1,6411,[427 588  79  98 127],450,5,25929,4.043824079850281,20.0,20.0
16412,1,6412,[427 588  79  98 127],18,5,25934,4.043973179479183,20.0,20.0
16413,1,6413,[176 111 143 237  12],655,1,25935,4.0434985968194574,0.0,0.0
16414,1,6414,[427 588  79  98 127],389,5,25940,4.043647700701481,20.0,20.0
16415,1,6415,[257   1 273  97  22],655,1,25941,4.04317331670823,0.0,0.0
16416,1,6416,[427 588  79  98 127],389,5,25946,4.043322424809101,20.0,20.0
16417,1,6417,[427 588  79  98 127],796,5,25951,4.043471486444375,20.0,20.0
16418,1,6418,[216 179 202 196 210],457,5,25956,4.043620501635769,0.0,0.0
16419,1,6419,[187  88  71 204  15],18,3,25959,4.043457943925234,0.0,0.0
16420,1,6420,[427 588  79  98 127],450,5,25964,4.043606914810777,20.0,20.0
16421,1,6421,[186 153 151 191   7],269,2,25966,4.043288695110557,0.0,0.0
16422,1,6422,[427 588  79  98 127],389,5,25971,4.043437645959832,20.0,20.0
16423,1,6423,[153 132 215 405 273],655,1,25972,4.042963885429639,0.0,0.0
16424,1,6424,[302 300  64   7 265],655,2,25974,4.042645914396887,20.0,0.0
16425,1,6425,[515 183  69  15 276],269,2,25976,4.042328042328043,0.0,0.0
16426,1,6426,[300 200 423 294 471],450,4,25980,4.042321456355998,0.0,0.0
16427,1,6427,[427 588  79  98 127],716,5,25985,4.04247044181705,20.0,20.0
16428,1,6428,[  1 100 183 405 144],655,1,25986,4.041997200186654,0.0,20.0
16429,1,6429,[204 318  82 186 202],504,2,25988,4.041679626749612,20.0,0.0
16430,1,6430,[427 588  79  98 127],389,5,25993,4.0418286425128285,20.0,20.0
16431,1,6431,[  9 302  98 172 423],269,3,25996,4.041666666666667,0.0,0.0
16432,1,6432,[121 269 118 588 313],796,4,26000,4.041660189647132,0.0,0.0
16433,1,6433,[ 12 200 245 195 196],629,4,26004,4.04165371464097,0.0,0.0
16434,1,6434,[ 56 151 168 200 234],269,4,26008,4.041647241647242,0.0,0.0
16435,1,6435,[427 588  79  98 127],389,5,26013,4.041796146674954,20.0,20.0
16436,1,6436,[427 588  79  98 127],716,5,26018,4.041945005437316,20.0,20.0
16437,1,6437,[121 176 187  97 357],796,4,26022,4.041938490214353,0.0,0.0
16438,1,6438,[748 118 127 322 173],796,4,26026,4.041931977015064,0.0,20.0
16439,1,6439,[427 588  79  98 127],18,5,26031,4.0420807453416145,20.0,20.0
16440,1,6440,[427 588  79  98 127],389,5,26036,4.0422294674739945,20.0,20.0
16441,1,6441,[427 588  79  98 127],389,5,26041,4.042378143433716,20.0,20.0
16442,1,6442,[200   7 174 181  70],269,1,26042,4.041905944435822,0.0,0.0
16443,1,6443,[427 588  79  98 127],389,5,26047,4.042054624456859,20.0,20.0
16444,1,6444,[ 95 655 153  22 196],450,4,26051,4.042048099301784,0.0,0.0
16445,1,6445,[427 588  79  98 127],18,5,26056,4.042196711138691,20.0,20.0
16446,1,6446,[427 588  79  98 127],18,5,26061,4.042345276872964,20.0,20.0
16447,1,6447,[180 742  28 186 144],450,4,26065,4.042338709677419,0.0,0.0
16448,1,6448,[427 588  79  98 127],18,5,26070,4.042487207318964,20.0,20.0
16449,1,6449,[183 282 151   7 475],292,4,26074,4.042480620155039,0.0,0.0
16450,1,6450,[427 588  79  98 127],716,5,26079,4.042629049759727,20.0,20.0
16451,1,6451,[111 276 197  50 294],629,4,26083,4.042622442653441,0.0,20.0
16452,1,6452,[237 269 496 235  88],344,2,26085,4.042305904230591,20.0,0.0
16453,1,6453,[427 588  79  98 127],716,5,26090,4.042454291911993,20.0,20.0
16454,1,6454,[427 588  79  98 127],18,5,26095,4.042602633617351,20.0,20.0
16455,1,6455,[496 269 237 300 132],535,4,26099,4.042596034696406,20.0,0.0
16456,1,6456,[427 588  79  98 127],796,5,26104,4.0427443085024,20.0,20.0
16457,1,6457,[427 588  79  98 127],716,5,26109,4.042892536388975,20.0,20.0
16458,1,6458,[405 161 403 318 183],280,2,26111,4.0425762501935285,20.0,0.0
16459,1,6459,[427 588  79  98 127],450,5,26116,4.042724458204335,20.0,20.0
16460,1,6460,[427 588  79  98 127],18,5,26121,4.042872620337409,20.0,20.0
16461,1,6461,[405 471 234  96 475],655,0,26121,4.042246982358403,0.0,0.0
16462,1,6462,[ 82 195 182  50 245],796,3,26124,4.042085718706483,0.0,20.0
16463,1,6463,[427 588  79  98 127],18,5,26129,4.042233910891089,20.0,20.0
16464,1,6464,[127 161  82 597 288],450,3,26132,4.042072699149266,0.0,20.0
16465,1,6465,[427 588  79  98 127],450,5,26137,4.042220847510053,20.0,20.0
16466,1,6466,[423   8  97  15   1],796,3,26140,4.042059687644967,0.0,0.0
16467,1,6467,[427 588  79  98 127],18,5,26145,4.042207792207792,20.0,20.0
16468,1,6468,[427 588  79  98 127],716,5,26150,4.042355850981605,20.0,20.0
16469,1,6469,[  7  96 748 597 127],450,5,26155,4.042503863987635,0.0,20.0
16470,1,6470,[ 97 597 186 195 286],796,2,26157,4.042188224385721,0.0,20.0
16471,1,6471,[427 588  79  98 127],796,5,26162,4.042336217552534,20.0,20.0
16472,1,6472,[ 98 237 132 301 191],450,5,26167,4.042484164993048,0.0,0.0
16473,1,6473,[180  96 168 568 222],457,5,26172,4.042632066728452,0.0,0.0
16474,1,6474,[427 588  79  98 127],716,5,26177,4.042779922779923,20.0,20.0
16475,1,6475,[111 173   1  70 132],151,5,26182,4.042927733168622,0.0,0.0
16476,1,6476,[427 588  79  98 127],450,5,26187,4.0430754979157015,20.0,20.0
16477,1,6477,[427 588  79  98 127],18,5,26192,4.043223217042297,20.0,20.0
16478,1,6478,[427 588  79  98 127],716,5,26197,4.043370890569532,20.0,20.0
16479,1,6479,[427 588  79  98 127],18,5,26202,4.0435185185185185,20.0,20.0
16480,1,6480,[427 588  79  98 127],450,5,26207,4.043666100910353,20.0,20.0
16481,1,6481,[427 588  79  98 127],389,5,26212,4.043813637766122,20.0,20.0
16482,1,6482,[655 143  96 132  56],796,4,26216,4.043806879531081,0.0,0.0
16483,1,6483,[318 173 301 100 483],535,5,26221,4.043954349167181,20.0,20.0
16484,1,6484,[427 588  79  98 127],796,5,26226,4.044101773323053,20.0,20.0
16485,1,6485,[427 588  79  98 127],450,5,26231,4.044249152019735,20.0,20.0
16486,1,6486,[ 97 185  56 483 748],796,4,26235,4.044242330815477,0.0,0.0
16487,1,6487,[125  25 234 127  28],18,1,26236,4.043773119605425,0.0,20.0
16488,1,6488,[191 245 172  22 546],796,4,26240,4.043766373863461,0.0,0.0
16489,1,6489,[588 195 546 196 187],786,5,26245,4.043913713405239,0.0,0.0
16490,1,6490,[  4 289 210  64 211],655,1,26246,4.043444769681097,20.0,0.0
16491,1,6491,[427 588  79  98 127],450,5,26251,4.043592113370302,20.0,20.0
16492,1,6492,[ 96 191 588 328 132],450,5,26256,4.04373941167411,0.0,0.0
16493,1,6493,[ 88 222  22  95 228],796,5,26261,4.043886664613489,0.0,0.0
16494,1,6494,[427 588  79  98 127],450,5,26266,4.044033872209392,20.0,20.0
16495,1,6495,[427 588  79  98 127],450,5,26271,4.044181034482759,20.0,20.0
16496,1,6496,[ 97 204 323 257 144],796,3,26274,4.044020317069417,0.0,0.0
16497,1,6497,[161 265 121 603  50],450,4,26278,4.044013542628501,20.0,20.0
16498,1,6498,[  7 276  79  25 235],344,4,26282,4.0440067702723494,0.0,0.0
16499,1,6499,[427 588  79  98 127],796,5,26287,4.044153846153846,20.0,20.0
16500,1,6500,[427 588  79  98 127],796,5,26292,4.044300876788187,20.0,20.0
16501,1,6501,[427 588  79  98 127],796,5,26297,4.044447862196248,20.0,20.0
16502,1,6502,[427 588  79  98 127],716,5,26302,4.044594802398893,20.0,20.0
16503,1,6503,[427 588  79  98 127],796,5,26307,4.044741697416974,20.0,20.0
16504,1,6504,[238 117 197 245 153],504,3,26310,4.0445810914681015,0.0,0.0
16505,1,6505,[235  69 385 216   9],457,4,26314,4.044574239163849,0.0,0.0
16506,1,6506,[257 100  22 568 588],330,5,26319,4.044721069617335,0.0,20.0
16507,1,6507,[196 286 427 186 195],450,4,26323,4.044714197910264,20.0,20.0
16508,1,6508,[427 588  79  98 127],389,5,26328,4.044860961745276,20.0,20.0
16509,1,6509,[427 588  79  98 127],716,5,26333,4.045007680491551,20.0,20.0
16510,1,6510,[ 82 258  25 196  22],450,3,26336,4.04484718169252,0.0,0.0
16511,1,6511,[357 588 322   4  95],796,4,26340,4.044840294840295,0.0,0.0
16512,1,6512,[ 95 435 302 275 403],450,4,26344,4.044833410102871,0.0,20.0
16513,1,6513,[179 144 655 546  97],450,5,26349,4.044980042984341,0.0,0.0
16514,1,6514,[427 588  79  98 127],450,5,26354,4.04512663085188,20.0,20.0
16515,1,6515,[181 204 286 121 423],786,4,26358,4.0451197053407,0.0,20.0
16516,1,6516,[176 597 168 200  64],450,4,26362,4.045112781954887,20.0,0.0
16517,1,6517,[135 300   7 483  25],535,3,26365,4.044952439398589,0.0,0.0
16518,1,6518,[357 235  70 161 143],457,4,26369,4.044945543795061,0.0,0.0
16519,1,6519,[427 588  79  98 127],18,5,26374,4.045092024539877,20.0,20.0
16520,1,6520,[427 588  79  98 127],716,5,26379,4.04523846035884,20.0,20.0
16521,1,6521,[195  28 301 125 300],151,4,26383,4.045231524072371,0.0,0.0
16522,1,6522,[200  89  71  88  69],796,5,26388,4.0453778936072355,0.0,0.0
16523,1,6523,[427 588  79  98 127],450,5,26393,4.045524218270999,20.0,20.0
16524,1,6524,[  4 210 135 161 200],457,5,26398,4.0456704980842915,0.0,0.0
16525,1,6525,[427 588  79  98 127],389,5,26403,4.0458167330677295,20.0,20.0
16526,1,6526,[176 125 100 245 588],344,3,26406,4.045656503753639,0.0,20.0
16527,1,6527,[475 302 222 191 216],655,3,26409,4.045496323529412,0.0,0.0
16528,1,6528,[427 748  95 196 313],796,5,26414,4.04564251799663,20.0,0.0
16529,1,6529,[ 15 318 435 483 210],236,4,26418,4.045635528330781,20.0,0.0
16530,1,6530,[204  50  89 234  98],457,5,26423,4.045781656714133,0.0,20.0
16531,1,6531,[427 588  79  98 127],716,5,26428,4.045927740355174,20.0,20.0
16532,1,6532,[427 588  79  98 127],716,5,26433,4.046073779274453,20.0,20.0
16533,1,6533,[427 588  79  98 127],796,5,26438,4.046219773492501,20.0,20.0
16534,1,6534,[258 202  28 742 127],457,5,26443,4.046365723029839,0.0,20.0
16535,1,6535,[ 71  95 294 111 496],280,4,26447,4.0463586291309666,20.0,0.0
16536,1,6536,[568 357 265 211  22],450,5,26452,4.046504512773444,0.0,0.0
16537,1,6537,[427 588  79  98 127],389,5,26457,4.0466503517895385,20.0,20.0
16538,1,6538,[427 588  79  98 127],796,5,26462,4.046796146199725,20.0,20.0
16539,1,6539,[427 588  79  98 127],796,5,26467,4.046941896024465,20.0,20.0
16540,1,6540,[427 588  79  98 127],450,5,26472,4.047087601284208,20.0,20.0
16541,1,6541,[427  69   8 173   1],796,4,26476,4.047080403546316,20.0,0.0
16542,1,6542,[216 301 176  79 202],344,5,26481,4.047226043099496,0.0,0.0
16543,1,6543,[180 222 483 132 228],280,3,26484,4.047066014669927,0.0,0.0
16544,1,6544,[427 588  79  98 127],796,5,26489,4.047211611917494,20.0,20.0
16545,1,6545,[183 471 174 187  70],655,2,26491,4.04689886953865,0.0,0.0
16546,1,6546,[427 588  79  98 127],389,5,26496,4.047044447838704,20.0,20.0
16547,1,6547,[427 588  79  98 127],18,5,26501,4.047189981673793,20.0,20.0
16548,1,6548,[318 195 678 742 173],280,2,26503,4.046877385860436,20.0,0.0
16549,1,6549,[172  89 328 121 174],151,4,26507,4.0468702290076335,0.0,0.0
16550,1,6550,[427 588  79  98 127],796,5,26512,4.047015722790413,20.0,20.0
16551,1,6551,[427 588  79  98 127],389,5,26517,4.047161172161172,20.0,20.0
16552,1,6552,[161 181 121 318 135],807,5,26522,4.047306577140241,20.0,0.0
16553,1,6553,[496  69 173  89 385],344,3,26525,4.047146780592005,20.0,0.0
16554,1,6554,[427 588  79  98 127],796,5,26530,4.047292143401983,20.0,20.0
16555,1,6555,[427 588  79  98 127],389,5,26535,4.047437461866992,20.0,20.0
16556,1,6556,[196 204 168  64 183],450,5,26540,4.04758273600732,20.0,0.0
16557,1,6557,[194  97 237 168 132],457,5,26545,4.047727965843245,0.0,0.0
16558,1,6558,[143  70 216 172 100],457,5,26550,4.04787315139503,0.0,20.0
16559,1,6559,[427 588  79  98 127],389,5,26555,4.048018292682927,20.0,20.0
16560,1,6560,[ 95  56 237 568 222],450,3,26558,4.047858558146624,0.0,0.0
16561,1,6561,[181 655 546  50  70],457,4,26562,4.0478512648582745,0.0,20.0
16562,1,6562,[427 588  79  98 127],450,5,26567,4.047996343135761,20.0,20.0
16563,1,6563,[135 403  95 161 245],280,3,26570,4.047836684948202,0.0,0.0
16564,1,6564,[427 588  79  98 127],18,5,26575,4.047981721249048,20.0,20.0
16565,1,6565,[204  64  25 515 655],535,4,26579,4.047974413646055,20.0,0.0
16566,1,6566,[  4 191 187 288  56],450,3,26582,4.04781483173443,0.0,0.0
16567,1,6567,[427 588  79  98 127],716,5,26587,4.047959805115712,20.0,20.0
16568,1,6568,[405 275 151  50 678],344,3,26590,4.0478002740143095,0.0,40.0
16569,1,6569,[186  22  25 215 603],716,4,26594,4.04779299847793,20.0,0.0
16570,1,6570,[273 153 210 275 100],655,2,26596,4.047481357479835,0.0,40.0
16571,1,6571,[ 95 111   1   4 603],796,4,26600,4.047474132684115,20.0,0.0
16572,1,6572,[191 200 435 258 144],655,2,26602,4.04716263502206,0.0,0.0
16573,1,6573,[191 187 176 186   9],796,3,26605,4.047003346516581,0.0,0.0
16574,1,6574,[118 313 237 300 187],655,2,26607,4.046692015209126,0.0,0.0
16575,1,6575,[427 588  79  98 127],389,5,26612,4.04683698296837,20.0,20.0
16576,1,6576,[333   4 286 268 289],655,0,26612,4.046221681617759,0.0,20.0
16577,1,6577,[ 28 197 196 183  82],504,4,26616,4.046214654910307,0.0,0.0
16578,1,6578,[427 588  79  98 127],389,5,26621,4.046359629122967,20.0,20.0
16579,1,6579,[286 313 237  28  88],236,4,26625,4.046352583586626,0.0,20.0
16580,1,6580,[144  25   1  70  12],450,4,26629,4.04634554019146,0.0,0.0
16581,1,6581,[427 588  79  98 127],450,5,26634,4.046490428441203,20.0,20.0
16582,1,6582,[153 121  69  79 235],450,3,26637,4.046331459820751,0.0,0.0
16583,1,6583,[427 588  79  98 127],796,5,26642,4.0464763061968405,20.0,20.0
16584,1,6584,[100 313 181 172 357],450,5,26647,4.046621108580107,0.0,20.0
16585,1,6585,[181 153 216 168   4],450,4,26651,4.046614029760097,0.0,0.0
16586,1,6586,[748 655 172 228 196],450,5,26656,4.046758767268863,0.0,0.0
16587,1,6587,[427 588  79  98 127],18,5,26661,4.046903460837887,20.0,20.0
16588,1,6588,[427 588  79  98 127],18,5,26666,4.047048110487175,20.0,20.0
16589,1,6589,[427 588  79  98 127],18,5,26671,4.047192716236722,20.0,20.0
16590,1,6590,[427 588  79  98 127],389,5,26676,4.047337278106509,20.0,20.0
16591,1,6591,[427 588  79  98 127],450,5,26681,4.047481796116505,20.0,20.0
16592,1,6592,[423 100 195 111 294],796,3,26684,4.047322918246625,0.0,20.0
16593,1,6593,[385 269 301 100   9],796,1,26685,4.046860782529572,0.0,20.0
16594,1,6594,[333  22 423 357 175],655,1,26686,4.046398786959818,0.0,0.0
16595,1,6595,[427 588  79  98 127],389,5,26691,4.046543359611886,20.0,20.0
16596,1,6596,[427 588  79  98 127],796,5,26696,4.046687888434136,20.0,20.0
16597,1,6597,[144 286 173 127 182],280,2,26698,4.046377690209154,0.0,40.0
16598,1,6598,[742  71 318 185 222],450,3,26701,4.046219124109713,20.0,0.0
16599,1,6599,[143 168 181 210 546],807,5,26706,4.046363636363636,0.0,0.0
16600,1,6600,[258 183 323 172  79],942,3,26709,4.046205120436298,0.0,0.0
16601,1,6601,[603 153 275 176 174],23,4,26713,4.046198121781279,20.0,20.0
16602,1,6602,[427 588  79  98 127],18,5,26718,4.046342571558383,20.0,20.0
16603,1,6603,[238 172 282 121 302],450,4,26722,4.04633555420957,0.0,0.0
16604,1,6604,[100   8 195 546 161],280,3,26725,4.046177138531416,0.0,20.0
16605,1,6605,[427 588  79  98 127],796,5,26730,4.046321525885559,20.0,20.0
16606,1,6606,[175  88  56 216 204],11,1,26731,4.045860451036779,0.0,0.0
16607,1,6607,[427 588  79  98 127],18,5,26736,4.046004842615012,20.0,20.0
16608,1,6608,[427 588  79  98 127],389,5,26741,4.046149190497806,20.0,20.0
16609,1,6609,[ 88 228  28 132 289],693,1,26742,4.045688350983358,0.0,0.0
16610,1,6610,[ 88 187 211 111 174],450,5,26747,4.04583270307064,0.0,0.0
16611,1,6611,[427 588  79  98 127],389,5,26752,4.045977011494253,20.0,20.0
16612,1,6612,[427 588  79  98 127],18,5,26757,4.046121276274006,20.0,20.0
16613,1,6613,[427 588  79  98 127],450,5,26762,4.046265497429695,20.0,20.0
16614,1,6614,[179  22  89 237  28],450,5,26767,4.046409674981104,0.0,0.0
16615,1,6615,[ 97 176 117 200 195],796,4,26771,4.046402660217654,0.0,0.0
16616,1,6616,[427 588  79  98 127],450,5,26776,4.046546773462294,20.0,20.0
16617,1,6617,[ 64 483 125 176 328],151,3,26779,4.046388637050469,20.0,0.0
16618,1,6618,[318  96 288 423  50],693,2,26781,4.046079468197613,20.0,20.0
16619,1,6619,[237 143 238  69 194],450,5,26786,4.0462235649546825,0.0,0.0
16620,1,6620,[245 286 275  95  96],450,4,26790,4.046216583597644,0.0,40.0
16621,1,6621,[204 143 151 313 135],450,4,26794,4.046209604349139,0.0,0.0
16622,1,6622,[427 588  79  98 127],18,5,26799,4.0463536161860185,20.0,20.0
16623,1,6623,[302 216  11 742 222],450,4,26803,4.046346618357488,0.0,0.0
16624,1,6624,[186 185 135 385 237],457,5,26808,4.046490566037736,0.0,0.0
16625,1,6625,[427 588  79  98 127],450,5,26813,4.046634470268638,20.0,20.0
16626,1,6626,[174 257 191 258  89],796,5,26818,4.0467783310698655,0.0,0.0
16627,1,6627,[427 588  79  98 127],450,5,26823,4.046922148461074,20.0,20.0
16628,1,6628,[288 216 191 302 195],655,3,26826,4.046764217830744,0.0,0.0
16629,1,6629,[427 588  79  98 127],716,5,26831,4.046907993966817,20.0,20.0
16630,1,6630,[237  25  97   1 210],65,4,26835,4.046900919921581,0.0,0.0
16631,1,6631,[118 172 294 385 204],796,4,26839,4.04689384800965,0.0,0.0
16632,1,6632,[194 288 568  56  11],450,4,26843,4.0468867782300615,0.0,0.0
16633,1,6633,[174 144 515 183  98],292,5,26848,4.047030449201086,0.0,0.0
16634,1,6634,[427 588  79  98 127],18,5,26853,4.047174076865109,20.0,20.0
16635,1,6635,[427 588  79  98 127],389,5,26858,4.047317661241712,20.0,20.0
16636,1,6636,[275  25 322 273  69],450,3,26861,4.047159861383155,0.0,20.0
16637,1,6637,[  9 183 153 111   4],151,3,26864,4.0470021090689965,0.0,0.0
16638,1,6638,[202 496 748 197 216],151,4,26868,4.046995029371893,20.0,0.0
16639,1,6639,[174 275 195 318 204],457,5,26873,4.047138554216867,20.0,20.0
16640,1,6640,[301   8   1 197 144],655,0,26873,4.046529137178136,0.0,0.0
16641,1,6641,[427 588  79  98 127],389,5,26878,4.046672688949112,20.0,20.0
16642,1,6642,[268 210 258 135 238],535,3,26881,4.046515128706909,0.0,0.0
16643,1,6643,[268   4  28 210 288],655,0,26881,4.045906080674293,0.0,0.0
16644,1,6644,[427 588  79  98 127],450,5,26886,4.0460496613995485,20.0,20.0
16645,1,6645,[135 288 286  50 300],450,3,26889,4.045892266024676,0.0,40.0
16646,1,6646,[186  71 300 403   1],450,3,26892,4.045734918008124,0.0,0.0
16647,1,6647,[ 11 546 237  88 168],716,4,26896,4.045728038507822,0.0,0.0
16648,1,6648,[168   4   9 405 211],151,4,26900,4.0457211610768535,0.0,0.0
16649,1,6649,[ 98 276 196 204 423],269,3,26903,4.045563909774436,0.0,0.0
16650,1,6650,[196 357 204 173  95],716,5,26908,4.045707412419185,0.0,0.0
16651,1,6651,[121 655 161 568  50],72,3,26911,4.045550210463019,0.0,20.0
16652,1,6652,[265   7 269 202 111],655,0,26911,4.044942131369307,0.0,0.0
16653,1,6653,[269 234 427 182 187],796,3,26914,4.044785091674181,20.0,0.0
16654,1,6654,[427 588  79  98 127],450,5,26919,4.044928625093914,20.0,20.0
16655,1,6655,[427 588  79  98 127],18,5,26924,4.045072115384615,20.0,20.0
16656,1,6656,[427 588  79  98 127],716,5,26929,4.04521556256572,20.0,20.0
16657,1,6657,[204 403 286 742 294],796,2,26931,4.044908380895164,0.0,20.0
16658,1,6658,[427 588  79  98 127],716,5,26936,4.045051809581018,20.0,20.0
16659,1,6659,[427 588  79  98 127],796,5,26941,4.045195195195195,20.0,20.0
16660,1,6660,[245   4 144 132 135],450,3,26944,4.045038282540159,0.0,0.0
16661,1,6661,[ 98 273  89 427 161],796,4,26948,4.045031522065446,20.0,0.0
16662,1,6662,[ 82 196 117  88  25],450,3,26951,4.044874681074591,0.0,0.0
16663,1,6663,[427 588  79  98 127],18,5,26956,4.045018007202881,20.0,20.0
16664,1,6664,[427 588  79  98 127],450,5,26961,4.04516129032258,20.0,20.0
16665,1,6665,[427 588  79  98 127],796,5,26966,4.045304530453046,20.0,20.0
16666,1,6666,[273  25  89  69 483],450,2,26968,4.044997750112494,0.0,0.0
16667,1,6667,[427 588  79  98 127],450,5,26973,4.045140971805639,20.0,20.0
16668,1,6668,[427 588  79  98 127],796,5,26978,4.0452841505473085,20.0,20.0
16669,1,6669,[427 588  79  98 127],389,5,26983,4.045427286356822,20.0,20.0
16670,1,6670,[427 588  79  98 127],450,5,26988,4.045570379253485,20.0,20.0
16671,1,6671,[427 588  79  98 127],450,5,26993,4.045713429256595,20.0,20.0
16672,1,6672,[ 79  25 328 483  64],151,4,26997,4.045706578750187,20.0,0.0
16673,1,6673,[ 95 385 127 100 357],786,5,27002,4.045849565477974,0.0,40.0
16674,1,6674,[144 258 435 173 196],450,5,27007,4.045992509363296,0.0,0.0
16675,1,6675,[125 143 273 234 186],450,2,27009,4.045686039544638,0.0,0.0
16676,1,6676,[427 588  79  98 127],716,5,27014,4.045828965104088,20.0,20.0
16677,1,6677,[196 187 357  15 271],72,4,27018,4.045822102425876,0.0,0.0
16678,1,6678,[427 588  79  98 127],796,5,27023,4.045964964815092,20.0,20.0
16679,1,6679,[186 568 318  69 427],716,4,27027,4.0459580838323355,40.0,0.0
16680,1,6680,[111  98 194 202 496],450,5,27032,4.0461008831013325,20.0,0.0
16681,1,6681,[427 588  79  98 127],18,5,27037,4.0462436396288535,20.0,20.0
16682,1,6682,[427 588  79  98 127],450,5,27042,4.0463863534340865,20.0,20.0
16683,1,6683,[588 211  69 257 435],807,4,27046,4.046379413524836,0.0,0.0
16684,1,6684,[143  64 204 161 423],450,5,27051,4.046522064323112,20.0,0.0
16685,1,6685,[427 588  79  98 127],716,5,27056,4.046664672449896,20.0,20.0
16686,1,6686,[427 588  79  98 127],716,5,27061,4.046807237924331,20.0,20.0
16687,1,6687,[427 588  79  98 127],18,5,27066,4.04694976076555,20.0,20.0
16688,1,6688,[ 56 300 282 195  79],716,3,27069,4.0467932426371656,0.0,0.0
16689,1,6689,[200 588 168 194  88],18,1,27070,4.046337817638266,0.0,0.0
16690,1,6690,[185 357 176 202 235],450,4,27074,4.046330892243312,0.0,0.0
16691,1,6691,[427 588  79  98 127],716,5,27079,4.046473401075912,20.0,20.0
16692,1,6692,[318 385 655 180 144],796,3,27082,4.046317047661736,20.0,0.0
16693,1,6693,[294 127 385 403 496],280,3,27085,4.046160740962056,20.0,20.0
16694,1,6694,[427 588  79  98 127],450,5,27090,4.046303211351755,20.0,20.0
16695,1,6695,[403  69 151 237  15],450,4,27094,4.046296296296297,0.0,0.0
16696,1,6696,[  4 202 183 357 423],716,3,27097,4.046140062714648,0.0,0.0
16697,1,6697,[427 588  79  98 127],450,5,27102,4.046282472379815,20.0,20.0
16698,1,6698,[427 588  79  98 127],716,5,27107,4.046424839528288,20.0,20.0
16699,1,6699,[427 588  79  98 127],389,5,27112,4.046567164179105,20.0,20.0
16700,1,6700,[427 588  79  98 127],716,5,27117,4.046709446351291,20.0,20.0
16701,1,6701,[427 588  79  98 127],18,5,27122,4.046851686063862,20.0,20.0
16702,1,6702,[ 28 118 276 132 186],457,5,27127,4.04699388333582,0.0,0.0
16703,1,6703,[ 64  70 183 204 235],457,4,27131,4.046986873508353,20.0,0.0
16704,1,6704,[216 234 748 245  82],256,5,27136,4.047129008202834,0.0,0.0
16705,1,6705,[ 50 282 121 117 238],716,4,27140,4.047121980316135,0.0,20.0
16706,1,6706,[151  79 196  50  64],151,5,27145,4.047264052482481,20.0,20.0
16707,1,6707,[ 88 172 275 435 125],18,2,27147,4.04695885509839,0.0,20.0
16708,1,6708,[427 588  79  98 127],450,5,27152,4.047100909226412,20.0,20.0
16709,1,6709,[ 64 234 135 202 405],269,2,27154,4.046795827123696,20.0,0.0
16710,1,6710,[265  11 222 405  79],450,4,27158,4.046788854120101,0.0,0.0
16711,1,6711,[427 588  79  98 127],716,5,27163,4.0469308700834326,20.0,20.0
16712,1,6712,[427 588  79  98 127],450,5,27168,4.047072843736035,20.0,20.0
16713,1,6713,[427 588  79  98 127],389,5,27173,4.047214775096813,20.0,20.0
16714,1,6714,[427 588  79  98 127],450,5,27178,4.047356664184661,20.0,20.0
16715,1,6715,[427 588  79  98 127],18,5,27183,4.047498511018463,20.0,20.0
16716,1,6716,[144 427 475   1 282],655,1,27184,4.047044811671877,20.0,0.0
16717,1,6717,[ 71 496 117 265 257],796,5,27189,4.047186662697231,20.0,0.0
16718,1,6718,[427 588  79  98 127],450,5,27194,4.0473284714987345,20.0,20.0
16719,1,6719,[196 210 483 286 143],655,2,27196,4.047023809523809,0.0,20.0
16720,1,6720,[405 174 508 294 191],401,2,27198,4.0467192382086,0.0,0.0
16721,1,6721,[427 588  79  98 127],796,5,27203,4.046861053257959,20.0,20.0
16722,1,6722,[ 28 183 153 196 179],450,5,27208,4.047002826119292,0.0,0.0
16723,1,6723,[427 588  79  98 127],18,5,27213,4.047144556811422,20.0,20.0
16724,1,6724,[144 179 216 175 100],655,2,27215,4.046840148698885,0.0,20.0
16725,1,6725,[100 186 196 197 176],269,2,27217,4.046535831103181,0.0,20.0
16726,1,6726,[ 11 174 143 357 180],269,1,27218,4.046082949308755,0.0,0.0
16727,1,6727,[427 588  79  98 127],796,5,27223,4.046224732461355,20.0,20.0
16728,1,6728,[427 588  79  98 127],796,5,27228,4.046366473473027,20.0,20.0
16729,1,6729,[180 179 172 269 275],450,5,27233,4.0465081723625556,0.0,20.0
16730,1,6730,[427 588  79  98 127],716,5,27238,4.0466498291487145,20.0,20.0
16731,1,6731,[427 588  79  98 127],450,5,27243,4.0467914438502675,20.0,20.0
16732,1,6732,[427 588  79  98 127],716,5,27248,4.046933016485965,20.0,20.0
16733,1,6733,[197 222 568 216  79],693,3,27251,4.046777546777546,0.0,0.0
16734,1,6734,[ 50 168 322 200 180],796,3,27254,4.046622123236823,0.0,20.0
16735,1,6735,[125  98 546 357 118],504,4,27258,4.046615201900238,0.0,0.0
16736,1,6736,[ 64 655 288 196 275],450,4,27262,4.046608282618376,20.0,20.0
16737,1,6737,[333 237 176 318 127],236,3,27265,4.046452953398634,20.0,20.0
16738,1,6738,[234  89 204 211 385],5,4,27269,4.0464460602463275,0.0,0.0
16739,1,6739,[ 82 385 405 496 210],151,2,27271,4.046142433234421,20.0,0.0
16740,1,6740,[427 588  79  98 127],716,5,27276,4.046283934134402,20.0,20.0
16741,1,6741,[125 183 182 237   1],457,5,27281,4.046425393058439,0.0,0.0
16742,1,6742,[127 200 357  25 269],18,3,27284,4.046270206139701,0.0,20.0
16743,1,6743,[427 588  79  98 127],716,5,27289,4.04641162514828,20.0,20.0
16744,1,6744,[427 588  79  98 127],389,5,27294,4.046553002223869,20.0,20.0
16745,1,6745,[427 588  79  98 127],796,5,27299,4.046694337385117,20.0,20.0
16746,1,6746,[ 82 144 195   7 276],655,1,27300,4.046242774566474,0.0,0.0
16747,1,6747,[427 588  79  98 127],716,5,27305,4.0463841138114995,20.0,20.0
16748,1,6748,[135 245 742 748 204],280,2,27307,4.046080900874204,0.0,0.0
16749,1,6749,[427 588  79  98 127],389,5,27312,4.046222222222222,20.0,20.0
16750,1,6750,[200 172 197 427 483],18,3,27315,4.0460672492964,20.0,0.0
16751,1,6751,[427 588  79  98 127],796,5,27320,4.046208530805687,20.0,20.0
16752,1,6752,[427 588  79  98 127],450,5,27325,4.046349770472383,20.0,20.0
16753,1,6753,[427 588  79  98 127],450,5,27330,4.046490968315073,20.0,20.0
16754,1,6754,[427 588  79  98 127],716,5,27335,4.046632124352332,20.0,20.0
16755,1,6755,[427 588  79  98 127],18,5,27340,4.046773238602723,20.0,20.0
16756,1,6756,[508 143 405 603 655],655,2,27342,4.046470327068225,20.0,0.0
16757,1,6757,[234 238 127 111  82],450,3,27345,4.0463154779520565,0.0,20.0
16758,1,6758,[ 69 496 121 196  15],786,3,27348,4.046160674656014,20.0,0.0
16759,1,6759,[427 588  79  98 127],716,5,27353,4.046301775147929,20.0,20.0
16760,1,6760,[288  71 313 117 135],280,4,27357,4.046294926785978,0.0,0.0
16761,1,6761,[742  96 471 127 181],457,5,27362,4.046435965690624,0.0,20.0
16762,1,6762,[427 588  79  98 127],796,5,27367,4.046576962886293,20.0,20.0
16763,1,6763,[427 588  79  98 127],450,5,27372,4.046717918391485,20.0,20.0
16764,1,6764,[211 496  97 271 742],796,2,27374,4.046415373244642,20.0,0.0
16765,1,6765,[427 588  79  98 127],796,5,27379,4.046556310966598,20.0,20.0
16766,1,6766,[161 195 153  28 257],23,2,27381,4.046253879119255,0.0,0.0
16767,1,6767,[186 174 289 515 294],655,1,27382,4.04580378250591,0.0,0.0
16768,1,6768,[204 234 475 100  25],503,3,27385,4.045649283498301,0.0,20.0
16769,1,6769,[222 204   9 328 257],655,0,27385,4.045051698670606,0.0,0.0
16770,1,6770,[200 127 196  28 282],716,4,27389,4.045045045045045,0.0,20.0
16771,1,6771,[132  28 603 111 282],796,4,27393,4.045038393384525,20.0,0.0
16772,1,6772,[144  28  50  11 135],716,3,27396,4.044884098626901,0.0,20.0
16773,1,6773,[195   8 234 322  88],280,2,27398,4.044582226158843,0.0,0.0
16774,1,6774,[427 588  79  98 127],796,5,27403,4.044723247232472,20.0,20.0
16775,1,6775,[288 127 117  64 222],292,3,27406,4.04456906729634,20.0,20.0
16776,1,6776,[195   1 603 196 568],796,4,27410,4.04456249077763,20.0,0.0
16777,1,6777,[427 588  79  98 127],389,5,27415,4.044703452345825,20.0,20.0
16778,1,6778,[183 215 176 318 202],504,2,27417,4.044401829178345,20.0,0.0
16779,1,6779,[427 588  79  98 127],450,5,27422,4.044542772861357,20.0,20.0
16780,1,6780,[186 385 234 427  69],503,4,27426,4.04453620409969,20.0,0.0
16781,1,6781,[197 216 234 176 127],450,4,27430,4.04452963727514,0.0,20.0
16782,1,6782,[427 588  79  98 127],796,5,27435,4.044670499778859,20.0,20.0
16783,1,6783,[ 88 286 288  22 210],280,3,27438,4.044516509433962,0.0,20.0
16784,1,6784,[ 88 200  95 742 186],450,2,27440,4.04421518054532,0.0,0.0
16785,1,6785,[300 174 204  25  98],716,5,27445,4.044356027114648,0.0,0.0
16786,1,6786,[427 588  79  98 127],389,5,27450,4.044496832179166,20.0,20.0
16787,1,6787,[427 588  79  98 127],450,5,27455,4.0446375957572185,20.0,20.0
16788,1,6788,[427 588  79  98 127],18,5,27460,4.044778317867138,20.0,20.0
16789,1,6789,[173 405 300 228 181],807,4,27464,4.044771723122238,0.0,0.0
16790,1,6790,[483 546 186  88 265],151,4,27468,4.044765130319541,0.0,0.0
16791,1,6791,[176 313 588  12  15],796,5,27473,4.044905771495878,0.0,0.0
16792,1,6792,[182  50 471 265  96],457,5,27478,4.045046371264537,0.0,20.0
16793,1,6793,[  4 197 195 174  70],18,3,27481,4.044892552251987,0.0,0.0
16794,1,6794,[194 143 333 282 183],796,5,27486,4.045033112582781,0.0,0.0
16795,1,6795,[357 168 483 301 174],450,4,27490,4.045026486168334,0.0,0.0
16796,1,6796,[ 79  69  15  50 127],450,4,27494,4.045019861703693,0.0,40.0
16797,1,6797,[245 483 471  89 174],450,4,27498,4.0450132391879965,0.0,0.0
16798,1,6798,[245  15 153 282 265],796,4,27502,4.045006618620385,0.0,0.0
16799,1,6799,[427 588  79  98 127],18,5,27507,4.045147058823529,20.0,20.0
16800,1,6800,[427 588  79  98 127],716,5,27512,4.045287457726805,20.0,20.0
16801,1,6801,[427 588  79  98 127],796,5,27517,4.045427815348427,20.0,20.0
16802,1,6802,[427 588  79  98 127],450,5,27522,4.0455681317066,20.0,20.0
16803,1,6803,[288  70 100  25  71],344,3,27525,4.045414462081129,0.0,20.0
16804,1,6804,[125  64 403 234 172],18,1,27526,4.044966936076414,20.0,0.0
16805,1,6805,[427 588  79  98 127],18,5,27531,4.045107258301499,20.0,20.0
16806,1,6806,[ 98  12 313 191  25],655,3,27534,4.044953724107536,0.0,0.0
16807,1,6807,[496 546 174 222 118],807,5,27539,4.045094007050529,20.0,0.0
16808,1,6808,[300 546 173 172  11],450,5,27544,4.045234248788368,0.0,0.0
16809,1,6809,[182 234  22 269 603],655,2,27546,4.044933920704846,20.0,0.0
16810,1,6810,[427 588  79  98 127],450,5,27551,4.04507414476582,20.0,20.0
16811,1,6811,[ 22 435 258 117 403],450,5,27556,4.045214327657075,0.0,0.0
16812,1,6812,[546 173  95 313  82],280,2,27558,4.044914134742404,0.0,0.0
16813,1,6813,[427 588  79  98 127],18,5,27563,4.045054299970649,20.0,20.0
16814,1,6814,[ 71 196 182 186 172],450,3,27566,4.04490095377843,0.0,0.0
16815,1,6815,[427 588  79  98 127],18,5,27571,4.045041079812207,20.0,20.0
16816,1,6816,[237   7 286 318 153],535,4,27575,4.045034472641925,20.0,20.0
16817,1,6817,[427 588  79  98 127],716,5,27580,4.04517453798768,20.0,20.0
16818,1,6818,[ 97 180  12 202 151],450,5,27585,4.045314562252529,0.0,0.0
16819,1,6819,[405  98 322 204 151],796,4,27589,4.045307917888563,0.0,0.0
16820,1,6820,[182  25 313 546 153],503,3,27592,4.045154669403313,0.0,0.0
16821,1,6821,[269 313 318 423  96],655,2,27594,4.044854881266491,20.0,0.0
16822,1,6822,[  4 222  98  69 195],796,5,27599,4.044994870291661,0.0,0.0
16823,1,6823,[111 204 215 471 144],457,4,27603,4.0449882766705745,0.0,0.0
16824,1,6824,[172 238 496 182 276],269,4,27607,4.044981684981685,20.0,0.0
16825,1,6825,[427 588  79  98 127],450,5,27612,4.045121593905655,20.0,20.0
16826,1,6826,[427 588  79  98 127],450,5,27617,4.045261461842683,20.0,20.0
16827,1,6827,[238  56 568 210 597],450,4,27621,4.045254833040421,0.0,0.0
16828,1,6828,[300 153 100 328 197],655,0,27621,4.044662468882706,0.0,20.0
16829,1,6829,[ 89 588  64 100  97],796,3,27624,4.044509516837482,20.0,20.0
16830,1,6830,[ 82 228 204 323 132],23,2,27626,4.044210218123261,0.0,0.0
16831,1,6831,[427 588  79  98 127],716,5,27631,4.044350117096019,20.0,20.0
16832,1,6832,[427 588  79  98 127],450,5,27636,4.0444899751207375,20.0,20.0
16833,1,6833,[427 588  79  98 127],18,5,27641,4.044629792215393,20.0,20.0
16834,1,6834,[423 273 546 216  25],450,3,27644,4.044476956839795,0.0,0.0
16835,1,6835,[ 71 183  15 282 483],236,3,27647,4.044324166179052,0.0,0.0
16836,1,6836,[427 588  79  98 127],796,5,27652,4.044463946175223,20.0,20.0
16837,1,6837,[427 588  79  98 127],450,5,27657,4.044603685288096,20.0,20.0
16838,1,6838,[427 588  79  98 127],716,5,27662,4.044743383535605,20.0,20.0
16839,1,6839,[427 588  79  98 127],389,5,27667,4.044883040935672,20.0,20.0
16840,1,6840,[427 588  79  98 127],716,5,27672,4.0450226575062125,20.0,20.0
16841,1,6841,[427 588  79  98 127],389,5,27677,4.045162233265128,20.0,20.0
16842,1,6842,[427 588  79  98 127],389,5,27682,4.045301768230308,20.0,20.0
16843,1,6843,[427 588  79  98 127],450,5,27687,4.045441262419637,20.0,20.0
16844,1,6844,[427 588  79  98 127],716,5,27692,4.045580715850986,20.0,20.0
16845,1,6845,[427 588  79  98 127],716,5,27697,4.045720128542214,20.0,20.0
16846,1,6846,[211 273 300 210  64],450,3,27700,4.045567401781803,20.0,0.0
16847,1,6847,[427 588  79  98 127],716,5,27705,4.045706775700935,20.0,20.0
16848,1,6848,[423 100 200 143 183],450,4,27709,4.045700102204702,0.0,20.0
16849,1,6849,[215 508 323 172   7],280,1,27710,4.045255474452555,0.0,0.0
16850,1,6850,[427 588  79  98 127],796,5,27715,4.045394832871113,20.0,20.0
16851,1,6851,[135  64 215 144 183],655,3,27718,4.045242265032107,20.0,0.0
16852,1,6852,[ 22  82 265 318 216],457,5,27723,4.045381584707427,20.0,0.0
16853,1,6853,[174 288 183 121 333],693,1,27724,4.0449372629121685,0.0,0.0
16854,1,6854,[197 655 186 204 405],655,0,27724,4.044347191830781,0.0,0.0
16855,1,6855,[117 211   1 483 257],655,1,27725,4.043903150525088,0.0,0.0
16856,1,6856,[328 216 289 200  98],236,4,27729,4.043896747848914,0.0,0.0
16857,1,6857,[427 588  79  98 127],389,5,27734,4.044036162146399,20.0,20.0
16858,1,6858,[427 588  79  98 127],796,5,27739,4.044175535792389,20.0,20.0
16859,1,6859,[100 234 202 204 423],504,2,27741,4.043877551020408,0.0,20.0
16860,1,6860,[427 588  79  98 127],18,5,27746,4.044016907156391,20.0,20.0
16861,1,6861,[427 588  79  98 127],450,5,27751,4.044156222675605,20.0,20.0
16862,1,6862,[427 588  79  98 127],18,5,27756,4.044295497595804,20.0,20.0
16863,1,6863,[174   9 125 210 197],786,4,27760,4.0442890442890445,0.0,0.0
16864,1,6864,[427 588  79  98 127],450,5,27765,4.044428259286234,20.0,20.0
16865,1,6865,[427 588  79  98 127],716,5,27770,4.04456743373143,20.0,20.0
16866,1,6866,[228 275 121 273 678],344,3,27773,4.044415319644678,0.0,20.0
16867,1,6867,[ 25   8 568 210 186],655,0,27773,4.043826441467676,0.0,0.0
16868,1,6868,[197 742 210 191  56],450,4,27777,4.043820061144271,0.0,0.0
16869,1,6869,[185 187  69 197 196],693,1,27778,4.043377001455604,0.0,0.0
16870,1,6870,[ 95 245 144 427 273],450,3,27781,4.043225149177704,20.0,0.0
16871,1,6871,[ 79 197 238 194  88],457,5,27786,4.043364377182771,0.0,0.0
16872,1,6872,[405 132  82 483 318],807,5,27791,4.04350356467336,20.0,0.0
16873,1,6873,[121 204 405  25 496],344,3,27794,4.043351760256037,20.0,0.0
16874,1,6874,[515 127 185 483 172],316,2,27796,4.043054545454545,0.0,20.0
16875,1,6875,[118   8 471 385   4],655,0,27796,4.042466550319953,0.0,0.0
16876,1,6876,[427 588  79  98 127],796,5,27801,4.042605787407299,20.0,20.0
16877,1,6877,[173  69 215 403  22],450,5,27806,4.042744984006979,0.0,0.0
16878,1,6878,[748 423  82 328 180],450,4,27810,4.042738770170083,0.0,0.0
16879,1,6879,[655 235  28 471  95],450,3,27813,4.042587209302326,0.0,0.0
16880,1,6880,[427 588  79  98 127],796,5,27818,4.042726347914547,20.0,20.0
16881,1,6881,[655 427 215  12 197],639,1,27819,4.042284219703575,20.0,0.0
16882,1,6882,[427 588  79  98 127],796,5,27824,4.042423361906145,20.0,20.0
16883,1,6883,[427 588  79  98 127],796,5,27829,4.042562463683905,20.0,20.0
16884,1,6884,[ 56  25 588 597 235],450,3,27832,4.04241103848947,0.0,0.0
16885,1,6885,[427 588  79  98 127],716,5,27837,4.042550101655533,20.0,20.0
16886,1,6886,[427 588  79  98 127],796,5,27842,4.042689124437346,20.0,20.0
16887,1,6887,[427 588  79  98 127],796,5,27847,4.042828106852497,20.0,20.0
16888,1,6888,[328 175 515 357 181],655,2,27849,4.042531572071418,0.0,0.0
16889,1,6889,[427 588  79  98 127],450,5,27854,4.042670537010159,20.0,20.0
16890,1,6890,[174 228 427 435 357],151,5,27859,4.042809461616601,20.0,0.0
16891,1,6891,[427 588  79  98 127],716,5,27864,4.042948345908299,20.0,20.0
16892,1,6892,[427 588  79  98 127],450,5,27869,4.0430871899028,20.0,20.0
16893,1,6893,[427 588  79  98 127],716,5,27874,4.0432259936176385,20.0,20.0
16894,1,6894,[427 588  79  98 127],18,5,27879,4.043364757070341,20.0,20.0
16895,1,6895,[300 423 173 118 161],796,5,27884,4.043503480278423,0.0,0.0
16896,1,6896,[427 588  79  98 127],716,5,27889,4.043642163259388,20.0,20.0
16897,1,6897,[427 588  79  98 127],450,5,27894,4.043780806030734,20.0,20.0
16898,1,6898,[216  71 210 200 678],280,3,27897,4.0436295115234095,0.0,0.0
16899,1,6899,[427 588  79  98 127],796,5,27902,4.043768115942029,20.0,20.0
16900,1,6900,[427 588  79  98 127],18,5,27907,4.043906680191276,20.0,20.0
16901,1,6901,[269 151 204  89  82],18,1,27908,4.04346566212692,0.0,0.0
16902,1,6902,[  9 471 172 385 210],655,1,27909,4.043024771838331,0.0,0.0
16903,1,6903,[ 82  64  97 357 100],72,4,27913,4.043018539976825,20.0,20.0
16904,1,6904,[265  98 471 496 238],450,5,27918,4.043157132512672,20.0,0.0
16905,1,6905,[185 100 210 282 174],401,4,27922,4.043150883289893,0.0,20.0
16906,1,6906,[427 588  79  98 127],796,5,27927,4.043289416533951,20.0,20.0
16907,1,6907,[427 588  79  98 127],450,5,27932,4.043427909669948,20.0,20.0
16908,1,6908,[275 197 135   4 238],707,3,27935,4.043276885222174,0.0,20.0
16909,1,6909,[ 70 173 302 603 100],151,3,27938,4.043125904486252,20.0,20.0
16910,1,6910,[ 64 257 125 475 318],655,2,27940,4.042830270583129,40.0,0.0
16911,1,6911,[181 483 179 211  82],269,3,27943,4.042679398148148,0.0,0.0
16912,1,6912,[385 423  98 195   1],450,5,27948,4.042817879357732,0.0,0.0
16913,1,6913,[117  82  69   8 216],796,4,27952,4.042811686433324,0.0,0.0
16914,1,6914,[357 118 245 200  96],504,4,27956,4.0428054953000725,0.0,0.0
16915,1,6915,[427 588  79  98 127],18,5,27961,4.0429438982070565,20.0,20.0
16916,1,6916,[427 588  79  98 127],18,5,27966,4.043082261095851,20.0,20.0
16917,1,6917,[172  79   4 313   1],796,4,27970,4.043076033535704,0.0,0.0
16918,1,6918,[288 153 194 111 222],450,3,27973,4.042925278219396,0.0,0.0
16919,1,6919,[427 588  79  98 127],796,5,27978,4.043063583815029,20.0,20.0
16920,1,6920,[ 25 186 132 125 175],151,5,27983,4.043201849443722,0.0,0.0
16921,1,6921,[597 318 181  89 282],450,5,27988,4.043340075122797,20.0,0.0
16922,1,6922,[121  97 111 185 294],457,3,27991,4.043189368770764,0.0,0.0
16923,1,6923,[427 588  79  98 127],796,5,27996,4.043327556325823,20.0,20.0
16924,1,6924,[546  25 197 568 173],450,4,28000,4.043321299638989,0.0,0.0
16925,1,6925,[427 588  79  98 127],389,5,28005,4.043459428241409,20.0,20.0
16926,1,6926,[257 234 196  69 174],796,4,28009,4.043453154323661,0.0,0.0
16927,1,6927,[235 546   7 333 328],15,0,28009,4.042869515011548,0.0,0.0
16928,1,6928,[117 135 234  11 175],457,5,28014,4.043007649011401,0.0,0.0
16929,1,6929,[ 11 258 211 313 289],296,4,28018,4.043001443001443,0.0,0.0
16930,1,6930,[427 588  79  98 127],450,5,28023,4.043139518107055,20.0,20.0
16931,1,6931,[427 588  79  98 127],18,5,28028,4.043277553375649,20.0,20.0
16932,1,6932,[ 79 216 185 238 183],457,5,28033,4.043415548824463,0.0,0.0
16933,1,6933,[427 588  79  98 127],450,5,28038,4.043553504470724,20.0,20.0
16934,1,6934,[427 588  79  98 127],796,5,28043,4.043691420331651,20.0,20.0
16935,1,6935,[483 117 508 471 121],693,1,28044,4.0432525951557095,0.0,0.0
16936,1,6936,[427 588  79  98 127],389,5,28049,4.043390514631685,20.0,20.0
16937,1,6937,[427 588  79  98 127],450,5,28054,4.0435283943499565,20.0,20.0
16938,1,6938,[427 588  79  98 127],796,5,28059,4.043666234327713,20.0,20.0
16939,1,6939,[427 588  79  98 127],18,5,28064,4.0438040345821324,20.0,20.0
16940,1,6940,[153 405 597 143 186],796,4,28068,4.043797723670941,0.0,0.0
16941,1,6941,[427 588  79  98 127],716,5,28073,4.04393546528378,20.0,20.0
16942,1,6942,[294 183 118 333 204],796,4,28077,4.04392913726055,0.0,0.0
16943,1,6943,[427 588  79  98 127],716,5,28082,4.044066820276497,20.0,20.0
16944,1,6944,[195  50 174 301  56],151,4,28086,4.044060475161987,0.0,20.0
16945,1,6945,[ 15 118  82  70 183],450,2,28088,4.043766196372013,0.0,0.0
16946,1,6946,[  8 515  15 222 210],655,1,28089,4.0433280552756585,0.0,0.0
16947,1,6947,[427 588  79  98 127],389,5,28094,4.043465745538285,20.0,20.0
16948,1,6948,[427 588  79  98 127],796,5,28099,4.043603396172111,20.0,20.0
16949,1,6949,[427 588  79  98 127],450,5,28104,4.043741007194245,20.0,20.0
16950,1,6950,[427 588  79  98 127],796,5,28109,4.043878578621781,20.0,20.0
16951,1,6951,[427 588  79  98 127],18,5,28114,4.044016110471807,20.0,20.0
16952,1,6952,[197 121 603 405 202],798,2,28116,4.043722134330505,20.0,0.0
16953,1,6953,[197   4 176 186  64],151,4,28120,4.043715846994536,20.0,0.0
16954,1,6954,[200 742 423  79  56],593,5,28125,4.043853342918763,0.0,0.0
16955,1,6955,[427 588  79  98 127],389,5,28130,4.043990799309948,20.0,20.0
16956,1,6956,[427 588  79  98 127],716,5,28135,4.044128216185137,20.0,20.0
16957,1,6957,[427 588  79  98 127],18,5,28140,4.044265593561368,20.0,20.0
16958,1,6958,[508 143 405  88 276],655,2,28142,4.043971835033769,0.0,0.0
16959,1,6959,[216 173 245 313 269],450,5,28147,4.0441091954022985,0.0,0.0
16960,1,6960,[ 50 234 183 143 194],23,2,28149,4.043815543743715,0.0,20.0
16961,1,6961,[  8 215 172 181 153],878,2,28151,4.043521976443551,0.0,0.0
16962,1,6962,[183 423 655 322 405],786,4,28155,4.043515725980181,0.0,0.0
16963,1,6963,[168 237 333 210 268],174,4,28159,4.04350947731189,0.0,0.0
16964,1,6964,[508   9 151 515 435],296,4,28163,4.043503230437904,0.0,0.0
16965,1,6965,[ 97 508 204 153  56],523,3,28166,4.04335343095033,0.0,0.0
16966,1,6966,[ 82 234 151  28   7],577,3,28169,4.043203674465337,0.0,0.0
16967,1,6967,[427 588  79  98 127],389,5,28174,4.043340987370838,20.0,20.0
16968,1,6968,[300 275  89 100   7],151,4,28178,4.0433347682594345,0.0,40.0
16969,1,6969,[275 655 385 268 603],655,2,28180,4.043041606886657,20.0,20.0
16970,1,6970,[427 588  79  98 127],450,5,28185,4.043178883947784,20.0,20.0
16971,1,6971,[427 588  79  98 127],389,5,28190,4.043316121629375,20.0,20.0
16972,1,6972,[228  12 144 405 100],450,5,28195,4.043453319948372,0.0,20.0
16973,1,6973,[196 237  25 181 405],457,5,28200,4.043590478921709,0.0,0.0
16974,1,6974,[228 182 216 121 288],457,5,28205,4.043727598566308,0.0,0.0
16975,1,6975,[313 182 568 286 483],796,4,28209,4.043721330275229,0.0,20.0
16976,1,6976,[568 216 132 597 176],457,4,28213,4.043715063780994,0.0,0.0
16977,1,6977,[197 111 168 275  56],457,4,28217,4.0437087990828315,0.0,20.0
16978,1,6978,[427 588  79  98 127],450,5,28222,4.043845823183837,20.0,20.0
16979,1,6979,[427 588  79  98 127],716,5,28227,4.043982808022923,20.0,20.0
16980,1,6980,[322 678  96  28 195],504,5,28232,4.04411975361696,0.0,0.0
16981,1,6981,[172 191 471  50 118],577,3,28235,4.043970209109138,0.0,20.0
16982,1,6982,[ 96 423  69 176 318],655,1,28236,4.0435342975798365,20.0,0.0
16983,1,6983,[235 271 173 121  71],807,2,28238,4.043241695303551,0.0,0.0
16984,1,6984,[ 98 187 403 288 121],256,4,28242,4.043235504652827,0.0,0.0
16985,1,6985,[427 588  79  98 127],450,5,28247,4.0433724592041225,20.0,20.0
16986,1,6986,[427 588  79  98 127],450,5,28252,4.043509374552741,20.0,20.0
16987,1,6987,[427 588  79  98 127],450,5,28257,4.043646250715512,20.0,20.0
16988,1,6988,[195  95 125 161 286],786,5,28262,4.043783087709257,0.0,20.0
16989,1,6989,[118  79 245 183 191],450,4,28266,4.043776824034334,0.0,0.0
16990,1,6990,[235 132 127 195 144],280,3,28269,4.043627521098555,0.0,20.0
16991,1,6991,[427 588  79  98 127],18,5,28274,4.043764302059497,20.0,20.0
16992,1,6992,[181 186 405 210  96],716,3,28277,4.043615043615044,0.0,0.0
16993,1,6993,[427 588  79  98 127],18,5,28282,4.043751787246211,20.0,20.0
16994,1,6994,[427 588  79  98 127],450,5,28287,4.0438884917798426,20.0,20.0
16995,1,6995,[144  79 234 173 222],716,4,28291,4.04388221841052,0.0,0.0
16996,1,6996,[153 121 197  64 515],655,2,28293,4.043590110047163,20.0,0.0
16997,1,6997,[427 588  79  98 127],796,5,28298,4.043726779079737,20.0,20.0
16998,1,6998,[228 238 216 385 318],786,5,28303,4.043863409058437,20.0,0.0
16999,1,6999,[427 588  79  98 127],716,5,28308,4.044,20.0,20.0
17000,1,7000,[427 588  79  98 127],389,5,28313,4.044136551921154,20.0,20.0
17001,1,7001,[427 588  79  98 127],716,5,28318,4.044273064838618,20.0,20.0
17002,1,7002,[172 168 655 132 403],269,3,28321,4.044123946879909,0.0,0.0
17003,1,7003,[427 588  79  98 127],716,5,28326,4.044260422615648,20.0,20.0
17004,1,7004,[187 496  28  22  12],18,4,28330,4.044254104211277,20.0,0.0
17005,1,7005,[427 588  79  98 127],450,5,28335,4.044390522409364,20.0,20.0
17006,1,7006,[427 588  79  98 127],18,5,28340,4.044526901669759,20.0,20.0
17007,1,7007,[294 181  56  64 127],256,3,28343,4.0443778538812785,20.0,20.0
17008,1,7008,[427 588  79  98 127],450,5,28348,4.044514196033671,20.0,20.0
17009,1,7009,[  9  15 132  50 357],18,5,28353,4.044650499286734,0.0,20.0
17010,1,7010,[173 182 127 202  70],450,5,28358,4.04478676365711,0.0,20.0
17011,1,7011,[ 12 228 328 161 185],796,5,28363,4.044922989161438,0.0,0.0
17012,1,7012,[748 204  96 245 228],450,5,28368,4.045059175816341,0.0,0.0
17013,1,7013,[427 588  79  98 127],18,5,28373,4.0451953236384375,20.0,20.0
17014,1,7014,[427 588  79  98 127],796,5,28378,4.045331432644334,20.0,20.0
17015,1,7015,[ 82 216 195  11 427],330,4,28382,4.045324971493729,20.0,0.0
17016,1,7016,[182 215 603  28  89],18,1,28383,4.0448909790508765,20.0,0.0
17017,1,7017,[194 125 288  11 181],457,5,28388,4.04502707324024,0.0,0.0
17018,1,7018,[427 588  79  98 127],450,5,28393,4.045163128650805,20.0,20.0
17019,1,7019,[427 161 118 275 127],389,3,28396,4.0450142450142454,20.0,40.0
17020,1,7020,[427 588  79  98 127],450,5,28401,4.045150263495229,20.0,20.0
17021,1,7021,[125 200 174  28 111],151,4,28405,4.045143833665622,0.0,0.0
17022,1,7022,[427 588  79  98 127],389,5,28410,4.045279794959419,20.0,20.0
17023,1,7023,[427 588  79  98 127],796,5,28415,4.045415717539863,20.0,20.0
17024,1,7024,[197 269 333 195 282],796,3,28418,4.045266903914591,0.0,0.0
17025,1,7025,[215 603 180 515  28],18,2,28420,4.0449758041559924,20.0,0.0
17026,1,7026,[194  25 202 245 357],450,4,28424,4.044969403728476,0.0,0.0
17027,1,7027,[237 258 271 183 275],655,2,28426,4.04467842914058,0.0,20.0
17028,1,7028,[ 50 186 211 588 515],18,5,28431,4.044814340588989,0.0,20.0
17029,1,7029,[210   4  56 200 144],796,4,28435,4.044807965860597,0.0,0.0
17030,1,7030,[427 588  79  98 127],716,5,28440,4.044943820224719,20.0,20.0
17031,1,7031,[427 588  79  98 127],18,5,28445,4.045079635949943,20.0,20.0
17032,1,7032,[427 588  79  98 127],796,5,28450,4.045215413052751,20.0,20.0
17033,1,7033,[328 211   9 357  70],401,4,28454,4.045208984930339,0.0,0.0
17034,1,7034,[323 265 546 216 423],280,4,28458,4.045202558635395,0.0,0.0
17035,1,7035,[333 151  56 210 135],236,1,28459,4.044769755542922,0.0,0.0
17036,1,7036,[204 286  98 318 168],878,4,28463,4.044763393491545,20.0,20.0
17037,1,7037,[143  95 200   9  88],786,5,28468,4.044899119067917,0.0,0.0
17038,1,7038,[ 22 191  25 235 210],457,4,28472,4.044892740446086,0.0,0.0
17039,1,7039,[ 71   8 427   4 238],389,5,28477,4.045028409090909,20.0,0.0
17040,1,7040,[ 97 300 172  50 187],716,4,28481,4.045022013918477,0.0,20.0
17041,1,7041,[215 403  28   1 132],450,5,28486,4.045157625674524,0.0,0.0
17042,1,7042,[427 588  79  98 127],18,5,28491,4.045293198920914,20.0,20.0
17043,1,7043,[271 568 195 186  96],655,0,28491,4.044718909710392,0.0,0.0
17044,1,7044,[742 202 197 195 257],796,3,28494,4.044570617459191,0.0,0.0
17045,1,7045,[427 588  79  98 127],389,5,28499,4.044706216292933,20.0,20.0
17046,1,7046,[300 191  50 655 423],796,4,28503,4.044699872286079,0.0,20.0
17047,1,7047,[161  69 183 174 132],280,3,28506,4.044551645856981,0.0,0.0
17048,1,7048,[ 98  79 275 405 132],151,4,28510,4.044545325578096,0.0,20.0
17049,1,7049,[ 12 216 182 273 405],655,3,28513,4.044397163120568,0.0,0.0
17050,1,7050,[ 70   4  88  56 118],457,5,28518,4.044532690398525,0.0,0.0
17051,1,7051,[427 588  79  98 127],389,5,28523,4.044668179239932,20.0,20.0
17052,1,7052,[185 222 197 215 269],796,3,28526,4.044520062384801,0.0,0.0
17053,1,7053,[655  96 191 132 179],450,5,28531,4.0446555146016445,0.0,0.0
17054,1,7054,[195   8 603 210  69],269,1,28532,4.0442239546420975,20.0,0.0
17055,1,7055,[179  98 289 328 496],236,3,28535,4.044075963718821,20.0,0.0
17056,1,7056,[161  22 125 191 265],457,5,28540,4.044211421283832,0.0,0.0
17057,1,7057,[144 200 127 228 678],280,2,28542,4.043921790875602,0.0,20.0
17058,1,7058,[427 588  79  98 127],716,5,28547,4.044057231902536,20.0,20.0
17059,1,7059,[132 197 385 194 153],562,4,28551,4.0440509915014164,0.0,0.0
17060,1,7060,[427 588  79  98 127],389,5,28556,4.044186375867441,20.0,20.0
17061,1,7061,[  7 257 216 286  98],655,2,28558,4.043896913055791,0.0,20.0
17062,1,7062,[135 276 211 186  15],655,2,28560,4.043607532210109,0.0,0.0
17063,1,7063,[427 588  79  98 127],389,5,28565,4.043742921857304,20.0,20.0
17064,1,7064,[427 588  79  98 127],18,5,28570,4.043878273177636,20.0,20.0
17065,1,7065,[427 588  79  98 127],450,5,28575,4.0440135861873765,20.0,20.0
17066,1,7066,[427 588  79  98 127],18,5,28580,4.044148860902788,20.0,20.0
17067,1,7067,[117 151   1  69 276],401,1,28581,4.043718166383702,0.0,0.0
17068,1,7068,[427 588  79  98 127],18,5,28586,4.043853444617343,20.0,20.0
17069,1,7069,[265 200 234  95  50],436,2,28588,4.043564356435644,0.0,20.0
17070,1,7070,[385  96 265 181 323],280,3,28591,4.043416772733701,0.0,0.0
17071,1,7071,[182 276 294 322 323],280,2,28593,4.043127828054299,0.0,0.0
17072,1,7072,[405 269 300  22 318],655,1,28594,4.042697582355436,20.0,0.0
17073,1,7073,[187 475 200 515 268],269,5,28599,4.042832909245123,0.0,0.0
17074,1,7074,[427 588  79  98 127],716,5,28604,4.042968197879858,20.0,20.0
17075,1,7075,[427 588  79  98 127],18,5,28609,4.043103448275862,20.0,20.0
17076,1,7076,[403 328  97 269  96],796,3,28612,4.042956054825491,0.0,0.0
17077,1,7077,[215 655  82 496 196],796,3,28615,4.042808703023453,20.0,0.0
17078,1,7078,[427 588  79  98 127],18,5,28620,4.0429439186325755,20.0,20.0
17079,1,7079,[153 127 655 546 168],450,5,28625,4.043079096045198,0.0,20.0
17080,1,7080,[186 546 597 237 117],796,4,28629,4.0430730122864,0.0,0.0
17081,1,7081,[195   1 180  25 318],18,3,28632,4.0429257271957075,20.0,0.0
17082,1,7082,[ 96 174  50 265  95],577,5,28637,4.043060849922349,0.0,20.0
17083,1,7083,[427 588  79  98 127],716,5,28642,4.043195934500282,20.0,20.0
17084,1,7084,[427 588  79  98 127],796,5,28647,4.04333098094566,20.0,20.0
17085,1,7085,[175  15 173 423 228],11,3,28650,4.043183742591024,0.0,0.0
17086,1,7086,[427 588  79  98 127],389,5,28655,4.043318752645689,20.0,20.0
17087,1,7087,[173  25 257 151 117],716,5,28660,4.043453724604966,0.0,0.0
17088,1,7088,[111 182 328  12  89],655,2,28662,4.043165467625899,0.0,0.0
17089,1,7089,[216 174 546  97 275],786,5,28667,4.04330042313117,0.0,20.0
17090,1,7090,[427 588  79  98 127],18,5,28672,4.0434353405725565,20.0,20.0
17091,1,7091,[271  96  89  82 276],655,2,28674,4.043147208121828,0.0,0.0
17092,1,7092,[  7  89 222 117 195],457,5,28679,4.0432821091216695,0.0,0.0
17093,1,7093,[427 588  79  98 127],389,5,28684,4.04341697208909,20.0,20.0
17094,1,7094,[546  56 100 333 238],174,4,28688,4.043410852713178,0.0,20.0
17095,1,7095,[ 95 435   4 237 179],450,3,28691,4.043263810597519,0.0,0.0
17096,1,7096,[328   9 546 176  70],151,2,28693,4.042975905312104,0.0,0.0
17097,1,7097,[655 121 200   4 195],786,4,28697,4.042969850662159,0.0,0.0
17098,1,7098,[237 471 435 161 172],655,1,28698,4.042541202986336,0.0,0.0
17099,1,7099,[427 508 180  50 265],535,4,28702,4.042535211267606,20.0,20.0
17100,1,7100,[427 588  79  98 127],796,5,28707,4.0426700464723275,20.0,20.0
17101,1,7101,[191 173 269  97 187],450,5,28712,4.042804843705999,0.0,0.0
17102,1,7102,[427 588  79  98 127],716,5,28717,4.042939602984655,20.0,20.0
17103,1,7103,[427 588  79  98 127],716,5,28722,4.043074324324325,20.0,20.0
17104,1,7104,[427 588  79  98 127],18,5,28727,4.043209007741027,20.0,20.0
17105,1,7105,[427 588  79  98 127],389,5,28732,4.043343653250774,20.0,20.0
17106,1,7106,[194 235   4 135 172],450,2,28734,4.043056141831997,0.0,0.0
17107,1,7107,[183 168 435  12 118],151,3,28737,4.042909397861564,0.0,0.0
17108,1,7108,[111 568 100 245  82],885,3,28740,4.0427626951751305,0.0,20.0
17109,1,7109,[179 161  98   9 183],786,5,28745,4.042897327707454,0.0,0.0
17110,1,7110,[427 588  79  98 127],450,5,28750,4.043031922373787,20.0,20.0
17111,1,7111,[427 588  79  98 127],18,5,28755,4.043166479190101,20.0,20.0
17112,1,7112,[135 161   1 228 117],280,4,28759,4.043160410515957,0.0,0.0
17113,1,7113,[333 603 238 153 275],796,4,28763,4.043154343547934,20.0,20.0
17114,1,7114,[191 143  64 222 289],693,1,28764,4.0427266338721015,20.0,0.0
17115,1,7115,[742  22 151 181 483],450,4,28768,4.042720629567173,0.0,0.0
17116,1,7116,[427 588  79  98 127],450,5,28773,4.042855135590838,20.0,20.0
17117,1,7117,[748 300 546 211   7],151,3,28776,4.042708626018545,0.0,0.0
17118,1,7118,[275 176 655 258  71],450,4,28780,4.042702626773424,0.0,20.0
17119,1,7119,[588 655  22 245 286],796,2,28782,4.042415730337079,0.0,20.0
17120,1,7120,[180 168 265 286 655],535,3,28785,4.042269344193231,0.0,20.0
17121,1,7121,[ 64 132 183 200 174],151,3,28788,4.04212299915754,20.0,0.0
17122,1,7122,[ 70 678 216 174 117],504,4,28792,4.042117085497684,0.0,0.0
17123,1,7123,[179   1 568  97 200],655,2,28794,4.041830432341381,0.0,0.0
17124,1,7124,[568 196 111 194  64],450,5,28799,4.041964912280702,20.0,0.0
17125,1,7125,[427 588  79  98 127],18,5,28804,4.042099354476565,20.0,20.0
17126,1,7126,[ 69 515 127 234 183],316,1,28805,4.041672512978813,0.0,20.0
17127,1,7127,[301 288 118 333  25],655,0,28805,4.0411054994388325,0.0,0.0
17128,1,7128,[174  28  22  56 742],577,4,28809,4.041099733482957,0.0,0.0
17129,1,7129,[427 588  79  98 127],389,5,28814,4.041234221598878,20.0,20.0
17130,1,7130,[427 588  79  98 127],716,5,28819,4.041368671995513,20.0,20.0
17131,1,7131,[427 588  79  98 127],450,5,28824,4.041503084688727,20.0,20.0
17132,1,7132,[195  89 196 176 118],796,5,28829,4.041637459694378,0.0,0.0
17133,1,7133,[302 174  79   4 423],151,4,28833,4.041631623212784,0.0,0.0
17134,1,7134,[427 588  79  98 127],450,5,28838,4.041765942536791,20.0,20.0
17135,1,7135,[265 195   8 238  89],655,1,28839,4.041339686098655,0.0,0.0
17136,1,7136,[427 588  79  98 127],716,5,28844,4.041474008687123,20.0,20.0
17137,1,7137,[185  25 275 427 302],389,4,28848,4.041468198374895,20.0,20.0
17138,1,7138,[288 117  70 144   9],593,4,28852,4.041462389690433,0.0,0.0
17139,1,7139,[427 588  79  98 127],18,5,28857,4.041596638655462,20.0,20.0
17140,1,7140,[  9 275  98 144 294],796,3,28860,4.041450777202073,0.0,20.0
17141,1,7141,[197 182 200  95 655],796,3,28863,4.041304956594791,0.0,0.0
17142,1,7142,[328 161 183  56 423],655,1,28864,4.040879182416352,0.0,0.0
17143,1,7143,[508 235 204  12 588],280,3,28867,4.040733482642777,0.0,0.0
17144,1,7144,[427 588  79  98 127],18,5,28872,4.040867739678097,20.0,20.0
17145,1,7145,[427 588  79  98 127],716,5,28877,4.041001959137979,20.0,20.0
17146,1,7146,[655  22 186  69 234],269,1,28878,4.040576465649923,0.0,0.0
17147,1,7147,[427 588  79  98 127],389,5,28883,4.040710688304421,20.0,20.0
17148,1,7148,[427 588  79  98 127],716,5,28888,4.040844873408869,20.0,20.0
17149,1,7149,[427 588  79  98 127],450,5,28893,4.040979020979021,20.0,20.0
17150,1,7150,[ 98 144 181 289  12],693,3,28896,4.040833449867152,0.0,0.0
17151,1,7151,[191 313  95 222 186],450,2,28898,4.040548098434004,0.0,0.0
17152,1,7152,[427 588  79  98 127],450,5,28903,4.040682231231651,20.0,20.0
17153,1,7153,[427 588  79  98 127],18,5,28908,4.040816326530612,20.0,20.0
17154,1,7154,[742  98 204 258 268],11,2,28910,4.0405310971348705,0.0,0.0
17155,1,7155,[405 427 603 187 176],503,3,28913,4.040385690329793,40.0,0.0
17156,1,7156,[427 588  79  98 127],716,5,28918,4.0405197708537095,20.0,20.0
17157,1,7157,[427 588  79  98 127],389,5,28923,4.040653813914501,20.0,20.0
17158,1,7158,[185 385  88 655 202],450,5,28928,4.040787819527867,0.0,0.0
17159,1,7159,[216  71 210 301   1],450,3,28931,4.040642458100558,0.0,0.0
17160,1,7160,[  4 195 210 403 288],457,5,28936,4.040776427873202,0.0,0.0
17161,1,7161,[427 194 191 121 228],716,5,28941,4.040910360234571,20.0,0.0
17162,1,7162,[546 258 168 403 588],807,4,28945,4.0409046488901295,0.0,0.0
17163,1,7163,[269 301 318 182  22],655,2,28947,4.040619765494137,20.0,0.0
17164,1,7164,[181 176  22 269 196],344,3,28950,4.040474528960224,0.0,0.0
17165,1,7165,[742  25 183  98 118],693,2,28952,4.040189785096288,0.0,0.0
17166,1,7166,[286 258  69 132 475],629,5,28957,4.040323705874146,0.0,20.0
17167,1,7167,[427 588  79  98 127],450,5,28962,4.040457589285714,20.0,20.0
17168,1,7168,[427 588  79  98 127],716,5,28967,4.040591435346632,20.0,20.0
17169,1,7169,[172  15 265   7 153],655,1,28968,4.040167364016736,0.0,0.0
17170,1,7170,[568 603 183  69 357],716,4,28972,4.0401617626551385,20.0,0.0
17171,1,7171,[427 588  79  98 127],796,5,28977,4.040295593976576,20.0,20.0
17172,1,7172,[180 318 286 235 176],450,4,28981,4.040289976300014,20.0,20.0
17173,1,7173,[483  15 197 172 180],450,3,28984,4.040144967939782,0.0,0.0
17174,1,7174,[237  82   9 186 423],457,5,28989,4.040278745644599,0.0,0.0
17175,1,7175,[427 588  79  98 127],389,5,28994,4.04041248606466,20.0,20.0
17176,1,7176,[655 496 210 597   1],796,2,28996,4.040128187264874,20.0,0.0
17177,1,7177,[427 588  79  98 127],716,5,29001,4.040261911395932,20.0,20.0
17178,1,7178,[  4  98 176  69 196],716,3,29004,4.040117007939824,0.0,0.0
17179,1,7179,[427 588  79  98 127],18,5,29009,4.0402506963788305,20.0,20.0
17180,1,7180,[427 588  79  98 127],389,5,29014,4.040384347583902,20.0,20.0
17181,1,7181,[427 588  79  98 127],450,5,29019,4.040517961570593,20.0,20.0
17182,1,7182,[100  71 173 202 588],577,5,29024,4.040651538354448,0.0,20.0
17183,1,7183,[427 588  79  98 127],389,5,29029,4.040785077951003,20.0,20.0
17184,1,7184,[257 215  25 144 435],655,0,29029,4.040222686151705,0.0,0.0
17185,1,7185,[427 588  79  98 127],796,5,29034,4.040356248260506,20.0,20.0
17186,1,7186,[276 515  15 271 568],655,2,29036,4.04007235285933,0.0,0.0
17187,1,7187,[180 153  82 100 323],504,4,29040,4.040066777963272,0.0,20.0
17188,1,7188,[427 588  79  98 127],450,5,29045,4.040200306023091,20.0,20.0
17189,1,7189,[121  12   4 200  15],577,3,29048,4.040055632823366,0.0,0.0
17190,1,7190,[194 294 496 183 117],716,4,29052,4.0400500625782225,20.0,0.0
17191,1,7191,[143  88 234  25  70],457,5,29057,4.040183537263626,0.0,0.0
17192,1,7192,[185 265   8 144 132],796,5,29062,4.040316974836647,0.0,0.0
17193,1,7193,[276  25   1 313 173],344,3,29065,4.040172365860439,0.0,0.0
17194,1,7194,[186 191 357 403 265],796,4,29069,4.040166782487839,0.0,0.0
17195,1,7195,[183 197 204 405 235],716,3,29072,4.040022234574764,0.0,0.0
17196,1,7196,[427 588  79  98 127],450,5,29077,4.040155620397388,20.0,20.0
17197,1,7197,[568 180 143 515 294],716,4,29081,4.040150041678244,0.0,0.0
17198,1,7198,[172 200 174 427 357],908,1,29082,4.039727739963884,20.0,0.0
17199,1,7199,[403   4 173   8 194],796,5,29087,4.039861111111111,0.0,0.0
17200,1,7200,[161  69 211 228 322],450,5,29092,4.039994445215942,0.0,0.0
17201,1,7201,[427 588  79  98 127],796,5,29097,4.040127742293807,20.0,20.0
17202,1,7202,[144  97 153 210   8],593,3,29100,4.039983340274885,0.0,0.0
17203,1,7203,[111  12 385 204 301],655,0,29100,4.039422543031649,0.0,0.0
17204,1,7204,[427 588  79  98 127],716,5,29105,4.039555863983345,20.0,20.0
17205,1,7205,[427 588  79  98 127],389,5,29110,4.039689147932279,20.0,20.0
17206,1,7206,[210 258 144 186 301],655,0,29110,4.039128624947967,0.0,0.0
17207,1,7207,[186  56   7 475 195],269,2,29112,4.038845726970033,0.0,0.0
17208,1,7208,[ 56  64 385  69 182],655,2,29114,4.0385629074767655,20.0,0.0
17209,1,7209,[655 294 215 318 132],716,5,29119,4.03869625520111,20.0,0.0
17210,1,7210,[282 235 187 118 127],450,3,29122,4.038552211898488,0.0,20.0
17211,1,7211,[385 655 238 195  96],23,4,29126,4.038546866333888,0.0,0.0
17212,1,7212,[ 11 568 144 268 318],655,1,29127,4.0381256065437405,20.0,0.0
17213,1,7213,[245 172 273 173  97],450,4,29131,4.038120321596895,0.0,0.0
17214,1,7214,[427 588  79  98 127],716,5,29136,4.0382536382536385,20.0,20.0
17215,1,7215,[ 79  82 748 153 143],450,4,29140,4.038248337028825,0.0,0.0
17216,1,7216,[318 508 228  12 300],11,2,29142,4.037965913814604,20.0,0.0
17217,1,7217,[153 588 196 655 173],716,5,29147,4.038099196453311,0.0,0.0
17218,1,7218,[271 118 385 318  96],796,5,29152,4.038232442166505,20.0,0.0
17219,1,7219,[174 210 568 385 121],655,0,29152,4.037673130193906,0.0,0.0
17220,1,7220,[427 588  79  98 127],796,5,29157,4.0378063980058165,20.0,20.0
17221,1,7221,[427 588  79  98 127],796,5,29162,4.0379396289116585,20.0,20.0
17222,1,7222,[175 483 385 216 300],716,3,29165,4.037795929669112,0.0,0.0
17223,1,7223,[180  70 423 483   8],280,5,29170,4.037929125138428,0.0,0.0
17224,1,7224,[204 121 153 186 483],450,2,29172,4.03764705882353,0.0,0.0
17225,1,7225,[286 269 748 357 588],796,3,29175,4.037503459728757,0.0,20.0
17226,1,7226,[ 69 195 597 273 174],450,4,29179,4.037498270374983,0.0,0.0
17227,1,7227,[427 588  79  98 127],796,5,29184,4.037631433314886,20.0,20.0
17228,1,7228,[161 273  50 210  70],401,2,29186,4.037349564255083,0.0,20.0
17229,1,7229,[194  69 655  88 196],504,3,29189,4.0372060857538035,0.0,0.0
17230,1,7230,[257 588 174 191 222],716,5,29194,4.037339233854238,0.0,0.0
17231,1,7231,[427 588  79  98 127],716,5,29199,4.037472345132743,20.0,20.0
17232,1,7232,[176  28  79 173  88],716,4,29203,4.037467164385456,0.0,0.0
17233,1,7233,[427 588  79  98 127],450,5,29208,4.0376002211777715,20.0,20.0
17234,1,7234,[427 588  79  98 127],450,5,29213,4.037733241188667,20.0,20.0
17235,1,7235,[427 588  79  98 127],18,5,29218,4.0378662244333885,20.0,20.0
17236,1,7236,[427 588  79  98 127],796,5,29223,4.03799917092718,20.0,20.0
17237,1,7237,[427 588  79  98 127],450,5,29228,4.038132080685272,20.0,20.0
17238,1,7238,[385   1  97  15 322],593,3,29231,4.037988672468573,0.0,0.0
17239,1,7239,[143 328 210 515 181],401,4,29235,4.037983425414365,0.0,0.0
17240,1,7240,[568 508 187 237 186],269,2,29237,4.03770197486535,0.0,0.0
17241,1,7241,[427 588  79  98 127],716,5,29242,4.03783485225076,20.0,20.0
17242,1,7242,[427 588  79  98 127],18,5,29247,4.037967692944912,20.0,20.0
17243,1,7243,[427 588  79  98 127],389,5,29252,4.038100496963004,20.0,20.0
17244,1,7244,[151 427 216  56 385],151,4,29256,4.038095238095238,20.0,0.0
17245,1,7245,[427 588  79  98 127],796,5,29261,4.038227987855368,20.0,20.0
17246,1,7246,[143 357 117 318 288],655,3,29264,4.038084724713674,20.0,0.0
17247,1,7247,[265 204  12 228 179],577,3,29267,4.037941501103753,0.0,0.0
17248,1,7248,[302 168 496 172 234],450,4,29271,4.03793626707132,20.0,0.0
17249,1,7249,[427 588  79  98 127],716,5,29276,4.038068965517241,20.0,20.0
17250,1,7250,[471 204  70 121 195],450,4,29280,4.038063715349607,0.0,0.0
17251,1,7251,[427 588  79  98 127],450,5,29285,4.038196359624931,20.0,20.0
17252,1,7252,[202 423  88 185 135],330,4,29289,4.038191093340687,0.0,0.0
17253,1,7253,[427 588  79  98 127],796,5,29294,4.038323683484974,20.0,20.0
17254,1,7254,[125 100 197 257 143],504,5,29299,4.038456237077877,0.0,20.0
17255,1,7255,[427 588  79  98 127],796,5,29304,4.038588754134509,20.0,20.0
17256,1,7256,[168 294 195  28 210],450,4,29308,4.038583436681824,0.0,0.0
17257,1,7257,[121  69 176 603 427],72,3,29311,4.038440341691926,40.0,0.0
17258,1,7258,[427 588  79  98 127],18,5,29316,4.038572806171649,20.0,20.0
17259,1,7259,[427 588  79  98 127],796,5,29321,4.03870523415978,20.0,20.0
17260,1,7260,[427 588  79  98 127],716,5,29326,4.038837625671395,20.0,20.0
17261,1,7261,[191 215  28 435 180],18,3,29329,4.0386945744973834,0.0,0.0
17262,1,7262,[300 211 185 328   4],450,4,29333,4.038689246867685,0.0,0.0
17263,1,7263,[427 588  79  98 127],450,5,29338,4.038821585903084,20.0,20.0
17264,1,7264,[427 588  79  98 127],796,5,29343,4.038953888506538,20.0,20.0
17265,1,7265,[275 161  97 179 222],457,5,29348,4.039086154693091,0.0,20.0
17266,1,7266,[118 202 282 183 196],655,1,29349,4.038667951011422,0.0,0.0
17267,1,7267,[191 423 127  88 183],269,3,29352,4.03852504127683,0.0,20.0
17268,1,7268,[ 15 655 597 151   9],269,3,29355,4.038382170862567,0.0,0.0
17269,1,7269,[427 588  79  98 127],716,5,29360,4.038514442916093,20.0,20.0
17270,1,7270,[318 204 151 173 153],269,2,29362,4.038234080594141,20.0,0.0
17271,1,7271,[282  97  25 294 318],716,4,29366,4.038228822882288,20.0,0.0
17272,1,7272,[ 69  11 153 275 435],716,5,29371,4.038361061460195,0.0,20.0
17273,1,7273,[185 196 181 210 168],269,2,29373,4.038080835853726,0.0,0.0
17274,1,7274,[427 588  79  98 127],389,5,29378,4.038213058419244,20.0,20.0
17275,1,7275,[  1 132 176 313 210],835,4,29382,4.0382078064870806,0.0,0.0
17276,1,7276,[427 588  79  98 127],796,5,29387,4.038339975264532,20.0,20.0
17277,1,7277,[222 275 191 161 588],23,3,29390,4.038197306952459,0.0,20.0
17278,1,7278,[185  69 194  28 210],389,4,29394,4.038192059348812,0.0,0.0
17279,1,7279,[ 89  56 228  22 742],457,5,29399,4.038324175824176,0.0,0.0
17280,1,7280,[427 588  79  98 127],716,5,29404,4.03845625600879,20.0,20.0
17281,1,7281,[100 174 496 117 603],796,4,29408,4.0384509750068665,40.0,20.0
17282,1,7282,[222 423  28  89 211],807,5,29413,4.038583001510367,0.0,0.0
17283,1,7283,[483 185 196   4 300],535,3,29416,4.038440417353103,0.0,0.0
17284,1,7284,[427 588  79  98 127],450,5,29421,4.038572409059712,20.0,20.0
17285,1,7285,[427 588  79  98 127],796,5,29426,4.038704364534724,20.0,20.0
17286,1,7286,[237 185 265   8  22],457,5,29431,4.0388362837930565,0.0,0.0
17287,1,7287,[435 475 161 144 196],655,0,29431,4.038282107574094,0.0,0.0
17288,1,7288,[196 181 195 197 191],457,5,29436,4.038414048566333,0.0,0.0
17289,1,7289,[245 173 546 151 111],796,4,29440,4.03840877914952,0.0,0.0
17290,1,7290,[196 216 748 435 234],151,4,29444,4.038403511178164,0.0,0.0
17291,1,7291,[  4 181  22 313 111],344,2,29446,4.038123971475589,0.0,0.0
17292,1,7292,[427 588  79  98 127],450,5,29451,4.038255861785274,20.0,20.0
17293,1,7293,[427 588  79  98 127],716,5,29456,4.038387715930902,20.0,20.0
17294,1,7294,[215  96 238 282 191],457,5,29461,4.038519533927348,0.0,0.0
17295,1,7295,[ 22  88 195 228  96],716,3,29464,4.038377192982456,0.0,0.0
17296,1,7296,[ 82  71 568 111 302],389,3,29467,4.0382348910511165,0.0,0.0
17297,1,7297,[357 194 318 182 173],450,5,29472,4.03836667580159,20.0,0.0
17298,1,7298,[742 161 423 483 143],693,1,29473,4.037950404164954,0.0,0.0
17299,1,7299,[427 588  79  98 127],716,5,29478,4.038082191780822,20.0,20.0
17300,1,7300,[ 50 597 234 194 127],450,4,29482,4.038076975756746,0.0,40.0
17301,1,7301,[313 475 273 204   7],655,2,29484,4.037797863599014,0.0,0.0
17302,1,7302,[  7  70  89 197 215],151,4,29488,4.037792687936465,0.0,0.0
17303,1,7303,[286  12 195 182 318],280,3,29491,4.037650602409639,20.0,20.0
17304,1,7304,[245 132  15  64   9],629,4,29495,4.037645448323066,20.0,0.0
17305,1,7305,[427 588  79  98 127],716,5,29500,4.037777169449767,20.0,20.0
17306,1,7306,[ 71 187 568 195 153],796,5,29505,4.03790885452306,0.0,0.0
17307,1,7307,[121 385 405  79 174],344,2,29507,4.037629994526546,0.0,0.0
17308,1,7308,[210 202 748 235 385],450,3,29510,4.037488028458065,0.0,0.0
17309,1,7309,[ 71 181 742 237  95],280,3,29513,4.03734610123119,0.0,0.0
17310,1,7310,[427 588  79  98 127],18,5,29518,4.037477773218438,20.0,20.0
17311,1,7311,[222 323 568  71 168],798,3,29521,4.037335886214442,0.0,0.0
17312,1,7312,[742 265 588 294 423],450,5,29526,4.0374675235881305,0.0,0.0
17313,1,7313,[228   9 483 269 211],655,1,29527,4.03705222860268,0.0,0.0
17314,1,7314,[427 588  79  98 127],716,5,29532,4.037183868762816,20.0,20.0
17315,1,7315,[181 318  50 435 191],878,4,29536,4.037178786221979,20.0,20.0
17316,1,7316,[588  98 181 655 228],716,5,29541,4.037310373103731,0.0,0.0
17317,1,7317,[471 405 483 238 125],450,4,29545,4.037305274665209,0.0,0.0
17318,1,7318,[117   1 174 161 180],786,5,29550,4.037436808307146,0.0,0.0
17319,1,7319,[427 588  79  98 127],18,5,29555,4.037568306010929,20.0,20.0
17320,1,7320,[427 588  79  98 127],18,5,29560,4.037699767791286,20.0,20.0
17321,1,7321,[ 11  71 483 151 282],401,1,29561,4.037284894837476,0.0,0.0
17322,1,7322,[471 211 121 197 127],786,3,29564,4.0371432473030175,0.0,20.0
17323,1,7323,[427 588  79  98 127],716,5,29569,4.037274713271437,20.0,20.0
17324,1,7324,[427 588  79  98 127],389,5,29574,4.03740614334471,20.0,20.0
17325,1,7325,[427 588  79  98 127],450,5,29579,4.0375375375375375,20.0,20.0
17326,1,7326,[175 185  98 135 125],151,5,29584,4.03766889586461,0.0,0.0
17327,1,7327,[427 588  79  98 127],389,5,29589,4.037800218340611,20.0,20.0
17328,1,7328,[427 588  79  98 127],450,5,29594,4.037931504980215,20.0,20.0
17329,1,7329,[ 71 132 234  79 403],577,4,29598,4.037926330150068,0.0,0.0
17330,1,7330,[748 194 132  50 127],796,5,29603,4.03805756377029,0.0,40.0
17331,1,7331,[197 483  15   9 181],269,3,29606,4.037915984724496,0.0,0.0
17332,1,7332,[427 588  79  98 127],389,5,29611,4.038047183962908,20.0,20.0
17333,1,7333,[405 153 286  70 546],593,3,29614,4.037905644941369,0.0,20.0
17334,1,7334,[237 182 118   4  15],457,5,29619,4.038036809815951,0.0,0.0
17335,1,7335,[427 588  79  98 127],716,5,29624,4.038167938931298,20.0,20.0
17336,1,7336,[427 588  79  98 127],18,5,29629,4.038299032302031,20.0,20.0
17337,1,7337,[427 588  79  98 127],796,5,29634,4.038430089942763,20.0,20.0
17338,1,7338,[748  96 117 187   7],450,5,29639,4.038561111868102,0.0,0.0
17339,1,7339,[427 588  79  98 127],18,5,29644,4.038692098092643,20.0,20.0
17340,1,7340,[191  88 186 197   7],457,5,29649,4.038823048630976,0.0,0.0
17341,1,7341,[405 301 202 273 237],344,3,29652,4.03868155815854,0.0,0.0
17342,1,7342,[427 588  79  98 127],18,5,29657,4.038812474465478,20.0,20.0
17343,1,7343,[427 588  79  98 127],18,5,29662,4.038943355119826,20.0,20.0
17344,1,7344,[427 588  79  98 127],796,5,29667,4.039074200136147,20.0,20.0
17345,1,7345,[153 322  70 742 222],280,4,29671,4.039068881023686,0.0,0.0
17346,1,7346,[427 588  79  98 127],716,5,29676,4.039199673336055,20.0,20.0
17347,1,7347,[427 588  79  98 127],450,5,29681,4.0393304300489925,20.0,20.0
17348,1,7348,[483 132  70 153 515],269,3,29684,4.039189005306844,0.0,0.0
17349,1,7349,[132 181 245 357 300],796,4,29688,4.039183673469387,0.0,0.0
17350,1,7350,[427 588  79  98 127],716,5,29693,4.039314378996055,20.0,20.0
17351,1,7351,[427 588  79  98 127],389,5,29698,4.039445048966268,20.0,20.0
17352,1,7352,[427 588  79  98 127],716,5,29703,4.039575683394533,20.0,20.0
17353,1,7353,[269  69 275 237 168],18,2,29705,4.03929834103889,0.0,20.0
17354,1,7354,[427 588  79  98 127],450,5,29710,4.0394289598912305,20.0,20.0
17355,1,7355,[ 28 427 210 238 228],796,2,29712,4.039151712887439,20.0,0.0
17356,1,7356,[ 98 144 742  96 135],693,4,29716,4.039146391192062,0.0,0.0
17357,1,7357,[ 97 174 216 210  15],835,5,29721,4.039276977439521,0.0,0.0
17358,1,7358,[265 186 173 185  98],535,3,29724,4.039135752140236,0.0,0.0
17359,1,7359,[427 588  79  98 127],18,5,29729,4.0392663043478265,20.0,20.0
17360,1,7360,[427 588  79  98 127],450,5,29734,4.039396821084092,20.0,20.0
17361,1,7361,[427 588  79  98 127],18,5,29739,4.039527302363489,20.0,20.0
17362,1,7362,[427 588  79  98 127],450,5,29744,4.039657748200462,20.0,20.0
17363,1,7363,[427 588  79  98 127],796,5,29749,4.0397881586094515,20.0,20.0
17364,1,7364,[427 588  79  98 127],450,5,29754,4.039918533604888,20.0,20.0
17365,1,7365,[276 182 275 180 127],321,2,29756,4.039641596524572,0.0,40.0
17366,1,7366,[237  22 200 568 294],280,2,29758,4.039364734627393,0.0,0.0
17367,1,7367,[  4 210 202 127 185],716,4,29762,4.039359391965255,0.0,20.0
17368,1,7368,[427 588  79  98 127],18,5,29767,4.039489754376442,20.0,20.0
17369,1,7369,[427 588  79  98 127],450,5,29772,4.039620081411126,20.0,20.0
17370,1,7370,[294   4  25 211   7],264,4,29776,4.039614706281373,0.0,0.0
17371,1,7371,[427 588  79  98 127],389,5,29781,4.039744981009224,20.0,20.0
17372,1,7372,[427 588  79  98 127],450,5,29786,4.039875220398752,20.0,20.0
17373,1,7373,[427 588  79  98 127],716,5,29791,4.040005424464334,20.0,20.0
17374,1,7374,[427 588  79  98 127],450,5,29796,4.040135593220339,20.0,20.0
17375,1,7375,[ 50 471  28 301   1],389,5,29801,4.040265726681128,0.0,20.0
17376,1,7376,[427 588  79  98 127],796,5,29806,4.040395824861054,20.0,20.0
17377,1,7377,[427 588  79  98 127],389,5,29811,4.040525887774464,20.0,20.0
17378,1,7378,[ 82 357 435 151   4],716,4,29815,4.040520395717577,0.0,0.0
17379,1,7379,[ 22 385 258 173 195],796,5,29820,4.040650406504065,0.0,0.0
17380,1,7380,[546  64 173   4 210],344,4,29824,4.0406448990651676,20.0,0.0
17381,1,7381,[427 588  79  98 127],796,5,29829,4.040774857762124,20.0,20.0
17382,1,7382,[ 15 194 151 153 183],236,1,29830,4.040362996072058,0.0,0.0
17383,1,7383,[427 588  79  98 127],18,5,29835,4.040492957746479,20.0,20.0
17384,1,7384,[313 143  71 568 127],450,4,29839,4.040487474610697,0.0,20.0
17385,1,7385,[427 588  79  98 127],450,5,29844,4.040617384240455,20.0,20.0
17386,1,7386,[275 265 185 471  15],655,2,29846,4.04034113984026,0.0,20.0
17387,1,7387,[427 588  79  98 127],716,5,29851,4.040471034109366,20.0,20.0
17388,1,7388,[181  70 195 185 172],450,5,29856,4.040600893219651,0.0,0.0
17389,1,7389,[427 588  79  98 127],450,5,29861,4.040730717185386,20.0,20.0
17390,1,7390,[427 588  79  98 127],716,5,29866,4.040860506020836,20.0,20.0
17391,1,7391,[427 588  79  98 127],716,5,29871,4.040990259740259,20.0,20.0
17392,1,7392,[427 588  79  98 127],18,5,29876,4.041119978357906,20.0,20.0
17393,1,7393,[357 182 179  96 318],450,5,29881,4.041249661888017,20.0,0.0
17394,1,7394,[215 216 508  97 196],655,1,29882,4.040838404327248,0.0,0.0
17395,1,7395,[216 173 496 328 186],151,4,29886,4.040832882639265,20.0,0.0
17396,1,7396,[ 12 318 496 238   8],18,5,29891,4.040962552386103,40.0,0.0
17397,1,7397,[603 143 435 496 385],151,4,29895,4.04095701540957,40.0,0.0
17398,1,7398,[210 204 194 265 483],535,4,29899,4.040951479929721,0.0,0.0
17399,1,7399,[121 191 179   4 172],655,3,29902,4.040810810810811,0.0,0.0
17400,1,7400,[ 69 153 183 181 286],593,5,29907,4.0409404134576405,0.0,20.0
17401,1,7401,[257 245 143  96   9],504,5,29912,4.041069981086193,0.0,0.0
17402,1,7402,[288   7  15  50 182],450,3,29915,4.040929352965014,0.0,20.0
17403,1,7403,[427 588  79  98 127],450,5,29920,4.04105888708806,20.0,20.0
17404,1,7404,[ 82  69 237 180 194],18,1,29921,4.040648210668468,0.0,0.0
17405,1,7405,[427 588  79  98 127],450,5,29926,4.0407777477720765,20.0,20.0
17406,1,7406,[210 118 117   4  69],344,2,29928,4.040502227622519,0.0,0.0
17407,1,7407,[546 318 179 238  56],593,4,29932,4.040496760259179,20.0,0.0
17408,1,7408,[286 273 100  25 302],344,4,29936,4.04049129437171,0.0,40.0
17409,1,7409,[427 588  79  98 127],450,5,29941,4.040620782726046,20.0,20.0
17410,1,7410,[294 172  64 265 181],450,5,29946,4.040750236135474,20.0,0.0
17411,1,7411,[222 191  25 204 175],655,1,29947,4.040339989206692,0.0,0.0
17412,1,7412,[427 588  79  98 127],796,5,29952,4.040469445568596,20.0,20.0
17413,1,7413,[385 187 237 181 245],796,4,29956,4.040463987051524,0.0,0.0
17414,1,7414,[403 483 117 742 172],450,4,29960,4.0404585300067435,0.0,0.0
17415,1,7415,[427 588  79  98 127],450,5,29965,4.0405879180151025,20.0,20.0
17416,1,7416,[427 588  79  98 127],389,5,29970,4.0407172711338815,20.0,20.0
17417,1,7417,[357  79 210 197  28],796,2,29972,4.0404421677001885,0.0,0.0
17418,1,7418,[748 111 234 151 423],450,4,29976,4.0404367165386175,0.0,0.0
17419,1,7419,[427 588  79  98 127],389,5,29981,4.040566037735849,20.0,20.0
17420,1,7420,[294  50 286  64 204],629,4,29985,4.04056057135157,20.0,40.0
17421,1,7421,[427 588  79  98 127],450,5,29990,4.040689841013204,20.0,20.0
17422,1,7422,[265 483  71 318 173],450,3,29993,4.040549643001482,20.0,0.0
17423,1,7423,[427 588  79  98 127],18,5,29998,4.040678879310345,20.0,20.0
17424,1,7424,[153 118 179 186  15],389,1,29999,4.0402693602693605,0.0,0.0
17425,1,7425,[427 588  79  98 127],716,5,30004,4.040398599515217,20.0,20.0
17426,1,7426,[427 588  79  98 127],796,5,30009,4.04052780395853,20.0,20.0
17427,1,7427,[597 173 161 210 215],796,4,30013,4.040522347872913,0.0,0.0
17428,1,7428,[427 588  79  98 127],716,5,30018,4.04065150087495,20.0,20.0
17429,1,7429,[546 181 228  69 289],693,0,30018,4.040107671601615,0.0,0.0
17430,1,7430,[427 588  79  98 127],389,5,30023,4.040236845646615,20.0,20.0
17431,1,7431,[175 216 100 143 300],151,4,30027,4.040231431646932,0.0,20.0
17432,1,7432,[ 15  88 237 174 318],269,1,30028,4.039822413561146,20.0,0.0
17433,1,7433,[183  97  12  96 151],577,5,30033,4.039951573849879,0.0,0.0
17434,1,7434,[427 588  79  98 127],716,5,30038,4.040080699394754,20.0,20.0
17435,1,7435,[427 588  79  98 127],796,5,30043,4.04020979020979,20.0,20.0
17436,1,7436,[427 588  79  98 127],450,5,30048,4.0403388463089955,20.0,20.0
17437,1,7437,[427 588  79  98 127],716,5,30053,4.040467867706373,20.0,20.0
17438,1,7438,[181  70  69 100 216],450,5,30058,4.0405968544159165,0.0,20.0
17439,1,7439,[ 64 186 196 168   1],151,5,30063,4.040725806451613,20.0,0.0
17440,1,7440,[597  15 210 216 403],269,0,30063,4.040182771132912,0.0,0.0
17441,1,7441,[427 588  79  98 127],389,5,30068,4.040311744154797,20.0,20.0
17442,1,7442,[427 588  79  98 127],450,5,30073,4.040440682520489,20.0,20.0
17443,1,7443,[427 588  79  98 127],796,5,30078,4.040569586243955,20.0,20.0
17444,1,7444,[427 588  79  98 127],389,5,30083,4.040698455339154,20.0,20.0
17445,1,7445,[427 588  79  98 127],796,5,30088,4.0408272898200375,20.0,20.0
17446,1,7446,[427 588  79  98 127],796,5,30093,4.0409560897005505,20.0,20.0
17447,1,7447,[427 588  79  98 127],389,5,30098,4.041084854994629,20.0,20.0
17448,1,7448,[202 100   8  88 186],577,4,30102,4.041079339508659,0.0,20.0
17449,1,7449,[427 588  79  98 127],716,5,30107,4.041208053691276,20.0,20.0
17450,1,7450,[125 275 257 111 289],655,1,30108,4.040799892631862,0.0,20.0
17451,1,7451,[427 588  79  98 127],389,5,30113,4.04092860976919,20.0,20.0
17452,1,7452,[  8  95 423 405  64],796,5,30118,4.04105729236549,20.0,0.0
17453,1,7453,[265 132 568 168 275],450,5,30123,4.041185940434666,0.0,20.0
17454,1,7454,[435  56 268 202 173],629,5,30128,4.041314553990611,0.0,0.0
17455,1,7455,[427 588  79  98 127],450,5,30133,4.041443133047211,20.0,20.0
17456,1,7456,[210 748 186 144 273],450,2,30135,4.041169371060748,0.0,0.0
17457,1,7457,[427 588  79  98 127],389,5,30140,4.041297935103245,20.0,20.0
17458,1,7458,[204 173 282 181 183],450,5,30145,4.041426464673549,0.0,0.0
17459,1,7459,[  7 268 144 153 237],296,5,30150,4.041554959785523,0.0,0.0
17460,1,7460,[427 588  79  98 127],716,5,30155,4.0416834204530225,20.0,20.0
17461,1,7461,[  1 197  95 286 117],330,5,30160,4.041811846689895,0.0,20.0
17462,1,7462,[222 144 153 238 228],296,5,30165,4.041940238509983,0.0,0.0
17463,1,7463,[427 588  79  98 127],450,5,30170,4.042068595927117,20.0,20.0
17464,1,7464,[100   9 655 403  97],457,5,30175,4.042196918955124,0.0,20.0
17465,1,7465,[176 597 186  96 172],796,4,30179,4.042191267077418,0.0,0.0
17466,1,7466,[202  50 204   4  95],280,1,30180,4.0417838489353155,0.0,20.0
17467,1,7467,[427 588  79  98 127],18,5,30185,4.041912158543117,20.0,20.0
17468,1,7468,[127 125 301 222 174],344,4,30189,4.041906547061187,0.0,20.0
17469,1,7469,[427 588  79  98 127],450,5,30194,4.042034805890228,20.0,20.0
17470,1,7470,[427 588  79  98 127],796,5,30199,4.0421630303841525,20.0,20.0
17471,1,7471,[435  95 603 496 194],389,4,30203,4.0421573875803,40.0,0.0
17472,1,7472,[427 588  79  98 127],796,5,30208,4.042285561354208,20.0,20.0
17473,1,7473,[427 588  79  98 127],450,5,30213,4.042413700829543,20.0,20.0
17474,1,7474,[385 175  96 151 176],344,4,30217,4.042408026755853,0.0,0.0
17475,1,7475,[ 79 385 328  11  15],450,4,30221,4.042402354200107,0.0,0.0
17476,1,7476,[288 235  71 173 143],450,2,30223,4.042129196201685,0.0,0.0
17477,1,7477,[121 153 187   9 275],296,5,30228,4.042257288044932,0.0,20.0
17478,1,7478,[427 588  79  98 127],796,5,30233,4.042385345634443,20.0,20.0
17479,1,7479,[427 588  79  98 127],716,5,30238,4.042513368983958,20.0,20.0
17480,1,7480,[427 588  79  98 127],389,5,30243,4.042641358107205,20.0,20.0
17481,1,7481,[ 95 403 496  97 655],796,3,30246,4.042502004811547,20.0,0.0
17482,1,7482,[427 588  79  98 127],18,5,30251,4.04262996124549,20.0,20.0
17483,1,7483,[427 588  79  98 127],450,5,30256,4.042757883484768,20.0,20.0
17484,1,7484,[427 588  79  98 127],389,5,30261,4.042885771543086,20.0,20.0
17485,1,7485,[195  50 403 423 313],655,2,30263,4.042612877371092,0.0,20.0
17486,1,7486,[427 588  79  98 127],450,5,30268,4.042740750634433,20.0,20.0
17487,1,7487,[174 125 742 483 678],280,2,30270,4.042467948717949,0.0,0.0
17488,1,7488,[427 588  79  98 127],716,5,30275,4.0425958071838695,20.0,20.0
17489,1,7489,[427 588  79  98 127],18,5,30280,4.042723631508678,20.0,20.0
17490,1,7490,[427 588  79  98 127],716,5,30285,4.042851421706048,20.0,20.0
17491,1,7491,[153 202 273 357  82],450,3,30288,4.0427122263748,0.0,0.0
17492,1,7492,[427 588  79  98 127],796,5,30293,4.042839983985052,20.0,20.0
17493,1,7493,[546  28  50 471 172],786,5,30298,4.042967707499333,0.0,20.0
17494,1,7494,[172 275 271  15  88],796,5,30303,4.043095396931288,0.0,20.0
17495,1,7495,[427 588  79  98 127],450,5,30308,4.043223052294557,20.0,20.0
17496,1,7496,[403 237 161 215 238],457,5,30313,4.043350673602775,0.0,0.0
17497,1,7497,[ 79 185 176 172  25],655,3,30316,4.043211523072819,0.0,0.0
17498,1,7498,[210  79 153 302 435],535,3,30319,4.043072409654621,0.0,0.0
17499,1,7499,[748 228 678 172 121],256,3,30322,4.042933333333333,0.0,0.0
17500,1,7500,[ 71 546 144 100 216],280,3,30325,4.04279429409412,0.0,20.0
17501,1,7501,[238   4 204 282  88],457,5,30330,4.042921887496668,0.0,0.0
17502,1,7502,[427 588  79  98 127],796,5,30335,4.0430494468879115,20.0,20.0
17503,1,7503,[427 588  79  98 127],18,5,30340,4.04317697228145,20.0,20.0
17504,1,7504,[427 588  79  98 127],450,5,30345,4.043304463690872,20.0,20.0
17505,1,7505,[161 216 423   4 117],280,4,30349,4.043298694377831,0.0,0.0
17506,1,7506,[427 588  79  98 127],450,5,30354,4.043426135606767,20.0,20.0
17507,1,7507,[ 50 182 211   1  97],655,2,30356,4.043153969099627,0.0,20.0
17508,1,7508,[427 588  79  98 127],450,5,30361,4.043281395658543,20.0,20.0
17509,1,7509,[427 588  79  98 127],389,5,30366,4.0434087882822904,20.0,20.0
17510,1,7510,[385 144 471  71 273],401,2,30368,4.043136732791905,0.0,0.0
17511,1,7511,[427 588  79  98 127],716,5,30373,4.043264110756123,20.0,20.0
17512,1,7512,[168 235 405  97 153],401,1,30374,4.042859044323174,0.0,0.0
17513,1,7513,[  8  28 194 294 151],23,2,30376,4.042587170614852,0.0,0.0
17514,1,7514,[603  50 222 405 234],292,3,30379,4.042448436460412,20.0,20.0
17515,1,7515,[ 97 197 333 271  95],796,3,30382,4.042309739222991,0.0,0.0
17516,1,7516,[ 82 427 300 186 238],450,3,30385,4.042171078887854,20.0,0.0
17517,1,7517,[427 588  79  98 127],716,5,30390,4.042298483639266,20.0,20.0
17518,1,7518,[ 15 216 132 237   1],18,4,30394,4.042292858092831,0.0,0.0
17519,1,7519,[483 496 546 179 286],450,4,30398,4.042287234042553,20.0,20.0
17520,1,7520,[427 588  79  98 127],716,5,30403,4.042414572530249,20.0,20.0
17521,1,7521,[427 181 300 302  98],151,4,30407,4.042408933794204,20.0,0.0
17522,1,7522,[300 403 568 435 228],450,5,30412,4.042536222251761,0.0,0.0
17523,1,7523,[427 588  79  98 127],450,5,30417,4.0426634768740035,20.0,20.0
17524,1,7524,[427 588  79  98 127],450,5,30422,4.042790697674419,20.0,20.0
17525,1,7525,[ 70 318   4 427 235],716,3,30425,4.042652139250598,40.0,0.0
17526,1,7526,[200  28 265  89 318],796,4,30429,4.042646472698286,20.0,0.0
17527,1,7527,[143  79 117 153  97],593,5,30434,4.042773645058449,0.0,0.0
17528,1,7528,[427 588  79  98 127],389,5,30439,4.042900783636605,20.0,20.0
17529,1,7529,[427 588  79  98 127],18,5,30444,4.043027888446215,20.0,20.0
17530,1,7530,[ 15 427  88 215 127],450,4,30448,4.043022175009959,20.0,20.0
17531,1,7531,[ 50 127 302 235 405],344,3,30451,4.0428836962294215,0.0,40.0
17532,1,7532,[588 238 475 135   4],389,4,30455,4.04287800345148,0.0,0.0
17533,1,7533,[427 588  79  98 127],716,5,30460,4.0430050438014336,20.0,20.0
17534,1,7534,[427 588  79  98 127],389,5,30465,4.04313205043132,20.0,20.0
17535,1,7535,[357 172 194  96 135],457,5,30470,4.043259023354564,0.0,0.0
17536,1,7536,[202 204 276 216 289],786,4,30474,4.04325328379992,0.0,0.0
17537,1,7537,[222 215 127  89  88],655,2,30476,4.042982223401433,0.0,20.0
17538,1,7538,[ 96 204  79   9 187],72,5,30481,4.04310916567184,0.0,0.0
17539,1,7539,[ 82  70  95 288 471],280,3,30484,4.042970822281167,0.0,0.0
17540,1,7540,[427 588  79  98 127],450,5,30489,4.043097732396234,20.0,20.0
17541,1,7541,[427 588  79  98 127],716,5,30494,4.043224608857067,20.0,20.0
17542,1,7542,[216 191 313 196 174],796,5,30499,4.043351451677052,0.0,0.0
17543,1,7543,[427 588  79  98 127],796,5,30504,4.043478260869565,20.0,20.0
17544,1,7544,[282 185 427 234 215],716,4,30508,4.043472498343274,20.0,0.0
17545,1,7545,[427 588  79  98 127],450,5,30513,4.043599257884972,20.0,20.0
17546,1,7546,[427 588  79  98 127],389,5,30518,4.043725983834636,20.0,20.0
17547,1,7547,[427 588  79  98 127],716,5,30523,4.043852676205617,20.0,20.0
17548,1,7548,[ 50 603 185 237 182],535,4,30527,4.04384686713472,20.0,20.0
17549,1,7549,[427 588  79  98 127],796,5,30532,4.043973509933775,20.0,20.0
17550,1,7550,[  4  88  79  25 168],457,5,30537,4.044100119189511,0.0,0.0
17551,1,7551,[185 216 211 194 322],401,4,30541,4.044094279661017,0.0,0.0
17552,1,7552,[427 588  79  98 127],450,5,30546,4.044220839401563,20.0,20.0
17553,1,7553,[427 588  79  98 127],716,5,30551,4.044347365634101,20.0,20.0
17554,1,7554,[427 588  79  98 127],716,5,30556,4.044473858371939,20.0,20.0
17555,1,7555,[427 588  79  98 127],389,5,30561,4.044600317628375,20.0,20.0
17556,1,7556,[172 210 180 161  96],72,4,30565,4.044594415773455,0.0,0.0
17557,1,7557,[ 95 180 235 215 153],450,3,30568,4.0444562053453295,0.0,0.0
17558,1,7558,[427 588  79  98 127],796,5,30573,4.044582616748247,20.0,20.0
17559,1,7559,[282 403 318 200 204],504,3,30576,4.044444444444444,20.0,0.0
17560,1,7560,[427 588  79  98 127],450,5,30581,4.044570823965084,20.0,20.0
17561,1,7561,[427 588  79  98 127],450,5,30586,4.0446971700608305,20.0,20.0
17562,1,7562,[ 15 118 403 191 127],796,5,30591,4.044823482744943,0.0,20.0
17563,1,7563,[179 183 210 265 151],450,4,30595,4.044817556848228,0.0,0.0
17564,1,7564,[403 181 237  79 173],577,5,30600,4.044943820224719,0.0,0.0
17565,1,7565,[215 313 176 222 257],796,5,30605,4.045070050224689,0.0,0.0
17566,1,7566,[427 588  79  98 127],796,5,30610,4.045196246861372,20.0,20.0
17567,1,7567,[144  56  71 276 210],593,3,30613,4.045058139534884,0.0,0.0
17568,1,7568,[168  97 185 302  96],450,5,30618,4.045184304399524,0.0,0.0
17569,1,7569,[181 357 385 234 405],796,4,30622,4.045178335535007,0.0,0.0
17570,1,7570,[185 288 546 403  11],693,2,30624,4.044908202351077,0.0,0.0
17571,1,7571,[ 71 423 204 357 238],593,5,30629,4.045034337031168,0.0,0.0
17572,1,7572,[ 70 318 183  71 234],280,3,30632,4.0448963422685855,20.0,0.0
17573,1,7573,[427 588  79  98 127],450,5,30637,4.045022445207288,20.0,20.0
17574,1,7574,[427 588  79  98 127],716,5,30642,4.045148514851485,20.0,20.0
17575,1,7575,[427 588  79  98 127],796,5,30647,4.045274551214361,20.0,20.0
17576,1,7576,[318   8 275 168  50],457,5,30652,4.045400554309094,20.0,40.0
17577,1,7577,[257 475  70 286 222],655,0,30652,4.044866719451043,0.0,20.0
17578,1,7578,[ 97  56  15  12 282],450,4,30656,4.044860799577781,0.0,0.0
17579,1,7579,[427 588  79  98 127],389,5,30661,4.044986807387863,20.0,20.0
17580,1,7580,[238 435  79 471 322],450,5,30666,4.045112781954887,0.0,0.0
17581,1,7581,[132 186 182   1  50],457,5,30671,4.045238723292007,0.0,20.0
17582,1,7582,[427 588  79  98 127],389,5,30676,4.04536463141237,20.0,20.0
17583,1,7583,[237 286 202 179 471],786,5,30681,4.045490506329114,0.0,20.0
17584,1,7584,[427  50 568  56 204],450,5,30686,4.045616348055373,20.0,20.0
17585,1,7585,[427 588  79  98 127],716,5,30691,4.045742156604271,20.0,20.0
17586,1,7586,[204 603 294 185 196],401,4,30695,4.045736127586661,20.0,0.0
17587,1,7587,[427 588  79  98 127],796,5,30700,4.0458618871903,20.0,20.0
17588,1,7588,[427 588  79  98 127],716,5,30705,4.045987613651337,20.0,20.0
17589,1,7589,[427 588  79  98 127],716,5,30710,4.046113306982872,20.0,20.0
17590,1,7590,[427 588  79  98 127],450,5,30715,4.046238967197998,20.0,20.0
17591,1,7591,[427 588  79  98 127],796,5,30720,4.0463645943098,20.0,20.0
17592,1,7592,[300 294 257 222 237],655,0,30720,4.045831687080206,0.0,0.0
17593,1,7593,[118 216   1 168 423],174,1,30721,4.045430603107716,0.0,0.0
17594,1,7594,[132   1 597  71 222],450,3,30724,4.045292955892034,0.0,0.0
17595,1,7595,[742 196  56 191 111],11,4,30728,4.045286993154292,0.0,0.0
17596,1,7596,[ 22 180 153 210 121],796,3,30731,4.045149401079374,0.0,0.0
17597,1,7597,[588 405 173 195  22],457,5,30736,4.04527507238747,0.0,0.0
17598,1,7598,[ 96 153 174 125   9],796,4,30740,4.045269114357152,0.0,0.0
17599,1,7599,[423 204 427  28 194],236,3,30743,4.045131578947369,20.0,0.0
17600,1,7600,[427 588  79  98 127],716,5,30748,4.045257202999605,20.0,20.0
17601,1,7601,[174 286 222 191 117],450,4,30752,4.045251249671139,0.0,20.0
17602,1,7602,[ 88 179 496  79 194],577,3,30755,4.045113770879916,20.0,0.0
17603,1,7603,[427 588  79  98 127],450,5,30760,4.045239347711731,20.0,20.0
17604,1,7604,[427 588  79  98 127],796,5,30765,4.045364891518737,20.0,20.0
17605,1,7605,[427 588  79  98 127],716,5,30770,4.045490402313963,20.0,20.0
17606,1,7606,[423  71 196  96 215],450,4,30774,4.045484422242671,0.0,0.0
17607,1,7607,[427 588  79  98 127],18,5,30779,4.045609884332282,20.0,20.0
17608,1,7608,[427 588  79  98 127],450,5,30784,4.045735313444605,20.0,20.0
17609,1,7609,[191 483  64  28 385],655,3,30787,4.045597897503285,20.0,0.0
17610,1,7610,[151 118 385  97 196],457,5,30792,4.045723295230587,0.0,0.0
17611,1,7611,[127   8 742 423 172],280,4,30796,4.045717288491855,0.0,20.0
17612,1,7612,[276 117 222 127 185],457,5,30801,4.04584263759359,0.0,20.0
17613,1,7613,[275 191 245 265 234],796,3,30804,4.045705279747833,0.0,20.0
17614,1,7614,[ 28 117  89 174 200],796,4,30808,4.0456992777413,0.0,0.0
17615,1,7615,[427 588  79  98 127],18,5,30813,4.045824579831932,20.0,20.0
17616,1,7616,[ 25 185  15 117 222],450,2,30815,4.045555993173165,0.0,0.0
17617,1,7617,[427 588  79  98 127],450,5,30820,4.0456812811761615,20.0,20.0
17618,1,7618,[ 69 204 405  28 135],11,2,30822,4.0454127838298986,0.0,0.0
17619,1,7619,[111 196 228 403 125],457,4,30826,4.045406824146982,0.0,0.0
17620,1,7620,[427 588  79  98 127],716,5,30831,4.045532082403884,20.0,20.0
17621,1,7621,[286 191 215   8 125],152,5,30836,4.04565730779323,0.0,20.0
17622,1,7622,[427 588  79  98 127],389,5,30841,4.045782500327955,20.0,20.0
17623,1,7623,[427 588  79  98 127],796,5,30846,4.045907660020986,20.0,20.0
17624,1,7624,[427 588  79  98 127],716,5,30851,4.046032786885246,20.0,20.0
17625,1,7625,[ 11  88  64 195 144],457,5,30856,4.046157880933648,20.0,0.0
17626,1,7626,[508  95 117 118 423],280,3,30859,4.046020715877803,0.0,0.0
17627,1,7627,[427 588  79  98 127],18,5,30864,4.046145778710016,20.0,20.0
17628,1,7628,[427 588  79  98 127],796,5,30869,4.046270808756063,20.0,20.0
17629,1,7629,[427 588  79  98 127],716,5,30874,4.046395806028833,20.0,20.0
17630,1,7630,[265 174 471 172 151],807,5,30879,4.046520770541213,0.0,0.0
17631,1,7631,[427 588  79  98 127],450,5,30884,4.04664570230608,20.0,20.0
17632,1,7632,[427 588  79  98 127],716,5,30889,4.046770601336303,20.0,20.0
17633,1,7633,[427 588  79  98 127],450,5,30894,4.046895467644747,20.0,20.0
17634,1,7634,[  9 191 180 175 282],457,5,30899,4.047020301244269,0.0,0.0
17635,1,7635,[427 100  25 151 181],389,4,30903,4.047014143530644,20.0,20.0
17636,1,7636,[742  96 234 300 655],693,1,30904,4.046615163022129,0.0,0.0
17637,1,7637,[357 216 168 204 471],450,5,30909,4.046739984289081,0.0,0.0
17638,1,7638,[191 568 204 546 435],716,4,30913,4.046733865689227,0.0,0.0
17639,1,7639,[195 174 168 228 185],450,5,30918,4.046858638743456,0.0,0.0
17640,1,7640,[427 588  79  98 127],389,5,30923,4.046983379138856,20.0,20.0
17641,1,7641,[427 588  79  98 127],716,5,30928,4.047108086888249,20.0,20.0
17642,1,7642,[427 588  79  98 127],18,5,30933,4.047232762004448,20.0,20.0
17643,1,7643,[427 588  79  98 127],450,5,30938,4.047357404500262,20.0,20.0
17644,1,7644,[187 186  11 202 174],450,4,30942,4.047351209941138,0.0,0.0
17645,1,7645,[194 546  97  22 427],716,4,30946,4.047345017002354,20.0,0.0
17646,1,7646,[427 588  79  98 127],796,5,30951,4.047469595919969,20.0,20.0
17647,1,7647,[471 228 211  15  69],786,4,30955,4.047463389121339,0.0,0.0
17648,1,7648,[ 71 181 655 132  69],236,3,30958,4.047326447901686,0.0,0.0
17649,1,7649,[ 82  50 238  98 216],18,4,30962,4.047320261437909,0.0,20.0
17650,1,7650,[ 28  11  79 176 186],693,2,30964,4.047052672853222,0.0,0.0
17651,1,7651,[427 588  79  98 127],716,5,30969,4.047177208572922,20.0,20.0
17652,1,7652,[100  71 202 181   7],23,3,30972,4.047040376323011,0.0,20.0
17653,1,7653,[118 258 196  69 222],655,0,30972,4.046511627906977,0.0,0.0
17654,1,7654,[318 423 121 234 322],786,2,30974,4.046244284781189,20.0,0.0
17655,1,7655,[187  70  25 111 228],716,4,30978,4.0462382445141065,0.0,0.0
17656,1,7656,[427 588  79  98 127],18,5,30983,4.0463628052762175,20.0,20.0
17657,1,7657,[ 97 265  28 202 161],716,4,30987,4.0463567511099505,0.0,0.0
17658,1,7658,[427 588  79  98 127],389,5,30992,4.046481263872568,20.0,20.0
17659,1,7659,[318 275 168   8 282],457,5,30997,4.046605744125326,20.0,20.0
17660,1,7660,[427 588  79  98 127],389,5,31002,4.046730191880956,20.0,20.0
17661,1,7661,[427 588  79  98 127],450,5,31007,4.04685460715218,20.0,20.0
17662,1,7662,[195  22 603 568 483],269,2,31009,4.046587498368785,20.0,0.0
17663,1,7663,[ 11 228 196 215 357],344,3,31012,4.046450939457203,0.0,0.0
17664,1,7664,[180 748  11 228 268],11,1,31013,4.046053489889107,0.0,0.0
17665,1,7665,[427 588  79  98 127],450,5,31018,4.046177928515523,20.0,20.0
17666,1,7666,[427 588  79  98 127],796,5,31023,4.0463023346811005,20.0,20.0
17667,1,7667,[427 588  79  98 127],18,5,31028,4.046426708398539,20.0,20.0
17668,1,7668,[117 237 172 132  95],716,5,31033,4.046551049680532,0.0,0.0
17669,1,7669,[111 748  79 313 197],796,4,31037,4.046544980443286,0.0,0.0
17670,1,7670,[427 588  79  98 127],389,5,31042,4.046669273888671,20.0,20.0
17671,1,7671,[427 588  79  98 127],796,5,31047,4.046793534932221,20.0,20.0
17672,1,7672,[ 56 151  96 235 288],292,3,31050,4.046657109344455,0.0,0.0
17673,1,7673,[427 588  79  98 127],450,5,31055,4.04678133958822,20.0,20.0
17674,1,7674,[427 588  79  98 127],18,5,31060,4.046905537459283,20.0,20.0
17675,1,7675,[265  70  12 483 125],450,4,31064,4.046899426784783,0.0,0.0
17676,1,7676,[216 302  97  15 179],450,4,31068,4.046893317702227,0.0,0.0
17677,1,7677,[427 588  79  98 127],716,5,31073,4.047017452461579,20.0,20.0
17678,1,7678,[215  96 183 258 301],450,5,31078,4.04714155488996,0.0,0.0
17679,1,7679,[427 588  79  98 127],796,5,31083,4.047265625,20.0,20.0
17680,1,7680,[176 172 423 195 435],450,5,31088,4.047389662804322,0.0,0.0
17681,1,7681,[427 588  79  98 127],450,5,31093,4.047513668315543,20.0,20.0
17682,1,7682,[153 197 200 194 186],151,3,31096,4.047377326565144,0.0,0.0
17683,1,7683,[427 588  79  98 127],450,5,31101,4.047501301405518,20.0,20.0
17684,1,7684,[427 588  79  98 127],450,5,31106,4.047625243981782,20.0,20.0
17685,1,7685,[427 588  79  98 127],796,5,31111,4.047749154306532,20.0,20.0
17686,1,7686,[ 12 174 127  25 222],344,5,31116,4.047873032392351,0.0,20.0
17687,1,7687,[121 182   1 153 118],593,3,31119,4.04773673257024,0.0,0.0
17688,1,7688,[269 403 276  71 195],18,3,31122,4.047600468201327,0.0,0.0
17689,1,7689,[195  25 143  79  50],151,4,31126,4.047594278283485,0.0,20.0
17690,1,7690,[197 322 496 151  79],151,4,31130,4.047588089975296,20.0,0.0
17691,1,7691,[ 50 121 197 196 238],151,5,31135,4.047711908476339,0.0,20.0
17692,1,7692,[603 258 144  71 483],535,4,31139,4.047705706486417,20.0,0.0
17693,1,7693,[427 588  79  98 127],716,5,31144,4.047829477514947,20.0,20.0
17694,1,7694,[427 588  79  98 127],389,5,31149,4.047953216374269,20.0,20.0
17695,1,7695,[ 12  15 568  69 210],796,4,31153,4.047946985446986,0.0,0.0
17696,1,7696,[ 22 496 153 174 161],796,5,31158,4.048070676887098,20.0,0.0
17697,1,7697,[427 588  79  98 127],796,5,31163,4.0481943361912185,20.0,20.0
17698,1,7698,[423 294   9 483 174],236,3,31166,4.048058189375244,0.0,0.0
17699,1,7699,[385 176 235 172 161],457,4,31170,4.048051948051948,0.0,0.0
17700,1,7700,[194 215  96 191 265],716,4,31174,4.048045708349565,0.0,0.0
17701,1,7701,[  8 282 435 176 118],655,0,31174,4.04752012464295,0.0,0.0
17702,1,7702,[427 588  79  98 127],796,5,31179,4.047643775152538,20.0,20.0
17703,1,7703,[186 204 173 357 125],786,5,31184,4.047767393561786,0.0,0.0
17704,1,7704,[ 22 117   4 215 245],450,4,31188,4.04776119402985,0.0,0.0
17705,1,7705,[357 143 496 144 100],796,4,31192,4.04775499610693,20.0,20.0
17706,1,7706,[  8 143  25 191 196],655,2,31194,4.047489295445699,0.0,0.0
17707,1,7707,[195 125 174  98 181],292,4,31198,4.047483134405812,0.0,0.0
17708,1,7708,[127 357  70 161 275],716,4,31202,4.047476974964328,0.0,40.0
17709,1,7709,[111 269 496  64 204],450,5,31207,4.047600518806744,40.0,0.0
17710,1,7710,[427 588  79  98 127],389,5,31212,4.047724030605628,20.0,20.0
17711,1,7711,[427 588  79  98 127],18,5,31217,4.047847510373444,20.0,20.0
17712,1,7712,[191 215 168  79 269],450,5,31222,4.04797095812265,0.0,0.0
17713,1,7713,[427 588  79  98 127],450,5,31227,4.048094373865699,20.0,20.0
17714,1,7714,[427 588  79  98 127],389,5,31232,4.048217757615036,20.0,20.0
17715,1,7715,[245 172 234  79  25],256,4,31236,4.0482115085536545,0.0,0.0
17716,1,7716,[ 25 286  56 301  89],655,1,31237,4.047816509006091,0.0,20.0
17717,1,7717,[427 588  79  98 127],716,5,31242,4.047939880798134,20.0,20.0
17718,1,7718,[427 588  79  98 127],389,5,31247,4.048063220624433,20.0,20.0
17719,1,7719,[204 100 282 257 174],796,4,31251,4.048056994818653,0.0,20.0
17720,1,7720,[265 135 435 318   1],807,4,31255,4.048050770625567,20.0,0.0
17721,1,7721,[  4  71 153 210 276],535,3,31258,4.047915047915048,0.0,0.0
17722,1,7722,[427 588  79  98 127],716,5,31263,4.048038327074971,20.0,20.0
17723,1,7723,[427 588  79  98 127],389,5,31268,4.048161574313827,20.0,20.0
17724,1,7724,[427 588  79  98 127],716,5,31273,4.048284789644013,20.0,20.0
17725,1,7725,[180 117 153 161 183],796,4,31277,4.048278539994823,0.0,0.0
17726,1,7726,[187 183  97 202 200],450,4,31281,4.0482722919632455,0.0,0.0
17727,1,7727,[427 588  79  98 127],389,5,31286,4.048395445134576,20.0,20.0
17728,1,7728,[427 588  79  98 127],716,5,31291,4.048518566438091,20.0,20.0
17729,1,7729,[228 173 182 179  11],450,5,31296,4.048641655886158,0.0,0.0
17730,1,7730,[ 64 403  56 127 118],693,2,31298,4.048376665373173,20.0,20.0
17731,1,7731,[202 405 186 588  97],457,5,31303,4.048499741334713,0.0,0.0
17732,1,7732,[294 496   7 237 313],450,5,31308,4.04862278546489,20.0,0.0
17733,1,7733,[427 588  79  98 127],716,5,31313,4.0487457977760535,20.0,20.0
17734,1,7734,[238 216 211 471  69],786,5,31318,4.048868778280543,0.0,0.0
17735,1,7735,[301 328 475 215 508],655,0,31318,4.048345398138573,0.0,0.0
17736,1,7736,[  1  89 195 191 234],786,4,31322,4.048339149541166,0.0,0.0
17737,1,7737,[427 588  79  98 127],716,5,31327,4.048462134918584,20.0,20.0
17738,1,7738,[427 588  79  98 127],389,5,31332,4.048585088512728,20.0,20.0
17739,1,7739,[ 97 471 172   9 237],457,5,31337,4.048708010335917,0.0,0.0
17740,1,7740,[195 172 125  89 228],344,4,31341,4.048701718124273,0.0,0.0
17741,1,7741,[  4 183 471 568 197],457,5,31346,4.048824593128391,0.0,0.0
17742,1,7742,[ 28  70 313 118 748],450,4,31350,4.048818287485471,0.0,0.0
17743,1,7743,[318 168 245 423 100],450,5,31355,4.04894111570248,20.0,20.0
17744,1,7744,[ 89 121 301 269 237],796,3,31358,4.048805681084571,0.0,0.0
17745,1,7745,[197   9 121 603 276],535,4,31362,4.048799380325329,20.0,0.0
17746,1,7746,[121 211 301 496 195],535,5,31367,4.048922163418097,20.0,0.0
17747,1,7747,[427 588  79  98 127],389,5,31372,4.049044914816727,20.0,20.0
17748,1,7748,[127 132 282  15 168],457,5,31377,4.049167634533489,0.0,20.0
17749,1,7749,[427 588  79  98 127],18,5,31382,4.049290322580645,20.0,20.0
17750,1,7750,[546  12 289 508 117],693,2,31384,4.049025932137789,0.0,0.0
17751,1,7751,[427 588  79  98 127],450,5,31389,4.049148606811145,20.0,20.0
17752,1,7752,[427 588  79  98 127],389,5,31394,4.049271249838772,20.0,20.0
17753,1,7753,[301   9 176 228 568],655,0,31394,4.048749032757287,0.0,0.0
17754,1,7754,[427 588  79  98 127],716,5,31399,4.048871695680206,20.0,20.0
17755,1,7755,[125   9 100 258 235],457,4,31403,4.048865394533265,0.0,20.0
17756,1,7756,[ 88  97 111 385  79],457,4,31407,4.0488590950109575,0.0,0.0
17757,1,7757,[ 88 234 132 191 423],786,4,31411,4.048852797112658,0.0,0.0
17758,1,7758,[742 172  25 194 196],450,4,31415,4.048846500837737,0.0,0.0
17759,1,7759,[427 588  79  98 127],450,5,31420,4.048969072164948,20.0,20.0
17760,1,7760,[282 546 118 405 403],796,5,31425,4.049091611905682,0.0,0.0
17761,1,7761,[118 275 117 181 357],655,2,31427,4.048827621746972,0.0,20.0
17762,1,7762,[427 588  79  98 127],716,5,31432,4.048950148138606,20.0,20.0
17763,1,7763,[427 588  79  98 127],389,5,31437,4.049072642967542,20.0,20.0
17764,1,7764,[496 195 176   4 483],450,3,31440,4.048937540244688,20.0,0.0
17765,1,7765,[427 588  79  98 127],450,5,31445,4.049060005150657,20.0,20.0
17766,1,7766,[427 588  79  98 127],450,5,31450,4.049182438521952,20.0,20.0
17767,1,7767,[ 79 597 405 172 357],457,4,31454,4.049176107106076,0.0,0.0
17768,1,7768,[427 588  79  98 127],18,5,31459,4.049298494014674,20.0,20.0
17769,1,7769,[427 588  79  98 127],450,5,31464,4.04942084942085,20.0,20.0
17770,1,7770,[427 588  79  98 127],796,5,31469,4.049543173336765,20.0,20.0
17771,1,7771,[294 215  12 202 258],655,0,31469,4.049022130725682,0.0,0.0
17772,1,7772,[ 69 258 127 597 245],344,1,31470,4.048629872636048,0.0,20.0
17773,1,7773,[427 588  79  98 127],796,5,31475,4.048752251093388,20.0,20.0
17774,1,7774,[427 588  79  98 127],450,5,31480,4.048874598070739,20.0,20.0
17775,1,7775,[222   1 197 423  56],716,5,31485,4.048996913580247,0.0,0.0
17776,1,7776,[427 588  79  98 127],796,5,31490,4.049119197634049,20.0,20.0
17777,1,7777,[427 588  79  98 127],389,5,31495,4.049241450244279,20.0,20.0
17778,1,7778,[427 588  79  98 127],450,5,31500,4.0493636714230625,20.0,20.0
17779,1,7779,[427 588  79  98 127],389,5,31505,4.049485861182519,20.0,20.0
17780,1,7780,[427 588  79  98 127],796,5,31510,4.049608019534764,20.0,20.0
17781,1,7781,[ 71 294 125  15 235],450,2,31512,4.04934464148034,0.0,0.0
17782,1,7782,[191 182 187  64 427],389,5,31517,4.049466786586149,40.0,0.0
17783,1,7783,[294 403   9 322 132],796,2,31519,4.049203494347379,0.0,0.0
17784,1,7784,[273 144 301  28 546],796,2,31521,4.048940269749519,0.0,0.0
17785,1,7785,[211   7 313 515 153],296,5,31526,4.049062419727717,0.0,0.0
17786,1,7786,[385 237  64 235  79],256,4,31530,4.049056119172981,20.0,0.0
17787,1,7787,[471  15 286 313  79],450,4,31534,4.049049820236261,0.0,20.0
17788,1,7788,[237  89 215   4  64],796,5,31539,4.04917190910258,20.0,0.0
17789,1,7789,[471 228 655 282  70],280,1,31540,4.048780487804878,0.0,0.0
17790,1,7790,[194 168 196 546 153],504,3,31543,4.048645873443717,0.0,0.0
17791,1,7791,[276  71 195 200  95],280,4,31547,4.048639630390143,0.0,0.0
17792,1,7792,[427 588  79  98 127],18,5,31552,4.048761709226229,20.0,20.0
17793,1,7793,[427 588  79  98 127],796,5,31557,4.04888375673595,20.0,20.0
17794,1,7794,[427 588  79  98 127],389,5,31562,4.049005772931366,20.0,20.0
17795,1,7795,[427 588  79  98 127],716,5,31567,4.049127757824525,20.0,20.0
17796,1,7796,[318 100   1 181 603],401,3,31570,4.048993202513787,40.0,20.0
17797,1,7797,[216 151 174 282 273],236,2,31572,4.048730443703514,0.0,0.0
17798,1,7798,[427 588  79  98 127],796,5,31577,4.048852416976535,20.0,20.0
17799,1,7799,[427 588  79  98 127],450,5,31582,4.048974358974359,20.0,20.0
17800,1,7800,[191 275 333 475 318],655,3,31585,4.048839892321498,20.0,20.0
17801,1,7801,[175 144 194 174  25],716,3,31588,4.048705460138426,0.0,0.0
17802,1,7802,[357 179 195 161 302],655,3,31591,4.0485710624118925,0.0,0.0
17803,1,7803,[  9 202 183 568   1],344,4,31595,4.048564838544336,0.0,0.0
17804,1,7804,[179 211 168 197  82],269,4,31599,4.048558616271621,0.0,0.0
17805,1,7805,[196 132 597 238 187],796,4,31603,4.048552395593133,0.0,0.0
17806,1,7806,[427 588  79  98 127],716,5,31608,4.048674266683745,20.0,20.0
17807,1,7807,[153 237 300 143 211],716,5,31613,4.048796106557377,0.0,0.0
17808,1,7808,[328 403 173 121 568],796,5,31618,4.0489179152260215,0.0,0.0
17809,1,7809,[197 235 168 234   7],269,2,31620,4.048655569782331,0.0,0.0
17810,1,7810,[427 588  79  98 127],796,5,31625,4.048777365254129,20.0,20.0
17811,1,7811,[194 143 742  25 172],450,4,31629,4.048771121351766,0.0,0.0
17812,1,7812,[204 234 313  96  98],450,4,31633,4.048764879047741,0.0,0.0
17813,1,7813,[427 588  79  98 127],716,5,31638,4.048886613770156,20.0,20.0
17814,1,7814,[ 98 427 202  28 257],330,5,31643,4.049008317338452,20.0,0.0
17815,1,7815,[427 588  79  98 127],389,5,31648,4.049129989764586,20.0,20.0
17816,1,7816,[508 333 210 180 357],693,1,31649,4.048739925802738,0.0,0.0
17817,1,7817,[427 588  79  98 127],18,5,31654,4.048861601432591,20.0,20.0
17818,1,7818,[427 588  79  98 127],450,5,31659,4.048983245939379,20.0,20.0
17819,1,7819,[427 588  79  98 127],716,5,31664,4.0491048593350385,20.0,20.0
17820,1,7820,[508 153   9 211 197],269,4,31668,4.04909858074415,0.0,0.0
17821,1,7821,[427 588  79  98 127],389,5,31673,4.049220148299668,20.0,20.0
17822,1,7822,[174 204 258 245 357],629,4,31677,4.049213856576761,0.0,0.0
17823,1,7823,[  1 195 100 403 204],655,0,31677,4.048696319018405,0.0,20.0
17824,1,7824,[211   1 276 179  69],18,4,31681,4.048690095846645,0.0,0.0
17825,1,7825,[427 588  79  98 127],18,5,31686,4.048811653462816,20.0,20.0
17826,1,7826,[282 515  15  88  11],655,1,31687,4.04842212852945,0.0,0.0
17827,1,7827,[182  70 471  22 483],457,5,31692,4.048543689320389,0.0,0.0
17828,1,7828,[427 588  79  98 127],389,5,31697,4.048665219057351,20.0,20.0
17829,1,7829,[318   8 161  70 423],655,1,31698,4.048275862068966,20.0,0.0
17830,1,7830,[427 588  79  98 127],389,5,31703,4.048397394968714,20.0,20.0
17831,1,7831,[  1 132 742 228  95],796,3,31706,4.048263534218591,0.0,0.0
17832,1,7832,[328 357 180 235 191],450,4,31710,4.048257372654155,0.0,0.0
17833,1,7833,[427 588  79  98 127],796,5,31715,4.0483788613735,20.0,20.0
17834,1,7834,[210 603 286 655 172],401,2,31717,4.048117421825143,20.0,20.0
17835,1,7835,[ 11 300 546 228 282],716,3,31720,4.047983665135273,0.0,0.0
17836,1,7836,[427 588  79  98 127],796,5,31725,4.04810514227383,20.0,20.0
17837,1,7837,[186  82 117  98  64],716,4,31729,4.048099004848176,20.0,0.0
17838,1,7838,[427 588  79  98 127],389,5,31734,4.048220436280138,20.0,20.0
17839,1,7839,[427 588  79  98 127],796,5,31739,4.048341836734694,20.0,20.0
17840,1,7840,[176  96  11 196 546],457,4,31743,4.0483356714704755,0.0,0.0
17841,1,7841,[265   4 180 204 197],457,5,31748,4.048457026268809,0.0,0.0
17842,1,7842,[427 588  79  98 127],389,5,31753,4.048578350121127,20.0,20.0
17843,1,7843,[427 588  79  98 127],716,5,31758,4.048699643039265,20.0,20.0
17844,1,7844,[427 588  79  98 127],796,5,31763,4.048820905035054,20.0,20.0
17845,1,7845,[427 588  79  98 127],18,5,31768,4.048942136120316,20.0,20.0
17846,1,7846,[176 117 655 357 237],72,3,31771,4.0488084618325475,0.0,0.0
17847,1,7847,[427 588  79  98 127],716,5,31776,4.048929663608563,20.0,20.0
17848,1,7848,[328 385 423 322 195],151,1,31777,4.048541215441458,0.0,0.0
17849,1,7849,[742 151 174 405 403],256,5,31782,4.048662420382166,0.0,0.0
17850,1,7850,[210 568 143 427 742],693,3,31785,4.048528849828047,20.0,0.0
17851,1,7851,[234 143 202  28  64],389,4,31789,4.048522669383597,20.0,0.0
17852,1,7852,[118 222   7 265  56],256,4,31793,4.04851649051318,0.0,0.0
17853,1,7853,[  9 143  97  98 300],655,2,31795,4.048255665902725,0.0,0.0
17854,1,7854,[204   1  98 269  70],344,3,31798,4.048122215149586,0.0,0.0
17855,1,7855,[427 588  79  98 127],18,5,31803,4.048243380855397,20.0,20.0
17856,1,7856,[427 588  79  98 127],450,5,31808,4.048364515718467,20.0,20.0
17857,1,7857,[427 588  79  98 127],716,5,31813,4.048485619750573,20.0,20.0
17858,1,7858,[427 588  79  98 127],716,5,31818,4.048606692963482,20.0,20.0
17859,1,7859,[318  69 196 286 228],450,5,31823,4.048727735368956,20.0,20.0
17860,1,7860,[588 257 742 546 357],796,4,31827,4.048721536700166,0.0,0.0
17861,1,7861,[427 588  79  98 127],796,5,31832,4.048842533706436,20.0,20.0
17862,1,7862,[ 28 275 204 215 144],716,4,31836,4.048836322014498,0.0,20.0
17863,1,7863,[427 588  79  98 127],450,5,31841,4.048957273652086,20.0,20.0
17864,1,7864,[ 97  50 546  98 204],796,4,31845,4.048951048951049,0.0,20.0
17865,1,7865,[ 96 185 176   7 568],457,5,31850,4.049071955250445,0.0,0.0
17866,1,7866,[427 588  79  98 127],389,5,31855,4.049192830812253,20.0,20.0
17867,1,7867,[275   1 288 125 496],593,3,31858,4.049059481443823,20.0,20.0
17868,1,7868,[245  79  22 496 204],280,3,31861,4.048926165967721,20.0,0.0
17869,1,7869,[435 210 204  96  50],807,3,31864,4.0487928843710295,0.0,20.0
17870,1,7870,[357 234 186  50 195],151,4,31868,4.04878668530047,0.0,20.0
17871,1,7871,[127 117 294 194 603],716,5,31873,4.048907520325203,20.0,20.0
17872,1,7872,[168 182  50 568 179],389,4,31877,4.048901308268767,0.0,20.0
17873,1,7873,[228  82 174 313 546],807,5,31882,4.049022098044196,0.0,0.0
17874,1,7874,[ 95  50  15  82 194],798,5,31887,4.049142857142857,0.0,20.0
17875,1,7875,[271 258 132 257 237],655,0,31887,4.04862874555612,0.0,0.0
17876,1,7876,[153  50  28 568  64],330,5,31892,4.0487495239304305,20.0,20.0
17877,1,7877,[328 318 191 357  56],450,5,31897,4.048870271642549,20.0,0.0
17878,1,7878,[427 588  79  98 127],716,5,31902,4.04899098870415,20.0,20.0
17879,1,7879,[288   4 273 655 300],450,2,31904,4.048730964467005,0.0,0.0
17880,1,7880,[427 588  79  98 127],389,5,31909,4.048851668569978,20.0,20.0
17881,1,7881,[588 655 117  22 678],280,3,31912,4.048718599340269,0.0,0.0
17882,1,7882,[275 211 300 435  95],450,4,31916,4.048712419129773,0.0,20.0
17883,1,7883,[197 276  79 268  15],655,2,31918,4.048452562151192,0.0,0.0
17884,1,7884,[ 98 172 427 174 173],269,2,31920,4.048192771084337,20.0,0.0
17885,1,7885,[117 322 210 179 238],593,3,31923,4.04805985290388,0.0,0.0
17886,1,7886,[  4 132  82  71 176],796,4,31927,4.048053759350831,0.0,0.0
17887,1,7887,[427 588  79  98 127],450,5,31932,4.048174442190669,20.0,20.0
17888,1,7888,[153 483  50 121 168],401,1,31933,4.047788059323108,0.0,20.0
17889,1,7889,[245 496 100 333  89],796,3,31936,4.047655259822561,20.0,20.0
17890,1,7890,[427 588  79  98 127],389,5,31941,4.047775947281713,20.0,20.0
17891,1,7891,[427 588  79  98 127],716,5,31946,4.047896604156107,20.0,20.0
17892,1,7892,[427 588  79  98 127],389,5,31951,4.048017230457368,20.0,20.0
17893,1,7893,[427 588  79  98 127],796,5,31956,4.048137826197112,20.0,20.0
17894,1,7894,[427 588  79  98 127],18,5,31961,4.048258391386954,20.0,20.0
17895,1,7895,[ 79 117 194 197  12],450,5,31966,4.048378926038501,0.0,0.0
17896,1,7896,[153 195  56 238 186],504,1,31967,4.047992908699507,0.0,0.0
17897,1,7897,[237 151 144  50 185],716,4,31971,4.047986832109395,0.0,20.0
17898,1,7898,[174 301 111  15 275],796,4,31975,4.047980757057855,0.0,20.0
17899,1,7899,[  1 275 196  97 181],716,5,31980,4.048101265822785,0.0,20.0
17900,1,7900,[427 588  79  98 127],389,5,31985,4.048221744083027,20.0,20.0
17901,1,7901,[427 588  79  98 127],389,5,31990,4.048342191850164,20.0,20.0
17902,1,7902,[222 121 172 196 185],450,3,31993,4.048209540680754,0.0,0.0
17903,1,7903,[151 100  96 111 222],450,4,31997,4.048203441295547,0.0,20.0
17904,1,7904,[210 222 258 328 174],450,3,32000,4.0480708412397215,0.0,0.0
17905,1,7905,[  7 276   4  70 117],786,4,32004,4.048064760941058,0.0,0.0
17906,1,7906,[742 423 318  11 191],693,2,32006,4.047805741747818,20.0,0.0
17907,1,7907,[318  15  70 175 196],655,1,32007,4.04742033383915,20.0,0.0
17908,1,7908,[427 588  79  98 127],18,5,32012,4.047540776330762,20.0,20.0
17909,1,7909,[427 588  79  98 127],389,5,32017,4.047661188369153,20.0,20.0
17910,1,7910,[ 15 257 180 405 196],457,4,32021,4.0476551636961196,0.0,0.0
17911,1,7911,[186  28 403 423 182],450,4,32025,4.047649140546006,0.0,0.0
17912,1,7912,[  1 257 276 237 275],457,4,32029,4.047643118918236,0.0,20.0
17913,1,7913,[183 318  96 172 508],655,3,32032,4.047510740459944,20.0,0.0
17914,1,7914,[111 143 176 222 185],796,5,32037,4.047631080227417,0.0,0.0
17915,1,7915,[ 82 228 144  89 180],796,3,32040,4.047498736735725,0.0,0.0
17916,1,7916,[195 258 288  70  64],457,5,32045,4.0476190476190474,20.0,0.0
17917,1,7917,[187 197 435  69 423],716,4,32049,4.047613033594342,0.0,0.0
17918,1,7918,[427 588  79  98 127],796,5,32054,4.047733299659048,20.0,20.0
17919,1,7919,[427 588  79  98 127],450,5,32059,4.047853535353536,20.0,20.0
17920,1,7920,[427 588  79  98 127],796,5,32064,4.047973740689307,20.0,20.0
17921,1,7921,[186 211   9   4 176],796,2,32066,4.047715223428427,0.0,0.0
17922,1,7922,[ 95 181 294 183 216],577,5,32071,4.047835415877824,0.0,0.0
17923,1,7923,[216 427 276 515  89],18,4,32075,4.047829379101464,20.0,0.0
17924,1,7924,[427 588  79  98 127],716,5,32080,4.0479495268138805,20.0,20.0
17925,1,7925,[174 186 100  69 313],450,4,32084,4.047943477163765,0.0,20.0
17926,1,7926,[427 588  79  98 127],18,5,32089,4.0480635801690426,20.0,20.0
17927,1,7927,[300 427 151 275  28],450,5,32094,4.048183652875883,20.0,20.0
17928,1,7928,[180 202 215 211 143],504,4,32098,4.048177575986884,0.0,0.0
17929,1,7929,[216 289  69  96 127],655,2,32100,4.047919293820933,0.0,20.0
17930,1,7930,[427 588  79  98 127],389,5,32105,4.048039339301475,20.0,20.0
17931,1,7931,[427 588  79  98 127],389,5,32110,4.048159354513364,20.0,20.0
17932,1,7932,[427 588  79  98 127],796,5,32115,4.048279339468045,20.0,20.0
17933,1,7933,[132 496 211 210 153],151,4,32119,4.048273254348374,20.0,0.0
17934,1,7934,[ 50 204 181 173 302],450,5,32124,4.048393194706994,0.0,20.0
17935,1,7935,[427 588  79  98 127],716,5,32129,4.04851310483871,20.0,20.0
17936,1,7936,[427 588  79  98 127],389,5,32134,4.048632984754946,20.0,20.0
17937,1,7937,[427 588  79  98 127],716,5,32139,4.04875283446712,20.0,20.0
17938,1,7938,[496 125 173 176  71],450,4,32143,4.048746693538229,20.0,0.0
17939,1,7939,[427 588  79  98 127],389,5,32148,4.048866498740554,20.0,20.0
17940,1,7940,[403 748 265  97  98],796,4,32152,4.048860345044704,0.0,0.0
17941,1,7941,[294 333 187 275 179],236,0,32152,4.048350541425334,0.0,20.0
17942,1,7942,[427 588  79  98 127],716,5,32157,4.048470351252675,20.0,20.0
17943,1,7943,[427 588  79  98 127],389,5,32162,4.0485901309164145,20.0,20.0
17944,1,7944,[427 588  79  98 127],18,5,32167,4.048709880427942,20.0,20.0
17945,1,7945,[427 588  79  98 127],716,5,32172,4.0488295997986405,20.0,20.0
17946,1,7946,[427 588  79  98 127],389,5,32177,4.048949289039889,20.0,20.0
17947,1,7947,[173 118 289 210   8],756,3,32180,4.048817312531455,0.0,0.0
17948,1,7948,[427 588  79  98 127],389,5,32185,4.048936973204176,20.0,20.0
17949,1,7949,[238 185 100 183 176],504,2,32187,4.048679245283019,0.0,20.0
17950,1,7950,[180  97  25  15 403],457,5,32192,4.048798893220979,0.0,0.0
17951,1,7951,[405 288  50  25 127],256,5,32197,4.0489185110663986,0.0,40.0
17952,1,7952,[179 132 183 588 151],450,5,32202,4.04903809883063,0.0,0.0
17953,1,7953,[427 588  79  98 127],716,5,32207,4.0491576565250185,20.0,20.0
17954,1,7954,[427 588  79  98 127],389,5,32212,4.049277184160905,20.0,20.0
17955,1,7955,[427 588  79  98 127],716,5,32217,4.049396681749623,20.0,20.0
17956,1,7956,[427 588  79  98 127],450,5,32222,4.049516149302501,20.0,20.0
17957,1,7957,[ 89 496 275 357 161],796,5,32227,4.049635586830862,20.0,20.0
17958,1,7958,[655  96 183  95 173],577,5,32232,4.049754994346023,0.0,0.0
17959,1,7959,[385  15 125 182  22],256,5,32237,4.049874371859296,0.0,0.0
17960,1,7960,[288 181 235 125 183],344,2,32239,4.049616882301218,0.0,0.0
17961,1,7961,[  4 385 125 176 202],796,5,32244,4.049736247174077,0.0,0.0
17962,1,7962,[427 588  79  98 127],716,5,32249,4.04985558206706,20.0,20.0
17963,1,7963,[403 215 161  64 423],450,5,32254,4.049974886991461,20.0,0.0
17964,1,7964,[174 655 238  25 132],151,5,32259,4.050094161958569,0.0,0.0
17965,1,7965,[427 588  79  98 127],389,5,32264,4.050213406979664,20.0,20.0
17966,1,7966,[427 588  79  98 127],389,5,32269,4.050332622066023,20.0,20.0
17967,1,7967,[197 204 172 118  11],457,5,32274,4.0504518072289155,0.0,0.0
17968,1,7968,[427 588  79  98 127],389,5,32279,4.0505709624796085,20.0,20.0
17969,1,7969,[111 742 216 210  12],174,5,32284,4.05069008782936,0.0,0.0
17970,1,7970,[427 588  79  98 127],389,5,32289,4.050809183289424,20.0,20.0
17971,1,7971,[427 588  79  98 127],796,5,32294,4.050928248871049,20.0,20.0
17972,1,7972,[748 237   7 678   1],15,0,32294,4.050420168067227,0.0,0.0
17973,1,7973,[ 56 200 127  28 117],457,5,32299,4.0505392525708555,0.0,20.0
17974,1,7974,[385 200 183 276 174],593,4,32303,4.050532915360502,0.0,0.0
17975,1,7975,[216 185 127   1 187],835,4,32307,4.050526579739218,0.0,20.0
17976,1,7976,[200  50 181 282 222],236,3,32310,4.050394885295224,0.0,20.0
17977,1,7977,[ 64 176 276   7 173],457,5,32315,4.050513913261469,20.0,0.0
17978,1,7978,[187 588 176   1 288],835,2,32317,4.05025692442662,0.0,0.0
17979,1,7979,[427 588  79  98 127],450,5,32322,4.050375939849624,20.0,20.0
17980,1,7980,[427 588  79  98 127],450,5,32327,4.050494925447939,20.0,20.0
17981,1,7981,[211 111 183 333 265],796,4,32331,4.050488599348534,0.0,0.0
17982,1,7982,[588   7 483 302 195],450,4,32335,4.050482274834022,0.0,0.0
17983,1,7983,[ 12 282 276 483 742],457,5,32340,4.05060120240481,0.0,0.0
17984,1,7984,[215   1   9 111 202],174,4,32344,4.050594865372574,0.0,0.0
17985,1,7985,[427 588  79  98 127],18,5,32349,4.050713749060857,20.0,20.0
17986,1,7986,[187 191 183  50  25],655,4,32353,4.050707399524227,0.0,20.0
17987,1,7987,[196 172   9 245 117],593,3,32356,4.050575863795694,0.0,0.0
17988,1,7988,[153 210 127 742  88],796,3,32359,4.05044436099637,0.0,20.0
17989,1,7989,[508 173  11 322 174],344,3,32362,4.050312891113892,0.0,0.0
17990,1,7990,[427 588  79  98 127],716,5,32367,4.050431735702666,20.0,20.0
17991,1,7991,[121 161 172 215 181],796,5,32372,4.05055055055055,0.0,0.0
17992,1,7992,[427 588  79  98 127],18,5,32377,4.05066933566871,20.0,20.0
17993,1,7993,[427 588  79  98 127],18,5,32382,4.050788091068301,20.0,20.0
17994,1,7994,[427 588  79  98 127],796,5,32387,4.050906816760476,20.0,20.0
17995,1,7995,[427 588  79  98 127],796,5,32392,4.051025512756378,20.0,20.0
17996,1,7996,[427 588  79  98 127],796,5,32397,4.05114417906715,20.0,20.0
17997,1,7997,[427 588  79  98 127],796,5,32402,4.051262815703926,20.0,20.0
17998,1,7998,[191 132 175 234 275],655,2,32404,4.051006375796975,0.0,20.0
17999,1,7999,[427 588  79  98 127],450,5,32409,4.051125,20.0,20.0
18000,1,8000,[153  11  56 132 423],716,5,32414,4.051243594550681,0.0,0.0
18001,1,8001,[427 588  79  98 127],389,5,32419,4.051362159460135,20.0,20.0
18002,1,8002,[174 186 265 127  12],450,4,32423,4.051355741596901,0.0,20.0
18003,1,8003,[173 210 180   4 172],457,5,32428,4.051474262868566,0.0,0.0
18004,1,8004,[427 588  79  98 127],450,5,32433,4.05159275452842,20.0,20.0
18005,1,8005,[427 588  79  98 127],18,5,32438,4.0517112165875595,20.0,20.0
18006,1,8006,[  4 273 173 313  79],796,4,32442,4.051704758336456,0.0,0.0
18007,1,8007,[423  98 144 245 200],593,4,32446,4.051698301698302,0.0,0.0
18008,1,8008,[ 22 100  71 568 176],577,4,32450,4.051691846672494,0.0,20.0
18009,1,8009,[ 82  64 258 215 111],796,4,32454,4.051685393258427,20.0,0.0
18010,1,8010,[161 237 121  88  70],593,5,32459,4.051803769816503,0.0,0.0
18011,1,8011,[275  96 117 182 180],796,4,32463,4.051797304043934,0.0,20.0
18012,1,8012,[427 588  79  98 127],450,5,32468,4.05191563708973,20.0,20.0
18013,1,8013,[168 742  79 655 322],796,2,32470,4.051659595707512,0.0,0.0
18014,1,8014,[405 185 125 228 288],655,1,32471,4.0512788521522145,0.0,0.0
18015,1,8015,[427 588  79  98 127],450,5,32476,4.051397205588822,20.0,20.0
18016,1,8016,[427 588  79  98 127],716,5,32481,4.051515529499813,20.0,20.0
18017,1,8017,[286 175 153 357  79],18,5,32486,4.051633823896234,0.0,20.0
18018,1,8018,[427 588  79  98 127],450,5,32491,4.051752088789126,20.0,20.0
18019,1,8019,[427 588  79  98 127],796,5,32496,4.051870324189526,20.0,20.0
18020,1,8020,[234 143   8 294 427],655,2,32498,4.051614511906246,20.0,0.0
18021,1,8021,[427 588  79  98 127],716,5,32503,4.051732734978808,20.0,20.0
18022,1,8022,[427 588  79  98 127],716,5,32508,4.051850928580332,20.0,20.0
18023,1,8023,[245  50   7 174 237],450,5,32513,4.051969092721834,0.0,20.0
18024,1,8024,[427 588  79  98 127],716,5,32518,4.05208722741433,20.0,20.0
18025,1,8025,[655 323  71 161 204],280,2,32520,4.05183154747072,0.0,0.0
18026,1,8026,[427 588  79  98 127],796,5,32525,4.051949669864208,20.0,20.0
18027,1,8027,[427 588  79  98 127],450,5,32530,4.052067762830094,20.0,20.0
18028,1,8028,[173 182 191  98 228],450,5,32535,4.052185826379374,0.0,0.0
18029,1,8029,[ 82 269 294 313 323],796,1,32536,4.051805728518057,0.0,0.0
18030,1,8030,[216 748   9 496 603],151,4,32540,4.051799277798531,40.0,0.0
18031,1,8031,[427 588  79  98 127],796,5,32545,4.05191733067729,20.0,20.0
18032,1,8032,[427 588  79  98 127],18,5,32550,4.052035354164073,20.0,20.0
18033,1,8033,[427 588  79  98 127],450,5,32555,4.0521533482698535,20.0,20.0
18034,1,8034,[238 322 127 195 237],786,4,32559,4.052146857498444,0.0,20.0
18035,1,8035,[427 588  79  98 127],389,5,32564,4.052264808362369,20.0,20.0
18036,1,8036,[427 588  79  98 127],389,5,32569,4.052382729874331,20.0,20.0
18037,1,8037,[ 96 568  22 403 508],269,1,32570,4.052002985817367,0.0,0.0
18038,1,8038,[275 179 118 121  22],655,2,32572,4.051747729817142,0.0,20.0
18039,1,8039,[427 588  79  98 127],716,5,32577,4.051865671641791,20.0,20.0
18040,1,8040,[182 235 234   4 191],457,4,32581,4.051859221489864,0.0,0.0
18041,1,8041,[427 588  79  98 127],389,5,32586,4.051977120119373,20.0,20.0
18042,1,8042,[427 588  79  98 127],389,5,32591,4.052094989431804,20.0,20.0
18043,1,8043,[ 98 183 237 173  88],796,5,32596,4.052212829438091,0.0,0.0
18044,1,8044,[427 588  79  98 127],450,5,32601,4.052330640149161,20.0,20.0
18045,1,8045,[180 258  11 748 568],450,5,32606,4.052448421575939,0.0,0.0
18046,1,8046,[427 588  79  98 127],18,5,32611,4.05256617372934,20.0,20.0
18047,1,8047,[  9  12 172 197 210],151,5,32616,4.0526838966202785,0.0,0.0
18048,1,8048,[427 588  79  98 127],18,5,32621,4.0528015902596595,20.0,20.0
18049,1,8049,[182 216 175  69 237],457,5,32626,4.052919254658385,0.0,0.0
18050,1,8050,[121  82 302   7 182],655,2,32628,4.052664265308657,0.0,0.0
18051,1,8051,[427 588  79  98 127],450,5,32633,4.052781917536016,20.0,20.0
18052,1,8052,[151 125  98 265 237],796,5,32638,4.052899540543897,0.0,0.0
18053,1,8053,[197 269 117 187 127],421,3,32641,4.05276881052893,0.0,20.0
18054,1,8054,[173 237 405  11 265],577,3,32644,4.052638112973309,0.0,0.0
18055,1,8055,[427 588  79  98 127],450,5,32649,4.052755710029792,20.0,20.0
18056,1,8056,[176  88  79 117  28],450,5,32654,4.0528732778949985,0.0,0.0
18057,1,8057,[427 588  79  98 127],450,5,32659,4.052990816579796,20.0,20.0
18058,1,8058,[ 28 127  98 333  97],796,3,32662,4.0528601563469415,0.0,20.0
18059,1,8059,[427 588  79  98 127],18,5,32667,4.0529776674937965,20.0,20.0
18060,1,8060,[427 588  79  98 127],389,5,32672,4.053095149485175,20.0,20.0
18061,1,8061,[427 588  79  98 127],796,5,32677,4.053212602331928,20.0,20.0
18062,1,8062,[427 588  79  98 127],389,5,32682,4.053330026044897,20.0,20.0
18063,1,8063,[ 25 211  11  28 175],716,4,32686,4.053323412698413,0.0,0.0
18064,1,8064,[151 195 186 204 228],716,3,32689,4.053192808431494,0.0,0.0
18065,1,8065,[427 588  79  98 127],796,5,32694,4.053310190924869,20.0,20.0
18066,1,8066,[427 588  79  98 127],796,5,32699,4.05342754431635,20.0,20.0
18067,1,8067,[301 515  98 238   1],535,2,32701,4.053173029251363,0.0,0.0
18068,1,8068,[427 588  79  98 127],389,5,32706,4.053290370553972,20.0,20.0
18069,1,8069,[  9  64 318 143 588],796,4,32710,4.053283767038414,40.0,0.0
18070,1,8070,[427 588  79  98 127],389,5,32715,4.053401065543303,20.0,20.0
18071,1,8071,[427 588  79  98 127],450,5,32720,4.053518334985133,20.0,20.0
18072,1,8072,[588 357 405  95 288],344,4,32724,4.053511705685619,0.0,0.0
18073,1,8073,[427 588  79  98 127],389,5,32729,4.053628932375527,20.0,20.0
18074,1,8074,[427 588  79  98 127],796,5,32734,4.05374613003096,20.0,20.0
18075,1,8075,[427 588  79  98 127],450,5,32739,4.053863298662704,20.0,20.0
18076,1,8076,[427 588  79  98 127],796,5,32744,4.05398043828154,20.0,20.0
18077,1,8077,[323 111 588  88 288],280,3,32747,4.0538499628620945,0.0,0.0
18078,1,8078,[215 403 121  95  11],577,4,32751,4.053843297437802,0.0,0.0
18079,1,8079,[276  15 197  97  96],457,5,32756,4.053960396039604,0.0,0.0
18080,1,8080,[132 151 118  71 405],798,3,32759,4.053829971538176,0.0,0.0
18081,1,8081,[471  64 300  98  56],655,2,32761,4.053575847562485,20.0,0.0
18082,1,8082,[222 191 435 194 237],72,3,32764,4.053445502907336,0.0,0.0
18083,1,8083,[427 588  79  98 127],389,5,32769,4.053562592775854,20.0,20.0
18084,1,8084,[183 313 282 748 322],796,4,32773,4.053555967841682,0.0,0.0
18085,1,8085,[ 50 568 300 196 496],716,5,32778,4.053673015087806,20.0,20.0
18086,1,8086,[427 588  79  98 127],450,5,32783,4.0537900333869175,20.0,20.0
18087,1,8087,[427 588  79  98 127],18,5,32788,4.053907022749753,20.0,20.0
18088,1,8088,[427 588  79  98 127],389,5,32793,4.054023983187044,20.0,20.0
18089,1,8089,[427 588  79  98 127],716,5,32798,4.054140914709518,20.0,20.0
18090,1,8090,[257 185 603 313 423],655,3,32801,4.054010629094055,20.0,0.0
18091,1,8091,[ 88  82 187 357   1],450,4,32805,4.054003954522986,0.0,0.0
18092,1,8092,[238 179 235  89  22],450,4,32809,4.053997281601384,0.0,0.0
18093,1,8093,[427 588  79  98 127],389,5,32814,4.054114158636026,20.0,20.0
18094,1,8094,[427 588  79  98 127],450,5,32819,4.054231006794318,20.0,20.0
18095,1,8095,[427 588  79  98 127],450,5,32824,4.054347826086956,20.0,20.0
18096,1,8096,[427 588  79  98 127],389,5,32829,4.054464616524639,20.0,20.0
18097,1,8097,[125 483 286 268 180],296,5,32834,4.054581378118054,0.0,20.0
18098,1,8098,[186  71   4 603 276],535,3,32837,4.0544511668107175,20.0,0.0
18099,1,8099,[568 216 301 176 742],655,1,32838,4.054074074074074,0.0,0.0
18100,1,8100,[187 405 357 435 186],269,2,32840,4.053820515985681,0.0,0.0
18101,1,8101,[ 89 197 275 144   1],450,5,32845,4.053937299432239,0.0,20.0
18102,1,8102,[427 588  79  98 127],18,5,32850,4.054054054054054,20.0,20.0
18103,1,8103,[483   8 174 202 121],457,5,32855,4.0541707798617965,0.0,0.0
18104,1,8104,[185 181 588 144 111],716,4,32859,4.054164096236891,0.0,0.0
18105,1,8105,[427 588  79  98 127],450,5,32864,4.054280779669381,20.0,20.0
18106,1,8106,[210   8 111 204  89],457,4,32868,4.05427408412483,0.0,0.0
18107,1,8107,[427 588  79  98 127],389,5,32873,4.05439072520967,20.0,20.0
18108,1,8108,[187 228  96 238 427],296,5,32878,4.054507337526205,20.0,0.0
18109,1,8109,[435 144 288  22 276],655,1,32879,4.054130702836005,0.0,0.0
18110,1,8110,[471  56 282 161 222],280,2,32881,4.053877450376032,0.0,0.0
18111,1,8111,[  8 568 191 216 121],269,1,32882,4.053500986193294,0.0,0.0
18112,1,8112,[173  96 405 174 286],796,4,32886,4.053494391716997,0.0,20.0
18113,1,8113,[100 143 144 282 234],593,4,32890,4.053487798866157,0.0,20.0
18114,1,8114,[427 588  79  98 127],796,5,32895,4.053604436229205,20.0,20.0
18115,1,8115,[427 588  79  98 127],716,5,32900,4.05372104484968,20.0,20.0
18116,1,8116,[ 56  96   9 258  70],504,3,32903,4.0535912282863125,0.0,0.0
18117,1,8117,[195 238 191 186 185],457,5,32908,4.0537078098053705,0.0,0.0
18118,1,8118,[427 588  79  98 127],389,5,32913,4.053824362606233,20.0,20.0
18119,1,8119,[237 100 181 202 276],878,1,32914,4.053448275862069,0.0,20.0
18120,1,8120,[151 215 483 121 186],535,5,32919,4.053564831917251,0.0,0.0
18121,1,8121,[603 300 294  89 269],796,3,32922,4.0534351145038165,20.0,0.0
18122,1,8122,[427 588  79  98 127],450,5,32927,4.053551643481472,20.0,20.0
18123,1,8123,[318 204  79 423 655],450,5,32932,4.053668143771541,20.0,0.0
18124,1,8124,[603   8 187 153 200],269,3,32935,4.053538461538461,20.0,0.0
18125,1,8125,[655 276 275 172 210],457,5,32940,4.053654934777258,0.0,20.0
18126,1,8126,[385 216 196  88 210],151,4,32944,4.0536483327181,0.0,0.0
18127,1,8127,[427 588  79  98 127],796,5,32949,4.053764763779528,20.0,20.0
18128,1,8128,[ 15 546 204 118 180],450,3,32952,4.053635133472752,0.0,0.0
18129,1,8129,[427 588  79  98 127],18,5,32957,4.053751537515375,20.0,20.0
18130,1,8130,[294 385 172 168 257],796,4,32961,4.053744926823269,0.0,0.0
18131,1,8131,[216 427 234 151  88],577,3,32964,4.053615346778161,20.0,0.0
18132,1,8132,[174 435 215   1 403],450,5,32969,4.053731710315996,0.0,0.0
18133,1,8133,[211 202 111 181 153],450,5,32974,4.053848045242193,0.0,0.0
18134,1,8134,[603 194  69 174 180],450,5,32979,4.053964351567302,20.0,0.0
18135,1,8135,[ 82 496 144 265 180],450,4,32983,4.053957718780728,20.0,0.0
18136,1,8136,[ 50 118 258  12 228],655,1,32984,4.053582401376429,0.0,20.0
18137,1,8137,[143 135 195 588  50],756,3,32987,4.053452936839518,0.0,20.0
18138,1,8138,[427 588  79  98 127],18,5,32992,4.053569234549699,20.0,20.0
18139,1,8139,[357 143 215 132 237],18,3,32995,4.053439803439804,0.0,0.0
18140,1,8140,[100 181 300 111 568],885,3,32998,4.053310404127257,0.0,20.0
18141,1,8141,[427 588  79  98 127],389,5,33003,4.053426676492262,20.0,20.0
18142,1,8142,[125 238 234 427 161],436,2,33005,4.053174505710426,20.0,0.0
18143,1,8143,[427 588  79  98 127],796,5,33010,4.053290766208251,20.0,20.0
18144,1,8144,[194 228 168 100  28],577,4,33014,4.053284223449969,0.0,20.0
18145,1,8145,[216 282 132  70 161],457,5,33019,4.053400441934692,0.0,0.0
18146,1,8146,[427 588  79  98 127],796,5,33024,4.053516631889039,20.0,20.0
18147,1,8147,[117 195 265  98  82],796,4,33028,4.053510063819342,0.0,0.0
18148,1,8148,[427 588  79  98 127],796,5,33033,4.053626211805129,20.0,20.0
18149,1,8149,[427 588  79  98 127],796,5,33038,4.053742331288343,20.0,20.0
18150,1,8150,[ 56 238  15 174   1],457,5,33043,4.053858422279475,0.0,0.0
18151,1,8151,[427 588  79  98 127],18,5,33048,4.053974484789009,20.0,20.0
18152,1,8152,[427 588  79  98 127],18,5,33053,4.054090518827426,20.0,20.0
18153,1,8153,[427 588  79  98 127],389,5,33058,4.0542065244052,20.0,20.0
18154,1,8154,[427 588  79  98 127],450,5,33063,4.054322501532802,20.0,20.0
18155,1,8155,[427 588  79  98 127],796,5,33068,4.0544384502206965,20.0,20.0
18156,1,8156,[427 588  79  98 127],18,5,33073,4.054554370479343,20.0,20.0
18157,1,8157,[568 222  25 132  88],716,5,33078,4.0546702623191955,0.0,0.0
18158,1,8158,[427 588  79  98 127],716,5,33083,4.054786125750705,20.0,20.0
18159,1,8159,[423 655 275  82  89],151,4,33087,4.054779411764706,0.0,20.0
18160,1,8160,[ 98 187 210 202 181],269,2,33089,4.054527631417718,0.0,0.0
18161,1,8161,[427 588  79  98 127],389,5,33094,4.054643469737809,20.0,20.0
18162,1,8162,[  1 135   7 132 294],280,4,33098,4.05463677569521,0.0,0.0
18163,1,8163,[427 588  79  98 127],389,5,33103,4.054752572268495,20.0,20.0
18164,1,8164,[194 143 211 237  98],18,3,33106,4.054623392529088,0.0,0.0
18165,1,8165,[427 588  79  98 127],389,5,33111,4.054739162380603,20.0,20.0
18166,1,8166,[427 588  79  98 127],450,5,33116,4.054854903881474,20.0,20.0
18167,1,8167,[180 403 265 323  98],796,3,33119,4.054725759059745,0.0,0.0
18168,1,8168,[427 588  79  98 127],796,5,33124,4.05484147386461,20.0,20.0
18169,1,8169,[427 588  79  98 127],450,5,33129,4.054957160342718,20.0,20.0
18170,1,8170,[403  97 588  69 151],577,5,33134,4.055072818504467,0.0,0.0
18171,1,8171,[427 588  79  98 127],716,5,33139,4.055188448360255,20.0,20.0
18172,1,8172,[427 588  79  98 127],716,5,33144,4.05530404992047,20.0,20.0
18173,1,8173,[318 237 215 151 200],18,1,33145,4.054930266699291,20.0,0.0
18174,1,8174,[427 588  79  98 127],796,5,33150,4.055045871559633,20.0,20.0
18175,1,8175,[427 588  79  98 127],389,5,33155,4.0551614481409,20.0,20.0
18176,1,8176,[111  25 323 289 100],938,3,33158,4.055032407973584,0.0,20.0
18177,1,8177,[427 588  79  98 127],389,5,33163,4.055147957935926,20.0,20.0
18178,1,8178,[427 588  79  98 127],796,5,33168,4.0552634796429885,20.0,20.0
18179,1,8179,[301  50   9  88  22],796,3,33171,4.0551344743276285,0.0,20.0
18180,1,8180,[216 210  50   4 234],280,1,33172,4.054761031658721,0.0,20.0
18181,1,8181,[ 79  69 222 172 173],807,4,33176,4.054754338792471,0.0,0.0
18182,1,8182,[176 117 202 204 237],280,1,33177,4.054381033850666,0.0,0.0
18183,1,8183,[211 174 357 204   1],535,3,33180,4.05425219941349,0.0,0.0
18184,1,8184,[153   8 195 496 588],330,4,33184,4.054245571166769,20.0,0.0
18185,1,8185,[237 196 121 183 202],786,4,33188,4.054238944539458,0.0,0.0
18186,1,8186,[151 194 180 300 603],716,4,33192,4.054232319530963,20.0,0.0
18187,1,8187,[ 79 111 173 265  50],577,5,33197,4.054347826086956,0.0,20.0
18188,1,8188,[ 97 143 228 202 237],796,4,33201,4.054341189400415,0.0,0.0
18189,1,8189,[175   1 258 228  12],655,0,33201,4.053846153846154,0.0,0.0
18190,1,8190,[318 153  70 144 111],716,4,33205,4.0538395800268585,20.0,0.0
18191,1,8191,[179 121 161 195 125],450,4,33209,4.0538330078125,0.0,0.0
18192,1,8192,[ 12 423 185  50 200],655,3,33212,4.053704381789332,0.0,20.0
18193,1,8193,[655 161 403 197 245],450,5,33217,4.053819868196241,0.0,0.0
18194,1,8194,[276 235 655 168 288],457,4,33221,4.053813300793166,0.0,0.0
18195,1,8195,[174 118 294  89 403],655,1,33222,4.053440702781844,0.0,0.0
18196,1,8196,[427 588  79  98 127],18,5,33227,4.053556179089911,20.0,20.0
18197,1,8197,[202 100 197 143  82],504,4,33231,4.053549646255184,0.0,20.0
18198,1,8198,[427 588  79  98 127],18,5,33236,4.053665081107452,20.0,20.0
18199,1,8199,[427 588  79  98 127],389,5,33241,4.053780487804878,20.0,20.0
18200,1,8200,[427 588  79  98 127],18,5,33246,4.053895866357761,20.0,20.0
18201,1,8201,[427 588  79  98 127],716,5,33251,4.054011216776396,20.0,20.0
18202,1,8202,[427 588  79  98 127],796,5,33256,4.0541265390710715,20.0,20.0
18203,1,8203,[405 318  82 275 186],655,2,33258,4.053876157971721,20.0,20.0
18204,1,8204,[265 143 183 222 211],655,2,33260,4.053625837903717,0.0,0.0
18205,1,8205,[427 588  79  98 127],389,5,33265,4.0537411650012185,20.0,20.0
18206,1,8206,[265   7 289 268 222],655,0,33265,4.053247227976118,0.0,0.0
18207,1,8207,[427 588  79  98 127],389,5,33270,4.053362573099415,20.0,20.0
18208,1,8208,[210 237 483 144  69],655,1,33271,4.052990620051164,0.0,0.0
18209,1,8209,[318 423 269  56 215],450,5,33276,4.0531059683313035,20.0,0.0
18210,1,8210,[427 588  79  98 127],796,5,33281,4.053221288515406,20.0,20.0
18211,1,8211,[427 588  79  98 127],18,5,33286,4.053336580613736,20.0,20.0
18212,1,8212,[496 322  12 196 294],450,5,33291,4.053451844636552,20.0,0.0
18213,1,8213,[176 161  89 496 588],786,5,33296,4.0535670805941075,20.0,0.0
18214,1,8214,[282 235 118 173 100],292,3,33299,4.053438831405964,0.0,20.0
18215,1,8215,[508 125 286  71 597],344,1,33300,4.053067185978579,0.0,20.0
18216,1,8216,[427 588  79  98 127],389,5,33305,4.053182426676402,20.0,20.0
18217,1,8217,[427 588  79  98 127],450,5,33310,4.053297639328304,20.0,20.0
18218,1,8218,[427 588  79  98 127],796,5,33315,4.053412823944519,20.0,20.0
18219,1,8219,[427 588  79  98 127],389,5,33320,4.0535279805352795,20.0,20.0
18220,1,8220,[427 588  79  98 127],716,5,33325,4.053643109110814,20.0,20.0
18221,1,8221,[427 588  79  98 127],450,5,33330,4.053758209681343,20.0,20.0
18222,1,8222,[215 405 196 222   9],655,0,33330,4.053265231667274,0.0,0.0
18223,1,8223,[427 588  79  98 127],18,5,33335,4.053380350194552,20.0,20.0
18224,1,8224,[182 132 603  25 200],450,3,33338,4.053252279635259,20.0,0.0
18225,1,8225,[ 82 471 403 191 197],655,1,33339,4.052881108679796,0.0,0.0
18226,1,8226,[427 588  79  98 127],716,5,33344,4.05299623191929,20.0,20.0
18227,1,8227,[471 172 196 357  82],450,4,33348,4.052989790957706,0.0,0.0
18228,1,8228,[655 257 294 143 385],401,1,33349,4.052618787215944,0.0,0.0
18229,1,8229,[195  89 117 215 235],344,2,33351,4.052369380315917,0.0,0.0
18230,1,8230,[427 588  79  98 127],716,5,33356,4.0524845097801,20.0,20.0
18231,1,8231,[117 195  96 234 222],716,3,33359,4.0523566569484935,0.0,0.0
18232,1,8232,[568   8 258  97  50],655,1,33360,4.051985910360743,0.0,20.0
18233,1,8233,[427 588  79  98 127],389,5,33365,4.052101044449842,20.0,20.0
18234,1,8234,[181 125 423 357 127],457,5,33370,4.052216150576807,0.0,20.0
18235,1,8235,[183 742 153 323 185],796,3,33373,4.0520883924235065,0.0,0.0
18236,1,8236,[427 588  79  98 127],796,5,33378,4.052203472137914,20.0,20.0
18237,1,8237,[204   9 269 172 322],344,4,33382,4.052197135226997,0.0,0.0
18238,1,8238,[328 153 127   9 515],292,4,33386,4.052190799854351,0.0,20.0
18239,1,8239,[427 588  79  98 127],796,5,33391,4.052305825242718,20.0,20.0
18240,1,8240,[427 588  79  98 127],450,5,33396,4.05242082271569,20.0,20.0
18241,1,8241,[427 588  79  98 127],796,5,33401,4.052535792283426,20.0,20.0
18242,1,8242,[603 197  82 238 275],389,5,33406,4.052650733956084,20.0,20.0
18243,1,8243,[483 202 195   4 301],796,4,33410,4.052644347404173,0.0,0.0
18244,1,8244,[302 216 282 273 144],450,4,33414,4.052637962401455,0.0,0.0
18245,1,8245,[427 588  79  98 127],389,5,33419,4.052752849866602,20.0,20.0
18246,1,8246,[234 568 215 403  64],72,4,33423,4.05274645325573,20.0,0.0
18247,1,8247,[588 161 200 127 121],796,5,33428,4.05286129970902,0.0,20.0
18248,1,8248,[222 483 228 294 216],23,4,33432,4.052854891502,0.0,0.0
18249,1,8249,[144 237 176  96 183],655,1,33433,4.052484848484848,0.0,0.0
18250,1,8250,[196 237 238 151  50],450,5,33438,4.0525996848866805,0.0,20.0
18251,1,8251,[  7  15  97 182 288],450,3,33441,4.0524721279689775,0.0,0.0
18252,1,8252,[427 588  79  98 127],450,5,33446,4.052586938083121,20.0,20.0
18253,1,8253,[153  88 117 183  69],593,5,33451,4.052701720377999,0.0,0.0
18254,1,8254,[ 25 357   7 508 215],344,4,33455,4.052695336159903,0.0,0.0
18255,1,8255,[427 588  79  98 127],796,5,33460,4.05281007751938,20.0,20.0
18256,1,8256,[ 97 153  50  25 237],450,4,33464,4.052803681724598,0.0,20.0
18257,1,8257,[427 588  79  98 127],450,5,33469,4.052918382174861,20.0,20.0
18258,1,8258,[273 275 471 187  15],450,3,33472,4.052790894781451,0.0,20.0
18259,1,8259,[202 385  97 176 742],796,3,33475,4.052663438256658,0.0,0.0
18260,1,8260,[427 588  79  98 127],716,5,33480,4.0527781140297785,20.0,20.0
18261,1,8261,[427 588  79  98 127],450,5,33485,4.052892762043089,20.0,20.0
18262,1,8262,[427 588  79  98 127],389,5,33490,4.053007382306668,20.0,20.0
18263,1,8263,[427 588  79  98 127],18,5,33495,4.0531219748305904,20.0,20.0
18264,1,8264,[182 301 245 195 742],450,5,33500,4.053236539624924,0.0,0.0
18265,1,8265,[111 175 483 127 471],457,4,33504,4.053230099201548,0.0,20.0
18266,1,8266,[427 588  79  98 127],389,5,33509,4.053344623200678,20.0,20.0
18267,1,8267,[427 588  79  98 127],450,5,33514,4.053459119496855,20.0,20.0
18268,1,8268,[471 222  96 111  28],457,4,33518,4.053452654492683,0.0,0.0
18269,1,8269,[286 282 185 427 175],655,2,33520,4.0532043530834345,20.0,20.0
18270,1,8270,[471 186 269 265 196],535,4,33524,4.053197920444928,0.0,0.0
18271,1,8271,[427 588  79  98 127],716,5,33529,4.053312379110252,20.0,20.0
18272,1,8272,[427 588  79  98 127],389,5,33534,4.053426810105162,20.0,20.0
18273,1,8273,[ 11 195 216 202 174],269,0,33534,4.052936910804931,0.0,0.0
18274,1,8274,[176   4 125 357  71],344,3,33537,4.052809667673716,0.0,0.0
18275,1,8275,[ 22 302  15 202 328],655,1,33538,4.052440792653456,0.0,0.0
18276,1,8276,[143 222  70  79 210],450,3,33541,4.052313640207805,0.0,0.0
18277,1,8277,[127 121 742 282 118],120,4,33545,4.0523073206088425,0.0,20.0
18278,1,8278,[  1 435  70 172 515],72,4,33549,4.052301002536538,0.0,0.0
18279,1,8279,[427 588  79  98 127],716,5,33554,4.052415458937198,20.0,20.0
18280,1,8280,[323 268 132 202 597],174,2,33556,4.052167612607173,0.0,0.0
18281,1,8281,[597 258 182  70 294],457,3,33559,4.052040569910649,0.0,0.0
18282,1,8282,[ 25 196 111 211 597],450,4,33563,4.052034287094048,0.0,0.0
18283,1,8283,[204 222 271  96 181],807,3,33566,4.051907291163689,0.0,0.0
18284,1,8284,[427 588  79  98 127],716,5,33571,4.052021726010863,20.0,20.0
18285,1,8285,[496 127 276 182 483],280,4,33575,4.052015447743181,20.0,20.0
18286,1,8286,[427 588  79  98 127],18,5,33580,4.052129841921081,20.0,20.0
18287,1,8287,[ 64 546 121 143 186],457,4,33584,4.052123552123552,20.0,0.0
18288,1,8288,[111 144 179 172 288],450,4,33588,4.052117263843648,0.0,0.0
18289,1,8289,[423 286 118 313   4],655,1,33589,4.051749095295537,0.0,20.0
18290,1,8290,[427 588  79  98 127],389,5,33594,4.051863466409359,20.0,20.0
18291,1,8291,[427 588  79  98 127],796,5,33599,4.051977809937289,20.0,20.0
18292,1,8292,[496 144 197  11 655],280,2,33601,4.051730375015073,20.0,0.0
18293,1,8293,[  7 423 118 276 161],280,4,33605,4.051724137931035,0.0,0.0
18294,1,8294,[483 117 294  12  98],450,4,33609,4.051717902350814,0.0,0.0
18295,1,8295,[427 588  79  98 127],796,5,33614,4.0518322082931535,20.0,20.0
18296,1,8296,[161 423   4 168 357],796,5,33619,4.051946486681933,0.0,0.0
18297,1,8297,[427 588  79  98 127],18,5,33624,4.052060737527115,20.0,20.0
18298,1,8298,[427 588  79  98 127],716,5,33629,4.052174960838656,20.0,20.0
18299,1,8299,[200 111   9 403 185],457,4,33633,4.0521686746987955,0.0,0.0
18300,1,8300,[427 588  79  98 127],18,5,33638,4.05228285748705,20.0,20.0
18301,1,8301,[427 588  79  98 127],716,5,33643,4.052397012768008,20.0,20.0
18302,1,8302,[127  15  70 245 258],450,4,33647,4.052390702155847,0.0,20.0
18303,1,8303,[546  12 237  56 258],186,1,33648,4.0520231213872835,0.0,0.0
18304,1,8304,[427 588  79  98 127],18,5,33653,4.052137266706803,20.0,20.0
18305,1,8305,[144 127  11 117 222],457,5,33658,4.052251384541296,0.0,20.0
18306,1,8306,[427 588  79  98 127],796,5,33663,4.052365474900686,20.0,20.0
18307,1,8307,[ 7 15  4 96 22],256,5,33668,4.052479537794897,0.0,0.0
18308,1,8308,[427 588  79  98 127],18,5,33673,4.0525935732338425,20.0,20.0
18309,1,8309,[427 588  79  98 127],450,5,33678,4.052707581227437,20.0,20.0
18310,1,8310,[ 98 117  70 204 282],593,5,33683,4.052821561785585,0.0,0.0
18311,1,8311,[ 82 180 181 195 176],269,0,33683,4.052333974975938,0.0,0.0
18312,1,8312,[121 100  50 257 268],296,5,33688,4.052447973054252,0.0,40.0
18313,1,8313,[427 588  79  98 127],796,5,33693,4.052561943709406,20.0,20.0
18314,1,8314,[655   4  79 185 161],450,4,33697,4.052555622369212,0.0,0.0
18315,1,8315,[238  95  82 211 245],796,1,33698,4.052188552188552,0.0,0.0
18316,1,8316,[427 588  79  98 127],389,5,33703,4.052302512925333,20.0,20.0
18317,1,8317,[427 588  79  98 127],18,5,33708,4.0524164462611205,20.0,20.0
18318,1,8318,[ 50 161 196 211 174],786,5,33713,4.052530352205794,0.0,20.0
18319,1,8319,[427 588  79  98 127],716,5,33718,4.052644230769231,20.0,20.0
18320,1,8320,[276 215  70 515 194],18,3,33721,4.052517726234828,0.0,0.0
18321,1,8321,[427 588  79  98 127],716,5,33726,4.052631578947368,20.0,20.0
18322,1,8322,[427 588  79  98 127],450,5,33731,4.052745404301334,20.0,20.0
18323,1,8323,[111 118 135 197  64],292,4,33735,4.052739067755887,20.0,0.0
18324,1,8324,[427 588  79  98 127],796,5,33740,4.052852852852853,20.0,20.0
18325,1,8325,[  8 211 100 174 300],796,3,33743,4.052726399231323,0.0,20.0
18326,1,8326,[135 238 403 385 174],655,1,33744,4.052359793443017,0.0,0.0
18327,1,8327,[202 191 228 597 257],23,1,33745,4.051993275696446,0.0,0.0
18328,1,8328,[427 588  79  98 127],796,5,33750,4.052107095689759,20.0,20.0
18329,1,8329,[173 269  64 237 185],535,5,33755,4.052220888355342,20.0,0.0
18330,1,8330,[125 276 179 200 302],655,4,33759,4.052214620093626,0.0,0.0
18331,1,8331,[427 588  79  98 127],450,5,33764,4.052328372539606,20.0,20.0
18332,1,8332,[427 588  79  98 127],716,5,33769,4.052442097683907,20.0,20.0
18333,1,8333,[313 121  50 597   9],344,2,33771,4.052195824334054,0.0,20.0
18334,1,8334,[427 588  79  98 127],716,5,33776,4.0523095380923815,20.0,20.0
18335,1,8335,[187 655 300  96 405],796,4,33780,4.052303262955854,0.0,0.0
18336,1,8336,[427 588  79  98 127],389,5,33785,4.052416936547919,20.0,20.0
18337,1,8337,[ 82 302 204 273   7],450,3,33788,4.052290717198369,0.0,0.0
18338,1,8338,[194 151 471 603 300],450,5,33793,4.052404365031778,20.0,0.0
18339,1,8339,[ 79 301 257 328 515],655,2,33795,4.052158273381295,0.0,0.0
18340,1,8340,[427 588  79  98 127],18,5,33800,4.052271909842944,20.0,20.0
18341,1,8341,[211  25 483  71 196],450,2,33802,4.052025893071206,0.0,0.0
18342,1,8342,[  1  98 234 174  22],457,5,33807,4.052139518158936,0.0,0.0
18343,1,8343,[179 195 496  88 161],269,2,33809,4.051893576222435,20.0,0.0
18344,1,8344,[222 191 265 194  79],716,5,33814,4.052007189934092,0.0,0.0
18345,1,8345,[211  25 202   8 294],655,0,33814,4.051521687035706,0.0,0.0
18346,1,8346,[427 588  79  98 127],796,5,33819,4.051635318078351,20.0,20.0
18347,1,8347,[403  56 135 151 211],269,4,33823,4.051629132726402,0.0,0.0
18348,1,8348,[405 185  69 194  15],796,5,33828,4.0517427236794825,0.0,0.0
18349,1,8349,[435 216  88 135 234],716,4,33832,4.051736526946108,0.0,0.0
18350,1,8350,[427 588  79  98 127],450,5,33837,4.05185007783499,20.0,20.0
18351,1,8351,[427 588  79  98 127],450,5,33842,4.051963601532567,20.0,20.0
18352,1,8352,[265 742 245 286   4],280,3,33845,4.051837663115048,0.0,20.0
18353,1,8353,[302 603 181 235  89],450,4,33849,4.051831457984199,20.0,0.0
18354,1,8354,[427 588  79  98 127],716,5,33854,4.051944943147816,20.0,20.0
18355,1,8355,[427 588  79  98 127],450,5,33859,4.052058401148875,20.0,20.0
18356,1,8356,[427 588  79  98 127],716,5,33864,4.0521718319971285,20.0,20.0
18357,1,8357,[ 96 195  25 405 385],344,3,33867,4.052045944005743,0.0,0.0
18358,1,8358,[427 588  79  98 127],716,5,33872,4.05215934920445,20.0,20.0
18359,1,8359,[427 588  79  98 127],716,5,33877,4.052272727272728,20.0,20.0
18360,1,8360,[ 82  98 588  56 172],796,4,33881,4.052266475301997,0.0,0.0
18361,1,8361,[427 588  79  98 127],716,5,33886,4.05237981344176,20.0,20.0
18362,1,8362,[197 655 258 153 423],535,5,33891,4.052493124476863,0.0,0.0
18363,1,8363,[258 215 546   1 210],450,4,33895,4.052486848397896,0.0,0.0
18364,1,8364,[427 588  79  98 127],389,5,33900,4.052600119545726,20.0,20.0
18365,1,8365,[385 405 568 245 403],796,4,33904,4.0525938321778625,0.0,0.0
18366,1,8366,[427 588  79  98 127],450,5,33909,4.052707063463607,20.0,20.0
18367,1,8367,[427 588  79  98 127],716,5,33914,4.052820267686425,20.0,20.0
18368,1,8368,[427 588  79  98 127],796,5,33919,4.052933444856016,20.0,20.0
18369,1,8369,[427 588  79  98 127],18,5,33924,4.053046594982079,20.0,20.0
18370,1,8370,[427 588  79  98 127],389,5,33929,4.053159718074304,20.0,20.0
18371,1,8371,[118 216  98 127 181],344,3,33932,4.05303392259914,0.0,20.0
18372,1,8372,[427 588  79  98 127],18,5,33937,4.053147020183925,20.0,20.0
18373,1,8373,[269 257  88 215   9],796,3,33940,4.053021256269405,0.0,0.0
18374,1,8374,[427 588  79  98 127],18,5,33945,4.053134328358209,20.0,20.0
18375,1,8375,[427 588  79  98 127],18,5,33950,4.053247373447946,20.0,20.0
18376,1,8376,[427 588  79  98 127],389,5,33955,4.053360391548287,20.0,20.0
18377,1,8377,[427 588  79  98 127],796,5,33960,4.053473382668895,20.0,20.0
18378,1,8378,[ 79 234  15 568 117],577,2,33962,4.053228308867407,0.0,0.0
18379,1,8379,[427 588  79  98 127],716,5,33967,4.053341288782816,20.0,20.0
18380,1,8380,[300 181 282 211 210],655,0,33967,4.052857654217874,0.0,0.0
18381,1,8381,[427 588  79  98 127],716,5,33972,4.0529706513958486,20.0,20.0
18382,1,8382,[222 194 423 185  97],11,4,33976,4.052964332577836,0.0,0.0
18383,1,8383,[294 182 187 132  89],796,4,33980,4.052958015267175,0.0,0.0
18384,1,8384,[427 588  79  98 127],450,5,33985,4.053070960047704,20.0,20.0
18385,1,8385,[427 588  79  98 127],18,5,33990,4.053183877891724,20.0,20.0
18386,1,8386,[121 237 117 471  82],786,4,33994,4.053177536663885,0.0,0.0
18387,1,8387,[427 588  79  98 127],450,5,33999,4.053290414878398,20.0,20.0
18388,1,8388,[182 588 228 144 322],450,5,34004,4.053403266181905,0.0,0.0
18389,1,8389,[183  50 597 195 173],269,0,34004,4.052920143027413,0.0,20.0
18390,1,8390,[405  79  70 603 211],655,2,34006,4.052675485639376,20.0,0.0
18391,1,8391,[427 588  79  98 127],716,5,34011,4.0527883698760725,20.0,20.0
18392,1,8392,[427 588  79  98 127],18,5,34016,4.0529012272131535,20.0,20.0
18393,1,8393,[100 471 276 496 265],786,4,34020,4.05289492494639,20.0,20.0
18394,1,8394,[ 97 286 238 111 322],593,4,34024,4.05288862418106,0.0,20.0
18395,1,8395,[427 588  79  98 127],796,5,34029,4.053001429252025,20.0,20.0
18396,1,8396,[182   4 118  56  28],450,3,34032,4.052876027152554,0.0,0.0
18397,1,8397,[172 174 143 204 318],401,4,34036,4.052869730888307,20.0,0.0
18398,1,8398,[234 475   9 144 153],292,5,34041,4.052982497916418,0.0,0.0
18399,1,8399,[568  82   4 289 238],655,0,34041,4.0525,0.0,0.0
18400,1,8400,[275 175  88 258 245],344,2,34043,4.052255683847161,0.0,20.0
18401,1,8401,[ 89  64 179 127  95],450,4,34047,4.052249464413235,20.0,20.0
18402,1,8402,[427 588  79  98 127],796,5,34052,4.052362251576818,20.0,20.0
18403,1,8403,[143 216 275 222 100],786,5,34057,4.052475011899095,0.0,40.0
18404,1,8404,[ 89   4 322 742 301],796,2,34059,4.052230814991077,0.0,0.0
18405,1,8405,[427 588  79  98 127],389,5,34064,4.052343564120866,20.0,20.0
18406,1,8406,[427 588  79  98 127],389,5,34069,4.052456286427977,20.0,20.0
18407,1,8407,[ 56 742 269 385 118],186,1,34070,4.05209324452902,0.0,0.0
18408,1,8408,[ 50  56 276  64 238],655,3,34073,4.051968129385182,20.0,20.0
18409,1,8409,[196 275 496 568 172],389,3,34076,4.051843043995244,20.0,20.0
18410,1,8410,[ 98 302 132 121 127],344,4,34080,4.051836880275829,0.0,20.0
18411,1,8411,[427 588  79  98 127],796,5,34085,4.051949595815501,20.0,20.0
18412,1,8412,[427 588  79  98 127],450,5,34090,4.05206228455961,20.0,20.0
18413,1,8413,[427 588  79  98 127],796,5,34095,4.052174946517709,20.0,20.0
18414,1,8414,[151 210  95  98 200],577,3,34098,4.05204991087344,0.0,0.0
18415,1,8415,[427 588  79  98 127],389,5,34103,4.052162547528517,20.0,20.0
18416,1,8416,[210 403 357   1 117],72,4,34107,4.052156350243555,0.0,0.0
18417,1,8417,[678  79   8  70 265],280,4,34111,4.052150154430981,0.0,0.0
18418,1,8418,[427 588  79  98 127],716,5,34116,4.052262739042642,20.0,20.0
18419,1,8419,[427 588  79  98 127],18,5,34121,4.052375296912114,20.0,20.0
18420,1,8420,[403 234  82 275   9],756,0,34121,4.051894074337965,0.0,20.0
18421,1,8421,[427 588  79  98 127],716,5,34126,4.052006649251959,20.0,20.0
18422,1,8422,[ 88 288 603 546 237],450,4,34130,4.052000474890182,20.0,0.0
18423,1,8423,[268  12 483 204 195],655,1,34131,4.051638176638177,0.0,0.0
18424,1,8424,[427 588  79  98 127],450,5,34136,4.051750741839762,20.0,20.0
18425,1,8425,[183 546 288 143  96],457,4,34140,4.051744600047472,0.0,0.0
18426,1,8426,[427 588  79  98 127],796,5,34145,4.05185712590483,20.0,20.0
18427,1,8427,[195 423  69  56 294],796,4,34149,4.051850972947318,0.0,0.0
18428,1,8428,[427 588  79  98 127],796,5,34154,4.051963459485111,20.0,20.0
18429,1,8429,[427 588  79  98 127],716,5,34159,4.052075919335706,20.0,20.0
18430,1,8430,[143 151 202 135 265],450,4,34163,4.052069742616534,0.0,0.0
18431,1,8431,[ 97 678 234  50 185],256,5,34168,4.052182163187855,0.0,20.0
18432,1,8432,[427 588  79  98 127],716,5,34173,4.0522945570971185,20.0,20.0
18433,1,8433,[210 121 748 195  56],256,4,34177,4.052288356651648,0.0,0.0
18434,1,8434,[427 588  79  98 127],796,5,34182,4.052400711321873,20.0,20.0
18435,1,8435,[427 588  79  98 127],716,5,34187,4.052513039355144,20.0,20.0
18436,1,8436,[427 588  79  98 127],389,5,34192,4.052625340760934,20.0,20.0
18437,1,8437,[173  11 195   4 546],457,4,34196,4.052619104053093,0.0,0.0
18438,1,8438,[ 12 238   7  56 111],450,5,34201,4.0527313662756255,0.0,0.0
18439,1,8439,[496  97 117 185  12],450,5,34206,4.052843601895734,20.0,0.0
18440,1,8440,[111 357 180 197  28],786,4,34210,4.05283734154721,0.0,0.0
18441,1,8441,[  1 125 182 333 187],796,4,34214,4.052831082681829,0.0,0.0
18442,1,8442,[427 588  79  98 127],389,5,34219,4.052943266611394,20.0,20.0
18443,1,8443,[742 300 258 403 176],756,2,34221,4.052700142112743,0.0,0.0
18444,1,8444,[ 12  82  64 194 318],577,5,34226,4.052812314979278,40.0,0.0
18445,1,8445,[427 588  79  98 127],18,5,34231,4.052924461283448,20.0,20.0
18446,1,8446,[135  82 286 269 301],655,1,34232,4.052563040132592,0.0,20.0
18447,1,8447,[ 82 435 265 127  97],878,2,34234,4.052320075757576,0.0,20.0
18448,1,8448,[ 28 405 151 111 235],457,3,34237,4.052195526097763,0.0,0.0
18449,1,8449,[276 151  88 403 204],269,2,34239,4.051952662721893,0.0,0.0
18450,1,8450,[197 202 161   8 185],269,2,34241,4.051709856821678,0.0,0.0
18451,1,8451,[427 588  79  98 127],796,5,34246,4.051822053951727,20.0,20.0
18452,1,8452,[427 588  79  98 127],450,5,34251,4.0519342245356675,20.0,20.0
18453,1,8453,[273 508 268 215 183],344,3,34254,4.0518097941802695,0.0,0.0
18454,1,8454,[427 588  79  98 127],18,5,34259,4.051921939680662,20.0,20.0
18455,1,8455,[427 588  79  98 127],796,5,34264,4.0520340586565755,20.0,20.0
18456,1,8456,[187   7 276 210 269],296,4,34268,4.0520279058767885,0.0,0.0
18457,1,8457,[117 183 118 210 161],450,3,34271,4.051903523291558,0.0,0.0
18458,1,8458,[179  22 603 117 471],655,2,34273,4.051660952831304,20.0,0.0
18459,1,8459,[427 588  79  98 127],716,5,34278,4.05177304964539,20.0,20.0
18460,1,8460,[197 357 174 194  89],450,5,34283,4.051885119962179,0.0,0.0
18461,1,8461,[423 181 117   1  56],577,4,34287,4.051878988418814,0.0,0.0
18462,1,8462,[269 127  89 268  71],344,3,34290,4.051754696915987,0.0,20.0
18463,1,8463,[496 405 185 183   1],503,4,34294,4.051748582230624,20.0,0.0
18464,1,8464,[  8  97  98  82 180],796,2,34296,4.0515062020082695,0.0,0.0
18465,1,8465,[ 88 118  97 237  25],655,0,34296,4.051027639971651,0.0,0.0
18466,1,8466,[ 98 294 603  82 111],655,2,34298,4.050785402149522,20.0,0.0
18467,1,8467,[427 588  79  98 127],796,5,34303,4.05089749645725,20.0,20.0
18468,1,8468,[427 588  79  98 127],450,5,34308,4.051009564293305,20.0,20.0
18469,1,8469,[427 588  79  98 127],18,5,34313,4.05112160566706,20.0,20.0
18470,1,8470,[427 588  79  98 127],450,5,34318,4.0512336205878885,20.0,20.0
18471,1,8471,[111 185 603 471 655],716,4,34322,4.051227573182247,20.0,0.0
18472,1,8472,[427 588  79  98 127],716,5,34327,4.051339549156143,20.0,20.0
18473,1,8473,[ 89  22 151 222 175],457,5,34332,4.051451498701912,0.0,0.0
18474,1,8474,[302 127 588 742 403],450,5,34337,4.0515634218289085,0.0,20.0
18475,1,8475,[ 79 275 118 655 235],457,4,34341,4.051557338367155,0.0,20.0
18476,1,8476,[111 423   7 286 172],450,5,34346,4.051669222602336,0.0,20.0
18477,1,8477,[427 588  79  98 127],450,5,34351,4.051781080443501,20.0,20.0
18478,1,8478,[427 588  79  98 127],450,5,34356,4.051892911899988,20.0,20.0
18479,1,8479,[427 588  79  98 127],796,5,34361,4.052004716981132,20.0,20.0
18480,1,8480,[357 143  11 655 300],450,5,34366,4.0521164956962625,0.0,0.0
18481,1,8481,[176  56 405   7 132],457,5,34371,4.052228248054704,0.0,0.0
18482,1,8482,[427 588  79  98 127],18,5,34376,4.052339974065778,20.0,20.0
18483,1,8483,[275 323 748 603  79],796,4,34380,4.052333804809052,20.0,20.0
18484,1,8484,[427 588  79  98 127],716,5,34385,4.052445492044785,20.0,20.0
18485,1,8485,[228 313 185 210 204],655,2,34387,4.052203629507424,0.0,0.0
18486,1,8486,[427 588  79  98 127],796,5,34392,4.052315305761753,20.0,20.0
18487,1,8487,[ 71 194 181   1 405],401,1,34393,4.051955702167766,0.0,0.0
18488,1,8488,[427 588  79  98 127],389,5,34398,4.0520673813169985,20.0,20.0
18489,1,8489,[182 748   4 273 546],796,4,34402,4.0520612485276795,0.0,0.0
18490,1,8490,[427 588  79  98 127],450,5,34407,4.052172888941232,20.0,20.0
18491,1,8491,[265   1 301 269 187],450,5,34412,4.052284503061705,0.0,0.0
18492,1,8492,[427 588  79  98 127],389,5,34417,4.0523960908983865,20.0,20.0
18493,1,8493,[471  96 121 173 423],807,3,34420,4.052272192135625,0.0,0.0
18494,1,8494,[427 588  79  98 127],716,5,34425,4.052383755150088,20.0,20.0
18495,1,8495,[427 588  79  98 127],389,5,34430,4.052495291902072,20.0,20.0
18496,1,8496,[117 245 357 385 427],450,5,34435,4.052606802400847,20.0,0.0
18497,1,8497,[568  50  82 475 191],269,2,34437,4.0523652624146855,0.0,20.0
18498,1,8498,[181 238  11 427 435],655,1,34438,4.052006118366867,20.0,0.0
18499,1,8499,[100 655 111   9 172],655,1,34439,4.051647058823529,0.0,20.0
18500,1,8500,[427 588  79  98 127],796,5,34444,4.051758616633338,20.0,20.0
18501,1,8501,[187 143 186 182 655],655,3,34447,4.051634909433075,0.0,0.0
18502,1,8502,[427 588  79  98 127],450,5,34452,4.051746442432083,20.0,20.0
18503,1,8503,[427 588  79  98 127],450,5,34457,4.051857949200376,20.0,20.0
18504,1,8504,[427 588  79  98 127],796,5,34462,4.051969429747207,20.0,20.0
18505,1,8505,[121 181  79  88 234],716,5,34467,4.052080884081825,0.0,0.0
18506,1,8506,[427 588  79  98 127],716,5,34472,4.052192312213471,20.0,20.0
18507,1,8507,[238  89 546 215 222],796,4,34476,4.052186177715091,0.0,0.0
18508,1,8508,[427 588  79  98 127],389,5,34481,4.052297567281702,20.0,20.0
18509,1,8509,[357 238 273   7 210],450,3,34484,4.052173913043478,0.0,0.0
18510,1,8510,[427 588  79  98 127],18,5,34489,4.05228527787569,20.0,20.0
18511,1,8511,[597 186 117 742  11],457,4,34493,4.052279135338346,0.0,0.0
18512,1,8512,[ 25 328 655 435 125],450,4,34497,4.052272994244097,0.0,0.0
18513,1,8513,[328 151 176  98 237],450,5,34502,4.052384308198262,0.0,0.0
18514,1,8514,[427 588  79  98 127],450,5,34507,4.052495596007047,20.0,20.0
18515,1,8515,[222  98  89 286 174],796,4,34511,4.0524894316580555,0.0,20.0
18516,1,8516,[427 588  79  98 127],796,5,34516,4.05260068099096,20.0,20.0
18517,1,8517,[427 588  79  98 127],389,5,34521,4.052711904202864,20.0,20.0
18518,1,8518,[597 127  98 117 185],256,5,34526,4.05282310130297,0.0,20.0
18519,1,8519,[132  12  96 121 742],344,3,34529,4.052699530516432,0.0,0.0
18520,1,8520,[173 127 271  98 117],629,5,34534,4.052810702969135,0.0,20.0
18521,1,8521,[427 588  79  98 127],796,5,34539,4.052921849331143,20.0,20.0
18522,1,8522,[ 12 748 175 210 423],151,4,34543,4.052915640032852,0.0,0.0
18523,1,8523,[427 588  79  98 127],389,5,34548,4.053026748005631,20.0,20.0
18524,1,8524,[427 588  79  98 127],18,5,34553,4.053137829912023,20.0,20.0
18525,1,8525,[168  79  82 655  88],796,3,34556,4.053014309171945,0.0,0.0
18526,1,8526,[176 183  70  97 546],344,2,34558,4.052773542863844,0.0,0.0
18527,1,8527,[180 265 313 215 181],796,4,34562,4.0527673545966225,0.0,0.0
18528,1,8528,[181 195 603 200  69],18,0,34562,4.052292179622465,20.0,0.0
18529,1,8529,[323 153 185 222 269],23,4,34566,4.052286049237984,0.0,0.0
18530,1,8530,[427 588  79  98 127],716,5,34571,4.052397139842926,20.0,20.0
18531,1,8531,[427 588  79  98 127],716,5,34576,4.052508204406939,20.0,20.0
18532,1,8532,[427 588  79  98 127],389,5,34581,4.052619242939177,20.0,20.0
18533,1,8533,[238 196 181 127 173],796,4,34585,4.052613077103351,0.0,20.0
18534,1,8534,[ 22 180 132 282 143],796,4,34589,4.052606912712361,0.0,0.0
18535,1,8535,[427 588  79  98 127],389,5,34594,4.052717900656045,20.0,20.0
18536,1,8536,[187  69 183  50  22],716,3,34597,4.052594588262856,0.0,20.0
18537,1,8537,[427 588  79  98 127],716,5,34602,4.0527055516514405,20.0,20.0
18538,1,8538,[301 202  88 121 161],655,0,34602,4.052230940391146,0.0,0.0
18539,1,8539,[427 588  79  98 127],716,5,34607,4.052341920374707,20.0,20.0
18540,1,8540,[238 211 127 655 318],796,2,34609,4.0521016274440935,20.0,20.0
18541,1,8541,[427 588  79  98 127],389,5,34614,4.0522125965815965,20.0,20.0
18542,1,8542,[357 121  88 275 427],330,5,34619,4.052323539740138,20.0,20.0
18543,1,8543,[427 588  79  98 127],796,5,34624,4.052434456928839,20.0,20.0
18544,1,8544,[ 56 257 179 496 100],389,4,34628,4.052428320655354,20.0,20.0
18545,1,8545,[182 275 186 144 180],535,3,34631,4.052305172010297,0.0,20.0
18546,1,8546,[427 588  79  98 127],450,5,34636,4.052416052416053,20.0,20.0
18547,1,8547,[  9 403 483 176 405],280,2,34638,4.052175947590079,0.0,0.0
18548,1,8548,[427 588  79  98 127],18,5,34643,4.052286817171599,20.0,20.0
18549,1,8549,[121 172 471 151 176],450,4,34647,4.052280701754386,0.0,0.0
18550,1,8550,[265 273  98 174 269],655,2,34649,4.052040696994504,0.0,0.0
18551,1,8551,[ 50  96 228 265 179],450,5,34654,4.052151543498597,0.0,20.0
18552,1,8552,[427 588  79  98 127],389,5,34659,4.052262364082778,20.0,20.0
18553,1,8553,[427 588  79  98 127],18,5,34664,4.052373158756137,20.0,20.0
18554,1,8554,[202  88 111 195 269],655,0,34664,4.051899473991818,0.0,0.0
18555,1,8555,[121 275 173 238 125],796,4,34668,4.051893408134642,0.0,20.0
18556,1,8556,[427 588  79  98 127],450,5,34673,4.0520042070819215,20.0,20.0
18557,1,8557,[427 588  79  98 127],18,5,34678,4.052114980135546,20.0,20.0
18558,1,8558,[427 588  79  98 127],18,5,34683,4.052225727304592,20.0,20.0
18559,1,8559,[471 294 322  64 127],256,4,34687,4.052219626168224,20.0,20.0
18560,1,8560,[427 588  79  98 127],716,5,34692,4.05233033524121,20.0,20.0
18561,1,8561,[427 588  79  98 127],450,5,34697,4.052441018453632,20.0,20.0
18562,1,8562,[135 121 403 186  15],269,1,34698,4.052084549807311,0.0,0.0
18563,1,8563,[ 89  97 191 546 174],344,3,34701,4.051961700140121,0.0,0.0
18564,1,8564,[427 588  79  98 127],389,5,34706,4.052072387624051,20.0,20.0
18565,1,8565,[144 111 235 117 175],457,3,34709,4.051949568059771,0.0,0.0
18566,1,8566,[313 423 173  11 111],280,3,34712,4.051826777168204,0.0,0.0
18567,1,8567,[200 282  88 515 196],716,4,34716,4.051820728291316,0.0,0.0
18568,1,8568,[427 588  79  98 127],450,5,34721,4.051931380557825,20.0,20.0
18569,1,8569,[427 588  79  98 127],450,5,34726,4.052042007001167,20.0,20.0
18570,1,8570,[300  98 385  79  96],655,2,34728,4.0518025901295065,0.0,0.0
18571,1,8571,[286  98 187 182 515],655,4,34732,4.051796546896874,0.0,20.0
18572,1,8572,[427 588  79  98 127],450,5,34737,4.051907150355768,20.0,20.0
18573,1,8573,[427 588  79  98 127],716,5,34742,4.0520177280149285,20.0,20.0
18574,1,8574,[427 588  79  98 127],389,5,34747,4.052128279883382,20.0,20.0
18575,1,8575,[ 79 174   4 423 172],593,5,34752,4.052238805970149,0.0,0.0
18576,1,8576,[427 588  79  98 127],389,5,34757,4.052349306284248,20.0,20.0
18577,1,8577,[427 588  79  98 127],389,5,34762,4.052459780834694,20.0,20.0
18578,1,8578,[210 322 180 427 132],796,2,34764,4.0522205385243035,20.0,0.0
18579,1,8579,[176 435 173 185 100],450,5,34769,4.052331002331003,0.0,20.0
18580,1,8580,[202 273 181 185 322],450,4,34773,4.052324903857359,0.0,0.0
18581,1,8581,[427 588  79  98 127],716,5,34778,4.0524353297599625,20.0,20.0
18582,1,8582,[435 405 322 288   1],450,4,34782,4.052429220552255,0.0,0.0
18583,1,8583,[427 588  79  98 127],389,5,34787,4.052539608574091,20.0,20.0
18584,1,8584,[237 132 210 172 121],450,3,34790,4.052417006406523,0.0,0.0
18585,1,8585,[427 588  79  98 127],450,5,34795,4.052527370137433,20.0,20.0
18586,1,8586,[ 64 258 215  12 185],450,5,34800,4.052637708163503,20.0,0.0
18587,1,8587,[427 588  79  98 127],796,5,34805,4.052748020493712,20.0,20.0
18588,1,8588,[655  50 245  11 210],593,2,34807,4.05250902316917,0.0,20.0
18589,1,8589,[144 483 117 748 211],796,4,34811,4.052502910360885,0.0,0.0
18590,1,8590,[427 588  79  98 127],450,5,34816,4.0526131998603185,20.0,20.0
18591,1,8591,[222 294 204 228 132],450,4,34820,4.052607076350093,0.0,0.0
18592,1,8592,[ 88 282 405 187 125],796,5,34825,4.052717328057722,0.0,0.0
18593,1,8593,[ 64  98   8 191 210],796,4,34829,4.052711193856179,20.0,0.0
18594,1,8594,[427 588  79  98 127],716,5,34834,4.052821407795229,20.0,20.0
18595,1,8595,[427 588  79  98 127],796,5,34839,4.052931596091205,20.0,20.0
18596,1,8596,[ 11 172  98 300 603],535,2,34841,4.052692799813888,20.0,0.0
18597,1,8597,[427 588  79  98 127],716,5,34846,4.052802977436613,20.0,20.0
18598,1,8598,[ 98  15 200  11 125],450,3,34849,4.052680544249331,0.0,0.0
18599,1,8599,[427 588  79  98 127],18,5,34854,4.052790697674419,20.0,20.0
18600,1,8600,[196 385 127 179 161],450,5,34859,4.052900825485409,0.0,20.0
18601,1,8601,[427 588  79  98 127],796,5,34864,4.0530109276912345,20.0,20.0
18602,1,8602,[ 98  70   1 211 655],151,5,34869,4.0531210043008254,0.0,0.0
18603,1,8603,[427 588  79  98 127],796,5,34874,4.0532310553231055,20.0,20.0
18604,1,8604,[427 588  79  98 127],18,5,34879,4.053341080766996,20.0,20.0
18605,1,8605,[427 588  79  98 127],389,5,34884,4.053451080641413,20.0,20.0
18606,1,8606,[  4 655 322 357 179],786,4,34888,4.053444870454282,0.0,0.0
18607,1,8607,[ 22 385 234 100 286],655,0,34888,4.052973977695167,0.0,40.0
18608,1,8608,[427 588  79  98 127],389,5,34893,4.053083981879428,20.0,20.0
18609,1,8609,[427 588  79  98 127],716,5,34898,4.053193960511034,20.0,20.0
18610,1,8610,[427 588  79  98 127],450,5,34903,4.053303913598885,20.0,20.0
18611,1,8611,[186  79  69  96 265],577,5,34908,4.053413841151881,0.0,0.0
18612,1,8612,[427 588  79  98 127],796,5,34913,4.053523743178916,20.0,20.0
18613,1,8613,[427 588  79  98 127],389,5,34918,4.0536336196888785,20.0,20.0
18614,1,8614,[427 588  79  98 127],450,5,34923,4.053743470690656,20.0,20.0
18615,1,8615,[427 588  79  98 127],450,5,34928,4.053853296193129,20.0,20.0
18616,1,8616,[ 50   7 186  98 282],296,4,34932,4.0538470465359175,0.0,20.0
18617,1,8617,[427 588  79  98 127],796,5,34937,4.053956834532374,20.0,20.0
18618,1,8618,[427 588  79  98 127],716,5,34942,4.054066597053023,20.0,20.0
18619,1,8619,[ 70  56 194 180 200],457,5,34947,4.054176334106729,0.0,0.0
18620,1,8620,[ 25 269 182 174 286],18,4,34951,4.054170049878205,0.0,20.0
18621,1,8621,[403 153 194 197 475],269,3,34954,4.05404778473672,0.0,0.0
18622,1,8622,[118 245 237 196 100],593,4,34958,4.054041516873478,0.0,20.0
18623,1,8623,[427 588  79  98 127],389,5,34963,4.05415120593692,20.0,20.0
18624,1,8624,[427 588  79  98 127],450,5,34968,4.054260869565217,20.0,20.0
18625,1,8625,[427 588  79  98 127],18,5,34973,4.054370507767215,20.0,20.0
18626,1,8626,[427 588  79  98 127],716,5,34978,4.054480120551756,20.0,20.0
18627,1,8627,[100 153  98 301 121],296,5,34983,4.054589707927677,0.0,20.0
18628,1,8628,[427 588  79  98 127],796,5,34988,4.0546992699038125,20.0,20.0
18629,1,8629,[427 588  79  98 127],450,5,34993,4.054808806488992,20.0,20.0
18630,1,8630,[427 588  79  98 127],389,5,34998,4.0549183176920405,20.0,20.0
18631,1,8631,[427 588  79  98 127],389,5,35003,4.05502780352178,20.0,20.0
18632,1,8632,[427 588  79  98 127],450,5,35008,4.055137263987026,20.0,20.0
18633,1,8633,[427 588  79  98 127],389,5,35013,4.055246699096595,20.0,20.0
18634,1,8634,[121 132 483 111  11],457,4,35017,4.055240301100174,0.0,0.0
18635,1,8635,[427 588  79  98 127],450,5,35022,4.055349698934692,20.0,20.0
18636,1,8636,[427 588  79  98 127],796,5,35027,4.055459071436841,20.0,20.0
18637,1,8637,[ 64  28 216 286 294],655,2,35029,4.055221115999074,20.0,20.0
18638,1,8638,[427 588  79  98 127],18,5,35034,4.055330478064591,20.0,20.0
18639,1,8639,[427 588  79  98 127],716,5,35039,4.0554398148148145,20.0,20.0
18640,1,8640,[174 179 318 423 161],577,4,35043,4.055433398912163,20.0,0.0
18641,1,8641,[546  95 180  79 427],450,4,35047,4.05542698449433,20.0,0.0
18642,1,8642,[427 588  79  98 127],796,5,35052,4.055536272127734,20.0,20.0
18643,1,8643,[597 191  15 100 197],457,4,35056,4.05552984729292,0.0,20.0
18644,1,8644,[187 238   4 173 195],786,5,35061,4.055639097744361,0.0,0.0
18645,1,8645,[269   8 515 328 237],655,1,35062,4.05528568123988,0.0,0.0
18646,1,8646,[427 588  79  98 127],450,5,35067,4.05539493465942,20.0,20.0
18647,1,8647,[179 475 197 357 172],269,4,35071,4.055388529139686,0.0,0.0
18648,1,8648,[427 588  79  98 127],796,5,35076,4.055497745404093,20.0,20.0
18649,1,8649,[  8 186 385   4  89],796,4,35080,4.055491329479769,0.0,0.0
18650,1,8650,[179  69 405 210 215],450,4,35084,4.055484915038724,0.0,0.0
18651,1,8651,[143 174 603  97   7],151,5,35089,4.055594082293111,20.0,0.0
18652,1,8652,[427 197 302 403 194],450,5,35094,4.055703224315266,20.0,0.0
18653,1,8653,[ 82 185 194 323 333],796,3,35097,4.0555812341113935,0.0,0.0
18654,1,8654,[204 268 515 200 237],655,2,35099,4.055343731946851,0.0,0.0
18655,1,8655,[ 79  28 423 176 258],23,2,35101,4.055106284658041,0.0,0.0
18656,1,8656,[427 588  79  98 127],450,5,35106,4.0552154325978975,20.0,20.0
18657,1,8657,[118 269 196 742 471],655,0,35106,4.054747054747055,0.0,0.0
18658,1,8658,[496 568 135  56 483],269,4,35110,4.054740732186165,20.0,0.0
18659,1,8659,[215 132 405 655 196],450,5,35115,4.054849884526559,0.0,0.0
18660,1,8660,[427 588  79  98 127],796,5,35120,4.054959011661471,20.0,20.0
18661,1,8661,[427 588  79  98 127],716,5,35125,4.0550681135996305,20.0,20.0
18662,1,8662,[195 333 313 204 117],796,5,35130,4.055177190349763,0.0,0.0
18663,1,8663,[135 180 216 173 197],716,3,35133,4.05505540166205,0.0,0.0
18664,1,8664,[289 202  97 204  12],655,0,35133,4.0545874206578185,0.0,0.0
18665,1,8665,[427 588  79  98 127],450,5,35138,4.0546965151165475,20.0,20.0
18666,1,8666,[427 588  79  98 127],18,5,35143,4.0548055844006,20.0,20.0
18667,1,8667,[427 588  79  98 127],796,5,35148,4.05491462851869,20.0,20.0
18668,1,8668,[427 588  79  98 127],389,5,35153,4.0550236474795245,20.0,20.0
18669,1,8669,[269 172 238 144  12],655,1,35154,4.054671280276817,0.0,0.0
18670,1,8670,[176 216 603 151   1],716,4,35158,4.054664975204705,20.0,0.0
18671,1,8671,[427 588  79  98 127],716,5,35163,4.054773985239852,20.0,20.0
18672,1,8672,[ 12   7  88 200  22],655,1,35164,4.054421768707483,0.0,0.0
18673,1,8673,[257 111 161 135 168],389,1,35165,4.054069633387134,0.0,0.0
18674,1,8674,[475 161 257 125  96],655,0,35165,4.053602305475504,0.0,0.0
18675,1,8675,[427 588  79  98 127],716,5,35170,4.053711387736284,20.0,20.0
18676,1,8676,[427 588  79  98 127],716,5,35175,4.053820444854212,20.0,20.0
18677,1,8677,[427 588  79  98 127],796,5,35180,4.053929476837981,20.0,20.0
18678,1,8678,[ 28   9 172 235 175],457,4,35184,4.0539232630487385,0.0,0.0
18679,1,8679,[588 121 385 187 135],716,2,35186,4.0536866359447,0.0,0.0
18680,1,8680,[ 98  95   9 174   4],796,4,35190,4.05368045156088,0.0,0.0
18681,1,8681,[427 151 216 357 655],151,5,35195,4.053789449435614,20.0,0.0
18682,1,8682,[ 71 100   9 143 117],593,4,35199,4.053783254635495,0.0,20.0
18683,1,8683,[174 187 202  50   9],256,3,35202,4.05366190695532,0.0,20.0
18684,1,8684,[427 588  79  98 127],389,5,35207,4.053770869314911,20.0,20.0
18685,1,8685,[427 588  79  98 127],18,5,35212,4.05387980658531,20.0,20.0
18686,1,8686,[496  96 194 125 655],796,4,35216,4.053873604236215,20.0,0.0
18687,1,8687,[228  89 179 161  12],655,2,35218,4.053637200736648,0.0,0.0
18688,1,8688,[435 238  12 655 204],450,5,35223,4.053746115778571,0.0,0.0
18689,1,8689,[ 12 328 173 210 183],796,4,35227,4.053739930955121,0.0,0.0
18690,1,8690,[  1 496 508 237 405],280,2,35229,4.053503624439075,20.0,0.0
18691,1,8691,[275 210 202 318 655],450,4,35233,4.053497468936953,20.0,20.0
18692,1,8692,[427 588  79  98 127],716,5,35238,4.0536063499367305,20.0,20.0
18693,1,8693,[144 127 328 196 276],629,4,35242,4.053600184034966,0.0,20.0
18694,1,8694,[427 588  79  98 127],716,5,35247,4.0537090281771135,20.0,20.0
18695,1,8695,[427 588  79  98 127],796,5,35252,4.053817847286108,20.0,20.0
18696,1,8696,[427 588  79  98 127],796,5,35257,4.0539266413705874,20.0,20.0
18697,1,8697,[427 588  79  98 127],450,5,35262,4.054035410439181,20.0,20.0
18698,1,8698,[427 588  79  98 127],389,5,35267,4.054144154500517,20.0,20.0
18699,1,8699,[ 88   1 222 151  28],450,4,35271,4.054137931034483,0.0,0.0
18700,1,8700,[427 588  79  98 127],18,5,35276,4.0542466383174345,20.0,20.0
18701,1,8701,[228 194 423 211 496],716,5,35281,4.05435532061595,20.0,0.0
18702,1,8702,[427 588  79  98 127],796,5,35286,4.054463977938642,20.0,20.0
18703,1,8703,[427 588  79  98 127],796,5,35291,4.054572610294118,20.0,20.0
18704,1,8704,[179  50 313 471 403],450,5,35296,4.054681217690982,0.0,20.0
18705,1,8705,[100 187   7  69 471],655,1,35297,4.0543303468872045,0.0,20.0
18706,1,8706,[427 588  79  98 127],716,5,35302,4.054438957160905,20.0,20.0
18707,1,8707,[228  22  50 328 742],450,5,35307,4.054547542489665,0.0,20.0
18708,1,8708,[300 183 125 258 153],504,3,35310,4.054426455390975,0.0,0.0
18709,1,8709,[  4 215 176   9  79],151,3,35313,4.054305396096441,0.0,0.0
18710,1,8710,[186 161 100   7  89],269,1,35314,4.053954769831248,0.0,20.0
18711,1,8711,[427 588  79  98 127],716,5,35319,4.054063360881543,20.0,20.0
18712,1,8712,[427 588  79  98 127],450,5,35324,4.054171927005624,20.0,20.0
18713,1,8713,[427 588  79  98 127],796,5,35329,4.054280468212072,20.0,20.0
18714,1,8714,[172 546 185 176 151],457,4,35333,4.054274239816409,0.0,0.0
18715,1,8715,[127 405 235 742 288],457,4,35337,4.054268012849931,0.0,20.0
18716,1,8716,[ 82 132  25 111 172],389,3,35340,4.054147068945738,0.0,0.0
18717,1,8717,[427 588  79  98 127],796,5,35345,4.054255563202569,20.0,20.0
18718,1,8718,[427 588  79  98 127],389,5,35350,4.0543640325725425,20.0,20.0
18719,1,8719,[427 588  79  98 127],389,5,35355,4.05447247706422,20.0,20.0
18720,1,8720,[186 125 603  88 143],450,4,35359,4.05446623093682,20.0,0.0
18721,1,8721,[427 588  79  98 127],716,5,35364,4.054574638844302,20.0,20.0
18722,1,8722,[427 588  79  98 127],796,5,35369,4.054683021896136,20.0,20.0
18723,1,8723,[427 588  79  98 127],716,5,35374,4.0547913801008715,20.0,20.0
18724,1,8724,[435 204 183 568 357],269,1,35375,4.054441260744985,0.0,0.0
18725,1,8725,[333 180 118 196 496],796,4,35379,4.054435021774009,20.0,0.0
18726,1,8726,[427 588  79  98 127],18,5,35384,4.054543371147015,20.0,20.0
18727,1,8727,[202 191 176 245 132],344,4,35388,4.054537121906508,0.0,0.0
18728,1,8728,[427 588  79  98 127],796,5,35393,4.054645434757704,20.0,20.0
18729,1,8729,[427 588  79  98 127],450,5,35398,4.05475372279496,20.0,20.0
18730,1,8730,[427 588  79  98 127],796,5,35403,4.054861986026801,20.0,20.0
18731,1,8731,[427 588  79  98 127],18,5,35408,4.05497022446175,20.0,20.0
18732,1,8732,[427 588  79  98 127],796,5,35413,4.055078438108325,20.0,20.0
18733,1,8733,[427 588  79  98 127],389,5,35418,4.05518662697504,20.0,20.0
18734,1,8734,[655 475 237 300  15],655,0,35418,4.054722381224957,0.0,0.0
18735,1,8735,[435 197 546 423 186],151,4,35422,4.054716117216117,0.0,0.0
18736,1,8736,[185 245 187 182 235],450,4,35426,4.054709854641181,0.0,0.0
18737,1,8737,[228   9 111 182 172],796,4,35430,4.0547035934996565,0.0,0.0
18738,1,8738,[ 98 144 237  79 318],535,2,35432,4.05446847465385,20.0,0.0
18739,1,8739,[  4 168 204   7  50],535,4,35436,4.054462242562929,0.0,20.0
18740,1,8740,[427 588  79  98 127],389,5,35441,4.054570415284292,20.0,20.0
18741,1,8741,[ 88   7 204   8  50],344,4,35445,4.054564172958133,0.0,20.0
18742,1,8742,[427 588  79  98 127],18,5,35450,4.054672309275992,20.0,20.0
18743,1,8743,[427 588  79  98 127],716,5,35455,4.054780420860018,20.0,20.0
18744,1,8744,[427 588  79  98 127],389,5,35460,4.0548885077186965,20.0,20.0
18745,1,8745,[276 515 294 289  15],655,2,35462,4.0546535559112735,0.0,0.0
18746,1,8746,[ 79 275  71 196 197],389,4,35466,4.054647307648336,0.0,20.0
18747,1,8747,[  4  95 191 161   1],716,3,35469,4.054526748971194,0.0,0.0
18748,1,8748,[427 588  79  98 127],18,5,35474,4.054634815407475,20.0,20.0
18749,1,8749,[427 588  79  98 127],450,5,35479,4.054742857142857,20.0,20.0
18750,1,8750,[427 588  79  98 127],716,5,35484,4.054850874185807,20.0,20.0
18751,1,8751,[282 313  64 289 179],236,4,35488,4.0548446069469835,20.0,0.0
18752,1,8752,[ 11 151 597 288 187],450,4,35492,4.05483834114018,0.0,0.0
18753,1,8753,[ 79 197 483 153 185],151,4,35496,4.0548320767649075,0.0,0.0
18754,1,8754,[427 588  79  98 127],450,5,35501,4.054940034266133,20.0,20.0
18755,1,8755,[471 211 173  50 265],786,5,35506,4.055047967108268,0.0,20.0
18756,1,8756,[427 588  79  98 127],18,5,35511,4.05515587529976,20.0,20.0
18757,1,8757,[191 153  88 286  97],796,3,35514,4.05503539620918,0.0,20.0
18758,1,8758,[ 71 678 235 195  50],344,2,35516,4.054800776344331,0.0,20.0
18759,1,8759,[427 588  79  98 127],389,5,35521,4.054908675799087,20.0,20.0
18760,1,8760,[427 588  79  98 127],450,5,35526,4.055016550622075,20.0,20.0
18761,1,8761,[245 678 568  98 269],344,3,35529,4.054896142433234,0.0,0.0
18762,1,8762,[181 176   4 405 118],716,2,35531,4.054661645555175,0.0,0.0
18763,1,8763,[153   4 483  22   1],450,3,35534,4.054541305340027,0.0,0.0
18764,1,8764,[427 588  79  98 127],796,5,35539,4.054649172846549,20.0,20.0
18765,1,8765,[191 185 183 117 742],655,3,35542,4.054528861510381,0.0,0.0
18766,1,8766,[427 588  79  98 127],796,5,35547,4.054636705828676,20.0,20.0
18767,1,8767,[200 385 286 405 282],450,4,35551,4.054630474452555,0.0,20.0
18768,1,8768,[151 194  70 121 294],401,2,35553,4.054396168320219,0.0,0.0
18769,1,8769,[427 588  79  98 127],796,5,35558,4.054503990877993,20.0,20.0
18770,1,8770,[427 588  79  98 127],18,5,35563,4.054611788849618,20.0,20.0
18771,1,8771,[427 588  79  98 127],18,5,35568,4.054719562243502,20.0,20.0
18772,1,8772,[234  25  82 282 186],716,3,35571,4.0545993388806565,0.0,0.0
18773,1,8773,[475 127 216 210  96],655,2,35573,4.054365169819922,0.0,20.0
18774,1,8774,[471  70 186 423 435],655,0,35573,4.053903133903134,0.0,0.0
18775,1,8775,[427 588  79  98 127],716,5,35578,4.054010938924339,20.0,20.0
18776,1,8776,[427 588  79  98 127],716,5,35583,4.054118719380198,20.0,20.0
18777,1,8777,[  4 196 175 234 183],655,1,35584,4.053770790612896,0.0,0.0
18778,1,8778,[427 588  79  98 127],716,5,35589,4.053878573869461,20.0,20.0
18779,1,8779,[427 588  79  98 127],18,5,35594,4.0539863325740315,20.0,20.0
18780,1,8780,[427 588  79  98 127],796,5,35599,4.054094066734996,20.0,20.0
18781,1,8781,[ 11 200 427 121 144],655,2,35601,4.053860168526532,20.0,0.0
18782,1,8782,[ 64 175 216 195 172],269,2,35603,4.053626323579643,20.0,0.0
18783,1,8783,[153 180 318 275 427],535,5,35608,4.053734061930784,40.0,20.0
18784,1,8784,[427 588  79  98 127],716,5,35613,4.053841775754126,20.0,20.0
18785,1,8785,[202 135 435 111 210],401,4,35617,4.053835647621216,0.0,0.0
18786,1,8786,[427 588  79  98 127],450,5,35622,4.05394332536702,20.0,20.0
18787,1,8787,[ 95 202 176 655  96],796,4,35626,4.053937187073282,0.0,0.0
18788,1,8788,[423 186  82 546 483],796,3,35629,4.0538172715894865,0.0,0.0
18789,1,8789,[ 70  50 588 222  97],716,5,35634,4.053924914675768,0.0,20.0
18790,1,8790,[427 588  79  98 127],389,5,35639,4.054032533272665,20.0,20.0
18791,1,8791,[357 196 568 222  50],457,5,35644,4.054140127388535,0.0,20.0
18792,1,8792,[144 568 318 183 333],693,3,35647,4.054020243375413,20.0,0.0
18793,1,8793,[427 588  79  98 127],716,5,35652,4.054127814418922,20.0,20.0
18794,1,8794,[ 22 176 427 194  64],577,5,35657,4.054235361000568,40.0,0.0
18795,1,8795,[427 588  79  98 127],389,5,35662,4.054342883128695,20.0,20.0
18796,1,8796,[427 588  79  98 127],18,5,35667,4.05445038081164,20.0,20.0
18797,1,8797,[275 385 328   1 318],401,3,35670,4.054330529665833,20.0,20.0
18798,1,8798,[111  50 405  97 183],450,5,35675,4.054438004318673,0.0,20.0
18799,1,8799,[301 237 204  50 289],655,1,35676,4.054090909090909,0.0,20.0
18800,1,8800,[ 50 194 222 176 423],72,2,35678,4.053857516191342,0.0,20.0
18801,1,8801,[121 427  12  28 211],693,2,35680,4.053624176323563,20.0,0.0
18802,1,8802,[318 357 211 153 194],504,3,35683,4.053504487106668,20.0,0.0
18803,1,8803,[183  28 191  88 568],577,3,35686,4.053384825079509,0.0,0.0
18804,1,8804,[132   9 168  82  12],18,3,35689,4.053265190232822,0.0,0.0
18805,1,8805,[385 435  82 238 118],151,2,35691,4.053032023620259,0.0,0.0
18806,1,8806,[427 588  79  98 127],18,5,35696,4.053139548086749,20.0,20.0
18807,1,8807,[655 423 546 215  50],577,4,35700,4.053133514986376,0.0,20.0
18808,1,8808,[427 588  79  98 127],796,5,35705,4.053241003519128,20.0,20.0
18809,1,8809,[427 588  79  98 127],18,5,35710,4.053348467650397,20.0,20.0
18810,1,8810,[427 588  79  98 127],18,5,35715,4.053455907388492,20.0,20.0
18811,1,8811,[427 588  79  98 127],796,5,35720,4.053563322741716,20.0,20.0
18812,1,8812,[427 588  79  98 127],450,5,35725,4.053670713718371,20.0,20.0
18813,1,8813,[ 28 427 301  98 322],151,4,35729,4.053664624461085,20.0,0.0
18814,1,8814,[427 588  79  98 127],18,5,35734,4.053771979580261,20.0,20.0
18815,1,8815,[258 603   9 286  28],655,1,35735,4.05342558983666,20.0,20.0
18816,1,8816,[427 588  79  98 127],18,5,35740,4.0535329477146425,20.0,20.0
18817,1,8817,[282 194 546 118 235],450,3,35743,4.053413472442731,0.0,0.0
18818,1,8818,[546  88 161 237 265],796,5,35748,4.0535208073477715,0.0,0.0
18819,1,8819,[427 588  79  98 127],450,5,35753,4.053628117913832,20.0,20.0
18820,1,8820,[194 173 121 405 655],401,1,35754,4.053281940823036,0.0,0.0
18821,1,8821,[427 588  79  98 127],796,5,35759,4.053389254137384,20.0,20.0
18822,1,8822,[427 588  79  98 127],18,5,35764,4.053496543125921,20.0,20.0
18823,1,8823,[ 12 117  25 185   9],693,4,35768,4.0534904805077066,0.0,0.0
18824,1,8824,[427 588  79  98 127],450,5,35773,4.053597733711048,20.0,20.0
18825,1,8825,[176 275 403  25 245],450,4,35777,4.053591661001586,0.0,20.0
18826,1,8826,[427 588  79  98 127],18,5,35782,4.053698878441146,20.0,20.0
18827,1,8827,[ 28   8 423  82 276],18,3,35785,4.053579519710014,0.0,0.0
18828,1,8828,[268  69 175 475 238],655,0,35785,4.053120398686148,0.0,0.0
18829,1,8829,[427 588  79  98 127],450,5,35790,4.053227633069083,20.0,20.0
18830,1,8830,[302 234 258 742 597],450,4,35794,4.053221605707168,0.0,0.0
18831,1,8831,[ 71 222 211 286 200],786,5,35799,4.053328804347826,0.0,20.0
18832,1,8832,[176 100   7 427 216],450,5,35804,4.053435978716178,20.0,20.0
18833,1,8833,[427 588  79  98 127],716,5,35809,4.053543128820467,20.0,20.0
18834,1,8834,[245 597 275 385 151],450,5,35814,4.053650254668931,0.0,20.0
18835,1,8835,[568 180 483 471 265],450,4,35818,4.053644182888185,0.0,0.0
18836,1,8836,[427 588  79  98 127],389,5,35823,4.053751273056467,20.0,20.0
18837,1,8837,[427 588  79  98 127],389,5,35828,4.053858338990722,20.0,20.0
18838,1,8838,[151  69 202 216 222],344,4,35832,4.053852245729155,0.0,0.0
18839,1,8839,[427 588  79  98 127],389,5,35837,4.0539592760181,20.0,20.0
18840,1,8840,[427 588  79  98 127],796,5,35842,4.0540662820947855,20.0,20.0
18841,1,8841,[187  88  98   1 655],450,5,35847,4.054173263967428,0.0,0.0
18842,1,8842,[196   1 168 546 302],151,3,35850,4.054054054054054,0.0,0.0
18843,1,8843,[427 588  79  98 127],450,5,35855,4.054161013116237,20.0,20.0
18844,1,8844,[ 28 471 125 194 222],450,4,35859,4.05415488976823,0.0,0.0
18845,1,8845,[ 28 185 294 181 318],796,3,35862,4.054035722360389,20.0,0.0
18846,1,8846,[427 588  79  98 127],796,5,35867,4.054142647225048,20.0,20.0
18847,1,8847,[125 405 471 234  69],450,4,35871,4.054136528028933,0.0,0.0
18848,1,8848,[427 588  79  98 127],716,5,35876,4.054243417335292,20.0,20.0
18849,1,8849,[121 132 742 191  28],796,3,35879,4.054124293785311,0.0,0.0
18850,1,8850,[427 588  79  98 127],716,5,35884,4.054231160320867,20.0,20.0
18851,1,8851,[  4  70  88 222 588],450,3,35887,4.054112065070041,0.0,0.0
18852,1,8852,[ 50 210 333 423   1],174,3,35890,4.053992996724274,0.0,20.0
18853,1,8853,[ 64  89 357 143 111],151,5,35895,4.054099841879377,20.0,0.0
18854,1,8854,[427 588  79  98 127],389,5,35900,4.054206662902315,20.0,20.0
18855,1,8855,[302 235 435 237  11],401,1,35901,4.053861788617886,0.0,0.0
18856,1,8856,[427 588  79  98 127],796,5,35906,4.053968612396974,20.0,20.0
18857,1,8857,[427 588  79  98 127],18,5,35911,4.054075412056898,20.0,20.0
18858,1,8858,[427 588  79  98 127],389,5,35916,4.054182187605824,20.0,20.0
18859,1,8859,[427 588  79  98 127],716,5,35921,4.054288939051919,20.0,20.0
18860,1,8860,[153 210   4 173 603],264,5,35926,4.05439566640334,20.0,0.0
18861,1,8861,[427 588  79  98 127],450,5,35931,4.0545023696682465,20.0,20.0
18862,1,8862,[ 82 210  95 132 186],577,4,35935,4.054496220241453,0.0,0.0
18863,1,8863,[  9 144 117 385 237],655,0,35935,4.05403880866426,0.0,0.0
18864,1,8864,[  7  70  28 175  88],23,2,35937,4.053807106598985,0.0,0.0
18865,1,8865,[427 588  79  98 127],796,5,35942,4.053913828107376,20.0,20.0
18866,1,8866,[235 403  11   8 195],269,0,35942,4.053456636968535,0.0,0.0
18867,1,8867,[195  82 168 181 197],450,4,35946,4.053450608930988,0.0,0.0
18868,1,8868,[427 588  79  98 127],716,5,35951,4.053557334536024,20.0,20.0
18869,1,8869,[100 403  70 202 211],655,0,35951,4.053100338218715,0.0,20.0
18870,1,8870,[427 588  79  98 127],18,5,35956,4.0532070792469845,20.0,20.0
18871,1,8871,[427 588  79  98 127],389,5,35961,4.053313796212804,20.0,20.0
18872,1,8872,[271  15 118  12 174],655,0,35961,4.052856981855066,0.0,0.0
18873,1,8873,[191 603 174  12 385],450,5,35966,4.05296371422132,20.0,0.0
18874,1,8874,[427 588  79  98 127],389,5,35971,4.053070422535211,20.0,20.0
18875,1,8875,[161  28 423 427 186],693,1,35972,4.052726453357368,20.0,0.0
18876,1,8876,[471 269 300 117  69],655,0,35972,4.05226991100597,0.0,0.0
18877,1,8877,[427 588  79  98 127],18,5,35977,4.052376661410228,20.0,20.0
18878,1,8878,[427 588  79  98 127],450,5,35982,4.052483387768893,20.0,20.0
18879,1,8879,[427 588  79  98 127],18,5,35987,4.05259009009009,20.0,20.0
18880,1,8880,[ 79 245 118  71 265],280,3,35990,4.052471568517059,0.0,0.0
18881,1,8881,[204 118 211 238 179],655,1,35991,4.052127899121819,0.0,0.0
18882,1,8882,[257 282 475 269 211],655,0,35991,4.051671732522796,0.0,0.0
18883,1,8883,[423   8 588 322 318],280,5,35996,4.05177847816299,20.0,0.0
18884,1,8884,[427 588  79  98 127],796,5,36001,4.051885199774902,20.0,20.0
18885,1,8885,[427 588  79  98 127],716,5,36006,4.051991897366644,20.0,20.0
18886,1,8886,[427 588  79  98 127],450,5,36011,4.052098570946326,20.0,20.0
18887,1,8887,[427 588  79  98 127],389,5,36016,4.052205220522052,20.0,20.0
18888,1,8888,[427 588  79  98 127],450,5,36021,4.052311846101924,20.0,20.0
18889,1,8889,[100 238  15 471 179],655,1,36022,4.051968503937008,0.0,20.0
18890,1,8890,[191  11  15 183 301],655,2,36024,4.05173771229333,0.0,0.0
18891,1,8891,[168 588 204  71 748],401,1,36025,4.051394511920828,0.0,0.0
18892,1,8892,[427 588  79  98 127],389,5,36030,4.051501180703925,20.0,20.0
18893,1,8893,[  1  79 235 161 117],256,4,36034,4.051495390150663,0.0,0.0
18894,1,8894,[176 204  98 258 471],457,5,36039,4.051602023608769,0.0,0.0
18895,1,8895,[427 588  79  98 127],716,5,36044,4.051708633093525,20.0,20.0
18896,1,8896,[302 186 276 357  89],269,2,36046,4.051478026301,0.0,0.0
18897,1,8897,[427 588  79  98 127],716,5,36051,4.051584625758597,20.0,20.0
18898,1,8898,[427 588  79  98 127],389,5,36056,4.051691201258568,20.0,20.0
18899,1,8899,[427 588  79  98 127],796,5,36061,4.051797752808989,20.0,20.0
18900,1,8900,[427 588  79  98 127],18,5,36066,4.05190428041793,20.0,20.0
18901,1,8901,[427 588  79  98 127],716,5,36071,4.052010784093462,20.0,20.0
18902,1,8902,[427 588  79  98 127],450,5,36076,4.052117263843648,20.0,20.0
18903,1,8903,[196  89 276 603 210],18,2,36078,4.05188679245283,20.0,0.0
18904,1,8904,[ 12 211 286 111 258],151,5,36083,4.05199326221224,0.0,20.0
18905,1,8905,[427 588  79  98 127],716,5,36088,4.052099708061981,20.0,20.0
18906,1,8906,[427 588  79  98 127],450,5,36093,4.052206130010104,20.0,20.0
18907,1,8907,[427 588  79  98 127],796,5,36098,4.052312528064661,20.0,20.0
18908,1,8908,[427 588  79  98 127],450,5,36103,4.052418902233696,20.0,20.0
18909,1,8909,[427 588  79  98 127],18,5,36108,4.052525252525252,20.0,20.0
18910,1,8910,[427 588  79  98 127],796,5,36113,4.052631578947368,20.0,20.0
18911,1,8911,[405 357 235 742   7],457,4,36117,4.052625673249551,0.0,0.0
18912,1,8912,[588 210 195 172 496],280,2,36119,4.052395377538427,20.0,0.0
18913,1,8913,[427 588  79  98 127],389,5,36124,4.052501682746242,20.0,20.0
18914,1,8914,[427 588  79  98 127],716,5,36129,4.05260796410544,20.0,20.0
18915,1,8915,[427 588  79  98 127],18,5,36134,4.052714221624047,20.0,20.0
18916,1,8916,[483 181 180  22 405],280,3,36137,4.052596164629359,0.0,0.0
18917,1,8917,[427 588  79  98 127],450,5,36142,4.052702399641175,20.0,20.0
18918,1,8918,[237 173 238  97  98],11,3,36145,4.052584370445117,0.0,0.0
18919,1,8919,[427 588  79  98 127],18,5,36150,4.052690582959642,20.0,20.0
18920,1,8920,[427 588  79  98 127],716,5,36155,4.052796771662369,20.0,20.0
18921,1,8921,[427 588  79  98 127],389,5,36160,4.052902936561309,20.0,20.0
18922,1,8922,[ 98 185 318 127  11],716,5,36165,4.053009077664463,20.0,20.0
18923,1,8923,[  7 271 196 289 176],655,0,36165,4.0525549081129535,0.0,0.0
18924,1,8924,[ 89  12 180 288 228],450,4,36169,4.052549019607843,0.0,0.0
18925,1,8925,[588 121 515  96 603],716,4,36173,4.052543132422137,20.0,0.0
18926,1,8926,[179 403 204 202 508],655,1,36174,4.052201187408984,0.0,0.0
18927,1,8927,[ 98 196   9 588  97],796,3,36177,4.052083333333333,0.0,0.0
18928,1,8928,[427 588  79  98 127],18,5,36182,4.052189494904245,20.0,20.0
18929,1,8929,[269 515 301 100 194],535,4,36186,4.052183650615901,0.0,20.0
18930,1,8930,[161 235  50  88 176],716,2,36188,4.051953868547755,0.0,20.0
18931,1,8931,[179 175 268  69 196],655,1,36189,4.051612180922525,0.0,0.0
18932,1,8932,[151 275 427  79 405],151,4,36193,4.0516064032240005,20.0,20.0
18933,1,8933,[427 588  79  98 127],389,5,36198,4.0517125587642715,20.0,20.0
18934,1,8934,[471 271 181  69 273],655,1,36199,4.051371012870733,0.0,0.0
18935,1,8935,[427 588  79  98 127],716,5,36204,4.051477170993733,20.0,20.0
18936,1,8936,[427 588  79  98 127],796,5,36209,4.05158330535974,20.0,20.0
18937,1,8937,[294 748  70   7 215],450,5,36214,4.051689415976728,0.0,0.0
18938,1,8938,[427 588  79  98 127],716,5,36219,4.051795502852668,20.0,20.0
18939,1,8939,[144 471  50 222 135],450,3,36222,4.051677852348993,0.0,20.0
18940,1,8940,[286  28 175 191 216],11,3,36225,4.051560228162398,0.0,20.0
18941,1,8941,[427 588  79  98 127],796,5,36230,4.051666293893984,20.0,20.0
18942,1,8942,[172 286 174 181 234],796,3,36233,4.051548697305154,0.0,20.0
18943,1,8943,[216 143 111  12 191],450,5,36238,4.051654740608229,0.0,0.0
18944,1,8944,[427 588  79  98 127],18,5,36243,4.05176076020123,20.0,20.0
18945,1,8945,[211 238 196 111  79],11,3,36246,4.051643192488263,0.0,0.0
18946,1,8946,[427 588  79  98 127],796,5,36251,4.051749189672516,20.0,20.0
18947,1,8947,[427 588  79  98 127],450,5,36256,4.051855163164953,20.0,20.0
18948,1,8948,[427 588  79  98 127],389,5,36261,4.051961112973516,20.0,20.0
18949,1,8949,[ 64   7   1 235 143],450,4,36265,4.05195530726257,20.0,0.0
18950,1,8950,[328 289 151 294 125],837,5,36270,4.052061222209809,0.0,0.0
18951,1,8951,[427 588  79  98 127],389,5,36275,4.052167113494192,20.0,20.0
18952,1,8952,[427 588  79  98 127],18,5,36280,4.052272981123646,20.0,20.0
18953,1,8953,[483 245 322 173 427],796,3,36283,4.05215546124637,20.0,0.0
18954,1,8954,[427 588  79  98 127],18,5,36288,4.052261306532663,20.0,20.0
18955,1,8955,[742 597  71 301 273],796,2,36290,4.052032157213041,0.0,0.0
18956,1,8956,[405  22  69 143 318],716,5,36295,4.052137992631462,20.0,0.0
18957,1,8957,[ 50 275 174  64   9],401,2,36297,4.051908908238446,20.0,40.0
18958,1,8958,[427 588  79  98 127],389,5,36302,4.052014733787253,20.0,20.0
18959,1,8959,[144 275 333 238 132],796,4,36306,4.0520089285714285,0.0,20.0
18960,1,8960,[257 238  89 269 603],23,4,36310,4.052003124651266,20.0,0.0
18961,1,8961,[427 588  79  98 127],18,5,36315,4.052108904262441,20.0,20.0
18962,1,8962,[748 282  79 405  11],256,4,36319,4.052103090483097,0.0,0.0
18963,1,8963,[427 588  79  98 127],796,5,36324,4.052208835341365,20.0,20.0
18964,1,8964,[427 269 216 423  97],796,3,36327,4.052091466815393,20.0,0.0
18965,1,8965,[427 588  79  98 127],389,5,36332,4.0521971893821105,20.0,20.0
18966,1,8966,[427 588  79  98 127],450,5,36337,4.052302888368462,20.0,20.0
18967,1,8967,[427 588  79  98 127],450,5,36342,4.052408563782337,20.0,20.0
18968,1,8968,[427 588  79  98 127],796,5,36347,4.05251421563162,20.0,20.0
18969,1,8969,[151 117 237 174 186],504,3,36350,4.052396878483835,0.0,0.0
18970,1,8970,[187 143 427 174 196],693,3,36353,4.052279567495263,20.0,0.0
18971,1,8971,[427 588  79  98 127],796,5,36358,4.052385198395006,20.0,20.0
18972,1,8972,[427 588  79  98 127],716,5,36363,4.052490805750585,20.0,20.0
18973,1,8973,[302 238 211 196 597],450,5,36368,4.052596389569868,0.0,0.0
18974,1,8974,[125 181  64  95 174],450,4,36372,4.052590529247911,20.0,0.0
18975,1,8975,[427 588  79  98 127],18,5,36377,4.052696078431373,20.0,20.0
18976,1,8976,[196 313 568 121 238],450,4,36381,4.052690208310126,0.0,0.0
18977,1,8977,[282 275 300 127  50],796,5,36386,4.052795722878146,0.0,60.0
18978,1,8978,[ 11 153 100 175 185],655,1,36387,4.052455730036752,0.0,20.0
18979,1,8979,[ 69 168  11  25 211],401,2,36389,4.052227171492205,0.0,0.0
18980,1,8980,[282 748 187 202 385],256,2,36391,4.051998663845897,0.0,0.0
18981,1,8981,[111 211 175 655 181],716,4,36395,4.051992874638165,0.0,0.0
18982,1,8982,[322  69 125  88  56],450,5,36400,4.052098408104197,0.0,0.0
18983,1,8983,[302 204 174 185 496],389,5,36405,4.0522039180765805,20.0,0.0
18984,1,8984,[427 588  79  98 127],796,5,36410,4.052309404563161,20.0,20.0
18985,1,8985,[100  70 143 265 186],457,5,36415,4.052414867571779,0.0,20.0
18986,1,8986,[185 302 568 195 215],450,5,36420,4.05252030711027,0.0,0.0
18987,1,8987,[289  11 132 186  56],655,0,36420,4.052069425901202,0.0,0.0
18988,1,8988,[427 588  79  98 127],716,5,36425,4.052174880409389,20.0,20.0
18989,1,8989,[ 98 191 111 196 197],269,3,36428,4.052057842046718,0.0,0.0
18990,1,8990,[427 588  79  98 127],450,5,36433,4.052163274385497,20.0,20.0
18991,1,8991,[427 588  79  98 127],450,5,36438,4.052268683274021,20.0,20.0
18992,1,8992,[172 153 273  89  79],655,4,36442,4.052262871121984,0.0,0.0
18993,1,8993,[427 588  79  98 127],389,5,36447,4.052368245496998,20.0,20.0
18994,1,8994,[427 588  79  98 127],18,5,36452,4.052473596442468,20.0,20.0
18995,1,8995,[ 12 121 194 132 210],457,5,36457,4.052578923966207,0.0,0.0
18996,1,8996,[427 588  79  98 127],18,5,36462,4.052684228076025,20.0,20.0
18997,1,8997,[ 22 132 300 237  50],450,5,36467,4.052789508779729,0.0,20.0
18998,1,8998,[427 588  79  98 127],450,5,36472,4.052894766085121,20.0,20.0
18999,1,8999,[427 588  79  98 127],389,5,36477,4.053,20.0,20.0
19000,1,9000,[153 181  69 200 403],655,1,36478,4.052660815464948,0.0,0.0
19001,1,9001,[301 215 427 211  97],655,1,36479,4.052321706287492,20.0,0.0
19002,1,9002,[427 588  79  98 127],389,5,36484,4.052426968788182,20.0,20.0
19003,1,9003,[302 508 282 132 215],655,1,36485,4.052087960906264,0.0,0.0
19004,1,9004,[118   8 508  88  79],655,1,36486,4.051749028317602,0.0,0.0
19005,1,9005,[427 588  79  98 127],450,5,36491,4.05185431934266,20.0,20.0
19006,1,9006,[427 588  79  98 127],716,5,36496,4.051959586987898,20.0,20.0
19007,1,9007,[427 588  79  98 127],796,5,36501,4.052064831261101,20.0,20.0
19008,1,9008,[186  56 118 215 655],457,5,36506,4.0521700521700525,0.0,0.0
19009,1,9009,[118 357  79 289 210],693,2,36508,4.051942286348502,0.0,0.0
19010,1,9010,[427 588  79  98 127],716,5,36513,4.052047497503052,20.0,20.0
19011,1,9011,[172 111 238 202 168],389,4,36517,4.052041722148247,0.0,0.0
19012,1,9012,[215 183  82 121 385],655,1,36518,4.051703095528681,0.0,0.0
19013,1,9013,[427 588  79  98 127],389,5,36523,4.051808298202796,20.0,20.0
19014,1,9014,[427 588  79  98 127],450,5,36528,4.051913477537438,20.0,20.0
19015,1,9015,[ 88 294  12  89 191],457,4,36532,4.051907719609583,0.0,0.0
19016,1,9016,[483  71 269 588 185],23,4,36536,4.051901962958856,0.0,0.0
19017,1,9017,[238 196 153 748 111],151,3,36539,4.051785318252384,0.0,0.0
19018,1,9018,[357 427  25 195 423],330,4,36543,4.051779576449717,20.0,0.0
19019,1,9019,[100  95 471 215   8],280,2,36545,4.051552106430155,0.0,20.0
19020,1,9020,[483  69 194  79 211],450,4,36549,4.051546391752577,0.0,0.0
19021,1,9021,[ 64 300 117 200 294],796,4,36553,4.051540678341831,20.0,0.0
19022,1,9022,[427 588  79  98 127],796,5,36558,4.051645794081791,20.0,20.0
19023,1,9023,[144 275 237 186 282],655,1,36559,4.051307624113475,0.0,20.0
19024,1,9024,[135  88  69 196  79],151,5,36564,4.051412742382271,0.0,0.0
19025,1,9025,[405  88 173 202  22],796,5,36569,4.051517837358741,0.0,0.0
19026,1,9026,[742 210 161 234 655],504,4,36573,4.051512130275839,0.0,0.0
19027,1,9027,[175 282 288  28 427],655,1,36574,4.051174124944617,20.0,0.0
19028,1,9028,[161 568 237 258 151],457,5,36579,4.051279211429837,0.0,0.0
19029,1,9029,[168 100 405 196 234],151,3,36582,4.051162790697674,0.0,20.0
19030,1,9030,[174 121 318  28 286],655,1,36583,4.050824936330417,20.0,20.0
19031,1,9031,[427 588  79  98 127],716,5,36588,4.050930026572188,20.0,20.0
19032,1,9032,[132 180  25 568 117],457,5,36593,4.051035093545887,0.0,0.0
19033,1,9033,[546 196 204 173   1],23,2,36595,4.050808058445871,0.0,0.0
19034,1,9034,[117 435 265 286 125],655,0,36595,4.0503597122302155,0.0,20.0
19035,1,9035,[427 588  79  98 127],450,5,36600,4.050464807436919,20.0,20.0
19036,1,9036,[ 97  95  28 215  25],716,5,36605,4.050569879384752,0.0,0.0
19037,1,9037,[196 435 194  98 597],269,2,36607,4.050342996238106,0.0,0.0
19038,1,9038,[ 82 186 210 200 174],269,1,36608,4.050005531585352,0.0,0.0
19039,1,9039,[427 588  79  98 127],389,5,36613,4.050110619469026,20.0,20.0
19040,1,9040,[215 294  98 191 176],450,5,36618,4.050215684105741,0.0,0.0
19041,1,9041,[427 588  79  98 127],716,5,36623,4.050320725503207,20.0,20.0
19042,1,9042,[301  95 125  71 173],450,3,36626,4.050204578126728,0.0,0.0
19043,1,9043,[127 427 195   8 187],18,4,36630,4.050199026979213,20.0,20.0
19044,1,9044,[568 211  98 286 328],655,1,36631,4.049861802100608,0.0,20.0
19045,1,9045,[427 588  79  98 127],716,5,36636,4.049966836170683,20.0,20.0
19046,1,9046,[427 588  79  98 127],18,5,36641,4.050071847021112,20.0,20.0
19047,1,9047,[427 588  79  98 127],716,5,36646,4.050176834659593,20.0,20.0
19048,1,9048,[275 179 183 385 153],593,4,36650,4.050171289645265,0.0,20.0
19049,1,9049,[427 588  79  98 127],450,5,36655,4.050276243093923,20.0,20.0
19050,1,9050,[427 588  79  98 127],716,5,36660,4.050381173351011,20.0,20.0
19051,1,9051,[ 12  25  79 143 234],18,3,36663,4.050265134776845,0.0,0.0
19052,1,9052,[183 125 228   1 200],655,2,36665,4.050038661217276,0.0,0.0
19053,1,9053,[427 588  79  98 127],796,5,36670,4.050143582946764,20.0,20.0
19054,1,9054,[172 144 496 215 742],796,4,36674,4.050138045278851,20.0,0.0
19055,1,9055,[427 588  79  98 127],716,5,36679,4.050242932862191,20.0,20.0
19056,1,9056,[322 161 265 234 180],280,4,36683,4.05023738544772,0.0,0.0
19057,1,9057,[427 588  79  98 127],796,5,36688,4.050342238904835,20.0,20.0
19058,1,9058,[427 588  79  98 127],18,5,36693,4.050447069212938,20.0,20.0
19059,1,9059,[288 496 403  11 276],280,4,36697,4.0504415011037525,20.0,0.0
19060,1,9060,[427 588  79  98 127],716,5,36702,4.050546297318177,20.0,20.0
19061,1,9061,[173  71 301 215 288],344,3,36705,4.0504303685720595,0.0,0.0
19062,1,9062,[211 508 603 179 195],269,4,36709,4.0504248041487365,20.0,0.0
19063,1,9063,[194 185 655 200  25],457,5,36714,4.050529567519859,0.0,0.0
19064,1,9064,[427 588  79  98 127],18,5,36719,4.050634307777165,20.0,20.0
19065,1,9065,[173 191 215 294 234],716,5,36724,4.050739024928304,0.0,0.0
19066,1,9066,[427 588  79  98 127],18,5,36729,4.05084371898092,20.0,20.0
19067,1,9067,[427 588  79  98 127],450,5,36734,4.050948389942655,20.0,20.0
19068,1,9068,[ 82 176 183 265 655],450,4,36738,4.050942772080715,0.0,0.0
19069,1,9069,[ 79 196  96 180  15],450,4,36742,4.050937155457552,0.0,0.0
19070,1,9070,[ 71  97  89 186  15],18,4,36746,4.050931540072759,0.0,0.0
19071,1,9071,[ 98 211 117 127 132],655,2,36748,4.050705467372134,0.0,20.0
19072,1,9072,[ 96 200 118  82 235],450,1,36749,4.050369227377934,0.0,0.0
19073,1,9073,[427 588  79  98 127],389,5,36754,4.05047388141944,20.0,20.0
19074,1,9074,[238 153 172   9  50],535,4,36758,4.050468319559228,0.0,20.0
19075,1,9075,[174  98  28 496  79],577,5,36763,4.050572939620978,20.0,0.0
19076,1,9076,[427 588  79  98 127],716,5,36768,4.050677536631046,20.0,20.0
19077,1,9077,[427 588  79  98 127],389,5,36773,4.050782110597048,20.0,20.0
19078,1,9078,[427 588  79  98 127],450,5,36778,4.0508866615266,20.0,20.0
19079,1,9079,[427 588  79  98 127],389,5,36783,4.050991189427313,20.0,20.0
19080,1,9080,[427 588  79  98 127],796,5,36788,4.051095694306794,20.0,20.0
19081,1,9081,[427 588  79  98 127],450,5,36793,4.0512001761726495,20.0,20.0
19082,1,9082,[427 588  79  98 127],389,5,36798,4.051304635032478,20.0,20.0
19083,1,9083,[181 132  56 257  28],504,3,36801,4.051188903566711,0.0,0.0
19084,1,9084,[427 588  79  98 127],18,5,36806,4.051293340671436,20.0,20.0
19085,1,9085,[  7 318  82  69 197],151,4,36810,4.051287695355492,20.0,0.0
19086,1,9086,[435  79 385 153 135],450,4,36814,4.051282051282051,0.0,0.0
19087,1,9087,[ 22 200 742 210  82],457,5,36819,4.051386443661972,0.0,0.0
19088,1,9088,[427 588  79  98 127],716,5,36824,4.051490813070745,20.0,20.0
19089,1,9089,[235 210  79 742  98],280,4,36828,4.0514851485148515,0.0,0.0
19090,1,9090,[  8 216 174  22  88],344,3,36831,4.051369486305137,0.0,0.0
19091,1,9091,[427 588  79  98 127],389,5,36836,4.051473823141223,20.0,20.0
19092,1,9092,[496 282 168 234 127],716,4,36840,4.051468162322665,20.0,20.0
19093,1,9093,[427 588  79  98 127],796,5,36845,4.051572465361777,20.0,20.0
19094,1,9094,[427 588  79  98 127],450,5,36850,4.051676745464541,20.0,20.0
19095,1,9095,[181 258 118 196 238],796,4,36854,4.051671064204045,0.0,0.0
19096,1,9096,[216 245  71  79 127],450,4,36858,4.051665384192591,0.0,20.0
19097,1,9097,[294 300  11 174 238],716,5,36863,4.051769619696636,0.0,0.0
19098,1,9098,[182 228 748 202  96],450,5,36868,4.051873832289263,0.0,0.0
19099,1,9099,[153 143  12 182  96],450,5,36873,4.051978021978022,0.0,0.0
19100,1,9100,[471 222  50 302 196],450,4,36877,4.051972310735084,0.0,20.0
19101,1,9101,[111 318 197 173 168],65,4,36881,4.051966600747089,20.0,0.0
19102,1,9102,[427 588  79  98 127],389,5,36886,4.052070745907942,20.0,20.0
19103,1,9103,[427 588  79  98 127],716,5,36891,4.052174868189807,20.0,20.0
19104,1,9104,[ 95 183 173 195 294],716,3,36894,4.052059308072487,0.0,0.0
19105,1,9105,[427 588  79  98 127],450,5,36899,4.052163408741489,20.0,20.0
19106,1,9106,[235 151 135 204 185],401,2,36901,4.051938069616778,0.0,0.0
19107,1,9107,[197 568 268  15  22],655,0,36901,4.05149319279754,0.0,0.0
19108,1,9108,[427 588  79  98 127],716,5,36906,4.0515973213305525,20.0,20.0
19109,1,9109,[275 202  64  50 151],457,5,36911,4.051701427003293,20.0,40.0
19110,1,9110,[427 588  79  98 127],716,5,36916,4.05180550982329,20.0,20.0
19111,1,9111,[427 588  79  98 127],796,5,36921,4.0519095697980685,20.0,20.0
19112,1,9112,[427 588  79  98 127],796,5,36926,4.052013606935148,20.0,20.0
19113,1,9113,[  4 269 117 187 323],796,3,36929,4.051898178626289,0.0,0.0
19114,1,9114,[258 174 748 117 210],796,4,36933,4.051892484914975,0.0,0.0
19115,1,9115,[151 546 195 168 403],457,4,36937,4.05188679245283,0.0,0.0
19116,1,9116,[202 121 180 210 135],716,3,36940,4.051771416035977,0.0,0.0
19117,1,9117,[385 121 179  88 196],593,5,36945,4.051875411274402,0.0,0.0
19118,1,9118,[427 588  79  98 127],796,5,36950,4.051979383704354,20.0,20.0
19119,1,9119,[508 135   1 294  50],401,0,36950,4.051535087719298,0.0,20.0
19120,1,9120,[200 100 175 179 405],655,2,36952,4.051310163359281,0.0,20.0
19121,1,9121,[748 187 195  82  79],450,4,36956,4.051304538478404,0.0,0.0
19122,1,9122,[211 182  22 132 197],796,3,36959,4.05118930176477,0.0,0.0
19123,1,9123,[427 588  79  98 127],18,5,36964,4.0512932924156075,20.0,20.0
19124,1,9124,[427 588  79  98 127],716,5,36969,4.051397260273973,20.0,20.0
19125,1,9125,[427 588  79  98 127],450,5,36974,4.05150120534736,20.0,20.0
19126,1,9126,[204  88 174 202 322],504,2,36976,4.051276432562726,0.0,0.0
19127,1,9127,[427 588  79  98 127],389,5,36981,4.05138036809816,20.0,20.0
19128,1,9128,[176 508 282 118 179],655,1,36982,4.05104611677073,0.0,0.0
19129,1,9129,[427 588  79  98 127],716,5,36987,4.051150054764513,20.0,20.0
19130,1,9130,[427 588  79  98 127],716,5,36992,4.051253969992334,20.0,20.0
19131,1,9131,[117 215 357 153   1],796,4,36996,4.051248357424441,0.0,0.0
19132,1,9132,[ 69 211 185 318 121],151,5,37001,4.051352239132815,20.0,0.0
19133,1,9133,[427 588  79  98 127],450,5,37006,4.05145609809503,20.0,20.0
19134,1,9134,[ 11 135 235 471  12],450,3,37009,4.051340996168582,0.0,0.0
19135,1,9135,[427 588  79  98 127],450,5,37014,4.051444833625219,20.0,20.0
19136,1,9136,[427 588  79  98 127],716,5,37019,4.051548648352851,20.0,20.0
19137,1,9137,[216   8 143  11 183],269,0,37019,4.051105274677172,0.0,0.0
19138,1,9138,[127 118 182 172 125],457,5,37024,4.051209103840683,0.0,20.0
19139,1,9139,[172 151 111 117 275],236,1,37025,4.050875273522976,0.0,20.0
19140,1,9140,[427 588  79  98 127],389,5,37030,4.05097910513073,20.0,20.0
19141,1,9141,[427 588  79  98 127],716,5,37035,4.05108291402319,20.0,20.0
19142,1,9142,[427 588  79  98 127],450,5,37040,4.0511867002078095,20.0,20.0
19143,1,9143,[483  88   1 172 135],280,3,37043,4.051071741032371,0.0,0.0
19144,1,9144,[  7 313 302 216 483],450,4,37047,4.0510661563696,0.0,0.0
19145,1,9145,[  1 191 588 117 202],457,5,37052,4.05116991034332,0.0,0.0
19146,1,9146,[742 238 257 471 117],457,4,37056,4.051164316169236,0.0,0.0
19147,1,9147,[655 117 172  82 546],716,4,37060,4.051158723218189,0.0,0.0
19148,1,9148,[ 97  71 282 603 405],450,4,37064,4.05115313148978,20.0,0.0
19149,1,9149,[ 50 179 187  28 143],236,2,37066,4.0509289617486335,0.0,20.0
19150,1,9150,[197  96 191 318 173],269,3,37069,4.050814118675555,20.0,0.0
19151,1,9151,[173 483 191 333 357],796,5,37074,4.0509178321678325,0.0,0.0
19152,1,9152,[125  97 271  88 181],796,4,37078,4.050912269201355,0.0,0.0
19153,1,9153,[427 588  79  98 127],796,5,37083,4.051015949311776,20.0,20.0
19154,1,9154,[405 508 121  22 100],269,2,37085,4.050791916985254,0.0,20.0
19155,1,9155,[216 222 204 186 357],450,3,37088,4.0506771515945825,0.0,0.0
19156,1,9156,[ 22   8 118 172 121],344,2,37090,4.050453205198209,0.0,0.0
19157,1,9157,[118 288  25  15 603],655,1,37091,4.050120113561913,20.0,0.0
19158,1,9158,[183 173 144  69 186],457,5,37096,4.050223823561524,0.0,0.0
19159,1,9159,[427 588  79  98 127],796,5,37101,4.050327510917031,20.0,20.0
19160,1,9160,[427 588  79  98 127],450,5,37106,4.050431175635848,20.0,20.0
19161,1,9161,[427 588  79  98 127],716,5,37111,4.050534817725388,20.0,20.0
19162,1,9162,[427 588  79  98 127],389,5,37116,4.050638437193059,20.0,20.0
19163,1,9163,[168  22 200  11 196],457,5,37121,4.050742034046268,0.0,0.0
19164,1,9164,[427 588  79  98 127],450,5,37126,4.050845608292417,20.0,20.0
19165,1,9165,[211 237 196 173 194],796,4,37130,4.050840061095353,0.0,0.0
19166,1,9166,[197 172 127  88 182],796,4,37134,4.050834515108542,0.0,20.0
19167,1,9167,[427 588  79  98 127],716,5,37139,4.050938045375218,20.0,20.0
19168,1,9168,[318  28 111 211  97],796,2,37141,4.050714363616534,20.0,0.0
19169,1,9169,[603  22 275 210 195],450,4,37145,4.050708833151581,20.0,20.0
19170,1,9170,[546 194 603  56 153],23,4,37149,4.050703303892705,20.0,0.0
19171,1,9171,[427 588  79  98 127],796,5,37154,4.050806803314435,20.0,20.0
19172,1,9172,[427 588  79  98 127],796,5,37159,4.050910280170064,20.0,20.0
19173,1,9173,[427 588  79  98 127],18,5,37164,4.051013734466972,20.0,20.0
19174,1,9174,[ 89  79 323 258 546],23,3,37167,4.050899182561308,0.0,0.0
19175,1,9175,[427 588  79  98 127],389,5,37172,4.051002615518745,20.0,20.0
19176,1,9176,[318 182 222 179 483],450,3,37175,4.050888089789692,20.0,0.0
19177,1,9177,[427 588  79  98 127],18,5,37180,4.050991501416431,20.0,20.0
19178,1,9178,[228   7 286  28 100],786,5,37185,4.0510948905109485,0.0,40.0
19179,1,9179,[427 588  79  98 127],716,5,37190,4.05119825708061,20.0,20.0
19180,1,9180,[496 197  50 143  70],151,5,37195,4.051301601132774,20.0,20.0
19181,1,9181,[186 204   4  11 174],655,0,37195,4.050860379002396,0.0,0.0
19182,1,9182,[ 82 546 196 153  95],716,4,37199,4.050854840466078,0.0,0.0
19183,1,9183,[483 143  69 197 655],151,5,37204,4.05095818815331,0.0,0.0
19184,1,9184,[172 678 197 228  95],280,1,37205,4.050626020685901,0.0,0.0
19185,1,9185,[185 318  98 257 118],330,5,37210,4.0507293707816245,20.0,0.0
19186,1,9186,[ 79 202   9 210 215],151,4,37214,4.050723848916948,0.0,0.0
19187,1,9187,[427 588  79  98 127],716,5,37219,4.050827165868524,20.0,20.0
19188,1,9188,[  9 202 603 174 483],18,3,37222,4.050712808793122,20.0,0.0
19189,1,9189,[427 588  79  98 127],716,5,37227,4.050816104461371,20.0,20.0
19190,1,9190,[427 588  79  98 127],796,5,37232,4.050919377652051,20.0,20.0
19191,1,9191,[748 222 286 235  95],450,2,37234,4.050696257615318,0.0,20.0
19192,1,9192,[318 294 173 328  11],450,5,37239,4.050799521374959,20.0,0.0
19193,1,9193,[183 200 181  69 405],786,5,37244,4.050902762671307,0.0,0.0
19194,1,9194,[427 588  79  98 127],389,5,37249,4.0510059815116914,20.0,20.0
19195,1,9195,[176 125 117  12 483],796,5,37254,4.051109177903436,0.0,0.0
19196,1,9196,[288 385 403 265 144],655,0,37254,4.050668696314015,0.0,0.0
19197,1,9197,[427 588  79  98 127],450,5,37259,4.050771906936291,20.0,20.0
19198,1,9198,[427 588  79  98 127],389,5,37264,4.050875095119035,20.0,20.0
19199,1,9199,[427 588  79  98 127],18,5,37269,4.050978260869565,20.0,20.0
19200,1,9200,[ 22 282 161 271   4],796,5,37274,4.051081404195196,0.0,0.0
19201,1,9201,[179  12  82  50 132],450,4,37278,4.051075853075418,0.0,20.0
19202,1,9202,[748 196 423 228 655],450,5,37283,4.051178963381506,0.0,0.0
19203,1,9203,[427 588  79  98 127],716,5,37288,4.051282051282051,20.0,20.0
19204,1,9204,[655 288 174 282 197],693,2,37290,4.051059206952743,0.0,0.0
19205,1,9205,[427 588  79  98 127],796,5,37295,4.051162285466001,20.0,20.0
19206,1,9206,[427 588  79  98 127],716,5,37300,4.051265341587922,20.0,20.0
19207,1,9207,[427 588  79  98 127],796,5,37305,4.051368375325803,20.0,20.0
19208,1,9208,[ 64  22 153 191 301],655,2,37307,4.051145618416766,20.0,0.0
19209,1,9209,[ 56  82 238 194 427],23,4,37311,4.05114006514658,20.0,0.0
19210,1,9210,[427 588  79  98 127],796,5,37316,4.051243078927369,20.0,20.0
19211,1,9211,[ 95 435 423 318 427],716,5,37321,4.051346070343031,40.0,0.0
19212,1,9212,[427 588  79  98 127],18,5,37326,4.051449039400847,20.0,20.0
19213,1,9213,[210 143 228  11  70],457,5,37331,4.051551986108096,0.0,0.0
19214,1,9214,[427 588  79  98 127],18,5,37336,4.051654910472056,20.0,20.0
19215,1,9215,[427 588  79  98 127],796,5,37341,4.0517578125,20.0,20.0
19216,1,9216,[174 234 435 200 182],18,3,37344,4.051643701855268,0.0,0.0
19217,1,9217,[568 185 471 234 197],655,1,37345,4.051312649164678,0.0,0.0
19218,1,9218,[238  28 357  98 196],504,4,37349,4.051307083197743,0.0,0.0
19219,1,9219,[427 588  79  98 127],716,5,37354,4.051409978308026,20.0,20.0
19220,1,9220,[427  82 187  25 118],450,2,37356,4.051187506778007,20.0,0.0
19221,1,9221,[ 28 597  56 483 300],796,4,37360,4.051181956191716,0.0,0.0
19222,1,9222,[427 588  79  98 127],716,5,37365,4.051284831399761,20.0,20.0
19223,1,9223,[ 28 191 183 423  15],450,4,37369,4.0512792714657415,0.0,0.0
19224,1,9224,[427 588  79  98 127],18,5,37374,4.0513821138211386,20.0,20.0
19225,1,9225,[427 588  79  98 127],450,5,37379,4.051484933882506,20.0,20.0
19226,1,9226,[237  12 276 173   1],344,3,37382,4.051370976482064,0.0,0.0
19227,1,9227,[301 132 185 179 289],655,2,37384,4.051148677936714,0.0,0.0
19228,1,9228,[238 121 132 135 125],457,5,37389,4.051251489868892,0.0,0.0
19229,1,9229,[210 282 196 185 151],716,4,37393,4.05124593716143,0.0,0.0
19230,1,9230,[257 748 385 127  15],796,5,37398,4.051348716282093,0.0,20.0
19231,1,9231,[508 197  28  64 275],655,2,37400,4.051126516464471,20.0,20.0
19232,1,9232,[427 588  79  98 127],18,5,37405,4.051229286255822,20.0,20.0
19233,1,9233,[180 258 234  89 245],450,4,37409,4.0512237383582415,0.0,0.0
19234,1,9234,[228   1 222 173  22],796,4,37413,4.051218191662155,0.0,0.0
19235,1,9235,[427 588  79  98 127],716,5,37418,4.051320918146383,20.0,20.0
19236,1,9236,[597 403 183  79 257],457,3,37421,4.051207101872903,0.0,0.0
19237,1,9237,[427 588  79  98 127],18,5,37426,4.051309807317601,20.0,20.0
19238,1,9238,[427 588  79  98 127],796,5,37431,4.051412490529278,20.0,20.0
19239,1,9239,[427 588  79  98 127],450,5,37436,4.051515151515152,20.0,20.0
19240,1,9240,[ 25 300  82 435  50],716,5,37441,4.051617790282437,0.0,20.0
19241,1,9241,[427 588  79  98 127],796,5,37446,4.0517204068383466,20.0,20.0
19242,1,9242,[427 588  79  98 127],389,5,37451,4.0518230011900895,20.0,20.0
19243,1,9243,[427 588  79  98 127],389,5,37456,4.051925573344873,20.0,20.0
19244,1,9244,[200 435 483  71  88],236,2,37458,4.051703623580313,0.0,0.0
19245,1,9245,[427 588  79  98 127],716,5,37463,4.051806186459009,20.0,20.0
19246,1,9246,[427 588  79  98 127],389,5,37468,4.0519087271547525,20.0,20.0
19247,1,9247,[ 98 161 265 603 222],798,1,37469,4.051578719723183,20.0,0.0
19248,1,9248,[191 234   9 435 318],316,3,37472,4.051465023245756,20.0,0.0
19249,1,9249,[427 588  79  98 127],389,5,37477,4.0515675675675675,20.0,20.0
19250,1,9250,[  4  15 144  70 143],593,5,37482,4.05167008972003,0.0,0.0
19251,1,9251,[202 194 435 187 302],269,2,37484,4.051448335495028,0.0,0.0
19252,1,9252,[427 588  79  98 127],450,5,37489,4.0515508483735,20.0,20.0
19253,1,9253,[423 151  96 168 282],796,5,37494,4.051653339096607,0.0,0.0
19254,1,9254,[427 588  79  98 127],716,5,37499,4.051755807671529,20.0,20.0
19255,1,9255,[568 132  25 275   1],330,5,37504,4.051858254105445,0.0,20.0
19256,1,9256,[222  89 174 228 597],23,4,37508,4.051852652047099,0.0,0.0
19257,1,9257,[210 100 496 603 471],450,4,37512,4.051847051198963,40.0,20.0
19258,1,9258,[276 237 176 135 546],457,4,37516,4.051841451560644,0.0,0.0
19259,1,9259,[427 588  79  98 127],716,5,37521,4.051943844492441,20.0,20.0
19260,1,9260,[174 143 216 286 186],151,5,37526,4.052046215311521,0.0,20.0
19261,1,9261,[ 28 196  15 603 143],798,3,37529,4.051932627942129,20.0,0.0
19262,1,9262,[427 588  79  98 127],716,5,37534,4.052034977868941,20.0,20.0
19263,1,9263,[427 588  79  98 127],450,5,37539,4.052137305699482,20.0,20.0
19264,1,9264,[546 385 228 183 144],450,5,37544,4.052239611440907,0.0,0.0
19265,1,9265,[427 588  79  98 127],18,5,37549,4.052341895100367,20.0,20.0
19266,1,9266,[  9  69 191 597 168],11,2,37551,4.052120427322758,0.0,0.0
19267,1,9267,[427 588  79  98 127],716,5,37556,4.052222701769529,20.0,20.0
19268,1,9268,[427 588  79  98 127],18,5,37561,4.0523249541482365,20.0,20.0
19269,1,9269,[ 71 483 111 258 597],450,3,37564,4.052211434735707,0.0,0.0
19270,1,9270,[427 588  79  98 127],716,5,37569,4.052313666271168,20.0,20.0
19271,1,9271,[ 69 405 265 186  28],807,5,37574,4.052415875754961,0.0,0.0
19272,1,9272,[427 588  79  98 127],389,5,37579,4.05251806319422,20.0,20.0
19273,1,9273,[568 183 175  28 196],716,3,37582,4.052404571921501,0.0,0.0
19274,1,9274,[235 385 423 100  50],5,5,37587,4.052506738544475,0.0,40.0
19275,1,9275,[282 211 186   4 172],450,3,37590,4.052393272962484,0.0,0.0
19276,1,9276,[427 588  79  98 127],18,5,37595,4.052495418777622,20.0,20.0
19277,1,9277,[216 678  96  98  15],256,5,37600,4.052597542573831,0.0,0.0
19278,1,9278,[427 588  79  98 127],796,5,37605,4.052699644358229,20.0,20.0
19279,1,9279,[313 204  95 273 245],796,3,37608,4.052586206896552,0.0,0.0
19280,1,9280,[427 588  79  98 127],796,5,37613,4.05268828790001,20.0,20.0
19281,1,9281,[427 588  79  98 127],796,5,37618,4.052790346907994,20.0,20.0
19282,1,9282,[427 588  79  98 127],18,5,37623,4.05289238392761,20.0,20.0
19283,1,9283,[318 313 568 301 172],593,5,37628,4.052994398965963,20.0,0.0
19284,1,9284,[427 588  79  98 127],18,5,37633,4.053096392030156,20.0,20.0
19285,1,9285,[318 405 496  71 186],577,4,37637,4.053090674133103,40.0,0.0
19286,1,9286,[427 588  79  98 127],18,5,37642,4.053192634865941,20.0,20.0
19287,1,9287,[471 183 118  28 216],655,2,37644,4.052971576227391,0.0,0.0
19288,1,9288,[275  96 194 496 118],796,5,37649,4.053073527828614,20.0,20.0
19289,1,9289,[427 588  79  98 127],389,5,37654,4.053175457481163,20.0,20.0
19290,1,9290,[185  25 143 237 176],716,4,37658,4.0531697341513295,0.0,0.0
19291,1,9291,[427 588  79  98 127],450,5,37663,4.053271631510977,20.0,20.0
19292,1,9292,[427 588  79  98 127],389,5,37668,4.053373506940708,20.0,20.0
19293,1,9293,[121 173 180 143 515],269,1,37669,4.053044975252852,0.0,0.0
19294,1,9294,[111 268 127 183 174],269,2,37671,4.052824098977945,0.0,20.0
19295,1,9295,[ 12 100   1 191  88],796,3,37674,4.052710843373494,0.0,20.0
19296,1,9296,[427 588  79  98 127],450,5,37679,4.052812735290954,20.0,20.0
19297,1,9297,[282 385 323 210  98],280,2,37681,4.052591955259196,0.0,0.0
19298,1,9298,[427 588  79  98 127],389,5,37686,4.052693838047102,20.0,20.0
19299,1,9299,[427 588  79  98 127],389,5,37691,4.052795698924731,20.0,20.0
19300,1,9300,[427 588  79  98 127],389,5,37696,4.052897537899151,20.0,20.0
19301,1,9301,[427 588  79  98 127],450,5,37701,4.052999354977424,20.0,20.0
19302,1,9302,[174 121 568 216 471],593,4,37705,4.052993657959798,0.0,0.0
19303,1,9303,[  7 269  70 194 151],23,3,37708,4.052880481513328,0.0,0.0
19304,1,9304,[427 588  79  98 127],450,5,37713,4.052982267598066,20.0,20.0
19305,1,9305,[427 588  79  98 127],18,5,37718,4.053084031807436,20.0,20.0
19306,1,9306,[127 186 196 655 427],693,2,37720,4.052863436123348,20.0,20.0
19307,1,9307,[427 588  79  98 127],18,5,37725,4.052965191233348,20.0,20.0
19308,1,9308,[405  89 678 276 172],256,3,37728,4.05285207863358,0.0,0.0
19309,1,9309,[427 588  79  98 127],716,5,37733,4.052953813104189,20.0,20.0
19310,1,9310,[427 588  79  98 127],796,5,37738,4.053055525722264,20.0,20.0
19311,1,9311,[427 588  79  98 127],450,5,37743,4.053157216494846,20.0,20.0
19312,1,9312,[427 588  79  98 127],450,5,37748,4.053258885428971,20.0,20.0
19313,1,9313,[496 483 427  79 200],151,4,37752,4.05325316727507,40.0,0.0
19314,1,9314,[427 588  79  98 127],450,5,37757,4.053354804079442,20.0,20.0
19315,1,9315,[153 111 588 238 196],450,5,37762,4.053456419063976,0.0,0.0
19316,1,9316,[427 588  79  98 127],716,5,37767,4.0535580122356984,20.0,20.0
19317,1,9317,[197 151 234 403 294],796,2,37769,4.053337626100022,0.0,0.0
19318,1,9318,[427 588  79  98 127],796,5,37774,4.053439210215688,20.0,20.0
19319,1,9319,[427 588  79  98 127],796,5,37779,4.053540772532189,20.0,20.0
19320,1,9320,[294  79 742 318  82],655,2,37781,4.0533204591782,20.0,0.0
19321,1,9321,[151 143  96 318 322],450,5,37786,4.053422012443682,20.0,0.0
19322,1,9322,[172 515 435  89  96],296,5,37791,4.05352354392363,0.0,0.0
19323,1,9323,[427 588  79  98 127],450,5,37796,4.053625053625054,20.0,20.0
19324,1,9324,[427 588  79  98 127],18,5,37801,4.05372654155496,20.0,20.0
19325,1,9325,[202 215 186 121 173],716,4,37805,4.053720780613339,0.0,0.0
19326,1,9326,[ 97 423 132 197   4],18,4,37809,4.0537150209070445,0.0,0.0
19327,1,9327,[483  97 196  89 282],655,2,37811,4.053494854202401,0.0,0.0
19328,1,9328,[  4 174 313 322 195],280,1,37812,4.053167542073106,0.0,0.0
19329,1,9329,[597 678 204 588 258],344,2,37814,4.052947481243301,0.0,0.0
19330,1,9330,[427 588  79  98 127],796,5,37819,4.053048976529847,20.0,20.0
19331,1,9331,[427 588  79  98 127],450,5,37824,4.053150450064295,20.0,20.0
19332,1,9332,[286 125 405 588 748],280,2,37826,4.052930461802207,0.0,20.0
19333,1,9333,[175  12 385 258  98],457,5,37831,4.053031926290979,0.0,0.0
19334,1,9334,[183 200 210 180 179],786,5,37836,4.053133369041243,0.0,0.0
19335,1,9335,[427 588  79  98 127],450,5,37841,4.0532347900599826,20.0,20.0
19336,1,9336,[161 180 200 202  22],280,4,37845,4.053229088572347,0.0,0.0
19337,1,9337,[132 183  50 496 238],716,4,37849,4.053223388305847,20.0,20.0
19338,1,9338,[427 588  79  98 127],450,5,37854,4.053324767105686,20.0,20.0
19339,1,9339,[427 588  79  98 127],716,5,37859,4.053426124197002,20.0,20.0
19340,1,9340,[183 300 405 196  22],655,1,37860,4.053099239910074,0.0,0.0
19341,1,9341,[  4   1 228 202 588],280,2,37862,4.0528794690644405,0.0,0.0
19342,1,9342,[191  56 100 173 333],796,4,37866,4.052873809268972,0.0,20.0
19343,1,9343,[427 588  79  98 127],796,5,37871,4.052975171232877,20.0,20.0
19344,1,9344,[427 588  79  98 127],796,5,37876,4.053076511503478,20.0,20.0
19345,1,9345,[215  79 204 603 748],11,2,37878,4.052856837149583,20.0,0.0
19346,1,9346,[427 588  79  98 127],716,5,37883,4.052958168396277,20.0,20.0
19347,1,9347,[427 588  79  98 127],18,5,37888,4.053059477963201,20.0,20.0
19348,1,9348,[588 238 597 121  15],457,4,37892,4.053053802545727,0.0,0.0
19349,1,9349,[427 588  79  98 127],450,5,37897,4.053155080213903,20.0,20.0
19350,1,9350,[427 588  79  98 127],796,5,37902,4.053256336220725,20.0,20.0
19351,1,9351,[257 276 144 200 197],457,4,37906,4.053250641573995,0.0,0.0
19352,1,9352,[286 204 202 403 172],330,5,37911,4.053351865711536,0.0,20.0
19353,1,9353,[182 603 597  89   9],796,4,37915,4.053346162069703,20.0,0.0
19354,1,9354,[427 588  79  98 127],716,5,37920,4.053447354355959,20.0,20.0
19355,1,9355,[ 64  56 173 197  11],535,4,37924,4.053441641727233,20.0,0.0
19356,1,9356,[427 588  79  98 127],796,5,37929,4.053542802180186,20.0,20.0
19357,1,9357,[427 588  79  98 127],796,5,37934,4.053643941013037,20.0,20.0
19358,1,9358,[172   8 144 286 427],655,2,37936,4.053424511165723,20.0,20.0
19359,1,9359,[427 588  79  98 127],18,5,37941,4.053525641025641,20.0,20.0
19360,1,9360,[427 588  79  98 127],450,5,37946,4.053626749278923,20.0,20.0
19361,1,9361,[ 11 210 333   9   7],629,3,37949,4.053514206366161,0.0,0.0
19362,1,9362,[ 98  50  25  11 471],655,2,37951,4.053294884118338,0.0,20.0
19363,1,9363,[245 151 222 197 176],756,2,37953,4.053075608714225,0.0,0.0
19364,1,9364,[237 568   9 183 245],796,3,37956,4.052963160704752,0.0,0.0
19365,1,9365,[427 588  79  98 127],18,5,37961,4.053064275037369,20.0,20.0
19366,1,9366,[318 173 204 405 588],786,5,37966,4.053165367780506,20.0,0.0
19367,1,9367,[176   9  79 357 268],655,2,37968,4.052946199829206,0.0,0.0
19368,1,9368,[125 143 655 202 318],655,2,37970,4.052727078663678,20.0,0.0
19369,1,9369,[427 588  79  98 127],450,5,37975,4.052828175026681,20.0,20.0
19370,1,9370,[427 588  79  98 127],716,5,37980,4.052929249813253,20.0,20.0
19371,1,9371,[238 111 385 186   1],151,4,37984,4.052923602219377,0.0,0.0
19372,1,9372,[  1 202 186 471   8],577,4,37988,4.052917955830577,0.0,0.0
19373,1,9373,[125 435 215 172   9],18,2,37990,4.052698954555153,0.0,0.0
19374,1,9374,[357 202  89 655  97],786,5,37995,4.0528,0.0,0.0
19375,1,9375,[118 191 176 181 216],693,1,37996,4.052474402730375,0.0,0.0
19376,1,9376,[179 187 153 181 186],504,0,37996,4.052042230990722,0.0,0.0
19377,1,9377,[427 588  79  98 127],450,5,38001,4.052143314139475,20.0,20.0
19378,1,9378,[211 196 200  64 323],796,3,38004,4.05203113338309,20.0,0.0
19379,1,9379,[427 588  79  98 127],389,5,38009,4.052132196162047,20.0,20.0
19380,1,9380,[427 588  79  98 127],389,5,38014,4.052233237394734,20.0,20.0
19381,1,9381,[222 655 144 427 174],796,4,38018,4.0522276700063955,20.0,0.0
19382,1,9382,[427 588  79  98 127],389,5,38023,4.052328679526804,20.0,20.0
19383,1,9383,[427 588  79  98 127],716,5,38028,4.052429667519181,20.0,20.0
19384,1,9384,[427 588  79  98 127],716,5,38033,4.05253063399041,20.0,20.0
19385,1,9385,[ 96 174 197 216  70],280,3,38036,4.052418495631792,0.0,0.0
19386,1,9386,[427 588  79  98 127],796,5,38041,4.052519441781187,20.0,20.0
19387,1,9387,[121 117 125 588 318],796,5,38046,4.052620366425224,20.0,0.0
19388,1,9388,[427 588  79  98 127],716,5,38051,4.052721269570775,20.0,20.0
19389,1,9389,[423 234 286 187 265],629,5,38056,4.052822151224707,0.0,20.0
19390,1,9390,[427 588  79  98 127],450,5,38061,4.052923011393887,20.0,20.0
19391,1,9391,[427 588  79  98 127],389,5,38066,4.053023850085179,20.0,20.0
19392,1,9392,[228 161 245 238 655],450,5,38071,4.053124667305441,0.0,0.0
19393,1,9393,[427 588  79  98 127],716,5,38076,4.053225463061529,20.0,20.0
19394,1,9394,[588 237 322 427 195],796,4,38080,4.053219797764768,20.0,0.0
19395,1,9395,[427 588  79  98 127],716,5,38085,4.053320561941252,20.0,20.0
19396,1,9396,[ 28  69 161 300 655],885,4,38089,4.053314887730127,0.0,0.0
19397,1,9397,[427 588  79  98 127],389,5,38094,4.0534156203447544,20.0,20.0
19398,1,9398,[ 22   4 237  56 187],796,5,38099,4.05351633152463,0.0,0.0
19399,1,9399,[191 276 125 121 568],655,2,38101,4.053297872340425,0.0,0.0
19400,1,9400,[111 597  70 269  56],450,5,38106,4.053398574619721,0.0,0.0
19401,1,9401,[ 22 179 286  64  50],655,3,38109,4.053286534779834,20.0,40.0
19402,1,9402,[172 405 483 357 197],716,5,38114,4.053387216845688,0.0,0.0
19403,1,9403,[118 268 385 132 186],655,0,38114,4.052956188855806,0.0,0.0
19404,1,9404,[742 202 403  64  82],457,5,38119,4.053056884635832,20.0,0.0
19405,1,9405,[427 588  79  98 127],450,5,38124,4.05315755900489,20.0,20.0
19406,1,9406,[ 22 742  15 186 655],655,0,38124,4.052726692888275,0.0,0.0
19407,1,9407,[427 588  79  98 127],796,5,38129,4.052827380952381,20.0,20.0
19408,1,9408,[111 288 127 181 257],457,3,38132,4.05271548517377,0.0,20.0
19409,1,9409,[427 588  79  98 127],716,5,38137,4.052816153028693,20.0,20.0
19410,1,9410,[427 588  79  98 127],389,5,38142,4.052916799489958,20.0,20.0
19411,1,9411,[471 357  89 135  50],72,3,38145,4.0528049298767534,0.0,20.0
19412,1,9412,[195 194 603 202 288],450,4,38149,4.052799320089238,20.0,0.0
19413,1,9413,[  7 742 271   1 427],655,1,38150,4.05247503717867,20.0,0.0
19414,1,9414,[427 588  79  98 127],796,5,38155,4.052575677110993,20.0,20.0
19415,1,9415,[125 183 121 323  82],796,3,38158,4.052463891248938,0.0,0.0
19416,1,9416,[181 176 603 265 121],716,4,38162,4.052458320059467,20.0,0.0
19417,1,9417,[427 588  79  98 127],450,5,38167,4.052558929709067,20.0,20.0
19418,1,9418,[427 588  79  98 127],796,5,38172,4.052659517995541,20.0,20.0
19419,1,9419,[427 588  79  98 127],389,5,38177,4.05276008492569,20.0,20.0
19420,1,9420,[427 588  79  98 127],18,5,38182,4.0528606305063155,20.0,20.0
19421,1,9421,[427 588  79  98 127],450,5,38187,4.0529611547442155,20.0,20.0
19422,1,9422,[286 215 282 179 276],535,2,38189,4.052743287700308,0.0,20.0
19423,1,9423,[568 118 222 483   7],693,2,38191,4.052525466893039,0.0,0.0
19424,1,9424,[427 588  79  98 127],716,5,38196,4.05262599469496,20.0,20.0
19425,1,9425,[  4 301  64 496 194],450,4,38200,4.052620411627413,40.0,0.0
19426,1,9426,[191  98 275 322 182],796,4,38204,4.052614829744352,0.0,20.0
19427,1,9427,[423  88  89 111 132],269,2,38206,4.0523971149766655,0.0,0.0
19428,1,9428,[132 322 258 187  88],504,3,38209,4.0522855021741435,0.0,0.0
19429,1,9429,[195  64 202 191  50],151,3,38212,4.052173913043478,20.0,20.0
19430,1,9430,[427 588  79  98 127],716,5,38217,4.052274414166048,20.0,20.0
19431,1,9431,[ 79 173 322 216 496],151,4,38221,4.05226887192536,20.0,0.0
19432,1,9432,[427 588  79  98 127],796,5,38226,4.052369341672851,20.0,20.0
19433,1,9433,[427 588  79  98 127],796,5,38231,4.052469790120839,20.0,20.0
19434,1,9434,[172 143 222  71 127],807,4,38235,4.052464228934817,0.0,20.0
19435,1,9435,[427 588  79  98 127],18,5,38240,4.052564646036456,20.0,20.0
19436,1,9436,[427 588  79  98 127],389,5,38245,4.052665041856522,20.0,20.0
19437,1,9437,[427 588  79  98 127],389,5,38250,4.05276541640178,20.0,20.0
19438,1,9438,[427 588  79  98 127],796,5,38255,4.052865769678991,20.0,20.0
19439,1,9439,[427 588  79  98 127],389,5,38260,4.052966101694915,20.0,20.0
19440,1,9440,[427 588  79  98 127],716,5,38265,4.053066412456308,20.0,20.0
19441,1,9441,[427 588  79  98 127],18,5,38270,4.053166701969921,20.0,20.0
19442,1,9442,[427 588  79  98 127],389,5,38275,4.0532669702425075,20.0,20.0
19443,1,9443,[427 588  79  98 127],716,5,38280,4.0533672172808135,20.0,20.0
19444,1,9444,[427 588  79  98 127],450,5,38285,4.0534674430915825,20.0,20.0
19445,1,9445,[427 588  79  98 127],796,5,38290,4.053567647681558,20.0,20.0
19446,1,9446,[483 265 268 121 333],655,1,38291,4.053244416216788,0.0,0.0
19447,1,9447,[271 118 265  50 275],655,2,38293,4.0530270956816254,0.0,40.0
19448,1,9448,[427 588  79  98 127],450,5,38298,4.053127315059795,20.0,20.0
19449,1,9449,[427 588  79  98 127],716,5,38303,4.0532275132275135,20.0,20.0
19450,1,9450,[117 568 181 655   1],450,5,38308,4.053327690191514,0.0,0.0
19451,1,9451,[742 228 197 144  56],655,0,38308,4.0528988573846805,0.0,0.0
19452,1,9452,[ 82 144 222   8 333],796,4,38312,4.052893261398498,0.0,0.0
19453,1,9453,[427 588  79  98 127],796,5,38317,4.052993441929342,20.0,20.0
19454,1,9454,[427 588  79  98 127],716,5,38322,4.05309360126917,20.0,20.0
19455,1,9455,[427 588  79  98 127],716,5,38327,4.053193739424704,20.0,20.0
19456,1,9456,[211 215 121 195 471],693,2,38329,4.052976631066935,0.0,0.0
19457,1,9457,[427 588  79  98 127],389,5,38334,4.053076760414464,20.0,20.0
19458,1,9458,[211 282   7 568 181],450,5,38339,4.05317686859076,0.0,0.0
19459,1,9459,[269 174 111 245 200],629,3,38342,4.053065539112051,0.0,0.0
19460,1,9460,[174 204   1 202  69],796,4,38346,4.053059930239932,0.0,0.0
19461,1,9461,[427 588  79  98 127],796,5,38351,4.0531600084548725,20.0,20.0
19462,1,9462,[275 588 100 603 117],401,3,38354,4.053048716051992,20.0,40.0
19463,1,9463,[427 588  79  98 127],450,5,38359,4.05314877430262,20.0,20.0
19464,1,9464,[100 180   1 405 568],280,2,38361,4.052931854199683,0.0,20.0
19465,1,9465,[603 168 183 435 143],716,4,38365,4.052926262412846,20.0,0.0
19466,1,9466,[ 28 435 568 197 496],389,4,38369,4.052920671807331,20.0,0.0
19467,1,9467,[  9 268  88 496 742],344,2,38371,4.052703844528939,20.0,0.0
19468,1,9468,[121 496 175   7 357],151,5,38376,4.0528038863660365,20.0,0.0
19469,1,9469,[427  96 117 271  70],655,1,38377,4.052481520591341,20.0,0.0
19470,1,9470,[357 748 191 100 435],11,4,38381,4.052475979305248,0.0,20.0
19471,1,9471,[427 588  79  98 127],18,5,38386,4.052576013513513,20.0,20.0
19472,1,9472,[ 70 100 143 742 183],450,5,38391,4.0526760266019215,0.0,20.0
19473,1,9473,[125  97 172 204 328],796,4,38395,4.052670466540004,0.0,0.0
19474,1,9474,[427 588  79  98 127],389,5,38400,4.052770448548813,20.0,20.0
19475,1,9475,[ 25 300 185  79 174],716,5,38405,4.052870409455466,0.0,0.0
19476,1,9476,[302 194   4 183  22],450,4,38409,4.0528648306426085,0.0,0.0
19477,1,9477,[427 588  79  98 127],389,5,38414,4.0529647604979955,20.0,20.0
19478,1,9478,[427 588  79  98 127],18,5,38419,4.0530646692689105,20.0,20.0
19479,1,9479,[427 588  79  98 127],389,5,38424,4.053164556962026,20.0,20.0
19480,1,9480,[132 742  25  64  56],577,4,38428,4.053158949477903,20.0,0.0
19481,1,9481,[427 588  79  98 127],18,5,38433,4.053258806159038,20.0,20.0
19482,1,9482,[111 678   1 176  11],280,3,38436,4.053147738057577,0.0,0.0
19483,1,9483,[215 228 294 195 210],280,0,38436,4.052720371151413,0.0,0.0
19484,1,9484,[ 88 174 228 328 435],450,5,38441,4.052820242488139,0.0,0.0
19485,1,9485,[427 588  79  98 127],796,5,38446,4.05292009276829,20.0,20.0
19486,1,9486,[427 588  79  98 127],716,5,38451,4.053019921998525,20.0,20.0
19487,1,9487,[  9  69 276   4 121],655,1,38452,4.052698145025295,0.0,0.0
19488,1,9488,[427 588  79  98 127],389,5,38457,4.05279797660449,20.0,20.0
19489,1,9489,[318   7 313 135 172],693,4,38461,4.052792413066386,20.0,0.0
19490,1,9490,[427 588  79  98 127],18,5,38466,4.052892213676114,20.0,20.0
19491,1,9491,[ 70 238 318 186 197],504,2,38468,4.052675937631689,20.0,0.0
19492,1,9492,[174 245  79 191  64],796,4,38472,4.052670388707469,20.0,0.0
19493,1,9493,[ 25 195  12  69 202],151,4,38476,4.05266484095218,0.0,0.0
19494,1,9494,[603 282 655 183 435],655,2,38478,4.052448657187994,20.0,0.0
19495,1,9495,[427 588  79  98 127],796,5,38483,4.052548441449031,20.0,20.0
19496,1,9496,[427 588  79  98 127],796,5,38488,4.05264820469622,20.0,20.0
19497,1,9497,[301 403 132 257 588],796,4,38492,4.052642661612971,0.0,0.0
19498,1,9498,[568 282  22  11 143],457,5,38497,4.052742393936204,0.0,0.0
19499,1,9499,[427 588  79  98 127],450,5,38502,4.052842105263158,20.0,20.0
19500,1,9500,[427 588  79  98 127],389,5,38507,4.052941795600463,20.0,20.0
19501,1,9501,[427 588  79  98 127],389,5,38512,4.053041464954746,20.0,20.0
19502,1,9502,[427 588  79  98 127],450,5,38517,4.053141113332631,20.0,20.0
19503,1,9503,[427 588  79  98 127],716,5,38522,4.0532407407407405,20.0,20.0
19504,1,9504,[176 180 144 100 237],450,5,38527,4.053340347185692,0.0,20.0
19505,1,9505,[228   4  82 196 151],577,4,38531,4.053334735956238,0.0,0.0
19506,1,9506,[161   1  98 427 234],577,4,38535,4.053329125907227,20.0,0.0
19507,1,9507,[427 588  79  98 127],796,5,38540,4.053428691628103,20.0,20.0
19508,1,9508,[427 588  79  98 127],450,5,38545,4.0535282364076135,20.0,20.0
19509,1,9509,[427 588  79  98 127],18,5,38550,4.053627760252366,20.0,20.0
19510,1,9510,[ 97 471 405 385 546],593,2,38552,4.053411838923352,0.0,0.0
19511,1,9511,[427 588  79  98 127],450,5,38557,4.053511354079058,20.0,20.0
19512,1,9512,[ 79 100 117 288 313],593,5,38562,4.053610848312835,0.0,20.0
19513,1,9513,[427 588  79  98 127],796,5,38567,4.05371032163128,20.0,20.0
19514,1,9514,[ 12   1 204  70 275],503,3,38570,4.053599579611141,0.0,20.0
19515,1,9515,[427 588  79  98 127],796,5,38575,4.05369903320723,20.0,20.0
19516,1,9516,[ 28 179 427 180 483],450,4,38579,4.053693390774404,20.0,0.0
19517,1,9517,[125 302 210 405 211],401,2,38581,4.053477621349023,0.0,0.0
19518,1,9518,[  1 143 234 427  64],389,4,38585,4.053472003361698,40.0,0.0
19519,1,9519,[435 238 276 191 603],269,4,38589,4.053466386554621,20.0,0.0
19520,1,9520,[427 588  79  98 127],389,5,38594,4.053565801911564,20.0,20.0
19521,1,9521,[427 588  79  98 127],716,5,38599,4.053665196387313,20.0,20.0
19522,1,9522,[427 588  79  98 127],450,5,38604,4.053764569988449,20.0,20.0
19523,1,9523,[357  98 288 179 471],457,5,38609,4.053863922721545,0.0,0.0
19524,1,9524,[546 286 245  11 202],344,1,38610,4.053543307086614,0.0,20.0
19525,1,9525,[183   4 300 100 195],655,1,38611,4.053222758765484,0.0,20.0
19526,1,9526,[427 588  79  98 127],796,5,38616,4.053322137084077,20.0,20.0
19527,1,9527,[204 127 173  15  56],796,5,38621,4.053421494542401,0.0,20.0
19528,1,9528,[ 25 151  98 748 471],256,5,38626,4.053520831147025,0.0,0.0
19529,1,9529,[269  69 117  15 161],655,0,38626,4.053095487932843,0.0,0.0
19530,1,9530,[546 183 153  70 357],716,3,38629,4.052984996327773,0.0,0.0
19531,1,9531,[204 597  82 135  70],269,1,38630,4.052664708350818,0.0,0.0
19532,1,9532,[210 238  98 515 742],655,2,38632,4.05244938634218,0.0,0.0
19533,1,9533,[186  98 427 181  22],450,4,38636,4.052443885043004,20.0,0.0
19534,1,9534,[118 216  50 597 215],457,4,38640,4.052438384897745,0.0,20.0
19535,1,9535,[597  82 271 186 127],807,3,38643,4.052328020134228,0.0,20.0
19536,1,9536,[  9 313 742 216   4],280,3,38646,4.052217678515256,0.0,0.0
19537,1,9537,[427 588  79  98 127],716,5,38651,4.052317047599077,20.0,20.0
19538,1,9538,[194  50 258 125 151],450,5,38656,4.0524163958486215,0.0,20.0
19539,1,9539,[427 588  79  98 127],450,5,38661,4.0525157232704405,20.0,20.0
19540,1,9540,[180   1 405 194 172],450,5,38666,4.052615029871083,0.0,0.0
19541,1,9541,[187  25  28 211 173],389,3,38669,4.0525047159924545,0.0,0.0
19542,1,9542,[187 161  79  50   1],256,4,38673,4.052499214083621,0.0,20.0
19543,1,9543,[742 100 282 405 127],280,2,38675,4.052284157585918,0.0,40.0
19544,1,9544,[172 269 313 238 222],296,5,38680,4.0523834468308015,0.0,0.0
19545,1,9545,[427 588  79  98 127],18,5,38685,4.052482715273413,20.0,20.0
19546,1,9546,[427 588  79  98 127],716,5,38690,4.052581962920289,20.0,20.0
19547,1,9547,[  8 322 172 245 200],280,3,38693,4.052471721826561,0.0,0.0
19548,1,9548,[427 588  79  98 127],450,5,38698,4.052570949837679,20.0,20.0
19549,1,9549,[237   9  98 195 275],236,3,38701,4.052460732984293,0.0,20.0
19550,1,9550,[568 742 235 385 210],344,2,38703,4.052245838132133,0.0,0.0
19551,1,9551,[183 234 153  56 276],292,5,38708,4.052345058626465,0.0,0.0
19552,1,9552,[ 97 168 143 235 405],330,4,38712,4.052339579189783,0.0,0.0
19553,1,9553,[185 151 215   9 186],457,5,38717,4.052438769101947,0.0,0.0
19554,1,9554,[427 588  79  98 127],450,5,38722,4.0525379382522235,20.0,20.0
19555,1,9555,[427 588  79  98 127],796,5,38727,4.052637086647133,20.0,20.0
19556,1,9556,[427 588  79  98 127],716,5,38732,4.052736214293188,20.0,20.0
19557,1,9557,[427 588  79  98 127],18,5,38737,4.052835321196903,20.0,20.0
19558,1,9558,[144 194 100 603   1],535,3,38740,4.052725180458207,20.0,20.0
19559,1,9559,[143 210 176 202 161],796,4,38744,4.052719665271966,0.0,0.0
19560,1,9560,[427 588  79  98 127],796,5,38749,4.05281874280933,20.0,20.0
19561,1,9561,[427 588  79  98 127],796,5,38754,4.0529177996235095,20.0,20.0
19562,1,9562,[427 588  79  98 127],389,5,38759,4.053016835721008,20.0,20.0
19563,1,9563,[286 405 222  69 196],796,4,38763,4.053011292346299,0.0,20.0
19564,1,9564,[427 588  79  98 127],18,5,38768,4.053110297961317,20.0,20.0
19565,1,9565,[588  28 597  82 204],450,4,38772,4.053104745975329,0.0,0.0
19566,1,9566,[427 588  79  98 127],796,5,38777,4.053203721124699,20.0,20.0
19567,1,9567,[427 185 423 405   8],23,4,38781,4.053198160535117,20.0,0.0
19568,1,9568,[427 588  79  98 127],796,5,38786,4.053297105235657,20.0,20.0
19569,1,9569,[300 186  82  64 183],716,3,38789,4.053187042842215,20.0,0.0
19570,1,9570,[427 588  79  98 127],450,5,38794,4.053285968028419,20.0,20.0
19571,1,9571,[423  50  71 100 161],593,5,38799,4.053384872544923,0.0,40.0
19572,1,9572,[427 588  79  98 127],18,5,38804,4.053483756398204,20.0,20.0
19573,1,9573,[100 211 153 111 204],796,3,38807,4.053373720493002,0.0,20.0
19574,1,9574,[427 588  79  98 127],450,5,38812,4.053472584856397,20.0,20.0
19575,1,9575,[ 69  11 168 191 313],450,5,38817,4.053571428571429,0.0,0.0
19576,1,9576,[294 197 302 135  25],401,2,38819,4.053357001148585,0.0,0.0
19577,1,9577,[427 588  79  98 127],450,5,38824,4.053455836291501,20.0,20.0
19578,1,9578,[403 143   1  95 191],796,4,38828,4.053450255767825,0.0,0.0
19579,1,9579,[427 588  79  98 127],450,5,38833,4.053549060542798,20.0,20.0
19580,1,9580,[427 588  79  98 127],18,5,38838,4.0536478446926205,20.0,20.0
19581,1,9581,[ 71  50 161 181 385],796,5,38843,4.0537466082237525,0.0,20.0
19582,1,9582,[427 588  79  98 127],18,5,38848,4.053845351142648,20.0,20.0
19583,1,9583,[427 588  79  98 127],716,5,38853,4.053944073455759,20.0,20.0
19584,1,9584,[144 294 546 197   7],450,5,38858,4.054042775169536,0.0,0.0
19585,1,9585,[427 588  79  98 127],450,5,38863,4.054141456290424,20.0,20.0
19586,1,9586,[ 82 597 282 403 151],450,4,38867,4.054135808907896,0.0,0.0
19587,1,9587,[269  69 168  11  12],174,4,38871,4.0541301627033794,0.0,0.0
19588,1,9588,[ 97 176 125  15 294],450,4,38875,4.054124517676504,0.0,0.0
19589,1,9589,[427 588  79  98 127],389,5,38880,4.05422314911366,20.0,20.0
19590,1,9590,[427 588  79  98 127],450,5,38885,4.054321759983318,20.0,20.0
19591,1,9591,[ 22 655 234 200 211],269,3,38888,4.054211843202669,0.0,0.0
19592,1,9592,[117 127 187 313  69],693,3,38891,4.054101949338059,0.0,20.0
19593,1,9593,[181 153 143 655  70],23,2,38893,4.053887846570773,0.0,0.0
19594,1,9594,[175 132  56  12  88],457,5,38898,4.053986451276707,0.0,0.0
19595,1,9595,[427 588  79  98 127],796,5,38903,4.05408503543143,20.0,20.0
19596,1,9596,[125 151 475   7 265],292,3,38906,4.0539752005835155,0.0,0.0
19597,1,9597,[211 216 179 176 234],269,2,38908,4.053761200250052,0.0,0.0
19598,1,9598,[427 588  79  98 127],716,5,38913,4.053859777060111,20.0,20.0
19599,1,9599,[427 588  79  98 127],796,5,38918,4.053958333333333,20.0,20.0
19600,1,9600,[ 28 268 508  96  79],655,1,38919,4.0536402458077285,0.0,0.0
19601,1,9601,[183 286 301  69  96],344,3,38922,4.053530514476151,0.0,20.0
19602,1,9602,[ 25 173 153 215   1],535,4,38926,4.053524940122879,0.0,0.0
19603,1,9603,[172 385 403 357 546],450,5,38931,4.053623490212411,0.0,0.0
19604,1,9604,[427 588  79  98 127],796,5,38936,4.053722019781364,20.0,20.0
19605,1,9605,[234 175 179 182 237],457,5,38941,4.053820528836144,0.0,0.0
19606,1,9606,[ 11 200 194  82 204],269,2,38943,4.053606745081711,0.0,0.0
19607,1,9607,[196 183 403 144 191],693,1,38944,4.053288925895087,0.0,0.0
19608,1,9608,[313 405 742 748 245],938,1,38945,4.052971172858778,0.0,0.0
19609,1,9609,[111  82 161 196 179],885,3,38948,4.052861602497399,0.0,0.0
19610,1,9610,[173 174 179 111 588],577,4,38952,4.052856102382687,0.0,0.0
19611,1,9611,[  8 235  89 181 237],457,4,38956,4.052850603412401,0.0,0.0
19612,1,9612,[427 588  79  98 127],450,5,38961,4.052949131384583,20.0,20.0
19613,1,9613,[427 588  79  98 127],716,5,38966,4.053047638859995,20.0,20.0
19614,1,9614,[427 588  79  98 127],796,5,38971,4.053146125845034,20.0,20.0
19615,1,9615,[185  15 153 603 135],389,2,38973,4.052932612312812,20.0,0.0
19616,1,9616,[ 64 357 423 302 187],269,4,38977,4.0529271082458145,20.0,0.0
19617,1,9617,[172 143  89 597 210],796,4,38981,4.052921605323352,0.0,0.0
19618,1,9618,[200 496  70 172  22],18,3,38984,4.0528121426343695,20.0,0.0
19619,1,9619,[427 588  79  98 127],18,5,38989,4.052910602910603,20.0,20.0
19620,1,9620,[144 121 357 174  50],796,5,38994,4.053009042719052,0.0,20.0
19621,1,9621,[427 588  79  98 127],716,5,38999,4.053107462066099,20.0,20.0
19622,1,9622,[282 185  64 508 588],401,1,39000,4.052790190169386,20.0,0.0
19623,1,9623,[ 70 228  97  89 187],655,2,39002,4.052576891105569,0.0,0.0
19624,1,9624,[427 588  79  98 127],389,5,39007,4.052675324675325,20.0,20.0
19625,1,9625,[427 588  79  98 127],450,5,39012,4.052773737793476,20.0,20.0
19626,1,9626,[742 186  79 210 300],693,1,39013,4.0524566323880755,0.0,0.0
19627,1,9627,[100  89 385 222 258],655,1,39014,4.052139592854175,0.0,20.0
19628,1,9628,[ 22 301 168   1 496],796,3,39017,4.052030325059715,20.0,0.0
19629,1,9629,[194 276 173 211   9],535,4,39021,4.05202492211838,0.0,0.0
19630,1,9630,[211 172 191  56 228],296,5,39026,4.052123351676877,0.0,0.0
19631,1,9631,[286  71 357 200 288],450,2,39028,4.051910299003322,0.0,20.0
19632,1,9632,[427 588  79  98 127],716,5,39033,4.052008720024914,20.0,20.0
19633,1,9633,[185 176 135   9 508],269,4,39037,4.052003321569441,0.0,0.0
19634,1,9634,[427 588  79  98 127],716,5,39042,4.052101712506487,20.0,20.0
19635,1,9635,[ 70 483 427 273 132],450,3,39045,4.051992528019925,20.0,0.0
19636,1,9636,[427 588  79  98 127],796,5,39050,4.0520908996575695,20.0,20.0
19637,1,9637,[427 588  79  98 127],450,5,39055,4.052189250881925,20.0,20.0
19638,1,9638,[210 186 288  50 655],655,1,39056,4.051872600892208,0.0,20.0
19639,1,9639,[427 588  79  98 127],716,5,39061,4.051970954356847,20.0,20.0
19640,1,9640,[318  56 176 405 172],280,2,39063,4.051758116377969,20.0,0.0
19641,1,9641,[427 588  79  98 127],18,5,39068,4.05185646131508,20.0,20.0
19642,1,9642,[98 95 12 70  8],18,5,39073,4.051954785855024,0.0,0.0
19643,1,9643,[200 237 196  22 176],269,1,39074,4.051638324346744,0.0,0.0
19644,1,9644,[427 588  79  98 127],389,5,39079,4.051736651114567,20.0,20.0
19645,1,9645,[173  97 268   9 168],11,4,39083,4.051731287580345,0.0,0.0
19646,1,9646,[427 588  79  98 127],796,5,39088,4.051829584326733,20.0,20.0
19647,1,9647,[427 588  79  98 127],389,5,39093,4.051927860696518,20.0,20.0
19648,1,9648,[180  28   8  98 135],18,3,39096,4.051818841330708,0.0,0.0
19649,1,9649,[483  70 234  15 121],269,1,39097,4.051502590673575,0.0,0.0
19650,1,9650,[655 216  89 234 195],450,4,39101,4.0514972541705525,0.0,0.0
19651,1,9651,[216 318 161 182 282],450,5,39106,4.05159552424368,20.0,0.0
19652,1,9652,[ 96 195 174 265  64],716,3,39109,4.051486584481508,20.0,0.0
19653,1,9653,[427 588  79  98 127],450,5,39114,4.05158483530143,20.0,20.0
19654,1,9654,[ 64 151 143   8 200],457,5,39119,4.051683065769032,20.0,0.0
19655,1,9655,[333 655  15  11 423],224,3,39122,4.051574150787076,0.0,0.0
19656,1,9656,[427 588  79  98 127],450,5,39127,4.0516723620171895,20.0,20.0
19657,1,9657,[210 100  71 182 546],450,3,39130,4.051563470697867,0.0,20.0
19658,1,9658,[427 588  79  98 127],796,5,39135,4.0516616626980015,20.0,20.0
19659,1,9659,[427 588  79  98 127],450,5,39140,4.05175983436853,20.0,20.0
19660,1,9660,[508 289 135 176  50],655,2,39142,4.051547458855191,0.0,20.0
19661,1,9661,[427 588  79  98 127],389,5,39147,4.0516456220244255,20.0,20.0
19662,1,9662,[294 245 216  88 301],450,5,39152,4.051743764876332,0.0,0.0
19663,1,9663,[318 161 174  50 357],269,2,39154,4.051531456953643,20.0,20.0
19664,1,9664,[127 742 234 194 210],457,5,39159,4.0516295913088465,0.0,20.0
19665,1,9665,[496 179 194 127  15],236,2,39161,4.051417339126837,20.0,20.0
19666,1,9666,[568 127 238 111  88],655,1,39162,4.051101686148754,0.0,20.0
19667,1,9667,[475  50  82  22  70],269,1,39163,4.050786098469176,0.0,20.0
19668,1,9668,[427 588  79  98 127],389,5,39168,4.050884269314303,20.0,20.0
19669,1,9669,[427 588  79  98 127],18,5,39173,4.050982419855222,20.0,20.0
19670,1,9670,[161 210 215  22   1],330,5,39178,4.051080550098232,0.0,0.0
19671,1,9671,[194 197 288 186  79],450,3,39181,4.0509718775847805,0.0,0.0
19672,1,9672,[ 56 173 269 357  96],450,5,39186,4.05106998862814,0.0,0.0
19673,1,9673,[427 588  79  98 127],716,5,39191,4.0511680793880505,20.0,20.0
19674,1,9674,[471 181   4  95 588],716,3,39194,4.051059431524548,0.0,0.0
19675,1,9675,[423 508 427 153 276],535,4,39198,4.051054154609343,20.0,0.0
19676,1,9676,[588 196 143 127 357],796,5,39203,4.051152216596052,0.0,20.0
19677,1,9677,[427 588  79  98 127],796,5,39208,4.051250258317834,20.0,20.0
19678,1,9678,[427 588  79  98 127],450,5,39213,4.051348279780969,20.0,20.0
19679,1,9679,[427 588  79  98 127],389,5,39218,4.051446280991735,20.0,20.0
19680,1,9680,[427  11 234  15 180],269,1,39219,4.051131081499845,20.0,0.0
19681,1,9681,[100 210  82 132 238],269,3,39222,4.051022516009089,0.0,20.0
19682,1,9682,[427 588  79  98 127],450,5,39227,4.051120520499845,20.0,20.0
19683,1,9683,[132 195   4   1 427],18,3,39230,4.051011978521272,20.0,0.0
19684,1,9684,[427 588  79  98 127],716,5,39235,4.0511099638616415,20.0,20.0
19685,1,9685,[427 588  79  98 127],716,5,39240,4.051207928969647,20.0,20.0
19686,1,9686,[176 423 515  96 257],655,1,39241,4.050892949313513,0.0,0.0
19687,1,9687,[228  98 496 323 385],280,3,39244,4.050784475639967,20.0,0.0
19688,1,9688,[427 588  79  98 127],716,5,39249,4.0508824440086695,20.0,20.0
19689,1,9689,[427 588  79  98 127],716,5,39254,4.050980392156863,20.0,20.0
19690,1,9690,[202 200 568 265 282],457,5,39259,4.051078320090806,0.0,0.0
19691,1,9691,[153 186 215  25 216],450,3,39262,4.05096987205943,0.0,0.0
19692,1,9692,[427 588  79  98 127],796,5,39267,4.051067780872795,20.0,20.0
19693,1,9693,[427 588  79  98 127],18,5,39272,4.05116566948628,20.0,20.0
19694,1,9694,[ 56 176   9 238 100],151,3,39275,4.0510572460030945,0.0,20.0
19695,1,9695,[427 588  79  98 127],450,5,39280,4.051155115511551,20.0,20.0
19696,1,9696,[216  50  79 273 125],450,4,39284,4.051149840156749,0.0,20.0
19697,1,9697,[181  95 204  50 597],807,5,39289,4.051247679934007,0.0,20.0
19698,1,9698,[318  95 100 588  12],577,5,39294,4.051345499536034,20.0,20.0
19699,1,9699,[427 588  79  98 127],450,5,39299,4.0514432989690725,20.0,20.0
19700,1,9700,[ 25 265 215 286 182],535,2,39301,4.051231831769921,0.0,20.0
19701,1,9701,[301 182  56  88 427],655,2,39303,4.051020408163265,20.0,0.0
19702,1,9702,[427 588  79  98 127],18,5,39308,4.05111821086262,20.0,20.0
19703,1,9703,[168 194 655 204  56],796,4,39312,4.051112943116241,0.0,0.0
19704,1,9704,[ 95 357 313  50 179],450,4,39316,4.051107676455436,0.0,20.0
19705,1,9705,[427 588  79  98 127],796,5,39321,4.051205439934061,20.0,20.0
19706,1,9706,[179 318 475  25 176],655,2,39323,4.050994127948903,20.0,0.0
19707,1,9707,[117 237 132   8 204],796,5,39328,4.051091882983107,0.0,0.0
19708,1,9708,[427 588  79  98 127],450,5,39333,4.0511896178803175,20.0,20.0
19709,1,9709,[161 100 588 204 117],280,3,39336,4.051081359423275,0.0,20.0
19710,1,9710,[427 588  79  98 127],389,5,39341,4.051179075275461,20.0,20.0
19711,1,9711,[427 588  79  98 127],389,5,39346,4.051276771004942,20.0,20.0
19712,1,9712,[427 588  79  98 127],796,5,39351,4.051374446617935,20.0,20.0
19713,1,9713,[427 588  79  98 127],716,5,39356,4.051472102120651,20.0,20.0
19714,1,9714,[269  69 172  97 185],503,5,39361,4.0515697375193,0.0,0.0
19715,1,9715,[427 588  79  98 127],716,5,39366,4.051667352820091,20.0,20.0
19716,1,9716,[215 135 153 588  95],280,4,39370,4.0516620356076976,0.0,0.0
19717,1,9717,[357 238  25 185  15],655,2,39372,4.051450915826302,0.0,0.0
19718,1,9718,[427 588  79  98 127],450,5,39377,4.051548513221525,20.0,20.0
19719,1,9719,[143 210 313 655 200],593,3,39380,4.051440329218107,0.0,0.0
19720,1,9720,[318   9   1 234  25],457,5,39385,4.051537907622673,20.0,0.0
19721,1,9721,[427 588  79  98 127],716,5,39390,4.051635465953508,20.0,20.0
19722,1,9722,[300 222 194 121  22],716,5,39395,4.051733004216805,0.0,0.0
19723,1,9723,[288 144 405 172  95],280,2,39397,4.05152200740436,0.0,0.0
19724,1,9724,[508  12 127 318 172],693,3,39400,4.051413881748072,20.0,20.0
19725,1,9725,[427 588  79  98 127],450,5,39405,4.051511412708205,20.0,20.0
19726,1,9726,[475 161 183 191 234],269,2,39407,4.051300503752442,0.0,0.0
19727,1,9727,[273 471 515  28 179],655,3,39410,4.0511924342105265,0.0,0.0
19728,1,9728,[127 483 423 215 186],655,2,39412,4.050981601397883,0.0,20.0
19729,1,9729,[196 117 202 182  22],796,5,39417,4.051079136690648,0.0,0.0
19730,1,9730,[357 273 300 385  28],796,3,39420,4.050971123214469,0.0,0.0
19731,1,9731,[ 97 153 508 238 269],535,5,39425,4.051068639539663,0.0,0.0
19732,1,9732,[427 588  79  98 127],18,5,39430,4.05116613582657,20.0,20.0
19733,1,9733,[181 588  69  15 117],577,4,39434,4.051160879391823,0.0,0.0
19734,1,9734,[427 588  79  98 127],716,5,39439,4.051258346173601,20.0,20.0
19735,1,9735,[427 588  79  98 127],450,5,39444,4.0513557929334425,20.0,20.0
19736,1,9736,[427 588  79  98 127],796,5,39449,4.051453219677518,20.0,20.0
19737,1,9737,[  4 427  71 215 153],450,3,39452,4.051345245430273,20.0,0.0
19738,1,9738,[427 588  79  98 127],716,5,39457,4.05144265324982,20.0,20.0
19739,1,9739,[322  12 197  97 135],151,4,39461,4.051437371663244,0.0,0.0
19740,1,9740,[427 588  79  98 127],796,5,39466,4.051534750025665,20.0,20.0
19741,1,9741,[427 588  79  98 127],796,5,39471,4.051632108396634,20.0,20.0
19742,1,9742,[200 427 302   1 286],450,4,39475,4.05162680899107,20.0,20.0
19743,1,9743,[265 286 603 357 118],796,4,39479,4.051621510673235,20.0,20.0
19744,1,9744,[181 357  88 257 135],716,4,39483,4.0516162134427915,0.0,0.0
19745,1,9745,[191 268 222 228  98],296,5,39488,4.05171352349682,0.0,0.0
19746,1,9746,[427 588  79  98 127],796,5,39493,4.051810813583667,20.0,20.0
19747,1,9747,[427 588  79  98 127],18,5,39498,4.0519080837094785,20.0,20.0
19748,1,9748,[211  97  98  95 172],18,4,39502,4.051902759257359,0.0,0.0
19749,1,9749,[427 588  79  98 127],18,5,39507,4.052,20.0,20.0
19750,1,9750,[211  98 597  70 191],23,2,39509,4.0517895600451235,0.0,0.0
19751,1,9751,[173 385 194 655 357],151,4,39513,4.051784249384742,0.0,0.0
19752,1,9752,[427 588  79  98 127],18,5,39518,4.0518814723674765,20.0,20.0
19753,1,9753,[427 588  79  98 127],18,5,39523,4.0519786754152145,20.0,20.0
19754,1,9754,[121   8  64  97  89],344,3,39526,4.05187083546899,20.0,0.0
19755,1,9755,[475   9  12   7  69],655,0,39526,4.051455514555146,0.0,0.0
19756,1,9756,[742 546   9 288 143],504,5,39531,4.051552731372348,0.0,0.0
19757,1,9757,[235 200   7  79 144],457,4,39535,4.051547448247591,0.0,0.0
19758,1,9758,[427 588  79  98 127],450,5,39540,4.051644635720873,20.0,20.0
19759,1,9759,[427 588  79  98 127],716,5,39545,4.051741803278689,20.0,20.0
19760,1,9760,[427 588  79  98 127],716,5,39550,4.051838950927159,20.0,20.0
19761,1,9761,[ 28 185 135 385 423],151,4,39554,4.051833640647408,0.0,0.0
19762,1,9762,[427 588  79  98 127],389,5,39559,4.051930758988016,20.0,20.0
19763,1,9763,[  9  70 185 100 168],11,4,39563,4.051925440393282,0.0,20.0
19764,1,9764,[427 588  79  98 127],796,5,39568,4.052022529441884,20.0,20.0
19765,1,9765,[ 15 172 508 195 268],269,2,39570,4.05181241040344,0.0,0.0
19766,1,9766,[161  97 234 195 172],655,1,39571,4.051499948807208,0.0,0.0
19767,1,9767,[427 588  79  98 127],716,5,39576,4.051597051597051,20.0,20.0
19768,1,9768,[195 179 200  11 127],457,5,39581,4.051694134507114,0.0,20.0
19769,1,9769,[427 588  79  98 127],450,5,39586,4.0517911975435,20.0,20.0
19770,1,9770,[427 588  79  98 127],18,5,39591,4.051888240712312,20.0,20.0
19771,1,9771,[427 588  79  98 127],18,5,39596,4.051985264019648,20.0,20.0
19772,1,9772,[194 172 168 182 195],535,3,39599,4.051877622019851,0.0,0.0
19773,1,9773,[427 588  79  98 127],716,5,39604,4.051974626560262,20.0,20.0
19774,1,9774,[427 588  79  98 127],18,5,39609,4.052071611253197,20.0,20.0
19775,1,9775,[427 588  79  98 127],389,5,39614,4.052168576104746,20.0,20.0
19776,1,9776,[ 96 546  82 322 385],504,5,39619,4.052265521120998,0.0,0.0
19777,1,9777,[204  69 318  28 211],236,3,39622,4.052157905502147,20.0,0.0
19778,1,9778,[427 588  79  98 127],450,5,39627,4.052254831782391,20.0,20.0
19779,1,9779,[ 98  12  64 655 186],151,5,39632,4.052351738241309,20.0,0.0
19780,1,9780,[427 588  79  98 127],18,5,39637,4.052448624884981,20.0,20.0
19781,1,9781,[427 588  79  98 127],796,5,39642,4.052545491719485,20.0,20.0
19782,1,9782,[210 197   9 216 475],269,3,39645,4.0524379024839,0.0,0.0
19783,1,9783,[216 195  12 655 237],457,5,39650,4.052534750613246,0.0,0.0
19784,1,9784,[318   1 186 181 403],796,3,39653,4.052427184466019,20.0,0.0
19785,1,9785,[ 22 258 202 183   7],457,5,39658,4.052524013897404,0.0,0.0
19786,1,9786,[427 588  79  98 127],450,5,39663,4.0526208235414325,20.0,20.0
19787,1,9787,[427 588  79  98 127],389,5,39668,4.052717613404169,20.0,20.0
19788,1,9788,[  7 117 222 175 215],457,5,39673,4.0528143834916746,0.0,0.0
19789,1,9789,[195 191 273 144  12],655,2,39675,4.0526046986721145,0.0,0.0
19790,1,9790,[427 588  79  98 127],18,5,39680,4.052701460524972,20.0,20.0
19791,1,9791,[ 22  71 176  70 174],450,4,39684,4.052696078431373,0.0,0.0
19792,1,9792,[427 588  79  98 127],18,5,39689,4.052792811191668,20.0,20.0
19793,1,9793,[427 588  79  98 127],18,5,39694,4.052889524198489,20.0,20.0
19794,1,9794,[117 173  88 132 191],716,5,39699,4.052986217457887,0.0,0.0
19795,1,9795,[427 588  79  98 127],716,5,39704,4.053082890975909,20.0,20.0
19796,1,9796,[313 196 222 300 301],796,4,39708,4.0530774726957235,0.0,0.0
19797,1,9797,[427 588  79  98 127],716,5,39713,4.053174117166769,20.0,20.0
19798,1,9798,[427 588  79  98 127],450,5,39718,4.05327074191244,20.0,20.0
19799,1,9799,[ 70  95 483 405  50],280,3,39721,4.0531632653061225,0.0,20.0
19800,1,9800,[427 588  79  98 127],389,5,39726,4.053259871441689,20.0,20.0
19801,1,9801,[  7  22 215 678 174],280,2,39728,4.053050397877984,0.0,0.0
19802,1,9802,[182  12 197 196 294],655,1,39729,4.052738957462002,0.0,0.0
19803,1,9803,[427 588  79  98 127],716,5,39734,4.052835577315381,20.0,20.0
19804,1,9804,[ 12 185 496   1 100],503,4,39738,4.052830188679246,20.0,20.0
19805,1,9805,[427 588  79  98 127],389,5,39743,4.052926779522741,20.0,20.0
19806,1,9806,[427 588  79  98 127],716,5,39748,4.05302335066789,20.0,20.0
19807,1,9807,[228 118 258  82 168],151,3,39751,4.052915986949429,0.0,0.0
19808,1,9808,[748 216 588 286 200],796,4,39755,4.052910592313181,0.0,20.0
19809,1,9809,[427 588  79  98 127],389,5,39760,4.0530071355759425,20.0,20.0
19810,1,9810,[427 588  79  98 127],796,5,39765,4.053103659158088,20.0,20.0
19811,1,9811,[427 588  79  98 127],18,5,39770,4.053200163065634,20.0,20.0
19812,1,9812,[168 215 196  64 202],151,4,39774,4.0531947416692145,20.0,0.0
19813,1,9813,[427 588  79  98 127],18,5,39779,4.053291216629305,20.0,20.0
19814,1,9814,[427 588  79  98 127],389,5,39784,4.053387671930718,20.0,20.0
19815,1,9815,[175  11 143  98 161],457,5,39789,4.053484107579462,0.0,0.0
19816,1,9816,[496 323   4 185  50],796,4,39793,4.0534786594682695,20.0,20.0
19817,1,9817,[427 588  79  98 127],796,5,39798,4.05357506620493,20.0,20.0
19818,1,9818,[ 56 204 183 357 216],716,4,39802,4.053569609939912,0.0,0.0
19819,1,9819,[  4  89 483 200  82],796,4,39806,4.053564154786151,0.0,0.0
19820,1,9820,[ 50 186 742 173  96],577,5,39811,4.0536605233682925,0.0,20.0
19821,1,9821,[172 143 181 275 568],798,5,39816,4.053756872327428,0.0,20.0
19822,1,9822,[179 275  50 194 183],236,0,39816,4.053344192201975,0.0,40.0
19823,1,9823,[313  98 215 286  56],450,5,39821,4.053440553745928,0.0,20.0
19824,1,9824,[180 258 183  89 185],796,4,39825,4.0534351145038165,0.0,0.0
19825,1,9825,[427 588  79  98 127],716,5,39830,4.053531447180949,20.0,20.0
19826,1,9826,[194 210 180 385 588],457,5,39835,4.053627760252366,0.0,0.0
19827,1,9827,[597  71 546 238   4],593,3,39838,4.053520553520554,0.0,0.0
19828,1,9828,[196 427 313 210  64],796,4,39842,4.053515108352833,40.0,0.0
19829,1,9829,[300 273 318  50 655],655,3,39845,4.053407934893184,20.0,20.0
19830,1,9830,[427 588  79  98 127],18,5,39850,4.053504221340657,20.0,20.0
19831,1,9831,[268  15 288 185 435],655,1,39851,4.053193653376729,0.0,0.0
19832,1,9832,[427 588  79  98 127],450,5,39856,4.053289942031934,20.0,20.0
19833,1,9833,[210 118 179   4 742],504,3,39859,4.05318283506203,0.0,0.0
19834,1,9834,[427 588  79  98 127],450,5,39864,4.053279105236401,20.0,20.0
19835,1,9835,[496   7   9 210 204],786,5,39869,4.053375355835706,20.0,0.0
19836,1,9836,[222 211 172   4  79],450,3,39872,4.053268272847413,0.0,0.0
19837,1,9837,[172 151 301 603 135],151,5,39877,4.053364504980687,20.0,0.0
19838,1,9838,[427 588  79  98 127],450,5,39882,4.053460717552597,20.0,20.0
19839,1,9839,[172  98 211 125 483],655,3,39885,4.053353658536586,0.0,0.0
19840,1,9840,[111 195 257 357 216],457,3,39888,4.053246621278325,0.0,0.0
19841,1,9841,[ 64 195   7 132 234],693,3,39891,4.053139605771185,20.0,0.0
19842,1,9842,[153 202 127  88 135],389,2,39893,4.052931016966372,0.0,20.0
19843,1,9843,[427 588  79  98 127],389,5,39898,4.053027224705405,20.0,20.0
19844,1,9844,[427 588  79  98 127],716,5,39903,4.053123412899949,20.0,20.0
19845,1,9845,[257 655 121 161  69],504,5,39908,4.053219581555962,0.0,0.0
19846,1,9846,[427 588  79  98 127],450,5,39913,4.053315730679395,20.0,20.0
19847,1,9847,[427 588  79  98 127],389,5,39918,4.053411860276198,20.0,20.0
19848,1,9848,[273 323 186 117 265],796,2,39920,4.053203370900599,0.0,0.0
19849,1,9849,[234 202  71 427 258],796,4,39924,4.053197969543147,20.0,0.0
19850,1,9850,[427 588  79  98 127],796,5,39929,4.0532940818191046,20.0,20.0
19851,1,9851,[357 288 742 275 313],593,4,39933,4.053288672350792,0.0,20.0
19852,1,9852,[427 588  79  98 127],796,5,39938,4.053384755911905,20.0,20.0
19853,1,9853,[427 588  79  98 127],389,5,39943,4.053480819971585,20.0,20.0
19854,1,9854,[174 194   9 423 483],236,3,39946,4.053373921867072,0.0,0.0
19855,1,9855,[318 742 603 117 197],796,3,39949,4.053267045454546,40.0,0.0
19856,1,9856,[427 588  79  98 127],450,5,39954,4.053363092218728,20.0,20.0
19857,1,9857,[427 588  79  98 127],18,5,39959,4.053459119496855,20.0,20.0
19858,1,9858,[471 210  79 195 172],256,4,39963,4.053453697129527,0.0,0.0
19859,1,9859,[ 64 318 235 153  56],269,3,39966,4.053346855983773,40.0,0.0
19860,1,9860,[238 655 121  89 135],450,3,39969,4.053240036507454,0.0,0.0
19861,1,9861,[191 286  64 508 405],344,3,39972,4.0531332386939765,20.0,20.0
19862,1,9862,[313 655   4  50  71],450,3,39975,4.053026462536754,0.0,20.0
19863,1,9863,[210 196 258  11 483],655,1,39976,4.052716950527169,0.0,0.0
19864,1,9864,[111 187 117   1 127],655,2,39978,4.05250886974151,0.0,20.0
19865,1,9865,[ 11 588  88 127  56],280,4,39982,4.052503547536996,0.0,20.0
19866,1,9866,[ 89 100 313 471 603],655,3,39985,4.052396878483835,20.0,20.0
19867,1,9867,[427 588  79  98 127],450,5,39990,4.052492906364005,20.0,20.0
19868,1,9868,[427 588  79  98 127],450,5,39995,4.052588914783666,20.0,20.0
19869,1,9869,[200 423 258 179 302],655,3,39998,4.052482269503546,0.0,0.0
19870,1,9870,[427 588  79  98 127],18,5,40003,4.052578259548171,20.0,20.0
19871,1,9871,[405  96 161  64 174],457,5,40008,4.052674230145867,20.0,0.0
19872,1,9872,[ 95 483  69 118  50],807,5,40013,4.0527701813025425,0.0,20.0
19873,1,9873,[427 588  79  98 127],18,5,40018,4.052866113024104,20.0,20.0
19874,1,9874,[ 25 276 204 132 211],504,3,40021,4.052759493670886,0.0,0.0
19875,1,9875,[471 186 202 111 597],450,4,40025,4.052754151478331,0.0,0.0
19876,1,9876,[ 79  95 328 172 423],450,4,40029,4.052748810367521,0.0,0.0
19877,1,9877,[603 195 202 265 313],450,5,40034,4.052844705405953,20.0,0.0
19878,1,9878,[ 82 216   7 117  95],280,4,40038,4.052839356210143,0.0,0.0
19879,1,9879,[742 403  22  96 117],280,4,40042,4.052834008097166,0.0,0.0
19880,1,9880,[427 588  79  98 127],18,5,40047,4.052929865398239,20.0,20.0
19881,1,9881,[427 588  79  98 127],716,5,40052,4.053025703298927,20.0,20.0
19882,1,9882,[ 12   8 588 546 742],796,4,40056,4.053020337954062,0.0,0.0
19883,1,9883,[132  28  79 194   4],457,5,40061,4.053116147308782,0.0,0.0
19884,1,9884,[427 588  79  98 127],796,5,40066,4.053211937278705,20.0,20.0
19885,1,9885,[427 588  79  98 127],389,5,40071,4.053307707869715,20.0,20.0
19886,1,9886,[427 588  79  98 127],796,5,40076,4.053403459087691,20.0,20.0
19887,1,9887,[427 588  79  98 127],796,5,40081,4.053499190938512,20.0,20.0
19888,1,9888,[258 286  12  15 187],655,1,40082,4.053190413590858,0.0,20.0
19889,1,9889,[427 588  79  98 127],18,5,40087,4.053286147623862,20.0,20.0
19890,1,9890,[ 64 597  56  82 322],256,4,40091,4.05328076028713,20.0,0.0
19891,1,9891,[ 82  22 182   9  50],796,3,40094,4.053174282248281,0.0,20.0
19892,1,9892,[  7 172 153 258  56],151,4,40098,4.053168907308198,0.0,0.0
19893,1,9893,[427 588  79  98 127],450,5,40103,4.053264604810996,20.0,20.0
19894,1,9894,[427 588  79  98 127],18,5,40108,4.053360282971197,20.0,20.0
19895,1,9895,[427 588  79  98 127],450,5,40113,4.053455941794665,20.0,20.0
19896,1,9896,[496 197 423 172 173],911,4,40117,4.053450540567849,20.0,0.0
19897,1,9897,[328 197 742   4  95],796,3,40120,4.053344109921196,0.0,0.0
19898,1,9898,[ 28  69 153 742 175],655,0,40120,4.052934639862612,0.0,0.0
19899,1,9899,[427 588  79  98 127],450,5,40125,4.053030303030303,20.0,20.0
19900,1,9900,[471 300 196  22 322],450,5,40130,4.0531259468740535,0.0,0.0
19901,1,9901,[427 588  79  98 127],450,5,40135,4.0532215713997175,20.0,20.0
19902,1,9902,[200 328 568 483  22],450,3,40138,4.053115217610825,0.0,0.0
19903,1,9903,[238 168 197 228 496],911,3,40141,4.053008885298869,20.0,0.0
19904,1,9904,[427 588  79  98 127],796,5,40146,4.053104492680465,20.0,20.0
19905,1,9905,[427 588  79  98 127],450,5,40151,4.053200080759136,20.0,20.0
19906,1,9906,[427 588  79  98 127],796,5,40156,4.053295649540729,20.0,20.0
19907,1,9907,[427 588  79  98 127],716,5,40161,4.053391199031086,20.0,20.0
19908,1,9908,[196 286 603 144 132],535,3,40164,4.053284892521949,20.0,20.0
19909,1,9909,[168 294 143  64 228],450,5,40169,4.053380423814329,20.0,0.0
19910,1,9910,[176 423 294 275 265],655,1,40170,4.053072343860357,0.0,20.0
19911,1,9911,[275  82 271 300 515],655,2,40172,4.052865213882163,0.0,20.0
19912,1,9912,[427 588  79  98 127],796,5,40177,4.052960758599818,20.0,20.0
19913,1,9913,[427 588  79  98 127],716,5,40182,4.053056284042768,20.0,20.0
19914,1,9914,[427 588  79  98 127],716,5,40187,4.053151790216843,20.0,20.0
19915,1,9915,[ 50  82 328 143 181],450,4,40191,4.053146430012101,0.0,20.0
19916,1,9916,[191 423  79 237 385],457,5,40196,4.053241907835031,0.0,0.0
19917,1,9917,[185 194 222 173 318],457,5,40201,4.053337366404517,20.0,0.0
19918,1,9918,[151 132  25  69 211],450,4,40205,4.053331989111806,0.0,0.0
19919,1,9919,[423 215 216 200  69],835,5,40210,4.053427419354839,0.0,0.0
19920,1,9920,[427 588  79  98 127],389,5,40215,4.053522830359843,20.0,20.0
19921,1,9921,[ 25 181 186 328 204],450,3,40218,4.053416649868978,0.0,0.0
19922,1,9922,[135  12  95  82 483],18,3,40221,4.0533104907789985,0.0,0.0
19923,1,9923,[427 588  79  98 127],450,5,40226,4.053405884723902,20.0,20.0
19924,1,9924,[118 100 385  28 172],457,5,40231,4.053501259445844,0.0,20.0
19925,1,9925,[427 588  79  98 127],796,5,40236,4.053596614950635,20.0,20.0
19926,1,9926,[427 588  79  98 127],796,5,40241,4.053691951244081,20.0,20.0
19927,1,9927,[153 194 180 121 168],716,4,40245,4.053686543110395,0.0,0.0
19928,1,9928,[175  11 603 182 357],269,4,40249,4.053681136066069,20.0,0.0
19929,1,9929,[ 95 471 111 405   7],786,5,40254,4.053776435045317,0.0,0.0
19930,1,9930,[265 125 275 161 196],655,1,40255,4.053468935656027,0.0,20.0
19931,1,9931,[ 22 121  64 153 238],655,1,40256,4.053161498187676,20.0,0.0
19932,1,9932,[191 228   7 175  69],344,4,40260,4.053156146179402,0.0,0.0
19933,1,9933,[ 95 678 322 127  88],280,3,40263,4.0530501308637,0.0,20.0
19934,1,9934,[427 588  79  98 127],450,5,40268,4.053145445395068,20.0,20.0
19935,1,9935,[427 588  79  98 127],389,5,40273,4.0532407407407405,20.0,20.0
19936,1,9936,[427 588  79  98 127],18,5,40278,4.053336016906511,20.0,20.0
19937,1,9937,[427 588  79  98 127],18,5,40283,4.053431273898169,20.0,20.0
19938,1,9938,[127 271 257 216 483],655,3,40286,4.053325284233827,0.0,20.0
19939,1,9939,[ 56 144 328  50  71],796,5,40291,4.053420523138833,0.0,20.0
19940,1,9940,[427 588  79  98 127],450,5,40296,4.05351574288301,20.0,20.0
19941,1,9941,[655 181 182  82 678],280,0,40296,4.053108026554013,0.0,0.0
19942,1,9942,[427 588  79  98 127],18,5,40301,4.053203258573871,20.0,20.0
19943,1,9943,[427 588  79  98 127],796,5,40306,4.053298471440065,20.0,20.0
19944,1,9944,[ 88 597 168 288 196],457,4,40310,4.053293112116641,0.0,0.0
19945,1,9945,[111 222  69 151 258],344,3,40313,4.053187210939071,0.0,0.0
19946,1,9946,[ 70 258 132 143 237],504,3,40316,4.05308133105459,0.0,0.0
19947,1,9947,[  9   1 237  95 197],280,3,40319,4.052975472456775,0.0,0.0
19948,1,9948,[427 588  79  98 127],716,5,40324,4.053070660367876,20.0,20.0
19949,1,9949,[  4 210 269 132 196],450,3,40327,4.052964824120603,0.0,0.0
19950,1,9950,[210 286  97 288 121],593,4,40331,4.052959501557632,0.0,20.0
19951,1,9951,[508 153 143 195 197],731,2,40333,4.052753215434084,0.0,0.0
19952,1,9952,[423 603 496 185 211],151,5,40338,4.0528483874208785,40.0,0.0
19953,1,9953,[427 588  79  98 127],18,5,40343,4.0529435402853125,20.0,20.0
19954,1,9954,[427 588  79  98 127],450,5,40348,4.053038674033149,20.0,20.0
19955,1,9955,[427 588  79  98 127],716,5,40353,4.053133788670149,20.0,20.0
19956,1,9956,[427 588  79  98 127],18,5,40358,4.053228884202069,20.0,20.0
19957,1,9957,[111 215 496   7 323],280,3,40361,4.053123117091785,20.0,0.0
19958,1,9958,[195 597 117 328 748],796,5,40366,4.053218194597851,0.0,0.0
19959,1,9959,[ 98 186 195  15 127],450,3,40369,4.053112449799197,0.0,20.0
19960,1,9960,[742 151   4 168  70],450,4,40373,4.053107117759261,0.0,0.0
19961,1,9961,[135  79 210 237 183],450,3,40376,4.053001405340293,0.0,0.0
19962,1,9962,[588 202 235 195 215],450,4,40380,4.052996085516411,0.0,0.0
19963,1,9963,[427 588  79  98 127],796,5,40385,4.05309112806102,20.0,20.0
19964,1,9964,[ 64 183 172 597 194],450,5,40390,4.053186151530356,20.0,0.0
19965,1,9965,[ 95 546 234 210 678],807,3,40393,4.053080473610275,0.0,0.0
19966,1,9966,[427 237  22  95 385],577,5,40398,4.053175479080967,20.0,0.0
19967,1,9967,[235  79 508 181 742],280,3,40401,4.053069823434992,0.0,0.0
19968,1,9968,[427 588  79  98 127],450,5,40406,4.053164810913833,20.0,20.0
19969,1,9969,[238  25 195 427 194],450,4,40410,4.0531594784353056,20.0,0.0
19970,1,9970,[183 483 357 301 172],151,4,40414,4.053154147026376,0.0,0.0
19971,1,9971,[186 210 176 172 180],269,0,40414,4.052747693541917,0.0,0.0
19972,1,9972,[151 135 121 546 597],457,3,40417,4.052642133761156,0.0,0.0
19973,1,9973,[174 655  96 191 185],655,2,40419,4.052436334469621,0.0,0.0
19974,1,9974,[427 588  79  98 127],796,5,40424,4.052531328320802,20.0,20.0
19975,1,9975,[ 88 234 423 301  89],151,5,40429,4.052626303127506,0.0,0.0
19976,1,9976,[427 588  79  98 127],450,5,40434,4.05272125889546,20.0,20.0
19977,1,9977,[273 202 333 289 196],655,1,40435,4.052415313690118,0.0,0.0
19978,1,9978,[  8 204 144 265 475],655,0,40435,4.052009219360658,0.0,0.0
19979,1,9979,[168 186   1  11  96],457,5,40440,4.052104208416834,0.0,0.0
19980,1,9980,[228 143 385 151   7],450,5,40445,4.052199178439034,0.0,0.0
19981,1,9981,[271  56   1  11 276],655,1,40446,4.051893408134642,0.0,0.0
19982,1,9982,[211 180  98  71 132],450,4,40450,4.0518882099569264,0.0,0.0
19983,1,9983,[427 588  79  98 127],450,5,40455,4.051983173076923,20.0,20.0
19984,1,9984,[289 333 301 118 568],655,0,40455,4.051577366049074,0.0,0.0
19985,1,9985,[ 12 176 121 588  11],344,3,40458,4.0514720608852395,0.0,0.0
19986,1,9986,[187  71 318 234  96],450,3,40461,4.051366776809853,20.0,0.0
19987,1,9987,[427 588  79  98 127],796,5,40466,4.051461754104926,20.0,20.0
19988,1,9988,[258  69 194   4 427],450,4,40470,4.051456602262489,20.0,0.0
19989,1,9989,[427 588  79  98 127],389,5,40475,4.051551551551552,20.0,20.0
19990,1,9990,[427 588  79  98 127],18,5,40480,4.05164648183365,20.0,20.0
19991,1,9991,[ 25 245 204  70   4],593,3,40483,4.051541232986389,0.0,0.0
19992,1,9992,[427 588  79  98 127],389,5,40488,4.051636145301711,20.0,20.0
19993,1,9993,[ 96  12 568 172 174],457,5,40493,4.051731038623174,0.0,0.0
19994,1,9994,[269 183 222 237 182],796,4,40497,4.051725862931466,0.0,0.0
19995,1,9995,[172 144 300 515 181],807,5,40502,4.051820728291316,0.0,0.0
19996,1,9996,[427 588  79  98 127],796,5,40507,4.051915574672401,20.0,20.0
19997,1,9997,[427 588  79  98 127],796,5,40512,4.052010402080416,20.0,20.0
19998,1,9998,[427 588  79  98 127],18,5,40517,4.052105210521052,20.0,20.0
19999,1,9999,[427 588  79  98 127],389,5,40522,4.0522,20.0,20.0
20000,2,0,[273 286 215  22 301],796,2,2,2.0,0.0,20.0
20001,2,1,[ 79 173 179 185 435],535,4,6,3.0,0.0,0.0
20002,2,2,[ 82 282 111 228 235],716,3,9,3.0,0.0,0.0
20003,2,3,[215 748 742 357 185],796,4,13,3.25,0.0,0.0
20004,2,4,[215 258 288  69   8],655,0,13,2.6,0.0,0.0
20005,2,5,[228 173 357 179  22],450,5,18,3.0,0.0,0.0
20006,2,6,[228 173 357 179  22],457,5,23,3.2857142857142856,0.0,0.0
20007,2,7,[265 271 172 258   9],655,1,24,3.0,0.0,0.0
20008,2,8,[265   1 237 182  50],450,5,29,3.2222222222222223,0.0,20.0
20009,2,9,[  1  50 182 173  82],796,3,32,3.2,0.0,20.0
20010,2,10,[216 194 427 405 742],11,2,34,3.090909090909091,20.0,0.0
20011,2,11,[173 185 228 435  50],5,4,38,3.1666666666666665,0.0,20.0
20012,2,12,[173 357 228 435  50],151,5,43,3.3076923076923075,0.0,20.0
20013,2,13,[ 70 204 168 294 238],450,5,48,3.4285714285714284,0.0,0.0
20014,2,14,[228 168 427 357 172],911,4,52,3.466666666666667,20.0,0.0
20015,2,15,[228 168 357 172 194],716,5,57,3.5625,0.0,0.0
20016,2,16,[405 121  50 194  28],796,4,61,3.588235294117647,0.0,20.0
20017,2,17,[228 168 357 172 194],716,5,66,3.6666666666666665,0.0,0.0
20018,2,18,[568 100  88 161  12],256,5,71,3.736842105263158,0.0,20.0
20019,2,19,[228 168 121 568  50],457,5,76,3.8,0.0,20.0
20020,2,20,[228 168 121 568  50],716,5,81,3.857142857142857,0.0,20.0
20021,2,21,[328 111 471 234 588],450,4,85,3.8636363636363638,0.0,0.0
20022,2,22,[197 135  28 185   1],389,4,89,3.869565217391304,0.0,0.0
20023,2,23,[111 161 471  12 568],577,3,92,3.8333333333333335,0.0,0.0
20024,2,24,[111 172  12 121  22],577,5,97,3.88,0.0,0.0
20025,2,25,[ 69 202 185 318 125],151,5,102,3.923076923076923,20.0,0.0
20026,2,26,[127 175 174 176 135],655,2,104,3.8518518518518516,0.0,20.0
20027,2,27,[127 197 161 294 228],796,3,107,3.8214285714285716,0.0,20.0
20028,2,28,[  7 117 357 172  11],296,4,111,3.8275862068965516,0.0,0.0
20029,2,29,[245 197 215 202 211],504,4,115,3.8333333333333335,0.0,0.0
20030,2,30,[127 111  50 228  12],655,2,117,3.774193548387097,0.0,40.0
20031,2,31,[127 168  50 161 435],716,4,121,3.78125,0.0,40.0
20032,2,32,[127 194  50 435 245],629,4,125,3.787878787878788,0.0,40.0
20033,2,33,[127 194 121  50 435],716,5,130,3.823529411764706,0.0,40.0
20034,2,34,[257 153 194 211  79],796,4,134,3.8285714285714287,0.0,0.0
20035,2,35,[179 276 234  25  11],593,2,136,3.7777777777777777,0.0,0.0
20036,2,36,[127 357  50 435 121],655,3,139,3.7567567567567566,0.0,40.0
20037,2,37,[204 235 144  22  96],807,3,142,3.736842105263158,0.0,0.0
20038,2,38,[127 357  50 204 182],18,4,146,3.7435897435897436,0.0,40.0
20039,2,39,[197   1 328 546  79],796,3,149,3.725,0.0,0.0
20040,2,40,[211 265 144 200 196],716,4,153,3.731707317073171,0.0,0.0
20041,2,41,[568 210  95 172 121],330,5,158,3.761904761904762,0.0,0.0
20042,2,42,[127 153 100  95  50],389,3,161,3.744186046511628,0.0,60.0
20043,2,43,[127 172 100  50   7],421,4,165,3.75,0.0,60.0
20044,2,44,[127 546 100  50 210],236,2,167,3.7111111111111112,0.0,60.0
20045,2,45,[127 257 196 318 748],401,2,169,3.6739130434782608,20.0,20.0
20046,2,46,[ 79 435  88  71  96],450,4,173,3.6808510638297873,0.0,0.0
20047,2,47,[  8 742 568  64 423],655,1,174,3.625,20.0,0.0
20048,2,48,[183 313 423 300 597],796,5,179,3.6530612244897958,0.0,0.0
20049,2,49,[211 328 546   9 258],151,3,182,3.64,0.0,0.0
20050,2,50,[318 183 168 182 173],796,5,187,3.6666666666666665,20.0,0.0
20051,2,51,[173  71 228 127  11],280,3,190,3.6538461538461537,0.0,20.0
20052,2,52,[301 183 174  50 111],593,5,195,3.6792452830188678,0.0,20.0
20053,2,53,[597  22 125 300 183],796,5,200,3.7037037037037037,0.0,0.0
20054,2,54,[176  71 423 111 151],577,5,205,3.727272727272727,0.0,0.0
20055,2,55,[ 79 273  56 423 210],655,2,207,3.6964285714285716,0.0,0.0
20056,2,56,[313 322 132 210 117],450,4,211,3.7017543859649122,0.0,0.0
20057,2,57,[216 196  69 125  25],151,5,216,3.7241379310344827,0.0,0.0
20058,2,58,[301  56 268 181 655],535,3,219,3.711864406779661,0.0,0.0
20059,2,59,[357 313 151  22 655],796,4,223,3.716666666666667,0.0,0.0
20060,2,60,[357 132 183  22 181],344,3,226,3.7049180327868854,0.0,0.0
20061,2,61,[182 151 183 172 168],269,3,229,3.693548387096774,0.0,0.0
20062,2,62,[275  88 187  97 588],786,5,234,3.7142857142857144,0.0,20.0
20063,2,63,[187 132 318 196 168],504,4,238,3.71875,20.0,0.0
20064,2,64,[125 151 318 168 196],151,5,243,3.7384615384615385,20.0,0.0
20065,2,65,[125 151 318 168 196],18,1,244,3.696969696969697,20.0,0.0
20066,2,66,[313 200 202 258 182],450,4,248,3.701492537313433,0.0,0.0
20067,2,67,[191 187 204   7 132],655,2,250,3.676470588235294,0.0,0.0
20068,2,68,[568 742 471 215 588],280,2,252,3.652173913043478,0.0,0.0
20069,2,69,[ 15 216 294 546 597],256,4,256,3.657142857142857,0.0,0.0
20070,2,70,[191 182 300  11  97],450,5,261,3.676056338028169,0.0,0.0
20071,2,71,[ 56 195 234 313 275],450,4,265,3.6805555555555554,0.0,20.0
20072,2,72,[181   9  96 180 257],504,4,269,3.684931506849315,0.0,0.0
20073,2,73,[151 179 568 588 100],577,3,272,3.675675675675676,0.0,20.0
20074,2,74,[195 318  64 300  11],716,4,276,3.68,40.0,0.0
20075,2,75,[204 483 153 196 435],716,5,281,3.6973684210526314,0.0,0.0
20076,2,76,[202  98  70 176 144],23,1,282,3.6623376623376624,0.0,0.0
20077,2,77,[357 318 194 300 483],151,5,287,3.6794871794871793,20.0,0.0
20078,2,78,[357 318 194 300 483],450,4,291,3.6835443037974684,20.0,0.0
20079,2,79,[ 69 603 678 125 748],401,1,292,3.65,20.0,0.0
20080,2,80,[313  11 191 300 182],655,3,295,3.6419753086419755,0.0,0.0
20081,2,81,[100 180  11 176 179],269,2,297,3.6219512195121952,0.0,20.0
20082,2,82,[182 655  82 174  50],655,2,299,3.602409638554217,0.0,20.0
20083,2,83,[423 273 210 300 117],796,3,302,3.5952380952380953,0.0,0.0
20084,2,84,[275 183 118 121 238],151,3,305,3.588235294117647,0.0,20.0
20085,2,85,[ 15 237 182 597 603],450,4,309,3.5930232558139537,20.0,0.0
20086,2,86,[ 97 238 357  64 191],457,5,314,3.6091954022988504,20.0,0.0
20087,2,87,[ 97 238 357  64 191],450,5,319,3.625,20.0,0.0
20088,2,88,[ 97 238 357  64 191],151,4,323,3.6292134831460676,20.0,0.0
20089,2,89,[275 496 174 153 258],796,5,328,3.6444444444444444,20.0,20.0
20090,2,90,[238 182 597 496 194],269,4,332,3.6483516483516483,20.0,0.0
20091,2,91,[ 64 603 275  97 313],450,5,337,3.6630434782608696,40.0,20.0
20092,2,92,[ 64 603 275  97 313],707,2,339,3.6451612903225805,40.0,20.0
20093,2,93,[194 275  97 318 588],457,5,344,3.6595744680851063,20.0,20.0
20094,2,94,[222  50  15 173  12],450,3,347,3.6526315789473682,0.0,20.0
20095,2,95,[200 282  70 568  56],655,1,348,3.625,0.0,0.0
20096,2,96,[245 151  12  64 173],344,4,352,3.6288659793814433,20.0,0.0
20097,2,97,[357 496 275 318  97],786,5,357,3.642857142857143,40.0,20.0
20098,2,98,[275 496 127 121 322],344,3,360,3.6363636363636362,20.0,40.0
20099,2,99,[357 194 275 318  97],18,4,364,3.64,20.0,20.0
20100,2,100,[357 496 275 318  97],450,5,369,3.6534653465346536,40.0,20.0
20101,2,101,[742 496 385 117 135],450,4,373,3.656862745098039,20.0,0.0
20102,2,102,[496 275 318  97 385],716,4,377,3.6601941747572817,40.0,20.0
20103,2,103,[182 275 318  97 237],593,3,380,3.6538461538461537,20.0,20.0
20104,2,104,[423 173 210   8  56],593,3,383,3.6476190476190475,0.0,0.0
20105,2,105,[318 496  97 357  98],786,5,388,3.660377358490566,40.0,0.0
20106,2,106,[121  98 435 475 237],655,1,389,3.635514018691589,0.0,0.0
20107,2,107,[318 238  97 357  98],151,5,394,3.6481481481481484,20.0,0.0
20108,2,108,[318 238  97 357  98],655,3,397,3.6422018348623855,20.0,0.0
20109,2,109,[143 176 100 172  64],450,5,402,3.6545454545454548,20.0,20.0
20110,2,110,[318  98 143  88 588],796,5,407,3.6666666666666665,20.0,0.0
20111,2,111,[318  98 143  88 588],716,5,412,3.6785714285714284,20.0,0.0
20112,2,112,[269  88  89  69 195],655,1,413,3.6548672566371683,0.0,0.0
20113,2,113,[ 98  89 318 143 357],562,2,415,3.6403508771929824,20.0,0.0
20114,2,114,[143 588  98 496 357],796,5,420,3.652173913043478,20.0,0.0
20115,2,115,[211 427 111  89  50],151,5,425,3.663793103448276,20.0,20.0
20116,2,116,[ 98 588 143 496 357],20,2,427,3.6495726495726495,20.0,0.0
20117,2,117,[588 496 318  50  97],450,5,432,3.6610169491525424,40.0,20.0
20118,2,118,[144  22  25 174  69],457,5,437,3.672268907563025,0.0,0.0
20119,2,119,[588 496 318  50  97],18,5,442,3.683333333333333,40.0,20.0
20120,2,120,[ 25 200 423 234   1],5,2,444,3.669421487603306,0.0,0.0
20121,2,121,[588 496 318  50  97],577,5,449,3.680327868852459,40.0,20.0
20122,2,122,[ 79 135 294 197 144],655,2,451,3.6666666666666665,0.0,0.0
20123,2,123,[588 496 318  50  97],18,5,456,3.6774193548387095,40.0,20.0
20124,2,124,[588 496 318  50  97],786,5,461,3.688,40.0,20.0
20125,2,125,[588 496 318  50  97],796,4,465,3.6904761904761907,40.0,20.0
20126,2,126,[111 405 496  11 588],716,5,470,3.7007874015748032,20.0,0.0
20127,2,127,[588 496 318  50 127],807,4,474,3.703125,40.0,40.0
20128,2,128,[588 496 318  50 275],18,5,479,3.7131782945736433,40.0,40.0
20129,2,129,[588 496 318  50 275],878,4,483,3.7153846153846155,40.0,40.0
20130,2,130,[269 435 161 742 427],655,1,484,3.6946564885496183,20.0,0.0
20131,2,131,[210 357 496  71 204],18,4,488,3.696969696969697,20.0,0.0
20132,2,132,[403 176 151 111 194],450,5,493,3.706766917293233,0.0,0.0
20133,2,133,[183 235 172 435 194],450,4,497,3.708955223880597,0.0,0.0
20134,2,134,[496 403 318  50 588],577,5,502,3.7185185185185183,40.0,20.0
20135,2,135,[ 15 678 568  96   9],256,5,507,3.7279411764705883,0.0,0.0
20136,2,136,[202 245 568  28  96],796,3,510,3.7226277372262775,0.0,0.0
20137,2,137,[216 546  98  82 678],256,5,515,3.7318840579710146,0.0,0.0
20138,2,138,[475 423  28 202 185],389,5,520,3.741007194244604,0.0,0.0
20139,2,139,[ 96  28 194  50 216],23,4,524,3.742857142857143,0.0,20.0
20140,2,140,[125  95 202 234 546],577,3,527,3.7375886524822697,0.0,0.0
20141,2,141,[357 121 180 100 176],72,3,530,3.732394366197183,0.0,20.0
20142,2,142,[403 496 318  50 588],577,5,535,3.7412587412587412,40.0,20.0
20143,2,143,[238 191 185 546 100],23,3,538,3.736111111111111,0.0,20.0
20144,2,144,[403 496 318  50 588],330,5,543,3.7448275862068967,40.0,20.0
20145,2,145,[403 496 318  50 588],18,4,547,3.7465753424657535,40.0,20.0
20146,2,146,[496 318  50 588 275],450,5,552,3.7551020408163267,40.0,40.0
20147,2,147,[496 318  50 588 275],716,5,557,3.7635135135135136,40.0,40.0
20148,2,148,[496 318  50 588 275],878,4,561,3.7651006711409396,40.0,40.0
20149,2,149,[496 318  50 275 194],535,5,566,3.7733333333333334,40.0,40.0
20150,2,150,[496 318  50 275 194],151,5,571,3.781456953642384,40.0,40.0
20151,2,151,[496 318  50 275 194],236,1,572,3.763157894736842,40.0,40.0
20152,2,152,[318 496  50 357 588],450,5,577,3.7712418300653594,40.0,20.0
20153,2,153,[258 210 405  28 182],796,3,580,3.7662337662337664,0.0,0.0
20154,2,154,[168   8 496 202 423],577,5,585,3.774193548387097,20.0,0.0
20155,2,155,[  7  88 234  95 191],450,3,588,3.769230769230769,0.0,0.0
20156,2,156,[ 64  69 215 282 183],693,2,590,3.7579617834394905,20.0,0.0
20157,2,157,[318 496  50 357 588],18,5,595,3.7658227848101267,40.0,20.0
20158,2,158,[318 496  50 357 588],786,5,600,3.7735849056603774,40.0,20.0
20159,2,159,[ 50 234 202 294 187],716,4,604,3.775,0.0,20.0
20160,2,160,[318 496  50 357 588],786,5,609,3.782608695652174,40.0,20.0
20161,2,161,[211 176  97  70 118],504,2,611,3.771604938271605,0.0,0.0
20162,2,162,[748 111 180 294 179],450,5,616,3.7791411042944785,0.0,0.0
20163,2,163,[318 496  50 357 588],450,5,621,3.7865853658536586,40.0,20.0
20164,2,164,[258 181 328 427 568],450,5,626,3.793939393939394,20.0,0.0
20165,2,165,[318 496  50 357 588],330,5,631,3.8012048192771086,40.0,20.0
20166,2,166,[215 238  15 176 237],796,4,635,3.802395209580838,0.0,0.0
20167,2,167,[318 496  50 357 588],18,5,640,3.8095238095238093,40.0,20.0
20168,2,168,[ 69 603 276  22 151],269,3,643,3.804733727810651,20.0,0.0
20169,2,169,[318 228 180 588 197],716,4,647,3.8058823529411763,20.0,0.0
20170,2,170,[318 496  50 357 588],450,5,652,3.8128654970760234,40.0,20.0
20171,2,171,[191  50 328 216 127],401,3,655,3.808139534883721,0.0,40.0
20172,2,172,[318 496 357 588  50],330,5,660,3.815028901734104,40.0,20.0
20173,2,173,[318 496 357 588  50],796,5,665,3.82183908045977,40.0,20.0
20174,2,174,[161 603 405  96   1],655,1,666,3.8057142857142856,20.0,0.0
20175,2,175,[318 496 357 588  50],18,5,671,3.8125,40.0,20.0
20176,2,176,[318 496 357 588  50],716,5,676,3.8192090395480225,40.0,20.0
20177,2,177,[496 405   4 194  98],151,4,680,3.8202247191011236,20.0,0.0
20178,2,178,[  4 318 496 357 588],18,4,684,3.82122905027933,40.0,0.0
20179,2,179,[117 483 100  50 333],236,1,685,3.8055555555555554,0.0,40.0
20180,2,180,[234 135  50 423 483],18,3,688,3.8011049723756907,0.0,20.0
20181,2,181,[318 496 357 588  50],18,5,693,3.8076923076923075,40.0,20.0
20182,2,182,[318 496 357 588  50],330,5,698,3.814207650273224,40.0,20.0
20183,2,183,[200 179 195 175  88],457,5,703,3.8206521739130435,0.0,0.0
20184,2,184,[328 204 245  64 234],629,3,706,3.8162162162162163,20.0,0.0
20185,2,185,[228 182 269  64 546],450,5,711,3.8225806451612905,20.0,0.0
20186,2,186,[318 496 357 588  50],716,5,716,3.828877005347594,40.0,20.0
20187,2,187,[ 15 423 204 238 385],655,0,716,3.8085106382978724,0.0,0.0
20188,2,188,[318 496 357 588  50],450,5,721,3.814814814814815,40.0,20.0
20189,2,189,[318 496 357 588  50],18,5,726,3.8210526315789473,40.0,20.0
20190,2,190,[318 496 357 588  50],330,5,731,3.8272251308900525,40.0,20.0
20191,2,191,[222 427 245 403 275],796,4,735,3.828125,20.0,20.0
20192,2,192,[276 200  82 196 174],18,2,737,3.8186528497409324,0.0,0.0
20193,2,193,[318 496 357 588  50],450,5,742,3.8247422680412373,40.0,20.0
20194,2,194,[318 496 357 588  50],786,5,747,3.830769230769231,40.0,20.0
20195,2,195,[318 496 357 588  50],18,5,752,3.836734693877551,40.0,20.0
20196,2,196,[318 496 357 588  50],796,5,757,3.8426395939086295,40.0,20.0
20197,2,197,[385 258 143 405 286],151,3,760,3.8383838383838382,0.0,20.0
20198,2,198,[318 496 357 588  50],796,5,765,3.8442211055276383,40.0,20.0
20199,2,199,[228   1  96  88 742],796,3,768,3.84,0.0,0.0
20200,2,200,[496 174 282 275 202],796,5,773,3.845771144278607,20.0,20.0
20201,2,201,[ 71 286  82 215   4],280,2,775,3.8366336633663365,0.0,20.0
20202,2,202,[202   1 173 211 185],450,5,780,3.8423645320197046,0.0,0.0
20203,2,203,[  7   4 181 215 135],280,2,782,3.8333333333333335,0.0,0.0
20204,2,204,[318 496 357 588  50],450,5,787,3.8390243902439023,40.0,20.0
20205,2,205,[181 427 265 483 153],450,4,791,3.8398058252427183,20.0,0.0
20206,2,206,[234 195  64 172 197],693,1,792,3.8260869565217392,20.0,0.0
20207,2,207,[318 496 357 588  50],450,5,797,3.831730769230769,40.0,20.0
20208,2,208,[318 496 357 588  50],18,5,802,3.8373205741626792,40.0,20.0
20209,2,209,[ 15  98  56  25 176],577,3,805,3.8333333333333335,0.0,0.0
20210,2,210,[318 496 357 588  50],18,5,810,3.838862559241706,40.0,20.0
20211,2,211,[318 496 357 588  50],786,5,815,3.8443396226415096,40.0,20.0
20212,2,212,[318 496 357 588  50],786,5,820,3.8497652582159625,40.0,20.0
20213,2,213,[257 121 603 318 191],655,3,823,3.8457943925233646,40.0,0.0
20214,2,214,[216 234 318 300 237],450,4,827,3.8465116279069766,20.0,0.0
20215,2,215,[127 211 100 475 179],269,5,832,3.8518518518518516,0.0,40.0
20216,2,216,[125 275 216 333 204],655,2,834,3.8433179723502304,0.0,20.0
20217,2,217,[228 597 216 174  79],457,4,838,3.8440366972477062,0.0,0.0
20218,2,218,[318 496 357 588  50],796,5,843,3.8493150684931505,40.0,20.0
20219,2,219,[328 210  15 403 176],655,0,843,3.831818181818182,0.0,0.0
20220,2,220,[385   8  95 180 161],280,5,848,3.83710407239819,0.0,0.0
20221,2,221,[318 496 357 588  50],716,5,853,3.8423423423423424,40.0,20.0
20222,2,222,[173  70 258 282  25],457,5,858,3.8475336322869955,0.0,0.0
20223,2,223,[132  79 742 183 195],693,3,861,3.84375,0.0,0.0
20224,2,224,[ 96 210   4 144  88],457,5,866,3.848888888888889,0.0,0.0
20225,2,225,[234  25 187 118 655],716,3,869,3.8451327433628317,0.0,0.0
20226,2,226,[318 496 357 588  50],716,5,874,3.850220264317181,40.0,20.0
20227,2,227,[318 496 357 588  50],796,5,879,3.8552631578947367,40.0,20.0
20228,2,228,[216 237 603 135 168],401,2,881,3.8471615720524017,20.0,0.0
20229,2,229,[318 496 357 588  50],716,5,886,3.8521739130434782,40.0,20.0
20230,2,230,[ 95 202 276  69 111],786,4,890,3.8528138528138527,0.0,0.0
20231,2,231,[318 496 357 588  50],716,5,895,3.8577586206896552,40.0,20.0
20232,2,232,[318 496 357 588  50],786,5,900,3.8626609442060085,40.0,20.0
20233,2,233,[185 301 175 328   7],655,1,901,3.8504273504273505,0.0,0.0
20234,2,234,[127  98 202 405 300],716,5,906,3.8553191489361702,0.0,20.0
20235,2,235,[318 496 357 588  50],716,5,911,3.860169491525424,40.0,20.0
20236,2,236,[496   1 678  88 176],344,2,913,3.852320675105485,20.0,0.0
20237,2,237,[318 496 357 588  50],18,5,918,3.857142857142857,40.0,20.0
20238,2,238,[228 161 318 568 357],457,5,923,3.8619246861924688,20.0,0.0
20239,2,239,[273   1 322 328 742],730,1,924,3.85,0.0,0.0
20240,2,240,[318 496 357 588  50],796,5,929,3.854771784232365,40.0,20.0
20241,2,241,[318 496 357 588  50],786,5,934,3.8595041322314048,40.0,20.0
20242,2,242,[483 215 117  50  97],655,2,936,3.8518518518518516,0.0,20.0
20243,2,243,[210  98 289  97 196],655,1,937,3.8401639344262297,0.0,0.0
20244,2,244,[318 496 357 588  50],450,5,942,3.8448979591836734,40.0,20.0
20245,2,245,[318 496 357 588  50],716,5,947,3.8495934959349594,40.0,20.0
20246,2,246,[187 216  82 161 100],796,3,950,3.8461538461538463,0.0,20.0
20247,2,247,[318 496 357 588  50],786,5,955,3.850806451612903,40.0,20.0
20248,2,248,[318 496 357 588  50],796,5,960,3.855421686746988,40.0,20.0
20249,2,249,[496  50   7 234  56],577,2,962,3.848,20.0,20.0
20250,2,250,[318 496 357 588  50],450,5,967,3.852589641434263,40.0,20.0
20251,2,251,[276 228 144 118 100],655,1,968,3.8412698412698414,0.0,20.0
20252,2,252,[318 496 357 588  50],716,5,973,3.8458498023715415,40.0,20.0
20253,2,253,[427 168 496 265 204],807,5,978,3.8503937007874014,40.0,0.0
20254,2,254,[318 496 357 588  50],716,5,983,3.854901960784314,40.0,20.0
20255,2,255,[318 496 357 588  50],330,5,988,3.859375,40.0,20.0
20256,2,256,[196 204 173  11  88],577,3,991,3.8560311284046693,0.0,0.0
20257,2,257,[275 301  97 127 228],344,4,995,3.856589147286822,0.0,40.0
20258,2,258,[318 496 357 588  50],18,5,1000,3.861003861003861,40.0,20.0
20259,2,259,[318 496 357 588  50],450,5,1005,3.8653846153846154,40.0,20.0
20260,2,260,[ 96 405  97 195 182],256,5,1010,3.8697318007662833,0.0,0.0
20261,2,261,[143   7  69 161 187],693,2,1012,3.8625954198473282,0.0,0.0
20262,2,262,[318 496 357 588  50],796,5,1017,3.8669201520912546,40.0,20.0
20263,2,263,[318 496 357 588  50],450,5,1022,3.871212121212121,40.0,20.0
20264,2,264,[318 496 357 588  50],796,5,1027,3.8754716981132074,40.0,20.0
20265,2,265,[  7   4 302  95 180],450,3,1030,3.8721804511278197,0.0,0.0
20266,2,266,[173 121 385 546 403],577,4,1034,3.8726591760299627,0.0,0.0
20267,2,267,[237 265 111 125 385],450,5,1039,3.876865671641791,0.0,0.0
20268,2,268,[313 174 185 228 127],796,5,1044,3.8810408921933086,0.0,20.0
20269,2,269,[ 12   8 197 210 269],18,5,1049,3.8851851851851853,0.0,0.0
20270,2,270,[302 318 496 357 588],450,5,1054,3.88929889298893,40.0,0.0
20271,2,271,[282 273 483 202   1],401,2,1056,3.8823529411764706,0.0,0.0
20272,2,272,[172 313 496 423  56],796,5,1061,3.8864468864468864,20.0,0.0
20273,2,273,[173 215 597 385  79],796,5,1066,3.8905109489051095,0.0,0.0
20274,2,274,[ 97 403 118 117 568],256,5,1071,3.8945454545454545,0.0,0.0
20275,2,275,[748 175 197 603 174],151,4,1075,3.8949275362318843,20.0,0.0
20276,2,276,[ 70 322 183 121   8],593,3,1078,3.891696750902527,0.0,0.0
20277,2,277,[302 318 496 357 588],450,5,1083,3.8956834532374103,40.0,0.0
20278,2,278,[210 125 403 427 515],655,2,1085,3.888888888888889,20.0,0.0
20279,2,279,[301  79  96 597  82],450,4,1089,3.8892857142857142,0.0,0.0
20280,2,280,[302 515 318 496 357],535,2,1091,3.882562277580071,40.0,0.0
20281,2,281,[748 202 195  95 471],280,1,1092,3.872340425531915,0.0,0.0
20282,2,282,[427 515 237  15 135],72,4,1096,3.872791519434629,20.0,0.0
20283,2,283,[318 496 588 357  50],450,5,1101,3.8767605633802815,40.0,20.0
20284,2,284,[215 265 175 568 427],655,1,1102,3.8666666666666667,20.0,0.0
20285,2,285,[318 496 588 357  50],796,5,1107,3.870629370629371,40.0,20.0
20286,2,286,[181 211 195 742 546],504,4,1111,3.8710801393728222,0.0,0.0
20287,2,287,[318 496 588 357  50],330,5,1116,3.875,40.0,20.0
20288,2,288,[ 79 143 294 185 182],655,4,1120,3.875432525951557,0.0,0.0
20289,2,289,[210 475 191 288  69],629,4,1124,3.8758620689655174,0.0,0.0
20290,2,290,[174 597   9  15 215],796,4,1128,3.8762886597938144,0.0,0.0
20291,2,291,[197 172 111   4 135],655,2,1130,3.8698630136986303,0.0,0.0
20292,2,292,[168 111 121  69 172],796,5,1135,3.8737201365187715,0.0,0.0
20293,2,293,[ 69 195 258  88 180],796,4,1139,3.8741496598639458,0.0,0.0
20294,2,294,[172 238  98 204   4],716,4,1143,3.8745762711864407,0.0,0.0
20295,2,295,[318 496 588 357  50],786,5,1148,3.8783783783783785,40.0,20.0
20296,2,296,[301 286 357 322 603],450,5,1153,3.8821548821548824,20.0,20.0
20297,2,297,[318 496 588 357  50],786,5,1158,3.8859060402684564,40.0,20.0
20298,2,298,[282 194 237  97 100],796,3,1161,3.882943143812709,0.0,20.0
20299,2,299,[318 496 588 357  50],450,5,1166,3.8866666666666667,40.0,20.0
20300,2,300,[318 496 588 357  50],330,5,1171,3.8903654485049834,40.0,20.0
20301,2,301,[655 143 234 121 174],786,3,1174,3.8874172185430464,0.0,0.0
20302,2,302,[318 496 588 357  50],18,5,1179,3.891089108910891,40.0,20.0
20303,2,303,[318 496 588 357  50],786,5,1184,3.8947368421052633,40.0,20.0
20304,2,304,[318 496 588 357  50],796,5,1189,3.898360655737705,40.0,20.0
20305,2,305,[257 121 427 187 238],296,5,1194,3.9019607843137254,20.0,0.0
20306,2,306,[265 322 168 385 187],450,5,1199,3.9055374592833876,0.0,0.0
20307,2,307,[318 496 588 357  50],716,5,1204,3.909090909090909,40.0,20.0
20308,2,308,[269 258 186  89  82],655,1,1205,3.899676375404531,0.0,0.0
20309,2,309,[318 496 588 357  50],450,5,1210,3.903225806451613,40.0,20.0
20310,2,310,[318 496 588 357  50],450,5,1215,3.9067524115755625,40.0,20.0
20311,2,311,[  7 508 151 202  69],344,4,1219,3.907051282051282,0.0,0.0
20312,2,312,[183 483 385 204 286],151,3,1222,3.9041533546325877,0.0,20.0
20313,2,313,[385  56 174 258 655],23,4,1226,3.9044585987261144,0.0,0.0
20314,2,314,[ 71 117 275 322 153],401,1,1227,3.895238095238095,0.0,20.0
20315,2,315,[258 174 471 191 200],450,4,1231,3.8955696202531644,0.0,0.0
20316,2,316,[125  56 183 151 269],450,5,1236,3.8990536277602525,0.0,0.0
20317,2,317,[144 245 111 185 125],796,4,1240,3.89937106918239,0.0,0.0
20318,2,318,[194 151 238 200 294],707,3,1243,3.896551724137931,0.0,0.0
20319,2,319,[ 56 197  70 405 234],72,4,1247,3.896875,0.0,0.0
20320,2,320,[ 89 215  64 202 132],344,4,1251,3.897196261682243,20.0,0.0
20321,2,321,[ 50 176 121 228   9],655,1,1252,3.888198757763975,0.0,20.0
20322,2,322,[546 427 333  95  12],796,5,1257,3.891640866873065,20.0,0.0
20323,2,323,[ 28  98 742 151 173],796,3,1260,3.888888888888889,0.0,0.0
20324,2,324,[ 56 180   7 194   9],292,4,1264,3.8892307692307693,0.0,0.0
20325,2,325,[185 117 186 200 273],450,2,1266,3.8834355828220857,0.0,0.0
20326,2,326,[403 748 215 135 597],450,4,1270,3.8837920489296636,0.0,0.0
20327,2,327,[173 568 237 275 655],716,5,1275,3.8871951219512195,0.0,20.0
20328,2,328,[ 28 423 172  98 204],577,5,1280,3.8905775075987843,0.0,0.0
20329,2,329,[222  56 265  50 216],236,3,1283,3.8878787878787877,0.0,20.0
20330,2,330,[ 88 176 121  70  97],716,4,1287,3.88821752265861,0.0,0.0
20331,2,331,[ 69  22  25 655  70],450,4,1291,3.88855421686747,0.0,0.0
20332,2,332,[195 483 181 144 173],457,5,1296,3.891891891891892,0.0,0.0
20333,2,333,[117 143 742 197  89],450,5,1301,3.895209580838323,0.0,0.0
20334,2,334,[333 215 210 117 186],693,2,1303,3.8895522388059702,0.0,0.0
20335,2,335,[173 161 322 385 196],593,4,1307,3.8898809523809526,0.0,0.0
20336,2,336,[175 191 127 427 286],878,4,1311,3.8902077151335313,20.0,40.0
20337,2,337,[ 97 273 175 132 258],344,3,1314,3.8875739644970415,0.0,0.0
20338,2,338,[153 603 197 597 328],796,4,1318,3.887905604719764,20.0,0.0
20339,2,339,[275  56 135 245 265],450,4,1322,3.888235294117647,0.0,20.0
20340,2,340,[222  98 301 186 132],151,5,1327,3.8914956011730206,0.0,0.0
20341,2,341,[276 257  50 238 117],504,2,1329,3.8859649122807016,0.0,20.0
20342,2,342,[258 195 423 132 294],504,4,1333,3.8862973760932946,0.0,0.0
20343,2,343,[427 597   1 546 286],450,5,1338,3.88953488372093,20.0,20.0
20344,2,344,[273 132 215 301 435],655,1,1339,3.881159420289855,0.0,0.0
20345,2,345,[471 196 228 179 496],577,2,1341,3.8757225433526012,20.0,0.0
20346,2,346,[ 50 257 194 153 211],23,4,1345,3.876080691642651,0.0,20.0
20347,2,347,[185 100  22  15  98],269,3,1348,3.8735632183908044,0.0,20.0
20348,2,348,[ 82 435 174  98  88],151,4,1352,3.8739255014326646,0.0,0.0
20349,2,349,[318 191 196 195 496],236,2,1354,3.8685714285714288,40.0,0.0
20350,2,350,[ 88 237 186  11 286],655,0,1354,3.8575498575498575,0.0,20.0
20351,2,351,[ 64  69  12 180  71],18,4,1358,3.8579545454545454,20.0,0.0
20352,2,352,[111 151 318 196  98],18,2,1360,3.8526912181303117,20.0,0.0
20353,2,353,[121 176 196 100 182],269,2,1362,3.847457627118644,0.0,20.0
20354,2,354,[195   1 323 143 228],796,3,1365,3.8450704225352115,0.0,0.0
20355,2,355,[200  50 234 195 655],796,3,1368,3.842696629213483,0.0,20.0
20356,2,356,[423  88  25 174  70],151,5,1373,3.84593837535014,0.0,0.0
20357,2,357,[597 237 125 288 187],450,4,1377,3.846368715083799,0.0,0.0
20358,2,358,[194 176 117 237  89],72,2,1379,3.8412256267409473,0.0,0.0
20359,2,359,[228 111 197  88 210],280,1,1380,3.8333333333333335,0.0,0.0
20360,2,360,[132 302 603  70 403],450,5,1385,3.8365650969529086,20.0,0.0
20361,2,361,[172 328 191 427 204],450,5,1390,3.839779005524862,20.0,0.0
20362,2,362,[100 275  79 405   7],23,5,1395,3.84297520661157,0.0,40.0
20363,2,363,[273  56 161 127  28],655,2,1397,3.837912087912088,0.0,20.0
20364,2,364,[471  28 191 204 588],450,5,1402,3.841095890410959,0.0,0.0
20365,2,365,[127 742  89 174 176],457,5,1407,3.8442622950819674,0.0,20.0
20366,2,366,[ 98 100 282 117 222],450,4,1411,3.844686648501362,0.0,20.0
20367,2,367,[197  50 180 546 117],457,4,1415,3.845108695652174,0.0,20.0
20368,2,368,[ 97 302 135 568  96],450,4,1419,3.845528455284553,0.0,0.0
20369,2,369,[238 273 144 125 265],796,3,1422,3.843243243243243,0.0,0.0
20370,2,370,[427   9 185 195 186],796,3,1425,3.8409703504043127,20.0,0.0
20371,2,371,[300 568  15 151   1],796,4,1429,3.8413978494623655,0.0,0.0
20372,2,372,[173 181 313  89 245],344,2,1431,3.836461126005362,0.0,0.0
20373,2,373,[ 15 282 117   4  97],796,4,1435,3.836898395721925,0.0,0.0
20374,2,374,[ 50 357 144 200 127],457,5,1440,3.84,0.0,40.0
20375,2,375,[597  79  88 222 588],796,5,1445,3.8430851063829787,0.0,0.0
20376,2,376,[172  79 245 286 111],796,3,1448,3.8408488063660475,0.0,20.0
20377,2,377,[427   7 546  89 174],151,4,1452,3.8412698412698414,20.0,0.0
20378,2,378,[187 111 496  50  95],796,5,1457,3.8443271767810026,20.0,20.0
20379,2,379,[427 125   1 191 151],796,4,1461,3.844736842105263,20.0,0.0
20380,2,380,[234  71  28 322 403],504,3,1464,3.84251968503937,0.0,0.0
20381,2,381,[197 742 135  95  98],450,3,1467,3.8403141361256545,0.0,0.0
20382,2,382,[181 234 100 161 151],457,5,1472,3.843342036553525,0.0,20.0
20383,2,383,[  1 196 135 194 655],457,5,1477,3.8463541666666665,0.0,0.0
20384,2,384,[  4  69 282  50 153],504,3,1480,3.844155844155844,0.0,20.0
20385,2,385,[403 195 202 496 234],269,1,1481,3.8367875647668392,20.0,0.0
20386,2,386,[215 172 483  12 121],693,2,1483,3.8320413436692506,0.0,0.0
20387,2,387,[211  82 197 183 508],269,3,1486,3.829896907216495,0.0,0.0
20388,2,388,[183 273 483 111 161],450,3,1489,3.827763496143959,0.0,0.0
20389,2,389,[357   7 161 742 194],450,5,1494,3.830769230769231,0.0,0.0
20390,2,390,[117 210 288 313 175],655,1,1495,3.823529411764706,0.0,0.0
20391,2,391,[196 125 286 265  88],655,0,1495,3.813775510204082,0.0,20.0
20392,2,392,[161 483 269 323  95],796,3,1498,3.811704834605598,0.0,0.0
20393,2,393,[174   8  15 183 172],577,4,1502,3.8121827411167515,0.0,0.0
20394,2,394,[294 655 322 176 161],796,2,1504,3.8075949367088606,0.0,0.0
20395,2,395,[211 435 328  64 302],450,5,1509,3.8106060606060606,20.0,0.0
20396,2,396,[258 300 427 117 186],655,1,1510,3.8035264483627205,20.0,0.0
20397,2,397,[210 294  95 194 215],450,3,1513,3.801507537688442,0.0,0.0
20398,2,398,[ 70 222   4 300 183],450,3,1516,3.799498746867168,0.0,0.0
20399,2,399,[182 135 435  70 357],655,3,1519,3.7975,0.0,0.0
20400,2,400,[483 258  12 186  89],151,5,1524,3.800498753117207,0.0,0.0
20401,2,401,[196 211  11 202 237],450,5,1529,3.8034825870646767,0.0,0.0
20402,2,402,[742  82   8 228 144],457,5,1534,3.806451612903226,0.0,0.0
20403,2,403,[210  82  88 151 289],756,3,1537,3.8044554455445545,0.0,0.0
20404,2,404,[ 11  64 273 191 200],655,4,1541,3.8049382716049385,20.0,0.0
20405,2,405,[197 179 210 185  22],269,3,1544,3.8029556650246303,0.0,0.0
20406,2,406,[173  97 204 222 318],450,4,1548,3.8034398034398036,20.0,0.0
20407,2,407,[ 98 180 318 151  25],18,3,1551,3.801470588235294,20.0,0.0
20408,2,408,[ 82 151 385 197 216],151,3,1554,3.7995110024449876,0.0,0.0
20409,2,409,[ 70 168 111 234  12],151,5,1559,3.8024390243902437,0.0,0.0
20410,2,410,[ 88 174 204 172 222],655,1,1560,3.795620437956204,0.0,0.0
20411,2,411,[200  22 603 202 174],655,2,1562,3.79126213592233,20.0,0.0
20412,2,412,[182 597   9  12 357],457,4,1566,3.791767554479419,0.0,0.0
20413,2,413,[175 328 172  97 196],151,4,1570,3.792270531400966,0.0,0.0
20414,2,414,[237 357  97 204 405],11,3,1573,3.7903614457831325,0.0,0.0
20415,2,415,[300 294  96 508 132],655,0,1573,3.78125,0.0,0.0
20416,2,416,[318 496 588 357  98],796,5,1578,3.7841726618705036,40.0,0.0
20417,2,417,[318 496 588 357  98],330,5,1583,3.787081339712919,40.0,0.0
20418,2,418,[423 385 196 655 427],450,5,1588,3.7899761336515514,20.0,0.0
20419,2,419,[318 496 588 357  98],330,5,1593,3.7928571428571427,40.0,0.0
20420,2,420,[318 496 588 357  98],450,5,1598,3.795724465558195,40.0,0.0
20421,2,421,[ 88 200  12  22 222],655,1,1599,3.7890995260663507,0.0,0.0
20422,2,422,[ 98 427 196 151  79],389,4,1603,3.789598108747045,20.0,0.0
20423,2,423,[181  50 195 200 144],457,5,1608,3.792452830188679,0.0,20.0
20424,2,424,[318 496 588 357  98],450,5,1613,3.795294117647059,40.0,0.0
20425,2,425,[238  82 257 742 194],504,3,1616,3.7934272300469485,0.0,0.0
20426,2,426,[ 97 200 127 333 271],655,2,1618,3.789227166276347,0.0,20.0
20427,2,427,[318 496 588 357  98],796,5,1623,3.792056074766355,40.0,0.0
20428,2,428,[318 496 588 357  98],18,5,1628,3.7948717948717947,40.0,0.0
20429,2,429,[318 496 588 357  98],18,5,1633,3.797674418604651,40.0,0.0
20430,2,430,[265 228 118 405 328],450,4,1637,3.7981438515081205,0.0,0.0
20431,2,431,[318 496 588 357  98],18,5,1642,3.800925925925926,40.0,0.0
20432,2,432,[318 496 588 357  98],796,5,1647,3.8036951501154737,40.0,0.0
20433,2,433,[125 121 276  98 211],786,3,1650,3.80184331797235,0.0,0.0
20434,2,434,[282 215 237 180 245],504,4,1654,3.802298850574713,0.0,0.0
20435,2,435,[318 257 269  56 258],655,1,1655,3.7958715596330275,20.0,0.0
20436,2,436,[318 496 588 357  98],18,5,1660,3.7986270022883297,40.0,0.0
20437,2,437,[168 195  50   7 185],269,2,1662,3.7945205479452055,0.0,20.0
20438,2,438,[318 496 588 357  98],786,5,1667,3.797266514806378,40.0,0.0
20439,2,439,[318 496 588  98 357],18,5,1672,3.8,40.0,0.0
20440,2,440,[216  96 174 655 222],655,1,1673,3.7936507936507935,0.0,0.0
20441,2,441,[318 496 588  98 357],18,5,1678,3.7963800904977374,40.0,0.0
20442,2,442,[318 496 588  98 357],330,5,1683,3.799097065462754,40.0,0.0
20443,2,443,[151 258  25 322 302],151,3,1686,3.7972972972972974,0.0,0.0
20444,2,444,[318 496 588  98 357],796,5,1691,3.8,40.0,0.0
20445,2,445,[318 496 588  98 357],450,5,1696,3.802690582959641,40.0,0.0
20446,2,446,[ 56  22  15 655 268],269,3,1699,3.80089485458613,0.0,0.0
20447,2,447,[132 471 273 161 300],655,1,1700,3.794642857142857,0.0,0.0
20448,2,448,[318 496 588  98 357],796,5,1705,3.797327394209354,40.0,0.0
20449,2,449,[144 161 195 508 191],693,2,1707,3.7933333333333334,0.0,0.0
20450,2,450,[603 228   1 301 210],655,1,1708,3.787139689578714,20.0,0.0
20451,2,451,[ 98   7  95 357 427],450,4,1712,3.7876106194690267,20.0,0.0
20452,2,452,[210 268 216  96 515],655,2,1714,3.7836644591611477,0.0,0.0
20453,2,453,[318 496 588  98 357],716,5,1719,3.7863436123348015,40.0,0.0
20454,2,454,[318 496 588  98 357],330,5,1724,3.789010989010989,40.0,0.0
20455,2,455,[ 50  11 238 197  69],655,1,1725,3.7828947368421053,0.0,20.0
20456,2,456,[318 496 588  98 357],716,5,1730,3.7855579868708973,40.0,0.0
20457,2,457,[265 200  64 215 161],716,4,1734,3.7860262008733625,20.0,0.0
20458,2,458,[318 496 588  98 357],18,5,1739,3.7886710239651418,40.0,0.0
20459,2,459,[655 323 118 508 202],280,0,1739,3.7804347826086957,0.0,0.0
20460,2,460,[132  79 282 228 222],716,4,1743,3.7809110629067244,0.0,0.0
20461,2,461,[318 496 588  98 357],796,5,1748,3.7835497835497836,40.0,0.0
20462,2,462,[318 496 588  98 357],330,5,1753,3.7861771058315337,40.0,0.0
20463,2,463,[ 28  71 161 135 204],330,4,1757,3.7866379310344827,0.0,0.0
20464,2,464,[238 235 269 427 144],450,4,1761,3.7870967741935484,20.0,0.0
20465,2,465,[318 496 588  98 357],18,5,1766,3.7896995708154506,40.0,0.0
20466,2,466,[117 237  95 423 179],786,5,1771,3.7922912205567454,0.0,0.0
20467,2,467,[385 197 196  28 211],504,5,1776,3.7948717948717947,0.0,0.0
20468,2,468,[318 496 588  98 357],330,5,1781,3.7974413646055436,40.0,0.0
20469,2,469,[318 496 588  98 357],786,5,1786,3.8,40.0,0.0
20470,2,470,[197 200 597 176 183],796,4,1790,3.800424628450106,0.0,0.0
20471,2,471,[318 496 588  98 357],18,5,1795,3.8029661016949152,40.0,0.0
20472,2,472,[100  71 135 153  69],885,2,1797,3.799154334038055,0.0,20.0
20473,2,473,[318 496 588  98 357],18,5,1802,3.80168776371308,40.0,0.0
20474,2,474,[275 168   1  25 483],450,3,1805,3.8,0.0,20.0
20475,2,475,[174 111 200 289 197],786,4,1809,3.8004201680672267,0.0,0.0
20476,2,476,[174 568 257 275 153],389,2,1811,3.79664570230608,0.0,20.0
20477,2,477,[318 496 588  98 357],716,5,1816,3.799163179916318,40.0,0.0
20478,2,478,[172  82 216 100 237],450,4,1820,3.799582463465553,0.0,20.0
20479,2,479,[515 180  95 111 197],18,4,1824,3.8,0.0,0.0
20480,2,480,[191 483 210  11 194],269,3,1827,3.7983367983367984,0.0,0.0
20481,2,481,[318 496 588  98 357],330,5,1832,3.800829875518672,40.0,0.0
20482,2,482,[328 301 183 151 191],450,5,1837,3.803312629399586,0.0,0.0
20483,2,483,[483 234  89 135 210],18,2,1839,3.799586776859504,0.0,0.0
20484,2,484,[ 96 288 385 161  28],457,5,1844,3.802061855670103,0.0,0.0
20485,2,485,[ 71 258 222 265 234],807,3,1847,3.8004115226337447,0.0,0.0
20486,2,486,[318 496 588  98 357],18,5,1852,3.802874743326489,40.0,0.0
20487,2,487,[318 496 588  98 357],786,5,1857,3.805327868852459,40.0,0.0
20488,2,488,[318 496 588  98 357],796,5,1862,3.807770961145194,40.0,0.0
20489,2,489,[117 183 423 211  15],236,2,1864,3.804081632653061,0.0,0.0
20490,2,490,[403  50 234   7 318],280,2,1866,3.8004073319755602,20.0,20.0
20491,2,491,[ 69 191 174  25 181],693,2,1868,3.796747967479675,0.0,0.0
20492,2,492,[168 132 211 210 385],716,4,1872,3.797160243407708,0.0,0.0
20493,2,493,[215 195 588  12 328],796,5,1877,3.799595141700405,0.0,0.0
20494,2,494,[318 496 588  98 357],18,5,1882,3.802020202020202,40.0,0.0
20495,2,495,[405 174 183 143 216],577,3,1885,3.8004032258064515,0.0,0.0
20496,2,496,[196 216 194 181 151],796,5,1890,3.8028169014084505,0.0,0.0
20497,2,497,[ 82 121 144 200 597],457,4,1894,3.8032128514056227,0.0,0.0
20498,2,498,[276 179 318 168 185],504,3,1897,3.8016032064128256,20.0,0.0
20499,2,499,[318 496 588  98 357],18,5,1902,3.804,40.0,0.0
20500,2,500,[322 282 597  50  71],796,4,1906,3.8043912175648704,0.0,20.0
20501,2,501,[318 496 588  98 357],716,5,1911,3.806772908366534,40.0,0.0
20502,2,502,[318 496 588  98 357],330,5,1916,3.809145129224652,40.0,0.0
20503,2,503,[ 79 323 286 125 385],280,3,1919,3.8075396825396823,0.0,20.0
20504,2,504,[423  98 228 234 135],693,2,1921,3.803960396039604,0.0,0.0
20505,2,505,[323 597  28 245 196],796,2,1923,3.800395256916996,0.0,0.0
20506,2,506,[318 496 588  98 357],796,5,1928,3.8027613412228796,40.0,0.0
20507,2,507,[318 496 588  98 357],450,5,1933,3.8051181102362204,40.0,0.0
20508,2,508,[318 496 588  98 357],786,5,1938,3.807465618860511,40.0,0.0
20509,2,509,[318 496  98 588 357],18,5,1943,3.8098039215686272,40.0,0.0
20510,2,510,[318 496  98 588 357],18,5,1948,3.812133072407045,40.0,0.0
20511,2,511,[318 496  98 588 357],18,5,1953,3.814453125,40.0,0.0
20512,2,512,[318 496  98 588 357],786,5,1958,3.8167641325536064,40.0,0.0
20513,2,513,[318 496  98 588 357],450,5,1963,3.8190661478599224,40.0,0.0
20514,2,514,[742  56  25  22  11],577,3,1966,3.81747572815534,0.0,0.0
20515,2,515,[318 496  98 588 357],450,5,1971,3.8197674418604652,40.0,0.0
20516,2,516,[  7  89 153 125 222],296,5,1976,3.8220502901353965,0.0,0.0
20517,2,517,[318 496  98 588 357],450,5,1981,3.824324324324324,40.0,0.0
20518,2,518,[318 496  98 588 357],450,5,1986,3.8265895953757227,40.0,0.0
20519,2,519,[318 496  98 588 357],796,5,1991,3.828846153846154,40.0,0.0
20520,2,520,[483 222 183 186 195],693,1,1992,3.8234165067178503,0.0,0.0
20521,2,521,[318 496  98 588 357],450,5,1997,3.8256704980842913,40.0,0.0
20522,2,522,[197 132 180 286 168],338,3,2000,3.8240917782026767,0.0,20.0
20523,2,523,[111  71  82 187   1],786,5,2005,3.8263358778625953,0.0,0.0
20524,2,524,[318 496  98 588 357],796,5,2010,3.8285714285714287,40.0,0.0
20525,2,525,[176 282 405 143  22],796,5,2015,3.8307984790874525,0.0,0.0
20526,2,526,[318 496  98 588 357],786,5,2020,3.8330170777988615,40.0,0.0
20527,2,527,[180  12 483  88   9],693,1,2021,3.827651515151515,0.0,0.0
20528,2,528,[173 222 597 200   9],796,4,2025,3.827977315689981,0.0,0.0
20529,2,529,[ 64  28  70  89 265],72,4,2029,3.828301886792453,20.0,0.0
20530,2,530,[318 496  98 588 357],18,5,2034,3.830508474576271,40.0,0.0
20531,2,531,[318  98 496 588 357],796,5,2039,3.832706766917293,40.0,0.0
20532,2,532,[318  98 496 588 357],450,5,2044,3.8348968105065664,40.0,0.0
20533,2,533,[318  98 496 588 357],330,5,2049,3.837078651685393,40.0,0.0
20534,2,534,[187 151 211 153 204],296,4,2053,3.8373831775700933,0.0,0.0
20535,2,535,[318  98 496 588 357],330,5,2058,3.83955223880597,40.0,0.0
20536,2,536,[435 269 204  56  12],450,5,2063,3.8417132216014895,0.0,0.0
20537,2,537,[318  98 496 588 357],450,5,2068,3.8438661710037176,40.0,0.0
20538,2,538,[318  98 496 588 357],450,5,2073,3.8460111317254175,40.0,0.0
20539,2,539,[318  98 496 588 357],450,5,2078,3.848148148148148,40.0,0.0
20540,2,540,[204  88 195 186 323],796,3,2081,3.846580406654344,0.0,0.0
20541,2,541,[318  98 496 588 357],18,5,2086,3.848708487084871,40.0,0.0
20542,2,542,[318  98 496 588 357],796,5,2091,3.850828729281768,40.0,0.0
20543,2,543,[318  98 496 588 357],716,5,2096,3.8529411764705883,40.0,0.0
20544,2,544,[197 194 269  70 318],450,5,2101,3.855045871559633,20.0,0.0
20545,2,545,[318  98 496 588 357],330,5,2106,3.857142857142857,40.0,0.0
20546,2,546,[318  98 496 588 357],330,5,2111,3.859232175502742,40.0,0.0
20547,2,547,[318  98 496 588 357],330,5,2116,3.8613138686131387,40.0,0.0
20548,2,548,[ 15  64  69 216  70],330,5,2121,3.8633879781420766,20.0,0.0
20549,2,549,[318  98 496 588 357],330,5,2126,3.8654545454545453,40.0,0.0
20550,2,550,[ 89  98 273  79 210],796,3,2129,3.8638838475499093,0.0,0.0
20551,2,551,[222  98 318 143 357],151,5,2134,3.8659420289855073,20.0,0.0
20552,2,552,[125 427 174 748 151],450,5,2139,3.867992766726944,20.0,0.0
20553,2,553,[318  98 496 588 357],330,5,2144,3.8700361010830324,40.0,0.0
20554,2,554,[318  98 496 588 357],450,5,2149,3.872072072072072,40.0,0.0
20555,2,555,[471 322 742 313 153],280,3,2152,3.870503597122302,0.0,0.0
20556,2,556,[318  98 496 588 357],716,5,2157,3.872531418312388,40.0,0.0
20557,2,557,[228 258   7 144 333],693,3,2160,3.870967741935484,0.0,0.0
20558,2,558,[318  98 496 588 357],450,5,2165,3.8729874776386404,40.0,0.0
20559,2,559,[118 603 496 405 144],716,3,2168,3.8714285714285714,40.0,0.0
20560,2,560,[427 300 282 191 174],716,4,2172,3.871657754010695,20.0,0.0
20561,2,561,[318  98 496 588 357],796,5,2177,3.873665480427046,40.0,0.0
20562,2,562,[265 322 179  70 238],786,4,2181,3.8738898756660745,0.0,0.0
20563,2,563,[318  98 496 588 357],796,5,2186,3.875886524822695,40.0,0.0
20564,2,564,[  7 235 173 568 385],450,4,2190,3.8761061946902653,0.0,0.0
20565,2,565,[132 216 546 215 183],450,5,2195,3.8780918727915195,0.0,0.0
20566,2,566,[318  98 496 588 357],796,5,2200,3.880070546737213,40.0,0.0
20567,2,567,[318  98 496 588 357],796,5,2205,3.882042253521127,40.0,0.0
20568,2,568,[318  98 496 588 357],330,5,2210,3.8840070298769773,40.0,0.0
20569,2,569,[117 125 176 168 183],292,4,2214,3.8842105263157896,0.0,0.0
20570,2,570,[117  88  98 202 180],280,3,2217,3.882661996497373,0.0,0.0
20571,2,571,[318  98 496 588 357],18,5,2222,3.8846153846153846,40.0,0.0
20572,2,572,[228 405 181 125  89],450,5,2227,3.886561954624782,0.0,0.0
20573,2,573,[318 210 515 211 195],18,4,2231,3.8867595818815333,20.0,0.0
20574,2,574,[318  98 496 588 357],450,5,2236,3.888695652173913,40.0,0.0
20575,2,575,[  8 302 286 318 187],535,2,2238,3.8854166666666665,20.0,20.0
20576,2,576,[288  98 238 176 195],655,1,2239,3.880415944540728,0.0,0.0
20577,2,577,[ 71 568  79 143 181],577,3,2242,3.878892733564014,0.0,0.0
20578,2,578,[318  98 496 588 357],18,5,2247,3.8808290155440415,40.0,0.0
20579,2,579,[125   7  98 228 313],344,3,2250,3.8793103448275863,0.0,0.0
20580,2,580,[318  98 496 588 357],786,5,2255,3.8812392426850257,40.0,0.0
20581,2,581,[597  96  11 216 238],450,5,2260,3.8831615120274914,0.0,0.0
20582,2,582,[238 318 194 153   4],18,3,2263,3.881646655231561,20.0,0.0
20583,2,583,[318  98 496 588 357],450,5,2268,3.8835616438356166,40.0,0.0
20584,2,584,[318  98 496 588 357],716,5,2273,3.8854700854700854,40.0,0.0
20585,2,585,[318  98 496 588 357],786,5,2278,3.887372013651877,40.0,0.0
20586,2,586,[318  98 496 588 357],786,5,2283,3.889267461669506,40.0,0.0
20587,2,587,[237 245 204 275   1],796,3,2286,3.8877551020408165,0.0,20.0
20588,2,588,[318  98 496 588 357],18,5,2291,3.8896434634974533,40.0,0.0
20589,2,589,[318  98 496 588 357],450,5,2296,3.8915254237288135,40.0,0.0
20590,2,590,[318  70 423  88 508],269,3,2299,3.8900169204737733,20.0,0.0
20591,2,591,[  9 302 222 271 258],655,1,2300,3.885135135135135,0.0,0.0
20592,2,592,[  9 179 186 111 228],786,5,2305,3.8870151770657673,0.0,0.0
20593,2,593,[ 12 475 318  15  25],655,1,2306,3.8821548821548824,20.0,0.0
20594,2,594,[318  98 496 588 357],716,5,2311,3.884033613445378,40.0,0.0
20595,2,595,[742 125  12 273 405],796,3,2314,3.88255033557047,0.0,0.0
20596,2,596,[318  98 496 588 357],330,5,2319,3.8844221105527637,40.0,0.0
20597,2,597,[318  98 496 588 357],450,5,2324,3.8862876254180603,40.0,0.0
20598,2,598,[318  98 496 588 357],18,5,2329,3.8881469115191987,40.0,0.0
20599,2,599,[ 11 216 125 176 322],344,2,2331,3.885,0.0,0.0
20600,2,600,[172  82 546 200 234],280,2,2333,3.8818635607321132,0.0,0.0
20601,2,601,[318  98 496 588 357],450,5,2338,3.883720930232558,40.0,0.0
20602,2,602,[258 271 195 238 269],655,0,2338,3.8772802653399667,0.0,0.0
20603,2,603,[172 289 118  50 333],693,0,2338,3.870860927152318,0.0,20.0
20604,2,604,[202 127 180 211 143],786,5,2343,3.8727272727272726,0.0,20.0
20605,2,605,[125 275 144   7 181],450,5,2348,3.8745874587458746,0.0,20.0
20606,2,606,[318  98 496 588 357],796,5,2353,3.8764415156507415,40.0,0.0
20607,2,607,[318  98 496 588 357],450,5,2358,3.8782894736842106,40.0,0.0
20608,2,608,[318  98 496 588 357],330,5,2363,3.8801313628899834,40.0,0.0
20609,2,609,[318  98 496 588 357],796,5,2368,3.8819672131147542,40.0,0.0
20610,2,610,[294 111 125 168  69],796,4,2372,3.8821603927986907,0.0,0.0
20611,2,611,[318  98 496 588 357],330,5,2377,3.883986928104575,40.0,0.0
20612,2,612,[318  98 496 588 357],796,5,2382,3.8858075040783033,40.0,0.0
20613,2,613,[318  98 496 588 357],796,5,2387,3.8876221498371337,40.0,0.0
20614,2,614,[125 258 161 427 180],450,5,2392,3.8894308943089433,20.0,0.0
20615,2,615,[204  12 125  89 172],450,5,2397,3.8912337662337664,0.0,0.0
20616,2,616,[546 111  15 179   1],450,4,2401,3.891410048622366,0.0,0.0
20617,2,617,[288 546 181 655 132],693,1,2402,3.8867313915857604,0.0,0.0
20618,2,618,[318  98 496 588 357],450,5,2407,3.888529886914378,40.0,0.0
20619,2,619,[318  98 496 588 357],330,5,2412,3.890322580645161,40.0,0.0
20620,2,620,[318  98 496 588 357],796,5,2417,3.892109500805153,40.0,0.0
20621,2,621,[318  98 496 588 357],18,5,2422,3.8938906752411575,40.0,0.0
20622,2,622,[318  98 496 588 357],330,5,2427,3.895666131621188,40.0,0.0
20623,2,623,[318  98 496 588 357],450,5,2432,3.8974358974358974,40.0,0.0
20624,2,624,[144 182 271 323 197],796,3,2435,3.896,0.0,0.0
20625,2,625,[318  98 496 588 357],18,5,2440,3.8977635782747604,40.0,0.0
20626,2,626,[288  98  56  97  70],450,4,2444,3.8979266347687402,0.0,0.0
20627,2,627,[318  98 496 588 357],330,5,2449,3.8996815286624202,40.0,0.0
20628,2,628,[318  98 496 588 357],786,5,2454,3.901430842607313,40.0,0.0
20629,2,629,[318  98 496 588 357],18,5,2459,3.903174603174603,40.0,0.0
20630,2,630,[143 127  11 568 211],655,2,2461,3.9001584786053884,0.0,20.0
20631,2,631,[318  98 496 588 357],716,5,2466,3.901898734177215,40.0,0.0
20632,2,632,[127 118  96 173  12],457,5,2471,3.9036334913112163,0.0,20.0
20633,2,633,[313  11  69  22  28],450,5,2476,3.9053627760252367,0.0,0.0
20634,2,634,[318  98 496 588 357],450,5,2481,3.9070866141732283,40.0,0.0
20635,2,635,[ 69 403 194 127 211],807,4,2485,3.907232704402516,0.0,20.0
20636,2,636,[125  70 143 111 117],457,4,2489,3.9073783359497645,0.0,0.0
20637,2,637,[318  98 496 588 357],450,5,2494,3.909090909090909,40.0,0.0
20638,2,638,[318  98 496 588 357],796,5,2499,3.9107981220657275,40.0,0.0
20639,2,639,[ 82 405 228 294 172],655,1,2500,3.90625,0.0,0.0
20640,2,640,[200 427 121   9 194],796,4,2504,3.906396255850234,20.0,0.0
20641,2,641,[318  98 496 588 357],716,5,2509,3.9080996884735204,40.0,0.0
20642,2,642,[118 196 423 215 216],151,3,2512,3.906687402799378,0.0,0.0
20643,2,643,[ 70 471 403  96  15],655,0,2512,3.900621118012422,0.0,0.0
20644,2,644,[318  98 496 588 357],786,5,2517,3.902325581395349,40.0,0.0
20645,2,645,[  8 269 121 328 313],796,4,2521,3.9024767801857587,0.0,0.0
20646,2,646,[318  98 496 588 357],330,5,2526,3.9041731066460588,40.0,0.0
20647,2,647,[588 186 176 269 496],450,4,2530,3.904320987654321,20.0,0.0
20648,2,648,[195  22 300  71 603],796,5,2535,3.906009244992296,20.0,0.0
20649,2,649,[318  98 496 588 357],796,5,2540,3.9076923076923076,40.0,0.0
20650,2,650,[318  98 496 588 357],786,5,2545,3.9093701996927805,40.0,0.0
20651,2,651,[175 202 483  50 405],716,4,2549,3.9095092024539877,0.0,20.0
20652,2,652,[318  98 496 588 357],716,5,2554,3.911179173047473,40.0,0.0
20653,2,653,[172 202 269 357 238],18,3,2557,3.9097859327217126,0.0,0.0
20654,2,654,[318  98 496 588 357],796,5,2562,3.9114503816793893,40.0,0.0
20655,2,655,[318  98 496 588 357],18,5,2567,3.913109756097561,40.0,0.0
20656,2,656,[318  98 496 588 357],786,5,2572,3.914764079147641,40.0,0.0
20657,2,657,[173 194 471 127  64],401,2,2574,3.911854103343465,20.0,20.0
20658,2,658,[318  98 496 588 357],18,5,2579,3.91350531107739,40.0,0.0
20659,2,659,[318  98 496 588 357],796,5,2584,3.915151515151515,40.0,0.0
20660,2,660,[318  98 496 588 357],786,5,2589,3.9167927382753405,40.0,0.0
20661,2,661,[318  98 496 588 357],716,5,2594,3.918429003021148,40.0,0.0
20662,2,662,[ 11 222 471 435 151],716,4,2598,3.918552036199095,0.0,0.0
20663,2,663,[258 182 265 318 302],450,5,2603,3.9201807228915664,20.0,0.0
20664,2,664,[195 181 210 568 118],796,4,2607,3.920300751879699,0.0,0.0
20665,2,665,[496 435 161 111 183],450,5,2612,3.921921921921922,20.0,0.0
20666,2,666,[603 237 175  70   1],716,4,2616,3.922038980509745,20.0,0.0
20667,2,667,[318  98 496 588 357],796,5,2621,3.9236526946107784,40.0,0.0
20668,2,668,[423 235 186 275 194],457,4,2625,3.9237668161434978,0.0,20.0
20669,2,669,[228 204 211 496  96],807,4,2629,3.9238805970149255,20.0,0.0
20670,2,670,[435 182 144 258 328],655,1,2630,3.9195230998509687,0.0,0.0
20671,2,671,[168 313 275 546 200],450,4,2634,3.919642857142857,0.0,20.0
20672,2,672,[135 273 174  11 357],629,3,2637,3.9182763744427933,0.0,0.0
20673,2,673,[318  98 496 588 357],450,5,2642,3.919881305637982,40.0,0.0
20674,2,674,[313 237 211 151 185],450,5,2647,3.9214814814814813,0.0,0.0
20675,2,675,[273 111 475   9 245],629,3,2650,3.9201183431952664,0.0,0.0
20676,2,676,[215 174 496 435 204],716,5,2655,3.9217134416543575,20.0,0.0
20677,2,677,[318  98 496 588 357],786,5,2660,3.9233038348082596,40.0,0.0
20678,2,678,[318  98 496 588 357],716,5,2665,3.9248895434462443,40.0,0.0
20679,2,679,[318  98 496 588 357],18,5,2670,3.926470588235294,40.0,0.0
20680,2,680,[318  98 496 588 357],786,5,2675,3.9280469897209986,40.0,0.0
20681,2,681,[318  98 496 588 357],18,5,2680,3.929618768328446,40.0,0.0
20682,2,682,[318  98 496 588 357],450,5,2685,3.931185944363104,40.0,0.0
20683,2,683,[318  98 496 588 357],786,5,2690,3.9327485380116958,40.0,0.0
20684,2,684,[318  98 496 588 357],716,5,2695,3.934306569343066,40.0,0.0
20685,2,685,[ 70 117 228 176  82],786,5,2700,3.935860058309038,0.0,0.0
20686,2,686,[318  98 496 588 357],786,5,2705,3.937409024745269,40.0,0.0
20687,2,687,[318  98 496 588 357],716,5,2710,3.938953488372093,40.0,0.0
20688,2,688,[318  98 496 588 357],330,5,2715,3.9404934687953554,40.0,0.0
20689,2,689,[427 174 194 603 483],908,3,2718,3.9391304347826086,40.0,0.0
20690,2,690,[318  98 496 588 357],796,5,2723,3.9406657018813314,40.0,0.0
20691,2,691,[216 196 427 289  88],236,3,2726,3.939306358381503,20.0,0.0
20692,2,692,[318  98 496 588 357],450,5,2731,3.940836940836941,40.0,0.0
20693,2,693,[ 25 385  82 435 471],655,0,2731,3.935158501440922,0.0,0.0
20694,2,694,[318  98 496 588 357],18,5,2736,3.9366906474820142,40.0,0.0
20695,2,695,[318  98 496 588 357],796,5,2741,3.9382183908045976,40.0,0.0
20696,2,696,[  8 742  70 185 273],655,2,2743,3.9354375896700144,0.0,0.0
20697,2,697,[318  98 496 588 357],330,5,2748,3.9369627507163325,40.0,0.0
20698,2,698,[318  98 496 588 357],18,5,2753,3.938483547925608,40.0,0.0
20699,2,699,[318  98 496 588 357],786,5,2758,3.94,40.0,0.0
20700,2,700,[180 235  98 153 210],280,4,2762,3.940085592011412,0.0,0.0
20701,2,701,[215  56 125  28 118],450,4,2766,3.9401709401709404,0.0,0.0
20702,2,702,[182 237 210 183 423],280,1,2767,3.9359886201991463,0.0,0.0
20703,2,703,[318  98 496 588 357],716,5,2772,3.9375,40.0,0.0
20704,2,704,[318  98 496 588 357],18,5,2777,3.9390070921985814,40.0,0.0
20705,2,705,[ 88 168 183 215 496],796,5,2782,3.9405099150141645,20.0,0.0
20706,2,706,[313 294  15  70 385],655,1,2783,3.9363507779349365,0.0,0.0
20707,2,707,[172 144 603 204 471],535,3,2786,3.9350282485875705,20.0,0.0
20708,2,708,[ 15 161   9 568 172],72,4,2790,3.9351198871650213,0.0,0.0
20709,2,709,[ 98  11 403 546 237],450,5,2795,3.936619718309859,0.0,0.0
20710,2,710,[318  98 496 588 357],716,5,2800,3.938115330520394,40.0,0.0
20711,2,711,[228  11 588 748 204],280,2,2802,3.9353932584269664,0.0,0.0
20712,2,712,[282 144 202  98   4],716,2,2804,3.932678821879383,0.0,0.0
20713,2,713,[235 197  28 180 204],450,4,2808,3.9327731092436973,0.0,0.0
20714,2,714,[318  98 496 588 357],716,5,2813,3.9342657342657343,40.0,0.0
20715,2,715,[211 423   4 275  64],796,4,2817,3.934357541899441,20.0,20.0
20716,2,716,[546  50 234 237  79],457,4,2821,3.9344490934449095,0.0,20.0
20717,2,717,[318  98 496 588 357],450,5,2826,3.935933147632312,40.0,0.0
20718,2,718,[318  98 496 588 357],18,5,2831,3.937413073713491,40.0,0.0
20719,2,719,[318  98 496 588 357],450,5,2836,3.938888888888889,40.0,0.0
20720,2,720,[ 79 471 228 427 151],807,5,2841,3.940360610263523,20.0,0.0
20721,2,721,[302  71 276  97 427],535,3,2844,3.9390581717451525,20.0,0.0
20722,2,722,[ 89 125 185 173  28],151,5,2849,3.9405255878284926,0.0,0.0
20723,2,723,[ 25 173 202 168 597],457,4,2853,3.9406077348066297,0.0,0.0
20724,2,724,[222 194  89 172   8],23,5,2858,3.942068965517241,0.0,0.0
20725,2,725,[318  98 496 588 357],18,5,2863,3.943526170798898,40.0,0.0
20726,2,726,[318  98 496 588 357],786,5,2868,3.9449793672627234,40.0,0.0
20727,2,727,[318  98 496 588 357],18,5,2873,3.9464285714285716,40.0,0.0
20728,2,728,[318  98 496 588 357],18,5,2878,3.9478737997256514,40.0,0.0
20729,2,729,[200 257 271 508 153],655,1,2879,3.9438356164383563,0.0,0.0
20730,2,730,[318  98 496 588 357],450,5,2884,3.945280437756498,40.0,0.0
20731,2,731,[318  98 496 588 357],796,5,2889,3.94672131147541,40.0,0.0
20732,2,732,[ 12  70 111 403  69],457,4,2893,3.946793997271487,0.0,0.0
20733,2,733,[318  98 496 588 357],796,5,2898,3.9482288828337873,40.0,0.0
20734,2,734,[181  25 195 483 197],457,5,2903,3.949659863945578,0.0,0.0
20735,2,735,[318  98 496 588 357],330,5,2908,3.9510869565217392,40.0,0.0
20736,2,736,[496   4  79 172 471],280,2,2910,3.948439620081411,20.0,0.0
20737,2,737,[318  98 496 588 357],796,5,2915,3.9498644986449865,40.0,0.0
20738,2,738,[100 179 196  88 211],389,3,2918,3.948579161028417,0.0,20.0
20739,2,739,[196  15 234  56 121],457,5,2923,3.95,0.0,0.0
20740,2,740,[161 175 655 318  15],457,5,2928,3.951417004048583,20.0,0.0
20741,2,741,[318  98 496 588 357],330,5,2933,3.952830188679245,40.0,0.0
20742,2,742,[318  98 496 588 357],330,5,2938,3.9542395693135934,40.0,0.0
20743,2,743,[318  98 496 588 357],796,5,2943,3.9556451612903225,40.0,0.0
20744,2,744,[318 423 301  89 172],655,3,2946,3.9543624161073825,20.0,0.0
20745,2,745,[153 187  98 185 234],503,4,2950,3.954423592493298,0.0,0.0
20746,2,746,[318  98 496 588 357],796,5,2955,3.9558232931726907,40.0,0.0
20747,2,747,[318  98 496 588 357],450,5,2960,3.9572192513368982,40.0,0.0
20748,2,748,[135 197 269 357 496],18,4,2964,3.9572763684913217,20.0,0.0
20749,2,749,[268 172  11 161   9],655,1,2965,3.953333333333333,0.0,0.0
20750,2,750,[546 318  82  25 265],577,4,2969,3.9533954727030625,20.0,0.0
20751,2,751,[111  96  79 588  82],756,4,2973,3.953457446808511,0.0,0.0
20752,2,752,[318  98 496 588 357],716,5,2978,3.954847277556441,40.0,0.0
20753,2,753,[318  98 496 588 357],18,5,2983,3.956233421750663,40.0,0.0
20754,2,754,[333 271  25 211   8],655,0,2983,3.9509933774834436,0.0,0.0
20755,2,755,[269  56 168 742 196],450,5,2988,3.9523809523809526,0.0,0.0
20756,2,756,[318  98 496 588 357],716,5,2993,3.9537648612945837,40.0,0.0
20757,2,757,[385 435   1 143 194],401,3,2996,3.9525065963060686,0.0,0.0
20758,2,758,[318  98 496 588 357],330,5,3001,3.953886693017128,40.0,0.0
20759,2,759,[318  98 496 588 357],786,5,3006,3.955263157894737,40.0,0.0
20760,2,760,[318  98 496 588 357],796,5,3011,3.9566360052562417,40.0,0.0
20761,2,761,[318  98 496 588 357],786,5,3016,3.958005249343832,40.0,0.0
20762,2,762,[318  98 496 588 357],786,5,3021,3.959370904325033,40.0,0.0
20763,2,763,[318  98 496 588 357],716,5,3026,3.9607329842931938,40.0,0.0
20764,2,764,[269  28 127 403 300],655,1,3027,3.9568627450980394,0.0,20.0
20765,2,765,[318  98 496 588 357],18,5,3032,3.9582245430809397,40.0,0.0
20766,2,766,[172 273 182 258 161],796,4,3036,3.958279009126467,0.0,0.0
20767,2,767,[318  98 496 588 357],796,5,3041,3.9596354166666665,40.0,0.0
20768,2,768,[318  98 496 588 357],18,5,3046,3.9609882964889467,40.0,0.0
20769,2,769,[191 357  79 313  71],796,5,3051,3.9623376623376623,0.0,0.0
20770,2,770,[318  98 496 588 357],450,5,3056,3.9636835278858626,40.0,0.0
20771,2,771,[197 286 328  97 238],450,5,3061,3.965025906735751,0.0,20.0
20772,2,772,[202 197 161 275 194],450,5,3066,3.966364812419146,0.0,20.0
20773,2,773,[318  98 496 588 357],796,5,3071,3.9677002583979326,40.0,0.0
20774,2,774,[ 25 210 144 357 508],693,3,3074,3.9664516129032257,0.0,0.0
20775,2,775,[210 678 117 111 288],344,3,3077,3.9652061855670104,0.0,0.0
20776,2,776,[318  98 496 588 357],716,5,3082,3.9665379665379668,40.0,0.0
20777,2,777,[318  98 496 588 357],716,5,3087,3.967866323907455,40.0,0.0
20778,2,778,[318  98 496 588 357],786,5,3092,3.969191270860077,40.0,0.0
20779,2,779,[318  98 496 588 357],716,5,3097,3.9705128205128206,40.0,0.0
20780,2,780,[235  97 153  11 197],401,2,3099,3.967989756722151,0.0,0.0
20781,2,781,[318  98 496 588 357],18,5,3104,3.969309462915601,40.0,0.0
20782,2,782,[318  98 496 588 357],18,5,3109,3.970625798212005,40.0,0.0
20783,2,783,[318  98 496 588 357],796,5,3114,3.9719387755102042,40.0,0.0
20784,2,784,[318  98 496 588 357],18,5,3119,3.973248407643312,40.0,0.0
20785,2,785,[318  98 496 588 357],18,5,3124,3.9745547073791347,40.0,0.0
20786,2,786,[144  79  11 127 546],716,3,3127,3.9733163913595932,0.0,20.0
20787,2,787,[318  98 496 588 357],450,5,3132,3.9746192893401013,40.0,0.0
20788,2,788,[301 288 269  50 318],450,4,3136,3.9746514575411913,20.0,20.0
20789,2,789,[748 257 196 568  15],798,4,3140,3.9746835443037973,0.0,0.0
20790,2,790,[275 588 216 181 195],786,5,3145,3.9759797724399495,0.0,20.0
20791,2,791,[318  98 496 588 357],716,5,3150,3.977272727272727,40.0,0.0
20792,2,792,[318  98 496 588 357],796,5,3155,3.978562421185372,40.0,0.0
20793,2,793,[318  98 496 588 357],716,5,3160,3.9798488664987404,40.0,0.0
20794,2,794,[222 174 471 176  22],450,4,3164,3.979874213836478,0.0,0.0
20795,2,795,[318  98 496 588 357],450,5,3169,3.9811557788944723,40.0,0.0
20796,2,796,[318  98 496 588 357],796,5,3174,3.982434127979925,40.0,0.0
20797,2,797,[318  98 496 588 357],796,5,3179,3.9837092731829573,40.0,0.0
20798,2,798,[427 568 237  82 313],577,4,3183,3.983729662077597,20.0,0.0
20799,2,799,[318  98 496 588 357],330,5,3188,3.985,40.0,0.0
20800,2,800,[186 597 181  79 143],450,4,3192,3.9850187265917603,0.0,0.0
20801,2,801,[318  98 496 588 357],330,5,3197,3.986284289276808,40.0,0.0
20802,2,802,[245 111 234 143 183],450,4,3201,3.9863013698630136,0.0,0.0
20803,2,803,[  7  97 121 216 168],65,4,3205,3.986318407960199,0.0,0.0
20804,2,804,[568 216 333 135 200],655,3,3208,3.9850931677018635,0.0,0.0
20805,2,805,[202 210 195 257 144],457,4,3212,3.9851116625310175,0.0,0.0
20806,2,806,[318  98 496 588 357],450,5,3217,3.98636926889715,40.0,0.0
20807,2,807,[276 245  25  96 172],344,4,3221,3.9863861386138613,0.0,0.0
20808,2,808,[161 245 200 125 215],504,5,3226,3.987639060568603,0.0,0.0
20809,2,809,[294 496 508 182 183],280,1,3227,3.9839506172839507,20.0,0.0
20810,2,810,[318  98 496 588 357],716,5,3232,3.9852034525277436,40.0,0.0
20811,2,811,[234  88 568 180 237],796,3,3235,3.9839901477832513,0.0,0.0
20812,2,812,[ 28   8 216 151 202],796,4,3239,3.984009840098401,0.0,0.0
20813,2,813,[222 237 211 196 515],655,1,3240,3.98034398034398,0.0,0.0
20814,2,814,[269 183 144 282  70],655,1,3241,3.9766871165644173,0.0,0.0
20815,2,815,[204 385  28 357 603],796,4,3245,3.9767156862745097,20.0,0.0
20816,2,816,[ 50 515 435 211 127],321,4,3249,3.9767441860465116,0.0,40.0
20817,2,817,[ 82 237 186 385 228],796,3,3252,3.975550122249389,0.0,0.0
20818,2,818,[483 300 546 168 496],807,5,3257,3.976800976800977,20.0,0.0
20819,2,819,[301 265 125 132  95],796,4,3261,3.976829268292683,0.0,0.0
20820,2,820,[204  98 427  56 211],18,4,3265,3.976857490864799,20.0,0.0
20821,2,821,[318  98 496 588 357],786,5,3270,3.978102189781022,40.0,0.0
20822,2,822,[318  98 496 588 357],18,5,3275,3.9793438639125154,40.0,0.0
20823,2,823,[318  98 496 588 357],796,5,3280,3.9805825242718447,40.0,0.0
20824,2,824,[318  98 496 588 357],450,5,3285,3.981818181818182,40.0,0.0
20825,2,825,[318  98 496 588 357],450,5,3290,3.983050847457627,40.0,0.0
20826,2,826,[196 237 179 258 187],504,2,3292,3.980652962515115,0.0,0.0
20827,2,827,[318  98 496 588 357],450,5,3297,3.9818840579710146,40.0,0.0
20828,2,828,[302 175  79  69  12],655,2,3299,3.9794933655006033,0.0,0.0
20829,2,829,[194 257 182 100 186],457,4,3303,3.9795180722891565,0.0,20.0
20830,2,830,[318  98 496 588 357],18,5,3308,3.980746089049338,40.0,0.0
20831,2,831,[318  98 496 588 357],786,5,3313,3.9819711538461537,40.0,0.0
20832,2,832,[318  98 496 588 357],18,5,3318,3.9831932773109244,40.0,0.0
20833,2,833,[318  98 496 588 357],18,5,3323,3.984412470023981,40.0,0.0
20834,2,834,[215  25 204 496 423],151,4,3327,3.9844311377245507,20.0,0.0
20835,2,835,[234 125 144 322  22],280,2,3329,3.9820574162679425,0.0,0.0
20836,2,836,[318  98 496 588 357],796,5,3334,3.983273596176822,40.0,0.0
20837,2,837,[588 151 161 318 172],450,5,3339,3.984486873508353,20.0,0.0
20838,2,838,[ 15  12 125 258 132],796,5,3344,3.9856972586412396,0.0,0.0
20839,2,839,[318  98 496 588 357],716,5,3349,3.986904761904762,40.0,0.0
20840,2,840,[172   4  11 182 125],280,1,3350,3.9833531510107014,0.0,0.0
20841,2,841,[318  98 496 588 357],716,5,3355,3.9845605700712587,40.0,0.0
20842,2,842,[153 568 144 403 597],450,5,3360,3.98576512455516,0.0,0.0
20843,2,843,[318  98 496 588 357],786,5,3365,3.9869668246445498,40.0,0.0
20844,2,844,[318  98 496 588 357],786,5,3370,3.9881656804733727,40.0,0.0
20845,2,845,[318  98 496 588 357],330,5,3375,3.9893617021276597,40.0,0.0
20846,2,846,[322 118  88 197 588],280,2,3377,3.987012987012987,0.0,0.0
20847,2,847,[200 288 211 216 245],593,4,3381,3.9870283018867925,0.0,0.0
20848,2,848,[300 182 117 235  70],450,4,3385,3.9870435806831566,0.0,0.0
20849,2,849,[ 82  15  95 403  50],450,2,3387,3.9847058823529413,0.0,20.0
20850,2,850,[197  25  12 655 302],151,4,3391,3.9847238542890717,0.0,0.0
20851,2,851,[  1 271 423 568 300],655,0,3391,3.9800469483568075,0.0,0.0
20852,2,852,[318  98 496 588 357],450,5,3396,3.981242672919109,40.0,0.0
20853,2,853,[318  98 496 588 357],18,5,3401,3.9824355971896956,40.0,0.0
20854,2,854,[153 181 196 151  11],716,5,3406,3.983625730994152,0.0,0.0
20855,2,855,[318  98 496 588 357],796,5,3411,3.9848130841121496,40.0,0.0
20856,2,856,[ 15 300 268 185 301],655,1,3412,3.981330221703617,0.0,0.0
20857,2,857,[ 28 655 210 300 603],796,2,3414,3.979020979020979,20.0,0.0
20858,2,858,[ 25 195  50 655 210],457,5,3419,3.980209545983702,0.0,20.0
20859,2,859,[318  98 496 588 357],796,5,3424,3.9813953488372094,40.0,0.0
20860,2,860,[132 182 118 111 313],450,4,3428,3.9814169570267133,0.0,0.0
20861,2,861,[405  22 403 568 238],330,5,3433,3.9825986078886313,0.0,0.0
20862,2,862,[318  98 496 588 357],450,5,3438,3.9837775202780996,40.0,0.0
20863,2,863,[ 50  82   9 174 187],269,2,3440,3.9814814814814814,0.0,20.0
20864,2,864,[ 97 195 132 174 200],18,3,3443,3.9803468208092485,0.0,0.0
20865,2,865,[318  98 496 588 357],450,5,3448,3.9815242494226326,40.0,0.0
20866,2,866,[318  98 496 588 357],786,5,3453,3.982698961937716,40.0,0.0
20867,2,867,[ 15 515 603 143 427],269,3,3456,3.9815668202764978,40.0,0.0
20868,2,868,[318  98 496 588 357],786,5,3461,3.982738780207135,40.0,0.0
20869,2,869,[515 286 121 276 196],401,3,3464,3.981609195402299,0.0,20.0
20870,2,870,[318  98 496 588 357],716,5,3469,3.9827784156142365,40.0,0.0
20871,2,871,[318  98 496 588 357],716,5,3474,3.9839449541284404,40.0,0.0
20872,2,872,[294 748 597 143 151],450,5,3479,3.9851088201603666,0.0,0.0
20873,2,873,[318  98 496 588 357],716,5,3484,3.986270022883295,40.0,0.0
20874,2,874,[202  15  88 275 197],151,5,3489,3.9874285714285715,0.0,20.0
20875,2,875,[269 100 234  69 588],450,4,3493,3.9874429223744294,0.0,20.0
20876,2,876,[318  98 496 588 357],786,5,3498,3.9885974914481186,40.0,0.0
20877,2,877,[318  98 496 588 357],796,5,3503,3.989749430523918,40.0,0.0
20878,2,878,[ 88 111 200 174 302],450,4,3507,3.9897610921501707,0.0,0.0
20879,2,879,[318  98 496 588 357],716,5,3512,3.9909090909090907,40.0,0.0
20880,2,880,[318  98 496 588 357],450,5,3517,3.99205448354143,40.0,0.0
20881,2,881,[318  98 496 588 357],18,5,3522,3.993197278911565,40.0,0.0
20882,2,882,[269  11 200 286 423],655,1,3523,3.9898074745186864,0.0,20.0
20883,2,883,[168 172 210 405  11],457,5,3528,3.990950226244344,0.0,0.0
20884,2,884,[211  11 183 234 357],693,2,3530,3.9887005649717513,0.0,0.0
20885,2,885,[318  98 496 588 357],18,5,3535,3.989841986455982,40.0,0.0
20886,2,886,[357 603 210 427 181],796,4,3539,3.9898534385569335,40.0,0.0
20887,2,887,[318  98 496 588 357],330,5,3544,3.990990990990991,40.0,0.0
20888,2,888,[318  98 496 588 357],716,5,3549,3.9921259842519685,40.0,0.0
20889,2,889,[318  98 496 588 357],796,5,3554,3.993258426966292,40.0,0.0
20890,2,890,[603 172 301  88 300],450,5,3559,3.994388327721661,20.0,0.0
20891,2,891,[318  98 496 588 357],796,5,3564,3.995515695067265,40.0,0.0
20892,2,892,[228   8 132 302 172],655,2,3566,3.9932810750279955,0.0,0.0
20893,2,893,[  1  95 195 483 211],716,4,3570,3.9932885906040267,0.0,0.0
20894,2,894,[318  98 496 588 357],786,5,3575,3.994413407821229,40.0,0.0
20895,2,895,[153 215  82 143   4],716,4,3579,3.994419642857143,0.0,0.0
20896,2,896,[153 268 313 483 294],296,4,3583,3.9944258639910815,0.0,0.0
20897,2,897,[ 64 174 423 546  95],450,4,3587,3.994432071269488,20.0,0.0
20898,2,898,[318  98 496 588 357],716,5,3592,3.9955506117908786,40.0,0.0
20899,2,899,[  1 202 191 100 176],655,1,3593,3.9922222222222223,0.0,20.0
20900,2,900,[318  98 496 588 357],796,5,3598,3.993340732519423,40.0,0.0
20901,2,901,[318  98 496 588 357],450,5,3603,3.994456762749446,40.0,0.0
20902,2,902,[202 268 153 200 357],629,5,3608,3.9955703211517166,0.0,0.0
20903,2,903,[273 603 234 275 183],655,4,3612,3.995575221238938,20.0,20.0
20904,2,904,[318  98 496 588 357],18,5,3617,3.9966850828729283,40.0,0.0
20905,2,905,[318  98 496 588 357],450,5,3622,3.9977924944812364,40.0,0.0
20906,2,906,[318  98 496 588 357],786,5,3627,3.9988974641675856,40.0,0.0
20907,2,907,[318  98 496 588 357],716,5,3632,4.0,40.0,0.0
20908,2,908,[318  98 496 588 357],796,5,3637,4.001100110011001,40.0,0.0
20909,2,909,[173 568 197  22 194],457,5,3642,4.002197802197802,0.0,0.0
20910,2,910,[318  71 286 357 135],18,4,3646,4.002195389681669,20.0,20.0
20911,2,911,[318  98 496 588 357],450,5,3651,4.003289473684211,40.0,0.0
20912,2,912,[275 111 117 100 144],401,4,3655,4.00328587075575,0.0,40.0
20913,2,913,[475 210   1  70 655],655,0,3655,3.99890590809628,0.0,0.0
20914,2,914,[318  98 496 588 357],330,5,3660,4.0,40.0,0.0
20915,2,915,[318  98 496 588 357],18,5,3665,4.001091703056769,40.0,0.0
20916,2,916,[742  50 245 423  70],450,5,3670,4.002181025081788,0.0,20.0
20917,2,917,[318  98 496 588 357],716,5,3675,4.003267973856209,40.0,0.0
20918,2,918,[318  98 496 588 357],450,5,3680,4.004352557127312,40.0,0.0
20919,2,919,[318  98 496 588 357],786,5,3685,4.005434782608695,40.0,0.0
20920,2,920,[ 25 237 111  98 151],18,1,3686,4.002171552660152,0.0,0.0
20921,2,921,[318  98 496 588 357],796,5,3691,4.003253796095445,40.0,0.0
20922,2,922,[174 180  82 132 742],796,2,3693,4.001083423618635,0.0,0.0
20923,2,923,[238 153 173  97 200],707,2,3695,3.9989177489177488,0.0,0.0
20924,2,924,[318  98 496 588 357],18,5,3700,4.0,40.0,0.0
20925,2,925,[237 117 216 182 275],450,5,3705,4.001079913606912,0.0,20.0
20926,2,926,[ 15  56 423 176  22],450,4,3709,4.001078748651564,0.0,0.0
20927,2,927,[318  98 496 588 357],716,5,3714,4.002155172413793,40.0,0.0
20928,2,928,[237 282   1  98  79],457,5,3719,4.003229278794403,0.0,0.0
20929,2,929,[318  98 496 588 357],18,5,3724,4.004301075268817,40.0,0.0
20930,2,930,[318  98 496 588 357],450,5,3729,4.005370569280344,40.0,0.0
20931,2,931,[ 95 496 179 210 195],786,5,3734,4.006437768240343,20.0,0.0
20932,2,932,[318  98 496 588 357],786,5,3739,4.007502679528403,40.0,0.0
20933,2,933,[238 197  97 172   9],655,1,3740,4.004282655246253,0.0,0.0
20934,2,934,[ 50 276 117 100   7],463,3,3743,4.003208556149732,0.0,40.0
20935,2,935,[132 228  96 100 181],23,5,3748,4.004273504273504,0.0,20.0
20936,2,936,[357 423  96 151 172],23,2,3750,4.00213447171825,0.0,0.0
20937,2,937,[318  98 496 588 357],450,5,3755,4.00319829424307,40.0,0.0
20938,2,938,[185 471  96 161 181],716,2,3757,4.001064962726304,0.0,0.0
20939,2,939,[385 269 200  12   8],796,4,3761,4.001063829787234,0.0,0.0
20940,2,940,[ 22  88 508  89  56],269,2,3763,3.9989373007438895,0.0,0.0
20941,2,941,[318  98 496 588 357],450,5,3768,4.0,40.0,0.0
20942,2,942,[405  71  79 111 181],450,4,3772,4.0,0.0,0.0
20943,2,943,[318  98 496 588 357],18,5,3777,4.001059322033898,40.0,0.0
20944,2,944,[  9 403 222  98 183],280,2,3779,3.998941798941799,0.0,0.0
20945,2,945,[275  64 143  95  28],389,3,3782,3.9978858350951376,20.0,20.0
20946,2,946,[318  98 496 588 357],716,5,3787,3.998944033790919,40.0,0.0
20947,2,947,[172 186  56  88 200],450,3,3790,3.99789029535865,0.0,0.0
20948,2,948,[496 235 597  95 748],450,3,3793,3.9968387776606953,20.0,0.0
20949,2,949,[132 275 238  50   1],457,5,3798,3.997894736842105,0.0,40.0
20950,2,950,[318  98 496 588 357],450,5,3803,3.9989484752891693,40.0,0.0
20951,2,951,[318  98 496 588 357],796,5,3808,4.0,40.0,0.0
20952,2,952,[300 237 423  12 153],450,5,3813,4.001049317943337,0.0,0.0
20953,2,953,[238   9 471  64 318],65,4,3817,4.00104821802935,40.0,0.0
20954,2,954,[ 70 174 175 275 100],151,4,3821,4.001047120418848,0.0,40.0
20955,2,955,[318  98 496 588 357],716,5,3826,4.002092050209205,40.0,0.0
20956,2,956,[318  98 496 588 357],786,5,3831,4.003134796238244,40.0,0.0
20957,2,957,[ 11 423 286 118 357],330,5,3836,4.004175365344468,0.0,20.0
20958,2,958,[216 271 175 143 273],655,3,3839,4.003128258602711,0.0,0.0
20959,2,959,[ 97   8 202 216 191],655,2,3841,4.001041666666667,0.0,0.0
20960,2,960,[318  98 496 588 357],796,5,3846,4.002081165452654,40.0,0.0
20961,2,961,[328 168   7 238  89],151,4,3850,4.002079002079002,0.0,0.0
20962,2,962,[318  98 496 588 357],330,5,3855,4.003115264797508,40.0,0.0
20963,2,963,[427 215 197 195 245],796,3,3858,4.0020746887966805,20.0,0.0
20964,2,964,[318  98 496 588 357],796,5,3863,4.003108808290156,40.0,0.0
20965,2,965,[318 111  50  95  56],450,4,3867,4.003105590062112,20.0,20.0
20966,2,966,[ 82  98 385  71 202],504,4,3871,4.003102378490175,0.0,0.0
20967,2,967,[ 56 286 194 271 228],796,4,3875,4.003099173553719,0.0,20.0
20968,2,968,[135  25 318 302 182],535,2,3877,4.001031991744066,20.0,0.0
20969,2,969,[655   7  15  11 588],577,2,3879,3.9989690721649485,0.0,0.0
20970,2,970,[318  98 496 588 357],786,5,3884,4.0,40.0,0.0
20971,2,971,[423 603 294  97  11],716,5,3889,4.001028806584362,20.0,0.0
20972,2,972,[546  64 245 237 357],450,5,3894,4.002055498458376,20.0,0.0
20973,2,973,[318  98 496 588 357],796,5,3899,4.003080082135524,40.0,0.0
20974,2,974,[318  98 496 588 357],18,5,3904,4.004102564102564,40.0,0.0
20975,2,975,[294 161 200 125 181],280,2,3906,4.002049180327869,0.0,0.0
20976,2,976,[111 202 200  50 121],577,4,3910,4.0020470829068575,0.0,20.0
20977,2,977,[318  98 496 588 357],796,5,3915,4.0030674846625764,40.0,0.0
20978,2,978,[403 300 286 118 313],655,1,3916,4.0,0.0,20.0
20979,2,979,[117 483 183 568  64],457,5,3921,4.001020408163265,20.0,0.0
20980,2,980,[318  98 496 588 357],796,5,3926,4.00203873598369,40.0,0.0
20981,2,981,[195 258 180 186 237],504,3,3929,4.0010183299389,0.0,0.0
20982,2,982,[294 194 200 496 121],716,5,3934,4.002034587995931,20.0,0.0
20983,2,983,[318  98 496 588 357],18,5,3939,4.003048780487805,40.0,0.0
20984,2,984,[318  98 496 588 357],330,5,3944,4.004060913705584,40.0,0.0
20985,2,985,[318  98 496 588 357],716,5,3949,4.005070993914807,40.0,0.0
20986,2,986,[318  98 496 588 357],786,5,3954,4.006079027355623,40.0,0.0
20987,2,987,[238 216  64 211 302],707,2,3956,4.004048582995951,20.0,0.0
20988,2,988,[318  98 496 588 357],786,5,3961,4.005055611729019,40.0,0.0
20989,2,989,[265 151 515 127 496],716,5,3966,4.006060606060606,20.0,20.0
20990,2,990,[318  98 496 588 357],786,5,3971,4.007063572149344,40.0,0.0
20991,2,991,[423  95  11 135 655],280,4,3975,4.007056451612903,0.0,0.0
20992,2,992,[318  98 496 588 357],716,5,3980,4.008056394763344,40.0,0.0
20993,2,993,[202 588 200 496 179],450,4,3984,4.00804828973843,20.0,0.0
20994,2,994,[318  98 496 588 357],18,5,3989,4.009045226130653,40.0,0.0
20995,2,995,[318  98 496 588 357],18,5,3994,4.01004016064257,40.0,0.0
20996,2,996,[174  69 222  96 194],450,4,3998,4.010030090270813,0.0,0.0
20997,2,997,[318  98 496 588 357],716,5,4003,4.011022044088176,40.0,0.0
20998,2,998,[143 194 742 195 323],796,3,4006,4.01001001001001,0.0,0.0
20999,2,999,[318  98 496 588 357],450,5,4011,4.011,40.0,0.0
21000,2,1000,[318  98 496 588 357],796,5,4016,4.011988011988012,40.0,0.0
21001,2,1001,[322 603 237  22 234],796,3,4019,4.010978043912176,20.0,0.0
21002,2,1002,[318  98 496 588 357],330,5,4024,4.011964107676969,40.0,0.0
21003,2,1003,[173  28 282 121  88],450,4,4028,4.01195219123506,0.0,0.0
21004,2,1004,[318  98 496 588 357],330,5,4033,4.0129353233830845,40.0,0.0
21005,2,1005,[ 11 597  56 176  98],457,4,4037,4.012922465208748,0.0,0.0
21006,2,1006,[ 82 385   4 153 286],151,2,4039,4.0109235352532275,0.0,20.0
21007,2,1007,[ 28 173 258  71 216],796,4,4043,4.010912698412699,0.0,0.0
21008,2,1008,[318  98 496 588 357],796,5,4048,4.0118929633300295,40.0,0.0
21009,2,1009,[496 168 258  98 180],796,4,4052,4.011881188118812,20.0,0.0
21010,2,1010,[ 96 294 210 196 318],450,4,4056,4.01186943620178,20.0,0.0
21011,2,1011,[181 117 235 273  79],450,3,4059,4.010869565217392,0.0,0.0
21012,2,1012,[603  71 471  79 210],450,3,4062,4.009871668311945,20.0,0.0
21013,2,1013,[603 186 275 318 228],151,5,4067,4.010848126232742,40.0,20.0
21014,2,1014,[435 357 173 265 385],716,4,4071,4.010837438423645,0.0,0.0
21015,2,1015,[318  98 496 588 357],18,5,4076,4.011811023622047,40.0,0.0
21016,2,1016,[318  98 496 588 357],18,5,4081,4.0127826941986235,40.0,0.0
21017,2,1017,[318  98 496 588 357],796,5,4086,4.013752455795678,40.0,0.0
21018,2,1018,[318  98 496 588 357],796,5,4091,4.014720314033366,40.0,0.0
21019,2,1019,[168 111   1 173 194],798,4,4095,4.014705882352941,0.0,0.0
21020,2,1020,[742 183   4   7  70],655,1,4096,4.011753183153771,0.0,0.0
21021,2,1021,[318  98 496 588 357],786,5,4101,4.012720156555773,40.0,0.0
21022,2,1022,[194 202 182 271 151],796,5,4106,4.013685239491691,0.0,0.0
21023,2,1023,[318  98 496 588 357],450,5,4111,4.0146484375,40.0,0.0
21024,2,1024,[318  98 496 588 357],330,5,4116,4.015609756097561,40.0,0.0
21025,2,1025,[215 427 234 135  96],716,3,4119,4.014619883040936,20.0,0.0
21026,2,1026,[318  98 496 588 357],796,5,4124,4.015579357351509,40.0,0.0
21027,2,1027,[318  98 496 588 357],786,5,4129,4.016536964980545,40.0,0.0
21028,2,1028,[318  98 496 588 357],796,5,4134,4.017492711370262,40.0,0.0
21029,2,1029,[302 546 118  64 435],450,4,4138,4.01747572815534,20.0,0.0
21030,2,1030,[318  98 496 588 357],18,5,4143,4.0184287099903,40.0,0.0
21031,2,1031,[318  98 496 588 357],18,5,4148,4.01937984496124,40.0,0.0
21032,2,1032,[181 125  64  56 328],292,3,4151,4.018393030009681,20.0,0.0
21033,2,1033,[597 216 385 196 202],23,2,4153,4.016441005802708,0.0,0.0
21034,2,1034,[318  98 496 588 357],796,5,4158,4.017391304347826,40.0,0.0
21035,2,1035,[318  98 496 588 357],330,5,4163,4.018339768339768,40.0,0.0
21036,2,1036,[211 100 237  50 275],655,2,4165,4.016393442622951,0.0,60.0
21037,2,1037,[318  98 496 588 357],786,5,4170,4.017341040462428,40.0,0.0
21038,2,1038,[318  98 496 588 357],796,5,4175,4.018286814244465,40.0,0.0
21039,2,1039,[318  98 496 588 357],450,5,4180,4.019230769230769,40.0,0.0
21040,2,1040,[153 435 181 269 496],503,3,4183,4.018251681075888,20.0,0.0
21041,2,1041,[423 197 174 318 181],280,2,4185,4.016314779270633,20.0,0.0
21042,2,1042,[318  98 496 588 357],450,5,4190,4.01725790987536,40.0,0.0
21043,2,1043,[ 56 603 202   1 235],450,4,4194,4.017241379310345,20.0,0.0
21044,2,1044,[318  98 496 588 357],330,5,4199,4.0181818181818185,40.0,0.0
21045,2,1045,[318  98 496 588 357],796,5,4204,4.019120458891013,40.0,0.0
21046,2,1046,[318  98 496 588 357],716,5,4209,4.020057306590258,40.0,0.0
21047,2,1047,[483 181 435 173 100],450,4,4213,4.020038167938932,0.0,20.0
21048,2,1048,[176 269 237 173 357],344,4,4217,4.02001906577693,0.0,0.0
21049,2,1049,[318  98 496 588 357],786,5,4222,4.020952380952381,40.0,0.0
21050,2,1050,[ 22 100 471 496 144],450,5,4227,4.021883920076118,20.0,20.0
21051,2,1051,[318  98 496 588 357],18,5,4232,4.022813688212928,40.0,0.0
21052,2,1052,[568 194 168 151 302],269,3,4235,4.021842355175688,0.0,0.0
21053,2,1053,[ 15 117 185 288 204],450,3,4238,4.020872865275142,0.0,0.0
21054,2,1054,[210  71 161 655 222],786,5,4243,4.021800947867298,0.0,0.0
21055,2,1055,[ 50  88 181   8 403],330,5,4248,4.0227272727272725,0.0,20.0
21056,2,1056,[318  98 496 588 357],786,5,4253,4.023651844843898,40.0,0.0
21057,2,1057,[318  98 496 588 357],786,5,4258,4.024574669187145,40.0,0.0
21058,2,1058,[318  98 496 588 357],796,5,4263,4.025495750708215,40.0,0.0
21059,2,1059,[ 50 748 245 144 286],280,1,4264,4.022641509433963,0.0,40.0
21060,2,1060,[197  79  15 173 496],450,4,4268,4.0226201696512724,20.0,0.0
21061,2,1061,[318  98 496 588 357],796,5,4273,4.023540489642184,40.0,0.0
21062,2,1062,[302 333 197 435 258],655,1,4274,4.020696142991533,0.0,0.0
21063,2,1063,[322 197 181 144   4],796,3,4277,4.019736842105263,0.0,0.0
21064,2,1064,[357 121 175  98 603],655,3,4280,4.018779342723005,20.0,0.0
21065,2,1065,[318  98 496 588 357],786,5,4285,4.019699812382739,40.0,0.0
21066,2,1066,[161 496  69 144 234],716,3,4288,4.018744142455483,20.0,0.0
21067,2,1067,[211 125 173 427 234],796,3,4291,4.0177902621722845,20.0,0.0
21068,2,1068,[211 546 111 125 174],151,4,4295,4.0177736202058,0.0,0.0
21069,2,1069,[318  98 496 588 357],786,5,4300,4.018691588785047,40.0,0.0
21070,2,1070,[403 423 151 294  96],450,5,4305,4.019607843137255,0.0,0.0
21071,2,1071,[ 50 121 100 132 603],151,4,4309,4.019589552238806,20.0,40.0
21072,2,1072,[318  98 496 588 357],786,5,4314,4.020503261882572,40.0,0.0
21073,2,1073,[318  98 496 588 357],330,5,4319,4.021415270018622,40.0,0.0
21074,2,1074,[318  98 496 588 357],18,5,4324,4.022325581395349,40.0,0.0
21075,2,1075,[318  98 496 588 357],796,5,4329,4.023234200743494,40.0,0.0
21076,2,1076,[ 70 153 216  15  64],330,5,4334,4.02414113277623,20.0,0.0
21077,2,1077,[301 282 508 603 483],655,2,4336,4.022263450834879,20.0,0.0
21078,2,1078,[ 64 328 202 237 161],401,2,4338,4.020389249304912,20.0,0.0
21079,2,1079,[200  89   9 125 228],796,4,4342,4.020370370370371,0.0,0.0
21080,2,1080,[ 97   4 471 483  98],535,3,4345,4.019426456984274,0.0,0.0
21081,2,1081,[318 496 588  98 357],716,5,4350,4.020332717190388,40.0,0.0
21082,2,1082,[318 496 588  98 357],796,5,4355,4.02123730378578,40.0,0.0
21083,2,1083,[318 496 588  98 357],716,5,4360,4.022140221402214,40.0,0.0
21084,2,1084,[ 56 210 200   9  79],151,4,4364,4.022119815668203,0.0,0.0
21085,2,1085,[186 318 202 215   9],457,5,4369,4.023020257826888,20.0,0.0
21086,2,1086,[423 427   9  56 118],151,4,4373,4.022999080036799,20.0,0.0
21087,2,1087,[742 471 405  70 588],457,5,4378,4.023897058823529,0.0,0.0
21088,2,1088,[318 496 588  98 357],330,5,4383,4.024793388429752,40.0,0.0
21089,2,1089,[318 496 588  98 357],716,5,4388,4.0256880733944955,40.0,0.0
21090,2,1090,[204 313 271 238  95],796,4,4392,4.025664527956003,0.0,0.0
21091,2,1091,[318 496 588  98 357],716,5,4397,4.0265567765567765,40.0,0.0
21092,2,1092,[471 200 196 191  69],786,5,4402,4.027447392497713,0.0,0.0
21093,2,1093,[301  82  56 228 265],796,3,4405,4.026508226691042,0.0,0.0
21094,2,1094,[186 286 181 202  89],786,5,4410,4.027397260273973,0.0,20.0
21095,2,1095,[318 496 588  98 357],716,5,4415,4.028284671532846,40.0,0.0
21096,2,1096,[234 216  70 286 237],878,2,4417,4.026435733819508,0.0,20.0
21097,2,1097,[318 496 588  98 357],796,5,4422,4.027322404371585,40.0,0.0
21098,2,1098,[ 12 273 222   4 257],655,1,4423,4.024567788898999,0.0,0.0
21099,2,1099,[318 496 588  98 357],796,5,4428,4.025454545454545,40.0,0.0
21100,2,1100,[289 423 117 265  50],236,2,4430,4.023614895549501,0.0,20.0
21101,2,1101,[322  96 385 204  98],344,3,4433,4.0226860254083485,0.0,0.0
21102,2,1102,[265 235  15 282 186],450,2,4435,4.020852221214868,0.0,0.0
21103,2,1103,[318 496 588  98 357],330,5,4440,4.021739130434782,40.0,0.0
21104,2,1104,[318 496 588  98 357],716,5,4445,4.02262443438914,40.0,0.0
21105,2,1105,[132  56  97 265 175],457,5,4450,4.023508137432188,0.0,0.0
21106,2,1106,[318 496 588  98 357],450,5,4455,4.024390243902439,40.0,0.0
21107,2,1107,[318 496 588  98 357],716,5,4460,4.025270758122744,40.0,0.0
21108,2,1108,[318 496 588  98 357],786,5,4465,4.026149684400361,40.0,0.0
21109,2,1109,[179 176  88  56 245],504,1,4466,4.023423423423424,0.0,0.0
21110,2,1110,[  7 237 483 143 168],450,4,4470,4.023402340234023,0.0,0.0
21111,2,1111,[318 496 588  98 357],786,5,4475,4.024280575539568,40.0,0.0
21112,2,1112,[318 496 588  98 357],330,5,4480,4.0251572327044025,40.0,0.0
21113,2,1113,[204 202  98 187 144],655,2,4482,4.023339317773788,0.0,0.0
21114,2,1114,[318  97 111 588 172],18,3,4485,4.022421524663677,20.0,0.0
21115,2,1115,[318 496 588  98 357],18,5,4490,4.023297491039426,40.0,0.0
21116,2,1116,[318 496 588  98 357],716,5,4495,4.024171888988362,40.0,0.0
21117,2,1117,[318 496 588  98 357],786,5,4500,4.025044722719142,40.0,0.0
21118,2,1118,[423 405 655 603  11],269,3,4503,4.024128686327078,20.0,0.0
21119,2,1119,[210 222 168 173   4],151,5,4508,4.025,0.0,0.0
21120,2,1120,[427 238 111 194 143],389,3,4511,4.024085637823372,20.0,0.0
21121,2,1121,[328 508 132 269 100],655,0,4511,4.020499108734403,0.0,20.0
21122,2,1122,[132 483 176 282   4],796,5,4516,4.021371326803206,0.0,0.0
21123,2,1123,[318 496 588  98 357],796,5,4521,4.022241992882562,40.0,0.0
21124,2,1124,[318 496 588  98 357],330,5,4526,4.0231111111111115,40.0,0.0
21125,2,1125,[187 118 322 125 423],504,3,4529,4.022202486678508,0.0,0.0
21126,2,1126,[174 144 132 471  50],693,3,4532,4.021295474711624,0.0,20.0
21127,2,1127,[318 496 588  98 357],18,5,4537,4.022163120567376,40.0,0.0
21128,2,1128,[318 496 588  98 357],716,5,4542,4.023029229406554,40.0,0.0
21129,2,1129,[318 496 588  98 357],786,5,4547,4.023893805309735,40.0,0.0
21130,2,1130,[318 496 588  98 357],18,5,4552,4.024756852343059,40.0,0.0
21131,2,1131,[742 423  64 191 286],450,5,4557,4.025618374558304,20.0,20.0
21132,2,1132,[117 357  12  82 121],655,1,4558,4.022947925860548,0.0,0.0
21133,2,1133,[318 496 588  98 357],18,5,4563,4.023809523809524,40.0,0.0
21134,2,1134,[318 496 588  98 357],330,5,4568,4.024669603524229,40.0,0.0
21135,2,1135,[234  82 172 174  64],269,1,4569,4.022007042253521,20.0,0.0
21136,2,1136,[ 50 258   9 181 655],878,2,4571,4.020228671943712,0.0,20.0
21137,2,1137,[318 496 588  98 357],18,5,4576,4.021089630931459,40.0,0.0
21138,2,1138,[180  15 288 210 742],457,5,4581,4.021949078138718,0.0,0.0
21139,2,1139,[318 496 588  98 357],716,5,4586,4.02280701754386,40.0,0.0
21140,2,1140,[318 496 588  98 357],716,5,4591,4.023663453111306,40.0,0.0
21141,2,1141,[318 496 588  98 357],716,5,4596,4.024518388791594,40.0,0.0
21142,2,1142,[318 496 588  98 357],796,5,4601,4.025371828521434,40.0,0.0
21143,2,1143,[318 496 588  98 357],716,5,4606,4.026223776223776,40.0,0.0
21144,2,1144,[195 423  64 186 403],450,4,4610,4.026200873362446,20.0,0.0
21145,2,1145,[318 496 588  98 357],18,5,4615,4.027050610820244,40.0,0.0
21146,2,1146,[318 496 588  98 357],716,5,4620,4.0278988666085445,40.0,0.0
21147,2,1147,[ 11 187  82   4 210],256,4,4624,4.02787456445993,0.0,0.0
21148,2,1148,[210 179  15 215 197],655,1,4625,4.025239338555266,0.0,0.0
21149,2,1149,[  9 294 228  69 257],457,3,4628,4.024347826086957,0.0,0.0
21150,2,1150,[161   7  70 174  96],280,4,4632,4.024326672458732,0.0,0.0
21151,2,1151,[216 125 176 210 228],344,4,4636,4.024305555555555,0.0,0.0
21152,2,1152,[318 496 588  98 357],450,5,4641,4.025151777970511,40.0,0.0
21153,2,1153,[100 181 496   4 228],450,4,4645,4.025129982668977,20.0,20.0
21154,2,1154,[318 496 588  98 357],796,5,4650,4.025974025974026,40.0,0.0
21155,2,1155,[187 289 204  12 385],655,1,4651,4.023356401384083,0.0,0.0
21156,2,1156,[427 215 197  50  71],535,5,4656,4.024200518582541,20.0,20.0
21157,2,1157,[318 496 588  98 357],796,5,4661,4.025043177892919,40.0,0.0
21158,2,1158,[302 235 276 496 121],269,2,4663,4.023295944779982,20.0,0.0
21159,2,1159,[318 496 588  98 357],18,5,4668,4.024137931034483,40.0,0.0
21160,2,1160,[318 496 588  98 357],716,5,4673,4.024978466838932,40.0,0.0
21161,2,1161,[427 151 496 196 121],269,3,4676,4.024096385542169,40.0,0.0
21162,2,1162,[318 496 588  98 357],786,5,4681,4.024935511607911,40.0,0.0
21163,2,1163,[168   4 238 216 265],450,4,4685,4.024914089347079,0.0,0.0
21164,2,1164,[318 496 588  98 357],450,5,4690,4.0257510729613735,40.0,0.0
21165,2,1165,[132 202 176 168 301],796,4,4694,4.025728987993139,0.0,0.0
21166,2,1166,[ 25  28 196 333 328],655,0,4694,4.022279348757498,0.0,0.0
21167,2,1167,[273 496 180 603  82],450,3,4697,4.021404109589041,40.0,0.0
21168,2,1168,[318 496 588  98 357],786,5,4702,4.02224123182207,40.0,0.0
21169,2,1169,[313 172 423 144  25],593,4,4706,4.022222222222222,0.0,0.0
21170,2,1170,[318 496 588  98 357],796,5,4711,4.023057216054654,40.0,0.0
21171,2,1171,[127  88   7 172 174],344,4,4715,4.023037542662116,0.0,20.0
21172,2,1172,[318 496 588  98 357],18,5,4720,4.023870417732311,40.0,0.0
21173,2,1173,[318 496 588  98 357],450,5,4725,4.024701873935264,40.0,0.0
21174,2,1174,[161 197 245 405  15],450,4,4729,4.02468085106383,0.0,0.0
21175,2,1175,[318 496 588  98 357],786,5,4734,4.025510204081633,40.0,0.0
21176,2,1176,[234 385  25  88 118],593,3,4737,4.0246389124893795,0.0,0.0
21177,2,1177,[  1 196 288 125 100],450,4,4741,4.024617996604414,0.0,20.0
21178,2,1178,[318 496 588  98 357],450,5,4746,4.025445292620865,40.0,0.0
21179,2,1179,[187  64   9 186 211],18,5,4751,4.026271186440678,20.0,0.0
21180,2,1180,[318 496 588  98 357],330,5,4756,4.027095681625741,40.0,0.0
21181,2,1181,[318 496 588  98 357],450,5,4761,4.027918781725888,40.0,0.0
21182,2,1182,[333 273 153 118 196],655,1,4762,4.025359256128487,0.0,0.0
21183,2,1183,[204 121 210 183 174],786,4,4766,4.025337837837838,0.0,0.0
21184,2,1184,[318 496 588  98 357],18,5,4771,4.026160337552743,40.0,0.0
21185,2,1185,[318 496 588  98 357],18,5,4776,4.0269814502529515,40.0,0.0
21186,2,1186,[111 210 186 172 100],885,3,4779,4.026116259477675,0.0,20.0
21187,2,1187,[318 496 588  98 357],330,5,4784,4.026936026936027,40.0,0.0
21188,2,1188,[318 496 588  98 357],786,5,4789,4.027754415475189,40.0,0.0
21189,2,1189,[568 269 144 211 151],796,3,4792,4.026890756302521,0.0,0.0
21190,2,1190,[318 496 588  98 357],796,5,4797,4.027707808564232,40.0,0.0
21191,2,1191,[195 234 179 153 185],269,2,4799,4.026006711409396,0.0,0.0
21192,2,1192,[151  50  98  11 121],20,0,4799,4.022632020117351,0.0,20.0
21193,2,1193,[175   7 597 135 403],269,2,4801,4.0209380234505865,0.0,0.0
21194,2,1194,[318 496 588  98 357],796,5,4806,4.021757322175732,40.0,0.0
21195,2,1195,[125 111 174 748 265],436,2,4808,4.0200668896321075,0.0,0.0
21196,2,1196,[318 496 588  98 357],786,5,4813,4.0208855472013365,40.0,0.0
21197,2,1197,[301 179 194   1 181],523,4,4817,4.020868113522537,0.0,0.0
21198,2,1198,[318 496 588  98 357],18,5,4822,4.021684737281068,40.0,0.0
21199,2,1199,[318 496 588  98 357],330,5,4827,4.0225,40.0,0.0
21200,2,1200,[318 496 588  98 357],450,5,4832,4.0233139050791005,40.0,0.0
21201,2,1201,[318 496 588  98 357],450,5,4837,4.024126455906822,40.0,0.0
21202,2,1202,[318 496 588  98 357],450,5,4842,4.024937655860349,40.0,0.0
21203,2,1203,[318 496 588  98 357],786,5,4847,4.025747508305648,40.0,0.0
21204,2,1204,[215 183 483 191   7],911,3,4850,4.024896265560166,0.0,0.0
21205,2,1205,[318 496 588  98 357],796,5,4855,4.025704809286899,40.0,0.0
21206,2,1206,[318 496 588  98 357],716,5,4860,4.026512013256006,40.0,0.0
21207,2,1207,[318 496 588  98 357],716,5,4865,4.027317880794702,40.0,0.0
21208,2,1208,[318 496 588  98 357],716,5,4870,4.0281224152191895,40.0,0.0
21209,2,1209,[269  70 423  25  50],655,1,4871,4.025619834710744,0.0,20.0
21210,2,1210,[313 328  71 204 235],450,3,4874,4.024772914946325,0.0,0.0
21211,2,1211,[ 12 265 603 174 655],151,5,4879,4.025577557755776,20.0,0.0
21212,2,1212,[273 265 742 195 655],450,4,4883,4.0255564715581205,0.0,0.0
21213,2,1213,[318 496 588  98 357],450,5,4888,4.026359143327842,40.0,0.0
21214,2,1214,[318 496 588  98 357],796,5,4893,4.027160493827161,40.0,0.0
21215,2,1215,[318 496 588  98 357],716,5,4898,4.027960526315789,40.0,0.0
21216,2,1216,[655 127 111 276  50],655,3,4901,4.027115858668858,0.0,40.0
21217,2,1217,[ 79 161 385 194 655],716,3,4904,4.026272577996716,0.0,0.0
21218,2,1218,[ 71 195 125 118  96],450,3,4907,4.025430680885972,0.0,0.0
21219,2,1219,[ 97 173 186  82 117],457,5,4912,4.026229508196721,0.0,0.0
21220,2,1220,[318 496 588  98 357],330,5,4917,4.027027027027027,40.0,0.0
21221,2,1221,[186 405 483   4 357],655,2,4919,4.025368248772504,0.0,0.0
21222,2,1222,[655   1 235  79 234],457,4,4923,4.025347506132461,0.0,0.0
21223,2,1223,[423 269 403   7  64],655,1,4924,4.022875816993464,20.0,0.0
21224,2,1224,[318 496 588  98 357],716,5,4929,4.023673469387755,40.0,0.0
21225,2,1225,[423  50 197  71 276],535,4,4933,4.023654159869494,0.0,20.0
21226,2,1226,[111 403 197 194 125],796,4,4937,4.023634881825591,0.0,0.0
21227,2,1227,[318 496 588  98 357],786,5,4942,4.02442996742671,40.0,0.0
21228,2,1228,[318 496 588  98 357],330,5,4947,4.025223759153784,40.0,0.0
21229,2,1229,[318 496 588  98 357],716,5,4952,4.026016260162602,40.0,0.0
21230,2,1230,[174 144 173 271 265],796,5,4957,4.0268074735987005,0.0,0.0
21231,2,1231,[215  56 238  98 176],151,3,4960,4.025974025974026,0.0,0.0
21232,2,1232,[  4 471 265 182 153],655,1,4961,4.023519870235199,0.0,0.0
21233,2,1233,[318 496 588  98 357],716,5,4966,4.024311183144246,40.0,0.0
21234,2,1234,[172 427 228  28   9],72,3,4969,4.0234817813765185,20.0,0.0
21235,2,1235,[318 496 588  98 357],786,5,4974,4.024271844660194,40.0,0.0
21236,2,1236,[ 88 111 161   4 597],450,4,4978,4.0242522231204525,0.0,0.0
21237,2,1237,[318 496 588  98 357],796,5,4983,4.025040387722132,40.0,0.0
21238,2,1238,[302  64   7 185 181],655,3,4986,4.0242130750605325,20.0,0.0
21239,2,1239,[318 496 588  98 357],18,5,4991,4.025,40.0,0.0
21240,2,1240,[265 181 176 427  56],796,5,4996,4.025785656728445,20.0,0.0
21241,2,1241,[318 496 588  98 357],786,5,5001,4.026570048309178,40.0,0.0
21242,2,1242,[161 234 273 228 328],450,3,5004,4.025744167337088,0.0,0.0
21243,2,1243,[180 286 471 187  88],450,5,5009,4.026527331189711,0.0,20.0
21244,2,1244,[210 204 121 286  98],503,2,5011,4.024899598393574,0.0,20.0
21245,2,1245,[127 655 405 357 202],716,5,5016,4.025682182985554,0.0,20.0
21246,2,1246,[318 496 588  98 357],330,5,5021,4.026463512429832,40.0,0.0
21247,2,1247,[318 496 588  98 357],786,5,5026,4.027243589743589,40.0,0.0
21248,2,1248,[318 496 588  98 357],450,5,5031,4.028022417934348,40.0,0.0
21249,2,1249,[ 71  98  79  70 403],450,4,5035,4.028,0.0,0.0
21250,2,1250,[ 96  71 168 313 515],807,4,5039,4.027977617905676,0.0,0.0
21251,2,1251,[276  15 423 204 282],655,1,5040,4.02555910543131,0.0,0.0
21252,2,1252,[318 496 588  98 357],786,5,5045,4.02633679169992,40.0,0.0
21253,2,1253,[318 496 588  98 357],18,5,5050,4.027113237639553,40.0,0.0
21254,2,1254,[318 496 588  98 357],330,5,5055,4.027888446215139,40.0,0.0
21255,2,1255,[118 471   9 222  11],344,2,5057,4.026273885350318,0.0,0.0
21256,2,1256,[318 496 588  98 357],716,5,5062,4.027048528241846,40.0,0.0
21257,2,1257,[245 117 603 300  22],796,4,5066,4.027027027027027,20.0,0.0
21258,2,1258,[143 483  97 182 276],457,5,5071,4.027799841143765,0.0,0.0
21259,2,1259,[318 496 588  98 357],18,5,5076,4.0285714285714285,40.0,0.0
21260,2,1260,[318 496 588  98 357],450,5,5081,4.02934179222839,40.0,0.0
21261,2,1261,[318 496 588  98 357],786,5,5086,4.030110935023772,40.0,0.0
21262,2,1262,[121 125  96 174 196],457,5,5091,4.0308788598574825,0.0,0.0
21263,2,1263,[176  28 132 153  12],450,5,5096,4.031645569620253,0.0,0.0
21264,2,1264,[318 496 588  98 357],786,5,5101,4.032411067193676,40.0,0.0
21265,2,1265,[183  50 655 153  11],655,2,5103,4.030805687203792,0.0,20.0
21266,2,1266,[546 132 228  96 151],716,3,5106,4.029992107340173,0.0,0.0
21267,2,1267,[318 496 588  98 357],450,5,5111,4.030757097791798,40.0,0.0
21268,2,1268,[180  64 294 211 197],796,1,5112,4.028368794326241,20.0,0.0
21269,2,1269,[318 496 588  98 357],786,5,5117,4.029133858267716,40.0,0.0
21270,2,1270,[172 568 161  50 282],280,1,5118,4.026750590086546,0.0,20.0
21271,2,1271,[318 496 588  98 357],716,5,5123,4.02751572327044,40.0,0.0
21272,2,1272,[ 56 515 655  79 118],716,4,5127,4.0274941084053415,0.0,0.0
21273,2,1273,[202 215 174 471 196],639,1,5128,4.025117739403454,0.0,0.0
21274,2,1274,[318 496 588  98 357],330,5,5133,4.025882352941177,40.0,0.0
21275,2,1275,[300  56  50 655  28],655,1,5134,4.023510971786834,0.0,20.0
21276,2,1276,[ 28 427 143 302   8],655,3,5137,4.022709475332811,20.0,0.0
21277,2,1277,[318 496 588  98 357],786,5,5142,4.023474178403756,40.0,0.0
21278,2,1278,[125 318 211  11 118],655,1,5143,4.0211102423768565,20.0,0.0
21279,2,1279,[117  11 215 546 202],577,3,5146,4.0203125,0.0,0.0
21280,2,1280,[  4 127 204   7 271],655,1,5147,4.017954722872756,0.0,20.0
21281,2,1281,[318 496 588  98 357],716,5,5152,4.018720748829953,40.0,0.0
21282,2,1282,[318 496 588  98 357],716,5,5157,4.019485580670304,40.0,0.0
21283,2,1283,[202 132  96 286 318],450,5,5162,4.020249221183801,20.0,20.0
21284,2,1284,[318 496 588  98 357],796,5,5167,4.021011673151751,40.0,0.0
21285,2,1285,[318 496 588  98 357],796,5,5172,4.021772939346812,40.0,0.0
21286,2,1286,[471 435 282 318 588],716,3,5175,4.020979020979021,20.0,0.0
21287,2,1287,[318 496 588  98 357],330,5,5180,4.021739130434782,40.0,0.0
21288,2,1288,[ 56 234 238 118 318],504,1,5181,4.019394879751745,20.0,0.0
21289,2,1289,[ 82  95 515 318 174],18,4,5185,4.01937984496124,20.0,0.0
21290,2,1290,[318 496 588  98 357],450,5,5190,4.020139426800929,40.0,0.0
21291,2,1291,[318 496 588  98 357],450,5,5195,4.0208978328173375,40.0,0.0
21292,2,1292,[357 423 127 197 153],655,2,5197,4.019334880123743,0.0,20.0
21293,2,1293,[318 496 588  98 357],18,5,5202,4.020092735703246,40.0,0.0
21294,2,1294,[318 496 588  98 357],786,5,5207,4.020849420849421,40.0,0.0
21295,2,1295,[186  11 174 496 125],577,4,5211,4.020833333333333,20.0,0.0
21296,2,1296,[135 174 187 496 125],450,4,5215,4.020817270624518,20.0,0.0
21297,2,1297,[318 496 588  98 357],450,5,5220,4.021571648690292,40.0,0.0
21298,2,1298,[ 96 515 182 211 294],655,2,5222,4.020015396458814,0.0,0.0
21299,2,1299,[234 357 185 111 196],457,4,5226,4.02,0.0,0.0
21300,2,1300,[100 204  50 195 182],72,4,5230,4.019984627209839,0.0,40.0
21301,2,1301,[318 496 588  98 357],786,5,5235,4.02073732718894,40.0,0.0
21302,2,1302,[318 496 588  98 357],796,5,5240,4.0214888718342285,40.0,0.0
21303,2,1303,[318 496 588  98 357],786,5,5245,4.022239263803681,40.0,0.0
21304,2,1304,[318 496 588  98 357],716,5,5250,4.022988505747127,40.0,0.0
21305,2,1305,[185 237 215 655 282],719,4,5254,4.022970903522205,0.0,0.0
21306,2,1306,[318 496 588  98 357],796,5,5259,4.02371843917368,40.0,0.0
21307,2,1307,[276 210 121  69   1],344,2,5261,4.02217125382263,0.0,0.0
21308,2,1308,[318 496 588  98 357],330,5,5266,4.022918258212376,40.0,0.0
21309,2,1309,[144 100 135 195 655],629,5,5271,4.023664122137404,0.0,20.0
21310,2,1310,[328 275 132 302   1],655,2,5273,4.022120518688024,0.0,20.0
21311,2,1311,[ 11  15  98  96 742],256,5,5278,4.022865853658536,0.0,0.0
21312,2,1312,[228 144 403 288 748],450,4,5282,4.022848438690023,0.0,0.0
21313,2,1313,[ 12 151 194 294 483],707,3,5285,4.0220700152207005,0.0,0.0
21314,2,1314,[318 496 588  98 357],716,5,5290,4.022813688212928,40.0,0.0
21315,2,1315,[318 496 588  98 357],796,5,5295,4.02355623100304,40.0,0.0
21316,2,1316,[318 496 588  98 357],786,5,5300,4.024297646165528,40.0,0.0
21317,2,1317,[483 471 258 135 423],535,4,5304,4.024279210925645,0.0,0.0
21318,2,1318,[318 496 588  98 357],18,5,5309,4.025018953752843,40.0,0.0
21319,2,1319,[318 496 588  98 357],18,5,5314,4.025757575757575,40.0,0.0
21320,2,1320,[655 216 168  97 195],796,3,5317,4.024981074943224,0.0,0.0
21321,2,1321,[318 496 588  98 357],18,5,5322,4.0257186081694405,40.0,0.0
21322,2,1322,[282  97 127  82 111],655,1,5323,4.023431594860166,0.0,20.0
21323,2,1323,[185 172 257 603 435],655,3,5326,4.022658610271903,20.0,0.0
21324,2,1324,[ 12  70 508 211 403],655,0,5326,4.019622641509434,0.0,0.0
21325,2,1325,[318 496 588  98 357],450,5,5331,4.020361990950226,40.0,0.0
21326,2,1326,[ 70 153 195 187   9],269,2,5333,4.018839487565939,0.0,0.0
21327,2,1327,[318 496 588  98 357],330,5,5338,4.019578313253012,40.0,0.0
21328,2,1328,[234 202 471 423 235],716,3,5341,4.018811136192626,0.0,0.0
21329,2,1329,[427 204 435 194  56],236,3,5344,4.018045112781955,20.0,0.0
21330,2,1330,[318 496 588  98 357],786,5,5349,4.018782870022539,40.0,0.0
21331,2,1331,[289 121 273 748 151],938,3,5352,4.018018018018018,0.0,0.0
21332,2,1332,[318 496 588  98 357],330,5,5357,4.018754688672168,40.0,0.0
21333,2,1333,[289 187 288 121 172],655,2,5359,4.017241379310345,0.0,0.0
21334,2,1334,[200  22 423 238 127],716,5,5364,4.0179775280898875,0.0,20.0
21335,2,1335,[151  98 181 423  11],577,4,5368,4.017964071856287,0.0,0.0
21336,2,1336,[282 191 237  28 328],450,5,5373,4.018698578908003,0.0,0.0
21337,2,1337,[318 496 588  98 357],18,5,5378,4.019431988041854,40.0,0.0
21338,2,1338,[181 546  97  50 211],236,3,5381,4.018670649738611,0.0,20.0
21339,2,1339,[405 121 508  88 100],401,2,5383,4.017164179104477,0.0,20.0
21340,2,1340,[318 496 588  98 357],18,5,5388,4.017897091722595,40.0,0.0
21341,2,1341,[318 496 588  98 357],786,5,5393,4.018628912071535,40.0,0.0
21342,2,1342,[318 496 588  98 357],716,5,5398,4.019359642591214,40.0,0.0
21343,2,1343,[ 69 471 185  11 275],655,2,5400,4.017857142857143,0.0,20.0
21344,2,1344,[385   4  79 100 172],151,3,5403,4.017100371747212,0.0,20.0
21345,2,1345,[748 286  12 117 235],280,4,5407,4.017087667161961,0.0,20.0
21346,2,1346,[318 496 588  98 357],330,5,5412,4.017817371937639,40.0,0.0
21347,2,1347,[176 483  79 144 294],902,4,5416,4.017804154302671,0.0,0.0
21348,2,1348,[318 496 588  98 357],716,5,5421,4.0185322461082285,40.0,0.0
21349,2,1349,[100   4 183  22 301],450,4,5425,4.018518518518518,0.0,20.0
21350,2,1350,[318 496 588  98 357],796,5,5430,4.019245003700962,40.0,0.0
21351,2,1351,[318 496 588  98 357],18,5,5435,4.019970414201183,40.0,0.0
21352,2,1352,[183 202  11 235  56],450,4,5439,4.019955654101995,0.0,0.0
21353,2,1353,[318 496 588  98 357],330,5,5444,4.020679468242245,40.0,0.0
21354,2,1354,[357 275 176 471 135],457,5,5449,4.021402214022141,0.0,20.0
21355,2,1355,[100 172 323 173 588],796,3,5452,4.020648967551622,0.0,20.0
21356,2,1356,[143 135   8 288 161],655,2,5454,4.019159911569639,0.0,0.0
21357,2,1357,[179 210   4 475 496],389,4,5458,4.019145802650957,20.0,0.0
21358,2,1358,[318 496 588  98 357],18,5,5463,4.0198675496688745,40.0,0.0
21359,2,1359,[  9  22 127 276 357],18,5,5468,4.020588235294118,0.0,20.0
21360,2,1360,[318 496 588  98 357],716,5,5473,4.0213078618662745,40.0,0.0
21361,2,1361,[318 496 588  98 357],450,5,5478,4.022026431718062,40.0,0.0
21362,2,1362,[318 496 588  98 357],450,5,5483,4.022743947175348,40.0,0.0
21363,2,1363,[318 496 588  98 357],18,5,5488,4.023460410557185,40.0,0.0
21364,2,1364,[748   9 301 186  64],151,4,5492,4.023443223443223,20.0,0.0
21365,2,1365,[318 496 588  98 357],796,5,5497,4.024158125915081,40.0,0.0
21366,2,1366,[276 269 118 204 405],344,3,5500,4.023408924652524,0.0,0.0
21367,2,1367,[318 496 588  98 357],716,5,5505,4.024122807017544,40.0,0.0
21368,2,1368,[318 496 588  98 357],796,5,5510,4.024835646457268,40.0,0.0
21369,2,1369,[135 143  69  28 211],655,2,5512,4.023357664233576,0.0,0.0
21370,2,1370,[111 257 483 187 172],716,4,5516,4.023340627279358,0.0,0.0
21371,2,1371,[186 496 182 173 238],269,3,5519,4.022594752186589,20.0,0.0
21372,2,1372,[151 187 202 588  82],450,4,5523,4.02257829570284,0.0,0.0
21373,2,1373,[100 117 403  88 385],457,5,5528,4.023289665211062,0.0,20.0
21374,2,1374,[318 496 588  98 357],716,5,5533,4.024,40.0,0.0
21375,2,1375,[153 282 174  88 508],401,2,5535,4.022529069767442,0.0,0.0
21376,2,1376,[318 496 588  98 357],450,5,5540,4.02323892519971,40.0,0.0
21377,2,1377,[135   8 174  71  50],389,4,5544,4.02322206095791,0.0,20.0
21378,2,1378,[318 496 588  98 357],330,5,5549,4.0239303843364755,40.0,0.0
21379,2,1379,[318 496 588  98 357],18,5,5554,4.024637681159421,40.0,0.0
21380,2,1380,[318 496 588  98 357],786,5,5559,4.025343953656771,40.0,0.0
21381,2,1381,[ 15 186 121 161 151],450,2,5561,4.023878437047757,0.0,0.0
21382,2,1382,[318 496 588  98 357],450,5,5566,4.024584237165582,40.0,0.0
21383,2,1383,[405  98  96 313 186],655,2,5568,4.023121387283237,0.0,0.0
21384,2,1384,[742 568 153 185 121],450,4,5572,4.0231046931407946,0.0,0.0
21385,2,1385,[174 196 151 202 405],23,2,5574,4.021645021645021,0.0,0.0
21386,2,1386,[496 603  28 174 273],450,4,5578,4.0216294160057675,40.0,0.0
21387,2,1387,[258 271 202  89 742],796,4,5582,4.021613832853026,0.0,0.0
21388,2,1388,[204 215 655  11 181],450,5,5587,4.022318214542836,0.0,0.0
21389,2,1389,[318 496 588  98 357],450,5,5592,4.023021582733813,40.0,0.0
21390,2,1390,[318 496 588  98 357],716,5,5597,4.02372393961179,40.0,0.0
21391,2,1391,[265 258 237 275 195],457,5,5602,4.024425287356322,0.0,20.0
21392,2,1392,[748 100  25 237 117],450,4,5606,4.024407753050969,0.0,20.0
21393,2,1393,[318 496 588  98 357],450,5,5611,4.025107604017217,40.0,0.0
21394,2,1394,[318 496 588  98 357],450,5,5616,4.025806451612903,40.0,0.0
21395,2,1395,[ 11 100 187 168 191],450,5,5621,4.026504297994269,0.0,20.0
21396,2,1396,[318 496 588  98 357],330,5,5626,4.027201145311381,40.0,0.0
21397,2,1397,[568  15 234  69 183],593,4,5630,4.027181688125894,0.0,0.0
21398,2,1398,[318 496 588  98 357],330,5,5635,4.027877055039314,40.0,0.0
21399,2,1399,[194  12  96 185  98],908,3,5638,4.027142857142858,0.0,0.0
21400,2,1400,[151 435 496 179   7],535,5,5643,4.027837259100642,20.0,0.0
21401,2,1401,[121 318 405 423 508],269,3,5646,4.0271041369472185,20.0,0.0
21402,2,1402,[318 496 588  98 357],18,5,5651,4.027797576621525,40.0,0.0
21403,2,1403,[174 179 187  25  88],18,3,5654,4.027065527065527,0.0,0.0
21404,2,1404,[318 496 588  98 357],716,5,5659,4.027758007117438,40.0,0.0
21405,2,1405,[318 496 588  98 357],796,5,5664,4.028449502133713,40.0,0.0
21406,2,1406,[318 496 588  98 357],330,5,5669,4.029140014214641,40.0,0.0
21407,2,1407,[238  89 471 333  64],655,2,5671,4.027698863636363,20.0,0.0
21408,2,1408,[161  95 185 597 127],450,4,5675,4.027679205110007,0.0,20.0
21409,2,1409,[182 655  50 161 204],72,4,5679,4.027659574468085,0.0,20.0
21410,2,1410,[204   1 187 200 180],796,3,5682,4.026931254429483,0.0,0.0
21411,2,1411,[127 135 333 423  64],693,2,5684,4.025495750708215,20.0,20.0
21412,2,1412,[211 125 265 118 181],796,4,5688,4.025477707006369,0.0,0.0
21413,2,1413,[471  12 202 132 289],655,0,5688,4.0226308345120225,0.0,0.0
21414,2,1414,[318 496 588  98 357],450,5,5693,4.023321554770318,40.0,0.0
21415,2,1415,[405 245 423  95 655],885,3,5696,4.022598870056497,0.0,0.0
21416,2,1416,[ 70 302 288 151 174],344,4,5700,4.0225829216654905,0.0,0.0
21417,2,1417,[318 496 588  98 357],716,5,5705,4.02327221438646,40.0,0.0
21418,2,1418,[ 22 179 195 197 234],18,3,5708,4.022551092318534,0.0,0.0
21419,2,1419,[318 496 588  98 357],18,5,5713,4.023239436619718,40.0,0.0
21420,2,1420,[318 496 588  98 357],786,5,5718,4.023926812104152,40.0,0.0
21421,2,1421,[483 435  70  82 200],151,3,5721,4.023206751054852,0.0,0.0
21422,2,1422,[318 496 588  98 357],330,5,5726,4.0238931834153195,40.0,0.0
21423,2,1423,[318 496 588  98 357],450,5,5731,4.024578651685394,40.0,0.0
21424,2,1424,[181 172 288  88   7],256,4,5735,4.024561403508772,0.0,0.0
21425,2,1425,[318 496 588  98 357],786,5,5740,4.0252454417952315,40.0,0.0
21426,2,1426,[228  88 288 173 275],457,5,5745,4.025928521373511,0.0,20.0
21427,2,1427,[318 496 588  98 357],786,5,5750,4.026610644257703,40.0,0.0
21428,2,1428,[ 82 194  89  88 357],796,4,5754,4.026592022393282,0.0,0.0
21429,2,1429,[200 135  50 275 405],457,5,5759,4.027272727272727,0.0,40.0
21430,2,1430,[318 496 588  98 357],330,5,5764,4.02795248078267,40.0,0.0
21431,2,1431,[288 286 111 174 405],450,4,5768,4.027932960893855,0.0,20.0
21432,2,1432,[318 496 588  98 357],450,5,5773,4.028611304954641,40.0,0.0
21433,2,1433,[318 496 588  98 357],786,5,5778,4.02928870292887,40.0,0.0
21434,2,1434,[318 496 588  98 357],796,5,5783,4.029965156794425,40.0,0.0
21435,2,1435,[132 603 195 151 405],450,5,5788,4.030640668523677,20.0,0.0
21436,2,1436,[333 273   9 143 318],796,3,5791,4.0299234516353515,20.0,0.0
21437,2,1437,[405 216 655  56 132],716,5,5796,4.0305980528511824,0.0,0.0
21438,2,1438,[143 172  50   7 100],23,4,5800,4.030576789437109,0.0,40.0
21439,2,1439,[211 265 568 200  88],450,4,5804,4.030555555555556,0.0,0.0
21440,2,1440,[ 64  50  88 161 153],655,2,5806,4.029146426092991,20.0,20.0
21441,2,1441,[318 496 588  98 357],716,5,5811,4.029819694868238,40.0,0.0
21442,2,1442,[318 496 588  98 357],786,5,5816,4.030492030492031,40.0,0.0
21443,2,1443,[265 161 282  82  69],457,5,5821,4.031163434903047,0.0,0.0
21444,2,1444,[318 496 588  98 357],450,5,5826,4.031833910034602,40.0,0.0
21445,2,1445,[318 496 588  98 357],716,5,5831,4.032503457814661,40.0,0.0
21446,2,1446,[135 197 301  12 144],629,4,5835,4.0324809951624045,0.0,0.0
21447,2,1447,[318 496 588  98 357],716,5,5840,4.033149171270718,40.0,0.0
21448,2,1448,[318 496 588  98 357],330,5,5845,4.033816425120773,40.0,0.0
21449,2,1449,[ 98 237 300 322 403],450,5,5850,4.0344827586206895,0.0,0.0
21450,2,1450,[ 69 496 235 175 176],344,3,5853,4.033769813921434,20.0,0.0
21451,2,1451,[318 496 588  98 357],450,5,5858,4.034435261707989,40.0,0.0
21452,2,1452,[318 496 588  98 357],18,5,5863,4.035099793530626,40.0,0.0
21453,2,1453,[245 161 568   7  12],280,3,5866,4.034387895460798,0.0,0.0
21454,2,1454,[318 496 588  98 357],330,5,5871,4.0350515463917525,40.0,0.0
21455,2,1455,[427 405 748 423 515],807,5,5876,4.035714285714286,20.0,0.0
21456,2,1456,[161 175  22 195 117],655,0,5876,4.0329444063143445,0.0,0.0
21457,2,1457,[318 496 588  98 357],796,5,5881,4.0336076817558295,40.0,0.0
21458,2,1458,[318 496 588  98 357],716,5,5886,4.034270047978067,40.0,0.0
21459,2,1459,[318 496 588  98 357],18,5,5891,4.034931506849315,40.0,0.0
21460,2,1460,[318 496 588  98 357],330,5,5896,4.035592060232717,40.0,0.0
21461,2,1461,[318 496 588  98 357],786,5,5901,4.03625170998632,40.0,0.0
21462,2,1462,[318 496 588  98 357],796,5,5906,4.0369104579630894,40.0,0.0
21463,2,1463,[318 496 588  98 357],786,5,5911,4.037568306010929,40.0,0.0
21464,2,1464,[655   9 515 197 471],401,3,5914,4.036860068259386,0.0,0.0
21465,2,1465,[318 496 588  98 357],450,5,5919,4.0375170532060025,40.0,0.0
21466,2,1466,[318 496 588  98 357],786,5,5924,4.038173142467621,40.0,0.0
21467,2,1467,[ 79 655  25  98 265],72,5,5929,4.0388283378746594,0.0,0.0
21468,2,1468,[318 496 588  98 357],786,5,5934,4.039482641252553,40.0,0.0
21469,2,1469,[172 191 301 151 357],151,4,5938,4.039455782312925,0.0,0.0
21470,2,1470,[318 496 588  98 357],786,5,5943,4.040108769544528,40.0,0.0
21471,2,1471,[655   1 210  96 118],72,4,5947,4.040081521739131,0.0,0.0
21472,2,1472,[318 496 588  98 357],716,5,5952,4.040733197556008,40.0,0.0
21473,2,1473,[318 496 588  98 357],450,5,5957,4.041383989145183,40.0,0.0
21474,2,1474,[333 211  64  79 100],655,2,5959,4.04,20.0,20.0
21475,2,1475,[318 496 588  98 357],786,5,5964,4.040650406504065,40.0,0.0
21476,2,1476,[318 496 588  98 357],330,5,5969,4.041299932295193,40.0,0.0
21477,2,1477,[179  95 222 603 328],450,3,5972,4.040595399188092,20.0,0.0
21478,2,1478,[318 496 588  98 357],786,5,5977,4.041244083840433,40.0,0.0
21479,2,1479,[168 282 328  98   8],796,5,5982,4.041891891891892,0.0,0.0
21480,2,1480,[ 50 181  11  71 153],401,0,5982,4.039162727886563,0.0,20.0
21481,2,1481,[483 216 153 655 222],450,3,5985,4.038461538461538,0.0,0.0
21482,2,1482,[183 568  22 153  56],796,5,5990,4.0391099123398515,0.0,0.0
21483,2,1483,[300 427 210 118 302],655,2,5992,4.037735849056604,20.0,0.0
21484,2,1484,[318 496 588  98 357],796,5,5997,4.038383838383838,40.0,0.0
21485,2,1485,[176  15 100 588 196],389,3,6000,4.037685060565276,0.0,20.0
21486,2,1486,[318 496 588  98 357],796,5,6005,4.038332212508406,40.0,0.0
21487,2,1487,[318 496 588  98 357],716,5,6010,4.038978494623656,40.0,0.0
21488,2,1488,[318 496 588  98 357],786,5,6015,4.039623908663533,40.0,0.0
21489,2,1489,[328 216 357 176 300],450,5,6020,4.040268456375839,0.0,0.0
21490,2,1490,[318 496 588  98 357],450,5,6025,4.040912139503689,40.0,0.0
21491,2,1491,[197 234 496  97  71],942,5,6030,4.041554959785523,20.0,0.0
21492,2,1492,[318 496 588  98 357],330,5,6035,4.042196918955124,40.0,0.0
21493,2,1493,[318 496 588  98 357],18,5,6040,4.042838018741633,40.0,0.0
21494,2,1494,[318 496 588  98 357],786,5,6045,4.043478260869565,40.0,0.0
21495,2,1495,[ 98 238 183 216 204],504,2,6047,4.0421122994652405,0.0,0.0
21496,2,1496,[125 271 215 200 313],655,2,6049,4.040748162992652,0.0,0.0
21497,2,1497,[318 496 588  98 357],786,5,6054,4.041388518024032,40.0,0.0
21498,2,1498,[475 216 135 121 197],269,3,6057,4.040693795863909,0.0,0.0
21499,2,1499,[496  25  98   8 127],503,5,6062,4.041333333333333,20.0,20.0
21500,2,1500,[153 234 483 357 117],796,4,6066,4.04130579613591,0.0,0.0
21501,2,1501,[  8 153 196 288 211],655,0,6066,4.03861517976032,0.0,0.0
21502,2,1502,[318 496 588  98 357],330,5,6071,4.039254823685962,40.0,0.0
21503,2,1503,[318 496 588  98 357],786,5,6076,4.039893617021277,40.0,0.0
21504,2,1504,[265 546   9 204 286],280,4,6080,4.039867109634551,0.0,20.0
21505,2,1505,[318 496 588  98 357],330,5,6085,4.04050464807437,40.0,0.0
21506,2,1506,[318 496 588  98 357],450,5,6090,4.041141340411413,40.0,0.0
21507,2,1507,[318 496 588  98 357],786,5,6095,4.041777188328912,40.0,0.0
21508,2,1508,[234 302  79 237 322],450,4,6099,4.041749502982108,0.0,0.0
21509,2,1509,[597  11 588 100 196],457,4,6103,4.041721854304636,0.0,20.0
21510,2,1510,[318 496 588  98 357],450,5,6108,4.042356055592323,40.0,0.0
21511,2,1511,[318 496 588  98 357],18,5,6113,4.042989417989418,40.0,0.0
21512,2,1512,[318 496 588  98 357],786,5,6118,4.043621943159287,40.0,0.0
21513,2,1513,[318 496 588  98 357],716,5,6123,4.044253632760898,40.0,0.0
21514,2,1514,[200 195 135 168 483],18,1,6124,4.042244224422443,0.0,0.0
21515,2,1515,[195  98 117  79 483],457,5,6129,4.0428759894459105,0.0,0.0
21516,2,1516,[318 496 588  98 357],450,5,6134,4.043506921555702,40.0,0.0
21517,2,1517,[318 496 588  98 357],18,5,6139,4.044137022397892,40.0,0.0
21518,2,1518,[318 496 588  98 357],716,5,6144,4.04476629361422,40.0,0.0
21519,2,1519,[204  50 125   7  95],577,4,6148,4.044736842105263,0.0,20.0
21520,2,1520,[318 496 588  98 357],716,5,6153,4.045364891518737,40.0,0.0
21521,2,1521,[318 496 588  98 357],450,5,6158,4.045992115637319,40.0,0.0
21522,2,1522,[ 50 405  88 210 403],450,4,6162,4.045961917268549,0.0,20.0
21523,2,1523,[318 174 172 222 117],786,5,6167,4.046587926509186,20.0,0.0
21524,2,1524,[318 496 588  98 357],18,5,6172,4.047213114754098,40.0,0.0
21525,2,1525,[ 79 228 269 238 135],655,2,6174,4.045871559633028,0.0,0.0
21526,2,1526,[ 69 483 127 168 234],457,5,6179,4.046496398166339,0.0,20.0
21527,2,1527,[ 82 427 181 153 237],716,5,6184,4.047120418848167,20.0,0.0
21528,2,1528,[318 496 588  98 357],450,5,6189,4.047743623283192,40.0,0.0
21529,2,1529,[568  50 222 144 405],280,0,6189,4.045098039215686,0.0,20.0
21530,2,1530,[100 196 322 228 151],450,5,6194,4.045721750489876,0.0,20.0
21531,2,1531,[318 496 588  98 357],18,5,6199,4.046344647519582,40.0,0.0
21532,2,1532,[153  28 135   7 322],151,3,6202,4.045662100456621,0.0,0.0
21533,2,1533,[182 172 195   4 153],655,2,6204,4.044328552803129,0.0,0.0
21534,2,1534,[318 496 588  98 357],796,5,6209,4.044951140065146,40.0,0.0
21535,2,1535,[318 496 588  98 357],786,5,6214,4.045572916666667,40.0,0.0
21536,2,1536,[187 235 135 483 318],716,2,6216,4.044242029928432,20.0,0.0
21537,2,1537,[471  56 245  25  71],593,2,6218,4.042912873862159,0.0,0.0
21538,2,1538,[161 228 237 100 328],796,4,6222,4.042884990253412,0.0,20.0
21539,2,1539,[318 496 588  98 357],450,5,6227,4.043506493506493,40.0,0.0
21540,2,1540,[302 322 181 197 200],450,4,6231,4.043478260869565,0.0,0.0
21541,2,1541,[294 200 181 143 127],796,4,6235,4.043450064850843,0.0,20.0
21542,2,1542,[ 22 168  71 210 269],18,4,6239,4.043421905379131,0.0,0.0
21543,2,1543,[151 265 174 423 182],796,5,6244,4.044041450777202,0.0,0.0
21544,2,1544,[117 228 183 191 194],796,5,6249,4.0446601941747575,0.0,0.0
21545,2,1545,[ 95 153  89  50 483],18,4,6253,4.044631306597672,0.0,20.0
21546,2,1546,[318 496 588  98 357],716,5,6258,4.04524886877828,40.0,0.0
21547,2,1547,[ 64 423  70 313 204],450,5,6263,4.045865633074936,20.0,0.0
21548,2,1548,[318 496 588  98 357],796,5,6268,4.046481601032925,40.0,0.0
21549,2,1549,[300 174 117  11 211],693,3,6271,4.045806451612903,0.0,0.0
21550,2,1550,[471   4 197  22 202],280,1,6272,4.043842682140554,0.0,0.0
21551,2,1551,[269 294 176 423 180],796,2,6274,4.042525773195877,0.0,0.0
21552,2,1552,[318 496 588  98 357],330,5,6279,4.043142305215712,40.0,0.0
21553,2,1553,[318 496 588  98 357],330,5,6284,4.043758043758044,40.0,0.0
21554,2,1554,[ 22  28   1  12 496],18,4,6288,4.043729903536978,20.0,0.0
21555,2,1555,[318 496 588  98 357],786,5,6293,4.044344473007712,40.0,0.0
21556,2,1556,[318 496 588  98 357],450,5,6298,4.044958253050739,40.0,0.0
21557,2,1557,[318 496 588  98 357],18,5,6303,4.045571245186136,40.0,0.0
21558,2,1558,[318 496 588  98 357],786,5,6308,4.046183450930084,40.0,0.0
21559,2,1559,[318 496 588  98 357],18,5,6313,4.046794871794872,40.0,0.0
21560,2,1560,[318 496 588  98 357],716,5,6318,4.047405509288917,40.0,0.0
21561,2,1561,[318 496 588  98 357],330,5,6323,4.048015364916774,40.0,0.0
21562,2,1562,[318 496 588  98 357],330,5,6328,4.048624440179142,40.0,0.0
21563,2,1563,[318 496 588  98 357],450,5,6333,4.04923273657289,40.0,0.0
21564,2,1564,[597 117 132  50 276],174,3,6336,4.048562300319489,0.0,20.0
21565,2,1565,[318 496 588  98 357],786,5,6341,4.049169859514687,40.0,0.0
21566,2,1566,[318 496 588  98 357],18,5,6346,4.04977664326739,40.0,0.0
21567,2,1567,[282 211 187  25 300],450,4,6350,4.049744897959184,0.0,0.0
21568,2,1568,[202 237 168 144 121],716,4,6354,4.049713193116634,0.0,0.0
21569,2,1569,[318 496 588  98 357],450,5,6359,4.0503184713375795,40.0,0.0
21570,2,1570,[143 121 294   7 181],450,4,6363,4.0502864417568425,0.0,0.0
21571,2,1571,[318 496 588  98 357],450,5,6368,4.0508905852417305,40.0,0.0
21572,2,1572,[318 496 588  98 357],18,5,6373,4.05149396058487,40.0,0.0
21573,2,1573,[318 496 588  98 357],330,5,6378,4.052096569250318,40.0,0.0
21574,2,1574,[318 496 588  98 357],450,5,6383,4.052698412698413,40.0,0.0
21575,2,1575,[197 182 135 603  89],72,4,6387,4.052664974619289,20.0,0.0
21576,2,1576,[ 79 185 268 515 302],655,4,6391,4.052631578947368,0.0,0.0
21577,2,1577,[269 144 427 234 196],655,1,6392,4.050697084917617,20.0,0.0
21578,2,1578,[318 496 588  98 357],330,5,6397,4.051298290056998,40.0,0.0
21579,2,1579,[318  97  50 508 228],693,2,6399,4.05,20.0,20.0
21580,2,1580,[318 496 588  98 357],330,5,6404,4.050600885515497,40.0,0.0
21581,2,1581,[318 603 179 118 286],450,4,6408,4.0505689001264225,40.0,20.0
21582,2,1582,[318 496 588  98 357],716,5,6413,4.051168667087808,40.0,0.0
21583,2,1583,[318 496 588  98 357],450,5,6418,4.0517676767676765,40.0,0.0
21584,2,1584,[318 496 588  98 357],796,5,6423,4.052365930599369,40.0,0.0
21585,2,1585,[ 28  98 483 132   4],796,4,6427,4.052332912988651,0.0,0.0
21586,2,1586,[  1  50 282  89   4],256,4,6431,4.052299936988028,0.0,20.0
21587,2,1587,[318 496 588  98 357],330,5,6436,4.052896725440806,40.0,0.0
21588,2,1588,[194  95   1  79 151],807,5,6441,4.053492762743864,0.0,0.0
21589,2,1589,[100 496  15 405 322],450,4,6445,4.053459119496855,20.0,20.0
21590,2,1590,[318 496 588  98 357],450,5,6450,4.054054054054054,40.0,0.0
21591,2,1591,[132 175   1 313 301],344,3,6453,4.053391959798995,0.0,0.0
21592,2,1592,[318 496 588  98 357],786,5,6458,4.05398618957941,40.0,0.0
21593,2,1593,[318 496 588  98 357],716,5,6463,4.054579673776662,40.0,0.0
21594,2,1594,[318 496 588  98 357],716,5,6468,4.055172413793104,40.0,0.0
21595,2,1595,[ 56   1 194 275 423],450,5,6473,4.055764411027569,0.0,20.0
21596,2,1596,[318 496 588  98 357],450,5,6478,4.056355666875391,40.0,0.0
21597,2,1597,[172 183 313  82 603],796,4,6482,4.056320400500626,20.0,0.0
21598,2,1598,[258 427 742 185 168],450,5,6487,4.056910569105691,20.0,0.0
21599,2,1599,[173  97  15 471 318],593,4,6491,4.056875,20.0,0.0
21600,2,1600,[ 28 183 100 215 496],577,5,6496,4.057464084946909,20.0,20.0
21601,2,1601,[318 496 588  98 357],330,5,6501,4.058052434456929,40.0,0.0
21602,2,1602,[318 496 588  98 357],786,5,6506,4.058640049906425,40.0,0.0
21603,2,1603,[318 496 588  98 357],796,5,6511,4.059226932668329,40.0,0.0
21604,2,1604,[197 496  69 275  12],18,4,6515,4.059190031152648,20.0,20.0
21605,2,1605,[318 496 588  98 357],330,5,6520,4.059775840597759,40.0,0.0
21606,2,1606,[143 265 748 196  12],450,5,6525,4.060360920970753,0.0,0.0
21607,2,1607,[318 496 588  98 357],786,5,6530,4.060945273631841,40.0,0.0
21608,2,1608,[318 496 588  98 357],330,5,6535,4.06152889993785,40.0,0.0
21609,2,1609,[174 111 168 202 185],450,5,6540,4.062111801242236,0.0,0.0
21610,2,1610,[423 176  64  98  28],796,4,6544,4.0620732464307885,20.0,0.0
21611,2,1611,[ 69 475  95  71 186],389,3,6547,4.061414392059554,0.0,0.0
21612,2,1612,[318 496 588  98 357],716,5,6552,4.061996280223187,40.0,0.0
21613,2,1613,[318 121 588 385 172],796,5,6557,4.062577447335812,20.0,0.0
21614,2,1614,[318 496 588  98 357],450,5,6562,4.063157894736842,40.0,0.0
21615,2,1615,[ 25 603 204 191 322],151,3,6565,4.0625,20.0,0.0
21616,2,1616,[318 496 588  98 357],18,5,6570,4.063079777365492,40.0,0.0
21617,2,1617,[ 22 191 588   4 423],450,4,6574,4.063040791100123,0.0,0.0
21618,2,1618,[187 228 222  15 211],655,1,6575,4.061148857319333,0.0,0.0
21619,2,1619,[385 483 546 323 118],280,3,6578,4.060493827160494,0.0,0.0
21620,2,1620,[196 496 210 132 237],796,4,6582,4.060456508328192,20.0,0.0
21621,2,1621,[318 496 588  98 357],796,5,6587,4.061035758323058,40.0,0.0
21622,2,1622,[268 508 181 265 282],535,2,6589,4.059765865680838,0.0,0.0
21623,2,1623,[265 143 195 216  56],716,4,6593,4.059729064039409,0.0,0.0
21624,2,1624,[318 496 588  98 357],450,5,6598,4.060307692307692,40.0,0.0
21625,2,1625,[318 496 588  98 357],450,5,6603,4.060885608856089,40.0,0.0
21626,2,1626,[655 265 234 172 546],457,4,6607,4.0608481868469575,0.0,0.0
21627,2,1627,[318 496 588  98 357],18,5,6612,4.061425061425061,40.0,0.0
21628,2,1628,[ 15 357 135 202  88],457,5,6617,4.062001227747084,0.0,0.0
21629,2,1629,[318 496 588  98 357],716,5,6622,4.0625766871165645,40.0,0.0
21630,2,1630,[318 496 588  98 357],786,5,6627,4.0631514408338445,40.0,0.0
21631,2,1631,[ 7 70 28 12 69],450,5,6632,4.063725490196078,0.0,0.0
21632,2,1632,[318 496 588  98 357],18,5,6637,4.064298836497245,40.0,0.0
21633,2,1633,[318 216  28 300 385],151,4,6641,4.064259485924112,20.0,0.0
21634,2,1634,[202 100 173 210 187],796,3,6644,4.063608562691131,0.0,20.0
21635,2,1635,[318 496 588  98 357],796,5,6649,4.064180929095355,40.0,0.0
21636,2,1636,[ 56 182 176 318 183],655,3,6652,4.063530849114233,20.0,0.0
21637,2,1637,[318 496 588  98 357],796,5,6657,4.064102564102564,40.0,0.0
21638,2,1638,[318 496 588  98 357],330,5,6662,4.064673581452105,40.0,0.0
21639,2,1639,[269 100 245 322 211],796,0,6662,4.06219512195122,0.0,20.0
21640,2,1640,[ 89 125   1 161 288],450,4,6666,4.062157221206581,0.0,0.0
21641,2,1641,[318 496 588  98 357],716,5,6671,4.06272838002436,40.0,0.0
21642,2,1642,[318 496 588  98 357],796,5,6676,4.063298843578819,40.0,0.0
21643,2,1643,[403 275 200   1 143],655,3,6679,4.06265206812652,0.0,20.0
21644,2,1644,[385 186 597 423 269],450,4,6683,4.062613981762918,0.0,0.0
21645,2,1645,[318 496 588  98 357],330,5,6688,4.06318347509113,40.0,0.0
21646,2,1646,[ 12 187 151 173 200],450,4,6692,4.06314511232544,0.0,0.0
21647,2,1647,[318 496 588  98 357],18,5,6697,4.06371359223301,40.0,0.0
21648,2,1648,[318 496 588  98 357],330,5,6702,4.064281382656155,40.0,0.0
21649,2,1649,[ 97   9 182 568 121],796,3,6705,4.0636363636363635,0.0,0.0
21650,2,1650,[318 496 588  98 357],18,5,6710,4.06420351302241,40.0,0.0
21651,2,1651,[121 196  89 161  28],655,1,6711,4.062348668280872,0.0,0.0
21652,2,1652,[125  56  22 403 176],450,5,6716,4.0629159104658195,0.0,0.0
21653,2,1653,[318 496 588  98 357],450,5,6721,4.0634824667472795,40.0,0.0
21654,2,1654,[180 423  82 127 117],450,4,6725,4.063444108761329,0.0,20.0
21655,2,1655,[ 15 210 111 289 125],655,0,6725,4.060990338164252,0.0,0.0
21656,2,1656,[318 496 588  98 357],18,5,6730,4.061557030778515,40.0,0.0
21657,2,1657,[318 496 588  98 357],786,5,6735,4.0621230398069965,40.0,0.0
21658,2,1658,[ 15  64 125  97 238],796,3,6738,4.061482820976492,20.0,0.0
21659,2,1659,[265 161 471  22 204],577,4,6742,4.06144578313253,0.0,0.0
21660,2,1660,[151 183  79 181 118],716,3,6745,4.060806742925948,0.0,0.0
21661,2,1661,[ 96  95 204 496 234],796,4,6749,4.060770156438027,20.0,0.0
21662,2,1662,[127  15 100  96 172],457,5,6754,4.061334936861094,0.0,40.0
21663,2,1663,[318 496 588  98 357],18,5,6759,4.061899038461538,40.0,0.0
21664,2,1664,[318 496 588  98 357],18,5,6764,4.062462462462462,40.0,0.0
21665,2,1665,[216   8 191 234 588],878,2,6766,4.061224489795919,0.0,0.0
21666,2,1666,[143 318   7   4 204],655,2,6768,4.05998800239952,20.0,0.0
21667,2,1667,[318 496 588  98 357],450,5,6773,4.060551558752998,40.0,0.0
21668,2,1668,[496 423   9  88 318],151,5,6778,4.061114439784302,40.0,0.0
21669,2,1669,[318 496 588  98 357],18,5,6783,4.061676646706587,40.0,0.0
21670,2,1670,[318 496 588  98 357],786,5,6788,4.062238180730102,40.0,0.0
21671,2,1671,[318 496 588  98 357],786,5,6793,4.062799043062201,40.0,0.0
21672,2,1672,[318 496 588  98 357],18,5,6798,4.063359234907352,40.0,0.0
21673,2,1673,[496 153 300 187 258],535,3,6801,4.062724014336918,20.0,0.0
21674,2,1674,[ 97 603  50 276 168],401,3,6804,4.062089552238806,20.0,20.0
21675,2,1675,[ 89 202 182 132  98],269,3,6807,4.06145584725537,0.0,0.0
21676,2,1676,[288 191 210 265  97],450,3,6810,4.0608228980322005,0.0,0.0
21677,2,1677,[318 496 588  98 357],330,5,6815,4.061382598331347,40.0,0.0
21678,2,1678,[318 496 588  98 357],18,5,6820,4.061941631923764,40.0,0.0
21679,2,1679,[268  79 655 100 153],535,3,6823,4.061309523809523,0.0,20.0
21680,2,1680,[318 496 588  98 357],450,5,6828,4.061867935752528,40.0,0.0
21681,2,1681,[182 357 174 161 151],796,5,6833,4.062425683709869,0.0,0.0
21682,2,1682,[318 496 588  98 357],18,5,6838,4.062982768865122,40.0,0.0
21683,2,1683,[132 655 222 195 187],450,4,6842,4.062945368171022,0.0,0.0
21684,2,1684,[318 496 588  98 357],450,5,6847,4.063501483679525,40.0,0.0
21685,2,1685,[318 496 588  98 357],330,5,6852,4.064056939501779,40.0,0.0
21686,2,1686,[318 496 588  98 357],18,5,6857,4.064611736810907,40.0,0.0
21687,2,1687,[318 496 588  98 357],796,5,6862,4.065165876777251,40.0,0.0
21688,2,1688,[202 385 117  95   1],796,4,6866,4.065127294256957,0.0,0.0
21689,2,1689,[318 496 588  98 357],716,5,6871,4.065680473372781,40.0,0.0
21690,2,1690,[318 496 588  98 357],786,5,6876,4.066232998225902,40.0,0.0
21691,2,1691,[318 496 588  98 357],786,5,6881,4.06678486997636,40.0,0.0
21692,2,1692,[318 496 588  98 357],450,5,6886,4.0673360897814534,40.0,0.0
21693,2,1693,[318 496 588  98 357],716,5,6891,4.06788665879575,40.0,0.0
21694,2,1694,[318 496 588  98 357],786,5,6896,4.068436578171092,40.0,0.0
21695,2,1695,[ 22 265 111 238  98],629,5,6901,4.068985849056604,0.0,0.0
21696,2,1696,[318 496 588  98 357],330,5,6906,4.069534472598703,40.0,0.0
21697,2,1697,[197 118  70 168 655],174,3,6909,4.068904593639576,0.0,0.0
21698,2,1698,[588   4 546 211 216],716,3,6912,4.068275456150677,0.0,0.0
21699,2,1699,[318 496 588  98 357],716,5,6917,4.068823529411764,40.0,0.0
21700,2,1700,[181 117 111  96  69],450,5,6922,4.069370958259847,0.0,0.0
21701,2,1701,[185 318 265  89 597],457,4,6926,4.069330199764982,20.0,0.0
21702,2,1702,[318 496 588  98 357],796,5,6931,4.069876688197299,40.0,0.0
21703,2,1703,[300 282  88 245 301],450,5,6936,4.070422535211268,0.0,0.0
21704,2,1704,[117 153 185 143 603],716,5,6941,4.070967741935484,20.0,0.0
21705,2,1705,[ 25 742 288 228 294],450,3,6944,4.070339976553341,0.0,0.0
21706,2,1706,[318 496 588  98 357],18,5,6949,4.070884592852958,40.0,0.0
21707,2,1707,[ 98 268 200 179 151],269,5,6954,4.071428571428571,0.0,0.0
21708,2,1708,[100 483 435 333 286],655,1,6955,4.069631363370392,0.0,40.0
21709,2,1709,[318 496 588  98 357],330,5,6960,4.0701754385964914,40.0,0.0
21710,2,1710,[318 496 588  98 357],330,5,6965,4.070718877849211,40.0,0.0
21711,2,1711,[318 496 588  98 357],330,5,6970,4.071261682242991,40.0,0.0
21712,2,1712,[318 496 588  98 357],796,5,6975,4.071803852889667,40.0,0.0
21713,2,1713,[515 204 423  64 168],18,3,6978,4.071178529754959,20.0,0.0
21714,2,1714,[318 496 588  98 357],796,5,6983,4.071720116618076,40.0,0.0
21715,2,1715,[318 496 588  98 357],330,5,6988,4.072261072261072,40.0,0.0
21716,2,1716,[318 496 588  98 357],450,5,6993,4.072801397786837,40.0,0.0
21717,2,1717,[235  89 546 174  28],450,4,6997,4.072759022118743,0.0,0.0
21718,2,1718,[748 144  71  82 100],796,3,7000,4.072134962187318,0.0,20.0
21719,2,1719,[ 97 194 228 597 403],450,5,7005,4.0726744186046515,0.0,0.0
21720,2,1720,[748 435 235 234  15],450,2,7007,4.071470075537478,0.0,0.0
21721,2,1721,[ 50 181 258  69 144],450,5,7012,4.0720092915214865,0.0,20.0
21722,2,1722,[318 496 588  98 357],786,5,7017,4.072547881601857,40.0,0.0
21723,2,1723,[ 98 288 301 258  22],655,1,7018,4.0707656612529,0.0,0.0
21724,2,1724,[318 496 588  98 357],18,5,7023,4.071304347826087,40.0,0.0
21725,2,1725,[318 496 588  98 357],796,5,7028,4.071842410196988,40.0,0.0
21726,2,1726,[318 496 588  98 357],796,5,7033,4.072379849449913,40.0,0.0
21727,2,1727,[318 496 588  98 357],18,5,7038,4.072916666666667,40.0,0.0
21728,2,1728,[301 273 546 322 294],796,1,7039,4.071139386928861,0.0,0.0
21729,2,1729,[318 496 588  98 357],450,5,7044,4.0716763005780345,40.0,0.0
21730,2,1730,[ 89 187 742 258 328],796,4,7048,4.071634893125361,0.0,0.0
21731,2,1731,[185 191 405   1  88],457,5,7053,4.072170900692841,0.0,0.0
21732,2,1732,[175  22 215  28  96],655,0,7053,4.069821119446047,0.0,0.0
21733,2,1733,[318 496 588  98 357],18,5,7058,4.070357554786621,40.0,0.0
21734,2,1734,[427  98 125 144   1],796,4,7062,4.070317002881844,20.0,0.0
21735,2,1735,[318 496 588  98 357],796,5,7067,4.070852534562212,40.0,0.0
21736,2,1736,[318 496 588  98 357],796,5,7072,4.071387449625791,40.0,0.0
21737,2,1737,[742  98 197 238 204],457,5,7077,4.071921749136939,0.0,0.0
21738,2,1738,[195 546  50 202 210],450,4,7081,4.071880391029327,0.0,20.0
21739,2,1739,[318 496 588  98 357],18,5,7086,4.072413793103448,40.0,0.0
21740,2,1740,[  4  69 168 318  88],796,5,7091,4.072946582423894,20.0,0.0
21741,2,1741,[318 496 588  98 357],796,5,7096,4.073478760045925,40.0,0.0
21742,2,1742,[318 496 588  98 357],18,5,7101,4.074010327022375,40.0,0.0
21743,2,1743,[318 496 588  98 357],716,5,7106,4.0745412844036695,40.0,0.0
21744,2,1744,[  7 200 403 483 179],269,3,7109,4.073925501432665,0.0,0.0
21745,2,1745,[  7 234 265 323 405],256,5,7114,4.074455899198167,0.0,0.0
21746,2,1746,[318 496 588  98 357],330,5,7119,4.074985689753864,40.0,0.0
21747,2,1747,[181  97 172  12  50],450,5,7124,4.075514874141876,0.0,20.0
21748,2,1748,[318 496 588  98 357],796,5,7129,4.076043453401944,40.0,0.0
21749,2,1749,[282  11  50 185 508],655,2,7131,4.074857142857143,0.0,20.0
21750,2,1750,[187 135 132 191 144],450,4,7135,4.074814391776128,0.0,0.0
21751,2,1751,[197 204 153 186 143],269,1,7136,4.073059360730594,0.0,0.0
21752,2,1752,[318 496 588  98 357],330,5,7141,4.0735881346263545,40.0,0.0
21753,2,1753,[182 197 258 268  50],535,3,7144,4.072976054732041,0.0,20.0
21754,2,1754,[318 496 588  98 357],330,5,7149,4.073504273504273,40.0,0.0
21755,2,1755,[318 496 588  98 357],18,5,7154,4.074031890660592,40.0,0.0
21756,2,1756,[318 496 588  98 357],330,5,7159,4.07455890722823,40.0,0.0
21757,2,1757,[318 496 588  98 357],450,5,7164,4.075085324232082,40.0,0.0
21758,2,1758,[117 322 742 176 357],796,3,7167,4.07447413303013,0.0,0.0
21759,2,1759,[318 496 588  98 357],18,5,7172,4.075,40.0,0.0
21760,2,1760,[191 100 269 174 210],344,5,7177,4.075525269733106,0.0,20.0
21761,2,1761,[ 98 318 100  70 161],280,4,7181,4.0754824063564135,20.0,20.0
21762,2,1762,[318 496 588  98 357],786,5,7186,4.076006806579693,40.0,0.0
21763,2,1763,[318 496 588  98 357],330,5,7191,4.076530612244898,40.0,0.0
21764,2,1764,[318 496 588  98 357],716,5,7196,4.077053824362606,40.0,0.0
21765,2,1765,[385 151 471 435 185],450,5,7201,4.07757644394111,0.0,0.0
21766,2,1766,[655   1 269  98 204],535,3,7204,4.076966610073571,0.0,0.0
21767,2,1767,[121 405 403 182 238],450,4,7208,4.076923076923077,0.0,0.0
21768,2,1768,[318 496 588 357  98],18,5,7213,4.0774448841153195,40.0,0.0
21769,2,1769,[318 496 588 357  98],450,5,7218,4.077966101694916,40.0,0.0
21770,2,1770,[318 496 588 357  98],450,5,7223,4.078486730660644,40.0,0.0
21771,2,1771,[ 82 179 204 197 235],450,3,7226,4.077878103837472,0.0,0.0
21772,2,1772,[196 282 238 257 118],716,3,7229,4.07727016356458,0.0,0.0
21773,2,1773,[318 496 588 357  98],18,5,7234,4.077790304396843,40.0,0.0
21774,2,1774,[318 496 588 357  98],450,5,7239,4.078309859154929,40.0,0.0
21775,2,1775,[ 88  96 181 435 234],716,4,7243,4.0782657657657655,0.0,0.0
21776,2,1776,[318 496 588 357  98],786,5,7248,4.07878446820484,40.0,0.0
21777,2,1777,[  9 202 143  88 216],18,3,7251,4.078177727784027,0.0,0.0
21778,2,1778,[  8 258 210   1 483],457,5,7256,4.078695896571108,0.0,0.0
21779,2,1779,[318 496 588 357  98],716,5,7261,4.079213483146067,40.0,0.0
21780,2,1780,[435 180  79  89 258],450,5,7266,4.079730488489613,0.0,0.0
21781,2,1781,[318 496 588 357  98],796,5,7271,4.080246913580247,40.0,0.0
21782,2,1782,[179  70  15 210 357],269,2,7273,4.079080201906899,0.0,0.0
21783,2,1783,[318 496 588 357  98],716,5,7278,4.079596412556054,40.0,0.0
21784,2,1784,[186   1 328 427 121],655,1,7279,4.0778711484593835,20.0,0.0
21785,2,1785,[318 496 588 357  98],796,5,7284,4.078387458006719,40.0,0.0
21786,2,1786,[117 322 182 144 195],280,2,7286,4.0772243984331284,0.0,0.0
21787,2,1787,[  4 237 211  50 546],593,4,7290,4.077181208053691,0.0,20.0
21788,2,1788,[318 496 588 357  98],716,5,7295,4.07769703745109,40.0,0.0
21789,2,1789,[318 496 588 357  98],786,5,7300,4.078212290502793,40.0,0.0
21790,2,1790,[191  70 265 471  96],457,5,7305,4.078726968174204,0.0,0.0
21791,2,1791,[318 496 588 357  98],330,5,7310,4.079241071428571,40.0,0.0
21792,2,1792,[318 496 588 357  98],450,5,7315,4.079754601226994,40.0,0.0
21793,2,1793,[318 496 588 357  98],796,5,7320,4.080267558528428,40.0,0.0
21794,2,1794,[237 568   8   9  50],655,1,7321,4.078551532033426,0.0,20.0
21795,2,1795,[318 496 588 357  98],786,5,7326,4.079064587973274,40.0,0.0
21796,2,1796,[181 322  25 179 742],450,4,7330,4.079020589872009,0.0,0.0
21797,2,1797,[318 496 588 357  98],450,5,7335,4.079532814238043,40.0,0.0
21798,2,1798,[300  97 603 132 111],450,5,7340,4.080044469149527,20.0,0.0
21799,2,1799,[282 237   1  64 275],655,2,7342,4.078888888888889,20.0,20.0
21800,2,1800,[475  96 435 111 282],655,0,7342,4.076624097723487,0.0,0.0
21801,2,1801,[318 496 588 357  98],450,5,7347,4.077136514983351,40.0,0.0
21802,2,1802,[121 191  96   4 385],796,5,7352,4.077648363838048,0.0,0.0
21803,2,1803,[403  96 197 151 185],504,4,7356,4.07760532150776,0.0,0.0
21804,2,1804,[168 268 181  15   9],269,3,7359,4.077008310249307,0.0,0.0
21805,2,1805,[435 282 471 483 427],450,4,7363,4.076965669988926,20.0,0.0
21806,2,1806,[318 496 588 357  98],450,5,7368,4.0774764803541785,40.0,0.0
21807,2,1807,[121 204 496 597  28],450,4,7372,4.077433628318584,20.0,0.0
21808,2,1808,[318 496 588 357  98],716,5,7377,4.077943615257048,40.0,0.0
21809,2,1809,[271  95 211  89 183],796,4,7381,4.077900552486188,0.0,0.0
21810,2,1810,[318 496 588 357  98],450,5,7386,4.078409718387631,40.0,0.0
21811,2,1811,[318 496 588 357  98],786,5,7391,4.078918322295806,40.0,0.0
21812,2,1812,[318 496 588 357  98],786,5,7396,4.079426365140651,40.0,0.0
21813,2,1813,[100  11  25 173 318],577,4,7400,4.0793825799338475,20.0,20.0
21814,2,1814,[301 268 257   1   7],296,5,7405,4.079889807162535,0.0,0.0
21815,2,1815,[294 143 211 273 333],796,2,7407,4.078744493392071,0.0,0.0
21816,2,1816,[318 496 588 357  98],18,5,7412,4.079251513483764,40.0,0.0
21817,2,1817,[318 496 588 357  98],786,5,7417,4.0797579757975795,40.0,0.0
21818,2,1818,[271  97 282 269 168],796,3,7420,4.0791643760307865,0.0,0.0
21819,2,1819,[318 496 588 357  98],450,5,7425,4.079670329670329,40.0,0.0
21820,2,1820,[742   9  88 300 328],655,0,7425,4.077429983525535,0.0,0.0
21821,2,1821,[132 204  22 172 180],280,3,7428,4.076838638858398,0.0,0.0
21822,2,1822,[322 228 471  89 151],344,3,7431,4.07624794295118,0.0,0.0
21823,2,1823,[318 496 588 357  98],450,5,7436,4.076754385964913,40.0,0.0
21824,2,1824,[427   8 200   1 143],18,4,7440,4.076712328767123,20.0,0.0
21825,2,1825,[318 496 588 357  98],796,5,7445,4.077217962760131,40.0,0.0
21826,2,1826,[318 496 588 357  98],450,5,7450,4.077723043240285,40.0,0.0
21827,2,1827,[ 79 222   7 172 180],457,5,7455,4.078227571115974,0.0,0.0
21828,2,1828,[546 603 423  64 245],796,4,7459,4.0781848004373975,40.0,0.0
21829,2,1829,[234 174 182   9 195],72,5,7464,4.078688524590164,0.0,0.0
21830,2,1830,[318 496 588 357  98],716,5,7469,4.0791916985253955,40.0,0.0
21831,2,1831,[117 181 111 322  71],401,1,7470,4.077510917030568,0.0,0.0
21832,2,1832,[318 496 588 357  98],18,5,7475,4.078014184397163,40.0,0.0
21833,2,1833,[100  98 200   7 385],151,2,7477,4.076881134133043,0.0,20.0
21834,2,1834,[318 496 588 357  98],450,5,7482,4.077384196185286,40.0,0.0
21835,2,1835,[202 318 427  15   8],269,2,7484,4.076252723311547,40.0,0.0
21836,2,1836,[318 496 588 357  98],450,5,7489,4.076755579749592,40.0,0.0
21837,2,1837,[318 496 588 357  98],450,5,7494,4.077257889009793,40.0,0.0
21838,2,1838,[282 111 276  56 288],457,4,7498,4.077215878194671,0.0,0.0
21839,2,1839,[318 496 588 357  98],330,5,7503,4.077717391304348,40.0,0.0
21840,2,1840,[318 496 588 357  98],716,5,7508,4.078218359587181,40.0,0.0
21841,2,1841,[318 496 588 357  98],330,5,7513,4.07871878393051,40.0,0.0
21842,2,1842,[151   1 435 216  28],18,3,7516,4.078133478024959,0.0,0.0
21843,2,1843,[288 215 185  70  82],655,1,7517,4.0764642082429505,0.0,0.0
21844,2,1844,[318 496 588 357  98],18,5,7522,4.076964769647696,40.0,0.0
21845,2,1845,[289 216 121 195 174],693,3,7525,4.076381365113759,0.0,0.0
21846,2,1846,[196 191 215 153 125],18,2,7527,4.075257173795344,0.0,0.0
21847,2,1847,[161 603 100 234 405],269,2,7529,4.074134199134199,20.0,20.0
21848,2,1848,[318 496 588 357  98],786,5,7534,4.074634937804219,40.0,0.0
21849,2,1849,[151 276  96 357 161],269,3,7537,4.074054054054054,0.0,0.0
21850,2,1850,[318 496 588 357  98],330,5,7542,4.074554294975689,40.0,0.0
21851,2,1851,[ 95  22 245 742 496],280,4,7546,4.07451403887689,20.0,0.0
21852,2,1852,[318 496 588 357  98],330,5,7551,4.075013491635186,40.0,0.0
21853,2,1853,[318 496 588 357  98],330,5,7556,4.075512405609493,40.0,0.0
21854,2,1854,[216 151 196 191 475],389,3,7559,4.074932614555256,0.0,0.0
21855,2,1855,[ 79 132 183 385 100],344,4,7563,4.0748922413793105,0.0,20.0
21856,2,1856,[318 496 588 357  98],716,5,7568,4.075390414647281,40.0,0.0
21857,2,1857,[678  96 235  11 222],344,2,7570,4.07427341227126,0.0,0.0
21858,2,1858,[597 135 423 197 435],269,3,7573,4.0736955352339965,0.0,0.0
21859,2,1859,[ 71  64 132 286 215],18,4,7577,4.073655913978494,20.0,20.0
21860,2,1860,[222 174 197 168 153],796,4,7581,4.0736163353036,0.0,0.0
21861,2,1861,[318 496 588 357  98],18,5,7586,4.0741138560687435,40.0,0.0
21862,2,1862,[258 118 111 228 222],655,0,7586,4.071926999463232,0.0,0.0
21863,2,1863,[ 25 603  95  88  28],450,3,7589,4.071351931330472,20.0,0.0
21864,2,1864,[318 496 588 357  98],450,5,7594,4.071849865951743,40.0,0.0
21865,2,1865,[318 496 588 357  98],716,5,7599,4.072347266881029,40.0,0.0
21866,2,1866,[357 182 216 127 111],796,5,7604,4.072844134975897,0.0,20.0
21867,2,1867,[269 153 175 222 282],655,0,7604,4.070663811563169,0.0,0.0
21868,2,1868,[204 144 125 742 196],457,5,7609,4.071161048689139,0.0,0.0
21869,2,1869,[318 496 588 357  98],796,5,7614,4.071657754010695,40.0,0.0
21870,2,1870,[318 496 588 357  98],18,5,7619,4.072153928380545,40.0,0.0
21871,2,1871,[161 423  98 237 144],716,3,7622,4.071581196581197,0.0,0.0
21872,2,1872,[318 496 588 357  98],450,5,7627,4.072076882007474,40.0,0.0
21873,2,1873,[318 496 588 357  98],330,5,7632,4.072572038420491,40.0,0.0
21874,2,1874,[117 191 258 323 257],796,4,7636,4.072533333333333,0.0,0.0
21875,2,1875,[174 181 235 121  98],344,2,7638,4.071428571428571,0.0,0.0
21876,2,1876,[211 273 183  22  12],450,4,7642,4.071390516782099,0.0,0.0
21877,2,1877,[ 98 195 216 515 173],716,4,7646,4.071352502662407,0.0,0.0
21878,2,1878,[405  64  50 194  28],292,4,7650,4.071314529004789,20.0,20.0
21879,2,1879,[ 88 318 302  89   7],269,1,7651,4.06968085106383,20.0,0.0
21880,2,1880,[ 50 151 191 183  97],236,2,7653,4.068580542264753,0.0,20.0
21881,2,1881,[318 496 588 357  98],796,5,7658,4.069075451647183,40.0,0.0
21882,2,1882,[258 180 151  22 268],296,4,7662,4.0690387679235265,0.0,0.0
21883,2,1883,[318 496 588 357  98],18,5,7667,4.0695329087048835,40.0,0.0
21884,2,1884,[173   7 135  28 202],65,3,7670,4.068965517241379,0.0,0.0
21885,2,1885,[318 496 588 357  98],450,5,7675,4.069459172852598,40.0,0.0
21886,2,1886,[300 196 183 318 172],450,5,7680,4.069952305246423,20.0,0.0
21887,2,1887,[245 237 204 176  12],280,1,7681,4.06832627118644,0.0,0.0
21888,2,1888,[172  12 180 195 196],18,2,7683,4.06723133933298,0.0,0.0
21889,2,1889,[318 496 588 357  98],18,5,7688,4.067724867724868,40.0,0.0
21890,2,1890,[318 496 588 357  98],330,5,7693,4.068217874140666,40.0,0.0
21891,2,1891,[318 496 588 357  98],330,5,7698,4.068710359408033,40.0,0.0
21892,2,1892,[234  88 475 603 111],269,2,7700,4.067617538298996,20.0,0.0
21893,2,1893,[318 496 588 357  98],796,5,7705,4.068109820485745,40.0,0.0
21894,2,1894,[181  88  12 195 204],655,0,7705,4.065963060686016,0.0,0.0
21895,2,1895,[318 496 588 357  98],330,5,7710,4.0664556962025316,40.0,0.0
21896,2,1896,[748 151 496 597 228],807,5,7715,4.0669478123352665,20.0,0.0
21897,2,1897,[588 183  11  98 161],280,4,7719,4.066912539515279,0.0,0.0
21898,2,1898,[742  69 196 222 211],796,3,7722,4.0663507109004735,0.0,0.0
21899,2,1899,[ 22 405 191 118 127],716,4,7726,4.066315789473684,0.0,20.0
21900,2,1900,[318 496 588 357  98],450,5,7731,4.066806943713835,40.0,0.0
21901,2,1901,[318 496 588 357  98],450,5,7736,4.067297581493165,40.0,0.0
21902,2,1902,[ 12 186 286 435  70],18,5,7741,4.067787703625854,0.0,20.0
21903,2,1903,[318 496 588 357  98],796,5,7746,4.06827731092437,40.0,0.0
21904,2,1904,[ 82  96 202 302 483],269,1,7747,4.066666666666666,0.0,0.0
21905,2,1905,[180  95 211 483 275],796,3,7750,4.066107030430221,0.0,20.0
21906,2,1906,[ 98 603 748  15 322],450,4,7754,4.066072364971159,20.0,0.0
21907,2,1907,[  4 238  98  89  56],421,4,7758,4.066037735849057,0.0,0.0
21908,2,1908,[185 328 238 257  69],655,1,7759,4.064431639601886,0.0,0.0
21909,2,1909,[318 496 588 357  98],18,5,7764,4.064921465968586,40.0,0.0
21910,2,1910,[302 186 289 385 603],655,2,7766,4.063840920983778,20.0,0.0
21911,2,1911,[318 496 588 357  98],18,5,7771,4.064330543933054,40.0,0.0
21912,2,1912,[ 28 435 318 237 111],450,5,7776,4.064819654992159,20.0,0.0
21913,2,1913,[118  96  95 302  97],344,3,7779,4.064263322884012,0.0,0.0
21914,2,1914,[194 546 265  12 191],457,4,7783,4.064229765013055,0.0,0.0
21915,2,1915,[403  70 195 483   1],18,3,7786,4.0636743215031315,0.0,0.0
21916,2,1916,[ 88 118  89 405 237],457,5,7791,4.0641627543036,0.0,0.0
21917,2,1917,[318 496 588 357  98],330,5,7796,4.064650677789364,40.0,0.0
21918,2,1918,[211 180 168 483 405],796,3,7799,4.064095883272538,0.0,0.0
21919,2,1919,[127 200 195 655 211],236,1,7800,4.0625,0.0,20.0
21920,2,1920,[318 496 588 357  98],796,5,7805,4.062988027069235,40.0,0.0
21921,2,1921,[228 265 100  64 175],457,5,7810,4.0634755463059316,20.0,20.0
21922,2,1922,[318 496 588 357  98],18,5,7815,4.0639625585023404,40.0,0.0
21923,2,1923,[318 496 588 357  98],716,5,7820,4.0644490644490645,40.0,0.0
21924,2,1924,[318 496 588 357  98],716,5,7825,4.064935064935065,40.0,0.0
21925,2,1925,[318 496 588 357  98],796,5,7830,4.065420560747664,40.0,0.0
21926,2,1926,[132 496 168 210 191],18,4,7834,4.065386611312921,20.0,0.0
21927,2,1927,[318 496 588 357  98],450,5,7839,4.065871369294606,40.0,0.0
21928,2,1928,[ 56 282 181 200 176],504,2,7841,4.064800414722654,0.0,0.0
21929,2,1929,[328  96 655 183  64],796,4,7845,4.064766839378239,20.0,0.0
21930,2,1930,[318 496 588 357  98],18,5,7850,4.065251165199379,40.0,0.0
21931,2,1931,[318 496 588 357  98],330,5,7855,4.065734989648033,40.0,0.0
21932,2,1932,[276 202 300 655 196],504,3,7858,4.065183652353854,0.0,0.0
21933,2,1933,[117 357   1 288 269],655,1,7859,4.063598759048604,0.0,0.0
21934,2,1934,[318 496 588 357  98],716,5,7864,4.064082687338502,40.0,0.0
21935,2,1935,[179 144  22 318  56],457,5,7869,4.06456611570248,20.0,0.0
21936,2,1936,[318 496 588 357  98],786,5,7874,4.065049044914817,40.0,0.0
21937,2,1937,[318 496 588 357  98],18,5,7879,4.065531475748194,40.0,0.0
21938,2,1938,[302 603 211 161 222],655,2,7881,4.0644662197008765,20.0,0.0
21939,2,1939,[318 496 588 357  98],716,5,7886,4.064948453608247,40.0,0.0
21940,2,1940,[546 288 294  97 222],256,4,7890,4.0649149922720245,0.0,0.0
21941,2,1941,[318 496 588 357  98],330,5,7895,4.0653964984552005,40.0,0.0
21942,2,1942,[328 187 268  96  11],655,1,7896,4.063818836850231,0.0,0.0
21943,2,1943,[318 496 588 357  98],18,5,7901,4.064300411522634,40.0,0.0
21944,2,1944,[ 11   9  96 144  89],457,5,7906,4.064781491002571,0.0,0.0
21945,2,1945,[318 496 588 357  98],786,5,7911,4.065262076053443,40.0,0.0
21946,2,1946,[318 496 588 357  98],716,5,7916,4.065742167437083,40.0,0.0
21947,2,1947,[153 151 117 289 435],296,2,7918,4.064681724845996,0.0,0.0
21948,2,1948,[318 496 588 357  98],450,5,7923,4.065161621344279,40.0,0.0
21949,2,1949,[173 282 276 275  64],457,5,7928,4.065641025641026,20.0,20.0
21950,2,1950,[568 313 496 742 301],593,5,7933,4.06611993849308,20.0,0.0
21951,2,1951,[197 127  15  98  89],786,3,7936,4.065573770491803,0.0,20.0
21952,2,1952,[ 22 357 286  96 210],450,4,7940,4.065540194572453,0.0,20.0
21953,2,1953,[318 496 588 357  98],18,5,7945,4.066018423746161,40.0,0.0
21954,2,1954,[ 64 403  28 238  98],796,3,7948,4.065473145780051,20.0,0.0
21955,2,1955,[403  88 153 508 173],280,1,7949,4.063905930470348,0.0,0.0
21956,2,1956,[100  98 127 282 423],280,3,7952,4.063362289218191,0.0,40.0
21957,2,1957,[245 234 210   8 655],796,1,7953,4.061797752808989,0.0,0.0
21958,2,1958,[483  50 172  82 179],18,3,7956,4.061255742725881,0.0,20.0
21959,2,1959,[100 294 748 282 427],450,5,7961,4.061734693877551,20.0,20.0
21960,2,1960,[471 237 435 216 202],716,4,7965,4.061703212646609,0.0,0.0
21961,2,1961,[282 234  89 186  88],796,3,7968,4.061162079510703,0.0,0.0
21962,2,1962,[318 496 588 357  98],716,5,7973,4.061640346408558,40.0,0.0
21963,2,1963,[318 496 588 357  98],796,5,7978,4.062118126272912,40.0,0.0
21964,2,1964,[318 496 588 357  98],786,5,7983,4.062595419847328,40.0,0.0
21965,2,1965,[318 496 588 357  98],450,5,7988,4.063072227873856,40.0,0.0
21966,2,1966,[237 180 125 173 200],796,4,7992,4.063040162684291,0.0,0.0
21967,2,1967,[125  88  28 245 176],504,3,7995,4.0625,0.0,0.0
21968,2,1968,[318 496 588 357  98],330,5,8000,4.062976130015236,40.0,0.0
21969,2,1969,[211 333  25 222 427],655,1,8001,4.061421319796954,20.0,0.0
21970,2,1970,[318 496 588 357  98],450,5,8006,4.061897513952308,40.0,0.0
21971,2,1971,[191   8 275  12  71],344,4,8010,4.061866125760649,0.0,20.0
21972,2,1972,[257 118   8   4 655],796,4,8014,4.061834769386721,0.0,0.0
21973,2,1973,[318 496 588 357  98],450,5,8019,4.062310030395137,40.0,0.0
21974,2,1974,[318 496 588 357  98],330,5,8024,4.062784810126582,40.0,0.0
21975,2,1975,[318 496 588 357  98],450,5,8029,4.0632591093117405,40.0,0.0
21976,2,1976,[405 172 294 174  70],716,5,8034,4.063732928679818,0.0,0.0
21977,2,1977,[322  64   1   7  95],344,3,8037,4.06319514661274,20.0,0.0
21978,2,1978,[181 268 121  22 211],655,0,8037,4.061141990904497,0.0,0.0
21979,2,1979,[318 496 588 357  98],18,5,8042,4.061616161616161,40.0,0.0
21980,2,1980,[318 496 588 357  98],796,5,8047,4.062089853609288,40.0,0.0
21981,2,1981,[ 98 172 135 180 286],280,4,8051,4.062058526740666,0.0,20.0
21982,2,1982,[151 196 300 265  97],796,4,8055,4.062027231467473,0.0,0.0
21983,2,1983,[318 496 588 357  98],716,5,8060,4.0625,40.0,0.0
21984,2,1984,[318 496 588 357  98],18,5,8065,4.062972292191436,40.0,0.0
21985,2,1985,[403 176 121 245 423],796,4,8069,4.06294058408862,0.0,0.0
21986,2,1986,[318 496 588 357  98],796,5,8074,4.06341217916457,40.0,0.0
21987,2,1987,[ 96 258 423  56 237],796,5,8079,4.063883299798793,0.0,0.0
21988,2,1988,[318 496 588 357  98],18,5,8084,4.064353946706888,40.0,0.0
21989,2,1989,[ 69  95 742 179 204],450,4,8088,4.064321608040201,0.0,0.0
21990,2,1990,[318 496 588 357  98],18,5,8093,4.064791562029131,40.0,0.0
21991,2,1991,[318 496 588 357  98],786,5,8098,4.065261044176707,40.0,0.0
21992,2,1992,[318 496 588 357  98],330,5,8103,4.0657300551931765,40.0,0.0
21993,2,1993,[318 496 588 357  98],796,5,8108,4.066198595787362,40.0,0.0
21994,2,1994,[175 405 282  70 435],716,3,8111,4.065664160401003,0.0,0.0
21995,2,1995,[318 496 588 357  98],450,5,8116,4.066132264529058,40.0,0.0
21996,2,1996,[  4 216  15 117 125],256,5,8121,4.066599899849774,0.0,0.0
21997,2,1997,[121 144 269 289   9],655,0,8121,4.064564564564565,0.0,0.0
21998,2,1998,[211 742 357 289 215],693,2,8123,4.063531765882941,0.0,0.0
21999,2,1999,[ 50 151 132 100  98],457,5,8128,4.064,0.0,40.0
22000,2,2000,[318 496 588 357  98],18,5,8133,4.064467766116942,40.0,0.0
22001,2,2001,[318 496 588 357  98],786,5,8138,4.064935064935065,40.0,0.0
22002,2,2002,[222 427 294 211 423],796,3,8141,4.064403394907639,20.0,0.0
22003,2,2003,[ 56 181  88 323 100],504,2,8143,4.063373253493014,0.0,20.0
22004,2,2004,[318 496 588 357  98],716,5,8148,4.063840399002494,40.0,0.0
22005,2,2005,[100 302 237   1 187],535,2,8150,4.062811565304088,0.0,20.0
22006,2,2006,[195 144 118 313 143],796,5,8155,4.063278525161933,0.0,0.0
22007,2,2007,[282 185 222 175 234],716,3,8158,4.062749003984064,0.0,0.0
22008,2,2008,[403 176  82 288 742],280,2,8160,4.06172224987556,0.0,0.0
22009,2,2009,[181  22 174  88 471],716,4,8164,4.061691542288557,0.0,0.0
22010,2,2010,[318 496 588 357  98],796,5,8169,4.062158130283441,40.0,0.0
22011,2,2011,[318 496 588 357  98],716,5,8174,4.062624254473161,40.0,0.0
22012,2,2012,[125 216 194 286  82],151,4,8178,4.062593144560358,0.0,20.0
22013,2,2013,[318 496 588 357  98],330,5,8183,4.063058589870904,40.0,0.0
22014,2,2014,[ 28  96 144 153 245],796,3,8186,4.062531017369727,0.0,0.0
22015,2,2015,[234 195 197 118 302],655,1,8187,4.061011904761905,0.0,0.0
22016,2,2016,[471 117   4 588 546],577,3,8190,4.060485870104115,0.0,0.0
22017,2,2017,[121 405 216 515 282],401,2,8192,4.059464816650149,0.0,0.0
22018,2,2018,[318 496 588 357  98],786,5,8197,4.059930658741951,40.0,0.0
22019,2,2019,[238  89   8 211  82],23,4,8201,4.05990099009901,0.0,0.0
22020,2,2020,[318 496 588 357  98],786,5,8206,4.060366155368629,40.0,0.0
22021,2,2021,[197 191 196 357 318],796,4,8210,4.060336300692383,20.0,0.0
22022,2,2022,[318 496 588 357  98],716,5,8215,4.060800790904597,40.0,0.0
22023,2,2023,[132 323 210 174  28],504,5,8220,4.061264822134388,0.0,0.0
22024,2,2024,[200   8  79 127 301],796,4,8224,4.061234567901234,0.0,20.0
22025,2,2025,[318 496 588 357  98],330,5,8229,4.0616979269496545,40.0,0.0
22026,2,2026,[186 435 200 385 111],716,3,8232,4.061174148988653,0.0,0.0
22027,2,2027,[318 496 588 357  98],330,5,8237,4.06163708086785,40.0,0.0
22028,2,2028,[318 496 588 357  98],18,5,8242,4.06209955643174,40.0,0.0
22029,2,2029,[204 286 175  69 216],344,3,8245,4.061576354679803,0.0,20.0
22030,2,2030,[318 496 588 357  98],796,5,8250,4.062038404726736,40.0,0.0
22031,2,2031,[546 172 748 161 200],796,5,8255,4.0625,0.0,0.0
22032,2,2032,[222  50 144 228 269],450,4,8259,4.062469257255287,0.0,20.0
22033,2,2033,[111 300 423  28 475],292,5,8264,4.062930186823992,0.0,0.0
22034,2,2034,[111 318 168  98  69],269,3,8267,4.062407862407863,20.0,0.0
22035,2,2035,[318 496 588 357  98],330,5,8272,4.06286836935167,40.0,0.0
22036,2,2036,[405 318 127 180 222],72,3,8275,4.062346588119784,20.0,20.0
22037,2,2037,[ 89   1 234  56 100],72,4,8279,4.062315996074583,0.0,20.0
22038,2,2038,[238 222   1 174 111],655,0,8279,4.060323688082393,0.0,0.0
22039,2,2039,[318 496 588 357  98],786,5,8284,4.06078431372549,40.0,0.0
22040,2,2040,[483  79 187  22  12],655,3,8287,4.060264576188143,0.0,0.0
22041,2,2041,[318 496 588 357  98],716,5,8292,4.060724779627816,40.0,0.0
22042,2,2042,[273  71 265 204 588],796,4,8296,4.06069505628977,0.0,0.0
22043,2,2043,[282 117 271 300 181],796,5,8301,4.061154598825832,0.0,0.0
22044,2,2044,[318 496 588 357  98],450,5,8306,4.06161369193154,40.0,0.0
22045,2,2045,[318 496 588 357  98],18,5,8311,4.062072336265885,40.0,0.0
22046,2,2046,[286  95 288 282  82],280,3,8314,4.061553492916463,0.0,20.0
22047,2,2047,[318 496 588 357  98],716,5,8319,4.06201171875,40.0,0.0
22048,2,2048,[318 496 588 357  98],330,5,8324,4.062469497315764,40.0,0.0
22049,2,2049,[318 496 588 357  98],796,5,8329,4.062926829268292,40.0,0.0
22050,2,2050,[318 496 588 357  98],716,5,8334,4.063383715260849,40.0,0.0
22051,2,2051,[ 12   4 132 235 228],280,3,8337,4.062865497076023,0.0,0.0
22052,2,2052,[318 496 588 357  98],18,5,8342,4.063321967851924,40.0,0.0
22053,2,2053,[172 423  25 187  98],450,4,8346,4.063291139240507,0.0,0.0
22054,2,2054,[318 496 588 357  98],786,5,8351,4.06374695863747,40.0,0.0
22055,2,2055,[172  88  70 132 265],450,5,8356,4.06420233463035,0.0,0.0
22056,2,2056,[318 496 588 357  98],796,5,8361,4.064657267865824,40.0,0.0
22057,2,2057,[286 182 187   7 603],535,2,8363,4.0636540330417885,20.0,20.0
22058,2,2058,[318 496 588 357  98],330,5,8368,4.064108790675085,40.0,0.0
22059,2,2059,[176 496 183 100 180],450,5,8373,4.0645631067961165,20.0,20.0
22060,2,2060,[ 12 135 143 127 228],693,4,8377,4.064531780688986,0.0,20.0
22061,2,2061,[ 25 196 117 328 385],401,3,8380,4.064015518913676,0.0,0.0
22062,2,2062,[742 588 121 294  96],457,4,8384,4.063984488608822,0.0,0.0
22063,2,2063,[318 496 588 357  98],330,5,8389,4.064437984496124,40.0,0.0
22064,2,2064,[318 496 588 357  98],716,5,8394,4.064891041162228,40.0,0.0
22065,2,2065,[318 496 588 357  98],18,5,8399,4.065343659244918,40.0,0.0
22066,2,2066,[318 496 588 357  98],796,5,8404,4.065795839380745,40.0,0.0
22067,2,2067,[357 546 111  88 273],344,3,8407,4.0652804642166345,0.0,0.0
22068,2,2068,[318 496 588 357  98],786,5,8412,4.065732237796037,40.0,0.0
22069,2,2069,[ 12  89 258  97 194],796,4,8416,4.0657004830917876,0.0,0.0
22070,2,2070,[318 496 588 357  98],330,5,8421,4.06615161757605,40.0,0.0
22071,2,2071,[143 483 151 153 174],18,4,8425,4.066119691119691,0.0,0.0
22072,2,2072,[318 496 588 357  98],786,5,8430,4.066570188133141,40.0,0.0
22073,2,2073,[118 282  96 742  71],504,4,8434,4.066538090646095,0.0,0.0
22074,2,2074,[655 100  97 405  98],655,1,8435,4.065060240963855,0.0,20.0
22075,2,2075,[597 127  96 185 276],269,3,8438,4.064547206165703,0.0,20.0
22076,2,2076,[222 127 234 483 496],280,3,8441,4.0640346653827635,20.0,20.0
22077,2,2077,[318 496 588 357  98],796,5,8446,4.0644850818094325,40.0,0.0
22078,2,2078,[318 496 588 357  98],18,5,8451,4.064935064935065,40.0,0.0
22079,2,2079,[135 100 144 153   1],280,3,8454,4.064423076923077,0.0,20.0
22080,2,2080,[ 64 111 275 228 121],151,5,8459,4.064872657376261,20.0,20.0
22081,2,2081,[318 496 588 357  98],796,5,8464,4.065321805955811,40.0,0.0
22082,2,2082,[187 471 121 269 176],655,1,8465,4.063850216034566,0.0,0.0
22083,2,2083,[118  22 161 210 294],280,2,8467,4.062859884836852,0.0,0.0
22084,2,2084,[318 496 588 357  98],18,5,8472,4.063309352517986,40.0,0.0
22085,2,2085,[185 275 168  98  64],18,3,8475,4.062799616490891,20.0,20.0
22086,2,2086,[318 496 588 357  98],786,5,8480,4.063248682319118,40.0,0.0
22087,2,2087,[318 496 588 357  98],786,5,8485,4.063697318007663,40.0,0.0
22088,2,2088,[181  95 238 235 202],330,5,8490,4.064145524174246,0.0,0.0
22089,2,2089,[318 496 588 357  98],786,5,8495,4.064593301435407,40.0,0.0
22090,2,2090,[328 238  28 185 215],151,3,8498,4.064084170253468,0.0,0.0
22091,2,2091,[210  70 235 238  97],450,3,8501,4.063575525812619,0.0,0.0
22092,2,2092,[435 237 655  25 186],655,0,8501,4.0616340181557575,0.0,0.0
22093,2,2093,[ 25 211 204 118 117],504,3,8504,4.0611270296084045,0.0,0.0
22094,2,2094,[ 79 132 195 286  12],344,4,8508,4.06109785202864,0.0,20.0
22095,2,2095,[357 180  97  96 294],450,5,8513,4.061545801526718,0.0,0.0
22096,2,2096,[ 11 234 508 211 483],655,1,8514,4.060085836909871,0.0,0.0
22097,2,2097,[318 496 588 357  98],786,5,8519,4.060533841754052,40.0,0.0
22098,2,2098,[318 496 588 357  98],18,5,8524,4.060981419723678,40.0,0.0
22099,2,2099,[318 496 588 357  98],786,5,8529,4.061428571428571,40.0,0.0
22100,2,2100,[318 496 588 357  98],18,5,8534,4.061875297477392,40.0,0.0
22101,2,2101,[318 496 588 357  98],450,5,8539,4.062321598477641,40.0,0.0
22102,2,2102,[194 176  12 423 286],11,3,8542,4.061816452686638,0.0,20.0
22103,2,2103,[318 496 588 357  98],18,5,8547,4.062262357414449,40.0,0.0
22104,2,2104,[318 496 588 357  98],716,5,8552,4.06270783847981,40.0,0.0
22105,2,2105,[318 496 588 357  98],18,5,8557,4.06315289648623,40.0,0.0
22106,2,2106,[172 181 125 121 161],457,5,8562,4.06359753203607,0.0,0.0
22107,2,2107,[318 496 588 357  98],18,5,8567,4.064041745730551,40.0,0.0
22108,2,2108,[318 496 588 357  98],450,5,8572,4.064485538169749,40.0,0.0
22109,2,2109,[405 496 403 151  79],807,5,8577,4.064928909952607,20.0,0.0
22110,2,2110,[318 496 588 357  98],18,5,8582,4.0653718616769305,40.0,0.0
22111,2,2111,[515 196 187   4 117],655,2,8584,4.0643939393939394,0.0,0.0
22112,2,2112,[245 210 333 135 288],629,4,8588,4.064363464268812,0.0,0.0
22113,2,2113,[318 496 588 357  98],786,5,8593,4.06480605487228,40.0,0.0
22114,2,2114,[ 79   1 318 282 127],655,3,8596,4.064302600472813,20.0,20.0
22115,2,2115,[182 385 269 427 144],655,2,8598,4.0633270321361055,20.0,0.0
22116,2,2116,[318 496 588 357  98],450,5,8603,4.063769485120454,40.0,0.0
22117,2,2117,[318 496 588 357  98],786,5,8608,4.064211520302172,40.0,0.0
22118,2,2118,[143 257 323 185 174],23,2,8610,4.063237376120812,0.0,0.0
22119,2,2119,[318 496 588 357  98],450,5,8615,4.063679245283019,40.0,0.0
22120,2,2120,[ 56 135 195 186  64],655,2,8617,4.0627062706270625,20.0,0.0
22121,2,2121,[135 273 483   4 125],450,1,8618,4.061262959472196,0.0,0.0
22122,2,2122,[318 496 588 357  98],18,5,8623,4.0617051342439945,40.0,0.0
22123,2,2123,[ 64 748 211  50  15],796,4,8627,4.061676082862523,20.0,20.0
22124,2,2124,[318 496 588 357  98],796,5,8632,4.062117647058823,40.0,0.0
22125,2,2125,[318 496 588 357  98],716,5,8637,4.062558795860771,40.0,0.0
22126,2,2126,[ 89  12  28  64 210],796,3,8640,4.062059238363893,20.0,0.0
22127,2,2127,[271 117  50 423  82],807,4,8644,4.06203007518797,0.0,20.0
22128,2,2128,[183 200 117 175 271],655,2,8646,4.061061531235322,0.0,0.0
22129,2,2129,[ 64 211 180 405 168],716,4,8650,4.061032863849765,20.0,0.0
22130,2,2130,[318 496 588 357  98],450,5,8655,4.061473486625998,40.0,0.0
22131,2,2131,[318 496 588 357  98],18,5,8660,4.061913696060038,40.0,0.0
22132,2,2132,[318 496 588 357  98],330,5,8665,4.06235349273324,40.0,0.0
22133,2,2133,[ 69 168 174  71  70],401,2,8667,4.061387066541705,0.0,0.0
22134,2,2134,[357 403  71 191 187],18,4,8671,4.061358313817331,0.0,0.0
22135,2,2135,[  1 258 427 276 117],296,4,8675,4.061329588014981,20.0,0.0
22136,2,2136,[318 496 588 357  98],450,5,8680,4.061768834815162,40.0,0.0
22137,2,2137,[318 496 588 357  98],330,5,8685,4.0622076707203,40.0,0.0
22138,2,2138,[191 143 237  97 301],450,5,8690,4.062646096306685,0.0,0.0
22139,2,2139,[318 496 588 357  98],786,5,8695,4.063084112149533,40.0,0.0
22140,2,2140,[ 69  89  25  22 385],457,5,8700,4.0635217188229795,0.0,0.0
22141,2,2141,[588 265 204 168 125],450,5,8705,4.063958916900093,0.0,0.0
22142,2,2142,[294 111 282 655  11],450,5,8710,4.06439570695287,0.0,0.0
22143,2,2143,[357 135 197 187 273],450,3,8713,4.063899253731344,0.0,0.0
22144,2,2144,[318 496 588 357  98],450,5,8718,4.0643356643356645,40.0,0.0
22145,2,2145,[318 496 588 357  98],18,5,8723,4.064771668219944,40.0,0.0
22146,2,2146,[275 186 588 191 318],786,5,8728,4.065207265952492,20.0,20.0
22147,2,2147,[568  15 546 588  97],457,4,8732,4.065176908752328,0.0,0.0
22148,2,2148,[237 286 180 132   1],280,4,8736,4.06514657980456,0.0,20.0
22149,2,2149,[318 496 588 357  98],716,5,8741,4.065581395348837,40.0,0.0
22150,2,2150,[127 100   9 179 200],655,3,8744,4.065086006508601,0.0,40.0
22151,2,2151,[ 64  25 187 235 546],450,3,8747,4.064591078066915,20.0,0.0
22152,2,2152,[117 111  69 118 515],655,1,8748,4.063167673014399,0.0,0.0
22153,2,2153,[318 496 588 357  98],796,5,8753,4.063602599814299,40.0,0.0
22154,2,2154,[318 496 588 357  98],716,5,8758,4.064037122969838,40.0,0.0
22155,2,2155,[121 195 597 427 200],450,3,8761,4.063543599257885,20.0,0.0
22156,2,2156,[318 496 588 357  98],716,5,8766,4.063977746870654,40.0,0.0
22157,2,2157,[318 496 588 357  98],716,5,8771,4.0644114921223355,40.0,0.0
22158,2,2158,[318 496 588 357  98],786,5,8776,4.064844835572024,40.0,0.0
22159,2,2159,[318 496 588 357  98],796,5,8781,4.065277777777778,40.0,0.0
22160,2,2160,[117   4 111   7  15],629,3,8784,4.06478482184174,0.0,0.0
22161,2,2161,[318 496 588 357  98],18,5,8789,4.065217391304348,40.0,0.0
22162,2,2162,[176 195  79 172  12],151,3,8792,4.064724919093851,0.0,0.0
22163,2,2163,[197 423 185 153  82],716,5,8797,4.065157116451017,0.0,0.0
22164,2,2164,[  9 273   1  22 427],655,2,8799,4.064203233256351,20.0,0.0
22165,2,2165,[318 496 588 357  98],716,5,8804,4.064635272391505,40.0,0.0
22166,2,2166,[100 191 471 423  50],65,4,8808,4.064605445316105,0.0,40.0
22167,2,2167,[318 496 588 357  98],330,5,8813,4.0650369003690034,40.0,0.0
22168,2,2168,[265 427 403 127   7],72,3,8816,4.064545873674504,20.0,20.0
22169,2,2169,[318 496 588 357  98],716,5,8821,4.064976958525346,40.0,0.0
22170,2,2170,[  7 405 245 185 181],450,5,8826,4.065407646245969,0.0,0.0
22171,2,2171,[318 496 588 357  98],716,5,8831,4.065837937384899,40.0,0.0
22172,2,2172,[144 273 318 176 161],655,2,8833,4.064887252646112,20.0,0.0
22173,2,2173,[318 496 588 357  98],716,5,8838,4.065317387304508,40.0,0.0
22174,2,2174,[471 176 186 435  64],655,1,8839,4.063908045977011,20.0,0.0
22175,2,2175,[318 496 588 357  98],796,5,8844,4.064338235294118,40.0,0.0
22176,2,2176,[182 215 143  15 180],18,4,8848,4.064308681672026,0.0,0.0
22177,2,2177,[318 496 588 357  98],716,5,8853,4.064738292011019,40.0,0.0
22178,2,2178,[135 222   1  95   9],280,4,8857,4.064708581918311,0.0,0.0
22179,2,2179,[234 204 385 211 210],5,3,8860,4.064220183486238,0.0,0.0
22180,2,2180,[742  64 286 313  88],796,3,8863,4.063732232920678,20.0,20.0
22181,2,2181,[196 195 181 161 172],786,5,8868,4.064161319890009,0.0,0.0
22182,2,2182,[200 196 215  71 194],504,4,8872,4.064131928538708,0.0,0.0
22183,2,2183,[ 82 204 496  95 200],330,5,8877,4.06456043956044,20.0,0.0
22184,2,2184,[318 496 588 357  98],786,5,8882,4.064988558352403,40.0,0.0
22185,2,2185,[197  82 174 508  64],655,1,8883,4.063586459286368,20.0,0.0
22186,2,2186,[ 22 483 174  79 496],18,5,8888,4.0640146319158665,20.0,0.0
22187,2,2187,[318 496 588 357  98],450,5,8893,4.0644424131627055,40.0,0.0
22188,2,2188,[508 185 357 302 172],535,2,8895,4.063499314755596,0.0,0.0
22189,2,2189,[168 496  12 153 423],18,4,8899,4.063470319634703,20.0,0.0
22190,2,2190,[318 496 588  98 357],450,5,8904,4.063897763578275,40.0,0.0
22191,2,2191,[210   8   7 127  56],457,5,8909,4.064324817518248,0.0,20.0
22192,2,2192,[117 403 185 300 125],504,4,8913,4.064295485636115,0.0,0.0
22193,2,2193,[ 11   7  98  69 423],269,2,8915,4.063354603463993,0.0,0.0
22194,2,2194,[ 70 496 588 197 132],450,5,8920,4.063781321184511,20.0,0.0
22195,2,2195,[318 496 588  98 357],716,5,8925,4.064207650273224,40.0,0.0
22196,2,2196,[318 496 588  98 357],796,5,8930,4.06463359126081,40.0,0.0
22197,2,2197,[182 202 111 176  69],280,2,8932,4.063694267515924,0.0,0.0
22198,2,2198,[318 496 588  98 357],786,5,8937,4.064120054570259,40.0,0.0
22199,2,2199,[318 161 475 282 357],655,2,8939,4.0631818181818184,20.0,0.0
22200,2,2200,[318 496 588  98 357],330,5,8944,4.063607451158564,40.0,0.0
22201,2,2201,[405 300 151 172 118],151,3,8947,4.0631244323342415,0.0,0.0
22202,2,2202,[403 181  22  98 204],450,5,8952,4.063549704947799,0.0,0.0
22203,2,2203,[202 176 204  88 181],151,4,8956,4.063520871143376,0.0,0.0
22204,2,2204,[403   1  12 269 234],450,4,8960,4.063492063492063,0.0,0.0
22205,2,2205,[144 483 655 273 234],655,2,8962,4.062556663644606,0.0,0.0
22206,2,2206,[318 496 588  98 357],716,5,8967,4.062981422745809,40.0,0.0
22207,2,2207,[318 496 588  98 357],18,5,8972,4.063405797101449,40.0,0.0
22208,2,2208,[127 195 204  71 173],344,4,8976,4.06337709370756,0.0,20.0
22209,2,2209,[210 185 257 235 143],5,2,8978,4.062443438914027,0.0,0.0
22210,2,2210,[ 71 176   1 127 204],344,3,8981,4.061962912709181,0.0,20.0
22211,2,2211,[318 496 588  98 357],786,5,8986,4.062386980108499,40.0,0.0
22212,2,2212,[318 496 588  98 357],450,5,8991,4.0628106642566655,40.0,0.0
22213,2,2213,[ 56 318 286 181 153],562,2,8993,4.061878952122854,20.0,20.0
22214,2,2214,[ 98 405 318 222  70],655,2,8995,4.060948081264108,20.0,0.0
22215,2,2215,[318 496 588  98 357],450,5,9000,4.061371841155235,40.0,0.0
22216,2,2216,[ 15 127 176 655 191],269,3,9003,4.060893098782138,0.0,20.0
22217,2,2217,[318 496 588  98 357],450,5,9008,4.06131650135257,40.0,0.0
22218,2,2218,[318 496 588  98 357],330,5,9013,4.061739522307346,40.0,0.0
22219,2,2219,[318 496 588  98 357],796,5,9018,4.062162162162162,40.0,0.0
22220,2,2220,[215 125 197  25   1],655,0,9018,4.060333183250788,0.0,0.0
22221,2,2221,[318 496 588  98 357],18,5,9023,4.060756075607561,40.0,0.0
22222,2,2222,[318 496 588  98 357],796,5,9028,4.061178587494377,40.0,0.0
22223,2,2223,[318 496 588  98 357],18,5,9033,4.061600719424461,40.0,0.0
22224,2,2224,[318 496 588  98 357],786,5,9038,4.062022471910113,40.0,0.0
22225,2,2225,[318 496 588  98 357],330,5,9043,4.062443845462713,40.0,0.0
22226,2,2226,[ 64   1 423 174  12],450,5,9048,4.0628648405927255,20.0,0.0
22227,2,2227,[318 496 588  98 357],450,5,9053,4.063285457809695,40.0,0.0
22228,2,2228,[318 496 588  98 357],786,5,9058,4.063705697622252,40.0,0.0
22229,2,2229,[318 496 588  98 357],716,5,9063,4.064125560538117,40.0,0.0
22230,2,2230,[318 496 588  98 357],716,5,9068,4.0645450470640965,40.0,0.0
22231,2,2231,[127 435  28 135  50],72,4,9072,4.064516129032258,0.0,40.0
22232,2,2232,[318 496 588  98 357],786,5,9077,4.064935064935065,40.0,0.0
22233,2,2233,[318 496 588  98 357],786,5,9082,4.065353625783349,40.0,0.0
22234,2,2234,[318 496 588  98 357],786,5,9087,4.065771812080537,40.0,0.0
22235,2,2235,[318 496 588  98 357],450,5,9092,4.0661896243291595,40.0,0.0
22236,2,2236,[286 195 117 191  56],655,1,9093,4.064818953956191,0.0,20.0
22237,2,2237,[318 496 588  98 357],330,5,9098,4.065236818588025,40.0,0.0
22238,2,2238,[568 186 427 143  56],577,2,9100,4.064314426083072,20.0,0.0
22239,2,2239,[196 172  98  25 211],716,5,9105,4.064732142857143,0.0,0.0
22240,2,2240,[318 496 588  98 357],716,5,9110,4.0651494868362335,40.0,0.0
22241,2,2241,[475  15 196 238 100],389,3,9113,4.064674397859054,0.0,20.0
22242,2,2242,[195 265  79 182 258],457,5,9118,4.0650913954525185,0.0,0.0
22243,2,2243,[318 496 588  98 357],716,5,9123,4.065508021390374,40.0,0.0
22244,2,2244,[318 496 588  98 357],18,5,9128,4.065924276169265,40.0,0.0
22245,2,2245,[318 496 588  98 357],716,5,9133,4.066340160284951,40.0,0.0
22246,2,2246,[271 187 216 117 172],796,5,9138,4.06675567423231,0.0,0.0
22247,2,2247,[318 496 588  98 357],796,5,9143,4.067170818505338,40.0,0.0
22248,2,2248,[318 496 588  98 357],450,5,9148,4.067585593597154,40.0,0.0
22249,2,2249,[318 496 588  98 357],716,5,9153,4.068,40.0,0.0
22250,2,2250,[318 496 588  98 357],716,5,9158,4.068414038205242,40.0,0.0
22251,2,2251,[180 597 135 125 211],450,4,9162,4.068383658969805,0.0,0.0
22252,2,2252,[202  11 197 204 483],655,1,9163,4.067021748779405,0.0,0.0
22253,2,2253,[318 496 588  98 357],796,5,9168,4.067435669920142,40.0,0.0
22254,2,2254,[275 185  69 318 180],796,4,9172,4.0674057649667406,20.0,20.0
22255,2,2255,[318 496 588  98 357],796,5,9177,4.06781914893617,40.0,0.0
22256,2,2256,[568 322 100 301 313],344,3,9180,4.067346034559149,0.0,20.0
22257,2,2257,[194 111 313 275 181],236,3,9183,4.066873339238264,0.0,20.0
22258,2,2258,[191 235 196 483 197],401,4,9187,4.066843736166446,0.0,0.0
22259,2,2259,[288 179 151  64   9],457,5,9192,4.067256637168142,20.0,0.0
22260,2,2260,[318 496 588  98 357],330,5,9197,4.067669172932331,40.0,0.0
22261,2,2261,[318 496 588  98 357],450,5,9202,4.068081343943413,40.0,0.0
22262,2,2262,[318 496 588  98 357],796,5,9207,4.068493150684931,40.0,0.0
22263,2,2263,[471 204 176  15 210],72,4,9211,4.068462897526501,0.0,0.0
22264,2,2264,[427 173 118 323 546],796,4,9215,4.068432671081678,20.0,0.0
22265,2,2265,[318 496 588  98 357],18,5,9220,4.068843777581642,40.0,0.0
22266,2,2266,[318 496 588  98 357],330,5,9225,4.069254521393913,40.0,0.0
22267,2,2267,[228 257 195 405 483],457,4,9229,4.069223985890653,0.0,0.0
22268,2,2268,[405  88  98  97 265],457,5,9234,4.069634200088145,0.0,0.0
22269,2,2269,[318 496 588  98 357],330,5,9239,4.0700440528634365,40.0,0.0
22270,2,2270,[ 69 471 191  97  98],693,2,9241,4.069132540730956,0.0,0.0
22271,2,2271,[215 318 678 132 235],280,3,9244,4.068661971830986,20.0,0.0
22272,2,2272,[318 496 588  98 357],786,5,9249,4.069071711394633,40.0,0.0
22273,2,2273,[194 423 153 228 143],23,3,9252,4.068601583113456,0.0,0.0
22274,2,2274,[258 183  71 742 222],450,3,9255,4.068131868131868,0.0,0.0
22275,2,2275,[135 294  15 216 161],655,2,9257,4.067223198594025,0.0,0.0
22276,2,2276,[185 385 118 181  89],450,4,9261,4.067193675889328,0.0,0.0
22277,2,2277,[318 496 588  98 357],18,5,9266,4.067603160667252,40.0,0.0
22278,2,2278,[ 11  64  89 435 175],269,2,9268,4.066695919262835,20.0,0.0
22279,2,2279,[ 28 238 132 323 405],796,2,9270,4.065789473684211,0.0,0.0
22280,2,2280,[318 496 588  98 357],796,5,9275,4.066199035510741,40.0,0.0
22281,2,2281,[211 300 294 197 186],716,4,9279,4.066170026292726,0.0,0.0
22282,2,2282,[318 496 588  98 357],786,5,9284,4.066579062636881,40.0,0.0
22283,2,2283,[265   1 204  70 288],450,4,9288,4.066549912434326,0.0,0.0
22284,2,2284,[168  82 273 328 153],796,3,9291,4.066083150984682,0.0,0.0
22285,2,2285,[318 496 588  98 357],786,5,9296,4.066491688538933,40.0,0.0
22286,2,2286,[  7 195 118 496 216],450,4,9300,4.066462614779187,20.0,0.0
22287,2,2287,[ 28 151 186 204  95],389,3,9303,4.065996503496503,0.0,0.0
22288,2,2288,[515  64 215 546  95],716,4,9307,4.065967671472259,20.0,0.0
22289,2,2289,[143 216 435 228 258],450,5,9312,4.066375545851528,0.0,0.0
22290,2,2290,[183 258 333 357   4],655,2,9314,4.065473592317765,0.0,0.0
22291,2,2291,[211 111 117 222 191],786,5,9319,4.065881326352531,0.0,0.0
22292,2,2292,[210 174 588 597 275],457,4,9323,4.0658525948539035,0.0,20.0
22293,2,2293,[211   7  50 286 496],535,4,9327,4.065823888404534,20.0,40.0
22294,2,2294,[318 496 588  98 357],716,5,9332,4.0662309368191725,40.0,0.0
22295,2,2295,[318 496 588  98 357],796,5,9337,4.066637630662021,40.0,0.0
22296,2,2296,[318 496 588  98 357],796,5,9342,4.067043970396169,40.0,0.0
22297,2,2297,[328 301 273 172 275],450,4,9346,4.067014795474326,0.0,20.0
22298,2,2298,[318  96 176   4 132],280,3,9349,4.0665506742061766,20.0,0.0
22299,2,2299,[202   7 333 302  97],655,1,9350,4.065217391304348,0.0,0.0
22300,2,2300,[228 546 282 742 111],796,4,9354,4.065189048239896,0.0,0.0
22301,2,2301,[179 127 172  15 216],457,5,9359,4.065595134665508,0.0,20.0
22302,2,2302,[318 496 588  98 357],716,5,9364,4.0660008684324795,40.0,0.0
22303,2,2303,[301 125  88 597  12],11,2,9366,4.065104166666667,0.0,0.0
22304,2,2304,[318 496 588  98 357],716,5,9371,4.065509761388286,40.0,0.0
22305,2,2305,[318 496 588  98 357],330,5,9376,4.065915004336514,40.0,0.0
22306,2,2306,[318 496 588  98 357],716,5,9381,4.066319895968791,40.0,0.0
22307,2,2307,[ 79 427 257 185 275],655,4,9385,4.066291161178509,20.0,20.0
22308,2,2308,[603 271  25  11  88],655,1,9386,4.064963187527068,20.0,0.0
22309,2,2309,[318 496 588  98 357],716,5,9391,4.065367965367965,40.0,0.0
22310,2,2310,[301 655 215 568  15],655,0,9391,4.063608827347468,0.0,0.0
22311,2,2311,[318 496 588  98 357],786,5,9396,4.06401384083045,40.0,0.0
22312,2,2312,[318 496 588  98 357],796,5,9401,4.06441850410722,40.0,0.0
22313,2,2313,[238 234 180 237 258],796,2,9403,4.0635263612791706,0.0,0.0
22314,2,2314,[471 238 475 175  15],655,0,9403,4.061771058315335,0.0,0.0
22315,2,2315,[301 121 172  50  88],593,5,9408,4.062176165803109,0.0,20.0
22316,2,2316,[318 496 588  98 357],716,5,9413,4.062580923608114,40.0,0.0
22317,2,2317,[ 82 143 258 168 180],457,5,9418,4.062985332182916,0.0,0.0
22318,2,2318,[286 175 173 172  50],151,5,9423,4.063389391979301,0.0,40.0
22319,2,2319,[318 496 588  98 357],330,5,9428,4.063793103448276,40.0,0.0
22320,2,2320,[288 172 174 182 143],436,2,9430,4.062903920723826,0.0,0.0
22321,2,2321,[318 496 588  98 357],450,5,9435,4.0633074935400515,40.0,0.0
22322,2,2322,[186  12   8 204  96],577,5,9440,4.063710718897977,0.0,0.0
22323,2,2323,[318 496 588  98 357],450,5,9445,4.064113597246127,40.0,0.0
22324,2,2324,[ 88  98 597 742 161],256,5,9450,4.064516129032258,0.0,0.0
22325,2,2325,[ 89 245 269 144 143],450,5,9455,4.064918314703354,0.0,0.0
22326,2,2326,[143 125 202 204 132],798,3,9458,4.064460678985819,0.0,0.0
22327,2,2327,[318 496 588  98 357],450,5,9463,4.064862542955327,40.0,0.0
22328,2,2328,[318 496 588  98 357],786,5,9468,4.065264061829112,40.0,0.0
22329,2,2329,[ 11 111 153 273 655],401,1,9469,4.063948497854077,0.0,0.0
22330,2,2330,[168 435 151 282 546],716,3,9472,4.063492063492063,0.0,0.0
22331,2,2331,[318 496 588  98 357],796,5,9477,4.063893653516295,40.0,0.0
22332,2,2332,[318 496 588  98 357],330,5,9482,4.064294899271324,40.0,0.0
22333,2,2333,[318 496 588  98 357],330,5,9487,4.064695801199657,40.0,0.0
22334,2,2334,[173 215 508 175 357],344,4,9491,4.0646680942184155,0.0,0.0
22335,2,2335,[318 496 588  98 357],796,5,9496,4.065068493150685,40.0,0.0
22336,2,2336,[318 496 588  98 357],786,5,9501,4.065468549422336,40.0,0.0
22337,2,2337,[318 496 588  98 357],450,5,9506,4.065868263473054,40.0,0.0
22338,2,2338,[515 118  95 385 183],716,2,9508,4.064985036340317,0.0,0.0
22339,2,2339,[318 496 588  98 357],786,5,9513,4.065384615384615,40.0,0.0
22340,2,2340,[318 496 588  98 357],18,5,9518,4.06578385305425,40.0,0.0
22341,2,2341,[ 69 257 151 197 427],796,4,9522,4.065755764304014,20.0,0.0
22342,2,2342,[318 496 588  98 357],330,5,9527,4.066154502774221,40.0,0.0
22343,2,2343,[318 496 588  98 357],450,5,9532,4.066552901023891,40.0,0.0
22344,2,2344,[269  82 125   7 655],655,0,9532,4.064818763326226,0.0,0.0
22345,2,2345,[318 496 588  98 357],796,5,9537,4.065217391304348,40.0,0.0
22346,2,2346,[191   9 302   7 322],344,4,9541,4.0651896037494675,0.0,0.0
22347,2,2347,[318 496 588  98 357],450,5,9546,4.065587734241908,40.0,0.0
22348,2,2348,[435 302  70 508 173],269,1,9547,4.0642826734780755,0.0,0.0
22349,2,2349,[318 496 588  98 357],796,5,9552,4.06468085106383,40.0,0.0
22350,2,2350,[318 496 588  98 357],330,5,9557,4.065078689919184,40.0,0.0
22351,2,2351,[175  12 300 181 161],655,0,9557,4.063350340136054,0.0,0.0
22352,2,2352,[318 496 588  98 357],786,5,9562,4.063748406289843,40.0,0.0
22353,2,2353,[ 50  28 403 174  97],72,3,9565,4.0632965165675445,0.0,20.0
22354,2,2354,[318 496 588  98 357],18,5,9570,4.063694267515924,40.0,0.0
22355,2,2355,[318 496 588  98 357],18,5,9575,4.064091680814941,40.0,0.0
22356,2,2356,[318 496 588  98 357],786,5,9580,4.064488756894357,40.0,0.0
22357,2,2357,[318 496 588  98 357],796,5,9585,4.064885496183206,40.0,0.0
22358,2,2358,[318 496 588  98 357],330,5,9590,4.0652818991097925,40.0,0.0
22359,2,2359,[180   9 174 183  98],457,5,9595,4.065677966101695,0.0,0.0
22360,2,2360,[300   4 187 385 265],796,5,9600,4.066073697585769,0.0,0.0
22361,2,2361,[318 496 588  98 357],330,5,9605,4.066469093988146,40.0,0.0
22362,2,2362,[204  97 427  11 357],716,5,9610,4.066864155734236,20.0,0.0
22363,2,2363,[318 496 588  98 357],18,5,9615,4.067258883248731,40.0,0.0
22364,2,2364,[318 496 588  98 357],786,5,9620,4.067653276955602,40.0,0.0
22365,2,2365,[318 496 588  98 357],716,5,9625,4.068047337278107,40.0,0.0
22366,2,2366,[318 496 588  98 357],450,5,9630,4.068441064638783,40.0,0.0
22367,2,2367,[318 496 588  98 357],450,5,9635,4.06883445945946,40.0,0.0
22368,2,2368,[318 496 588  98 357],796,5,9640,4.069227522161249,40.0,0.0
22369,2,2369,[318 496 588  98 357],18,5,9645,4.069620253164557,40.0,0.0
22370,2,2370,[ 71 286 238  11  69],450,4,9649,4.069590889919865,0.0,20.0
22371,2,2371,[318 496 588  98 357],786,5,9654,4.069983136593592,40.0,0.0
22372,2,2372,[237 100 286  82 197],878,2,9656,4.069110830172777,0.0,40.0
22373,2,2373,[ 25 496 117 288 144],593,4,9660,4.069081718618365,20.0,0.0
22374,2,2374,[313  25  82 191 179],450,3,9663,4.068631578947368,0.0,0.0
22375,2,2375,[234 174  96  97 132],655,0,9663,4.066919191919192,0.0,0.0
22376,2,2376,[318 496 588  98 357],716,5,9668,4.067311737484224,40.0,0.0
22377,2,2377,[318 496 588  98 357],450,5,9673,4.067703952901598,40.0,0.0
22378,2,2378,[318 496 588  98 357],330,5,9678,4.068095838587642,40.0,0.0
22379,2,2379,[597 196 117 546 483],457,3,9681,4.067647058823529,0.0,0.0
22380,2,2380,[175 603 216   4 143],655,3,9684,4.067198656026879,20.0,0.0
22381,2,2381,[200 603 286  71 215],796,4,9688,4.067170445004198,20.0,20.0
22382,2,2382,[318 496 588  98 357],716,5,9693,4.067561896768779,40.0,0.0
22383,2,2383,[318 496 588  98 357],786,5,9698,4.067953020134228,40.0,0.0
22384,2,2384,[318 496 588  98 357],796,5,9703,4.068343815513627,40.0,0.0
22385,2,2385,[318 496 588  98 357],18,5,9708,4.068734283319363,40.0,0.0
22386,2,2386,[318 496 588  98 357],450,5,9713,4.0691244239631335,40.0,0.0
22387,2,2387,[323 121 181 176 168],504,3,9716,4.068676716917923,0.0,0.0
22388,2,2388,[318 496 588  98 357],796,5,9721,4.0690665550439515,40.0,0.0
22389,2,2389,[318 496 588  98 357],716,5,9726,4.069456066945607,40.0,0.0
22390,2,2390,[423 200 196   4  69],655,1,9727,4.068172312839816,0.0,0.0
22391,2,2391,[121 300 588 197 186],716,4,9731,4.06814381270903,0.0,0.0
22392,2,2392,[318 496 588  98 357],716,5,9736,4.068533221897201,40.0,0.0
22393,2,2393,[258  11  22 186 144],450,4,9740,4.068504594820384,0.0,0.0
22394,2,2394,[ 89  15  71 286 215],796,4,9744,4.06847599164927,0.0,20.0
22395,2,2395,[318 496 588  98 357],450,5,9749,4.068864774624374,40.0,0.0
22396,2,2396,[174 121  28 257 282],796,4,9753,4.068836045056321,0.0,0.0
22397,2,2397,[197  69 210 100 200],457,5,9758,4.069224353628023,0.0,20.0
22398,2,2398,[ 71 151  12  95 423],450,3,9761,4.0687786577740725,0.0,0.0
22399,2,2399,[234  88 286 265 144],796,3,9764,4.068333333333333,0.0,20.0
22400,2,2400,[742 313 265 318 202],577,5,9769,4.068721366097459,20.0,0.0
22401,2,2401,[318 496 588  98 357],716,5,9774,4.069109075770191,40.0,0.0
22402,2,2402,[111 173 385 257 127],796,5,9779,4.0694964627548895,0.0,20.0
22403,2,2403,[127 588 186 191 111],389,3,9782,4.069051580698836,0.0,20.0
22404,2,2404,[200 197  82 385 357],450,3,9785,4.0686070686070686,0.0,0.0
22405,2,2405,[197 427 194 222 153],716,5,9790,4.0689941812136325,20.0,0.0
22406,2,2406,[100 196 597   9 282],457,4,9794,4.068965517241379,0.0,20.0
22407,2,2407,[318 496 588  98 357],18,5,9799,4.069352159468439,40.0,0.0
22408,2,2408,[173 568 546 194 483],796,5,9804,4.069738480697385,0.0,0.0
22409,2,2409,[318 496 588  98 357],330,5,9809,4.070124481327801,40.0,0.0
22410,2,2410,[318 496 588  98 357],450,5,9814,4.070510161758606,40.0,0.0
22411,2,2411,[318 496 588  98 357],330,5,9819,4.07089552238806,40.0,0.0
22412,2,2412,[318 496 588  98 357],18,5,9824,4.071280563613759,40.0,0.0
22413,2,2413,[168 302 174 301 200],450,4,9828,4.071251035625518,0.0,0.0
22414,2,2414,[318 496 588  98 357],786,5,9833,4.071635610766045,40.0,0.0
22415,2,2415,[318 496 588  98 357],450,5,9838,4.072019867549669,40.0,0.0
22416,2,2416,[ 56 423 271  82  15],796,4,9842,4.071990070335127,0.0,0.0
22417,2,2417,[204  22 403 423  95],450,4,9846,4.07196029776675,0.0,0.0
22418,2,2418,[318 496 588  98 357],716,5,9851,4.072343943778421,40.0,0.0
22419,2,2419,[180  97   4 515   1],18,4,9855,4.072314049586777,0.0,0.0
22420,2,2420,[ 64 174 187 191 483],796,5,9860,4.072697232548534,20.0,0.0
22421,2,2421,[318 496 588  98 357],716,5,9865,4.073080099091659,40.0,0.0
22422,2,2422,[318 496 588  98 357],18,5,9870,4.073462649607924,40.0,0.0
22423,2,2423,[748 597 403 275 385],450,5,9875,4.073844884488449,0.0,20.0
22424,2,2424,[318 496 588  98 357],330,5,9880,4.074226804123711,40.0,0.0
22425,2,2425,[ 25 210  64 282 175],457,5,9885,4.074608408903545,20.0,0.0
22426,2,2426,[ 64 403 172 423  95],18,3,9888,4.074165636588381,20.0,0.0
22427,2,2427,[318 496 588  98 357],796,5,9893,4.074546952224052,40.0,0.0
22428,2,2428,[176  25 195 181  82],457,5,9898,4.07492795389049,0.0,0.0
22429,2,2429,[111 197  70 318  88],786,4,9902,4.074897119341564,20.0,0.0
22430,2,2430,[318 496 588  98 357],716,5,9907,4.075277663512957,40.0,0.0
22431,2,2431,[ 28 313 403 202 211],450,5,9912,4.0756578947368425,0.0,0.0
22432,2,2432,[215 588 127  64  82],716,5,9917,4.076037813399096,20.0,20.0
22433,2,2433,[210 144 117 181 204],296,3,9920,4.075595727198028,0.0,0.0
22434,2,2434,[318 496 588  98 357],330,5,9925,4.075975359342916,40.0,0.0
22435,2,2435,[318 496 588  98 357],786,5,9930,4.0763546798029555,40.0,0.0
22436,2,2436,[127 385 276 215 180],457,5,9935,4.076733688961839,0.0,20.0
22437,2,2437,[318 496 588  98 357],716,5,9940,4.077112387202625,40.0,0.0
22438,2,2438,[318 496 588  98 357],330,5,9945,4.077490774907749,40.0,0.0
22439,2,2439,[318 496 588  98 357],18,5,9950,4.077868852459017,40.0,0.0
22440,2,2440,[ 69 289 197 172 132],316,2,9952,4.077017615731258,0.0,0.0
22441,2,2441,[ 88 111 211 182 202],450,5,9957,4.077395577395578,0.0,0.0
22442,2,2442,[318 496 588  98 357],18,5,9962,4.077773229635694,40.0,0.0
22443,2,2443,[216   7 483 234 194],269,2,9964,4.076923076923077,0.0,0.0
22444,2,2444,[289 204 182 215  70],655,1,9965,4.075664621676892,0.0,0.0
22445,2,2445,[508 127  11  88 357],344,3,9968,4.07522485690924,0.0,20.0
22446,2,2446,[  7 222 228 603 186],151,5,9973,4.0756027789129545,20.0,0.0
22447,2,2447,[318 496 588  98 357],450,5,9978,4.075980392156863,40.0,0.0
22448,2,2448,[282 385 322   8 183],280,3,9981,4.075541037158024,0.0,0.0
22449,2,2449,[427  88 118  70 423],655,1,9982,4.074285714285714,20.0,0.0
22450,2,2450,[ 98 515  88 423  89],269,3,9985,4.073847409220726,0.0,0.0
22451,2,2451,[111 153 173 204 195],280,2,9987,4.07300163132137,0.0,0.0
22452,2,2452,[175 357 179 117   1],457,5,9992,4.073379535262943,0.0,0.0
22453,2,2453,[546 597 210 143   1],796,3,9995,4.072942135289323,0.0,0.0
22454,2,2454,[  1 597 168   9  15],174,2,9997,4.072097759674135,0.0,0.0
22455,2,2455,[235 100 288  69 183],280,3,10000,4.071661237785016,0.0,20.0
22456,2,2456,[  8 200 228  64 168],457,5,10005,4.072039072039072,20.0,0.0
22457,2,2457,[318 496 588  98 357],330,5,10010,4.072416598860863,40.0,0.0
22458,2,2458,[237 496   7 282 508],535,4,10014,4.072387149247661,20.0,0.0
22459,2,2459,[318 496 588  98 357],786,5,10019,4.072764227642277,40.0,0.0
22460,2,2460,[265 245  70 200 161],450,4,10023,4.07273466070703,0.0,0.0
22461,2,2461,[  4 194 237 186 117],457,5,10028,4.073111291632819,0.0,0.0
22462,2,2462,[603  64 135 185 496],716,4,10032,4.0730816077953715,60.0,0.0
22463,2,2463,[ 11 200 196 173 183],269,1,10033,4.071834415584416,0.0,0.0
22464,2,2464,[282  69 191 179 216],236,4,10037,4.071805273833672,0.0,0.0
22465,2,2465,[318 496 588  98 357],796,5,10042,4.072181670721816,40.0,0.0
22466,2,2466,[257 313  11 268 385],655,1,10043,4.070936359951358,0.0,0.0
22467,2,2467,[318 496 588  98 357],716,5,10048,4.071312803889789,40.0,0.0
22468,2,2468,[286 288 144  56 423],280,4,10052,4.071283920615634,0.0,20.0
22469,2,2469,[318 496 588  98 357],450,5,10057,4.07165991902834,40.0,0.0
22470,2,2470,[318 496 588  98 357],450,5,10062,4.0720356131121,40.0,0.0
22471,2,2471,[423 216 202 179   9],786,5,10067,4.072411003236246,0.0,0.0
22472,2,2472,[318 496 588  98 357],450,5,10072,4.072786089769511,40.0,0.0
22473,2,2473,[ 22 222 273  28 191],655,2,10074,4.0719482619240095,0.0,0.0
22474,2,2474,[318 496 588  98 357],18,5,10079,4.072323232323233,40.0,0.0
22475,2,2475,[318 496 588  98 357],786,5,10084,4.072697899838449,40.0,0.0
22476,2,2476,[161 210 151 238 483],389,3,10087,4.072264836495761,0.0,0.0
22477,2,2477,[318 496 588  98 357],786,5,10092,4.072639225181598,40.0,0.0
22478,2,2478,[318 496 588  98 357],18,5,10097,4.073013311819282,40.0,0.0
22479,2,2479,[318 496 588  98 357],716,5,10102,4.073387096774193,40.0,0.0
22480,2,2480,[318 496 588  98 357],18,5,10107,4.0737605804111245,40.0,0.0
22481,2,2481,[ 97 228  69  50 238],716,5,10112,4.074133763094279,0.0,20.0
22482,2,2482,[302   7 471 228 125],450,5,10117,4.074506645187274,0.0,0.0
22483,2,2483,[282 475 121 182 276],655,2,10119,4.073671497584541,0.0,0.0
22484,2,2484,[ 70 215  15  64  89],450,4,10123,4.07364185110664,20.0,0.0
22485,2,2485,[222  64  70 265 235],450,3,10126,4.0732099758648435,20.0,0.0
22486,2,2486,[318 496 588  98 357],450,5,10131,4.0735826296743065,40.0,0.0
22487,2,2487,[215  89   1 655 181],796,3,10134,4.073151125401929,0.0,0.0
22488,2,2488,[318 496 588  98 357],330,5,10139,4.073523503415026,40.0,0.0
22489,2,2489,[ 50  95 143 742 289],756,3,10142,4.073092369477911,0.0,20.0
22490,2,2490,[195 194 185 211 245],504,4,10146,4.073063026896828,0.0,0.0
22491,2,2491,[318 496 588  98 357],450,5,10151,4.073434991974318,40.0,0.0
22492,2,2492,[318 496 588  98 357],786,5,10156,4.073806658644203,40.0,0.0
22493,2,2493,[318 496 588  98 357],716,5,10161,4.074178027265437,40.0,0.0
22494,2,2494,[423 173 300 183  50],716,4,10165,4.074148296593187,0.0,20.0
22495,2,2495,[ 96 546 173 245 172],450,5,10170,4.074519230769231,0.0,0.0
22496,2,2496,[318 496 588  98 357],18,5,10175,4.07488986784141,40.0,0.0
22497,2,2497,[318 496 588  98 357],786,5,10180,4.075260208166533,40.0,0.0
22498,2,2498,[471 276   7  25 300],518,2,10182,4.074429771908764,0.0,0.0
22499,2,2499,[318 496 588  98 357],796,5,10187,4.0748,40.0,0.0
22500,2,2500,[318 496 588  98 357],330,5,10192,4.0751699320271895,40.0,0.0
22501,2,2501,[183 215  88 143  95],577,3,10195,4.074740207833733,0.0,0.0
22502,2,2502,[318 496 588  98 357],18,5,10200,4.0751098681582105,40.0,0.0
22503,2,2503,[318 496 588  98 357],786,5,10205,4.0754792332268375,40.0,0.0
22504,2,2504,[318 496 588  98 357],450,5,10210,4.075848303393213,40.0,0.0
22505,2,2505,[318 496 588  98 357],18,5,10215,4.076217079010375,40.0,0.0
22506,2,2506,[318 496 588  98 357],18,5,10220,4.076585560430794,40.0,0.0
22507,2,2507,[603  15 258 182  11],450,4,10224,4.076555023923445,20.0,0.0
22508,2,2508,[603 269 117 118   7],450,4,10228,4.076524511757673,20.0,0.0
22509,2,2509,[ 88 143 161 111   1],401,3,10231,4.07609561752988,0.0,0.0
22510,2,2510,[318 496 588  98 357],330,5,10236,4.0764635603345285,40.0,0.0
22511,2,2511,[318 496 588  98 357],786,5,10241,4.076831210191083,40.0,0.0
22512,2,2512,[318 496 588  98 357],18,5,10246,4.077198567449264,40.0,0.0
22513,2,2513,[318 496 588  98 357],716,5,10251,4.077565632458234,40.0,0.0
22514,2,2514,[238 179 176  50 300],655,2,10253,4.076739562624255,0.0,20.0
22515,2,2515,[195 187  12 289 176],655,1,10254,4.075516693163752,0.0,0.0
22516,2,2516,[318 496 588  98 357],796,5,10259,4.0758839888756455,40.0,0.0
22517,2,2517,[175 181 597  95 132],23,4,10263,4.075853852263702,0.0,0.0
22518,2,2518,[ 71  15 228 182 237],450,3,10266,4.075426756649464,0.0,0.0
22519,2,2519,[318 496 588  98 357],716,5,10271,4.075793650793651,40.0,0.0
22520,2,2520,[151 143 318 191 173],716,5,10276,4.076160253867513,20.0,0.0
22521,2,2521,[318 496 588  98 357],450,5,10281,4.076526566217288,40.0,0.0
22522,2,2522,[ 89 748 210 172 483],151,4,10285,4.0764962346413,0.0,0.0
22523,2,2523,[318 496 588  98 357],330,5,10290,4.076862123613312,40.0,0.0
22524,2,2524,[144 118 435   7 288],450,3,10293,4.0764356435643565,0.0,0.0
22525,2,2525,[238 182 174   9 118],593,3,10296,4.076009501187649,0.0,0.0
22526,2,2526,[318 496 588  98 357],786,5,10301,4.076375148397309,40.0,0.0
22527,2,2527,[ 15 211 172 269 185],796,3,10304,4.075949367088608,0.0,0.0
22528,2,2528,[ 64  96 204 210 273],655,2,10306,4.0751285092922105,20.0,0.0
22529,2,2529,[318 496 588  98 357],18,5,10311,4.075494071146245,40.0,0.0
22530,2,2530,[132 172  69 215 403],577,5,10316,4.075859344132754,0.0,0.0
22531,2,2531,[301 313 483 234 237],450,3,10319,4.075434439178515,0.0,0.0
22532,2,2532,[385 161 294 202 186],716,2,10321,4.074615080931702,0.0,0.0
22533,2,2533,[276 153 187   9 603],535,3,10324,4.074191002367798,20.0,0.0
22534,2,2534,[318 496 588  98 357],330,5,10329,4.074556213017751,40.0,0.0
22535,2,2535,[318 496 588  98 357],330,5,10334,4.0749211356466875,40.0,0.0
22536,2,2536,[318 496 588  98 357],18,5,10339,4.075285770595191,40.0,0.0
22537,2,2537,[172  12 174 132 195],450,5,10344,4.07565011820331,0.0,0.0
22538,2,2538,[  4  88 111   1 546],344,2,10346,4.074832611264277,0.0,0.0
22539,2,2539,[318 496 588  98 357],450,5,10351,4.0751968503937,40.0,0.0
22540,2,2540,[318 496 588  98 357],786,5,10356,4.07556080283353,40.0,0.0
22541,2,2541,[385 678 191   7 176],344,3,10359,4.07513768686074,0.0,0.0
22542,2,2542,[318 496 588  98 357],796,5,10364,4.075501376327173,40.0,0.0
22543,2,2543,[318 496 588  98 357],786,5,10369,4.075864779874214,40.0,0.0
22544,2,2544,[289 174 181 132  88],693,2,10371,4.075049115913556,0.0,0.0
22545,2,2545,[318 496 588  98 357],450,5,10376,4.07541241162608,40.0,0.0
22546,2,2546,[144 174 172 258 271],796,5,10381,4.075775422065175,0.0,0.0
22547,2,2547,[403 301 568 427 603],450,5,10386,4.076138147566719,40.0,0.0
22548,2,2548,[318 496 588  98 357],716,5,10391,4.0765005884660654,40.0,0.0
22549,2,2549,[318 496 588  98 357],450,5,10396,4.0768627450980395,40.0,0.0
22550,2,2550,[318 496 588  98 357],716,5,10401,4.077224617796943,40.0,0.0
22551,2,2551,[318 496 588  98 357],330,5,10406,4.077586206896552,40.0,0.0
22552,2,2552,[318 496 588  98 357],18,5,10411,4.0779475127301215,40.0,0.0
22553,2,2553,[318 496 588  98 357],330,5,10416,4.078308535630383,40.0,0.0
22554,2,2554,[182 269 174 204   1],535,3,10419,4.077886497064579,0.0,0.0
22555,2,2555,[318 496 588  98 357],450,5,10424,4.078247261345853,40.0,0.0
22556,2,2556,[318 496 588  98 357],18,5,10429,4.078607743449354,40.0,0.0
22557,2,2557,[318 496 588  98 357],450,5,10434,4.0789679437060204,40.0,0.0
22558,2,2558,[238   9 181  89 202],786,5,10439,4.079327862446268,0.0,0.0
22559,2,2559,[125 483  69  25 286],151,5,10444,4.0796875,0.0,20.0
22560,2,2560,[568 174 257 132 323],796,4,10448,4.079656384224912,0.0,0.0
22561,2,2561,[196  82  50  96  11],655,1,10449,4.078454332552694,0.0,20.0
22562,2,2562,[118 194  56   1 174],457,5,10454,4.078813889972689,0.0,0.0
22563,2,2563,[333 182  70   8 238],655,1,10455,4.077613104524181,0.0,0.0
22564,2,2564,[176 172 222 333 117],236,1,10456,4.076413255360624,0.0,0.0
22565,2,2565,[318 496 588  98 357],796,5,10461,4.076773187840998,40.0,0.0
22566,2,2566,[318 496 588  98 357],786,5,10466,4.077132839890924,40.0,0.0
22567,2,2567,[172 216 265 742 318],450,5,10471,4.077492211838006,20.0,0.0
22568,2,2568,[196 546 200 289  71],236,2,10473,4.076683534449202,0.0,0.0
22569,2,2569,[318 496 588  98 357],18,5,10478,4.07704280155642,40.0,0.0
22570,2,2570,[210 258  11 282 546],457,4,10482,4.077012835472579,0.0,0.0
22571,2,2571,[318 496 588  98 357],786,5,10487,4.077371695178849,40.0,0.0
22572,2,2572,[258 196 135 546  12],457,4,10491,4.077341624562767,0.0,0.0
22573,2,2573,[271 196 273 275 234],629,4,10495,4.077311577311577,0.0,20.0
22574,2,2574,[196 161 181 222 235],450,3,10498,4.076893203883495,0.0,0.0
22575,2,2575,[161 174 181 182 313],796,5,10503,4.0772515527950315,0.0,0.0
22576,2,2576,[318 496 588  98 357],796,5,10508,4.077609623593325,40.0,0.0
22577,2,2577,[181 423 187 313  69],796,5,10513,4.077967416602017,0.0,0.0
22578,2,2578,[143 496 276   1 483],18,5,10518,4.078324932144242,20.0,0.0
22579,2,2579,[132 176 180 118 181],716,2,10520,4.077519379844961,0.0,0.0
22580,2,2580,[318 496 588  98 357],716,5,10525,4.077876791941108,40.0,0.0
22581,2,2581,[245 186 194 143 153],796,3,10528,4.0774593338497285,0.0,0.0
22582,2,2582,[168 185 153 173 194],796,5,10533,4.077816492450639,0.0,0.0
22583,2,2583,[678 300  28 127 237],504,4,10537,4.0777863777089784,0.0,20.0
22584,2,2584,[318 496 588  98 357],330,5,10542,4.078143133462282,40.0,0.0
22585,2,2585,[318 496 588  98 357],450,5,10547,4.078499613302397,40.0,0.0
22586,2,2586,[318 496 588  98 357],330,5,10552,4.078855817549285,40.0,0.0
22587,2,2587,[121  50 568 234  88],577,2,10554,4.078052550231839,0.0,20.0
22588,2,2588,[568 655 175 235 238],269,3,10557,4.077636152954809,0.0,0.0
22589,2,2589,[318 496 588  98 357],450,5,10562,4.077992277992278,40.0,0.0
22590,2,2590,[318 496 588  98 357],796,5,10567,4.078348128135855,40.0,0.0
22591,2,2591,[318 496 588  98 357],716,5,10572,4.078703703703703,40.0,0.0
22592,2,2592,[132 568 174  98 318],330,5,10577,4.079059005013498,20.0,0.0
22593,2,2593,[257 237  70 153 185],401,2,10579,4.078257517347725,0.0,0.0
22594,2,2594,[318 496 588  98 357],796,5,10584,4.078612716763006,40.0,0.0
22595,2,2595,[196 135 153 111 100],236,1,10585,4.077426810477658,0.0,20.0
22596,2,2596,[546  50 195 588  98],786,5,10590,4.077782056218714,0.0,20.0
22597,2,2597,[117 748 185 385 172],450,5,10595,4.078137028483448,0.0,0.0
22598,2,2598,[300 471 172 423 185],389,4,10599,4.078106964217007,0.0,0.0
22599,2,2599,[200 427 168 121 483],716,5,10604,4.078461538461538,20.0,0.0
22600,2,2600,[318 496 588  98 357],786,5,10609,4.078815840061515,40.0,0.0
22601,2,2601,[204  69 211  89 475],655,1,10610,4.077632590315142,0.0,0.0
22602,2,2602,[ 25 275  89   4 191],18,2,10612,4.076834421820976,0.0,20.0
22603,2,2603,[318 496 588  98 357],330,5,10617,4.0771889400921655,40.0,0.0
22604,2,2604,[196  88 357 202 210],786,5,10622,4.0775431861804226,0.0,0.0
22605,2,2605,[318 496 588  98 357],796,5,10627,4.077897160399079,40.0,0.0
22606,2,2606,[204 748 118 180 168],450,4,10631,4.077867280398926,0.0,0.0
22607,2,2607,[204 546 245 385 258],450,5,10636,4.078220858895706,0.0,0.0
22608,2,2608,[ 56 161   7  79 288],693,3,10639,4.077807589114603,0.0,0.0
22609,2,2609,[  9 210 508 143 228],693,1,10640,4.076628352490421,0.0,0.0
22610,2,2610,[275   1 258 125 234],796,3,10643,4.076216009191881,0.0,20.0
22611,2,2611,[318 496 588  98 357],450,5,10648,4.076569678407351,40.0,0.0
22612,2,2612,[222  97 172 196 238],151,5,10653,4.076923076923077,0.0,0.0
22613,2,2613,[202 194  64 121 427],151,5,10658,4.077276205049732,40.0,0.0
22614,2,2614,[603 423 153 143  22],330,5,10663,4.077629063097515,20.0,0.0
22615,2,2615,[179 238 385 301 318],655,2,10665,4.076834862385321,20.0,0.0
22616,2,2616,[195   4 435 302 235],450,3,10668,4.07642338555598,0.0,0.0
22617,2,2617,[ 50  69  71  15 143],450,3,10671,4.0760122230710465,0.0,20.0
22618,2,2618,[318 496 588  98 357],450,5,10676,4.076365024818633,40.0,0.0
22619,2,2619,[197 183 172 202 237],796,4,10680,4.076335877862595,0.0,0.0
22620,2,2620,[ 69 318 588 403 111],577,5,10685,4.076688286913392,20.0,0.0
22621,2,2621,[318 496 588  98 357],450,5,10690,4.077040427154843,40.0,0.0
22622,2,2622,[423  71 204 216 174],330,5,10695,4.077392298894396,0.0,0.0
22623,2,2623,[318 496 588  98 357],330,5,10700,4.077743902439025,40.0,0.0
22624,2,2624,[186 271 273  98  88],655,2,10702,4.076952380952381,0.0,0.0
22625,2,2625,[385   9  22 187 183],796,4,10706,4.076923076923077,0.0,0.0
22626,2,2626,[655 300 111  88 483],151,5,10711,4.077274457556148,0.0,0.0
22627,2,2627,[196 185 294 237  50],236,2,10713,4.07648401826484,0.0,20.0
22628,2,2628,[427 185 357 121 508],269,4,10717,4.076454925827311,20.0,0.0
22629,2,2629,[286 235 100 385 121],330,5,10722,4.07680608365019,0.0,40.0
22630,2,2630,[318 496 588  98 357],786,5,10727,4.077156974534398,40.0,0.0
22631,2,2631,[318 496 588  98 357],786,5,10732,4.077507598784194,40.0,0.0
22632,2,2632,[318 496 588  98 357],786,5,10737,4.07785795670338,40.0,0.0
22633,2,2633,[318 496 588  98 357],450,5,10742,4.078208048595292,40.0,0.0
22634,2,2634,[318 496 588  98 357],450,5,10747,4.078557874762808,40.0,0.0
22635,2,2635,[ 15 427 403  50 238],18,4,10751,4.078528072837633,20.0,20.0
22636,2,2636,[191 276 127 238  15],269,4,10755,4.078498293515358,0.0,20.0
22637,2,2637,[  8 200 196 427 132],18,3,10758,4.078089461713419,20.0,0.0
22638,2,2638,[318 496 588  98 357],786,5,10763,4.078438802576733,40.0,0.0
22639,2,2639,[318 496 588  98 357],786,5,10768,4.078787878787879,40.0,0.0
22640,2,2640,[ 56  88  25   4 197],716,4,10772,4.078758046194623,0.0,0.0
22641,2,2641,[318 496 588  98 357],330,5,10777,4.079106737320212,40.0,0.0
22642,2,2642,[204 182 403  89 471],655,2,10779,4.078320090805902,0.0,0.0
22643,2,2643,[238 200 282 742 228],796,3,10782,4.077912254160363,0.0,0.0
22644,2,2644,[318 496 588  98 357],330,5,10787,4.078260869565217,40.0,0.0
22645,2,2645,[318 496 588  98 357],18,5,10792,4.0786092214663645,40.0,0.0
22646,2,2646,[318 496 588  98 357],786,5,10797,4.078957310162448,40.0,0.0
22647,2,2647,[318 496 588  98 357],18,5,10802,4.079305135951661,40.0,0.0
22648,2,2648,[318 496 588  98 357],18,5,10807,4.079652699131747,40.0,0.0
22649,2,2649,[179 183 475 175  98],269,4,10811,4.079622641509434,0.0,0.0
22650,2,2650,[211 235 191 273 423],450,3,10814,4.07921539041871,0.0,0.0
22651,2,2651,[405 187 435 245 742],450,5,10819,4.079562594268476,0.0,0.0
22652,2,2652,[ 28  69 176 318 117],693,2,10821,4.07877874104787,20.0,0.0
22653,2,2653,[318 496 588  98 357],716,5,10826,4.0791258477769405,40.0,0.0
22654,2,2654,[318 496 588  98 357],18,5,10831,4.079472693032015,40.0,0.0
22655,2,2655,[200 568 427 216  69],330,5,10836,4.079819277108434,20.0,0.0
22656,2,2656,[678 508 313  89 151],344,3,10839,4.079412871659767,0.0,0.0
22657,2,2657,[483   1 174 180 748],280,3,10842,4.07900677200903,0.0,0.0
22658,2,2658,[568 403 294  15 483],655,1,10843,4.077848815344114,0.0,0.0
22659,2,2659,[174 100  88 204  56],269,2,10845,4.077067669172933,0.0,20.0
22660,2,2660,[318 496 588  98 357],716,5,10850,4.077414505824878,40.0,0.0
22661,2,2661,[318 496 588  98 357],716,5,10855,4.077761081893313,40.0,0.0
22662,2,2662,[318 496 588  98 357],716,5,10860,4.078107397671799,40.0,0.0
22663,2,2663,[318 496 588  98 357],450,5,10865,4.078453453453453,40.0,0.0
22664,2,2664,[210 153 117 195 204],236,0,10865,4.076923076923077,0.0,0.0
22665,2,2665,[318 496 588  98 357],786,5,10870,4.077269317329332,40.0,0.0
22666,2,2666,[318 496 588  98 357],330,5,10875,4.077615298087739,40.0,0.0
22667,2,2667,[196 125  98 471   8],577,4,10879,4.077586206896552,0.0,0.0
22668,2,2668,[318 496 588  98 357],18,5,10884,4.077931809666541,40.0,0.0
22669,2,2669,[318 496 588  98 357],450,5,10889,4.078277153558052,40.0,0.0
22670,2,2670,[318 496 588  98 357],716,5,10894,4.07862223886185,40.0,0.0
22671,2,2671,[318 496 588  98 357],796,5,10899,4.078967065868263,40.0,0.0
22672,2,2672,[318 496 588  98 357],330,5,10904,4.0793116348671905,40.0,0.0
22673,2,2673,[204 173 655 323  98],23,2,10906,4.0785340314136125,0.0,0.0
22674,2,2674,[318 496 588  98 357],330,5,10911,4.078878504672897,40.0,0.0
22675,2,2675,[318 496 588  98 357],786,5,10916,4.079222720478326,40.0,0.0
22676,2,2676,[483 294  12 238  79],457,4,10920,4.0791931266342925,0.0,0.0
22677,2,2677,[173  64 202 228 183],151,4,10924,4.079163554891711,20.0,0.0
22678,2,2678,[318 496 588  98 357],450,5,10929,4.079507278835386,40.0,0.0
22679,2,2679,[168  88 301 588 196],389,3,10932,4.07910447761194,0.0,0.0
22680,2,2680,[318 496 588  98 357],450,5,10937,4.079447967176427,40.0,0.0
22681,2,2681,[318 496 588  98 357],796,5,10942,4.07979120059657,40.0,0.0
22682,2,2682,[288 655 318  98 268],655,2,10944,4.079016026835632,20.0,0.0
22683,2,2683,[238  69 135 187 174],18,3,10947,4.078614008941877,0.0,0.0
22684,2,2684,[318 496 588  98 357],796,5,10952,4.0789571694599625,40.0,0.0
22685,2,2685,[318 496 588  98 357],716,5,10957,4.079300074460164,40.0,0.0
22686,2,2686,[174 568 318 323 187],796,4,10961,4.079270561965017,20.0,0.0
22687,2,2687,[603 204  95 117 132],450,4,10965,4.079241071428571,20.0,0.0
22688,2,2688,[318 496 588  98 357],450,5,10970,4.079583488285608,40.0,0.0
22689,2,2689,[318 496 588  98 357],716,5,10975,4.0799256505576205,40.0,0.0
22690,2,2690,[318 496 588  98 357],18,5,10980,4.080267558528428,40.0,0.0
22691,2,2691,[194 275  89 187  12],450,5,10985,4.080609212481426,0.0,20.0
22692,2,2692,[258 200 302 269  97],655,2,10987,4.079836613442258,0.0,0.0
22693,2,2693,[318 496 588  98 357],716,5,10992,4.080178173719377,40.0,0.0
22694,2,2694,[318 496 588  98 357],786,5,10997,4.080519480519481,40.0,0.0
22695,2,2695,[172   7 245 300 328],450,5,11002,4.080860534124629,0.0,0.0
22696,2,2696,[318 496 588  98 357],716,5,11007,4.081201334816463,40.0,0.0
22697,2,2697,[318 496 588  98 357],786,5,11012,4.081541882876205,40.0,0.0
22698,2,2698,[318 496 588  98 357],716,5,11017,4.081882178584661,40.0,0.0
22699,2,2699,[318 496 588  98 357],330,5,11022,4.082222222222223,40.0,0.0
22700,2,2700,[318 496 588  98 357],18,5,11027,4.082562014068864,40.0,0.0
22701,2,2701,[318 496 588  98 357],450,5,11032,4.082901554404145,40.0,0.0
22702,2,2702,[ 70 588  97 435  69],716,5,11037,4.083240843507214,0.0,0.0
22703,2,2703,[357 257 144 238 483],796,4,11041,4.083210059171598,0.0,0.0
22704,2,2704,[127 194 186 185 245],450,4,11045,4.0831792975970425,0.0,20.0
22705,2,2705,[118 180 117 258 204],796,4,11049,4.083148558758315,0.0,0.0
22706,2,2706,[318 496 588  98 357],18,5,11054,4.08348725526413,40.0,0.0
22707,2,2707,[318 496 588  98 357],796,5,11059,4.083825701624815,40.0,0.0
22708,2,2708,[318 496 588  98 357],450,5,11064,4.084163898117387,40.0,0.0
22709,2,2709,[603 216 302 210  82],389,3,11067,4.083763837638377,20.0,0.0
22710,2,2710,[568 301 597 174 144],796,4,11071,4.083732939874585,0.0,0.0
22711,2,2711,[318 496 588  98 357],450,5,11076,4.084070796460177,40.0,0.0
22712,2,2712,[318 496 588  98 357],786,5,11081,4.084408403980833,40.0,0.0
22713,2,2713,[318 496 588  98 357],330,5,11086,4.084745762711864,40.0,0.0
22714,2,2714,[318 496 588  98 357],18,5,11091,4.085082872928177,40.0,0.0
22715,2,2715,[318 496 588  98 357],330,5,11096,4.085419734904271,40.0,0.0
22716,2,2716,[174 180 202 322 483],280,3,11099,4.08502024291498,0.0,0.0
22717,2,2717,[301 588  56 423 132],389,5,11104,4.085356880058867,0.0,0.0
22718,2,2718,[318 496 588  98 357],716,5,11109,4.085693269584406,40.0,0.0
22719,2,2719,[234 143 286 100 313],593,4,11113,4.085661764705883,0.0,40.0
22720,2,2720,[222 216 111  96 322],280,4,11117,4.085630282984197,0.0,0.0
22721,2,2721,[ 98 191 234 143 318],269,3,11120,4.085231447465099,20.0,0.0
22722,2,2722,[318 496 588  98 357],450,5,11125,4.085567388909292,40.0,0.0
22723,2,2723,[318 496 588  98 357],796,5,11130,4.08590308370044,40.0,0.0
22724,2,2724,[ 98 275   4 111  95],450,3,11133,4.085504587155963,0.0,20.0
22725,2,2725,[318 496 588  98 357],18,5,11138,4.085840058694057,40.0,0.0
22726,2,2726,[318 496 588  98 357],450,5,11143,4.086175284195086,40.0,0.0
22727,2,2727,[  9 100  71 742 196],593,4,11147,4.086143695014663,0.0,20.0
22728,2,2728,[318 496 588  98 357],796,5,11152,4.086478563576402,40.0,0.0
22729,2,2729,[  1 151  79  64 118],344,3,11155,4.086080586080586,20.0,0.0
22730,2,2730,[318 496 588  98 357],786,5,11160,4.086415232515562,40.0,0.0
22731,2,2731,[143 176 258 483  64],450,4,11164,4.086383601756955,20.0,0.0
22732,2,2732,[318 496 588  98 357],450,5,11169,4.086717892425906,40.0,0.0
22733,2,2733,[318 496 588  98 357],796,5,11174,4.087051938551573,40.0,0.0
22734,2,2734,[318 496 588  98 357],450,5,11179,4.087385740402194,40.0,0.0
22735,2,2735,[318 496 588  98 357],796,5,11184,4.087719298245614,40.0,0.0
22736,2,2736,[318 496 588  98 357],330,5,11189,4.088052612349288,40.0,0.0
22737,2,2737,[200 204  88 132  97],716,5,11194,4.088385682980277,0.0,0.0
22738,2,2738,[318 496 588  98 357],330,5,11199,4.088718510405258,40.0,0.0
22739,2,2739,[258 176 357 276  25],504,3,11202,4.088321167883212,0.0,0.0
22740,2,2740,[318 496 588  98 357],330,5,11207,4.088653775994163,40.0,0.0
22741,2,2741,[197  97  79 125 191],450,5,11212,4.088986141502553,0.0,0.0
22742,2,2742,[385  56 125  15 318],577,3,11215,4.088589135982501,20.0,0.0
22743,2,2743,[603 269 195 183 258],23,4,11219,4.088556851311953,20.0,0.0
22744,2,2744,[222 265  95 405 238],716,5,11224,4.088888888888889,0.0,0.0
22745,2,2745,[100 302 322 143 483],450,4,11228,4.088856518572469,0.0,20.0
22746,2,2746,[318 496 588  98 357],786,5,11233,4.089188205314889,40.0,0.0
22747,2,2747,[100 202 265 186 258],655,0,11233,4.087700145560407,0.0,20.0
22748,2,2748,[318 496 588  98 357],450,5,11238,4.088032011640596,40.0,0.0
22749,2,2749,[318 496 588  98 357],716,5,11243,4.088363636363637,40.0,0.0
22750,2,2750,[204 183 275 127  98],655,4,11247,4.088331515812432,0.0,40.0
22751,2,2751,[318 496 588  98 357],796,5,11252,4.088662790697675,40.0,0.0
22752,2,2752,[318 496 588  98 357],18,5,11257,4.088993824918271,40.0,0.0
22753,2,2753,[211 173 204 282 185],401,3,11260,4.088598402323893,0.0,0.0
22754,2,2754,[318 496 588  98 357],786,5,11265,4.088929219600726,40.0,0.0
22755,2,2755,[318 496 588  98 357],330,5,11270,4.089259796806966,40.0,0.0
22756,2,2756,[318 496 588  98 357],450,5,11275,4.089590134203845,40.0,0.0
22757,2,2757,[318 496 588  98 357],796,5,11280,4.0899202320522114,40.0,0.0
22758,2,2758,[282 405   7 471 235],457,4,11284,4.089887640449438,0.0,0.0
22759,2,2759,[318 496 588  98 357],716,5,11289,4.090217391304348,40.0,0.0
22760,2,2760,[174 196 275 127   9],344,5,11294,4.090546903295907,0.0,40.0
22761,2,2761,[318 496 588  98 357],786,5,11299,4.090876176683563,40.0,0.0
22762,2,2762,[318 496 588  98 357],450,5,11304,4.091205211726384,40.0,0.0
22763,2,2763,[168  70 273  79 161],450,4,11308,4.091172214182344,0.0,0.0
22764,2,2764,[135  11  71 216  79],280,5,11313,4.091500904159132,0.0,0.0
22765,2,2765,[318 496 588  98 357],18,5,11318,4.091829356471439,40.0,0.0
22766,2,2766,[234 143 748 127 151],796,4,11322,4.0917961691362486,0.0,20.0
22767,2,2767,[318 496 588  98 357],450,5,11327,4.092124277456647,40.0,0.0
22768,2,2768,[318 496 588  98 357],18,5,11332,4.092452148790177,40.0,0.0
22769,2,2769,[483 245 333 286  50],796,3,11335,4.092057761732852,0.0,40.0
22770,2,2770,[318 496 588  98 357],716,5,11340,4.092385420425839,40.0,0.0
22771,2,2771,[318 496 588  98 357],796,5,11345,4.092712842712842,40.0,0.0
22772,2,2772,[ 64 118 302 423 174],450,4,11349,4.092679408582763,20.0,0.0
22773,2,2773,[161 132  79 313  89],450,5,11354,4.093006488824802,0.0,0.0
22774,2,2774,[546  71 202 245  79],344,2,11356,4.092252252252252,0.0,0.0
22775,2,2775,[ 56  50 185   8  98],796,5,11361,4.092579250720461,0.0,20.0
22776,2,2776,[237 234 179 318 204],835,4,11365,4.092545912855599,20.0,0.0
22777,2,2777,[318 496 588  98 357],450,5,11370,4.092872570194385,40.0,0.0
22778,2,2778,[ 88 125 117  98 269],450,5,11375,4.093198992443325,0.0,0.0
22779,2,2779,[318 496 588  98 357],716,5,11380,4.093525179856115,40.0,0.0
22780,2,2780,[318 496 588  98 357],786,5,11385,4.093851132686084,40.0,0.0
22781,2,2781,[318 496 588  98 357],786,5,11390,4.094176851186197,40.0,0.0
22782,2,2782,[195 483 118 385 144],655,1,11391,4.093065037729069,0.0,0.0
22783,2,2783,[318 496 588  98 357],330,5,11396,4.093390804597701,40.0,0.0
22784,2,2784,[318 496 588  98 357],450,5,11401,4.093716337522442,40.0,0.0
22785,2,2785,[ 71  82 187 546 125],786,5,11406,4.094041636755205,0.0,0.0
22786,2,2786,[588  82 215 118 186],577,4,11410,4.094007893792608,0.0,0.0
22787,2,2787,[318 496 588  98 357],796,5,11415,4.094332855093257,40.0,0.0
22788,2,2788,[318 496 588  98 357],796,5,11420,4.094657583363213,40.0,0.0
22789,2,2789,[258 118 228 191 216],344,3,11423,4.0942652329749105,0.0,0.0
22790,2,2790,[ 96  22  69 151 234],269,1,11424,4.093156574704407,0.0,0.0
22791,2,2791,[ 56 215 191 153 143],151,2,11426,4.092406876790831,0.0,0.0
22792,2,2792,[423 195 194 403 257],504,3,11429,4.092015753669889,0.0,0.0
22793,2,2793,[318 496 588  98 357],716,5,11434,4.092340730136006,40.0,0.0
22794,2,2794,[318 496 588  98 357],450,5,11439,4.092665474060823,40.0,0.0
22795,2,2795,[318 496 588  98 357],330,5,11444,4.0929899856938485,40.0,0.0
22796,2,2796,[282  70 215 597  25],450,4,11448,4.092956739363604,0.0,0.0
22797,2,2797,[  7  96 597  15 117],450,4,11452,4.092923516797713,0.0,0.0
22798,2,2798,[318 496 588  98 357],330,5,11457,4.093247588424437,40.0,0.0
22799,2,2799,[318 496 588  98 357],716,5,11462,4.093571428571429,40.0,0.0
22800,2,2800,[186 100 546 151 200],151,2,11464,4.092823991431632,0.0,20.0
22801,2,2801,[234 194  22 196 117],450,4,11468,4.092790863668808,0.0,0.0
22802,2,2802,[385 288 183 222 483],457,5,11473,4.093114520156974,0.0,0.0
22803,2,2803,[ 71 143 257 111  28],796,4,11477,4.093081312410842,0.0,0.0
22804,2,2804,[471 237  50  22  15],457,5,11482,4.0934046345811055,0.0,20.0
22805,2,2805,[655 323 182 322 174],796,2,11484,4.092658588738417,0.0,0.0
22806,2,2806,[318 496 588  98 357],18,5,11489,4.092981831136445,40.0,0.0
22807,2,2807,[496 237  25 186  98],577,5,11494,4.093304843304844,20.0,0.0
22808,2,2808,[318 496 588  98 357],330,5,11499,4.093627625489498,40.0,0.0
22809,2,2809,[515 483  11 195 427],716,4,11503,4.093594306049822,20.0,0.0
22810,2,2810,[210 196 143 282 228],693,2,11505,4.092849519743863,0.0,0.0
22811,2,2811,[ 82 471 435  64 301],389,5,11510,4.093172119487909,20.0,0.0
22812,2,2812,[181 182 176 172  70],450,5,11515,4.093494489868468,0.0,0.0
22813,2,2813,[121 211 168 322 588],450,4,11519,4.093461265103056,0.0,0.0
22814,2,2814,[435 300  97 357 216],716,5,11524,4.093783303730018,0.0,0.0
22815,2,2815,[318 496 588  98 357],450,5,11529,4.094105113636363,40.0,0.0
22816,2,2816,[318 496 588  98 357],450,5,11534,4.094426695065673,40.0,0.0
22817,2,2817,[318 496 588  98 357],330,5,11539,4.094748048261178,40.0,0.0
22818,2,2818,[318 496 588  98 357],796,5,11544,4.095069173465768,40.0,0.0
22819,2,2819,[ 82 216 427 153 235],330,5,11549,4.095390070921986,20.0,0.0
22820,2,2820,[100 318 168 185 132],503,5,11554,4.095710740872031,20.0,20.0
22821,2,2821,[483 228 151 427 237],450,4,11558,4.095676824946846,20.0,0.0
22822,2,2822,[275 175 186 127 132],716,3,11561,4.095288699964577,0.0,40.0
22823,2,2823,[318 496 588  98 357],330,5,11566,4.0956090651558075,40.0,0.0
22824,2,2824,[318 496 588  98 357],18,5,11571,4.095929203539823,40.0,0.0
22825,2,2825,[180 282 471 300 191],450,5,11576,4.096249115357396,0.0,0.0
22826,2,2826,[161 385 100  88 121],401,2,11578,4.095507605235231,0.0,20.0
22827,2,2827,[318 496 588  98 357],796,5,11583,4.095827439886846,40.0,0.0
22828,2,2828,[748 294 323  50 257],796,3,11586,4.095440084835631,0.0,20.0
22829,2,2829,[ 71  25 471   9 172],401,2,11588,4.094699646643109,0.0,0.0
22830,2,2830,[318 496 588  98 357],18,5,11593,4.095019427764041,40.0,0.0
22831,2,2831,[318 496 588  98 357],716,5,11598,4.095338983050848,40.0,0.0
22832,2,2832,[173  88   1 245  95],450,4,11602,4.095305330038828,0.0,0.0
22833,2,2833,[ 70 405 300  98 301],11,2,11604,4.094565984474241,0.0,0.0
22834,2,2834,[333  22 172 181 405],796,5,11609,4.094885361552028,0.0,0.0
22835,2,2835,[318 496 588 357  98],330,5,11614,4.095204513399154,40.0,0.0
22836,2,2836,[568 385 302 179 496],450,5,11619,4.095523440253789,20.0,0.0
22837,2,2837,[318 496 588 357  98],786,5,11624,4.09584214235377,40.0,0.0
22838,2,2838,[318 496 588 357  98],450,5,11629,4.096160619936597,40.0,0.0
22839,2,2839,[210 216 508 301 302],655,2,11631,4.095422535211267,0.0,0.0
22840,2,2840,[238  71 235   7 176],23,2,11633,4.094684970080958,0.0,0.0
22841,2,2841,[318 496 588 357  98],786,5,11638,4.095003518648839,40.0,0.0
22842,2,2842,[318 496 588 357  98],330,5,11643,4.095321843123461,40.0,0.0
22843,2,2843,[318 496 588 357  98],716,5,11648,4.09563994374121,40.0,0.0
22844,2,2844,[603 318 153 282 288],450,4,11652,4.095606326889279,40.0,0.0
22845,2,2845,[238 546 403 318 216],796,4,11656,4.095572733661279,20.0,0.0
22846,2,2846,[196 215 173 471  82],577,4,11660,4.095539164032314,0.0,0.0
22847,2,2847,[318 496 588 357  98],330,5,11665,4.095856741573034,40.0,0.0
22848,2,2848,[318 496 588 357  98],716,5,11670,4.096174096174096,40.0,0.0
22849,2,2849,[318 496 588 357  98],450,5,11675,4.0964912280701755,40.0,0.0
22850,2,2850,[318 496 588 357  98],18,5,11680,4.096808137495616,40.0,0.0
22851,2,2851,[318 496 588 357  98],716,5,11685,4.097124824684432,40.0,0.0
22852,2,2852,[318 496 588 357  98],18,5,11690,4.097441289870312,40.0,0.0
22853,2,2853,[238 322  50 427 196],151,4,11694,4.097407147862649,20.0,20.0
22854,2,2854,[435 211 546 748 265],450,5,11699,4.097723292469352,0.0,0.0
22855,2,2855,[475 568 471 135  25],655,1,11700,4.0966386554621845,0.0,0.0
22856,2,2856,[655 423 471 144 275],593,2,11702,4.095904795239762,0.0,20.0
22857,2,2857,[185 385  28 234 216],504,4,11706,4.095871238628411,0.0,0.0
22858,2,2858,[210 275 216 179  69],450,4,11710,4.095837705491431,0.0,20.0
22859,2,2859,[427   4 161 176 186],577,5,11715,4.096153846153846,20.0,0.0
22860,2,2860,[286 127 186 603  79],503,3,11718,4.095770709542118,20.0,40.0
22861,2,2861,[318 496 588 357  98],796,5,11723,4.096086652690427,40.0,0.0
22862,2,2862,[318 496 588 357  98],786,5,11728,4.096402375130982,40.0,0.0
22863,2,2863,[318 496 588 357  98],330,5,11733,4.096717877094972,40.0,0.0
22864,2,2864,[ 22 186 118 195 151],457,5,11738,4.097033158813264,0.0,0.0
22865,2,2865,[655 257 200 202 196],655,1,11739,4.095952547103978,0.0,0.0
22866,2,2866,[568 271 195   1 174],796,4,11743,4.09591907917684,0.0,0.0
22867,2,2867,[318 496 588 357  98],786,5,11748,4.096234309623431,40.0,0.0
22868,2,2868,[185 210 161   8 403],796,4,11752,4.096200766817707,0.0,0.0
22869,2,2869,[ 71 172 100 322  64],401,1,11753,4.095121951219512,20.0,20.0
22870,2,2870,[143 153 194 357 174],911,5,11758,4.095437129919889,0.0,0.0
22871,2,2871,[ 56 228 257 181 191],716,5,11763,4.09575208913649,0.0,0.0
22872,2,2872,[318 496 588 357  98],450,5,11768,4.096066829098503,40.0,0.0
22873,2,2873,[117 237 483 185 222],655,2,11770,4.095337508698678,0.0,0.0
22874,2,2874,[196  95 202 174   4],786,5,11775,4.095652173913043,0.0,0.0
22875,2,2875,[181  12 273 111 597],796,4,11779,4.095618915159944,0.0,0.0
22876,2,2876,[318 496 588 357  98],786,5,11784,4.095933263816476,40.0,0.0
22877,2,2877,[322  88 546 210 181],256,5,11789,4.096247394023628,0.0,0.0
22878,2,2878,[318 496 588 357  98],330,5,11794,4.096561306009031,40.0,0.0
22879,2,2879,[318 496 588 357  98],450,5,11799,4.096875,40.0,0.0
22880,2,2880,[405 100 483  50  22],450,4,11803,4.096841374522735,0.0,40.0
22881,2,2881,[173 210  56  88 181],389,2,11805,4.096113809854268,0.0,0.0
22882,2,2882,[153 257 318 121 215],796,5,11810,4.096427332639611,20.0,0.0
22883,2,2883,[318 496 588 357  98],18,5,11815,4.096740638002774,40.0,0.0
22884,2,2884,[ 97 161 211 125 258],450,5,11820,4.097053726169844,0.0,0.0
22885,2,2885,[ 50 603   9 423 125],292,4,11824,4.097020097020097,20.0,20.0
22886,2,2886,[161  88 202 195 328],796,5,11829,4.097332871492899,0.0,0.0
22887,2,2887,[318 496 588 357  98],18,5,11834,4.097645429362881,40.0,0.0
22888,2,2888,[318 496 588 357  98],330,5,11839,4.0979577708549675,40.0,0.0
22889,2,2889,[471 313 275 195 204],450,5,11844,4.098269896193772,0.0,20.0
22890,2,2890,[318 496 588 357  98],786,5,11849,4.098581805603597,40.0,0.0
22891,2,2891,[ 50 151 597 245 100],938,3,11852,4.09820193637621,0.0,40.0
22892,2,2892,[176 403 234 282 182],450,4,11856,4.098167991704114,0.0,0.0
22893,2,2893,[187   9 174 603 405],796,4,11860,4.09813407049067,20.0,0.0
22894,2,2894,[318 496 588 357  98],716,5,11865,4.098445595854923,40.0,0.0
22895,2,2895,[180  25 153 215 508],535,5,11870,4.098756906077348,0.0,0.0
22896,2,2896,[318 496 588 357  98],18,5,11875,4.099068001380739,40.0,0.0
22897,2,2897,[318 496 588 357  98],330,5,11880,4.099378881987578,40.0,0.0
22898,2,2898,[301 405 265 294 483],796,3,11883,4.098999655053467,0.0,0.0
22899,2,2899,[318 496 588 357  98],786,5,11888,4.099310344827586,40.0,0.0
22900,2,2900,[ 70  12 180 179 144],457,5,11893,4.099620820406757,0.0,0.0
22901,2,2901,[318 496 588 357  98],716,5,11898,4.0999310820124055,40.0,0.0
22902,2,2902,[328 181 210 238 197],655,0,11898,4.098518773682398,0.0,0.0
22903,2,2903,[318 496 588 357  98],330,5,11903,4.098829201101928,40.0,0.0
22904,2,2904,[265 118 655 286 168],450,4,11907,4.098795180722892,0.0,20.0
22905,2,2905,[151 257 568 275   1],796,4,11911,4.098761183757743,0.0,20.0
22906,2,2906,[318 496 588 357  98],786,5,11916,4.099071207430341,40.0,0.0
22907,2,2907,[318 496 588 357  98],716,5,11921,4.099381017881706,40.0,0.0
22908,2,2908,[318 496 588 357  98],796,5,11926,4.099690615331729,40.0,0.0
22909,2,2909,[  8 678   7 111  11],344,3,11929,4.099312714776632,0.0,0.0
22910,2,2910,[318 496 588 357  98],716,5,11934,4.099622122981793,40.0,0.0
22911,2,2911,[185 301 100 172   7],151,4,11938,4.099587912087912,0.0,20.0
22912,2,2912,[318 496 588 357  98],450,5,11943,4.09989701338826,40.0,0.0
22913,2,2913,[318 496 588 357  98],330,5,11948,4.100205902539464,40.0,0.0
22914,2,2914,[228 403   8 483 186],796,4,11952,4.100171526586621,0.0,0.0
22915,2,2915,[318 496 588 357  98],796,5,11957,4.100480109739369,40.0,0.0
22916,2,2916,[318 496 588 357  98],796,5,11962,4.100788481316421,40.0,0.0
22917,2,2917,[318 496 588 357  98],716,5,11967,4.101096641535298,40.0,0.0
22918,2,2918,[318 496 588 357  98],18,5,11972,4.101404590613224,40.0,0.0
22919,2,2919,[200 275 515 196 143],716,5,11977,4.101712328767123,0.0,20.0
22920,2,2920,[216  88 483 186 258],693,2,11979,4.100992810681274,0.0,0.0
22921,2,2921,[318 496 588 357  98],796,5,11984,4.101300479123887,40.0,0.0
22922,2,2922,[ 69 176 748 294 313],796,4,11988,4.10126582278481,0.0,0.0
22923,2,2923,[318 496 588 357  98],450,5,11993,4.101573187414501,40.0,0.0
22924,2,2924,[194 100 302 197 153],401,3,11996,4.101196581196581,0.0,20.0
22925,2,2925,[318 496 588 357  98],330,5,12001,4.101503759398496,40.0,0.0
22926,2,2926,[ 12 228 210 176 143],457,5,12006,4.101810727707551,0.0,0.0
22927,2,2927,[215 176  96 127 117],344,3,12009,4.101434426229508,0.0,20.0
22928,2,2928,[318 496 588 357  98],786,5,12014,4.101741208603619,40.0,0.0
22929,2,2929,[318 496 588 357  98],450,5,12019,4.102047781569966,40.0,0.0
22930,2,2930,[318 496 588 357  98],796,5,12024,4.102354145342886,40.0,0.0
22931,2,2931,[ 82 175 234 301  28],655,0,12024,4.100954979536152,0.0,0.0
22932,2,2932,[294 211 269   9 435],655,0,12024,4.099556767814525,0.0,0.0
22933,2,2933,[318 496 588 357  98],330,5,12029,4.0998636673483295,40.0,0.0
22934,2,2934,[ 69  11 269  79 151],450,5,12034,4.100170357751278,0.0,0.0
22935,2,2935,[318 496 588 357  98],716,5,12039,4.100476839237057,40.0,0.0
22936,2,2936,[ 88 187 282 265  28],236,2,12041,4.099761661559414,0.0,0.0
22937,2,2937,[318 496 588 357  98],796,5,12046,4.100068073519401,40.0,0.0
22938,2,2938,[175 181 655 235 172],23,3,12049,4.0996937733923104,0.0,0.0
22939,2,2939,[ 28 568 127 508 282],693,3,12052,4.099319727891157,0.0,20.0
22940,2,2940,[237 235  22 179  70],269,1,12053,4.098265895953757,0.0,0.0
22941,2,2941,[318 496 588 357  98],330,5,12058,4.098572399728076,40.0,0.0
22942,2,2942,[191 183 186 197 117],786,4,12062,4.098538905878355,0.0,0.0
22943,2,2943,[202 385  12 185  50],151,4,12066,4.098505434782608,0.0,20.0
22944,2,2944,[195  70 403 179 168],450,5,12071,4.098811544991511,0.0,0.0
22945,2,2945,[187 265 132 144  50],535,2,12073,4.098099117447386,0.0,20.0
22946,2,2946,[ 97   8 118  56 318],655,1,12074,4.097047845266372,20.0,0.0
22947,2,2947,[318 496 588 357  98],330,5,12079,4.097354138398915,40.0,0.0
22948,2,2948,[471  95 568  98 282],716,3,12082,4.096982027806036,0.0,0.0
22949,2,2949,[182  12   1 222 427],450,4,12086,4.096949152542373,20.0,0.0
22950,2,2950,[ 88 195 235 323 151],256,4,12090,4.096916299559472,0.0,0.0
22951,2,2951,[318 496 588 357  98],796,5,12095,4.097222222222222,40.0,0.0
22952,2,2952,[318 496 588 357  98],716,5,12100,4.097527937690484,40.0,0.0
22953,2,2953,[ 88 423 288  12 118],693,1,12101,4.096479350033852,0.0,0.0
22954,2,2954,[318 496 588 357  98],716,5,12106,4.096785109983079,40.0,0.0
22955,2,2955,[318 496 588 357  98],330,5,12111,4.097090663058187,40.0,0.0
22956,2,2956,[318 496 588 357  98],786,5,12116,4.0973960094690565,40.0,0.0
22957,2,2957,[318 496 588 357  98],18,5,12121,4.097701149425287,40.0,0.0
22958,2,2958,[318 496 588 357  98],330,5,12126,4.098006083136195,40.0,0.0
22959,2,2959,[423  25 282 172 294],716,4,12130,4.097972972972973,0.0,0.0
22960,2,2960,[176 132 245 228 135],450,4,12134,4.097939885173928,0.0,0.0
22961,2,2961,[318 496 588 357  98],330,5,12139,4.098244429439568,40.0,0.0
22962,2,2962,[ 15 197  88 742 258],450,4,12143,4.098211272359095,0.0,0.0
22963,2,2963,[ 97 258 496 222  79],151,5,12148,4.098515519568151,20.0,0.0
22964,2,2964,[318 496 588 357  98],450,5,12153,4.098819561551434,40.0,0.0
22965,2,2965,[176 471 257 435 204],655,0,12153,4.097437626432907,0.0,0.0
22966,2,2966,[318 496 588 357  98],450,5,12158,4.097741826761038,40.0,0.0
22967,2,2967,[127 125 194 742  11],457,5,12163,4.098045822102426,0.0,20.0
22968,2,2968,[181 568 742 183  12],655,1,12164,4.097002357696194,0.0,0.0
22969,2,2969,[328 153 176 269  71],450,4,12168,4.096969696969697,0.0,0.0
22970,2,2970,[318 496 588 357  98],796,5,12173,4.097273645237294,40.0,0.0
22971,2,2971,[318 496 588 357  98],450,5,12178,4.097577388963661,40.0,0.0
22972,2,2972,[ 12 151  95 427 153],18,4,12182,4.097544567776657,20.0,0.0
22973,2,2973,[318 496 588 357  98],330,5,12187,4.097848016139879,40.0,0.0
22974,2,2974,[318 496 588 357  98],796,5,12192,4.098151260504202,40.0,0.0
22975,2,2975,[ 25  64 234 194 144],716,4,12196,4.098118279569892,20.0,0.0
22976,2,2976,[318 496 588 357  98],796,5,12201,4.098421229425596,40.0,0.0
22977,2,2977,[318 496 588 357  98],450,5,12206,4.0987239758227,40.0,0.0
22978,2,2978,[318 496 588 357  98],450,5,12211,4.099026518966096,40.0,0.0
22979,2,2979,[318 496 588 357  98],796,5,12216,4.099328859060403,40.0,0.0
22980,2,2980,[405  98  82 197 168],796,3,12219,4.098960080509896,0.0,0.0
22981,2,2981,[  8   4 135 151 216],457,5,12224,4.09926224010731,0.0,0.0
22982,2,2982,[318 496 588 357  98],18,5,12229,4.0995641971169965,40.0,0.0
22983,2,2983,[111 483  50 405 173],457,4,12233,4.099530831099195,0.0,20.0
22984,2,2984,[318 496 588 357  98],786,5,12238,4.099832495812396,40.0,0.0
22985,2,2985,[318 496 588 357  98],330,5,12243,4.100133958472873,40.0,0.0
22986,2,2986,[ 95 405 181  56  15],796,5,12248,4.100435219283562,0.0,0.0
22987,2,2987,[318 496 588 357  98],796,5,12253,4.100736278447122,40.0,0.0
22988,2,2988,[318 496 588 357  98],450,5,12258,4.1010371361659415,40.0,0.0
22989,2,2989,[ 97 742  12 117  15],655,0,12258,4.099665551839465,0.0,0.0
22990,2,2990,[483  56 179 100 197],389,5,12263,4.099966566365764,0.0,20.0
22991,2,2991,[597 235 111 180 222],457,2,12265,4.099264705882353,0.0,0.0
22992,2,2992,[318 496 588 357  98],716,5,12270,4.099565653190779,40.0,0.0
22993,2,2993,[  9 210  96 168 655],504,5,12275,4.099866399465598,0.0,0.0
22994,2,2994,[318 496 588 357  98],18,5,12280,4.10016694490818,40.0,0.0
22995,2,2995,[318 496 588 357  98],716,5,12285,4.100467289719626,40.0,0.0
22996,2,2996,[187 111  97 118 234],655,1,12286,4.099432766099433,0.0,0.0
22997,2,2997,[318 496 588 357  98],716,5,12291,4.099733155436958,40.0,0.0
22998,2,2998,[318 496 588 357  98],450,5,12296,4.10003334444815,40.0,0.0
22999,2,2999,[117   4 228 276 187],786,4,12300,4.1,0.0,0.0
23000,2,3000,[265 174  50  97 185],535,4,12304,4.099966677774075,0.0,20.0
23001,2,3001,[318 496 588 357  98],450,5,12309,4.100266489007328,40.0,0.0
23002,2,3002,[318 496 588 357  98],18,5,12314,4.100566100566101,40.0,0.0
23003,2,3003,[318 496 588 357  98],796,5,12319,4.100865512649801,40.0,0.0
23004,2,3004,[117  11 546 423 100],577,3,12322,4.100499168053244,0.0,20.0
23005,2,3005,[318 496 588 357  98],450,5,12327,4.100798403193613,40.0,0.0
23006,2,3006,[318 496 588 357  98],330,5,12332,4.101097439308281,40.0,0.0
23007,2,3007,[318 496 588 357  98],450,5,12337,4.101396276595745,40.0,0.0
23008,2,3008,[318 496 588 357  98],786,5,12342,4.101694915254237,40.0,0.0
23009,2,3009,[  7  88 603 168 100],264,4,12346,4.1016611295681065,20.0,20.0
23010,2,3010,[318 496 588 357  98],18,5,12351,4.101959481899701,40.0,0.0
23011,2,3011,[318 222 121 748 215],450,3,12354,4.101593625498008,20.0,0.0
23012,2,3012,[318 496 588 357  98],18,5,12359,4.101891802190508,40.0,0.0
23013,2,3013,[318 496 588 357  98],330,5,12364,4.102189781021898,40.0,0.0
23014,2,3014,[318 496 588 357  98],18,5,12369,4.102487562189054,40.0,0.0
23015,2,3015,[215 245 127 294 328],450,5,12374,4.102785145888594,0.0,20.0
23016,2,3016,[318 496 588 357  98],786,5,12379,4.103082532316871,40.0,0.0
23017,2,3017,[318 496 588 357  98],450,5,12384,4.10337972166998,40.0,0.0
23018,2,3018,[174 194 228 385 151],577,4,12388,4.10334547863531,0.0,0.0
23019,2,3019,[ 15 186 288 143 127],655,2,12390,4.102649006622516,0.0,20.0
23020,2,3020,[318 496 588 357  98],716,5,12395,4.102946044356173,40.0,0.0
23021,2,3021,[100 181 603 427 265],450,5,12400,4.103242885506287,40.0,20.0
23022,2,3022,[318 496 588 357  98],18,5,12405,4.103539530267946,40.0,0.0
23023,2,3023,[ 79  15  28 210 275],18,4,12409,4.103505291005291,0.0,20.0
23024,2,3024,[318 496 588 357  98],716,5,12414,4.103801652892562,40.0,0.0
23025,2,3025,[318 496 588 357  98],716,5,12419,4.104097818902842,40.0,0.0
23026,2,3026,[318 496 588 357  98],18,5,12424,4.104393789230261,40.0,0.0
23027,2,3027,[ 79  71 357 117 211],593,5,12429,4.104689564068692,0.0,0.0
23028,2,3028,[318 496 588 357  98],716,5,12434,4.104985143611753,40.0,0.0
23029,2,3029,[210 194 202 216  98],796,4,12438,4.104950495049505,0.0,0.0
23030,2,3030,[176  15 275  12 258],457,5,12443,4.105245793467502,0.0,20.0
23031,2,3031,[318 496 588 357  98],18,5,12448,4.105540897097625,40.0,0.0
23032,2,3032,[318 496 588 357  98],330,5,12453,4.105835806132542,40.0,0.0
23033,2,3033,[318 496 588 357  98],716,5,12458,4.106130520764667,40.0,0.0
23034,2,3034,[ 11 211   4 181  69],593,5,12463,4.106425041186162,0.0,0.0
23035,2,3035,[318 496 588 357  98],450,5,12468,4.106719367588933,40.0,0.0
23036,2,3036,[318 496 588 357  98],18,5,12473,4.107013500164636,40.0,0.0
23037,2,3037,[318 496 588 357  98],786,5,12478,4.107307439104674,40.0,0.0
23038,2,3038,[318 496 588 357  98],450,5,12483,4.107601184600197,40.0,0.0
23039,2,3039,[435  12 200 117 238],629,5,12488,4.1078947368421055,0.0,0.0
23040,2,3040,[318 496 588 357  98],18,5,12493,4.1081880960210455,40.0,0.0
23041,2,3041,[194 211  56  88 265],151,5,12498,4.108481262327416,0.0,0.0
23042,2,3042,[318 496 588 357  98],18,5,12503,4.108774235951364,40.0,0.0
23043,2,3043,[385 301 222  98 118],450,3,12506,4.108409986859396,0.0,0.0
23044,2,3044,[318 496 588 357  98],716,5,12511,4.108702791461412,40.0,0.0
23045,2,3045,[318 496 588 357  98],18,5,12516,4.108995403808273,40.0,0.0
23046,2,3046,[318 496 588 357  98],330,5,12521,4.109287824089268,40.0,0.0
23047,2,3047,[202 588 175  97 237],18,3,12524,4.108923884514436,0.0,0.0
23048,2,3048,[318 496 588 357  98],450,5,12529,4.109216136438176,40.0,0.0
23049,2,3049,[483  64 111 282 100],401,3,12532,4.1088524590163935,20.0,20.0
23050,2,3050,[318 496 588 357  98],716,5,12537,4.109144542772861,40.0,0.0
23051,2,3051,[211 655  82 496  98],911,1,12538,4.108125819134994,20.0,0.0
23052,2,3052,[211 121 228 153  69],450,4,12542,4.108090402882411,0.0,0.0
23053,2,3053,[318 496 588 357  98],330,5,12547,4.108382449246889,40.0,0.0
23054,2,3054,[175 144 132  98 186],457,5,12552,4.108674304418985,0.0,0.0
23055,2,3055,[357  97  69  71 200],786,5,12557,4.1089659685863875,0.0,0.0
23056,2,3056,[121   8  79  98 118],796,5,12562,4.109257441936539,0.0,0.0
23057,2,3057,[216  56 191 222 313],796,5,12567,4.109548724656638,0.0,0.0
23058,2,3058,[318 496 588 357  98],330,5,12572,4.109839816933638,40.0,0.0
23059,2,3059,[318 496 588 357  98],18,5,12577,4.110130718954248,40.0,0.0
23060,2,3060,[ 97 143  82   1 405],457,5,12582,4.110421430904933,0.0,0.0
23061,2,3061,[294 186  12  96 276],655,1,12583,4.109405617243632,0.0,0.0
23062,2,3062,[318 496 588 357  98],450,5,12588,4.109696376101861,40.0,0.0
23063,2,3063,[135 132 196 200  56],18,2,12590,4.109007832898173,0.0,0.0
23064,2,3064,[288 435 153 204 238],450,4,12594,4.108972267536704,0.0,0.0
23065,2,3065,[ 96 301 318 273 313],796,3,12597,4.108610567514677,20.0,0.0
23066,2,3066,[318 496 588 357  98],716,5,12602,4.10890120639061,40.0,0.0
23067,2,3067,[318 496 588 357  98],450,5,12607,4.109191655801825,40.0,0.0
23068,2,3068,[168 357 301 275 195],450,5,12612,4.109481915933529,0.0,20.0
23069,2,3069,[ 28  69 237 322 180],450,5,12617,4.109771986970684,0.0,0.0
23070,2,3070,[318 496 588 357  98],330,5,12622,4.110061869098014,40.0,0.0
23071,2,3071,[181 210   7  25  79],450,3,12625,4.109700520833333,0.0,0.0
23072,2,3072,[318 496 588 357  98],716,5,12630,4.10999023755288,40.0,0.0
23073,2,3073,[ 11 187 211 269   4],450,4,12634,4.109954456733897,0.0,0.0
23074,2,3074,[318 496 588 357  98],450,5,12639,4.1102439024390245,40.0,0.0
23075,2,3075,[318 496 588 357  98],716,5,12644,4.110533159947984,40.0,0.0
23076,2,3076,[204 357 245 301  89],450,5,12649,4.110822229444264,0.0,0.0
23077,2,3077,[318 496 588 357  98],18,5,12654,4.111111111111111,40.0,0.0
23078,2,3078,[175 125 483 318 186],655,2,12656,4.110425462812602,20.0,0.0
23079,2,3079,[318 496 588 357  98],796,5,12661,4.110714285714286,40.0,0.0
23080,2,3080,[318 496 588 357  98],330,5,12666,4.111002921129503,40.0,0.0
23081,2,3081,[318 496 588 357  98],18,5,12671,4.111291369240753,40.0,0.0
23082,2,3082,[435 515 427 258  79],655,3,12674,4.110930911449887,20.0,0.0
23083,2,3083,[318 496 588 357  98],18,5,12679,4.111219195849546,40.0,0.0
23084,2,3084,[318 496 588 357  98],450,5,12684,4.1115072933549435,40.0,0.0
23085,2,3085,[318 496 588 357  98],450,5,12689,4.111795204147764,40.0,0.0
23086,2,3086,[318 496 588 357  98],18,5,12694,4.112082928409459,40.0,0.0
23087,2,3087,[318 496 588 357  98],716,5,12699,4.112370466321243,40.0,0.0
23088,2,3088,[318 496 588 357  98],786,5,12704,4.112657818064099,40.0,0.0
23089,2,3089,[269 197 276   8  70],18,5,12709,4.11294498381877,0.0,0.0
23090,2,3090,[318 496 588 357  98],330,5,12714,4.113231963765772,40.0,0.0
23091,2,3091,[318 496 588 357  98],330,5,12719,4.113518758085382,40.0,0.0
23092,2,3092,[313 318 153 125 191],655,3,12722,4.113158745554478,20.0,0.0
23093,2,3093,[238 195  82  11 172],457,5,12727,4.11344537815126,0.0,0.0
23094,2,3094,[195 357 597 173 168],450,5,12732,4.113731825525041,0.0,0.0
23095,2,3095,[318 496 588 357  98],450,5,12737,4.114018087855297,40.0,0.0
23096,2,3096,[318 496 588 357  98],786,5,12742,4.114304165321279,40.0,0.0
23097,2,3097,[173 135   7 288   1],450,3,12745,4.113944480309877,0.0,0.0
23098,2,3098,[333 515 191 238 268],655,2,12747,4.113262342691191,0.0,0.0
23099,2,3099,[655  69 127 216 204],457,5,12752,4.113548387096774,0.0,20.0
23100,2,3100,[318 496 588 357  98],716,5,12757,4.113834247017091,40.0,0.0
23101,2,3101,[282 210 288   7  56],256,3,12760,4.113475177304965,0.0,0.0
23102,2,3102,[318 496 588 357  98],786,5,12765,4.11376087657106,40.0,0.0
23103,2,3103,[196 132 151 204  95],716,5,12770,4.114046391752577,0.0,0.0
23104,2,3104,[318 496 588 357  98],450,5,12775,4.114331723027375,40.0,0.0
23105,2,3105,[318 496 588 357  98],786,5,12780,4.114616870573085,40.0,0.0
23106,2,3106,[ 79 405   4 328  11],655,1,12781,4.11361441905375,0.0,0.0
23107,2,3107,[318 496 588 357  98],716,5,12786,4.113899613899614,40.0,0.0
23108,2,3108,[318 496 588 357  98],18,5,12791,4.114184625281441,40.0,0.0
23109,2,3109,[302 161  15 168 191],389,3,12794,4.113826366559485,0.0,0.0
23110,2,3110,[ 12   4 200  70 234],151,4,12798,4.113789778206365,0.0,0.0
23111,2,3111,[318 496 588 357  98],796,5,12803,4.114074550128534,40.0,0.0
23112,2,3112,[269 265  89  79 100],796,3,12806,4.113716672020559,0.0,20.0
23113,2,3113,[238 125 597 269  12],450,5,12811,4.114001284521516,0.0,0.0
23114,2,3114,[318 496 588 357  98],716,5,12816,4.114285714285714,40.0,0.0
23115,2,3115,[318 496 588 357  98],796,5,12821,4.114569961489089,40.0,0.0
23116,2,3116,[357 196 197  98 127],835,5,12826,4.114854026307347,0.0,20.0
23117,2,3117,[483 197 496 301 202],151,5,12831,4.115137908915972,20.0,0.0
23118,2,3118,[318 496 588 357  98],796,5,12836,4.115421609490221,40.0,0.0
23119,2,3119,[180  82 265 210 204],450,3,12839,4.115064102564102,0.0,0.0
23120,2,3120,[318 496 588 357  98],716,5,12844,4.115347644985581,40.0,0.0
23121,2,3121,[318 496 588 357  98],796,5,12849,4.115631005765535,40.0,0.0
23122,2,3122,[ 82 603 748  15 313],796,4,12853,4.1155939801472945,20.0,0.0
23123,2,3123,[172  88  97 322  96],796,3,12856,4.115236875800256,0.0,0.0
23124,2,3124,[ 97 282 185 423 496],716,4,12860,4.1152,20.0,0.0
23125,2,3125,[204 132 100  89 275],796,4,12864,4.115163147792706,0.0,40.0
23126,2,3126,[318 496 588 357  98],786,5,12869,4.115446114486729,40.0,0.0
23127,2,3127,[318 496 588 357  98],716,5,12874,4.115728900255754,40.0,0.0
23128,2,3128,[318 496 588 357  98],716,5,12879,4.11601150527325,40.0,0.0
23129,2,3129,[318 496 588 357  98],18,5,12884,4.11629392971246,40.0,0.0
23130,2,3130,[204   7 187 483 153],535,4,12888,4.11625678696902,0.0,0.0
23131,2,3131,[ 56  98 172 117 194],450,5,12893,4.11653895274585,0.0,0.0
23132,2,3132,[318 496 588 357  98],796,5,12898,4.1168209383977015,40.0,0.0
23133,2,3133,[588 144 748  98 143],796,5,12903,4.117102744097001,0.0,0.0
23134,2,3134,[318 496 588 357  98],18,5,12908,4.117384370015949,40.0,0.0
23135,2,3135,[  1  71 234 183 210],796,2,12910,4.1167091836734695,0.0,0.0
23136,2,3136,[318 496 588 357  98],716,5,12915,4.116990755498884,40.0,0.0
23137,2,3137,[318 496 588 357  98],716,5,12920,4.117272147864882,40.0,0.0
23138,2,3138,[100 385 286 153 301],655,0,12920,4.115960496973559,0.0,40.0
23139,2,3139,[318 496 588 357  98],330,5,12925,4.11624203821656,40.0,0.0
23140,2,3140,[318 496 588 357  98],786,5,12930,4.116523400191022,40.0,0.0
23141,2,3141,[ 70 276  89 357   7],269,2,12932,4.115849777211967,0.0,0.0
23142,2,3142,[216 328 215 357 186],655,2,12934,4.115176582882596,0.0,0.0
23143,2,3143,[318 496 588 357  98],786,5,12939,4.115458015267175,40.0,0.0
23144,2,3144,[318 496 588 357  98],786,5,12944,4.1157392686804455,40.0,0.0
23145,2,3145,[172 125 183 204 210],796,4,12948,4.115702479338843,0.0,0.0
23146,2,3146,[273 405 258 245 121],450,3,12951,4.11534795042898,0.0,0.0
23147,2,3147,[ 22 271  89 237 161],796,5,12956,4.115628970775095,0.0,0.0
23148,2,3148,[318 496 588 357  98],18,5,12961,4.115909812638933,40.0,0.0
23149,2,3149,[318 496 588 357  98],796,5,12966,4.116190476190476,40.0,0.0
23150,2,3150,[318 496 588 357  98],786,5,12971,4.116470961599492,40.0,0.0
23151,2,3151,[135 215 132 143  28],693,4,12975,4.116434010152284,0.0,0.0
23152,2,3152,[ 89 135 258 174 318],807,4,12979,4.1163970821439895,20.0,0.0
23153,2,3153,[318 496 588 357  98],786,5,12984,4.116677235256817,40.0,0.0
23154,2,3154,[318 496 588 357  98],450,5,12989,4.116957210776545,40.0,0.0
23155,2,3155,[  9 183 294 322 117],796,2,12991,4.116286438529785,0.0,0.0
23156,2,3156,[318 496 588 357  98],330,5,12996,4.116566360468799,40.0,0.0
23157,2,3157,[187  88 204 238 234],504,0,12996,4.115262824572515,0.0,0.0
23158,2,3158,[117 121 132 471 172],786,4,13000,4.11522633744856,0.0,0.0
23159,2,3159,[ 56  22  12 186 258],655,0,13000,4.113924050632911,0.0,0.0
23160,2,3160,[ 56 172 197 153 318],716,5,13005,4.114204365707055,20.0,0.0
23161,2,3161,[ 22 423 117  79 655],450,5,13010,4.114484503478811,0.0,0.0
23162,2,3162,[318 496 588 357  98],450,5,13015,4.114764464116345,40.0,0.0
23163,2,3163,[318 496 588 357  98],18,5,13020,4.115044247787611,40.0,0.0
23164,2,3164,[183 174 153 172 161],593,5,13025,4.115323854660348,0.0,0.0
23165,2,3165,[318 496 588 357  98],716,5,13030,4.115603284902084,40.0,0.0
23166,2,3166,[318 496 588 357  98],796,5,13035,4.115882538680139,40.0,0.0
23167,2,3167,[318 496 588 357  98],18,5,13040,4.116161616161616,40.0,0.0
23168,2,3168,[  8 271 228 597 258],796,5,13045,4.116440517513412,0.0,0.0
23169,2,3169,[318 496 588 357  98],786,5,13050,4.116719242902208,40.0,0.0
23170,2,3170,[161 423 323 294 211],504,4,13054,4.116682434563229,0.0,0.0
23171,2,3171,[385  71 143 471 173],450,4,13058,4.1166456494325345,0.0,0.0
23172,2,3172,[318 496 588 357  98],796,5,13063,4.116924046643555,40.0,0.0
23173,2,3173,[333  11 161 313 268],655,1,13064,4.115942028985507,0.0,0.0
23174,2,3174,[318 496 588 357  98],716,5,13069,4.116220472440945,40.0,0.0
23175,2,3175,[318 496 588 357  98],796,5,13074,4.116498740554156,40.0,0.0
23176,2,3176,[200 655  82  64 328],151,2,13076,4.1158325464274474,20.0,0.0
23177,2,3177,[318 496 588 357  98],716,5,13081,4.116110761485211,40.0,0.0
23178,2,3178,[318 496 588 357  98],796,5,13086,4.116388801509909,40.0,0.0
23179,2,3179,[125 471 301 265 175],655,0,13086,4.115094339622641,0.0,0.0
23180,2,3180,[318 496 588 357  98],796,5,13091,4.115372524363408,40.0,0.0
23181,2,3181,[318 496 588 357  98],450,5,13096,4.1156505342551855,40.0,0.0
23182,2,3182,[742 275 132 289  15],655,1,13097,4.114671693371034,0.0,20.0
23183,2,3183,[405 153 423 269 496],450,5,13102,4.114949748743719,20.0,0.0
23184,2,3184,[318 496 588 357  98],796,5,13107,4.115227629513344,40.0,0.0
23185,2,3185,[318 496 588 357  98],18,5,13112,4.115505335844319,40.0,0.0
23186,2,3186,[483  79 181 172 197],389,5,13117,4.1157828679008475,0.0,0.0
23187,2,3187,[318 496 588 357  98],450,5,13122,4.116060225846926,40.0,0.0
23188,2,3188,[318 496 588 357  98],716,5,13127,4.116337409846347,40.0,0.0
23189,2,3189,[318 496 588 357  98],796,5,13132,4.116614420062696,40.0,0.0
23190,2,3190,[318 496 588 357  98],330,5,13137,4.116891256659354,40.0,0.0
23191,2,3191,[318 496 588 357  98],716,5,13142,4.117167919799499,40.0,0.0
23192,2,3192,[318 496 588 357  98],18,5,13147,4.117444409646101,40.0,0.0
23193,2,3193,[127  79 182 357 176],796,5,13152,4.117720726361928,0.0,20.0
23194,2,3194,[181 475 180 403 196],269,1,13153,4.116744913928012,0.0,0.0
23195,2,3195,[204   8 655 197 357],457,5,13158,4.117021276595745,0.0,0.0
23196,2,3196,[318 496 588 357  98],716,5,13163,4.117297466374726,40.0,0.0
23197,2,3197,[318 496 588 357  98],796,5,13168,4.117573483427142,40.0,0.0
23198,2,3198,[318 496 588 357  98],450,5,13173,4.117849327914973,40.0,0.0
23199,2,3199,[318 496 588 357  98],18,5,13178,4.118125,40.0,0.0
23200,2,3200,[515 153 282 118  25],655,1,13179,4.117150890346767,0.0,0.0
23201,2,3201,[302 144 222 183 357],655,3,13182,4.1168019987507805,0.0,0.0
23202,2,3202,[318 496 588 357  98],716,5,13187,4.117077739619107,40.0,0.0
23203,2,3203,[153 173 245 118 237],450,4,13191,4.117041198501872,0.0,0.0
23204,2,3204,[318 496 588 357  98],330,5,13196,4.117316692667707,40.0,0.0
23205,2,3205,[185 238 237 423 132],457,5,13201,4.117592014971928,0.0,0.0
23206,2,3206,[427 403 234 144 117],807,4,13205,4.117555347676957,20.0,0.0
23207,2,3207,[ 28 197 265 125 300],292,4,13209,4.117518703241895,0.0,0.0
23208,2,3208,[318 496 588 357  98],796,5,13214,4.117793705204114,40.0,0.0
23209,2,3209,[318 496 588 357  98],330,5,13219,4.118068535825545,40.0,0.0
23210,2,3210,[318 496 588 357  98],796,5,13224,4.118343195266272,40.0,0.0
23211,2,3211,[187  50 471 132 273],693,1,13225,4.117372353673724,0.0,20.0
23212,2,3212,[318 496 588 357  98],450,5,13230,4.117647058823529,40.0,0.0
23213,2,3213,[318 496 588 357  98],716,5,13235,4.117921593030491,40.0,0.0
23214,2,3214,[318 496 588 357  98],330,5,13240,4.118195956454121,40.0,0.0
23215,2,3215,[318 496 588 357  98],796,5,13245,4.1184701492537314,40.0,0.0
23216,2,3216,[318 496 588 357  98],18,5,13250,4.118744171588436,40.0,0.0
23217,2,3217,[318 496 588 357  98],716,5,13255,4.119018023617153,40.0,0.0
23218,2,3218,[121 186 742 144  70],457,5,13260,4.119291705498602,0.0,0.0
23219,2,3219,[483 117 202 588  25],457,5,13265,4.119565217391305,0.0,0.0
23220,2,3220,[318 496 588 357  98],716,5,13270,4.119838559453586,40.0,0.0
23221,2,3221,[318 496 588 357  98],786,5,13275,4.120111731843576,40.0,0.0
23222,2,3222,[ 15  50 100 222  98],296,4,13279,4.120074464784363,0.0,40.0
23223,2,3223,[318 496 588 357  98],796,5,13284,4.120347394540943,40.0,0.0
23224,2,3224,[318 496 588 357  98],330,5,13289,4.120620155038759,40.0,0.0
23225,2,3225,[ 88  89 118  79 117],256,5,13294,4.120892746435214,0.0,0.0
23226,2,3226,[ 88 181  56  69 135],716,4,13298,4.1208552835450885,0.0,0.0
23227,2,3227,[318 496 588 357  98],450,5,13303,4.121127633209418,40.0,0.0
23228,2,3228,[588 216 195  88 423],786,5,13308,4.121399814183958,0.0,0.0
23229,2,3229,[215  97 117 588 143],330,5,13313,4.121671826625387,0.0,0.0
23230,2,3230,[318 496 588 357  98],18,5,13318,4.121943670690189,40.0,0.0
23231,2,3231,[318 496 588 357  98],18,5,13323,4.122215346534653,40.0,0.0
23232,2,3232,[183 228 268   7 318],655,2,13325,4.121558923600372,20.0,0.0
23233,2,3233,[435  70 357 181  15],72,4,13329,4.12152133580705,0.0,0.0
23234,2,3234,[ 50 127 228 183 318],457,5,13334,4.121792890262751,20.0,40.0
23235,2,3235,[423 385  89 318 186],796,4,13338,4.121755253399258,20.0,0.0
23236,2,3236,[385 197  82 471 175],716,2,13340,4.121099783750386,0.0,0.0
23237,2,3237,[ 96  70 185 508 194],269,3,13343,4.120753551575047,0.0,0.0
23238,2,3238,[ 28 135  22 276 168],18,2,13345,4.120098795924668,0.0,0.0
23239,2,3239,[318 496 588 357  98],716,5,13350,4.12037037037037,40.0,0.0
23240,2,3240,[318 496 588 357  98],18,5,13355,4.12064177722925,40.0,0.0
23241,2,3241,[172 197 143 161  95],389,2,13357,4.119987661937076,0.0,0.0
23242,2,3242,[655 211 385 118 200],151,2,13359,4.119333950046253,0.0,0.0
23243,2,3243,[ 12 135 300 273 328],655,2,13361,4.118680641183724,0.0,0.0
23244,2,3244,[496 483 200 210 196],151,4,13365,4.11864406779661,20.0,0.0
23245,2,3245,[318 496 588 357  98],786,5,13370,4.118915588416512,40.0,0.0
23246,2,3246,[  1 300  89  28 313],655,2,13372,4.118263012011087,0.0,0.0
23247,2,3247,[318 496 588 357  98],716,5,13377,4.118534482758621,40.0,0.0
23248,2,3248,[ 98 357 183 210  79],716,4,13381,4.118497999384426,0.0,0.0
23249,2,3249,[  9 161 173 132 265],796,4,13385,4.118461538461538,0.0,0.0
23250,2,3250,[318 496 588 357  98],786,5,13390,4.118732697631498,40.0,0.0
23251,2,3251,[245   4 196  88  22],344,2,13392,4.118081180811808,0.0,0.0
23252,2,3252,[318 496 588 357  98],716,5,13397,4.118352290193667,40.0,0.0
23253,2,3253,[318 496 588 357  98],796,5,13402,4.118623232944069,40.0,0.0
23254,2,3254,[151 385 125 186  50],450,4,13406,4.118586789554532,0.0,20.0
23255,2,3255,[318 496 588 357  98],450,5,13411,4.118857493857494,40.0,0.0
23256,2,3256,[318 496 588 357  98],796,5,13416,4.119128031931225,40.0,0.0
23257,2,3257,[181 210 235 294 195],450,3,13419,4.1187845303867405,0.0,0.0
23258,2,3258,[132 597 183 228 294],450,5,13424,4.1190549248235655,0.0,0.0
23259,2,3259,[597 222  79  11 286],344,2,13426,4.11840490797546,0.0,20.0
23260,2,3260,[318 496 588 357  98],330,5,13431,4.11867525298988,40.0,0.0
23261,2,3261,[ 97 301 245 271 265],796,2,13433,4.118025751072961,0.0,0.0
23262,2,3262,[286 238 202 196  97],450,5,13438,4.118296046582899,0.0,20.0
23263,2,3263,[475 100  82 179 235],269,3,13441,4.117953431372549,0.0,20.0
23264,2,3264,[748 195 222 211  96],807,3,13444,4.117611026033691,0.0,0.0
23265,2,3265,[568 405 153  69 385],655,0,13444,4.116350275566442,0.0,0.0
23266,2,3266,[318 496 588 357  98],18,5,13449,4.11662075298439,40.0,0.0
23267,2,3267,[202 195 678 313  50],344,3,13452,4.116279069767442,0.0,20.0
23268,2,3268,[318 496 588 357  98],450,5,13457,4.116549403487305,40.0,0.0
23269,2,3269,[318 496 588 357  98],330,5,13462,4.1168195718654435,40.0,0.0
23270,2,3270,[318 496 588 357  98],716,5,13467,4.117089575053501,40.0,0.0
23271,2,3271,[318 496 588 357  98],18,5,13472,4.117359413202934,40.0,0.0
23272,2,3272,[318 496 588 357  98],786,5,13477,4.1176290864650165,40.0,0.0
23273,2,3273,[318 496 588 357  98],18,5,13482,4.117898594990837,40.0,0.0
23274,2,3274,[235 168 318 172 515],807,4,13486,4.117862595419847,20.0,0.0
23275,2,3275,[318 496 588 357  98],330,5,13491,4.118131868131868,40.0,0.0
23276,2,3276,[318 496 588 357  98],796,5,13496,4.118400976502899,40.0,0.0
23277,2,3277,[318 496 588 357  98],796,5,13501,4.1186699206833435,40.0,0.0
23278,2,3278,[318 496 588 357  98],796,5,13506,4.1189387008234215,40.0,0.0
23279,2,3279,[  4 200 182 118  15],655,2,13508,4.118292682926829,0.0,0.0
23280,2,3280,[318 496 588 357  98],716,5,13513,4.118561414202987,40.0,0.0
23281,2,3281,[318 496 588 357  98],18,5,13518,4.118829981718465,40.0,0.0
23282,2,3282,[357 228  79 202 135],655,3,13521,4.118489186719464,0.0,0.0
23283,2,3283,[318 496 588 357  98],450,5,13526,4.118757612667479,40.0,0.0
23284,2,3284,[318 496 588 357  98],716,5,13531,4.119025875190259,40.0,0.0
23285,2,3285,[322 318 216 515 405],401,3,13534,4.118685331710286,20.0,0.0
23286,2,3286,[318 496 588 357  98],330,5,13539,4.118953452996654,40.0,0.0
23287,2,3287,[271 161 423 135 210],655,1,13540,4.118004866180049,0.0,0.0
23288,2,3288,[216 318 655 182  28],796,3,13543,4.1176649437519,20.0,0.0
23289,2,3289,[318 496 588 357  98],330,5,13548,4.117933130699088,40.0,0.0
23290,2,3290,[318 496 588 357  98],18,5,13553,4.118201154664236,40.0,0.0
23291,2,3291,[475 187 195 196 286],655,1,13554,4.1172539489671935,0.0,20.0
23292,2,3292,[216 117 172 294 135],280,3,13557,4.116914667476466,0.0,0.0
23293,2,3293,[286 357 151 496  50],796,4,13561,4.116879174256224,20.0,40.0
23294,2,3294,[168  64 215 210  95],18,3,13564,4.116540212443096,20.0,0.0
23295,2,3295,[318 496 588 357  98],796,5,13569,4.116808252427185,40.0,0.0
23296,2,3296,[185 357 168 588 173],796,5,13574,4.117076129814984,0.0,0.0
23297,2,3297,[ 95 222  89  28 258],450,3,13577,4.116737416616131,0.0,0.0
23298,2,3298,[318 496 588 357  98],796,5,13582,4.11700515307669,40.0,0.0
23299,2,3299,[423  69 483 117 265],807,5,13587,4.117272727272727,0.0,0.0
23300,2,3300,[  7 179 197  79  64],535,4,13591,4.117237200848228,20.0,0.0
23301,2,3301,[318 496 588 357  98],18,5,13596,4.117504542701393,40.0,0.0
23302,2,3302,[ 64 475 195 117 144],629,5,13601,4.117771722676355,20.0,0.0
23303,2,3303,[ 12 183  22  97 234],450,4,13605,4.11773607748184,0.0,0.0
23304,2,3304,[318 496 588 357  98],716,5,13610,4.118003025718608,40.0,0.0
23305,2,3305,[202  64 100  88   1],330,5,13615,4.11826981246219,20.0,20.0
23306,2,3306,[318 496 588 357  98],450,5,13620,4.1185364378590865,40.0,0.0
23307,2,3307,[318 496 588 357  98],450,5,13625,4.118802902055623,40.0,0.0
23308,2,3308,[318 496 588 357  98],786,5,13630,4.119069205197945,40.0,0.0
23309,2,3309,[ 25 655   1  50 202],457,5,13635,4.119335347432024,0.0,20.0
23310,2,3310,[300  28  89 258 483],151,5,13640,4.119601328903655,0.0,0.0
23311,2,3311,[ 15 216 237 655 200],236,3,13643,4.119263285024155,0.0,0.0
23312,2,3312,[318 496 588 357  98],786,5,13648,4.119529127678841,40.0,0.0
23313,2,3313,[ 22 294  97 496 182],796,3,13651,4.119191309595655,20.0,0.0
23314,2,3314,[  7  56 357 121 237],655,1,13652,4.118250377073906,0.0,0.0
23315,2,3315,[318 496 588 357  98],796,5,13657,4.118516284680338,40.0,0.0
23316,2,3316,[222 117 135   9 183],457,5,13662,4.118782031956587,0.0,0.0
23317,2,3317,[318 496 588 357  98],716,5,13667,4.119047619047619,40.0,0.0
23318,2,3318,[318 496 588 357  98],450,5,13672,4.119313046098222,40.0,0.0
23319,2,3319,[318 496 588 357  98],450,5,13677,4.119578313253012,40.0,0.0
23320,2,3320,[ 56 748 234 222 405],151,3,13680,4.119241192411924,0.0,0.0
23321,2,3321,[318 496 588 357  98],786,5,13685,4.119506321493076,40.0,0.0
23322,2,3322,[ 11 282 143 276 210],593,3,13688,4.1191694252181765,0.0,0.0
23323,2,3323,[483  95   9 258  79],796,4,13692,4.11913357400722,0.0,0.0
23324,2,3324,[318 496 588 357  98],450,5,13697,4.119398496240602,40.0,0.0
23325,2,3325,[318 496 588 357  98],796,5,13702,4.119663259170174,40.0,0.0
23326,2,3326,[496 204 194  50 195],236,0,13702,4.118425007514277,20.0,20.0
23327,2,3327,[179  50  15  79 357],18,5,13707,4.118689903846154,0.0,20.0
23328,2,3328,[318 588 496 357  98],18,5,13712,4.118954641033343,40.0,0.0
23329,2,3329,[318 588 496 357  98],450,5,13717,4.119219219219219,40.0,0.0
23330,2,3330,[151   1 300 172 210],450,4,13721,4.11918342839988,0.0,0.0
23331,2,3331,[318 588 496 357  98],330,5,13726,4.119447779111645,40.0,0.0
23332,2,3332,[121   8 211 200  56],593,4,13730,4.1194119411941195,0.0,0.0
23333,2,3333,[302 161 427  70 483],655,3,13733,4.119076184763047,20.0,0.0
23334,2,3334,[568 546 245  79 210],450,4,13737,4.11904047976012,0.0,0.0
23335,2,3335,[318 588 496 357  98],330,5,13742,4.119304556354916,40.0,0.0
23336,2,3336,[ 88  22  11 172 508],269,1,13743,4.1183697932274494,0.0,0.0
23337,2,3337,[222 135  82 168 546],716,3,13746,4.118034751348112,0.0,0.0
23338,2,3338,[300 508 288 234 125],655,0,13746,4.116801437556155,0.0,0.0
23339,2,3339,[318 588 496 357  98],450,5,13751,4.117065868263473,40.0,0.0
23340,2,3340,[318 588 496 357  98],786,5,13756,4.117330140676444,40.0,0.0
23341,2,3341,[318 588 496 357  98],450,5,13761,4.117594254937163,40.0,0.0
23342,2,3342,[286 276   4 288 294],655,1,13762,4.1166616811247385,0.0,20.0
23343,2,3343,[176  70   7 483 210],450,3,13765,4.116327751196172,0.0,0.0
23344,2,3344,[568 168 132 175 228],457,5,13770,4.116591928251121,0.0,0.0
23345,2,3345,[196 175 237 161 508],655,0,13770,4.115361625821877,0.0,0.0
23346,2,3346,[302  56  98 125 144],655,2,13772,4.114729608604721,0.0,0.0
23347,2,3347,[318 588 496 357  98],330,5,13777,4.114994026284349,40.0,0.0
23348,2,3348,[328 603 427 405 546],151,2,13779,4.1143624962675425,40.0,0.0
23349,2,3349,[ 64  88 257 197 168],401,2,13781,4.1137313432835825,20.0,0.0
23350,2,3350,[318 588 496 357  98],796,5,13786,4.113995822142644,40.0,0.0
23351,2,3351,[318 588 496 357  98],716,5,13791,4.1142601431980905,40.0,0.0
23352,2,3352,[235   9  22 313  70],344,1,13792,4.113331345064122,0.0,0.0
23353,2,3353,[318 588 496 357  98],330,5,13797,4.113595706618963,40.0,0.0
23354,2,3354,[117 202 121 216 238],450,4,13801,4.113561847988078,0.0,0.0
23355,2,3355,[318 588 496 357  98],796,5,13806,4.113825983313468,40.0,0.0
23356,2,3356,[215  95 135  12  28],450,3,13809,4.1134941912421805,0.0,0.0
23357,2,3357,[200  22 294 483 173],457,4,13813,4.113460393091126,0.0,0.0
23358,2,3358,[318 588 496 357  98],786,5,13818,4.113724322715094,40.0,0.0
23359,2,3359,[405 483 204 117  96],655,1,13819,4.112797619047619,0.0,0.0
23360,2,3360,[318 588 496 357  98],786,5,13824,4.113061588812854,40.0,0.0
23361,2,3361,[318 588 496 357  98],330,5,13829,4.113325401546699,40.0,0.0
23362,2,3362,[318 588 496 357  98],786,5,13834,4.113589057389236,40.0,0.0
23363,2,3363,[195  64 151 118 357],457,5,13839,4.1138525564803805,20.0,0.0
23364,2,3364,[ 97 172 282 276 117],593,4,13843,4.113818722139673,0.0,0.0
23365,2,3365,[197 172  22  69   9],457,5,13848,4.114081996434938,0.0,0.0
23366,2,3366,[318 588 496 357  98],716,5,13853,4.114345114345114,40.0,0.0
23367,2,3367,[121 186 118 238 222],457,5,13858,4.114608076009501,0.0,0.0
23368,2,3368,[161 318 151 435  98],269,3,13861,4.1142772336004745,20.0,0.0
23369,2,3369,[471 403 237 111 294],655,0,13861,4.113056379821958,0.0,0.0
23370,2,3370,[471  96 546 265  79],807,4,13865,4.11302284188668,0.0,0.0
23371,2,3371,[195  64 153 238  71],330,4,13869,4.112989323843417,20.0,0.0
23372,2,3372,[286 121 245 180 313],796,2,13871,4.1123628817076785,0.0,20.0
23373,2,3373,[ 95 125 301 132 196],344,4,13875,4.112329579134558,0.0,0.0
23374,2,3374,[228 174 318 179  11],457,5,13880,4.112592592592593,20.0,0.0
23375,2,3375,[318 588 496 357  98],450,5,13885,4.1128554502369665,40.0,0.0
23376,2,3376,[515 204  82 183  98],655,3,13888,4.112525910571513,0.0,0.0
23377,2,3377,[ 96 161 151 210 179],577,3,13891,4.112196566015394,0.0,0.0
23378,2,3378,[ 98   8 187 144 597],796,5,13896,4.1124593074874225,0.0,0.0
23379,2,3379,[318 588 496 357  98],716,5,13901,4.112721893491124,40.0,0.0
23380,2,3380,[318 588 496 357  98],716,5,13906,4.112984324164448,40.0,0.0
23381,2,3381,[318 588 496 357  98],18,5,13911,4.113246599645181,40.0,0.0
23382,2,3382,[ 28  11 216 588  64],330,5,13916,4.113508720070943,20.0,0.0
23383,2,3383,[318 588 496 357  98],796,5,13921,4.113770685579196,40.0,0.0
23384,2,3384,[ 88 742 153  22  98],280,4,13925,4.113737075332349,0.0,0.0
23385,2,3385,[318 588 496 357  98],796,5,13930,4.113998818665092,40.0,0.0
23386,2,3386,[132 286 173 153 588],280,4,13934,4.113965160909359,0.0,20.0
23387,2,3387,[318 588 496 357  98],450,5,13939,4.114226682408501,40.0,0.0
23388,2,3388,[117  69  82 603 313],796,4,13943,4.1141929772794334,20.0,0.0
23389,2,3389,[318 588 496 357  98],786,5,13948,4.114454277286136,40.0,0.0
23390,2,3390,[318 588 496 357  98],450,5,13953,4.114715423179003,40.0,0.0
23391,2,3391,[318 588 496 357  98],450,5,13958,4.11497641509434,40.0,0.0
23392,2,3392,[568 742 182 588 286],450,5,13963,4.115237253168288,0.0,20.0
23393,2,3393,[318 588 496 357  98],716,5,13968,4.11549793753683,40.0,0.0
23394,2,3394,[423 222 135 216 111],236,4,13972,4.115463917525773,0.0,0.0
23395,2,3395,[318 588 496 357  98],450,5,13977,4.115724381625442,40.0,0.0
23396,2,3396,[318 588 496 357  98],786,5,13982,4.115984692375625,40.0,0.0
23397,2,3397,[435 161 237  64 195],716,3,13985,4.115656268393172,20.0,0.0
23398,2,3398,[318 588 496 357  98],786,5,13990,4.115916446013533,40.0,0.0
23399,2,3399,[276 423 182 301  11],535,3,13993,4.115588235294117,0.0,0.0
23400,2,3400,[318   9 172 276 288],457,5,13998,4.115848279917671,20.0,0.0
23401,2,3401,[222 508 302 588  50],344,5,14003,4.116108171663727,0.0,20.0
23402,2,3402,[151   4 181  22 313],796,5,14008,4.1163679106670585,0.0,0.0
23403,2,3403,[ 69 385 273 100  11],450,4,14012,4.116333725029377,0.0,20.0
23404,2,3404,[318 588 496 357  98],450,5,14017,4.116593245227606,40.0,0.0
23405,2,3405,[195 100 135 302  97],151,2,14019,4.115971814445097,0.0,20.0
23406,2,3406,[318 588 496 357  98],450,5,14024,4.116231288523628,40.0,0.0
23407,2,3407,[318 588 496 357  98],330,5,14029,4.116490610328638,40.0,0.0
23408,2,3408,[ 11 235   7   8 204],344,3,14032,4.1161630976826045,0.0,0.0
23409,2,3409,[318 588 496 357  98],796,5,14037,4.116422287390029,40.0,0.0
23410,2,3410,[742 568   7 127 276],344,4,14041,4.116388155965993,0.0,20.0
23411,2,3411,[132 204 211 180 181],716,4,14045,4.116354044548652,0.0,0.0
23412,2,3412,[318 588 496 357  98],450,5,14050,4.116612950483446,40.0,0.0
23413,2,3413,[318 588 496 357  98],716,5,14055,4.116871704745167,40.0,0.0
23414,2,3414,[318 588 496 357  98],450,5,14060,4.117130307467057,40.0,0.0
23415,2,3415,[318 588 496 357  98],716,5,14065,4.117388758782202,40.0,0.0
23416,2,3416,[435  82 515 151  64],18,3,14068,4.117061750073163,20.0,0.0
23417,2,3417,[182 179  64  98  28],450,5,14073,4.1173200702165005,20.0,0.0
23418,2,3418,[318 588 496 357  98],450,5,14078,4.117578239251243,40.0,0.0
23419,2,3419,[318 588 496 357  98],716,5,14083,4.117836257309942,40.0,0.0
23420,2,3420,[318 588 496 357  98],18,5,14088,4.118094124524993,40.0,0.0
23421,2,3421,[301 313   7  50 300],450,5,14093,4.118351841028638,0.0,20.0
23422,2,3422,[318 588 496 357  98],330,5,14098,4.118609406952965,40.0,0.0
23423,2,3423,[ 70 313 258  15 385],655,1,14099,4.117698598130841,0.0,0.0
23424,2,3424,[195 127  98 173 168],796,5,14104,4.117956204379562,0.0,20.0
23425,2,3425,[318 588 496 357  98],18,5,14109,4.118213660245184,40.0,0.0
23426,2,3426,[318 588 496 357  98],786,5,14114,4.118470965859352,40.0,0.0
23427,2,3427,[121 196 176  25 180],716,3,14117,4.118144690781797,0.0,0.0
23428,2,3428,[183 427 475 300 200],655,3,14120,4.1178186060075825,20.0,0.0
23429,2,3429,[186 508 301 294 216],655,1,14121,4.116909620991254,0.0,0.0
23430,2,3430,[318 588 496 357  98],716,5,14126,4.117167006703585,40.0,0.0
23431,2,3431,[196 176 333 187  69],693,0,14126,4.115967365967366,0.0,0.0
23432,2,3432,[318 588 496 357  98],796,5,14131,4.116224876201573,40.0,0.0
23433,2,3433,[318 588 496 357  98],796,5,14136,4.11648223645894,40.0,0.0
23434,2,3434,[ 88 423 655  89 144],655,1,14137,4.115574963609898,0.0,0.0
23435,2,3435,[318 588 496 357  98],716,5,14142,4.1158323632130385,40.0,0.0
23436,2,3436,[ 64 427 144 294 257],655,2,14144,4.11521675880128,40.0,0.0
23437,2,3437,[318 588 496 357  98],786,5,14149,4.115474112856312,40.0,0.0
23438,2,3438,[318 588 496 357  98],716,5,14154,4.115731317243385,40.0,0.0
23439,2,3439,[118 195 603  88 405],450,4,14158,4.1156976744186045,20.0,0.0
23440,2,3440,[151 111 237 318 179],457,4,14162,4.115664051147922,20.0,0.0
23441,2,3441,[318 588 496 357  98],18,5,14167,4.115920976176642,40.0,0.0
23442,2,3442,[318 588 496 357  98],450,5,14172,4.1161777519605,40.0,0.0
23443,2,3443,[143 121  96  12  64],796,5,14177,4.116434378629501,20.0,0.0
23444,2,3444,[318 588 496 357  98],716,5,14182,4.116690856313498,40.0,0.0
23445,2,3445,[202 100  64 427 195],151,3,14185,4.116366802089379,40.0,20.0
23446,2,3446,[318 588 496 357  98],330,5,14190,4.116623150565709,40.0,0.0
23447,2,3447,[318 588 496 357  98],18,5,14195,4.116879350348028,40.0,0.0
23448,2,3448,[318 588 496 357  98],330,5,14200,4.117135401565672,40.0,0.0
23449,2,3449,[318 588 496 357  98],716,5,14205,4.1173913043478265,40.0,0.0
23450,2,3450,[318 588 496 357  98],330,5,14210,4.117647058823529,40.0,0.0
23451,2,3451,[ 98   4  50 100 187],504,3,14213,4.117323290845887,0.0,40.0
23452,2,3452,[318 588 496 357  98],796,5,14218,4.117578916883869,40.0,0.0
23453,2,3453,[ 12 237 182 275 173],503,3,14221,4.117255356108859,0.0,20.0
23454,2,3454,[182 100 153 238  11],629,4,14225,4.117221418234442,0.0,20.0
23455,2,3455,[318 588 496 357  98],450,5,14230,4.117476851851852,40.0,0.0
23456,2,3456,[318 588 496 357  98],716,5,14235,4.1177321376916405,40.0,0.0
23457,2,3457,[210 269 125  22 238],18,4,14239,4.117698091382302,0.0,0.0
23458,2,3458,[318 588 496 357  98],716,5,14244,4.117953165654813,40.0,0.0
23459,2,3459,[318 588 496 357  98],330,5,14249,4.118208092485549,40.0,0.0
23460,2,3460,[568 111 211 238  50],269,2,14251,4.1175960704998555,0.0,20.0
23461,2,3461,[318 588 496 357  98],716,5,14256,4.117850953206239,40.0,0.0
23462,2,3462,[318 588 496 357  98],450,5,14261,4.118105688709211,40.0,0.0
23463,2,3463,[ 70 176 748  15 568],450,4,14265,4.118071593533488,0.0,0.0
23464,2,3464,[ 12 265 135 186 237],655,1,14266,4.1171717171717175,0.0,0.0
23465,2,3465,[423 125  79 151   4],457,5,14271,4.117426428159261,0.0,0.0
23466,2,3466,[318 588 496 357  98],450,5,14276,4.1176809922122874,40.0,0.0
23467,2,3467,[318 588 496 357  98],330,5,14281,4.117935409457901,40.0,0.0
23468,2,3468,[318 588 496 357  98],450,5,14286,4.118189680023061,40.0,0.0
23469,2,3469,[ 88 100 294 202  69],796,3,14289,4.117867435158502,0.0,20.0
23470,2,3470,[318 588 496 357  98],330,5,14294,4.118121578795736,40.0,0.0
23471,2,3471,[ 89  12 153 210 197],450,4,14298,4.118087557603687,0.0,0.0
23472,2,3472,[318 588 496 357  98],330,5,14303,4.118341491505903,40.0,0.0
23473,2,3473,[318 588 496 357  98],716,5,14308,4.118595279217041,40.0,0.0
23474,2,3474,[318 588 496 357  98],450,5,14313,4.118848920863309,40.0,0.0
23475,2,3475,[216 117 568  28 182],450,5,14318,4.119102416570771,0.0,0.0
23476,2,3476,[603 197  89   7 100],421,3,14321,4.118780557952258,20.0,20.0
23477,2,3477,[318 588 496 357  98],330,5,14326,4.1190339275445655,40.0,0.0
23478,2,3478,[174 186 200 196 185],457,5,14331,4.11928715148031,0.0,0.0
23479,2,3479,[125 597 118 508 174],344,2,14333,4.11867816091954,0.0,0.0
23480,2,3480,[603 194 135 286 313],450,4,14337,4.11864406779661,20.0,20.0
23481,2,3481,[318 588 496 357  98],450,5,14342,4.11889718552556,40.0,0.0
23482,2,3482,[318 588 496 357  98],330,5,14347,4.119150157909848,40.0,0.0
23483,2,3483,[742 172 153   8 655],796,3,14350,4.118828932261768,0.0,0.0
23484,2,3484,[318 588 496 357  98],18,5,14355,4.119081779053085,40.0,0.0
23485,2,3485,[318 588 496 357  98],796,5,14360,4.119334480780264,40.0,0.0
23486,2,3486,[318 588 496 357  98],450,5,14365,4.1195870375681105,40.0,0.0
23487,2,3487,[318 588 496 357  98],330,5,14370,4.119839449541284,40.0,0.0
23488,2,3488,[318 588 496 357  98],716,5,14375,4.120091716824305,40.0,0.0
23489,2,3489,[318 588 496 357  98],18,5,14380,4.1203438395415475,40.0,0.0
23490,2,3490,[172 132 121 191  11],716,5,14385,4.120595817817244,0.0,0.0
23491,2,3491,[211 200 269 153  71],796,3,14388,4.120274914089347,0.0,0.0
23492,2,3492,[269 496 100 222 191],344,5,14393,4.120526767821357,20.0,20.0
23493,2,3493,[143  71 185 211   7],450,4,14397,4.120492272467087,0.0,0.0
23494,2,3494,[318 588 496 357  98],450,5,14402,4.120743919885551,40.0,0.0
23495,2,3495,[318 588 496 357  98],18,5,14407,4.120995423340961,40.0,0.0
23496,2,3496,[100 172 275 546 132],796,4,14411,4.120960823563054,0.0,40.0
23497,2,3497,[300 265  98 127 197],629,5,14416,4.121212121212121,0.0,20.0
23498,2,3498,[235  88 153 121  97],401,2,14418,4.120605887396399,0.0,0.0
23499,2,3499,[435 153 210  28 132],450,4,14422,4.120571428571429,0.0,0.0
23500,2,3500,[172  95 238 144  50],716,4,14426,4.120536989431591,0.0,20.0
23501,2,3501,[121 144 238 176  12],655,0,14426,4.119360365505425,0.0,0.0
23502,2,3502,[318 588 496 357  98],450,5,14431,4.119611761347416,40.0,0.0
23503,2,3503,[185 111 546 204 186],796,4,14435,4.119577625570776,0.0,0.0
23504,2,3504,[318 588 496 357  98],786,5,14440,4.119828815977176,40.0,0.0
23505,2,3505,[318 588 496 357  98],330,5,14445,4.120079863091843,40.0,0.0
23506,2,3506,[318 588 496 357  98],786,5,14450,4.120330767037354,40.0,0.0
23507,2,3507,[318 588 496 357  98],330,5,14455,4.120581527936146,40.0,0.0
23508,2,3508,[318 588 496 357  98],18,5,14460,4.120832145910516,40.0,0.0
23509,2,3509,[318 588 496 357  98],330,5,14465,4.121082621082621,40.0,0.0
23510,2,3510,[318 588 496 357  98],716,5,14470,4.1213329535744805,40.0,0.0
23511,2,3511,[597  82 403 121   8],807,5,14475,4.121583143507973,0.0,0.0
23512,2,3512,[427 568 357 475 161],269,3,14478,4.121263877028181,20.0,0.0
23513,2,3513,[181 200  79 333 265],655,2,14480,4.120660216277746,0.0,0.0
23514,2,3514,[301 289  50   4 286],655,1,14481,4.11977240398293,0.0,40.0
23515,2,3515,[318 588 496 357  98],450,5,14486,4.120022753128556,40.0,0.0
23516,2,3516,[318 588 496 357  98],796,5,14491,4.1202729599090135,40.0,0.0
23517,2,3517,[318 588 496 357  98],330,5,14496,4.120523024445708,40.0,0.0
23518,2,3518,[318 588 496 357  98],796,5,14501,4.120772946859903,40.0,0.0
23519,2,3519,[210  56 271 216  97],796,3,14504,4.120454545454545,0.0,0.0
23520,2,3520,[210 748 282  71 168],796,4,14508,4.1204203351320645,0.0,0.0
23521,2,3521,[318 588 496 357  98],330,5,14513,4.120670073821692,40.0,0.0
23522,2,3522,[ 15  82 127 282 185],450,3,14516,4.1203519727504965,0.0,20.0
23523,2,3523,[318 588 496 357  98],330,5,14521,4.120601589103292,40.0,0.0
23524,2,3524,[302  71 144 568 245],450,4,14525,4.120567375886525,0.0,0.0
23525,2,3525,[ 50 385  12 197 202],450,5,14530,4.120816789563245,0.0,20.0
23526,2,3526,[172 180  82  12 202],796,3,14533,4.120499007655231,0.0,0.0
23527,2,3527,[179  64 202 197 235],450,4,14537,4.12046485260771,20.0,0.0
23528,2,3528,[216 183 258 508  25],655,2,14539,4.119863984131482,0.0,0.0
23529,2,3529,[318 588 496 357  98],786,5,14544,4.120113314447592,40.0,0.0
23530,2,3530,[180 288 237  28 173],457,5,14549,4.120362503540074,0.0,0.0
23531,2,3531,[322 496 118 210  95],450,2,14551,4.119762174405436,20.0,0.0
23532,2,3532,[318 588 496 357  98],796,5,14556,4.120011321822814,40.0,0.0
23533,2,3533,[496 403 135 275 288],450,3,14559,4.119694397283531,20.0,20.0
23534,2,3534,[175 742 174 235 496],344,3,14562,4.119377652050919,20.0,0.0
23535,2,3535,[318 588 496 357  98],330,5,14567,4.119626696832579,40.0,0.0
23536,2,3536,[245 195  15 210 313],796,3,14570,4.119310149844501,0.0,0.0
23537,2,3537,[318 588 496 357  98],450,5,14575,4.119559072922555,40.0,0.0
23538,2,3538,[174  82 197 318  96],72,4,14579,4.119525289629839,20.0,0.0
23539,2,3539,[405 135 286 216 151],450,4,14583,4.1194915254237285,0.0,20.0
23540,2,3540,[181 187  88 197 210],796,3,14586,4.1191753741880826,0.0,0.0
23541,2,3541,[318 588 496 357  98],796,5,14591,4.119424054206663,40.0,0.0
23542,2,3542,[318 588 496 357  98],330,5,14596,4.119672593847023,40.0,0.0
23543,2,3543,[ 88 179  82 302  97],655,2,14598,4.1190744920993225,0.0,0.0
23544,2,3544,[318 588 496 357  98],18,5,14603,4.119322990126939,40.0,0.0
23545,2,3545,[318 588 496 357  98],796,5,14608,4.119571347997744,40.0,0.0
23546,2,3546,[ 12 603 118 483 202],796,5,14613,4.119819565830279,20.0,0.0
23547,2,3547,[237 127 176 195 273],344,4,14617,4.119785794813979,0.0,20.0
23548,2,3548,[318 588 496 357  98],450,5,14622,4.120033812341505,40.0,0.0
23549,2,3549,[318 588 496 357  98],786,5,14627,4.120281690140845,40.0,0.0
23550,2,3550,[318 588 496 357  98],716,5,14632,4.120529428330048,40.0,0.0
23551,2,3551,[318 588 496 357  98],796,5,14637,4.120777027027027,40.0,0.0
23552,2,3552,[268 276   1  89 588],344,3,14640,4.120461581761892,0.0,0.0
23553,2,3553,[318 588 496 357  98],786,5,14645,4.120709060213843,40.0,0.0
23554,2,3554,[318 588 496 357  98],450,5,14650,4.120956399437412,40.0,0.0
23555,2,3555,[603 181 257 294 121],796,4,14654,4.120922384701912,20.0,0.0
23556,2,3556,[318 588 496 357  98],330,5,14659,4.121169524880517,40.0,0.0
23557,2,3557,[405 144 275 180 181],457,5,14664,4.12141652613828,0.0,20.0
23558,2,3558,[245 568  89 228 271],796,4,14668,4.121382410789548,0.0,0.0
23559,2,3559,[111  88   1 273 215],796,3,14671,4.121067415730337,0.0,0.0
23560,2,3560,[318 237 597 235 257],457,2,14673,4.120471777590565,20.0,0.0
23561,2,3561,[191  79 546  95  12],796,5,14678,4.120718697361033,0.0,0.0
23562,2,3562,[318 588 496 357  98],18,5,14683,4.120965478529329,40.0,0.0
23563,2,3563,[ 79 405  25 183 197],151,3,14686,4.1206509539842875,0.0,0.0
23564,2,3564,[187 271 127 195  64],72,4,14690,4.120617110799439,20.0,20.0
23565,2,3565,[322 294 153 471 121],450,4,14694,4.120583286595625,0.0,0.0
23566,2,3566,[186 357 515  50  79],535,2,14696,4.1199887860947575,0.0,20.0
23567,2,3567,[742 234 151 245 173],450,4,14700,4.119955156950673,0.0,0.0
23568,2,3568,[ 56  79 176   4 546],280,3,14703,4.119641356122163,0.0,0.0
23569,2,3569,[318 588 496 357  98],18,5,14708,4.119887955182072,40.0,0.0
23570,2,3570,[318 588 496 357  98],450,5,14713,4.120134416129936,40.0,0.0
23571,2,3571,[318 588 496 357  98],330,5,14718,4.120380739081747,40.0,0.0
23572,2,3572,[318 588 496 357  98],786,5,14723,4.120626924153372,40.0,0.0
23573,2,3573,[318 588 496 357  98],796,5,14728,4.120872971460549,40.0,0.0
23574,2,3574,[ 97 100   8 748 118],796,3,14731,4.120559440559441,0.0,20.0
23575,2,3575,[318 588 496 357  98],330,5,14736,4.120805369127517,40.0,0.0
23576,2,3576,[215  71 435  97 195],450,4,14740,4.120771596309757,0.0,0.0
23577,2,3577,[318 588 496 357  98],796,5,14745,4.121017328116266,40.0,0.0
23578,2,3578,[234 183 258 172 403],655,2,14747,4.12042469963677,0.0,0.0
23579,2,3579,[ 71  15 191 118 173],389,2,14749,4.119832402234637,0.0,0.0
23580,2,3580,[210  98  56 568 125],256,4,14753,4.119798938843898,0.0,0.0
23581,2,3581,[435 111 195 211 179],450,5,14758,4.120044667783361,0.0,0.0
23582,2,3582,[318 588 496 357  98],796,5,14763,4.120290259559029,40.0,0.0
23583,2,3583,[127  88  69 111 286],344,2,14765,4.119698660714286,0.0,40.0
23584,2,3584,[174  70  89 328  97],151,4,14769,4.119665271966527,0.0,0.0
23585,2,3585,[216 405 275 132  64],151,4,14773,4.119631901840491,20.0,20.0
23586,2,3586,[318 588 496 357  98],716,5,14778,4.119877334820184,40.0,0.0
23587,2,3587,[289  82 271 265  79],807,4,14782,4.11984392419175,0.0,0.0
23588,2,3588,[318 588 496 357  98],786,5,14787,4.120089161326275,40.0,0.0
23589,2,3589,[318 588 496 357  98],450,5,14792,4.12033426183844,40.0,0.0
23590,2,3590,[ 98 483  82 161  88],796,4,14796,4.120300751879699,0.0,0.0
23591,2,3591,[748 196 185  82 204],450,4,14800,4.120267260579064,0.0,0.0
23592,2,3592,[318 588 496 357  98],450,5,14805,4.120512106874478,40.0,0.0
23593,2,3593,[318 588 496 357  98],330,5,14810,4.120756816917084,40.0,0.0
23594,2,3594,[215 125 300   7   1],450,5,14815,4.1210013908205845,0.0,0.0
23595,2,3595,[475 210 127 603 125],655,2,14817,4.120411568409343,20.0,20.0
23596,2,3596,[322 200 313  70   4],593,4,14821,4.120378092855157,0.0,0.0
23597,2,3597,[121 328  70  98 597],450,4,14825,4.120344635908838,0.0,0.0
23598,2,3598,[187 194 405 496 302],450,5,14830,4.120589052514587,20.0,0.0
23599,2,3599,[318 588 496 357  98],796,5,14835,4.120833333333334,40.0,0.0
23600,2,3600,[ 98 405 228 273  50],655,3,14838,4.120522077200778,0.0,20.0
23601,2,3601,[405  89   9 265 603],151,4,14842,4.120488617434758,20.0,0.0
23602,2,3602,[275 195 117 121 235],716,3,14845,4.120177629752984,0.0,20.0
23603,2,3603,[215 151 322 357  12],151,3,14848,4.119866814650388,0.0,0.0
23604,2,3604,[186 300 301 597  22],450,4,14852,4.119833564493758,0.0,0.0
23605,2,3605,[318 588 496 357  98],330,5,14857,4.120077648363838,40.0,0.0
23606,2,3606,[318 588 496 357  98],796,5,14862,4.120321596894927,40.0,0.0
23607,2,3607,[313 265  56 228 187],796,5,14867,4.120565410199556,0.0,0.0
23608,2,3608,[200 237 187  28  70],786,5,14872,4.120809088390136,0.0,0.0
23609,2,3609,[ 12 655 546 127   1],280,4,14876,4.120775623268698,0.0,20.0
23610,2,3610,[318 588 496 357  98],796,5,14881,4.1210191082802545,40.0,0.0
23611,2,3611,[508 182 294  15 289],655,1,14882,4.12015503875969,0.0,0.0
23612,2,3612,[318 588 496 357  98],450,5,14887,4.120398560752837,40.0,0.0
23613,2,3613,[318 216 323   9  88],280,3,14890,4.1200885445489766,20.0,0.0
23614,2,3614,[318 588 496 357  98],786,5,14895,4.1203319502074685,40.0,0.0
23615,2,3615,[151 180 423  88 235],457,4,14899,4.1202986725663715,0.0,0.0
23616,2,3616,[318 588 496 357  98],716,5,14904,4.120541885540503,40.0,0.0
23617,2,3617,[ 28  22 210 180 200],18,3,14907,4.1202321724709785,0.0,0.0
23618,2,3618,[ 56 268  11 483 121],269,3,14910,4.119922630560929,0.0,0.0
23619,2,3619,[318 588 496 357  98],796,5,14915,4.120165745856354,40.0,0.0
23620,2,3620,[183 286  71 196  95],450,3,14918,4.1198563932615295,0.0,20.0
23621,2,3621,[318 588 496 357  98],450,5,14923,4.120099392600773,40.0,0.0
23622,2,3622,[318 588 496 357  98],796,5,14928,4.120342257797406,40.0,0.0
23623,2,3623,[318 588 496 357  98],330,5,14933,4.120584988962473,40.0,0.0
23624,2,3624,[405 603 215 117 200],796,5,14938,4.120827586206897,20.0,0.0
23625,2,3625,[ 89  64  88 471  69],450,5,14943,4.121070049641478,20.0,0.0
23626,2,3626,[228  96  28 180 265],72,4,14947,4.121036669423766,0.0,0.0
23627,2,3627,[357 302 678 405 135],401,1,14948,4.120176405733186,0.0,0.0
23628,2,3628,[318 588 496 357  98],786,5,14953,4.12041884816754,40.0,0.0
23629,2,3629,[318 588 496 357  98],450,5,14958,4.120661157024793,40.0,0.0
23630,2,3630,[ 12 257 403 288 143],655,1,14959,4.11980170751859,0.0,0.0
23631,2,3631,[216 265   4 322 403],796,4,14963,4.119768722466961,0.0,0.0
23632,2,3632,[258 135 195 132  98],655,2,14965,4.119185246352877,0.0,0.0
23633,2,3633,[318 588 496 357  98],330,5,14970,4.1194276279581725,40.0,0.0
23634,2,3634,[258 313 117  95 196],450,4,14974,4.11939477303989,0.0,0.0
23635,2,3635,[318 588 496 357  98],786,5,14979,4.11963696369637,40.0,0.0
23636,2,3636,[187 210 385  12  50],655,2,14981,4.1190541655210335,0.0,20.0
23637,2,3637,[144 197 328 181 235],292,3,14984,4.118746564046179,0.0,0.0
23638,2,3638,[318 588 496 357  98],786,5,14989,4.118988733168453,40.0,0.0
23639,2,3639,[318 588 496 357  98],18,5,14994,4.119230769230769,40.0,0.0
23640,2,3640,[318 588 496 357  98],716,5,14999,4.119472672342763,40.0,0.0
23641,2,3641,[323 185  71 183  56],23,2,15001,4.118890719384953,0.0,0.0
23642,2,3642,[318 588 496 357  98],18,5,15006,4.1191325830359595,40.0,0.0
23643,2,3643,[ 88 603 238 228 111],151,5,15011,4.119374313940725,20.0,0.0
23644,2,3644,[180 265 176  98 273],796,3,15014,4.119067215363511,0.0,0.0
23645,2,3645,[204 222 403 328 275],796,5,15019,4.11930883159627,0.0,20.0
23646,2,3646,[588 127 151 168  70],878,2,15021,4.118727721414862,0.0,20.0
23647,2,3647,[318 496 588 357  98],18,5,15026,4.118969298245614,40.0,0.0
23648,2,3648,[322 471  88 228  70],344,1,15027,4.118114551932036,0.0,0.0
23649,2,3649,[237 100  12 678 125],280,1,15028,4.117260273972603,0.0,20.0
23650,2,3650,[435 302 153 483 588],450,4,15032,4.117228156669405,0.0,0.0
23651,2,3651,[748 195  28 323 597],796,3,15035,4.1169222343921135,0.0,0.0
23652,2,3652,[357 186 143 282 125],450,4,15039,4.116890227210512,0.0,0.0
23653,2,3653,[289 423  98 275 471],655,2,15041,4.116310892172961,0.0,20.0
23654,2,3654,[318 496 588 357  98],796,5,15046,4.1165526675786595,40.0,0.0
23655,2,3655,[423 179  98 471 197],457,5,15051,4.116794310722101,0.0,0.0
23656,2,3656,[100 603  96 185 202],655,2,15053,4.116215477167077,20.0,20.0
23657,2,3657,[322  69 423 238 121],504,4,15057,4.116183706943685,0.0,0.0
23658,2,3658,[318 496 588 357  98],786,5,15062,4.116425252801312,40.0,0.0
23659,2,3659,[318 496 588 357  98],716,5,15067,4.116666666666666,40.0,0.0
23660,2,3660,[318 496 588 357  98],786,5,15072,4.116907948647911,40.0,0.0
23661,2,3661,[357 515 238 385 216],655,3,15075,4.116602949208083,0.0,0.0
23662,2,3662,[318 496 588 357  98],18,5,15080,4.116844116844117,40.0,0.0
23663,2,3663,[ 95 191 300 742 196],450,4,15084,4.116812227074236,0.0,0.0
23664,2,3664,[318 496 588 357  98],796,5,15089,4.117053206002729,40.0,0.0
23665,2,3665,[318 496 588 357  98],330,5,15094,4.117294053464266,40.0,0.0
23666,2,3666,[318 496 588 357  98],330,5,15099,4.117534769566403,40.0,0.0
23667,2,3667,[318 496 588 357  98],450,5,15104,4.117775354416576,40.0,0.0
23668,2,3668,[318 496 588 357  98],450,5,15109,4.118015808122104,40.0,0.0
23669,2,3669,[318 496 588 357  98],716,5,15114,4.118256130790191,40.0,0.0
23670,2,3670,[ 28 237  98 294 515],655,2,15116,4.117679106510487,0.0,0.0
23671,2,3671,[318 496 588 357  98],330,5,15121,4.117919389978214,40.0,0.0
23672,2,3672,[475 187 333  50 182],655,3,15124,4.117615028586986,0.0,20.0
23673,2,3673,[318 496 588 357  98],330,5,15129,4.117855198693522,40.0,0.0
23674,2,3674,[ 79 151 302 176 181],389,5,15134,4.118095238095238,0.0,0.0
23675,2,3675,[175 204 172 195 180],269,1,15135,4.117247007616975,0.0,0.0
23676,2,3676,[127  69 153 202 237],401,1,15136,4.116399238509654,0.0,20.0
23677,2,3677,[318 496 588 357  98],716,5,15141,4.116639477977161,40.0,0.0
23678,2,3678,[318 496 588 357  98],18,5,15146,4.116879586844251,40.0,0.0
23679,2,3679,[318 496 588 357  98],796,5,15151,4.117119565217391,40.0,0.0
23680,2,3680,[318 496 588 357  98],796,5,15156,4.117359413202934,40.0,0.0
23681,2,3681,[318 496 588 357  98],786,5,15161,4.117599130907116,40.0,0.0
23682,2,3682,[ 88 257 655  64 282],716,4,15165,4.117567200651643,20.0,0.0
23683,2,3683,[197 153 174 211 132],503,4,15169,4.117535287730727,0.0,0.0
23684,2,3684,[546  64  98  82 174],796,4,15173,4.117503392130258,20.0,0.0
23685,2,3685,[204  71 180  96 597],450,4,15177,4.117471513836136,0.0,0.0
23686,2,3686,[423 144  64 168 210],535,4,15181,4.117439652834283,20.0,0.0
23687,2,3687,[172 135 405  50  82],72,1,15182,4.116594360086768,0.0,20.0
23688,2,3688,[318 496 588 357  98],18,5,15187,4.116833830306316,40.0,0.0
23689,2,3689,[ 69 182 125 118 655],280,1,15188,4.1159891598915985,0.0,0.0
23690,2,3690,[185 282 153 328 211],655,1,15189,4.115144947168789,0.0,0.0
23691,2,3691,[ 12 385  98 678 172],344,3,15192,4.114842903575298,0.0,0.0
23692,2,3692,[187 186  79 228 405],655,2,15194,4.11427024099648,0.0,0.0
23693,2,3693,[ 28 202 173 603 568],796,4,15198,4.114239306984299,20.0,0.0
23694,2,3694,[318 496 588 357  98],716,5,15203,4.11447902571042,40.0,0.0
23695,2,3695,[ 22 196 183  25 423],450,4,15207,4.1144480519480515,0.0,0.0
23696,2,3696,[ 70 187 176 194 174],716,3,15210,4.114146605355693,0.0,0.0
23697,2,3697,[597  88 328 143 195],796,5,15215,4.114386154678204,0.0,0.0
23698,2,3698,[318 496 588 357  98],18,5,15220,4.114625574479589,40.0,0.0
23699,2,3699,[318 496 588 357  98],330,5,15225,4.114864864864865,40.0,0.0
23700,2,3700,[318 496 588 357  98],450,5,15230,4.115104025938935,40.0,0.0
23701,2,3701,[318 496 588 357  98],330,5,15235,4.115343057806591,40.0,0.0
23702,2,3702,[215 655 257 202 127],655,1,15236,4.114501755333514,0.0,20.0
23703,2,3703,[318 496 588 357  98],18,5,15241,4.114740820734341,40.0,0.0
23704,2,3704,[403   9  56  98 153],796,4,15245,4.1147098515519565,0.0,0.0
23705,2,3705,[318 496 588 357  98],18,5,15250,4.114948731786292,40.0,0.0
23706,2,3706,[257 275 210  71 161],798,3,15253,4.114647963312652,0.0,20.0
23707,2,3707,[ 22 111 318 357 181],450,5,15258,4.114886731391586,20.0,0.0
23708,2,3708,[318 496 588 357  98],450,5,15263,4.115125370719871,40.0,0.0
23709,2,3709,[194 496  82  98  28],389,5,15268,4.115363881401617,20.0,0.0
23710,2,3710,[318 496 588 357  98],18,5,15273,4.115602263540825,40.0,0.0
23711,2,3711,[475 121 204 655  11],655,0,15273,4.114493534482759,0.0,0.0
23712,2,3712,[318 496 588 357  98],18,5,15278,4.114732022623215,40.0,0.0
23713,2,3713,[318 496 588 357  98],330,5,15283,4.114970382337103,40.0,0.0
23714,2,3714,[  4   1  50 597 258],796,4,15287,4.114939434724092,0.0,20.0
23715,2,3715,[ 64  71 245 597  15],796,4,15291,4.1149085037674915,20.0,0.0
23716,2,3716,[318 496 588 357  98],330,5,15296,4.1151466236212,40.0,0.0
23717,2,3717,[127 215   7 173 117],457,5,15301,4.115384615384615,0.0,20.0
23718,2,3718,[318 496 588 357  98],716,5,15306,4.115622479161065,40.0,0.0
23719,2,3719,[385  88 191  95 508],344,3,15309,4.115322580645161,0.0,0.0
23720,2,3720,[318 496 588 357  98],330,5,15314,4.115560333243752,40.0,0.0
23721,2,3721,[318 496 588 357  98],786,5,15319,4.11579795808705,40.0,0.0
23722,2,3722,[ 97   7 483 127  88],457,5,15324,4.116035455278001,0.0,20.0
23723,2,3723,[186 282 323  95 597],796,3,15327,4.115735767991407,0.0,0.0
23724,2,3724,[301  22 427 211 328],450,5,15332,4.1159731543624165,20.0,0.0
23725,2,3725,[245 127 258 210 100],344,3,15335,4.115673644659152,0.0,40.0
23726,2,3726,[168 238 161 265  98],436,2,15337,4.115105983364637,0.0,0.0
23727,2,3727,[100  56 151 181  50],908,3,15340,4.114806866952789,0.0,40.0
23728,2,3728,[301 597 313 423 151],796,4,15344,4.114776079377849,0.0,0.0
23729,2,3729,[318 496 588 357  98],786,5,15349,4.115013404825738,40.0,0.0
23730,2,3730,[300 200 234 197 228],151,4,15353,4.114982578397212,0.0,0.0
23731,2,3731,[318 496 588 357  98],796,5,15358,4.115219721329046,40.0,0.0
23732,2,3732,[222 282 183  50 191],236,3,15361,4.1149209750870614,0.0,20.0
23733,2,3733,[294 238 111 194  28],796,2,15363,4.114354579539368,0.0,0.0
23734,2,3734,[318 496 588 357  98],330,5,15368,4.114591700133869,40.0,0.0
23735,2,3735,[258 268 301 427  25],11,4,15372,4.114561027837259,20.0,0.0
23736,2,3736,[175 174 269  96 427],23,5,15377,4.114797966283115,20.0,0.0
23737,2,3737,[ 96 678 258   1 228],344,2,15379,4.114232209737827,0.0,0.0
23738,2,3738,[318 496 588 357  98],18,5,15384,4.114469109387537,40.0,0.0
23739,2,3739,[258  79  88 265 172],796,5,15389,4.114705882352941,0.0,0.0
23740,2,3740,[318 496 588 357  98],796,5,15394,4.114942528735632,40.0,0.0
23741,2,3741,[318 496 588 357  98],450,5,15399,4.115179048637092,40.0,0.0
23742,2,3742,[318 496 588 357  98],330,5,15404,4.115415442158696,40.0,0.0
23743,2,3743,[318 496 588 357  98],330,5,15409,4.1156517094017095,40.0,0.0
23744,2,3744,[204 173  79 257 127],716,5,15414,4.115887850467289,0.0,20.0
23745,2,3745,[289   1 187 655  12],655,1,15415,4.115056059797117,0.0,0.0
23746,2,3746,[318 496 588 357  98],796,5,15420,4.11529223378703,40.0,0.0
23747,2,3747,[318 496 588 357  98],18,5,15425,4.115528281750267,40.0,0.0
23748,2,3748,[258 286  98 302  69],151,4,15429,4.115497465990931,0.0,20.0
23749,2,3749,[ 56 742 238 237 603],655,1,15430,4.1146666666666665,20.0,0.0
23750,2,3750,[318 496 588 357  98],796,5,15435,4.114902692615303,40.0,0.0
23751,2,3751,[318 496 588 357  98],330,5,15440,4.115138592750533,40.0,0.0
23752,2,3752,[210 127 748  82   4],280,1,15441,4.114308553157474,0.0,20.0
23753,2,3753,[ 15 216 175 515 100],655,2,15443,4.113745338305807,0.0,20.0
23754,2,3754,[185 210 121 546 200],796,4,15447,4.113715046604527,0.0,0.0
23755,2,3755,[182 117 210  97  70],72,5,15452,4.11395101171459,0.0,0.0
23756,2,3756,[318 496 588 357  98],330,5,15457,4.114186851211072,40.0,0.0
23757,2,3757,[168 121 357 258  96],457,5,15462,4.1144225651942525,0.0,0.0
23758,2,3758,[318 496 588 357  98],796,5,15467,4.114658153764299,40.0,0.0
23759,2,3759,[318 496 588 357  98],796,5,15472,4.114893617021276,40.0,0.0
23760,2,3760,[318 496 588 357  98],330,5,15477,4.115128955065142,40.0,0.0
23761,2,3761,[183 313 515  96 405],655,3,15480,4.114832535885167,0.0,0.0
23762,2,3762,[318 496 588 357  98],796,5,15485,4.1150677650810525,40.0,0.0
23763,2,3763,[318 496 588 357  98],18,5,15490,4.115302869287992,40.0,0.0
23764,2,3764,[318 496 588 357  98],716,5,15495,4.115537848605578,40.0,0.0
23765,2,3765,[318 496 588 357  98],796,5,15500,4.115772703133298,40.0,0.0
23766,2,3766,[ 98  28 191 111 238],450,5,15505,4.116007432970534,0.0,0.0
23767,2,3767,[ 82 234  70 405 172],151,3,15508,4.115711252653928,0.0,0.0
23768,2,3768,[318 496 588 357  98],330,5,15513,4.115945874237198,40.0,0.0
23769,2,3769,[318 496 588 357  98],716,5,15518,4.116180371352785,40.0,0.0
23770,2,3770,[318 496 588 357  98],716,5,15523,4.116414744099708,40.0,0.0
23771,2,3771,[318 496 588 357  98],796,5,15528,4.1166489925768825,40.0,0.0
23772,2,3772,[318 496 588 357  98],18,5,15533,4.116883116883117,40.0,0.0
23773,2,3773,[302 276 111 333 181],655,2,15535,4.116322204557498,0.0,0.0
23774,2,3774,[318 496 588 357  98],18,5,15540,4.1165562913907285,40.0,0.0
23775,2,3775,[318 496 588 357  98],786,5,15545,4.116790254237288,40.0,0.0
23776,2,3776,[215  15  56 275   9],796,4,15549,4.116759332803812,0.0,20.0
23777,2,3777,[318 496 588 357  98],330,5,15554,4.116993118051879,40.0,0.0
23778,2,3778,[318 496 588 357  98],786,5,15559,4.1172267795713156,40.0,0.0
23779,2,3779,[245 313 153 301  15],593,4,15563,4.117195767195767,0.0,0.0
23780,2,3780,[318 496 588 357  98],786,5,15568,4.117429251520762,40.0,0.0
23781,2,3781,[318 496 588 357  98],796,5,15573,4.117662612374405,40.0,0.0
23782,2,3782,[318 496 588 357  98],18,5,15578,4.117895849854612,40.0,0.0
23783,2,3783,[318 496 588 357  98],450,5,15583,4.1181289640591965,40.0,0.0
23784,2,3784,[ 11 176   8  88   1],457,5,15588,4.118361955085866,0.0,0.0
23785,2,3785,[318 496 588 357  98],18,5,15593,4.118594823032224,40.0,0.0
23786,2,3786,[168 151 222 194 195],450,4,15597,4.118563506733562,0.0,0.0
23787,2,3787,[195 405   8 127 288],344,4,15601,4.118532206969377,0.0,20.0
23788,2,3788,[318 496 588 357  98],450,5,15606,4.118764845605701,40.0,0.0
23789,2,3789,[318 403 173 117 121],450,4,15610,4.118733509234828,20.0,0.0
23790,2,3790,[182 144 228 186 435],655,1,15611,4.117910841466632,0.0,0.0
23791,2,3791,[ 22   9 234 228 237],256,4,15615,4.117879746835443,0.0,0.0
23792,2,3792,[318 496 588 357  98],796,5,15620,4.118112312153968,40.0,0.0
23793,2,3793,[ 69 125 597   1 176],796,4,15624,4.118081180811808,0.0,0.0
23794,2,3794,[318 496 588 357  98],450,5,15629,4.118313570487484,40.0,0.0
23795,2,3795,[183 300 568  22 111],756,3,15632,4.118018967334036,0.0,0.0
23796,2,3796,[204 508 276 238 210],655,1,15633,4.117197787727153,0.0,0.0
23797,2,3797,[318 496 588 357  98],18,5,15638,4.117430226434966,40.0,0.0
23798,2,3798,[322 210 215 228 385],796,3,15641,4.117136088444328,0.0,0.0
23799,2,3799,[125  25 173 180 185],450,4,15645,4.117105263157895,0.0,0.0
23800,2,3800,[100 742 151   4  12],344,4,15649,4.1170744540910285,0.0,20.0
23801,2,3801,[318 496 588 357  98],330,5,15654,4.117306680694371,40.0,0.0
23802,2,3802,[423  11 216  28 318],11,3,15657,4.117012884564817,20.0,0.0
23803,2,3803,[168 742 176 186 258],504,3,15660,4.116719242902208,0.0,0.0
23804,2,3804,[318 496 588 357  98],450,5,15665,4.116951379763469,40.0,0.0
23805,2,3805,[200 195 288 742 222],655,1,15666,4.116132422490804,0.0,0.0
23806,2,3806,[318 496 588 357  98],450,5,15671,4.116364591541896,40.0,0.0
23807,2,3807,[423 174 216 288 127],655,2,15673,4.115808823529412,0.0,20.0
23808,2,3808,[328  69 187 151 403],796,5,15678,4.1160409556314,0.0,0.0
23809,2,3809,[237 234 471  82  56],280,1,15679,4.115223097112861,0.0,0.0
23810,2,3810,[204 427 186 302  12],151,4,15683,4.115192862765678,20.0,0.0
23811,2,3811,[318 496 588 357  98],796,5,15688,4.115424973767052,40.0,0.0
23812,2,3812,[318 496 588 357  98],330,5,15693,4.115656963021243,40.0,0.0
23813,2,3813,[318 496 588 357  98],330,5,15698,4.115888830624017,40.0,0.0
23814,2,3814,[ 98 210 435 135 328],236,3,15701,4.115596330275229,0.0,0.0
23815,2,3815,[ 79  12  69 181  98],693,3,15704,4.115303983228512,0.0,0.0
23816,2,3816,[234  28 183   1 181],716,4,15708,4.115273775216139,0.0,0.0
23817,2,3817,[ 96   9 183 742 111],756,3,15711,4.114981665793609,0.0,0.0
23818,2,3818,[176 423 125 175  97],151,4,15715,4.114951557999476,0.0,0.0
23819,2,3819,[403 483  22 258 294],655,1,15716,4.114136125654451,0.0,0.0
23820,2,3820,[ 89 161 196  82 748],796,4,15720,4.114106254907092,0.0,0.0
23821,2,3821,[318 496 588 357  98],786,5,15725,4.114338042909472,40.0,0.0
23822,2,3822,[423 546 176  79 258],457,4,15729,4.114308134972535,0.0,0.0
23823,2,3823,[318 496 588 357  98],786,5,15734,4.114539748953975,40.0,0.0
23824,2,3824,[318 496 588 357  98],330,5,15739,4.1147712418300655,40.0,0.0
23825,2,3825,[318 496 588 357  98],330,5,15744,4.115002613695766,40.0,0.0
23826,2,3826,[ 15 427 183 151  79],577,4,15748,4.11497256336556,20.0,0.0
23827,2,3827,[403   7 173 318 202],280,2,15750,4.114420062695925,20.0,0.0
23828,2,3828,[202 234   4 237 215],577,4,15754,4.114390180203708,0.0,0.0
23829,2,3829,[174 357 515 655 508],655,2,15756,4.113838120104439,0.0,0.0
23830,2,3830,[318 496 588 357  98],716,5,15761,4.114069433568259,40.0,0.0
23831,2,3831,[318 496 588 357  98],450,5,15766,4.114300626304802,40.0,0.0
23832,2,3832,[ 28 403 197 180 194],18,2,15768,4.113749021654057,0.0,0.0
23833,2,3833,[318 496 588 357  98],796,5,15773,4.113980177360459,40.0,0.0
23834,2,3834,[318 496 588 357  98],330,5,15778,4.114211212516297,40.0,0.0
23835,2,3835,[318 496 588 357  98],716,5,15783,4.11444212721585,40.0,0.0
23836,2,3836,[318 496 588 357  98],796,5,15788,4.1146729215532964,40.0,0.0
23837,2,3837,[186 403 176 228 191],450,4,15792,4.114643043251694,0.0,0.0
23838,2,3838,[ 50   7 237 313 195],280,1,15793,4.113831727012243,0.0,20.0
23839,2,3839,[318 496 588 357  98],796,5,15798,4.1140625,40.0,0.0
23840,2,3840,[318 496 588 357  98],330,5,15803,4.114293152824785,40.0,0.0
23841,2,3841,[471  96  22 235 180],450,4,15807,4.114263404476835,0.0,0.0
23842,2,3842,[196  71   4 435  82],18,2,15809,4.113713244860786,0.0,0.0
23843,2,3843,[210 204 301  82  15],389,3,15812,4.113423517169615,0.0,0.0
23844,2,3844,[ 95 181 118  89 405],344,2,15814,4.112873862158648,0.0,0.0
23845,2,3845,[121 132 185 357 258],457,5,15819,4.113104524180967,0.0,0.0
23846,2,3846,[ 12 216 403 265 195],796,5,15824,4.113335066285417,0.0,0.0
23847,2,3847,[318  25  70  22 496],535,4,15828,4.113305613305613,40.0,0.0
23848,2,3848,[318 496 588 357  98],330,5,15833,4.113535983372304,40.0,0.0
23849,2,3849,[ 82 245   8  96 185],796,3,15836,4.113246753246753,0.0,0.0
23850,2,3850,[403 181  50 423 194],450,5,15841,4.113477018956115,0.0,20.0
23851,2,3851,[318 496 588 357  98],716,5,15846,4.113707165109035,40.0,0.0
23852,2,3852,[328  69  50  12 179],450,5,15851,4.113937191798598,0.0,20.0
23853,2,3853,[318 496 588 357  98],330,5,15856,4.114167099117799,40.0,0.0
23854,2,3854,[318 496 588 357  98],786,5,15861,4.114396887159533,40.0,0.0
23855,2,3855,[111  28 423 258 475],655,0,15861,4.113329875518672,0.0,0.0
23856,2,3856,[ 12 222 515  50 568],655,2,15863,4.112781954887218,0.0,20.0
23857,2,3857,[202 245 313 111 211],450,5,15868,4.113011923276309,0.0,0.0
23858,2,3858,[111 117  70 135 210],450,3,15871,4.112723503498316,0.0,0.0
23859,2,3859,[  1   7 182 216 127],256,5,15876,4.112953367875647,0.0,20.0
23860,2,3860,[216  98  11 655 143],457,5,15881,4.113183113183113,0.0,0.0
23861,2,3861,[174 385 194 202 111],577,5,15886,4.113412739513206,0.0,0.0
23862,2,3862,[318 496 588 357  98],18,5,15891,4.113642246958323,40.0,0.0
23863,2,3863,[286 202 385 597  71],344,1,15892,4.112836438923395,0.0,20.0
23864,2,3864,[496  79 222 117 328],450,4,15896,4.112807244501941,20.0,0.0
23865,2,3865,[318 496 588 357  98],330,5,15901,4.113036730470771,40.0,0.0
23866,2,3866,[318 496 588 357  98],450,5,15906,4.113266097750194,40.0,0.0
23867,2,3867,[ 50  69 385 191 161],716,3,15909,4.112978283350569,0.0,20.0
23868,2,3868,[318 496 588 357  98],796,5,15914,4.113207547169812,40.0,0.0
23869,2,3869,[318 496 588 357  98],796,5,15919,4.11343669250646,40.0,0.0
23870,2,3870,[238 153 245 185 194],796,3,15922,4.113149057091191,0.0,0.0
23871,2,3871,[181 385 655   1 183],796,3,15925,4.112861570247934,0.0,0.0
23872,2,3872,[118 183  11 385 405],655,1,15926,4.112057836302608,0.0,0.0
23873,2,3873,[318 496 588 357  98],18,5,15931,4.112287041817243,40.0,0.0
23874,2,3874,[318 496 588 357  98],796,5,15936,4.112516129032258,40.0,0.0
23875,2,3875,[318 496 588 357  98],786,5,15941,4.112745098039215,40.0,0.0
23876,2,3876,[318 496 588 357  98],716,5,15946,4.112973948929585,40.0,0.0
23877,2,3877,[357 269 483 328 294],796,3,15949,4.112686952037133,0.0,0.0
23878,2,3878,[318 496 588 357  98],330,5,15954,4.11291569992266,40.0,0.0
23879,2,3879,[318 496 588 357  98],786,5,15959,4.113144329896907,40.0,0.0
23880,2,3880,[271 143 269 237 597],796,4,15963,4.1131151765009015,0.0,0.0
23881,2,3881,[187 403 121 245 228],450,4,15967,4.113086038124678,0.0,0.0
23882,2,3882,[318 496 588 357  98],450,5,15972,4.113314447592068,40.0,0.0
23883,2,3883,[318 496 588 357  98],330,5,15977,4.113542739443872,40.0,0.0
23884,2,3884,[ 22 204 202 197 603],796,4,15981,4.113513513513514,20.0,0.0
23885,2,3885,[515  70  22 168 100],535,3,15984,4.113226968605249,0.0,20.0
23886,2,3886,[318 496 588 357  98],450,5,15989,4.113455106766144,40.0,0.0
23887,2,3887,[ 56 195 273 258  50],629,4,15993,4.113425925925926,0.0,20.0
23888,2,3888,[328  50 655 111 273],796,3,15996,4.113139624582155,0.0,20.0
23889,2,3889,[ 98   4 202  12 313],796,5,16001,4.113367609254499,0.0,0.0
23890,2,3890,[100  98 300  12  28],655,1,16002,4.112567463377024,0.0,20.0
23891,2,3891,[655 125  82 121 258],151,4,16006,4.112538540596095,0.0,0.0
23892,2,3892,[318 496 588 357  98],330,5,16011,4.112766503981505,40.0,0.0
23893,2,3893,[318 496 588 357  98],716,5,16016,4.112994350282486,40.0,0.0
23894,2,3894,[179 215   7 168 183],450,5,16021,4.113222079589217,0.0,0.0
23895,2,3895,[257  70 483 135 144],401,3,16024,4.112936344969199,0.0,0.0
23896,2,3896,[151 194 125 275 276],296,4,16028,4.112907364639466,0.0,20.0
23897,2,3897,[318 496 588 357  98],450,5,16033,4.113134940995383,40.0,0.0
23898,2,3898,[318 496 588 357  98],18,5,16038,4.113362400615542,40.0,0.0
23899,2,3899,[318 496 588 357  98],786,5,16043,4.113589743589744,40.0,0.0
23900,2,3900,[318 496 588 357  98],330,5,16048,4.11381697000769,40.0,0.0
23901,2,3901,[318 496 588 357  98],450,5,16053,4.114044079958996,40.0,0.0
23902,2,3902,[496  79 515  97 508],535,3,16056,4.113758647194466,20.0,0.0
23903,2,3903,[318 496 588 357  98],450,5,16061,4.113985655737705,40.0,0.0
23904,2,3904,[176 202 196 357 294],796,4,16065,4.113956466069142,0.0,0.0
23905,2,3905,[318 496 588 357  98],450,5,16070,4.114183307731695,40.0,0.0
23906,2,3906,[748 153  70 117  98],450,5,16075,4.114410033273612,0.0,0.0
23907,2,3907,[182 144  96 197 435],655,1,16076,4.113613101330604,0.0,0.0
23908,2,3908,[ 97 328  28 187 176],450,5,16081,4.113839856740855,0.0,0.0
23909,2,3909,[318 496 588 357  98],796,5,16086,4.114066496163683,40.0,0.0
23910,2,3910,[318 496 588 357  98],786,5,16091,4.114293019688059,40.0,0.0
23911,2,3911,[215 237 121 100 204],344,2,16093,4.113752556237219,0.0,20.0
23912,2,3912,[318 496 588 357  98],330,5,16098,4.113979044211602,40.0,0.0
23913,2,3913,[318 496 588 357  98],716,5,16103,4.114205416453756,40.0,0.0
23914,2,3914,[546  28 151 318 258],504,5,16108,4.114431673052363,20.0,0.0
23915,2,3915,[183 181  12   7 174],344,4,16112,4.114402451481103,0.0,0.0
23916,2,3916,[  4 132 258  88 234],151,5,16117,4.114628542251723,0.0,0.0
23917,2,3917,[318 496 588 357  98],18,5,16122,4.114854517611026,40.0,0.0
23918,2,3918,[237 423 385 111  22],577,5,16127,4.1150803776473595,0.0,0.0
23919,2,3919,[318 496 588 357  98],786,5,16132,4.115306122448979,40.0,0.0
23920,2,3920,[318 496 588 357  98],786,5,16137,4.115531752104055,40.0,0.0
23921,2,3921,[144 111   1 405 427],716,4,16141,4.115502294747578,20.0,0.0
23922,2,3922,[318 496 588 357  98],330,5,16146,4.1157277593678305,40.0,0.0
23923,2,3923,[234 100 191 237 118],457,5,16151,4.115953109072375,0.0,20.0
23924,2,3924,[204 328 228 183 385],655,1,16152,4.11515923566879,0.0,0.0
23925,2,3925,[318 496 588 357  98],786,5,16157,4.115384615384615,40.0,0.0
23926,2,3926,[172 127 195 200 385],786,5,16162,4.115609880315763,0.0,20.0
23927,2,3927,[357 216 483  70 111],457,4,16166,4.115580448065173,0.0,0.0
23928,2,3928,[ 64 288 275  98  56],629,5,16171,4.1158055484856195,20.0,20.0
23929,2,3929,[271  79 318 289 168],807,4,16175,4.1157760814249365,20.0,0.0
23930,2,3930,[ 70 748 143 153 191],450,5,16180,4.116001017552786,0.0,0.0
23931,2,3931,[318 496 588 357  98],716,5,16185,4.116225839267548,40.0,0.0
23932,2,3932,[195 269 176 405 282],655,0,16185,4.115179252479024,0.0,0.0
23933,2,3933,[191  97 228 282 313],693,3,16188,4.114895780376208,0.0,0.0
23934,2,3934,[435 269   9   1 181],296,5,16193,4.115120711562897,0.0,0.0
23935,2,3935,[318 496 588 357  98],330,5,16198,4.1153455284552845,40.0,0.0
23936,2,3936,[318 496 588 357  98],18,5,16203,4.115570231140462,40.0,0.0
23937,2,3937,[318 496 588 357  98],18,5,16208,4.115794819705434,40.0,0.0
23938,2,3938,[318 496 588 357  98],716,5,16213,4.116019294237116,40.0,0.0
23939,2,3939,[318 496 588 357  98],450,5,16218,4.116243654822335,40.0,0.0
23940,2,3940,[318 496 588 357  98],330,5,16223,4.11646790154783,40.0,0.0
23941,2,3941,[318 496 588 357  98],450,5,16228,4.116692034500254,40.0,0.0
23942,2,3942,[318 496 588 357  98],450,5,16233,4.116916053766168,40.0,0.0
23943,2,3943,[318 496 588 357  98],18,5,16238,4.117139959432048,40.0,0.0
23944,2,3944,[318 496 588 357  98],330,5,16243,4.117363751584284,40.0,0.0
23945,2,3945,[318 496 588 357  98],786,5,16248,4.1175874303091735,40.0,0.0
23946,2,3946,[318 496 588 357  98],786,5,16253,4.117810995692931,40.0,0.0
23947,2,3947,[318 496 588 357  98],796,5,16258,4.118034447821682,40.0,0.0
23948,2,3948,[196 144 191 117 403],693,2,16260,4.117498100785009,0.0,0.0
23949,2,3949,[238  56   1 127 143],18,5,16265,4.1177215189873415,0.0,20.0
23950,2,3950,[318 496 588 357  98],450,5,16270,4.117944824095166,40.0,0.0
23951,2,3951,[318 496 588 357  98],716,5,16275,4.118168016194332,40.0,0.0
23952,2,3952,[318 496 588 357  98],18,5,16280,4.118391095370605,40.0,0.0
23953,2,3953,[151 228 117 181 132],716,5,16285,4.118614061709661,0.0,0.0
23954,2,3954,[ 50 100 742 161 301],450,5,16290,4.118836915297092,0.0,40.0
23955,2,3955,[318 496 588 357  98],18,5,16295,4.119059656218402,40.0,0.0
23956,2,3956,[ 71 265 288  11  95],450,2,16297,4.118524134445287,0.0,0.0
23957,2,3957,[ 82 258 174 245 168],504,5,16302,4.118746841839313,0.0,0.0
23958,2,3958,[318 496 588 357  98],796,5,16307,4.118969436726446,40.0,0.0
23959,2,3959,[318 496 588 357  98],450,5,16312,4.119191919191919,40.0,0.0
23960,2,3960,[318 496 588 357  98],786,5,16317,4.119414289320878,40.0,0.0
23961,2,3961,[318 496 588 357  98],330,5,16322,4.119636547198384,40.0,0.0
23962,2,3962,[286 175 183 483 216],151,4,16326,4.119606358819077,0.0,20.0
23963,2,3963,[318 496 588 357  98],18,5,16331,4.119828456104944,40.0,0.0
23964,2,3964,[318 496 588 357  98],796,5,16336,4.120050441361917,40.0,0.0
23965,2,3965,[318 496 588 357  98],786,5,16341,4.120272314674735,40.0,0.0
23966,2,3966,[  1 121 222 546   4],457,4,16345,4.1202419964708845,0.0,0.0
23967,2,3967,[318 496 588 357  98],716,5,16350,4.120463709677419,40.0,0.0
23968,2,3968,[318 496 588 357  98],716,5,16355,4.120685311161502,40.0,0.0
23969,2,3969,[286 300 546 318 403],450,5,16360,4.120906801007557,20.0,20.0
23970,2,3970,[127 173  56   9  15],269,3,16363,4.1206245278267435,0.0,20.0
23971,2,3971,[318 496 588 357  98],716,5,16368,4.120845921450151,40.0,0.0
23972,2,3972,[301 496 173  28 185],389,4,16372,4.120815504656431,20.0,0.0
23973,2,3973,[  7 196 275 286  89],786,5,16377,4.121036738802214,0.0,40.0
23974,2,3974,[318 496 588 357  98],450,5,16382,4.12125786163522,40.0,0.0
23975,2,3975,[323 405 546 258 111],938,2,16384,4.120724346076459,0.0,0.0
23976,2,3976,[174 204 313 302 357],344,4,16388,4.1206939904450595,0.0,0.0
23977,2,3977,[318 496 588 357  98],450,5,16393,4.120915032679738,40.0,0.0
23978,2,3978,[318 496 588 357  98],786,5,16398,4.121135963810002,40.0,0.0
23979,2,3979,[282 508 302 546 289],15,1,16399,4.12035175879397,0.0,0.0
23980,2,3980,[318 496 588 357  98],786,5,16404,4.120572720422005,40.0,0.0
23981,2,3981,[423 228  71 222 183],23,2,16406,4.120040180813661,0.0,0.0
23982,2,3982,[183 179 216  12 288],655,3,16409,4.119758975646498,0.0,0.0
23983,2,3983,[191 238 385 195 194],796,4,16413,4.119728915662651,0.0,0.0
23984,2,3984,[357 125 300 197 257],504,5,16418,4.119949811794228,0.0,0.0
23985,2,3985,[318 496 588 357  98],330,5,16423,4.120170597089814,40.0,0.0
23986,2,3986,[ 88   8 597 175 222],344,3,16426,4.119889641334336,0.0,0.0
23987,2,3987,[385 181 237 117 197],796,4,16430,4.119859578736208,0.0,0.0
23988,2,3988,[318 496 588 357  98],786,5,16435,4.120080220606669,40.0,0.0
23989,2,3989,[403 496 132 183 357],796,5,16440,4.120300751879699,20.0,0.0
23990,2,3990,[318 496 588 357  98],786,5,16445,4.120521172638436,40.0,0.0
23991,2,3991,[318 496 588 357  98],18,5,16450,4.120741482965932,40.0,0.0
23992,2,3992,[318 496 588 357  98],330,5,16455,4.120961682945154,40.0,0.0
23993,2,3993,[318 496 588 357  98],796,5,16460,4.121181772658988,40.0,0.0
23994,2,3994,[180 423 216 186 546],504,4,16464,4.1211514392991235,0.0,0.0
23995,2,3995,[318 496 588 357  98],450,5,16469,4.121371371371372,40.0,0.0
23996,2,3996,[318 496 588 357  98],18,5,16474,4.121591193395046,40.0,0.0
23997,2,3997,[318 496 588 357  98],450,5,16479,4.121810905452726,40.0,0.0
23998,2,3998,[144 204  79 118 210],593,4,16483,4.121780445111278,0.0,0.0
23999,2,3999,[318 496 588 357  98],450,5,16488,4.122,40.0,0.0
24000,2,4000,[100 144 678 405  97],401,3,16491,4.121719570107473,0.0,20.0
24001,2,4001,[318 496 588 357  98],716,5,16496,4.121939030484757,40.0,0.0
24002,2,4002,[742 318 228 200 328],450,4,16500,4.12190856857357,20.0,0.0
24003,2,4003,[318 496 588 357  98],450,5,16505,4.122127872127872,40.0,0.0
24004,2,4004,[ 82 135 196 289  89],655,2,16507,4.121598002496879,0.0,0.0
24005,2,4005,[318 496 588 357  98],786,5,16512,4.121817274088866,40.0,0.0
24006,2,4006,[546 237 588 471 185],716,3,16515,4.121537309708011,0.0,0.0
24007,2,4007,[237 603 161 588 333],796,5,16520,4.121756487025948,20.0,0.0
24008,2,4008,[318 496 588 357  98],18,5,16525,4.121975555001248,40.0,0.0
24009,2,4009,[318 496 588 357  98],18,5,16530,4.12219451371571,40.0,0.0
24010,2,4010,[185 742 568 127 216],256,5,16535,4.122413363251059,0.0,20.0
24011,2,4011,[318 496 588 357  98],786,5,16540,4.122632103688933,40.0,0.0
24012,2,4012,[318 496 588 357  98],18,5,16545,4.122850735110889,40.0,0.0
24013,2,4013,[318 496 588 357  98],796,5,16550,4.123069257598406,40.0,0.0
24014,2,4014,[318 496 588 357  98],716,5,16555,4.123287671232877,40.0,0.0
24015,2,4015,[228 748 265 275  95],798,4,16559,4.1232569721115535,0.0,20.0
24016,2,4016,[ 70 235 588 568 258],457,4,16563,4.123226288274832,0.0,0.0
24017,2,4017,[385 405  79 168 132],796,5,16568,4.12344449975112,0.0,0.0
24018,2,4018,[ 79 179 423 132 265],236,3,16571,4.123164966409554,0.0,0.0
24019,2,4019,[318 496 588 357  98],796,5,16576,4.123383084577115,40.0,0.0
24020,2,4020,[318 496 588 357  98],18,5,16581,4.12360109425516,40.0,0.0
24021,2,4021,[318 496 588 357  98],330,5,16586,4.123818995524615,40.0,0.0
24022,2,4022,[194 405  12 168 181],577,4,16590,4.12378821774795,0.0,0.0
24023,2,4023,[318 496 588 357  98],786,5,16595,4.124005964214712,40.0,0.0
24024,2,4024,[318 496 588 357  98],786,5,16600,4.124223602484472,40.0,0.0
24025,2,4025,[318 496 588 357  98],18,5,16605,4.124441132637854,40.0,0.0
24026,2,4026,[182 176 153  69  56],269,2,16607,4.12391358331264,0.0,0.0
24027,2,4027,[318 496 588 357  98],796,5,16612,4.124131082423038,40.0,0.0
24028,2,4028,[176 125  56   4 234],280,1,16613,4.123355671382477,0.0,0.0
24029,2,4029,[318 496 588 357  98],450,5,16618,4.123573200992555,40.0,0.0
24030,2,4030,[318 496 588 357  98],450,5,16623,4.123790622674274,40.0,0.0
24031,2,4031,[118 276 268 508 318],655,2,16625,4.123263888888889,20.0,0.0
24032,2,4032,[318 496 588 357  98],786,5,16630,4.123481279444582,40.0,0.0
24033,2,4033,[318 496 588 357  98],716,5,16635,4.12369856222112,40.0,0.0
24034,2,4034,[318 496 588 357  98],786,5,16640,4.123915737298637,40.0,0.0
24035,2,4035,[302  96 187 111  25],450,4,16644,4.1238850346878095,0.0,0.0
24036,2,4036,[588  82 173 181 222],798,4,16648,4.1238543472875895,0.0,0.0
24037,2,4037,[ 11   4  70 276 427],655,2,16650,4.123328380386329,20.0,0.0
24038,2,4038,[318 496 588 357  98],716,5,16655,4.123545432037633,40.0,0.0
24039,2,4039,[ 28 172  70 118 211],151,4,16659,4.123514851485148,0.0,0.0
24040,2,4040,[318 496 588 357  98],450,5,16664,4.1237317495669386,40.0,0.0
24041,2,4041,[143  70  95 180 603],18,4,16668,4.12370113805047,20.0,0.0
24042,2,4042,[318 496 588 357  98],796,5,16673,4.123917882760327,40.0,0.0
24043,2,4043,[ 64 135 180 211 185],535,4,16677,4.123887240356083,20.0,0.0
24044,2,4044,[318 496 588 357  98],716,5,16682,4.124103831891223,40.0,0.0
24045,2,4045,[435 121  64 127 282],716,4,16686,4.124073158675235,20.0,20.0
24046,2,4046,[276 235 151  82 111],269,2,16688,4.123548307388189,0.0,0.0
24047,2,4047,[318 496 588 357  98],796,5,16693,4.123764822134388,40.0,0.0
24048,2,4048,[202 435  50 174 210],401,4,16697,4.123734255371697,0.0,20.0
24049,2,4049,[318 496 588 357  98],716,5,16702,4.123950617283951,40.0,0.0
24050,2,4050,[202 194 179   4 357],18,2,16704,4.123426314490249,0.0,0.0
24051,2,4051,[183 176 118 385 197],450,4,16708,4.123395853899309,0.0,0.0
24052,2,4052,[435 603 238 204 286],655,1,16709,4.122625215889465,20.0,20.0
24053,2,4053,[423  69 191 174  11],655,1,16710,4.121854958066107,0.0,0.0
24054,2,4054,[318 496 588 357  98],716,5,16715,4.122071516646116,40.0,0.0
24055,2,4055,[173  95  71 385 181],450,3,16718,4.121794871794871,0.0,0.0
24056,2,4056,[318 496 588 357  98],450,5,16723,4.122011338427409,40.0,0.0
24057,2,4057,[  4  98 202 216 211],786,5,16728,4.122227698373583,0.0,0.0
24058,2,4058,[318 496 588 357  98],18,5,16733,4.122443951712245,40.0,0.0
24059,2,4059,[318 496 588 357  98],330,5,16738,4.122660098522167,40.0,0.0
24060,2,4060,[318 496 588 357  98],330,5,16743,4.122876138882049,40.0,0.0
24061,2,4061,[385 132 333 195 200],796,5,16748,4.123092072870507,0.0,0.0
24062,2,4062,[318 496 588 357  98],450,5,16753,4.123307900566084,40.0,0.0
24063,2,4063,[318 496 588 357  98],18,5,16758,4.123523622047244,40.0,0.0
24064,2,4064,[275 183 748 172  22],796,5,16763,4.123739237392374,0.0,20.0
24065,2,4065,[318 496 588 357  98],716,5,16768,4.123954746679783,40.0,0.0
24066,2,4066,[318 496 588 357  98],18,5,16773,4.124170149987706,40.0,0.0
24067,2,4067,[111 496 655 405 172],269,2,16775,4.123647984267453,20.0,0.0
24068,2,4068,[318 496 588 357  98],18,5,16780,4.123863357090194,40.0,0.0
24069,2,4069,[318 496 588 357  98],18,5,16785,4.124078624078624,40.0,0.0
24070,2,4070,[318 496 588 357  98],796,5,16790,4.124293785310734,40.0,0.0
24071,2,4071,[318  70  28  69 289],786,5,16795,4.12450884086444,20.0,0.0
24072,2,4072,[318 496 588 357  98],796,5,16800,4.124723790817579,40.0,0.0
24073,2,4073,[161 568  11  69  96],280,4,16804,4.1246931762395675,0.0,0.0
24074,2,4074,[ 89 191 215 135  12],151,3,16807,4.12441717791411,0.0,0.0
24075,2,4075,[385 357 132 258   8],23,4,16811,4.124386653581943,0.0,0.0
24076,2,4076,[318 496 588  98 357],330,5,16816,4.124601422614668,40.0,0.0
24077,2,4077,[471 435 143  69 183],655,2,16818,4.12408043158411,0.0,0.0
24078,2,4078,[318 496 588  98 357],18,5,16823,4.124295170384898,40.0,0.0
24079,2,4079,[276 423  56  69 161],655,1,16824,4.123529411764705,0.0,0.0
24080,2,4080,[318 496 588  98 357],716,5,16829,4.123744180347954,40.0,0.0
24081,2,4081,[318 496 588  98 357],450,5,16834,4.123958843704067,40.0,0.0
24082,2,4082,[655 568 210  98   1],72,5,16839,4.12417340191036,0.0,0.0
24083,2,4083,[318 496 588  98 357],716,5,16844,4.124387855044074,40.0,0.0
24084,2,4084,[318 496 588  98 357],786,5,16849,4.124602203182374,40.0,0.0
24085,2,4085,[132   9 435 100  64],321,4,16853,4.124571708272149,20.0,20.0
24086,2,4086,[ 88 742  98  50 234],796,3,16856,4.124296550036702,0.0,20.0
24087,2,4087,[318 496 588  98 357],716,5,16861,4.124510763209393,40.0,0.0
24088,2,4088,[328 258 294 427 568],450,5,16866,4.12472487160675,20.0,0.0
24089,2,4089,[318 496 588  98 357],796,5,16871,4.124938875305624,40.0,0.0
24090,2,4090,[228 257 173 161 182],457,4,16875,4.124908335370325,0.0,0.0
24091,2,4091,[211  88  56 216 215],151,4,16879,4.124877810361681,0.0,0.0
24092,2,4092,[318 496 588  98 357],716,5,16884,4.1250916198387495,40.0,0.0
24093,2,4093,[  8 228 127  88 132],280,3,16887,4.124816805080606,0.0,20.0
24094,2,4094,[318 496 588  98 357],796,5,16892,4.1250305250305255,40.0,0.0
24095,2,4095,[216 288 191 294 143],655,3,16895,4.124755859375,0.0,0.0
24096,2,4096,[318 496 588  98 357],716,5,16900,4.124969489870637,40.0,0.0
24097,2,4097,[  4 172 265 181 161],450,4,16904,4.124938994631528,0.0,0.0
24098,2,4098,[182 204   4 300 200],450,3,16907,4.124664552329836,0.0,0.0
24099,2,4099,[318 496 588  98 357],18,5,16912,4.124878048780488,40.0,0.0
24100,2,4100,[318 496 588  98 357],786,5,16917,4.125091441111924,40.0,0.0
24101,2,4101,[318 496 588  98 357],796,5,16922,4.125304729400293,40.0,0.0
24102,2,4102,[748 176 153 427  50],450,5,16927,4.125517913721667,20.0,20.0
24103,2,4103,[742 234 118 183  22],457,5,16932,4.125730994152047,0.0,0.0
24104,2,4104,[318 496 588  98 357],796,5,16937,4.125943970767357,40.0,0.0
24105,2,4105,[318 496 588  98 357],18,5,16942,4.126156843643448,40.0,0.0
24106,2,4106,[ 12 174 127 191 118],457,5,16947,4.1263696128561,0.0,20.0
24107,2,4107,[748  50 211 202 168],796,4,16951,4.126338851022395,0.0,20.0
24108,2,4108,[318 496 588  98 357],796,5,16956,4.126551472377708,40.0,0.0
24109,2,4109,[216 196 275 245 286],796,3,16959,4.1262773722627735,0.0,40.0
24110,2,4110,[318 496 588  98 357],450,5,16964,4.126489905132571,40.0,0.0
24111,2,4111,[302 182 435 286 100],655,2,16966,4.125972762645914,0.0,40.0
24112,2,4112,[603 117 271 427   9],796,4,16970,4.12594213469487,40.0,0.0
24113,2,4113,[318 496 588  98 357],450,5,16975,4.126154594069033,40.0,0.0
24114,2,4114,[318 496 588  98 357],786,5,16980,4.12636695018226,40.0,0.0
24115,2,4115,[318 496 588  98 357],796,5,16985,4.126579203109816,40.0,0.0
24116,2,4116,[318 496 588  98 357],330,5,16990,4.1267913529268885,40.0,0.0
24117,2,4117,[318 496 588  98 357],796,5,16995,4.127003399708596,40.0,0.0
24118,2,4118,[318 496 588  98 357],716,5,17000,4.127215343529983,40.0,0.0
24119,2,4119,[237   4 655 202  56],577,4,17004,4.1271844660194175,0.0,0.0
24120,2,4120,[318 496 588  98 357],18,5,17009,4.127396263042951,40.0,0.0
24121,2,4121,[313 269 403 125 121],796,4,17013,4.127365356622999,0.0,0.0
24122,2,4122,[200  89   8 603  22],269,2,17015,4.126849381518312,20.0,0.0
24123,2,4123,[318 496 588  98 357],716,5,17020,4.127061105722599,40.0,0.0
24124,2,4124,[318 496 588  98 357],18,5,17025,4.127272727272727,40.0,0.0
24125,2,4125,[318 496 588  98 357],18,5,17030,4.127484246243335,40.0,0.0
24126,2,4126,[603  96 174 275 196],23,4,17034,4.127453355948631,20.0,20.0
24127,2,4127,[318 496 588  98 357],716,5,17039,4.127664728682171,40.0,0.0
24128,2,4128,[ 56  82 100 471 215],655,0,17039,4.126665052070719,0.0,20.0
24129,2,4129,[318 496 588  98 357],786,5,17044,4.126876513317192,40.0,0.0
24130,2,4130,[245 748 271 568 180],796,3,17047,4.126603727910918,0.0,0.0
24131,2,4131,[318 496 588  98 357],786,5,17052,4.126815101645692,40.0,0.0
24132,2,4132,[182 655 313  15   1],593,2,17054,4.126300508105492,0.0,0.0
24133,2,4133,[405 268   8 187 435],269,2,17056,4.1257861635220126,0.0,0.0
24134,2,4134,[ 71 121 202 161  82],504,4,17060,4.125755743651753,0.0,0.0
24135,2,4135,[318 496 588  98 357],716,5,17065,4.125967117988394,40.0,0.0
24136,2,4136,[496 172 748 135 151],450,4,17069,4.1259366690838775,20.0,0.0
24137,2,4137,[143 100 228 294 195],23,3,17072,4.125664572257129,0.0,20.0
24138,2,4138,[318 496 588  98 357],330,5,17077,4.125875815414351,40.0,0.0
24139,2,4139,[318 496 588  98 357],330,5,17082,4.126086956521739,40.0,0.0
24140,2,4140,[  4 496 204 423  89],786,5,17087,4.126297995653224,20.0,0.0
24141,2,4141,[318 496 588  98 357],450,5,17092,4.126508932882666,40.0,0.0
24142,2,4142,[318 496 588  98 357],786,5,17097,4.126719768283852,40.0,0.0
24143,2,4143,[318 496 588  98 357],796,5,17102,4.126930501930502,40.0,0.0
24144,2,4144,[  7 216   4 191 268],655,2,17104,4.126417370325694,0.0,0.0
24145,2,4145,[191   8 176  15 275],796,5,17109,4.126628075253256,0.0,20.0
24146,2,4146,[185 313 127 200 427],655,5,17114,4.126838678562817,20.0,20.0
24147,2,4147,[318 496 588  98 357],450,5,17119,4.127049180327869,40.0,0.0
24148,2,4148,[318 496 588  98 357],796,5,17124,4.127259580621836,40.0,0.0
24149,2,4149,[318 496 588  98 357],18,5,17129,4.127469879518072,40.0,0.0
24150,2,4150,[318 496 588  98 357],716,5,17134,4.127680077089858,40.0,0.0
24151,2,4151,[ 98  88  25 742 125],344,2,17136,4.127167630057803,0.0,0.0
24152,2,4152,[318 496 588  98 357],330,5,17141,4.127377799181315,40.0,0.0
24153,2,4153,[  7  88  98 153   9],269,2,17143,4.126865671641791,0.0,0.0
24154,2,4154,[597 127 588  98 195],457,4,17147,4.126835138387485,0.0,20.0
24155,2,4155,[ 56 603 275 186  97],796,3,17150,4.126564003849856,20.0,20.0
24156,2,4156,[ 56 435 286 294 175],655,0,17150,4.125571325475102,0.0,20.0
24157,2,4157,[181 182 216 200  97],796,4,17154,4.125541125541125,0.0,0.0
24158,2,4158,[385 357 211 132 161],786,5,17159,4.12575138254388,0.0,0.0
24159,2,4159,[318 496 588  98 357],330,5,17164,4.125961538461539,40.0,0.0
24160,2,4160,[423  70 161 195 180],450,5,17169,4.126171593366979,0.0,0.0
24161,2,4161,[318 496 588  98 357],450,5,17174,4.126381547333013,40.0,0.0
24162,2,4162,[318 496 588  98 357],450,5,17179,4.126591400432381,40.0,0.0
24163,2,4163,[286 185 197 405  79],450,5,17184,4.126801152737752,0.0,20.0
24164,2,4164,[125 118   4 187 471],655,1,17185,4.126050420168068,0.0,0.0
24165,2,4165,[318 496 588  98 357],450,5,17190,4.126260201632261,40.0,0.0
24166,2,4166,[748  89 182 183 318],796,5,17195,4.126469882409407,20.0,0.0
24167,2,4167,[318 496 588  98 357],786,5,17200,4.126679462571977,40.0,0.0
24168,2,4168,[318 496 588  98 357],716,5,17205,4.126888942192372,40.0,0.0
24169,2,4169,[742 172  89  12  96],796,4,17209,4.126858513189449,0.0,0.0
24170,2,4170,[318 496 588  98 357],716,5,17214,4.127067849436586,40.0,0.0
24171,2,4171,[121 357 144 748 125],401,2,17216,4.126558005752637,0.0,0.0
24172,2,4172,[182 202 196 475 238],389,4,17220,4.126527677929547,0.0,0.0
24173,2,4173,[302 179  64 135 121],655,4,17224,4.126497364638237,20.0,0.0
24174,2,4174,[318 496 588  98 357],796,5,17229,4.126706586826347,40.0,0.0
24175,2,4175,[ 95 185 197  50 216],716,5,17234,4.126915708812261,0.0,20.0
24176,2,4176,[318 496 588  98 357],796,5,17239,4.127124730667943,40.0,0.0
24177,2,4177,[318 496 588  98 357],330,5,17244,4.127333652465294,40.0,0.0
24178,2,4178,[427  97 333 111  88],796,4,17248,4.127303182579564,20.0,0.0
24179,2,4179,[ 56 423 176 603   4],655,1,17249,4.126555023923445,20.0,0.0
24180,2,4180,[318 496 588  98 357],330,5,17254,4.126763932073667,40.0,0.0
24181,2,4181,[318 496 588  98 357],450,5,17259,4.126972740315638,40.0,0.0
24182,2,4182,[300 161 234 265 194],796,4,17263,4.126942385847478,0.0,0.0
24183,2,4183,[215 546  15 282 196],796,5,17268,4.127151051625239,0.0,0.0
24184,2,4184,[127  82 234 202 322],504,3,17271,4.126881720430108,0.0,20.0
24185,2,4185,[318 496 588  98 357],786,5,17276,4.127090301003345,40.0,0.0
24186,2,4186,[118  82  56  97 186],450,2,17278,4.1265822784810124,0.0,0.0
24187,2,4187,[ 70 176 175 222 435],716,3,17281,4.126313276026743,0.0,0.0
24188,2,4188,[196 117 588 204 127],450,5,17286,4.126521842921939,0.0,20.0
24189,2,4189,[237 357 496 100  97],796,3,17289,4.126252983293556,20.0,20.0
24190,2,4190,[174 276 144  98  50],629,5,17294,4.126461465044142,0.0,20.0
24191,2,4191,[318 496 588  98 357],716,5,17299,4.126669847328245,40.0,0.0
24192,2,4192,[318 496 588  98 357],716,5,17304,4.126878130217029,40.0,0.0
24193,2,4193,[318 496 588  98 357],330,5,17309,4.127086313781593,40.0,0.0
24194,2,4194,[403 655 111 135 276],655,2,17311,4.12657926102503,0.0,0.0
24195,2,4195,[176 215 322 181 655],796,3,17314,4.126310772163966,0.0,0.0
24196,2,4196,[318 496 588  98 357],450,5,17319,4.126518942101501,40.0,0.0
24197,2,4197,[318 496 588  98 357],330,5,17324,4.1267270128632685,40.0,0.0
24198,2,4198,[318 496 588  98 357],18,5,17329,4.1269349845201235,40.0,0.0
24199,2,4199,[  8 216 153 234 144],796,4,17333,4.126904761904762,0.0,0.0
24200,2,4200,[300 196 181 197 179],504,3,17336,4.1266365151154485,0.0,0.0
24201,2,4201,[427 117 200 234  64],796,4,17340,4.126606377915278,40.0,0.0
24202,2,4202,[ 50 237 405 125 282],655,1,17341,4.125862479181537,0.0,20.0
24203,2,4203,[294 546 185 111 187],796,4,17345,4.1258325404376786,0.0,0.0
24204,2,4204,[318 496 588  98 357],330,5,17350,4.126040428061831,40.0,0.0
24205,2,4205,[318 496 588  98 357],716,5,17355,4.126248216833096,40.0,0.0
24206,2,4206,[568 323 168 211 172],796,3,17358,4.125980508676016,0.0,0.0
24207,2,4207,[  1 143   7 265 204],450,5,17363,4.126188212927756,0.0,0.0
24208,2,4208,[318 496 588  98 357],796,5,17368,4.126395818484201,40.0,0.0
24209,2,4209,[318 496 588  98 357],18,5,17373,4.126603325415677,40.0,0.0
24210,2,4210,[ 70 161 187 127 471],716,2,17375,4.126098313939682,0.0,20.0
24211,2,4211,[588 135  64 197  56],389,4,17379,4.1260683760683765,20.0,0.0
24212,2,4212,[597 471 173 153 357],593,3,17382,4.125801091858533,0.0,0.0
24213,2,4213,[ 56 194 427 204 269],18,3,17385,4.125533934504034,20.0,0.0
24214,2,4214,[318 496 588  98 357],450,5,17390,4.125741399762752,40.0,0.0
24215,2,4215,[191  98 435 588 175],18,5,17395,4.125948766603416,0.0,0.0
24216,2,4216,[161 282 183 100 568],796,4,17399,4.125918899691724,0.0,20.0
24217,2,4217,[183 191 496  28  88],151,3,17402,4.125651967757231,20.0,0.0
24218,2,4218,[300  88  64 172 121],796,5,17407,4.1258592083432095,20.0,0.0
24219,2,4219,[211 196 174  71 282],504,5,17412,4.1260663507109,0.0,0.0
24220,2,4220,[301 100 403  56 405],796,3,17415,4.1257995735607675,0.0,20.0
24221,2,4221,[318 496 588  98 357],716,5,17420,4.126006631927996,40.0,0.0
24222,2,4222,[168 194 125 143 195],457,5,17425,4.12621359223301,0.0,0.0
24223,2,4223,[318 496 588  98 357],450,5,17430,4.126420454545454,40.0,0.0
24224,2,4224,[318 496 588  98 357],330,5,17435,4.126627218934911,40.0,0.0
24225,2,4225,[  7 168 222 194 202],450,4,17439,4.126597255087553,0.0,0.0
24226,2,4226,[151  56 127 191 423],269,5,17444,4.126803879820203,0.0,20.0
24227,2,4227,[318 496 588  98 357],796,5,17449,4.127010406811731,40.0,0.0
24228,2,4228,[318 496 588  98 357],18,5,17454,4.127216836131473,40.0,0.0
24229,2,4229,[ 11 265 197 483 210],457,5,17459,4.1274231678487,0.0,0.0
24230,2,4230,[ 25 111  98 546 179],450,4,17463,4.127393051288111,0.0,0.0
24231,2,4231,[318 496 588  98 357],450,5,17468,4.1275992438563325,40.0,0.0
24232,2,4232,[183 403 118 234  69],457,5,17473,4.127805339003071,0.0,0.0
24233,2,4233,[318 496 588  98 357],450,5,17478,4.128011336797354,40.0,0.0
24234,2,4234,[153 471  56 508 403],655,0,17478,4.127036599763873,0.0,0.0
24235,2,4235,[318 496 588  98 357],330,5,17483,4.12724268177526,40.0,0.0
24236,2,4236,[318 496 588  98 357],716,5,17488,4.127448666509323,40.0,0.0
24237,2,4237,[151  97 423 276  71],504,4,17492,4.127418593676262,0.0,0.0
24238,2,4238,[ 11   7 216 195 328],655,1,17493,4.126680820948337,0.0,0.0
24239,2,4239,[405  12 195 151  64],457,5,17498,4.12688679245283,20.0,0.0
24240,2,4240,[357  56 275   9   4],151,5,17503,4.127092666823862,0.0,20.0
24241,2,4241,[318 496 588  98 357],796,5,17508,4.127298444130127,40.0,0.0
24242,2,4242,[185 588 151 210  82],18,2,17510,4.126797077539477,0.0,0.0
24243,2,4243,[318 496 588  98 357],786,5,17515,4.127002827521206,40.0,0.0
24244,2,4244,[265 100 245 546  89],256,5,17520,4.127208480565371,0.0,20.0
24245,2,4245,[215 238 289 132 603],539,4,17524,4.127178520960904,20.0,0.0
24246,2,4246,[153 508 318 302 237],269,2,17526,4.126677654815164,20.0,0.0
24247,2,4247,[100 210 185 300 187],504,4,17530,4.126647834274953,0.0,20.0
24248,2,4248,[318 496 588  98 357],716,5,17535,4.126853377265239,40.0,0.0
24249,2,4249,[318 496 588  98 357],796,5,17540,4.127058823529412,40.0,0.0
24250,2,4250,[318 496 588  98 357],796,5,17545,4.127264173135733,40.0,0.0
24251,2,4251,[318 496 588  98 357],796,5,17550,4.127469426152399,40.0,0.0
24252,2,4252,[125  82 237 288 234],457,5,17555,4.1276745826475425,0.0,0.0
24253,2,4253,[483 118 597 196 180],796,4,17559,4.127644569816643,0.0,0.0
24254,2,4254,[318 496 588  98 357],18,5,17564,4.127849588719154,40.0,0.0
24255,2,4255,[318 496 588  98 357],330,5,17569,4.1280545112781954,40.0,0.0
24256,2,4256,[302 475 742  64 403],655,2,17571,4.127554615926709,20.0,0.0
24257,2,4257,[405 655 168   9 282],457,5,17576,4.12775951150775,0.0,0.0
24258,2,4258,[318 496 588  98 357],450,5,17581,4.127964310871096,40.0,0.0
24259,2,4259,[228 183 237 204 357],716,4,17585,4.127934272300469,0.0,0.0
24260,2,4260,[ 25 238 655   1  50],593,2,17587,4.127434874442619,0.0,20.0
24261,2,4261,[318 496 588  98 357],786,5,17592,4.127639605818865,40.0,0.0
24262,2,4262,[318 496 588  98 357],716,5,17597,4.127844241144734,40.0,0.0
24263,2,4263,[211 742  56 588 423],796,3,17600,4.127579737335835,0.0,0.0
24264,2,4264,[204 568   7  50  88],885,3,17603,4.127315357561548,0.0,20.0
24265,2,4265,[135  69 508   9 302],655,2,17605,4.126816690107829,0.0,0.0
24266,2,4266,[202 515 175 276  64],878,3,17608,4.126552613077103,20.0,0.0
24267,2,4267,[318 496 588  98 357],796,5,17613,4.126757263355201,40.0,0.0
24268,2,4268,[655 257 300 427 228],655,1,17614,4.1260248301710005,20.0,0.0
24269,2,4269,[403 385   4 173 655],457,5,17619,4.1262295081967215,0.0,0.0
24270,2,4270,[655 301  15 238 194],629,4,17623,4.126199953172559,0.0,0.0
24271,2,4271,[318 496 588  98 357],18,5,17628,4.126404494382022,40.0,0.0
24272,2,4272,[318 496 588  98 357],330,5,17633,4.126608939854903,40.0,0.0
24273,2,4273,[  4  64  15  69 195],18,2,17635,4.126111371080954,20.0,0.0
24274,2,4274,[515 186  22 269 286],18,5,17640,4.126315789473685,0.0,20.0
24275,2,4275,[318 496 588  98 357],18,5,17645,4.126520112254443,40.0,0.0
24276,2,4276,[318 496 588  98 357],18,5,17650,4.126724339490297,40.0,0.0
24277,2,4277,[172 385 118 496  25],344,3,17653,4.126460963066854,20.0,0.0
24278,2,4278,[204 100 302 180 187],450,5,17658,4.12666510867025,0.0,20.0
24279,2,4279,[568 204   9 237  50],269,1,17659,4.125934579439252,0.0,20.0
24280,2,4280,[197 144 151 235 183],292,4,17663,4.125905162345246,0.0,0.0
24281,2,4281,[318 496 588  98 357],786,5,17668,4.1261092947220925,40.0,0.0
24282,2,4282,[318 496 588  98 357],786,5,17673,4.126313331776792,40.0,0.0
24283,2,4283,[318 496 588  98 357],450,5,17678,4.1265172735760975,40.0,0.0
24284,2,4284,[276  50 265 405   4],655,2,17680,4.1260210035005835,0.0,20.0
24285,2,4285,[237 748 168 588 269],450,5,17685,4.126224918338777,0.0,0.0
24286,2,4286,[318 496 588  98 357],450,5,17690,4.126428738045253,40.0,0.0
24287,2,4287,[318 496 588  98 357],716,5,17695,4.126632462686567,40.0,0.0
24288,2,4288,[144 118 228 546 748],807,5,17700,4.1268360923292144,0.0,0.0
24289,2,4289,[118 333 197 357 405],796,4,17704,4.126806526806527,0.0,0.0
24290,2,4290,[301 182  97  25 742],593,3,17707,4.126543929154043,0.0,0.0
24291,2,4291,[318 496 588  98 357],796,5,17712,4.1267474370922645,40.0,0.0
24292,2,4292,[508   8 357 176 228],655,1,17713,4.1260191008618685,0.0,0.0
24293,2,4293,[181 294 655 151 196],796,3,17716,4.125756870051235,0.0,0.0
24294,2,4294,[427 204 385 125 211],796,4,17720,4.125727590221188,20.0,0.0
24295,2,4295,[ 95  22 318 403  56],577,4,17724,4.125698324022347,20.0,0.0
24296,2,4296,[318 496 588  98 357],18,5,17729,4.125901791947871,40.0,0.0
24297,2,4297,[318 496 588  98 357],450,5,17734,4.126105165193113,40.0,0.0
24298,2,4298,[245 318 258  50 151],796,4,17738,4.126075831588741,20.0,20.0
24299,2,4299,[318 496 588  98 357],796,5,17743,4.126279069767442,40.0,0.0
24300,2,4300,[318 496 588  98 357],796,5,17748,4.126482213438735,40.0,0.0
24301,2,4301,[132  25 151  28 286],389,3,17751,4.126220362622036,0.0,20.0
24302,2,4302,[ 56 172 187 144 204],716,3,17754,4.1259586335115035,0.0,0.0
24303,2,4303,[222 196 132 176 135],693,2,17756,4.12546468401487,0.0,0.0
24304,2,4304,[385 197 100  11 328],401,3,17759,4.12520325203252,0.0,20.0
24305,2,4305,[245 197 182  71 117],450,4,17763,4.125174175568974,0.0,0.0
24306,2,4306,[182 172  89  50 222],256,4,17767,4.125145112607384,0.0,20.0
24307,2,4307,[318 496 588  98 357],716,5,17772,4.125348189415042,40.0,0.0
24308,2,4308,[ 95 323  89  70 597],23,2,17774,4.124854954745881,0.0,0.0
24309,2,4309,[318 496 588  98 357],796,5,17779,4.125058004640371,40.0,0.0
24310,2,4310,[168  28 302 216 195],151,3,17782,4.124797030851311,0.0,0.0
24311,2,4311,[318 496 588  98 357],450,5,17787,4.125,40.0,0.0
24312,2,4312,[603 215 118 300  95],796,5,17792,4.125202875028982,20.0,0.0
24313,2,4313,[318 496 588  98 357],786,5,17797,4.125405656003709,40.0,0.0
24314,2,4314,[153  64 483 135 195],269,3,17800,4.125144843568946,20.0,0.0
24315,2,4315,[318 496 588  98 357],18,5,17805,4.125347544022243,40.0,0.0
24316,2,4316,[318 496 588  98 357],786,5,17810,4.125550150567523,40.0,0.0
24317,2,4317,[318 496 588  98 357],716,5,17815,4.125752663270032,40.0,0.0
24318,2,4318,[318 496 588  98 357],450,5,17820,4.125955082194952,40.0,0.0
24319,2,4319,[161 200 228 173 117],716,4,17824,4.125925925925926,0.0,0.0
24320,2,4320,[135 204 100 117 471],457,5,17829,4.126128211062254,0.0,20.0
24321,2,4321,[318 496 588  98 357],18,5,17834,4.1263304025913925,40.0,0.0
24322,2,4322,[318 496 588  98 357],450,5,17839,4.1265325005783025,40.0,0.0
24323,2,4323,[318 496 588  98 357],18,5,17844,4.126734505087882,40.0,0.0
24324,2,4324,[318 496 588  98 357],796,5,17849,4.1269364161849715,40.0,0.0
24325,2,4325,[211 215   1 132 179],450,5,17854,4.1271382339343505,0.0,0.0
24326,2,4326,[403 187  97  70  22],18,4,17858,4.127108851398197,0.0,0.0
24327,2,4327,[318 496 588  98 357],450,5,17863,4.127310536044362,40.0,0.0
24328,2,4328,[172 235 191   1 195],450,4,17867,4.127281127281127,0.0,0.0
24329,2,4329,[318 496 588  98 357],450,5,17872,4.127482678983834,40.0,0.0
24330,2,4330,[318 496 588  98 357],18,5,17877,4.127684137612561,40.0,0.0
24331,2,4331,[187 301 194 118 300],796,4,17881,4.127654662973223,0.0,0.0
24332,2,4332,[302 186 153 508 222],655,1,17882,4.126932840987768,0.0,0.0
24333,2,4333,[318 496 588  98 357],716,5,17887,4.1271342870327645,40.0,0.0
24334,2,4334,[144 194 173 183 603],796,5,17892,4.1273356401384085,20.0,0.0
24335,2,4335,[275  25 222 111   1],151,5,17897,4.1275369003690034,0.0,20.0
24336,2,4336,[435  97 196 100 318],535,5,17902,4.127738067788794,20.0,20.0
24337,2,4337,[234 197 237 269 153],18,3,17905,4.127478100507147,0.0,0.0
24338,2,4338,[ 50 197 655 210 100],629,5,17910,4.127679188753169,0.0,40.0
24339,2,4339,[238 135 302 197 132],535,3,17913,4.127419354838709,0.0,0.0
24340,2,4340,[318 496 588  98 357],450,5,17918,4.1276203639714355,40.0,0.0
24341,2,4341,[318 496 588  98 357],796,5,17923,4.127821280515891,40.0,0.0
24342,2,4342,[475 182 202 427 655],269,4,17927,4.127791848952337,20.0,0.0
24343,2,4343,[318 496 588  98 357],450,5,17932,4.127992633517495,40.0,0.0
24344,2,4344,[276 245  98 228  82],280,2,17934,4.127502876869966,0.0,0.0
24345,2,4345,[210 568 183 265 483],457,5,17939,4.127703635526921,0.0,0.0
24346,2,4346,[318 496 588  98 357],716,5,17944,4.127904301817345,40.0,0.0
24347,2,4347,[204 215 258 118 282],457,5,17949,4.128104875804968,0.0,0.0
24348,2,4348,[318 496 588  98 357],716,5,17954,4.128305357553461,40.0,0.0
24349,2,4349,[194 234 568 196  95],716,5,17959,4.128505747126437,0.0,0.0
24350,2,4350,[318 496 588  98 357],330,5,17964,4.128706044587451,40.0,0.0
24351,2,4351,[318 496 588  98 357],330,5,17969,4.12890625,40.0,0.0
24352,2,4352,[  4 197 234 357 144],457,5,17974,4.129106363427521,0.0,0.0
24353,2,4353,[318 496 588  98 357],18,5,17979,4.129306384933394,40.0,0.0
24354,2,4354,[ 64  50 237 161 168],330,4,17983,4.129276693455798,20.0,20.0
24355,2,4355,[ 71 237 135 742  89],450,3,17986,4.129017447199265,0.0,0.0
24356,2,4356,[318 496 588  98 357],716,5,17991,4.12921735138857,40.0,0.0
24357,2,4357,[282  88 385  95 202],280,2,17993,4.1287287746672785,0.0,0.0
24358,2,4358,[318 496 588  98 357],330,5,17998,4.1289286533608625,40.0,0.0
24359,2,4359,[318 496 588  98 357],450,5,18003,4.129128440366973,40.0,0.0
24360,2,4360,[318 496 588  98 357],450,5,18008,4.129328135748682,40.0,0.0
24361,2,4361,[181 323 257 194 117],504,3,18011,4.129069234296194,0.0,0.0
24362,2,4362,[245 173 216  56 222],796,4,18015,4.1290396516158605,0.0,0.0
24363,2,4363,[318 496 588  98 357],450,5,18020,4.129239230064162,40.0,0.0
24364,2,4364,[318 496 588  98 357],786,5,18025,4.1294387170675835,40.0,0.0
24365,2,4365,[318 496 588  98 357],330,5,18030,4.12963811268896,40.0,0.0
24366,2,4366,[153 185  69 357 302],655,3,18033,4.129379436684222,0.0,0.0
24367,2,4367,[318 496 588  98 357],716,5,18038,4.129578754578755,40.0,0.0
24368,2,4368,[318 496 588  98 357],18,5,18043,4.1297779812314035,40.0,0.0
24369,2,4369,[135  11 117 196  12],655,1,18044,4.129061784897025,0.0,0.0
24370,2,4370,[181 118  71 282 234],504,2,18046,4.128574696865706,0.0,0.0
24371,2,4371,[318 496 588  98 357],450,5,18051,4.1287740164684354,40.0,0.0
24372,2,4372,[181   4 216 172 194],352,3,18054,4.128515892979648,0.0,0.0
24373,2,4373,[200  50 111 196 597],593,4,18058,4.128486511202561,0.0,20.0
24374,2,4374,[ 28   9  56 176   8],655,0,18058,4.127542857142857,0.0,0.0
24375,2,4375,[318 496 588  98 357],796,5,18063,4.127742230347349,40.0,0.0
24376,2,4376,[405 195 175 153 202],269,1,18064,4.127027644505369,0.0,0.0
24377,2,4377,[237 588 405 151 168],796,5,18069,4.1272270443124714,0.0,0.0
24378,2,4378,[175 318 237 172  98],18,3,18072,4.126969627768897,20.0,0.0
24379,2,4379,[176 172 118 258 257],796,5,18077,4.12716894977169,0.0,0.0
24380,2,4380,[286  50  22   4 144],450,4,18081,4.127139922392148,0.0,40.0
24381,2,4381,[318 496 588  98 357],330,5,18086,4.127339114559562,40.0,0.0
24382,2,4382,[210 603 168  12 237],18,2,18088,4.12685375313712,20.0,0.0
24383,2,4383,[222 196  12 496 121],151,5,18093,4.127052919708029,20.0,0.0
24384,2,4384,[318 496 588  98 357],786,5,18098,4.127251995438996,40.0,0.0
24385,2,4385,[300 282 333   9  98],655,1,18099,4.1265389876880985,0.0,0.0
24386,2,4386,[568 187 216  88 333],693,2,18101,4.1260542511967175,0.0,0.0
24387,2,4387,[318 496 588  98 357],716,5,18106,4.126253418413856,40.0,0.0
24388,2,4388,[318 496 588  98 357],450,5,18111,4.126452494873548,40.0,0.0
24389,2,4389,[318 496 588  98 357],716,5,18116,4.126651480637813,40.0,0.0
24390,2,4390,[318 496 588  98 357],796,5,18121,4.126850375768617,40.0,0.0
24391,2,4391,[195 172  71 228 483],450,3,18124,4.126593806921676,0.0,0.0
24392,2,4392,[135 182 435 276   8],535,2,18126,4.126109720009105,0.0,0.0
24393,2,4393,[748  22 174 496 328],796,5,18131,4.126308602639964,20.0,0.0
24394,2,4394,[ 97 405  89 172 228],457,5,18136,4.12650739476678,0.0,0.0
24395,2,4395,[100 215 196 313 269],639,0,18136,4.125568698817107,0.0,20.0
24396,2,4396,[111 568 385 127  70],457,4,18140,4.125540141005231,0.0,20.0
24397,2,4397,[151 301 318 168 181],535,5,18145,4.125738972260118,20.0,0.0
24398,2,4398,[187  82  96 237 153],655,1,18146,4.1250284155489885,0.0,0.0
24399,2,4399,[322 172 357 288  11],629,3,18149,4.1247727272727275,0.0,0.0
24400,2,4400,[ 70 427 318 268  89],269,3,18152,4.1245171551920015,40.0,0.0
24401,2,4401,[318 496 588  98 357],450,5,18157,4.124716038164471,40.0,0.0
24402,2,4402,[151 168 313 597 182],796,5,18162,4.1249148307971835,0.0,0.0
24403,2,4403,[318 496 588  98 357],796,5,18167,4.12511353315168,40.0,0.0
24404,2,4404,[742 257 187 182 300],655,2,18169,4.124631101021566,0.0,0.0
24405,2,4405,[196  11  71 276   8],593,3,18172,4.12437585111212,0.0,0.0
24406,2,4406,[  1 403 118  97 161],256,5,18177,4.124574540503744,0.0,0.0
24407,2,4407,[127 405 273 435 168],401,1,18178,4.123865698729583,0.0,20.0
24408,2,4408,[318 496 588  98 357],330,5,18183,4.1240644136992515,40.0,0.0
24409,2,4409,[318 496 588  98 357],796,5,18188,4.124263038548753,40.0,0.0
24410,2,4410,[318 496 588  98 357],18,5,18193,4.124461573339379,40.0,0.0
24411,2,4411,[318 496 588  98 357],796,5,18198,4.124660018132366,40.0,0.0
24412,2,4412,[318 496 588  98 357],786,5,18203,4.124858372988896,40.0,0.0
24413,2,4413,[234 475 194 191 269],629,3,18206,4.124603534209334,0.0,0.0
24414,2,4414,[403 357 168  69 153],330,4,18210,4.124575311438279,0.0,0.0
24415,2,4415,[ 50 286 275 187  71],450,4,18214,4.124547101449275,0.0,60.0
24416,2,4416,[318 496 588  98 357],330,5,18219,4.12474530224134,40.0,0.0
24417,2,4417,[655 300  82 471 475],655,0,18219,4.1238116794929836,0.0,0.0
24418,2,4418,[318 496 588  98 357],18,5,18224,4.124009957003847,40.0,0.0
24419,2,4419,[  4 195 168 323 153],796,4,18228,4.123981900452488,0.0,0.0
24420,2,4420,[  8  15 423 235 127],457,4,18232,4.1239538565935305,0.0,20.0
24421,2,4421,[318 496 588  98 357],796,5,18237,4.12415196743555,40.0,0.0
24422,2,4422,[318 496 588  98 357],716,5,18242,4.124349988695456,40.0,0.0
24423,2,4423,[194  50 427  82  69],18,2,18244,4.123869801084991,20.0,20.0
24424,2,4424,[318 496 588  98 357],786,5,18249,4.124067796610169,40.0,0.0
24425,2,4425,[318 496 588  98 357],796,5,18254,4.124265702666064,40.0,0.0
24426,2,4426,[328 185 121 172 276],655,3,18257,4.124011746103456,0.0,0.0
24427,2,4427,[300 588 187 216 204],796,5,18262,4.124209575429088,0.0,0.0
24428,2,4428,[318 496 588  98 357],796,5,18267,4.124407315421088,40.0,0.0
24429,2,4429,[423 258 202  22 144],796,5,18272,4.124604966139954,0.0,0.0
24430,2,4430,[318 496 588  98 357],450,5,18277,4.124802527646129,40.0,0.0
24431,2,4431,[318 496 588  98 357],716,5,18282,4.125,40.0,0.0
24432,2,4432,[282 215 132 357 194],535,3,18285,4.124746221520415,0.0,0.0
24433,2,4433,[318 496 588  98 357],450,5,18290,4.124943617501128,40.0,0.0
24434,2,4434,[318 496 588  98 357],330,5,18295,4.125140924464487,40.0,0.0
24435,2,4435,[175  70 197 168 181],878,2,18297,4.124661857529306,0.0,0.0
24436,2,4436,[655 100 194 276  22],878,1,18298,4.123957629028623,0.0,20.0
24437,2,4437,[318 496 588  98 357],786,5,18303,4.1241550247859395,40.0,0.0
24438,2,4438,[318 496 588  98 357],450,5,18308,4.124352331606218,40.0,0.0
24439,2,4439,[318 496 588  98 357],796,5,18313,4.12454954954955,40.0,0.0
24440,2,4440,[313 194 748  64 237],796,5,18318,4.124746678675974,20.0,0.0
24441,2,4441,[318 496 588  98 357],330,5,18323,4.124943719045475,40.0,0.0
24442,2,4442,[318 496 588  98 357],796,5,18328,4.125140670717983,40.0,0.0
24443,2,4443,[ 70  11 655 172 168],457,5,18333,4.125337533753376,0.0,0.0
24444,2,4444,[427 271 197 202 313],796,4,18337,4.1253093363329585,20.0,0.0
24445,2,4445,[268 172  82 655 427],269,3,18340,4.125056230319388,20.0,0.0
24446,2,4446,[318 496 588  98 357],450,5,18345,4.125252979536766,40.0,0.0
24447,2,4447,[ 22 588 186 197  25],450,3,18348,4.125,0.0,0.0
24448,2,4448,[ 56 117  15  89 210],655,1,18349,4.124297594965161,0.0,0.0
24449,2,4449,[173 144 265   4  70],457,5,18354,4.124494382022472,0.0,0.0
24450,2,4450,[245 301 196 215 423],450,5,18359,4.124691080656032,0.0,0.0
24451,2,4451,[318 496 588  98 357],330,5,18364,4.124887690925426,40.0,0.0
24452,2,4452,[ 88 508  89   4 471],655,1,18365,4.124185942061532,0.0,0.0
24453,2,4453,[144 423 161  71 496],280,4,18369,4.124158060170633,20.0,0.0
24454,2,4454,[135 173  70 302 275],151,4,18373,4.1241301907968575,0.0,20.0
24455,2,4455,[318 496 588  98 357],716,5,18378,4.124326750448833,40.0,0.0
24456,2,4456,[357 121 282   7 100],296,5,18383,4.124523221898138,0.0,20.0
24457,2,4457,[318 496 588  98 357],330,5,18388,4.1247196052041275,40.0,0.0
24458,2,4458,[195  96 168 132  82],716,3,18391,4.124467369365329,0.0,0.0
24459,2,4459,[ 95  98 175 286 269],344,4,18395,4.124439461883408,0.0,20.0
24460,2,4460,[318 496 588  98 357],450,5,18400,4.124635731898677,40.0,0.0
24461,2,4461,[318 496 588  98 357],796,5,18405,4.124831913939937,40.0,0.0
24462,2,4462,[318 496 588  98 357],786,5,18410,4.125028008066323,40.0,0.0
24463,2,4463,[143 191 423   1 357],655,3,18413,4.124775985663082,0.0,0.0
24464,2,4464,[318 496 588  98 357],330,5,18418,4.124972004479283,40.0,0.0
24465,2,4465,[318 496 588  98 357],18,5,18423,4.1251679355127635,40.0,0.0
24466,2,4466,[318 496 588  98 357],18,5,18428,4.125363778822476,40.0,0.0
24467,2,4467,[318 496 588  98 357],786,5,18433,4.125559534467323,40.0,0.0
24468,2,4468,[168 197 588 143 222],716,5,18438,4.125755202506154,0.0,0.0
24469,2,4469,[318 496 588  98 357],716,5,18443,4.125950782997763,40.0,0.0
24470,2,4470,[111 186 313 183 357],655,3,18446,4.125698948781033,0.0,0.0
24471,2,4471,[318 153 111 508 322],401,2,18448,4.125223613595707,20.0,0.0
24472,2,4472,[ 97 427 215 202  50],65,5,18453,4.12541918175721,20.0,20.0
24473,2,4473,[300 269 210 196 471],450,4,18457,4.12539114886008,0.0,0.0
24474,2,4474,[742  56 435 357 118],655,1,18458,4.124692737430167,0.0,0.0
24475,2,4475,[ 97 237 588 301  15],450,4,18462,4.124664879356568,0.0,0.0
24476,2,4476,[111 200 471 204 237],457,4,18466,4.124637033727943,0.0,0.0
24477,2,4477,[ 11 161 215 191  64],577,4,18470,4.124609200535954,20.0,0.0
24478,2,4478,[318 496 588  98 357],796,5,18475,4.124804643893726,40.0,0.0
24479,2,4479,[111 302 210  28   7],151,4,18479,4.124776785714285,0.0,0.0
24480,2,4480,[318 496 588  98 357],450,5,18484,4.124972104440973,40.0,0.0
24481,2,4481,[172 471 181 245 174],450,5,18489,4.125167336010709,0.0,0.0
24482,2,4482,[318 496 588  98 357],18,5,18494,4.1253624804818205,40.0,0.0
24483,2,4483,[276  82  70   4 655],504,3,18497,4.125111507582516,0.0,0.0
24484,2,4484,[ 79 187  89 181  11],296,5,18502,4.12530657748049,0.0,0.0
24485,2,4485,[568  71 100 143 151],885,4,18506,4.1252786446723135,0.0,20.0
24486,2,4486,[153 125 435 151 294],296,3,18509,4.125027858257187,0.0,0.0
24487,2,4487,[ 82 435 153   9 161],655,0,18509,4.124108734402852,0.0,0.0
24488,2,4488,[318 496 588  98 357],786,5,18514,4.124303853865003,40.0,0.0
24489,2,4489,[187 204 265 173 273],450,4,18518,4.124276169265033,0.0,0.0
24490,2,4490,[222 173 200 318 186],457,5,18523,4.124471164551325,20.0,0.0
24491,2,4491,[161 117 200 300 173],716,4,18527,4.124443455031167,0.0,0.0
24492,2,4492,[318 496 588  98 357],796,5,18532,4.124638326285333,40.0,0.0
24493,2,4493,[168 237 597  11 215],11,1,18533,4.123943035157988,0.0,0.0
24494,2,4494,[173 121 588 168 144],807,4,18537,4.123915461624026,0.0,0.0
24495,2,4495,[216 568  95 318 333],796,5,18542,4.124110320284697,20.0,0.0
24496,2,4496,[173 125 603 301  64],796,4,18546,4.124082721814543,40.0,0.0
24497,2,4497,[318 496 588  98 357],18,5,18551,4.124277456647399,40.0,0.0
24498,2,4498,[ 88 302  64  98 515],269,3,18554,4.124027561680373,20.0,0.0
24499,2,4499,[597 118 197 151 301],796,3,18557,4.123777777777778,0.0,0.0
24500,2,4500,[318 496 588  98 357],786,5,18562,4.123972450566541,40.0,0.0
24501,2,4501,[215 568 121  12 318],693,4,18566,4.123944913371835,20.0,0.0
24502,2,4502,[318 496 588  98 357],716,5,18571,4.1241394625805015,40.0,0.0
24503,2,4503,[318 496 588  98 357],330,5,18576,4.124333925399645,40.0,0.0
24504,2,4504,[194   8 125  69 258],457,5,18581,4.124528301886793,0.0,0.0
24505,2,4505,[318 496 588  98 357],18,5,18586,4.124722592099423,40.0,0.0
24506,2,4506,[496  96 237  50   8],280,3,18589,4.124473041934768,20.0,20.0
24507,2,4507,[318 496 588  98 357],450,5,18594,4.124667258207631,40.0,0.0
24508,2,4508,[318 496 588  98 357],18,5,18599,4.124861388334442,40.0,0.0
24509,2,4509,[318 496 588  98 357],796,5,18604,4.1250554323725055,40.0,0.0
24510,2,4510,[318 496 588  98 357],716,5,18609,4.125249390379073,40.0,0.0
24511,2,4511,[202  79 405  11 228],716,5,18614,4.1254432624113475,0.0,0.0
24512,2,4512,[318 496 588  98 357],450,5,18619,4.125637048526479,40.0,0.0
24513,2,4513,[282 211   1 143 228],796,3,18622,4.125387682764732,0.0,0.0
24514,2,4514,[318 496 588  98 357],796,5,18627,4.125581395348838,40.0,0.0
24515,2,4515,[318 496 588  98 357],796,5,18632,4.12577502214349,40.0,0.0
24516,2,4516,[318 496 588  98 357],716,5,18637,4.125968563205667,40.0,0.0
24517,2,4517,[483  89 286 121 748],151,4,18641,4.125940681717574,0.0,20.0
24518,2,4518,[211 185 234  88 195],504,3,18644,4.1256915246736,0.0,0.0
24519,2,4519,[118 121 748 471 286],938,2,18646,4.125221238938053,0.0,20.0
24520,2,4520,[318 496 588  98 357],716,5,18651,4.125414731254147,40.0,0.0
24521,2,4521,[318 496 588  98 357],716,5,18656,4.125608137992039,40.0,0.0
24522,2,4522,[357 748 286 202 269],796,3,18659,4.125359274817599,0.0,20.0
24523,2,4523,[202 173 172 210 546],716,4,18663,4.1253315649867375,0.0,0.0
24524,2,4524,[318 496 588  98 357],796,5,18668,4.1255248618784535,40.0,0.0
24525,2,4525,[318 496 588  98 357],716,5,18673,4.125718073353955,40.0,0.0
24526,2,4526,[318 496 588  98 357],18,5,18678,4.125911199469847,40.0,0.0
24527,2,4527,[318 496 588  98 357],786,5,18683,4.126104240282685,40.0,0.0
24528,2,4528,[318 496 588  98 357],786,5,18688,4.126297195848974,40.0,0.0
24529,2,4529,[273  97 269 173 286],450,4,18692,4.126269315673289,0.0,20.0
24530,2,4530,[153 385 151 168   9],151,3,18695,4.126020745972191,0.0,0.0
24531,2,4531,[318  56 238 121 197],535,4,18699,4.125992939099735,20.0,0.0
24532,2,4532,[125 121 328 300  50],796,5,18704,4.126185748952129,0.0,20.0
24533,2,4533,[200 194 568   7 427],577,2,18706,4.125716806352007,20.0,0.0
24534,2,4534,[118 275  25 508  97],655,1,18707,4.12502756339581,0.0,20.0
24535,2,4535,[172 111  25 568  88],655,1,18708,4.124338624338624,0.0,0.0
24536,2,4536,[318 496 588  98 357],330,5,18713,4.124531628829623,40.0,0.0
24537,2,4537,[ 69 153 286 483 194],236,3,18716,4.124283825473777,0.0,20.0
24538,2,4538,[318 496 588  98 357],450,5,18721,4.124476756994933,40.0,0.0
24539,2,4539,[318 496 588  98 357],796,5,18726,4.124669603524229,40.0,0.0
24540,2,4540,[127  96  71 678 318],504,5,18731,4.124862365117815,20.0,20.0
24541,2,4541,[181 125 302 508 117],401,0,18731,4.123954205195949,0.0,0.0
24542,2,4542,[318 496 588  98 357],330,5,18736,4.124147039401277,40.0,0.0
24543,2,4543,[181 483 185 174 172],236,3,18739,4.123899647887324,0.0,0.0
24544,2,4544,[318 496 588  98 357],18,5,18744,4.124092409240924,40.0,0.0
24545,2,4545,[318 496 588  98 357],716,5,18749,4.1242850857897055,40.0,0.0
24546,2,4546,[318 496 588  98 357],796,5,18754,4.12447767758962,40.0,0.0
24547,2,4547,[173 144 222 678 181],807,3,18757,4.124230430958663,0.0,0.0
24548,2,4548,[ 88 235  82 294 144],716,3,18760,4.1239832930314355,0.0,0.0
24549,2,4549,[143 210 125 300 186],450,3,18763,4.123736263736264,0.0,0.0
24550,2,4550,[235 153 546 318 282],450,4,18767,4.123709074928587,20.0,0.0
24551,2,4551,[172  96 269 275   1],450,5,18772,4.12390158172232,0.0,20.0
24552,2,4552,[318 496 588  98 357],716,5,18777,4.124094003953437,40.0,0.0
24553,2,4553,[318 496 588  98 357],786,5,18782,4.124286341677646,40.0,0.0
24554,2,4554,[ 69 191 132 161  97],786,5,18787,4.124478594950603,0.0,0.0
24555,2,4555,[322   4 176 161 427],796,4,18791,4.124451273046532,20.0,0.0
24556,2,4556,[313 182 271 175 181],655,2,18793,4.1239850779021285,0.0,0.0
24557,2,4557,[ 82 385 742 127 202],256,4,18797,4.123957876261518,0.0,20.0
24558,2,4558,[318 496 588  98 357],450,5,18802,4.1241500329019525,40.0,0.0
24559,2,4559,[318 496 588  98 357],18,5,18807,4.124342105263158,40.0,0.0
24560,2,4560,[742  28 496  25 269],450,4,18811,4.1243148432361325,20.0,0.0
24561,2,4561,[318 496 588  98 357],796,5,18816,4.124506795265234,40.0,0.0
24562,2,4562,[318 496 588  98 357],450,5,18821,4.124698663160202,40.0,0.0
24563,2,4563,[ 56 195 174  69   1],457,5,18826,4.1248904469763366,0.0,0.0
24564,2,4564,[258   1 322 121  79],344,1,18827,4.12420591456736,0.0,0.0
24565,2,4565,[ 71 187 211 173  96],796,4,18831,4.124178712220762,0.0,0.0
24566,2,4566,[318 496 588  98 357],18,5,18836,4.124370483906284,40.0,0.0
24567,2,4567,[318 496 588  98 357],330,5,18841,4.124562171628722,40.0,0.0
24568,2,4568,[742   7 357  89 161],655,2,18843,4.1240971766250825,0.0,0.0
24569,2,4569,[748 294 313 276 288],280,2,18845,4.1236323851203505,0.0,0.0
24570,2,4570,[318 496 588  98 357],330,5,18850,4.123824108510173,40.0,0.0
24571,2,4571,[183 423 187 546  69],786,5,18855,4.124015748031496,0.0,0.0
24572,2,4572,[135 234 174 655 210],693,2,18857,4.123551279247758,0.0,0.0
24573,2,4573,[ 82   8 211 132 294],655,0,18857,4.122649759510275,0.0,0.0
24574,2,4574,[  7  82 603 282 135],655,2,18859,4.122185792349727,20.0,0.0
24575,2,4575,[318 496 588  98 357],18,5,18864,4.1223776223776225,40.0,0.0
24576,2,4576,[ 22 276 191 175 289],655,2,18866,4.121913917413153,0.0,0.0
24577,2,4577,[318 496 588  98 357],716,5,18871,4.122105723023155,40.0,0.0
24578,2,4578,[318 496 588  98 357],796,5,18876,4.122297444856955,40.0,0.0
24579,2,4579,[151 215 435 546 235],450,4,18880,4.122270742358078,0.0,0.0
24580,2,4580,[318 496 588  98 357],450,5,18885,4.122462344466274,40.0,0.0
24581,2,4581,[ 82 174 197 235 180],269,1,18886,4.121780881711043,0.0,0.0
24582,2,4582,[318 496 588  98 357],716,5,18891,4.121972507091425,40.0,0.0
24583,2,4583,[655 294 100  98 300],796,2,18893,4.121509598603839,0.0,20.0
24584,2,4584,[ 96 161 144 328  89],450,5,18898,4.121701199563795,0.0,0.0
24585,2,4585,[471 127 197 195 333],693,2,18900,4.121238552115133,0.0,20.0
24586,2,4586,[318 496 588  98 357],450,5,18905,4.1214301286243735,40.0,0.0
24587,2,4587,[168 302 588 186 196],389,3,18908,4.121185701830863,0.0,0.0
24588,2,4588,[403 195 210 143 121],655,1,18909,4.12050555676618,0.0,0.0
24589,2,4589,[ 15 173 301   4 144],629,3,18912,4.120261437908496,0.0,0.0
24590,2,4590,[318 496 588  98 357],330,5,18917,4.120453060335439,40.0,0.0
24591,2,4591,[588 275  79 185  98],18,4,18921,4.120426829268292,0.0,20.0
24592,2,4592,[423 546 186 187 125],503,4,18925,4.120400609623339,0.0,0.0
24593,2,4593,[318 496 588  98 357],450,5,18930,4.120592076621681,40.0,0.0
24594,2,4594,[  1 275 222 405 546],786,5,18935,4.120783460282916,0.0,20.0
24595,2,4595,[  1 132  89  15 423],655,1,18936,4.120104438642298,0.0,0.0
24596,2,4596,[318 496 588  98 357],330,5,18941,4.12029584511638,40.0,0.0
24597,2,4597,[  4 423  69  11 405],716,4,18945,4.1202696824706395,0.0,0.0
24598,2,4598,[318 496 588  98 357],330,5,18950,4.120460969776039,40.0,0.0
24599,2,4599,[318 496 588  98 357],18,5,18955,4.120652173913044,40.0,0.0
24600,2,4600,[318 496 588  98 357],450,5,18960,4.1208432949358835,40.0,0.0
24601,2,4601,[204 191 196 235  95],716,4,18964,4.120817036071274,0.0,0.0
24602,2,4602,[328 258 202 200  88],655,1,18965,4.120139039756681,0.0,0.0
24603,2,4603,[318 496 588  98 357],796,5,18970,4.120330147697654,40.0,0.0
24604,2,4604,[153 258 216 182 211],655,2,18972,4.119869706840391,0.0,0.0
24605,2,4605,[318 496 588  98 357],330,5,18977,4.120060790273556,40.0,0.0
24606,2,4606,[318 496 588  98 357],716,5,18982,4.120251790753201,40.0,0.0
24607,2,4607,[238 234 135 173  28],716,4,18986,4.120225694444445,0.0,0.0
24608,2,4608,[ 96  11 118 151 301],344,3,18989,4.119982642655674,0.0,0.0
24609,2,4609,[ 70 100 268 423 125],503,4,18993,4.119956616052061,0.0,20.0
24610,2,4610,[ 96 172  88 238 237],655,1,18994,4.119279982650184,0.0,0.0
24611,2,4611,[318 496 588  98 357],796,5,18999,4.1194709453599305,40.0,0.0
24612,2,4612,[318 496 588  98 357],330,5,19004,4.119661825276393,40.0,0.0
24613,2,4613,[200  56 273  25 191],655,3,19007,4.119419159081057,0.0,0.0
24614,2,4614,[234  25 151 195 286],151,4,19011,4.119393282773564,0.0,20.0
24615,2,4615,[318 496 588  98 357],796,5,19016,4.119584055459272,40.0,0.0
24616,2,4616,[174 294 238 143 216],716,5,19021,4.119774745505739,0.0,0.0
24617,2,4617,[ 89 179 200  69 186],18,2,19023,4.1193157210913816,0.0,0.0
24618,2,4618,[318 496 588  98 357],796,5,19028,4.11950638666378,40.0,0.0
24619,2,4619,[318 496 588  98 357],716,5,19033,4.11969696969697,40.0,0.0
24620,2,4620,[172 405  82 568 204],796,4,19037,4.119671066868643,0.0,0.0
24621,2,4621,[294 176 322 143 597],450,5,19042,4.119861531804414,0.0,0.0
24622,2,4622,[318 496 588  98 357],786,5,19047,4.120051914341337,40.0,0.0
24623,2,4623,[187 228 318 132 210],786,5,19052,4.120242214532872,20.0,0.0
24624,2,4624,[318 496 588  98 357],716,5,19057,4.120432432432432,40.0,0.0
24625,2,4625,[257 222 423 427 483],796,5,19062,4.120622568093385,20.0,0.0
24626,2,4626,[204 179 153 151  28],450,5,19067,4.120812621569051,0.0,0.0
24627,2,4627,[ 22 118 234 269 144],796,3,19070,4.12057044079516,0.0,0.0
24628,2,4628,[318 496 588  98 357],786,5,19075,4.120760423417585,40.0,0.0
24629,2,4629,[ 98 180 245 655 179],504,4,19079,4.1207343412526996,0.0,0.0
24630,2,4630,[ 28 179 313 196 125],577,4,19083,4.120708270351976,0.0,0.0
24631,2,4631,[234 125 257 144 313],655,1,19084,4.120034542314335,0.0,0.0
24632,2,4632,[435 204 508 385  89],655,1,19085,4.119361105115476,0.0,0.0
24633,2,4633,[174 210 185 257 183],835,4,19089,4.119335347432024,0.0,0.0
24634,2,4634,[318 496 588  98 357],450,5,19094,4.119525350593312,40.0,0.0
24635,2,4635,[318 496 588  98 357],796,5,19099,4.119715271786022,40.0,0.0
24636,2,4636,[318 496 588  98 357],330,5,19104,4.119905111063187,40.0,0.0
24637,2,4637,[318 496 588  98 357],18,5,19109,4.120094868477792,40.0,0.0
24638,2,4638,[318 496 588  98 357],796,5,19114,4.120284544082777,40.0,0.0
24639,2,4639,[300 471  89 121  12],655,1,19115,4.119612068965517,0.0,0.0
24640,2,4640,[ 12 403 191  22 186],655,1,19116,4.118939883645766,0.0,0.0
24641,2,4641,[ 70 204 194 195 318],716,4,19120,4.118914261094356,20.0,0.0
24642,2,4642,[318 496 588  98 357],18,5,19125,4.119104027568382,40.0,0.0
24643,2,4643,[ 70 228 282 323  98],280,2,19127,4.118647717484927,0.0,0.0
24644,2,4644,[ 82 508 603   1 197],655,1,19128,4.1179763186221745,20.0,0.0
24645,2,4645,[318 496 588  98 357],796,5,19133,4.118166164442531,40.0,0.0
24646,2,4646,[318 655 197  88  70],878,3,19136,4.1179255433613084,20.0,0.0
24647,2,4647,[202  88 196 288 268],344,3,19139,4.117685025817556,0.0,0.0
24648,2,4648,[ 71   7 174 357 211],23,3,19142,4.117444611744461,0.0,0.0
24649,2,4649,[318 496 588  98 357],18,5,19147,4.11763440860215,40.0,0.0
24650,2,4650,[118 273   9 151 403],796,3,19150,4.117394108793808,0.0,0.0
24651,2,4651,[ 12 215  82 357 435],655,1,19151,4.116723989681858,0.0,0.0
24652,2,4652,[318 496 588  98 357],18,5,19156,4.1169138190414785,40.0,0.0
24653,2,4653,[181 483  98 180 185],716,4,19160,4.116888697894285,0.0,0.0
24654,2,4654,[269  56 168 568  79],796,4,19164,4.116863587540279,0.0,0.0
24655,2,4655,[318 496 588  98 357],796,5,19169,4.117053264604811,40.0,0.0
24656,2,4656,[100 216 174   8   7],269,1,19170,4.116383938157612,0.0,20.0
24657,2,4657,[318 496 588  98 357],716,5,19175,4.116573636753972,40.0,0.0
24658,2,4658,[318 496 588  98 357],716,5,19180,4.116763253917149,40.0,0.0
24659,2,4659,[175 215 151 588 127],344,4,19184,4.116738197424893,0.0,20.0
24660,2,4660,[318 496 588  98 357],716,5,19189,4.116927697918902,40.0,0.0
24661,2,4661,[318 496 588  98 357],716,5,19194,4.117117117117117,40.0,0.0
24662,2,4662,[234  11 204 423 174],593,4,19198,4.1170920008578165,0.0,0.0
24663,2,4663,[211  70  50   1 475],503,4,19202,4.117066895368782,0.0,20.0
24664,2,4664,[318 496 588  98 357],450,5,19207,4.117256162915327,40.0,0.0
24665,2,4665,[318 496 588  98 357],786,5,19212,4.117445349335619,40.0,0.0
24666,2,4666,[318 496 588  98 357],716,5,19217,4.117634454681808,40.0,0.0
24667,2,4667,[403 603 135 125 191],450,4,19221,4.117609254498714,20.0,0.0
24668,2,4668,[135 301 357 328 194],151,4,19225,4.117584065110302,0.0,0.0
24669,2,4669,[318 496 588  98 357],716,5,19230,4.117773019271948,40.0,0.0
24670,2,4670,[269  12 268 191 174],629,3,19233,4.1175337186897885,0.0,0.0
24671,2,4671,[318 496 588  98 357],716,5,19238,4.117722602739726,40.0,0.0
24672,2,4672,[318 496 588  98 357],18,5,19243,4.117911405949069,40.0,0.0
24673,2,4673,[318 496 588  98 357],330,5,19248,4.118100128369705,40.0,0.0
24674,2,4674,[318 496 588  98 357],716,5,19253,4.118288770053476,40.0,0.0
24675,2,4675,[318 496 588  98 357],786,5,19258,4.118477331052182,40.0,0.0
24676,2,4676,[191 174  28   7  79],23,3,19261,4.118238186871927,0.0,0.0
24677,2,4677,[194 483  22 173   4],457,5,19266,4.11842667806755,0.0,0.0
24678,2,4678,[318 496 588  98 357],450,5,19271,4.118615088694165,40.0,0.0
24679,2,4679,[318 496 588  98 357],786,5,19276,4.118803418803418,40.0,0.0
24680,2,4680,[294 179  82  96 423],655,1,19277,4.118137150181585,0.0,0.0
24681,2,4681,[182 603 483 234  89],269,3,19280,4.11789833404528,20.0,0.0
24682,2,4682,[ 70 211  50   8 546],503,5,19285,4.118086696562033,0.0,20.0
24683,2,4683,[ 97   1  50 200 234],18,3,19288,4.117847993168232,0.0,20.0
24684,2,4684,[318 496 588  98 357],18,5,19293,4.11803628601921,40.0,0.0
24685,2,4685,[318 496 588  98 357],716,5,19298,4.118224498506189,40.0,0.0
24686,2,4686,[318 496 588  98 357],796,5,19303,4.118412630680606,40.0,0.0
24687,2,4687,[202 210  25 111 216],655,1,19304,4.117747440273037,0.0,0.0
24688,2,4688,[195 234 111 302 228],450,4,19308,4.117722328854766,0.0,0.0
24689,2,4689,[318 496 588  98 357],450,5,19313,4.117910447761194,40.0,0.0
24690,2,4690,[318 496 588  98 357],330,5,19318,4.118098486463441,40.0,0.0
24691,2,4691,[318 496 588  98 357],786,5,19323,4.118286445012788,40.0,0.0
24692,2,4692,[318 496 588  98 357],796,5,19328,4.1184743234604735,40.0,0.0
24693,2,4693,[216  64 132 127 181],457,5,19333,4.118662121857691,20.0,20.0
24694,2,4694,[ 98 237 194 191 183],450,5,19338,4.118849840255591,0.0,0.0
24695,2,4695,[318 496 588  98 357],796,5,19343,4.119037478705281,40.0,0.0
24696,2,4696,[318 496 588  98 357],716,5,19348,4.1192250372578245,40.0,0.0
24697,2,4697,[427 269   1 151  28],796,2,19350,4.118773946360153,20.0,0.0
24698,2,4698,[318 496 588  98 357],716,5,19355,4.118961481166205,40.0,0.0
24699,2,4699,[318 496 588  98 357],716,5,19360,4.1191489361702125,40.0,0.0
24700,2,4700,[117  98 175  71 237],344,2,19362,4.11869814932993,0.0,0.0
24701,2,4701,[318 496 588  98 357],786,5,19367,4.118885580603998,40.0,0.0
24702,2,4702,[318 496 588  98 357],786,5,19372,4.119072932170955,40.0,0.0
24703,2,4703,[318 496 588  98 357],786,5,19377,4.119260204081633,40.0,0.0
24704,2,4704,[333 195 423 588  69],796,5,19382,4.119447396386822,0.0,0.0
24705,2,4705,[197  79 202 176  97],716,4,19386,4.119422014449639,0.0,0.0
24706,2,4706,[318 496 588  98 357],796,5,19391,4.1196090928404505,40.0,0.0
24707,2,4707,[742 515   1 302 237],655,2,19393,4.119158878504673,0.0,0.0
24708,2,4708,[222 202 568   7 175],344,5,19398,4.119345933319176,0.0,0.0
24709,2,4709,[742 318   9 132  12],457,5,19403,4.119532908704883,20.0,0.0
24710,2,4710,[200  97  22 508 423],655,1,19404,4.118870728083209,0.0,0.0
24711,2,4711,[237 187 655 603 179],655,3,19407,4.118633276740238,20.0,0.0
24712,2,4712,[318 496 588  98 357],450,5,19412,4.118820284319966,40.0,0.0
24713,2,4713,[180 121 182  28 211],450,4,19416,4.1187950784896055,0.0,0.0
24714,2,4714,[318 496 588  98 357],450,5,19421,4.11898197242842,40.0,0.0
24715,2,4715,[186 210 568 603 357],450,3,19424,4.118744698897371,20.0,0.0
24716,2,4716,[568 202 118 483  28],450,3,19427,4.118507525969896,0.0,0.0
24717,2,4717,[ 89  28 176  97 328],796,3,19430,4.118270453582026,0.0,0.0
24718,2,4718,[318 496 588  98 357],796,5,19435,4.118457300275482,40.0,0.0
24719,2,4719,[318 496 588  98 357],716,5,19440,4.11864406779661,40.0,0.0
24720,2,4720,[318 496 588  98 357],716,5,19445,4.118830756195721,40.0,0.0
24721,2,4721,[318 496 588  98 357],330,5,19450,4.119017365523083,40.0,0.0
24722,2,4722,[187  22 435 269 175],704,3,19453,4.118780436163456,0.0,0.0
24723,2,4723,[483  11 181 174 286],655,1,19454,4.118120237087214,0.0,20.0
24724,2,4724,[427 179 191 496  70],450,5,19459,4.118306878306878,40.0,0.0
24725,2,4725,[202 282  69  71 427],450,4,19463,4.118281845112145,20.0,0.0
24726,2,4726,[318 496 588  98 357],786,5,19468,4.118468373175375,40.0,0.0
24727,2,4727,[168 423 186  98 385],457,5,19473,4.118654822335025,0.0,0.0
24728,2,4728,[318 496 588  98 357],786,5,19478,4.118841192641151,40.0,0.0
24729,2,4729,[318 496 588  98 357],716,5,19483,4.119027484143763,40.0,0.0
24730,2,4730,[176 313 318 179 423],236,3,19486,4.118790953286831,20.0,0.0
24731,2,4731,[318 496 588  98 357],716,5,19491,4.1189771766694845,40.0,0.0
24732,2,4732,[143 127  89 161 471],450,5,19496,4.119163321360659,0.0,20.0
24733,2,4733,[318 496 588  98 357],330,5,19501,4.119349387410224,40.0,0.0
24734,2,4734,[655 185 111 211 210],65,5,19506,4.119535374868004,0.0,0.0
24735,2,4735,[318 496 588  98 357],18,5,19511,4.119721283783784,40.0,0.0
24736,2,4736,[318 496 588  98 357],450,5,19516,4.1199071142073045,40.0,0.0
24737,2,4737,[471  64 186 568 265],716,3,19519,4.119670747150696,20.0,0.0
24738,2,4738,[318 496 588  98 357],716,5,19524,4.119856509812196,40.0,0.0
24739,2,4739,[288 100 273  69  22],629,4,19528,4.119831223628692,0.0,20.0
24740,2,4740,[318 496 588  98 357],18,5,19533,4.120016874077199,40.0,0.0
24741,2,4741,[427 273 655  98 194],796,3,19536,4.11978068325601,20.0,0.0
24742,2,4742,[ 11  22 210 475 508],655,0,19536,4.118912080961417,0.0,0.0
24743,2,4743,[508 748 168 194 238],11,2,19538,4.1184654300168635,0.0,0.0
24744,2,4744,[318 496 588  98 357],450,5,19543,4.118651211801897,40.0,0.0
24745,2,4745,[ 95 423 238 322 191],786,4,19547,4.118626211546566,0.0,0.0
24746,2,4746,[318 496 588  98 357],786,5,19552,4.118811881188119,40.0,0.0
24747,2,4747,[318 496 588  98 357],796,5,19557,4.118997472620051,40.0,0.0
24748,2,4748,[318 496 588  98 357],786,5,19562,4.119182985891767,40.0,0.0
24749,2,4749,[318 496 588  98 357],786,5,19567,4.119368421052632,40.0,0.0
24750,2,4750,[ 97 357 222 161 301],655,1,19568,4.118711850136814,0.0,0.0
24751,2,4751,[ 56 195 194 603 182],72,5,19573,4.118897306397306,20.0,0.0
24752,2,4752,[237 588  56 210 151],577,3,19576,4.11866189774879,0.0,0.0
24753,2,4753,[289 276   7 313 269],655,2,19578,4.118216238956668,0.0,0.0
24754,2,4754,[318 496 588  98 357],716,5,19583,4.118401682439537,40.0,0.0
24755,2,4755,[742  64  69 427 175],655,2,19585,4.117956265769554,40.0,0.0
24756,2,4756,[405 294   4 282 176],796,4,19589,4.117931469413496,0.0,0.0
24757,2,4757,[318 496 588  98 357],796,5,19594,4.118116855821774,40.0,0.0
24758,2,4758,[117  56 222 427 568],716,5,19599,4.1183021643202355,20.0,0.0
24759,2,4759,[318 496 588  98 357],796,5,19604,4.118487394957983,40.0,0.0
24760,2,4760,[168 588 175 181 265],716,4,19608,4.1184625078764965,0.0,0.0
24761,2,4761,[318 496 588  98 357],786,5,19613,4.1186476270474595,40.0,0.0
24762,2,4762,[269 100   7 179  22],535,4,19617,4.118622716775142,0.0,20.0
24763,2,4763,[318 496 588  98 357],330,5,19622,4.118807724601176,40.0,0.0
24764,2,4764,[ 50 132 403 237 597],457,4,19626,4.118782791185729,0.0,20.0
24765,2,4765,[357  71 117   4 135],450,2,19628,4.118338229122954,0.0,0.0
24766,2,4766,[100 125 161 257   8],457,4,19632,4.118313404657017,0.0,20.0
24767,2,4767,[200 197 471  28 211],716,4,19636,4.118288590604027,0.0,0.0
24768,2,4768,[176 245 172 268 210],344,3,19639,4.118054099391906,0.0,0.0
24769,2,4769,[496 111  70  96  95],280,5,19644,4.118238993710692,20.0,0.0
24770,2,4770,[318 496 588  98 357],450,5,19649,4.118423810521903,40.0,0.0
24771,2,4771,[111 195 117 403 475],655,0,19649,4.11756077116513,0.0,0.0
24772,2,4772,[257 313 300 333 301],860,2,19651,4.117117117117117,0.0,0.0
24773,2,4773,[318 496 588  98 357],786,5,19656,4.117302052785924,40.0,0.0
24774,2,4774,[318 496 588  98 357],716,5,19661,4.1174869109947645,40.0,0.0
24775,2,4775,[318 496 588  98 357],450,5,19666,4.117671691792295,40.0,0.0
24776,2,4776,[318 496 588  98 357],786,5,19671,4.11785639522713,40.0,0.0
24777,2,4777,[318 496 588  98 357],330,5,19676,4.118041021347844,40.0,0.0
24778,2,4778,[318 496 588  98 357],18,5,19681,4.118225570202972,40.0,0.0
24779,2,4779,[ 71 333 237 300 187],796,5,19686,4.118410041841004,0.0,0.0
24780,2,4780,[ 25 742 111  70  50],457,4,19690,4.1183852750470615,0.0,20.0
24781,2,4781,[185 655 238 288 200],504,4,19694,4.11836051861146,0.0,0.0
24782,2,4782,[328 172 288 655 742],450,4,19698,4.118335772527702,0.0,0.0
24783,2,4783,[318 496 588  98 357],450,5,19703,4.118520066889632,40.0,0.0
24784,2,4784,[200 143  97 328  98],236,4,19707,4.118495297805643,0.0,0.0
24785,2,4785,[257 176 210 742  96],457,4,19711,4.118470539072294,0.0,0.0
24786,2,4786,[265   4 405  89 172],450,4,19715,4.1184457906831,0.0,0.0
24787,2,4787,[318 496 588  98 357],796,5,19720,4.118629908103593,40.0,0.0
24788,2,4788,[318 496 588  98 357],786,5,19725,4.118813948632282,40.0,0.0
24789,2,4789,[318 496 588  98 357],330,5,19730,4.118997912317328,40.0,0.0
24790,2,4790,[318 496 588  98 357],450,5,19735,4.119181799206846,40.0,0.0
24791,2,4791,[245 127 173 202 475],629,4,19739,4.119156928213689,0.0,20.0
24792,2,4792,[195 121  82 174 496],330,4,19743,4.119132067598581,20.0,0.0
24793,2,4793,[318 496 588  98 357],786,5,19748,4.119315811430956,40.0,0.0
24794,2,4794,[318 161 588 182 546],450,5,19753,4.119499478623566,20.0,0.0
24795,2,4795,[318 496 588  98 357],330,5,19758,4.119683069224354,40.0,0.0
24796,2,4796,[318 496 588  98 357],796,5,19763,4.119866583281217,40.0,0.0
24797,2,4797,[318 496 588  98 357],796,5,19768,4.120050020842018,40.0,0.0
24798,2,4798,[318 496 588  98 357],716,5,19773,4.120233381954574,40.0,0.0
24799,2,4799,[183 180 471  79 210],457,5,19778,4.120416666666666,0.0,0.0
24800,2,4800,[318 496 588  98 357],330,5,19783,4.120599875026036,40.0,0.0
24801,2,4801,[385 289 144 238  12],655,0,19783,4.119741774260724,0.0,0.0
24802,2,4802,[288 228 127 175 508],655,1,19784,4.119092234020404,0.0,20.0
24803,2,4803,[318 496 588  98 357],450,5,19789,4.119275603663613,40.0,0.0
24804,2,4804,[318 496 588  98 357],18,5,19794,4.1194588969823105,40.0,0.0
24805,2,4805,[357  98 385 175 144],716,2,19796,4.119017894298794,0.0,0.0
24806,2,4806,[211 185  28 143 258],796,3,19799,4.118785105055128,0.0,0.0
24807,2,4807,[153 403  12  50 238],450,5,19804,4.118968386023295,0.0,20.0
24808,2,4808,[151 288 180 153 176],292,4,19808,4.118943647327927,0.0,0.0
24809,2,4809,[318 496 588  98 357],330,5,19813,4.119126819126819,40.0,0.0
24810,2,4810,[318 496 588  98 357],450,5,19818,4.119309914778633,40.0,0.0
24811,2,4811,[318 496 588  98 357],716,5,19823,4.1194929343308395,40.0,0.0
24812,2,4812,[318 496 588  98 357],796,5,19828,4.119675877830875,40.0,0.0
24813,2,4813,[318 496 588  98 357],786,5,19833,4.119858745326132,40.0,0.0
24814,2,4814,[234 748 127 172 385],280,2,19835,4.119418483904465,0.0,20.0
24815,2,4815,[191 127 195 385 318],716,3,19838,4.119186046511628,20.0,20.0
24816,2,4816,[ 64 172  82 475 135],389,4,19842,4.119161303716006,20.0,0.0
24817,2,4817,[179 222 282 187 211],236,2,19844,4.1187214611872145,0.0,0.0
24818,2,4818,[318 496 588  98 357],330,5,19849,4.118904336999377,40.0,0.0
24819,2,4819,[318 496 588  98 357],330,5,19854,4.11908713692946,40.0,0.0
24820,2,4820,[318 496 588  98 357],796,5,19859,4.119269861024684,40.0,0.0
24821,2,4821,[318 496 588  98 357],716,5,19864,4.119452509332227,40.0,0.0
24822,2,4822,[318 496 588  98 357],786,5,19869,4.119635081899233,40.0,0.0
24823,2,4823,[423 210 216 276 204],269,2,19871,4.119195688225539,0.0,0.0
24824,2,4824,[318 496 588  98 357],716,5,19876,4.119378238341969,40.0,0.0
24825,2,4825,[318 496 588  98 357],330,5,19881,4.119560712805636,40.0,0.0
24826,2,4826,[318 496 588  98 357],716,5,19886,4.119743111663559,40.0,0.0
24827,2,4827,[318 496 588  98 357],330,5,19891,4.119925434962718,40.0,0.0
24828,2,4828,[318   1 132 181 273],655,2,19893,4.119486436115138,20.0,0.0
24829,2,4829,[ 15 168 195 118 144],796,5,19898,4.119668737060041,0.0,0.0
24830,2,4830,[ 28 276 237  70  88],18,2,19900,4.119229973090458,0.0,0.0
24831,2,4831,[172 269 186 179 286],655,2,19902,4.118791390728477,0.0,20.0
24832,2,4832,[742 275  15 127   9],938,2,19904,4.1183529898613696,0.0,40.0
24833,2,4833,[318 496 588  98 357],450,5,19909,4.118535374431113,40.0,0.0
24834,2,4834,[300  25 175  64 427],655,2,19911,4.118097207859359,40.0,0.0
24835,2,4835,[ 11 187 568 211 202],716,4,19915,4.118072787427626,0.0,0.0
24836,2,4836,[318 496 588  98 357],18,5,19920,4.118255116807939,40.0,0.0
24837,2,4837,[117 153  88  71 216],885,3,19923,4.118023976849938,0.0,0.0
24838,2,4838,[318 496 588  98 357],716,5,19928,4.118206240958876,40.0,0.0
24839,2,4839,[318 496 588  98 357],330,5,19933,4.118388429752066,40.0,0.0
24840,2,4840,[655  79 151 125  25],151,5,19938,4.118570543276182,0.0,0.0
24841,2,4841,[318 496 588  98 357],330,5,19943,4.11875258157786,40.0,0.0
24842,2,4842,[318 496 588  98 357],330,5,19948,4.118934544703696,40.0,0.0
24843,2,4843,[318 496 588  98 357],18,5,19953,4.119116432700248,40.0,0.0
24844,2,4844,[318 496 588  98 357],716,5,19958,4.1192982456140355,40.0,0.0
24845,2,4845,[318 496 588  98 357],786,5,19963,4.119479983491539,40.0,0.0
24846,2,4846,[258 234 182 475  56],655,1,19964,4.118836393645554,0.0,0.0
24847,2,4847,[318 496 588  98 357],18,5,19969,4.119018151815181,40.0,0.0
24848,2,4848,[195 161 568  25 237],457,5,19974,4.119199835017529,0.0,0.0
24849,2,4849,[143 403 471 215 181],577,3,19977,4.118969072164949,0.0,0.0
24850,2,4850,[121 176 135  97 405],72,2,19979,4.118532261389404,0.0,0.0
24851,2,4851,[ 64 118 182  97 187],256,4,19983,4.118507831821929,20.0,0.0
24852,2,4852,[318 496 588  98 357],786,5,19988,4.118689470430661,40.0,0.0
24853,2,4853,[318 496 588  98 357],18,5,19993,4.118871034198599,40.0,0.0
24854,2,4854,[181 588  28  96 275],23,4,19997,4.118846549948507,0.0,20.0
24855,2,4855,[318 496 588  98 357],786,5,20002,4.119028006589786,40.0,0.0
24856,2,4856,[318 496 588  98 357],330,5,20007,4.119209388511427,40.0,0.0
24857,2,4857,[318 496 588  98 357],330,5,20012,4.119390695759572,40.0,0.0
24858,2,4858,[111 200 210 302 195],151,2,20014,4.118954517390409,0.0,0.0
24859,2,4859,[318 496 588  98 357],450,5,20019,4.119135802469136,40.0,0.0
24860,2,4860,[318 496 588  98 357],18,5,20024,4.1193170129602965,40.0,0.0
24861,2,4861,[318 496 588  98 357],716,5,20029,4.119498148909914,40.0,0.0
24862,2,4862,[318 496 588  98 357],18,5,20034,4.119679210363973,40.0,0.0
24863,2,4863,[318 496 588  98 357],716,5,20039,4.119860197368421,40.0,0.0
24864,2,4864,[318 496 588  98 357],450,5,20044,4.120041109969168,40.0,0.0
24865,2,4865,[228 185 182 191  82],450,4,20048,4.120016440608302,0.0,0.0
24866,2,4866,[318 496 588  98 357],330,5,20053,4.1201972467639205,40.0,0.0
24867,2,4867,[300 385 151 210 174],796,4,20057,4.120172555464256,0.0,0.0
24868,2,4868,[ 22 151 318 275 238],18,4,20061,4.12014787430684,20.0,20.0
24869,2,4869,[ 82 168 237 269 216],796,3,20064,4.119917864476386,0.0,0.0
24870,2,4870,[318 496 588  98 357],716,5,20069,4.120098542393759,40.0,0.0
24871,2,4871,[ 12 357 286 195  98],450,5,20074,4.120279146141215,0.0,20.0
24872,2,4872,[435 186 143 151 235],716,3,20077,4.120049250974759,0.0,0.0
24873,2,4873,[176  56 276 258   9],655,1,20078,4.1194091095609355,0.0,0.0
24874,2,4874,[245 181   8 222  70],280,2,20080,4.118974358974359,0.0,0.0
24875,2,4875,[318 496 588  98 357],716,5,20085,4.11915504511895,40.0,0.0
24876,2,4876,[318 496 588  98 357],330,5,20090,4.119335657166291,40.0,0.0
24877,2,4877,[202 118  28 288 197],457,5,20095,4.119516195161951,0.0,0.0
24878,2,4878,[ 69 268 215  56 211],11,2,20097,4.119081779053085,0.0,0.0
24879,2,4879,[ 64 655 121   4 265],151,5,20102,4.119262295081967,20.0,0.0
24880,2,4880,[318 496 588  98 357],786,5,20107,4.119442737144028,40.0,0.0
24881,2,4881,[195  98 174 322 180],450,5,20112,4.119623105284719,0.0,0.0
24882,2,4882,[  7 211  69 161 318],786,5,20117,4.119803399549458,20.0,0.0
24883,2,4883,[318 496 588  98 357],716,5,20122,4.11998361998362,40.0,0.0
24884,2,4884,[318 496 588  98 357],330,5,20127,4.120163766632548,40.0,0.0
24885,2,4885,[318 496 588  98 357],18,5,20132,4.1203438395415475,40.0,0.0
24886,2,4886,[318 496 588  98 357],18,5,20137,4.120523838755883,40.0,0.0
24887,2,4887,[ 15 176 185 172  64],450,4,20141,4.120499181669395,20.0,0.0
24888,2,4888,[318 496 588  98 357],18,5,20146,4.120679075475557,40.0,0.0
24889,2,4889,[313 182 276 427 234],436,3,20149,4.120449897750511,20.0,0.0
24890,2,4890,[132   4 135 111 265],151,5,20154,4.120629728071969,0.0,0.0
24891,2,4891,[318 496 588  98 357],18,5,20159,4.120809484873263,40.0,0.0
24892,2,4892,[546 385 175 302 191],151,1,20160,4.120171673819742,0.0,0.0
24893,2,4893,[318 496 588  98 357],716,5,20165,4.1203514507560275,40.0,0.0
24894,2,4894,[318 496 588  98 357],450,5,20170,4.1205311542390195,40.0,0.0
24895,2,4895,[234 111 258 603 168],450,4,20174,4.120506535947713,20.0,0.0
24896,2,4896,[318 496 588  98 357],330,5,20179,4.120686134367981,40.0,0.0
24897,2,4897,[318 496 588  98 357],796,5,20184,4.120865659452838,40.0,0.0
24898,2,4898,[318 496 588  98 357],716,5,20189,4.121045111247193,40.0,0.0
24899,2,4899,[132 265  96  79  95],796,5,20194,4.121224489795918,0.0,0.0
24900,2,4900,[318 496 588  98 357],18,5,20199,4.1214037951438485,40.0,0.0
24901,2,4901,[318 496 588  98 357],716,5,20204,4.121583027335781,40.0,0.0
24902,2,4902,[318 496 588  98 357],330,5,20209,4.12176218641648,40.0,0.0
24903,2,4903,[318 496 588  98 357],796,5,20214,4.121941272430669,40.0,0.0
24904,2,4904,[318 496 588  98 357],796,5,20219,4.122120285423038,40.0,0.0
24905,2,4905,[  7 275 204 748 135],151,4,20223,4.122095393395842,0.0,20.0
24906,2,4906,[269 179 144  11 117],450,5,20228,4.122274302017526,0.0,0.0
24907,2,4907,[228  15 515 211 180],296,4,20232,4.1222493887530565,0.0,0.0
24908,2,4908,[ 64  98   9 210 333],655,2,20234,4.121817070686494,20.0,0.0
24909,2,4909,[318 496 588  98 357],450,5,20239,4.121995926680245,40.0,0.0
24910,2,4910,[318 496 588  98 357],450,5,20244,4.122174709835064,40.0,0.0
24911,2,4911,[318 496 588  98 357],330,5,20249,4.12235342019544,40.0,0.0
24912,2,4912,[318 496 588  98 357],18,5,20254,4.122532057805821,40.0,0.0
24913,2,4913,[237  56 234 222 183],716,4,20258,4.122507122507122,0.0,0.0
24914,2,4914,[228 118 211 161  12],693,1,20259,4.121871820956256,0.0,0.0
24915,2,4915,[173   4 294 204 269],264,4,20263,4.121847030105777,0.0,0.0
24916,2,4916,[228  82 222 237 288],655,0,20263,4.121008745169819,0.0,0.0
24917,2,4917,[318 496 588  98 357],716,5,20268,4.121187474583164,40.0,0.0
24918,2,4918,[318 496 588  98 357],796,5,20273,4.121366131327505,40.0,0.0
24919,2,4919,[180  50  69 168 196],18,2,20275,4.120934959349594,0.0,20.0
24920,2,4920,[318 496 588  98 357],18,5,20280,4.121113594797805,40.0,0.0
24921,2,4921,[318 496 588  98 357],796,5,20285,4.121292157659488,40.0,0.0
24922,2,4922,[318 496 588  98 357],450,5,20290,4.1214706479788745,40.0,0.0
24923,2,4923,[318 496 588  98 357],450,5,20295,4.121649065800162,40.0,0.0
24924,2,4924,[191 117 597 174 286],344,2,20297,4.121218274111675,0.0,20.0
24925,2,4925,[  7 143 151 125  28],450,5,20302,4.121396670726756,0.0,0.0
24926,2,4926,[318 496 588  98 357],796,5,20307,4.121574994925918,40.0,0.0
24927,2,4927,[318 496 588  98 357],796,5,20312,4.121753246753247,40.0,0.0
24928,2,4928,[200 191 204 385 202],796,5,20317,4.1219314262527895,0.0,0.0
24929,2,4929,[318 496 588  98 357],796,5,20322,4.12210953346856,40.0,0.0
24930,2,4930,[318 496 588  98 357],786,5,20327,4.122287568444534,40.0,0.0
24931,2,4931,[ 25 300 118 515  69],655,1,20328,4.121654501216545,0.0,0.0
24932,2,4932,[403 204 211  64 273],450,4,20332,4.1216298398540445,20.0,0.0
24933,2,4933,[ 88 153   1  56 568],593,4,20336,4.121605188488042,0.0,0.0
24934,2,4934,[302 742 588 235 135],450,3,20339,4.121377912867275,0.0,0.0
24935,2,4935,[194 403 174 200 588],577,4,20343,4.121353322528363,0.0,0.0
24936,2,4936,[  9 135 179 234  22],18,3,20346,4.121126189993923,0.0,0.0
24937,2,4937,[ 96  56 508 385  12],280,4,20350,4.121101660591332,0.0,0.0
24938,2,4938,[ 15 318 100 118 405],796,4,20354,4.121077141121685,20.0,20.0
24939,2,4939,[151   9 275  82 197],878,3,20357,4.12085020242915,0.0,20.0
24940,2,4940,[318 496 588  98 357],450,5,20362,4.121028131957094,40.0,0.0
24941,2,4941,[318 496 588  98 357],786,5,20367,4.121205989477944,40.0,0.0
24942,2,4942,[318 496 588  98 357],786,5,20372,4.121383775035404,40.0,0.0
24943,2,4943,[318 496 588  98 357],18,5,20377,4.121561488673139,40.0,0.0
24944,2,4944,[318 496 588  98 357],796,5,20382,4.121739130434783,40.0,0.0
24945,2,4945,[318 496 588  98 357],716,5,20387,4.12191670036393,40.0,0.0
24946,2,4946,[182 568 168 257 471],389,3,20390,4.121689913078633,0.0,0.0
24947,2,4947,[318 496 588  98 357],18,5,20395,4.121867421180275,40.0,0.0
24948,2,4948,[318 496 588  98 357],796,5,20400,4.122044857546979,40.0,0.0
24949,2,4949,[ 12 322 655  56 195],796,3,20403,4.121818181818182,0.0,0.0
24950,2,4950,[318 496 588  98 357],716,5,20408,4.121995556453242,40.0,0.0
24951,2,4951,[318 496 588  98 357],18,5,20413,4.122172859450727,40.0,0.0
24952,2,4952,[318 496 588  98 357],450,5,20418,4.122350090854028,40.0,0.0
24953,2,4953,[742 125 269 228 216],655,1,20419,4.121719822365765,0.0,0.0
24954,2,4954,[328  82 211 405 302],450,4,20423,4.121695257315842,0.0,0.0
24955,2,4955,[318 496 588  98 357],18,5,20428,4.121872477804681,40.0,0.0
24956,2,4956,[318 496 588  98 357],450,5,20433,4.122049626790397,40.0,0.0
24957,2,4957,[318 496 588  98 357],716,5,20438,4.122226704316256,40.0,0.0
24958,2,4958,[ 82 111   1 427 483],716,5,20443,4.122403710425489,20.0,0.0
24959,2,4959,[275 258 269 234   9],655,1,20444,4.121774193548387,0.0,20.0
24960,2,4960,[ 97  15 300 483 181],450,3,20447,4.121548074984882,0.0,0.0
24961,2,4961,[318 496 588  98 357],786,5,20452,4.1217251108424025,40.0,0.0
24962,2,4962,[187 294 234 333 127],796,3,20455,4.121499093290349,0.0,20.0
24963,2,4963,[318 496 588  98 357],716,5,20460,4.121676067687349,40.0,0.0
24964,2,4964,[318 496 588  98 357],786,5,20465,4.121852970795569,40.0,0.0
24965,2,4965,[111 181 132 196  50],655,1,20466,4.121224325412807,0.0,20.0
24966,2,4966,[ 71 276  89 100 172],316,1,20467,4.120595933158849,0.0,20.0
24967,2,4967,[179 275 269 328 151],450,5,20472,4.120772946859903,0.0,20.0
24968,2,4968,[318 496 588  98 357],450,5,20477,4.120949889313745,40.0,0.0
24969,2,4969,[135 385 100   8 196],457,5,20482,4.121126760563381,0.0,20.0
24970,2,4970,[318 496 588  98 357],716,5,20487,4.12130356065178,40.0,0.0
24971,2,4971,[ 71 300   4 179 181],450,3,20490,4.121078037007241,0.0,0.0
24972,2,4972,[318 496 588  98 357],450,5,20495,4.121254775789262,40.0,0.0
24973,2,4973,[135 194  64 403 302],269,3,20498,4.121029352633696,20.0,0.0
24974,2,4974,[318 496 588  98 357],450,5,20503,4.121206030150754,40.0,0.0
24975,2,4975,[  8 222  56 172 568],280,2,20505,4.120779742765273,0.0,0.0
24976,2,4976,[588 121 168 222 313],450,3,20508,4.120554550934298,0.0,0.0
24977,2,4977,[318 496 588  98 357],716,5,20513,4.120731217356368,40.0,0.0
24978,2,4978,[318 496 588  98 357],18,5,20518,4.120907812813818,40.0,0.0
24979,2,4979,[302   4 204 269 176],655,1,20519,4.120281124497992,0.0,0.0
24980,2,4980,[121  97 655 210 187],786,4,20523,4.120256976510741,0.0,0.0
24981,2,4981,[318 496 588  98 357],796,5,20528,4.120433560818948,40.0,0.0
24982,2,4982,[318 496 588  98 357],786,5,20533,4.1206100742524585,40.0,0.0
24983,2,4983,[568  98 427  50 234],577,3,20536,4.120385232744783,20.0,20.0
24984,2,4984,[ 96  25 234 197  95],716,4,20540,4.120361083249749,0.0,0.0
24985,2,4985,[111 588  70 172 546],450,5,20545,4.120537505014039,0.0,0.0
24986,2,4986,[403 300 183  71 496],450,4,20549,4.120513334670142,20.0,0.0
24987,2,4987,[318 496 588  98 357],330,5,20554,4.120689655172414,40.0,0.0
24988,2,4988,[318 496 588  98 357],716,5,20559,4.12086590499098,40.0,0.0
24989,2,4989,[318 496 588  98 357],796,5,20564,4.121042084168336,40.0,0.0
24990,2,4990,[318 496 588  98 357],450,5,20569,4.1212181927469445,40.0,0.0
24991,2,4991,[318 496 588  98 357],786,5,20574,4.121394230769231,40.0,0.0
24992,2,4992,[181 143  22 185 546],457,4,20578,4.121369917885039,0.0,0.0
24993,2,4993,[195 185  79 175 161],655,2,20580,4.120945134160993,0.0,0.0
24994,2,4994,[197 403 271  22 210],796,3,20583,4.120720720720721,0.0,0.0
24995,2,4995,[268 187 179 194 197],535,3,20586,4.120496397117694,0.0,0.0
24996,2,4996,[318 496 588  98 357],716,5,20591,4.120672403442065,40.0,0.0
24997,2,4997,[318 496 588  98 357],18,5,20596,4.120848339335734,40.0,0.0
24998,2,4998,[318 496 588  98 357],18,5,20601,4.121024204840968,40.0,0.0
24999,2,4999,[318 496 588  98 357],796,5,20606,4.1212,40.0,0.0
25000,2,5000,[ 70 385 235 222 168],450,3,20609,4.120975804839032,0.0,0.0
25001,2,5001,[258  82 135  56 179],655,2,20611,4.120551779288284,0.0,0.0
25002,2,5002,[144 200 405  97 234],796,3,20614,4.120327803318009,0.0,0.0
25003,2,5003,[  8   9 597 153 483],796,4,20618,4.120303756994405,0.0,0.0
25004,2,5004,[  1 135 258  79  96],450,4,20622,4.12027972027972,0.0,0.0
25005,2,5005,[318 496 588  98 357],716,5,20627,4.120455453455853,40.0,0.0
25006,2,5006,[238 282 294 191 318],655,2,20629,4.1200319552626326,20.0,0.0
25007,2,5007,[ 50 161 300 135 187],693,1,20630,4.119408945686901,0.0,20.0
25008,2,5008,[132 265  56   1 194],450,5,20635,4.1195847474545815,0.0,0.0
25009,2,5009,[318 496 588  98 357],330,5,20640,4.119760479041916,40.0,0.0
25010,2,5010,[318 496 588  98 357],716,5,20645,4.11993614049092,40.0,0.0
25011,2,5011,[318 496 588  98 357],796,5,20650,4.120111731843576,40.0,0.0
25012,2,5012,[318 496 588  98 357],716,5,20655,4.120287253141831,40.0,0.0
25013,2,5013,[318 496 588  98 357],796,5,20660,4.120462704427602,40.0,0.0
25014,2,5014,[318 496 588  98 357],450,5,20665,4.120638085742772,40.0,0.0
25015,2,5015,[222 197 194 275 282],796,4,20669,4.120614035087719,0.0,20.0
25016,2,5016,[181 111 228 588 210],756,4,20673,4.120589994020331,0.0,0.0
25017,2,5017,[318 496 588  98 357],450,5,20678,4.1207652451175765,40.0,0.0
25018,2,5018,[ 12 183 742 483 333],796,4,20682,4.12074118350269,0.0,0.0
25019,2,5019,[318 496 588  98 357],786,5,20687,4.120916334661355,40.0,0.0
25020,2,5020,[179 234  25 427   9],18,3,20690,4.120693089026091,20.0,0.0
25021,2,5021,[318 496 588  98 357],18,5,20695,4.120868180007965,40.0,0.0
25022,2,5022,[318 496 588  98 357],716,5,20700,4.121043201274139,40.0,0.0
25023,2,5023,[318 496 588  98 357],330,5,20705,4.121218152866242,40.0,0.0
25024,2,5024,[ 50 200 204 172 144],593,5,20710,4.1213930348258705,0.0,20.0
25025,2,5025,[121 202 135 200 300],450,2,20712,4.120970951054517,0.0,0.0
25026,2,5026,[204 265   7 118  98],577,3,20715,4.120747961010543,0.0,0.0
25027,2,5027,[118  79 546  96 191],457,4,20719,4.120723945902943,0.0,0.0
25028,2,5028,[318 496 588  98 357],330,5,20724,4.120898787035196,40.0,0.0
25029,2,5029,[568 172 405 176 258],344,3,20727,4.120675944333996,0.0,0.0
25030,2,5030,[318 496 588  98 357],450,5,20732,4.120850725501889,40.0,0.0
25031,2,5031,[318 496 588  98 357],786,5,20737,4.121025437201908,40.0,0.0
25032,2,5032,[318 496 588  98 357],786,5,20742,4.121200079475462,40.0,0.0
25033,2,5033,[318 496 588  98 357],716,5,20747,4.121374652363925,40.0,0.0
25034,2,5034,[318 496 588  98 357],330,5,20752,4.12154915590864,40.0,0.0
25035,2,5035,[210 508 100 151  88],401,3,20755,4.121326449563146,0.0,20.0
25036,2,5036,[286 222 588 172 204],796,4,20759,4.121302362517372,0.0,20.0
25037,2,5037,[318 496 588  98 357],450,5,20764,4.121476776498611,40.0,0.0
25038,2,5038,[655 471 357 100 168],450,5,20769,4.121651121254217,0.0,20.0
25039,2,5039,[194 588  50 181 191],457,5,20774,4.121825396825397,0.0,20.0
25040,2,5040,[318 496 588  98 357],786,5,20779,4.121999603253323,40.0,0.0
25041,2,5041,[318 496 588  98 357],450,5,20784,4.122173740579135,40.0,0.0
25042,2,5042,[318 496 588  98 357],716,5,20789,4.1223478088439425,40.0,0.0
25043,2,5043,[210 748 144 427 597],807,5,20794,4.122521808088818,20.0,0.0
25044,2,5044,[111 357 238 196 100],629,5,20799,4.122695738354807,0.0,20.0
25045,2,5045,[318 496 588  98 357],796,5,20804,4.122869599682917,40.0,0.0
25046,2,5046,[318 496 588  98 357],786,5,20809,4.123043392114127,40.0,0.0
25047,2,5047,[100 194 238 427 276],269,5,20814,4.123217115689382,20.0,20.0
25048,2,5048,[ 70 132  97 742   1],450,5,20819,4.123390770449594,0.0,0.0
25049,2,5049,[318 496 588  98 357],796,5,20824,4.123564356435644,40.0,0.0
25050,2,5050,[300 678 742 153 151],504,4,20828,4.123539893090477,0.0,0.0
25051,2,5051,[318 496 588  98 357],796,5,20833,4.123713380839272,40.0,0.0
25052,2,5052,[318 496 588  98 357],18,5,20838,4.1238867999208395,40.0,0.0
25053,2,5053,[ 97 143 153  56 655],236,3,20841,4.123664424218441,0.0,0.0
25054,2,5054,[318 496 588  98 357],786,5,20846,4.123837784371909,40.0,0.0
25055,2,5055,[546  79 385 118 294],716,2,20848,4.1234177215189876,0.0,0.0
25056,2,5056,[289 237 276 117 210],296,2,20850,4.12299782479731,0.0,0.0
25057,2,5057,[300 269  56 210 546],796,3,20853,4.122775800711744,0.0,0.0
25058,2,5058,[318 496 588  98 357],796,5,20858,4.122949199446531,40.0,0.0
25059,2,5059,[603 125  82 204  71],798,2,20860,4.122529644268774,20.0,0.0
25060,2,5060,[318 496 588  98 357],716,5,20865,4.12270302311796,40.0,0.0
25061,2,5061,[318 496 588  98 357],18,5,20870,4.122876333465034,40.0,0.0
25062,2,5062,[318 496 588  98 357],716,5,20875,4.123049575350582,40.0,0.0
25063,2,5063,[318 496 588  98 357],796,5,20880,4.123222748815166,40.0,0.0
25064,2,5064,[318 496 588  98 357],786,5,20885,4.123395853899309,40.0,0.0
25065,2,5065,[318 496 588  98 357],786,5,20890,4.123568890643505,40.0,0.0
25066,2,5066,[318 496 588  98 357],450,5,20895,4.123741859088218,40.0,0.0
25067,2,5067,[318 496 588  98 357],18,5,20900,4.123914759273875,40.0,0.0
25068,2,5068,[318 496 588  98 357],18,5,20905,4.124087591240876,40.0,0.0
25069,2,5069,[318 496 588  98 357],18,5,20910,4.124260355029586,40.0,0.0
25070,2,5070,[318 496 588  98 357],450,5,20915,4.124433050680339,40.0,0.0
25071,2,5071,[318 496 588  98 357],18,5,20920,4.124605678233438,40.0,0.0
25072,2,5072,[318 496 588  98 357],450,5,20925,4.124778237729155,40.0,0.0
25073,2,5073,[318 496 588  98 357],330,5,20930,4.124950729207725,40.0,0.0
25074,2,5074,[508 216 210  79   8],280,3,20933,4.124729064039409,0.0,0.0
25075,2,5075,[318 496 588  98 357],716,5,20938,4.124901497241923,40.0,0.0
25076,2,5076,[153  11 234 655 125],450,4,20942,4.124876895804609,0.0,0.0
25077,2,5077,[210 322  56 121 216],796,3,20945,4.124655376132336,0.0,0.0
25078,2,5078,[ 69 282  98  15 195],236,4,20949,4.1246308328411105,0.0,0.0
25079,2,5079,[ 79  82 172 211 216],655,3,20952,4.124409448818898,0.0,0.0
25080,2,5080,[286  69 111 357  28],450,5,20957,4.1245817752410945,0.0,20.0
25081,2,5081,[318 496 588  98 357],18,5,20962,4.124754033844943,40.0,0.0
25082,2,5082,[318 496 588  98 357],786,5,20967,4.12492622467047,40.0,0.0
25083,2,5083,[318 496 588  98 357],796,5,20972,4.125098347757671,40.0,0.0
25084,2,5084,[318 496 588  98 357],716,5,20977,4.1252704031465095,40.0,0.0
25085,2,5085,[100 135 111 191   4],151,3,20980,4.1250491545418795,0.0,20.0
25086,2,5086,[427 300  56 200 173],151,4,20984,4.125024572439552,20.0,0.0
25087,2,5087,[318 496 588  98 357],450,5,20989,4.125196540880503,40.0,0.0
25088,2,5088,[318 496 588  98 357],18,5,20994,4.12536844173708,40.0,0.0
25089,2,5089,[215 301  50  11 172],450,5,20999,4.125540275049116,0.0,20.0
25090,2,5090,[318 496 588  98 357],786,5,21004,4.125712040856413,40.0,0.0
25091,2,5091,[238   1  89 211 588],786,5,21009,4.125883739198743,0.0,0.0
25092,2,5092,[186  22 300 135 268],535,1,21010,4.125269978401728,0.0,0.0
25093,2,5093,[318 496 588  98 357],786,5,21015,4.125441696113074,40.0,0.0
25094,2,5094,[318 496 588  98 357],18,5,21020,4.125613346418057,40.0,0.0
25095,2,5095,[265 125  98  64  69],450,5,21025,4.1257849293563575,20.0,0.0
25096,2,5096,[318 496 588  98 357],716,5,21030,4.125956444967628,40.0,0.0
25097,2,5097,[172 405 427 196 153],716,5,21035,4.126127893291486,20.0,0.0
25098,2,5098,[318 496 588  98 357],18,5,21040,4.126299274367523,40.0,0.0
25099,2,5099,[200 546 313   4 118],796,5,21045,4.126470588235295,0.0,0.0
25100,2,5100,[318 496 588  98 357],450,5,21050,4.126641834934326,40.0,0.0
25101,2,5101,[318 496 588  98 357],330,5,21055,4.126813014504116,40.0,0.0
25102,2,5102,[318 496 588  98 357],796,5,21060,4.126984126984127,40.0,0.0
25103,2,5103,[318 496 588  98 357],796,5,21065,4.127155172413793,40.0,0.0
25104,2,5104,[318 496 588  98 357],796,5,21070,4.127326150832517,40.0,0.0
25105,2,5105,[318 496 588  98 357],786,5,21075,4.127497062279671,40.0,0.0
25106,2,5106,[318 496 588  98 357],796,5,21080,4.127667906794596,40.0,0.0
25107,2,5107,[318 496 588  98 357],18,5,21085,4.127838684416601,40.0,0.0
25108,2,5108,[ 50 168 405 202  88],151,4,21089,4.127813662164807,0.0,20.0
25109,2,5109,[313  12 300  82 216],655,2,21091,4.127397260273972,0.0,0.0
25110,2,5110,[318 496 588  98 357],450,5,21096,4.127567990608491,40.0,0.0
25111,2,5111,[475 405 300 748  64],292,3,21099,4.127347417840376,20.0,0.0
25112,2,5112,[318 496 588  98 357],796,5,21104,4.127518091140231,40.0,0.0
25113,2,5113,[318 496 588  98 357],786,5,21109,4.127688697692609,40.0,0.0
25114,2,5114,[118 185 282 187  82],256,3,21112,4.127468230694038,0.0,0.0
25115,2,5115,[  7 202 273 127 111],344,5,21117,4.127638780297107,0.0,20.0
25116,2,5116,[318 496 588  98 357],716,5,21122,4.12780926324018,40.0,0.0
25117,2,5117,[294  64 282 182 161],796,4,21126,4.127784290738569,20.0,0.0
25118,2,5118,[318 496 588  98 357],330,5,21131,4.127954678648173,40.0,0.0
25119,2,5119,[153 405 211 187  64],716,4,21135,4.1279296875,20.0,0.0
25120,2,5120,[194 603  70 275 176],450,5,21140,4.128099980472564,20.0,20.0
25121,2,5121,[318 496 588  98 357],716,5,21145,4.12827020695041,40.0,0.0
25122,2,5122,[183  50 289 117 194],236,1,21146,4.127659574468085,0.0,20.0
25123,2,5123,[318 496 588  98 357],796,5,21151,4.127829820452772,40.0,0.0
25124,2,5124,[ 97 427 423   8   4],796,4,21155,4.127804878048781,20.0,0.0
25125,2,5125,[194 172  95 202 121],450,3,21158,4.1275848614904405,0.0,0.0
25126,2,5126,[238 603 168  22 235],269,3,21161,4.127364930758728,20.0,0.0
25127,2,5127,[588 483 173 211 186],911,3,21164,4.127145085803432,0.0,0.0
25128,2,5128,[210 125  98 748  69],151,4,21168,4.127120296354065,0.0,0.0
25129,2,5129,[ 64  98 161  22 496],269,3,21171,4.1269005847953215,40.0,0.0
25130,2,5130,[275 100 222 273 235],344,4,21175,4.1268758526603,0.0,40.0
25131,2,5131,[318 496 588  98 357],786,5,21180,4.127045985970382,40.0,0.0
25132,2,5132,[318 496 588  98 357],796,5,21185,4.127216052990454,40.0,0.0
25133,2,5133,[318 496 588  98 357],330,5,21190,4.127386053759252,40.0,0.0
25134,2,5134,[318 496 588  98 357],330,5,21195,4.127555988315482,40.0,0.0
25135,2,5135,[318 496 588  98 357],450,5,21200,4.127725856697819,40.0,0.0
25136,2,5136,[132 508 328   9 111],655,0,21200,4.126922328207125,0.0,0.0
25137,2,5137,[318 496 588  98 357],450,5,21205,4.127092253795251,40.0,0.0
25138,2,5138,[318 496 588  98 357],796,5,21210,4.127262113251605,40.0,0.0
25139,2,5139,[237   8 197  89 176],796,4,21214,4.1272373540856035,0.0,0.0
25140,2,5140,[318 496 588  98 357],786,5,21219,4.127407119237502,40.0,0.0
25141,2,5141,[183 318 204 333 216],796,5,21224,4.127576818358615,20.0,0.0
25142,2,5142,[168   9 546 172 183],796,4,21228,4.127552012444099,0.0,0.0
25143,2,5143,[318 496 588  98 357],786,5,21233,4.127721617418351,40.0,0.0
25144,2,5144,[318 496 588  98 357],330,5,21238,4.127891156462585,40.0,0.0
25145,2,5145,[318 496 588  98 357],786,5,21243,4.128060629615235,40.0,0.0
25146,2,5146,[ 15 179 135 742  88],450,3,21246,4.127841461045269,0.0,0.0
25147,2,5147,[153 301 275  11 161],593,4,21250,4.127816627816628,0.0,20.0
25148,2,5148,[181 588 191 118  95],389,3,21253,4.127597591765391,0.0,0.0
25149,2,5149,[318 496 588  98 357],450,5,21258,4.127766990291262,40.0,0.0
25150,2,5150,[269 202 235 742 234],264,4,21262,4.127742185983304,0.0,0.0
25151,2,5151,[318 496 588  98 357],18,5,21267,4.12791149068323,40.0,0.0
25152,2,5152,[318 496 588  98 357],450,5,21272,4.128080729672035,40.0,0.0
25153,2,5153,[318 568 200 588 191],450,4,21276,4.128055878928987,20.0,0.0
25154,2,5154,[318 496 588  98 357],450,5,21281,4.1282250242483025,40.0,0.0
25155,2,5155,[318 496 588  98 357],330,5,21286,4.1283941039565555,40.0,0.0
25156,2,5156,[ 15  28 200 176 202],450,3,21289,4.128175295714563,0.0,0.0
25157,2,5157,[ 12 403 182 181 183],796,5,21294,4.128344319503683,0.0,0.0
25158,2,5158,[318 496 588  98 357],330,5,21299,4.128513277767009,40.0,0.0
25159,2,5159,[  7  95 276 121 151],344,4,21303,4.128488372093023,0.0,0.0
25160,2,5160,[318 496 588  98 357],786,5,21308,4.1286572369695795,40.0,0.0
25161,2,5161,[318 496 588  98 357],716,5,21313,4.1288260364199925,40.0,0.0
25162,2,5162,[235 172 161  50 151],23,2,21315,4.128413712957583,0.0,20.0
25163,2,5163,[318 496 588  98 357],450,5,21320,4.12858249419055,40.0,0.0
25164,2,5164,[ 89 216 237 135 215],450,4,21324,4.128557599225557,0.0,0.0
25165,2,5165,[294   7 597 257  56],457,2,21326,4.128145567169957,0.0,0.0
25166,2,5166,[ 12 204 100 302  25],344,5,21331,4.128314302303077,0.0,20.0
25167,2,5167,[318 496 588  98 357],796,5,21336,4.128482972136223,40.0,0.0
25168,2,5168,[318 496 588  98 357],796,5,21341,4.128651576707293,40.0,0.0
25169,2,5169,[603 174 238  12 258],450,5,21346,4.128820116054158,20.0,0.0
25170,2,5170,[195 173 143 215 135],716,3,21349,4.128601817830207,0.0,0.0
25171,2,5171,[318 496 588  98 357],716,5,21354,4.1287703016241295,40.0,0.0
25172,2,5172,[318 496 588  98 357],796,5,21359,4.128938720278368,40.0,0.0
25173,2,5173,[318 496 588  98 357],786,5,21364,4.129107073830692,40.0,0.0
25174,2,5174,[318 496 588  98 357],786,5,21369,4.1292753623188405,40.0,0.0
25175,2,5175,[318 237 288 185 216],655,3,21372,4.129057187017001,20.0,0.0
25176,2,5176,[276 132 111  89   9],18,3,21375,4.1288390960015455,0.0,0.0
25177,2,5177,[333  15  50 172  82],655,2,21377,4.128427964465044,0.0,20.0
25178,2,5178,[318 496 588  98 357],450,5,21382,4.128596254103108,40.0,0.0
25179,2,5179,[318 496 588  98 357],330,5,21387,4.128764478764479,40.0,0.0
25180,2,5180,[180  82   9 302 427],269,2,21389,4.128353599691179,20.0,0.0
25181,2,5181,[318 496 588  98 357],716,5,21394,4.1285218062524125,40.0,0.0
25182,2,5182,[318 496 588  98 357],786,5,21399,4.128689947906618,40.0,0.0
25183,2,5183,[318 496 588  98 357],330,5,21404,4.128858024691358,40.0,0.0
25184,2,5184,[228 121  89 258 125],151,5,21409,4.129026036644166,0.0,0.0
25185,2,5185,[125 143 151 313 202],450,5,21414,4.129193983802545,0.0,0.0
25186,2,5186,[132   9 143 173 100],796,3,21417,4.128976286871024,0.0,20.0
25187,2,5187,[318 496 588  98 357],716,5,21422,4.129144178874325,40.0,0.0
25188,2,5188,[318 496 588  98 357],716,5,21427,4.1293120061668915,40.0,0.0
25189,2,5189,[  4 204  56 300  50],504,2,21429,4.128901734104046,0.0,20.0
25190,2,5190,[318 496 588  98 357],450,5,21434,4.12906954344057,40.0,0.0
25191,2,5191,[273 161 173 100 197],450,4,21438,4.12904468412943,0.0,20.0
25192,2,5192,[318 496 588  98 357],786,5,21443,4.129212401309455,40.0,0.0
25193,2,5193,[153 471 301 176 180],450,5,21448,4.129380053908355,0.0,0.0
25194,2,5194,[318 496 588  98 357],18,5,21453,4.129547641963426,40.0,0.0
25195,2,5195,[318 496 588  98 357],716,5,21458,4.129715165511932,40.0,0.0
25196,2,5196,[318 496 588  98 357],796,5,21463,4.129882624591111,40.0,0.0
25197,2,5197,[318 496 588  98 357],796,5,21468,4.130050019238168,40.0,0.0
25198,2,5198,[318 496 588  98 357],786,5,21473,4.1302173494902865,40.0,0.0
25199,2,5199,[318 496 588  98 357],18,5,21478,4.1303846153846155,40.0,0.0
25200,2,5200,[  7  82 294 168 496],577,4,21482,4.130359546241108,20.0,0.0
25201,2,5201,[294 508 204 265 496],280,2,21484,4.129950019223376,20.0,0.0
25202,2,5202,[275 125 245 237 144],593,3,21487,4.12973284643475,0.0,20.0
25203,2,5203,[301 237 215 202 483],450,4,21491,4.129707916986933,0.0,0.0
25204,2,5204,[318 496 588  98 357],450,5,21496,4.129875120076849,40.0,0.0
25205,2,5205,[168 172  22 210 195],716,4,21500,4.1298501728774495,0.0,0.0
25206,2,5206,[405 403 257 515 748],807,5,21505,4.130017284424813,0.0,0.0
25207,2,5207,[ 15 423   9 185   7],65,4,21509,4.129992319508449,0.0,0.0
25208,2,5208,[318 496 588  98 357],716,5,21514,4.13015933960453,40.0,0.0
25209,2,5209,[318 496 588  98 357],796,5,21519,4.130326295585412,40.0,0.0
25210,2,5210,[132 172 204 176 301],450,5,21524,4.130493187488006,0.0,0.0
25211,2,5211,[318 496 588  98 357],330,5,21529,4.130660015349195,40.0,0.0
25212,2,5212,[318 748 210 132 181],796,4,21533,4.130634951083829,20.0,0.0
25213,2,5213,[ 15  64 603  28  88],151,5,21538,4.1308016877637135,40.0,0.0
25214,2,5214,[143 471 313 258  50],655,3,21541,4.13058485139022,0.0,20.0
25215,2,5215,[318 496 588  98 357],796,5,21546,4.130751533742331,40.0,0.0
25216,2,5216,[196 483 185 187 180],796,4,21550,4.130726471152003,0.0,0.0
25217,2,5217,[ 22 265 405 111   4],655,0,21550,4.129934840935224,0.0,0.0
25218,2,5218,[475 210 100  64 186],389,3,21553,4.129718336846139,20.0,20.0
25219,2,5219,[597 423 185 183 144],457,4,21557,4.129693486590038,0.0,0.0
25220,2,5220,[318 496 588  98 357],18,5,21562,4.1298601800421375,40.0,0.0
25221,2,5221,[318 496 588  98 357],18,5,21567,4.130026809651475,40.0,0.0
25222,2,5222,[211 132 175  98   7],151,5,21572,4.130193375454719,0.0,0.0
25223,2,5223,[187 301 175 222 143],655,2,21574,4.1297856049004595,0.0,0.0
25224,2,5224,[ 56 496 202 385 118],577,3,21577,4.129569377990431,20.0,0.0
25225,2,5225,[161 216 568 427 168],796,5,21582,4.129735935706085,20.0,0.0
25226,2,5226,[475  71 185 588  50],389,5,21587,4.129902429691984,0.0,20.0
25227,2,5227,[318 496 588  98 357],330,5,21592,4.130068859984698,40.0,0.0
25228,2,5228,[318 496 588  98 357],18,5,21597,4.130235226620769,40.0,0.0
25229,2,5229,[302  98  28 222 183],450,4,21601,4.130210325047801,0.0,0.0
25230,2,5230,[318 496 588  98 357],330,5,21606,4.1303766010323075,40.0,0.0
25231,2,5231,[ 97 748  70 385   9],151,3,21609,4.130160550458716,0.0,0.0
25232,2,5232,[568 111 276 427   9],269,3,21612,4.129944582457481,20.0,0.0
25233,2,5233,[191 357 245 168 204],450,5,21617,4.130110813909056,0.0,0.0
25234,2,5234,[288 328 175  15 200],655,1,21618,4.129512893982808,0.0,0.0
25235,2,5235,[318 496 588  98 357],796,5,21623,4.129679144385027,40.0,0.0
25236,2,5236,[235  98 151 435 427],5,2,21625,4.129272484246706,20.0,0.0
25237,2,5237,[318 496 588  98 357],450,5,21630,4.1294387170675835,40.0,0.0
25238,2,5238,[318 496 588  98 357],330,5,21635,4.129604886428708,40.0,0.0
25239,2,5239,[318 496 588  98 357],330,5,21640,4.129770992366412,40.0,0.0
25240,2,5240,[318 496 588  98 357],450,5,21645,4.129937034917001,40.0,0.0
25241,2,5241,[318 496 588  98 357],450,5,21650,4.13010301411675,40.0,0.0
25242,2,5242,[135 300 210  15 435],629,5,21655,4.1302689300019075,0.0,0.0
25243,2,5243,[200  97  96 357 132],655,2,21657,4.129862700228833,0.0,0.0
25244,2,5244,[210 222 196 405 265],72,3,21660,4.129647283126787,0.0,0.0
25245,2,5245,[234 385 183 161 237],577,4,21664,4.129622569576821,0.0,0.0
25246,2,5246,[318 496 588  98 357],786,5,21669,4.129788450543168,40.0,0.0
25247,2,5247,[318 496 588  98 357],786,5,21674,4.129954268292683,40.0,0.0
25248,2,5248,[180  69 423 427 323],796,3,21677,4.129738997904362,20.0,0.0
25249,2,5249,[186  88 204 257 181],716,4,21681,4.129714285714286,0.0,0.0
25250,2,5250,[385  50 496 143 172],151,4,21685,4.129689582936583,20.0,20.0
25251,2,5251,[318 496 588  98 357],716,5,21690,4.12985529322163,40.0,0.0
25252,2,5252,[318 496 588  98 357],18,5,21695,4.130020940415001,40.0,0.0
25253,2,5253,[328 238 168  12 111],796,4,21699,4.129996193376475,0.0,0.0
25254,2,5254,[546 301 215  88 427],151,3,21702,4.129781160799239,20.0,0.0
25255,2,5255,[176 234 228 195  56],352,4,21706,4.129756468797565,0.0,0.0
25256,2,5256,[318 496 588  98 357],18,5,21711,4.1299220087502375,40.0,0.0
25257,2,5257,[318 496 588  98 357],18,5,21716,4.130087485736022,40.0,0.0
25258,2,5258,[276 172 318 286  69],786,4,21720,4.130062749572162,20.0,20.0
25259,2,5259,[318 496 588  98 357],796,5,21725,4.130228136882129,40.0,0.0
25260,2,5260,[186 194   1   7 286],535,3,21728,4.130013305455237,0.0,20.0
25261,2,5261,[318 496 588  98 357],330,5,21733,4.130178639300646,40.0,0.0
25262,2,5262,[318 496 588  98 357],450,5,21738,4.130343910317309,40.0,0.0
25263,2,5263,[143 121 238 568  79],796,4,21742,4.13031914893617,0.0,0.0
25264,2,5264,[385 273 471  25  22],655,1,21743,4.129724596391263,0.0,0.0
25265,2,5265,[302 318 301 111  70],655,2,21745,4.129320167109761,20.0,0.0
25266,2,5266,[318 496 588  98 357],796,5,21750,4.12948547560281,40.0,0.0
25267,2,5267,[318 496 588  98 357],786,5,21755,4.129650721336371,40.0,0.0
25268,2,5268,[318 496 588  98 357],18,5,21760,4.1298159043461755,40.0,0.0
25269,2,5269,[  8   4 117 546 210],280,3,21763,4.129601518026566,0.0,0.0
25270,2,5270,[318 496 588  98 357],18,5,21768,4.129766647694934,40.0,0.0
25271,2,5271,[318 496 588  98 357],330,5,21773,4.129931714719271,40.0,0.0
25272,2,5272,[286 144 385 333 357],796,4,21777,4.1299070737720465,0.0,20.0
25273,2,5273,[318 496 588  98 357],796,5,21782,4.130072051573758,40.0,0.0
25274,2,5274,[186  64 135 202 210],269,2,21784,4.1296682464454975,20.0,0.0
25275,2,5275,[318 496 588  98 357],716,5,21789,4.129833206974981,40.0,0.0
25276,2,5276,[ 12  79 748 286  15],11,3,21792,4.129619101762365,0.0,20.0
25277,2,5277,[196 197 191  69 183],269,2,21794,4.1292156119742325,0.0,0.0
25278,2,5278,[289  70  25 187 238],655,1,21795,4.12862284523584,0.0,0.0
25279,2,5279,[318 496 588  98 357],18,5,21800,4.128787878787879,40.0,0.0
25280,2,5280,[ 50  70 269 237 234],655,1,21801,4.128195417534558,0.0,20.0
25281,2,5281,[318 496 588  98 357],18,5,21806,4.128360469519121,40.0,0.0
25282,2,5282,[318 496 588  98 357],450,5,21811,4.128525459019497,40.0,0.0
25283,2,5283,[211  69 200  96 568],796,4,21815,4.128501135503407,0.0,0.0
25284,2,5284,[318 496 588  98 357],796,5,21820,4.128666035950804,40.0,0.0
25285,2,5285,[183 269 403 144 748],796,4,21824,4.128641695043511,0.0,0.0
25286,2,5286,[318 496 588  98 357],796,5,21829,4.128806506525439,40.0,0.0
25287,2,5287,[318 496 588  98 357],330,5,21834,4.128971255673222,40.0,0.0
25288,2,5288,[ 12 153 403  97  56],18,4,21838,4.128946870864057,0.0,0.0
25289,2,5289,[318 496 588  98 357],786,5,21843,4.129111531190926,40.0,0.0
25290,2,5290,[132 195 471 258 180],693,3,21846,4.128898128898129,0.0,0.0
25291,2,5291,[318 496 588  98 357],786,5,21851,4.129062736205594,40.0,0.0
25292,2,5292,[125 181 322 403  82],280,1,21852,4.1284715662195355,0.0,0.0
25293,2,5293,[318 496 588  98 357],18,5,21857,4.128636191915376,40.0,0.0
25294,2,5294,[132 135 427 127 191],236,4,21861,4.128611898016997,20.0,20.0
25295,2,5295,[318 496 588  98 357],330,5,21866,4.128776435045317,40.0,0.0
25296,2,5296,[216 197   8  71  69],18,4,21870,4.128752123843685,0.0,0.0
25297,2,5297,[  7 151 117 496 144],450,5,21875,4.1289165722914305,20.0,0.0
25298,2,5298,[196 269 100  89  56],450,5,21880,4.129080958671447,0.0,20.0
25299,2,5299,[318 496 588  98 357],716,5,21885,4.129245283018868,40.0,0.0
25300,2,5300,[ 56 127 135 427 176],693,4,21889,4.129220901716657,20.0,20.0
25301,2,5301,[276 234 403  69   9],655,1,21890,4.128630705394191,0.0,0.0
25302,2,5302,[318 496 588  98 357],786,5,21895,4.128795021685838,40.0,0.0
25303,2,5303,[318 496 588  98 357],796,5,21900,4.1289592760181,40.0,0.0
25304,2,5304,[483  82 176 265 197],450,3,21903,4.128746465598492,0.0,0.0
25305,2,5305,[322 100  71 202 183],504,3,21906,4.128533735393893,0.0,20.0
25306,2,5306,[318 496 588  98 357],716,5,21911,4.128697946108913,40.0,0.0
25307,2,5307,[135 191 202  22  50],716,4,21915,4.128673700075358,0.0,20.0
25308,2,5308,[318 496 588  98 357],18,5,21920,4.128837822565455,40.0,0.0
25309,2,5309,[318 496 588  98 357],450,5,21925,4.129001883239171,40.0,0.0
25310,2,5310,[357 197 187 151 174],18,4,21929,4.128977593673508,0.0,0.0
25311,2,5311,[318 496 588  98 357],796,5,21934,4.12914156626506,40.0,0.0
25312,2,5312,[318 496 588  98 357],716,5,21939,4.129305477131564,40.0,0.0
25313,2,5313,[186  15 183 127  79],623,3,21942,4.129092961987204,0.0,20.0
25314,2,5314,[185 258 161 111 603],655,2,21944,4.128692380056444,20.0,0.0
25315,2,5315,[153 655 403 282  71],280,2,21946,4.128291948833709,0.0,0.0
25316,2,5316,[ 12 132  89 143 125],151,5,21951,4.128455896182057,0.0,0.0
25317,2,5317,[318 496 588  98 357],796,5,21956,4.128619781872884,40.0,0.0
25318,2,5318,[200 483 174 111 265],236,2,21958,4.128219590148524,0.0,0.0
25319,2,5319,[132  56 405  96  88],269,2,21960,4.12781954887218,0.0,0.0
25320,2,5320,[318 496 588  98 357],786,5,21965,4.127983461755309,40.0,0.0
25321,2,5321,[194 127 202 174  97],796,4,21969,4.127959413754228,0.0,20.0
25322,2,5322,[318 496 588  98 357],330,5,21974,4.128123238775127,40.0,0.0
25323,2,5323,[210  79  28 195 357],796,3,21977,4.127911344853493,0.0,0.0
25324,2,5324,[204 195 183 173 678],344,4,21981,4.1278873239436615,0.0,0.0
25325,2,5325,[318 496 588  98 357],796,5,21986,4.128051070221555,40.0,0.0
25326,2,5326,[318 496 588  98 357],796,5,21991,4.128214755021588,40.0,0.0
25327,2,5327,[302  15 200  56 143],151,3,21994,4.128003003003003,0.0,0.0
25328,2,5328,[318 496 588  98 357],716,5,21999,4.128166635391255,40.0,0.0
25329,2,5329,[318 496 588  98 357],450,5,22004,4.128330206378987,40.0,0.0
25330,2,5330,[318 496 588  98 357],796,5,22009,4.12849371600075,40.0,0.0
25331,2,5331,[318 496 588  98 357],786,5,22014,4.128657164291073,40.0,0.0
25332,2,5332,[357 318 173 300 333],796,5,22019,4.128820551284456,20.0,0.0
25333,2,5333,[183 222   4 173 655],457,5,22024,4.128983877015373,0.0,0.0
25334,2,5334,[318 496 588  98 357],796,5,22029,4.129147141518276,40.0,0.0
25335,2,5335,[ 95 234 228 318 151],450,3,22032,4.128935532233883,20.0,0.0
25336,2,5336,[318 496 588  98 357],716,5,22037,4.129098744613079,40.0,0.0
25337,2,5337,[318 496 588  98 357],330,5,22042,4.129261895841139,40.0,0.0
25338,2,5338,[318 496 588  98 357],450,5,22047,4.129424985952426,40.0,0.0
25339,2,5339,[318 496 588  98 357],716,5,22052,4.129588014981273,40.0,0.0
25340,2,5340,[300 245 182   4 173],629,3,22055,4.129376521250702,0.0,0.0
25341,2,5341,[313 235  70 186 183],450,3,22058,4.12916510670161,0.0,0.0
25342,2,5342,[228  50 181 187  96],796,5,22063,4.129328092831742,0.0,20.0
25343,2,5343,[328 202 182 271  64],796,5,22068,4.129491017964072,20.0,0.0
25344,2,5344,[ 82  71  28 245 471],450,3,22071,4.129279700654817,0.0,0.0
25345,2,5345,[318 496 588  98 357],18,5,22076,4.129442573887018,40.0,0.0
25346,2,5346,[318 496 588  98 357],796,5,22081,4.129605386197868,40.0,0.0
25347,2,5347,[191 186 405 300 118],151,2,22083,4.1292071802543004,0.0,0.0
25348,2,5348,[318 496 588  98 357],450,5,22088,4.129369975696392,40.0,0.0
25349,2,5349,[318 496 588  98 357],716,5,22093,4.129532710280374,40.0,0.0
25350,2,5350,[185 216 318 483  50],693,3,22096,4.129321622126706,20.0,20.0
25351,2,5351,[200 179 228 276 204],655,3,22099,4.1291106128550075,0.0,0.0
25352,2,5352,[318 496 588  98 357],716,5,22104,4.12927330468896,40.0,0.0
25353,2,5353,[318 496 588  98 357],716,5,22109,4.1294359357489725,40.0,0.0
25354,2,5354,[318 238  11 288 191],457,5,22114,4.129598506069095,20.0,0.0
25355,2,5355,[385   9  25 276 182],655,2,22116,4.129200896191187,0.0,0.0
25356,2,5356,[318 496 588  98 357],716,5,22121,4.129363449691992,40.0,0.0
25357,2,5357,[318 496 588  98 357],330,5,22126,4.129525942515864,40.0,0.0
25358,2,5358,[ 11 483 546 238 403],457,4,22130,4.129501772718791,0.0,0.0
25359,2,5359,[318 496 588  98 357],796,5,22135,4.129664179104478,40.0,0.0
25360,2,5360,[173 568 117 357  96],457,5,22140,4.129826524902071,0.0,0.0
25361,2,5361,[ 64 322 271 333 197],629,4,22144,4.129802312569937,20.0,0.0
25362,2,5362,[318 496 588  98 357],796,5,22149,4.129964572067872,40.0,0.0
25363,2,5363,[318 496 588  98 357],786,5,22154,4.130126771066369,40.0,0.0
25364,2,5364,[318 496 588  98 357],796,5,22159,4.130288909599255,40.0,0.0
25365,2,5365,[282 228  50 211 286],655,1,22160,4.1297055534849045,0.0,40.0
25366,2,5366,[302 179 118 121 271],655,2,22162,4.129308738587666,0.0,0.0
25367,2,5367,[318 496 588  98 357],450,5,22167,4.129470938897168,40.0,0.0
25368,2,5368,[318 496 588  98 357],450,5,22172,4.129633078785621,40.0,0.0
25369,2,5369,[318 496 588  98 357],18,5,22177,4.129795158286778,40.0,0.0
25370,2,5370,[318 496 588  98 357],330,5,22182,4.1299571774343695,40.0,0.0
25371,2,5371,[216 405 471 655 302],655,2,22184,4.129560685033507,0.0,0.0
25372,2,5372,[318 496 588  98 357],18,5,22189,4.129722687511633,40.0,0.0
25373,2,5373,[318 496 588  98 357],330,5,22194,4.129884629698549,40.0,0.0
25374,2,5374,[318 496 588  98 357],796,5,22199,4.130046511627907,40.0,0.0
25375,2,5375,[  1 144 182 471 183],280,1,22200,4.129464285714286,0.0,0.0
25376,2,5376,[318 496 588  98 357],450,5,22205,4.129626185605356,40.0,0.0
25377,2,5377,[318 496 588  98 357],716,5,22210,4.129788025288211,40.0,0.0
25378,2,5378,[318 496 588  98 357],716,5,22215,4.12994980479643,40.0,0.0
25379,2,5379,[182 210 132 180 161],457,5,22220,4.130111524163569,0.0,0.0
25380,2,5380,[ 88 118  71 191 258],798,4,22224,4.130087344359785,0.0,0.0
25381,2,5381,[ 95 546 603 313  50],796,5,22229,4.130248978075065,20.0,20.0
25382,2,5382,[318 496 588  98 357],716,5,22234,4.13041055173695,40.0,0.0
25383,2,5383,[111 197  15 275 132],151,5,22239,4.1305720653789,0.0,20.0
25384,2,5384,[235 568 742 423  98],280,4,22243,4.130547818012999,0.0,0.0
25385,2,5385,[191 302 174 405 300],655,2,22245,4.130152246565169,0.0,0.0
25386,2,5386,[318 496 588  98 357],450,5,22250,4.130313718210507,40.0,0.0
25387,2,5387,[275 185 322 269 234],450,4,22254,4.130289532293987,0.0,20.0
25388,2,5388,[216  70  12 144 117],457,5,22259,4.130450918537762,0.0,0.0
25389,2,5389,[318 496 588  98 357],18,5,22264,4.130612244897959,40.0,0.0
25390,2,5390,[318 496 588  98 357],796,5,22269,4.130773511407902,40.0,0.0
25391,2,5391,[318 496 588  98 357],786,5,22274,4.130934718100891,40.0,0.0
25392,2,5392,[515 318 174  15  64],878,4,22278,4.130910439458558,40.0,0.0
25393,2,5393,[318 496 588  98 357],330,5,22283,4.131071560993696,40.0,0.0
25394,2,5394,[318 496 588  98 357],716,5,22288,4.131232622798888,40.0,0.0
25395,2,5395,[385  79 678 435 265],807,3,22291,4.1310229799851745,0.0,0.0
25396,2,5396,[568 135 357  11  69],269,2,22293,4.130628126737077,0.0,0.0
25397,2,5397,[318 496 588  98 357],786,5,22298,4.130789181178214,40.0,0.0
25398,2,5398,[318 496 588  98 357],18,5,22303,4.130950175958511,40.0,0.0
25399,2,5399,[286 186 302 179  71],450,3,22306,4.130740740740741,0.0,20.0
25400,2,5400,[546 117 678 234 405],807,3,22309,4.130531383077208,0.0,0.0
25401,2,5401,[318 496 588  98 357],330,5,22314,4.130692336171788,40.0,0.0
25402,2,5402,[403 269 238  71 273],450,3,22317,4.130483064963909,0.0,0.0
25403,2,5403,[ 28 597 748 603 200],450,4,22321,4.130458919319023,20.0,0.0
25404,2,5404,[318 496 588  98 357],450,5,22326,4.130619796484736,40.0,0.0
25405,2,5405,[318 496 588  98 357],18,5,22331,4.130780614132445,40.0,0.0
25406,2,5406,[318 496 588  98 357],450,5,22336,4.130941372295173,40.0,0.0
25407,2,5407,[117 161 300 143 100],796,4,22340,4.130917159763314,0.0,20.0
25408,2,5408,[318 496 588  98 357],716,5,22345,4.131077833240894,40.0,0.0
25409,2,5409,[318 496 588  98 357],450,5,22350,4.131238447319778,40.0,0.0
25410,2,5410,[185 196 357 153 182],655,3,22353,4.131029384586952,0.0,0.0
25411,2,5411,[118  50  71 301 186],450,2,22355,4.130635624538064,0.0,20.0
25412,2,5412,[318 496 588  98 357],330,5,22360,4.13079623129503,40.0,0.0
25413,2,5413,[318 496 588  98 357],18,5,22365,4.130956778721832,40.0,0.0
25414,2,5414,[ 79 185  25 496 286],450,4,22369,4.130932594644506,20.0,20.0
25415,2,5415,[318 496 588  98 357],330,5,22374,4.13109305760709,40.0,0.0
25416,2,5416,[318 496 588  98 357],716,5,22379,4.131253461325457,40.0,0.0
25417,2,5417,[496 151 276 174 268],344,4,22383,4.131229235880399,20.0,0.0
25418,2,5418,[323  88 588  12 204],796,4,22387,4.131205019376269,0.0,0.0
25419,2,5419,[318 496 588  98 357],796,5,22392,4.131365313653137,40.0,0.0
25420,2,5420,[318 496 588  98 357],716,5,22397,4.1315255487917355,40.0,0.0
25421,2,5421,[ 70  82 294 181 238],655,0,22397,4.130763555883438,0.0,0.0
25422,2,5422,[318 496 588  98 357],796,5,22402,4.130923842891389,40.0,0.0
25423,2,5423,[176 125 286 405 202],344,2,22404,4.130530973451328,0.0,20.0
25424,2,5424,[318 496 588  98 357],796,5,22409,4.130691244239632,40.0,0.0
25425,2,5425,[318 496 588  98 357],716,5,22414,4.130851455952819,40.0,0.0
25426,2,5426,[117 222 294 196 179],655,1,22415,4.130274553160126,0.0,0.0
25427,2,5427,[318 496 588  98 357],450,5,22420,4.130434782608695,40.0,0.0
25428,2,5428,[323  82 202 282 182],796,3,22423,4.130226561060969,0.0,0.0
25429,2,5429,[318 496 588  98 357],450,5,22428,4.130386740331492,40.0,0.0
25430,2,5430,[286 385 302  69 655],655,1,22429,4.129810348002209,0.0,20.0
25431,2,5431,[181 333 323 357 216],796,4,22433,4.129786450662739,0.0,0.0
25432,2,5432,[318 496 588  98 357],330,5,22438,4.129946622492177,40.0,0.0
25433,2,5433,[132 245  79 210 121],796,3,22441,4.129738682370261,0.0,0.0
25434,2,5434,[318 496 588  98 357],330,5,22446,4.129898804047838,40.0,0.0
25435,2,5435,[111 153 234   8 268],269,1,22447,4.129323031640912,0.0,0.0
25436,2,5436,[238 234 385 748 588],450,4,22451,4.12929924590767,0.0,0.0
25437,2,5437,[678 161 286 200 222],280,3,22454,4.1290915777859505,0.0,20.0
25438,2,5438,[210 546 194 234 318],796,3,22457,4.128883986026843,20.0,0.0
25439,2,5439,[318 496 588  98 357],786,5,22462,4.129044117647059,40.0,0.0
25440,2,5440,[318 313 427 182 603],796,5,22467,4.129204190406175,60.0,0.0
25441,2,5441,[318 496 588  98 357],716,5,22472,4.129364204336641,40.0,0.0
25442,2,5442,[318 496 588  98 357],796,5,22477,4.12952415947088,40.0,0.0
25443,2,5443,[318 496 588  98 357],450,5,22482,4.1296840558412935,40.0,0.0
25444,2,5444,[318 496 588  98 357],18,5,22487,4.129843893480257,40.0,0.0
25445,2,5445,[176 194 153  98 180],796,4,22491,4.129820051413882,0.0,0.0
25446,2,5446,[237 385 265  71 204],577,5,22496,4.129979805397467,0.0,0.0
25447,2,5447,[318 496 588  98 357],330,5,22501,4.130139500734215,40.0,0.0
25448,2,5448,[  4  89  96 322 127],450,4,22505,4.1301156175445035,0.0,20.0
25449,2,5449,[318 496 588  98 357],18,5,22510,4.130275229357798,40.0,0.0
25450,2,5450,[237 132  15 265  69],450,4,22514,4.130251330031187,0.0,0.0
25451,2,5451,[318 496 588  98 357],18,5,22519,4.1304108584005865,40.0,0.0
25452,2,5452,[183 121 176 173 100],269,1,22520,4.129836787089675,0.0,20.0
25453,2,5453,[603 168 204  70   8],11,3,22523,4.12962962962963,20.0,0.0
25454,2,5454,[318 496 588  98 357],18,5,22528,4.129789184234647,40.0,0.0
25455,2,5455,[161 172 118 168 238],796,4,22532,4.129765395894428,0.0,0.0
25456,2,5456,[153  98  50 678 257],504,3,22535,4.129558365402236,0.0,20.0
25457,2,5457,[200 300  88 125 678],504,4,22539,4.12953462806889,0.0,0.0
25458,2,5458,[318 496 588  98 357],786,5,22544,4.129694083165415,40.0,0.0
25459,2,5459,[318 496 588  98 357],786,5,22549,4.12985347985348,40.0,0.0
25460,2,5460,[172 216 435 265 427],878,4,22553,4.129829701519868,20.0,0.0
25461,2,5461,[302 132 185 238 211],450,5,22558,4.129989015012816,0.0,0.0
25462,2,5462,[318 496 588  98 357],18,5,22563,4.130148270181219,40.0,0.0
25463,2,5463,[318 496 588  98 357],786,5,22568,4.130307467057101,40.0,0.0
25464,2,5464,[258  25 302 294 100],2,3,22571,4.130100640439158,0.0,20.0
25465,2,5465,[318 496 588  98 357],18,5,22576,4.130259787778997,40.0,0.0
25466,2,5466,[ 69 385  64 125 258],151,4,22580,4.130235961221877,20.0,0.0
25467,2,5467,[427  50 282  89  12],655,3,22583,4.130029261155816,20.0,20.0
25468,2,5468,[ 79 100 275 172 238],18,4,22587,4.1300054854635215,0.0,40.0
25469,2,5469,[318 496 588  98 357],330,5,22592,4.130164533820841,40.0,0.0
25470,2,5470,[ 28 546 144 603 125],450,5,22597,4.130323524035825,20.0,0.0
25471,2,5471,[318 496 588  98 357],786,5,22602,4.130482456140351,40.0,0.0
25472,2,5472,[318 496 588  98 357],18,5,22607,4.130641330166271,40.0,0.0
25473,2,5473,[318 496 588  98 357],786,5,22612,4.130800146145415,40.0,0.0
25474,2,5474,[318 496 588  98 357],796,5,22617,4.130958904109589,40.0,0.0
25475,2,5475,[588 176 269  50 204],450,5,22622,4.131117604090577,0.0,20.0
25476,2,5476,[318 496 588  98 357],796,5,22627,4.131276246120139,40.0,0.0
25477,2,5477,[318 496 588  98 357],716,5,22632,4.131434830230011,40.0,0.0
25478,2,5478,[496 275 151 603 318],535,5,22637,4.131593356451908,60.0,20.0
25479,2,5479,[ 12   8  82  50 185],655,2,22639,4.1312043795620434,0.0,20.0
25480,2,5480,[318 496 588  98 357],18,5,22644,4.1313628899835795,40.0,0.0
25481,2,5481,[318 496 588  98 357],330,5,22649,4.131521342575702,40.0,0.0
25482,2,5482,[127 132 161 282 588],280,4,22653,4.131497355462338,0.0,20.0
25483,2,5483,[  7 300 276 234 117],292,4,22657,4.131473377097009,0.0,0.0
25484,2,5484,[471  88 195   1   7],786,5,22662,4.1316317228805834,0.0,0.0
25485,2,5485,[176 742 328 427 357],450,5,22667,4.13179001093693,20.0,0.0
25486,2,5486,[318 496 588  98 357],330,5,22672,4.1319482412976125,40.0,0.0
25487,2,5487,[111 265 172 222 385],280,3,22675,4.131741982507289,0.0,0.0
25488,2,5488,[237 300 151  97 216],716,5,22680,4.131900163964292,0.0,0.0
25489,2,5489,[318 496 588  98 357],18,5,22685,4.132058287795993,40.0,0.0
25490,2,5490,[ 70 121 211 132   4],655,0,22685,4.131305773083227,0.0,0.0
25491,2,5491,[100 237 211 258  56],65,2,22687,4.130917698470503,0.0,20.0
25492,2,5492,[100  97 195 276   9],655,1,22688,4.130347715273985,0.0,20.0
25493,2,5493,[238  50 175 183 496],269,3,22691,4.130141973061522,20.0,20.0
25494,2,5494,[  4 275  69 172 175],344,4,22695,4.130118289353958,0.0,20.0
25495,2,5495,[153  69  64 143 257],401,1,22696,4.129548762736536,20.0,0.0
25496,2,5496,[318 496 588  98 357],330,5,22701,4.129707112970712,40.0,0.0
25497,2,5497,[318 496 588  98 357],716,5,22706,4.129865405602037,40.0,0.0
25498,2,5498,[318 496 588  98 357],18,5,22711,4.130023640661938,40.0,0.0
25499,2,5499,[333 238 118  96 144],655,0,22711,4.129272727272728,0.0,0.0
25500,2,5500,[318 496 588  98 357],18,5,22716,4.129431012543174,40.0,0.0
25501,2,5501,[100 568  28 258 328],796,3,22719,4.129225736095965,0.0,20.0
25502,2,5502,[196 237 194  71 195],450,4,22723,4.129202253316373,0.0,0.0
25503,2,5503,[318 496 588  98 357],450,5,22728,4.129360465116279,40.0,0.0
25504,2,5504,[318 496 588  98 357],450,5,22733,4.129518619436875,40.0,0.0
25505,2,5505,[318 496 588  98 357],330,5,22738,4.129676716309481,40.0,0.0
25506,2,5506,[318 496 588  98 357],716,5,22743,4.12983475576539,40.0,0.0
25507,2,5507,[222 125 175 176 333],655,0,22743,4.129084967320262,0.0,0.0
25508,2,5508,[318 496 588  98 357],786,5,22748,4.129243056816119,40.0,0.0
25509,2,5509,[318 496 588  98 357],716,5,22753,4.129401088929219,40.0,0.0
25510,2,5510,[135 187 117 427   7],693,4,22757,4.129377608419524,20.0,0.0
25511,2,5511,[318 496 588  98 357],716,5,22762,4.129535558780842,40.0,0.0
25512,2,5512,[318 496 588  98 357],716,5,22767,4.129693451841103,40.0,0.0
25513,2,5513,[144 237 258  89 187],655,2,22769,4.129307217990569,0.0,0.0
25514,2,5514,[318 496 588  98 357],796,5,22774,4.129465095194923,40.0,0.0
25515,2,5515,[258 194 144 196 125],796,5,22779,4.1296229151559105,0.0,0.0
25516,2,5516,[161 175 196 385 118],716,1,22780,4.12905564618452,0.0,0.0
25517,2,5517,[318 496 588  98 357],450,5,22785,4.129213483146067,40.0,0.0
25518,2,5518,[174  89 216 245 300],796,4,22789,4.129190070664976,0.0,0.0
25519,2,5519,[318 496 588  98 357],786,5,22794,4.129347826086956,40.0,0.0
25520,2,5520,[318 496 588  98 357],716,5,22799,4.129505524361528,40.0,0.0
25521,2,5521,[318 496 588  98 357],450,5,22804,4.129663165519739,40.0,0.0
25522,2,5522,[318 496 588  98 357],330,5,22809,4.1298207495926125,40.0,0.0
25523,2,5523,[118 153 288   7  98],655,1,22810,4.129254163649529,0.0,0.0
25524,2,5524,[318 496 588  98 357],450,5,22815,4.129411764705883,40.0,0.0
25525,2,5525,[318 496 588  98 357],330,5,22820,4.129569308722403,40.0,0.0
25526,2,5526,[318 496 588  98 357],330,5,22825,4.129726795730052,40.0,0.0
25527,2,5527,[318 496 588  98 357],18,5,22830,4.129884225759769,40.0,0.0
25528,2,5528,[269 222 143 273  28],655,2,22832,4.129499005245071,0.0,0.0
25529,2,5529,[127 435 234 228 194],450,4,22836,4.1294755877034355,0.0,20.0
25530,2,5530,[100 132  98 175 161],269,4,22840,4.129452178629543,0.0,20.0
25531,2,5531,[313 546 385 121  79],503,3,22843,4.129248011569053,0.0,0.0
25532,2,5532,[318 496 588  98 357],18,5,22848,4.129405385866619,40.0,0.0
25533,2,5533,[ 11   8 475 286 234],655,0,22848,4.128659197687026,0.0,20.0
25534,2,5534,[318 496 588  98 357],450,5,22853,4.128816621499548,40.0,0.0
25535,2,5535,[318 496 588  98 357],450,5,22858,4.128973988439307,40.0,0.0
25536,2,5536,[273 176 427 245 568],796,3,22861,4.128770092107639,20.0,0.0
25537,2,5537,[176 186 655 161 568],796,3,22864,4.12856626941134,0.0,0.0
25538,2,5538,[318 496 588  98 357],786,5,22869,4.128723596317025,40.0,0.0
25539,2,5539,[318 496 588  98 357],18,5,22874,4.128880866425993,40.0,0.0
25540,2,5540,[385 100 405 423 258],23,4,22878,4.128857606930157,0.0,20.0
25541,2,5541,[181  79 286 211 180],450,5,22883,4.12901479610249,0.0,20.0
25542,2,5542,[228 144 211 180 132],716,3,22886,4.128811113115641,0.0,0.0
25543,2,5543,[318 496 588  98 357],330,5,22891,4.128968253968254,40.0,0.0
25544,2,5544,[ 22 185 161 515 301],655,2,22893,4.12858431018936,0.0,0.0
25545,2,5545,[318 496 588  98 357],716,5,22898,4.128741435268662,40.0,0.0
25546,2,5546,[269 328 294 117  56],796,3,22901,4.128537948440599,0.0,0.0
25547,2,5547,[678 275 121 323 111],938,3,22904,4.128334534967556,0.0,20.0
25548,2,5548,[216 186 200 168  50],796,4,22908,4.128311407460804,0.0,20.0
25549,2,5549,[385 216  70 546 174],151,3,22911,4.128108108108108,0.0,0.0
25550,2,5550,[328 183 118 301 385],796,4,22915,4.128085029724374,0.0,0.0
25551,2,5551,[318 496 588  98 357],450,5,22920,4.128242074927954,40.0,0.0
25552,2,5552,[318 496 588  98 357],18,5,22925,4.128399063569242,40.0,0.0
25553,2,5553,[187   4 269 195  96],796,4,22929,4.128375945264674,0.0,0.0
25554,2,5554,[318 496 588  98 357],796,5,22934,4.1285328532853285,40.0,0.0
25555,2,5555,[302 143 568 144 405],655,2,22936,4.128149748020158,0.0,0.0
25556,2,5556,[228 195 204  79  15],655,1,22937,4.12758682742487,0.0,0.0
25557,2,5557,[  7 197  98  82  89],911,3,22940,4.127383951061533,0.0,0.0
25558,2,5558,[318 496 588  98 357],450,5,22945,4.127540924626731,40.0,0.0
25559,2,5559,[318 496 588  98 357],796,5,22950,4.127697841726619,40.0,0.0
25560,2,5560,[318 496 588  98 357],330,5,22955,4.127854702391656,40.0,0.0
25561,2,5561,[125 191 546 237 483],796,5,22960,4.128011506652284,0.0,0.0
25562,2,5562,[318 496 588  98 357],716,5,22965,4.128168254538918,40.0,0.0
25563,2,5563,[597 200 588   1 286],796,3,22968,4.127965492451474,0.0,20.0
25564,2,5564,[196 125 179 286 111],450,5,22973,4.1281221922731355,0.0,20.0
25565,2,5565,[127 423  50 118 151],450,4,22977,4.128099173553719,0.0,40.0
25566,2,5566,[ 50   7  25 423 742],655,1,22978,4.127537273217173,0.0,20.0
25567,2,5567,[318 496 588  98 357],18,5,22983,4.127693965517241,40.0,0.0
25568,2,5568,[ 79 200 302 197 237],655,3,22986,4.127491470641049,0.0,0.0
25569,2,5569,[318 496 588  98 357],716,5,22991,4.127648114901257,40.0,0.0
25570,2,5570,[471 182 228 132 153],655,1,22992,4.127086698976845,0.0,0.0
25571,2,5571,[318 496 588  98 357],330,5,22997,4.12724335965542,40.0,0.0
25572,2,5572,[471 235  11 117 322],401,1,22998,4.126682217835995,0.0,0.0
25573,2,5573,[318 496 588  98 357],716,5,23003,4.126838894869035,40.0,0.0
25574,2,5574,[318 496 588  98 357],716,5,23008,4.126995515695067,40.0,0.0
25575,2,5575,[328 210 385 237 357],450,4,23012,4.126972740315638,0.0,0.0
25576,2,5576,[318 496 588  98 357],450,5,23017,4.127129280975435,40.0,0.0
25577,2,5577,[318 496 588  98 357],716,5,23022,4.1272857655073505,40.0,0.0
25578,2,5578,[318 496 588  98 357],716,5,23027,4.127442193941566,40.0,0.0
25579,2,5579,[181 117  15 187 385],796,5,23032,4.127598566308244,0.0,0.0
25580,2,5580,[ 64 238 172  70 151],716,5,23037,4.12775488263752,20.0,0.0
25581,2,5581,[318 496 588  98 357],716,5,23042,4.127911142959513,40.0,0.0
25582,2,5582,[318 496 588  98 357],716,5,23047,4.128067347304317,40.0,0.0
25583,2,5583,[423 132 216  82 117],655,1,23048,4.1275071633237825,0.0,0.0
25584,2,5584,[748 471   4 195 568],280,0,23048,4.1267681289167415,0.0,0.0
25585,2,5585,[318 496 588  98 357],18,5,23053,4.126924453992123,40.0,0.0
25586,2,5586,[118   7 588  56 403],577,2,23055,4.126543762305352,0.0,0.0
25587,2,5587,[318 496 588  98 357],796,5,23060,4.126700071581961,40.0,0.0
25588,2,5588,[ 15 588  88 300   1],796,4,23064,4.1266774020397206,0.0,0.0
25589,2,5589,[318 496 588  98 357],18,5,23069,4.126833631484795,40.0,0.0
25590,2,5590,[328  70 258   7  98],65,2,23071,4.126453228402791,0.0,0.0
25591,2,5591,[318 496 588  98 357],18,5,23076,4.126609442060086,40.0,0.0
25592,2,5592,[318 496 588  98 357],18,5,23081,4.126765599856964,40.0,0.0
25593,2,5593,[276 235  96 282 195],256,2,23083,4.126385412942438,0.0,0.0
25594,2,5594,[135 302   9  25   4],535,2,23085,4.126005361930295,0.0,0.0
25595,2,5595,[322 204 302  50 196],450,5,23090,4.126161543959971,0.0,20.0
25596,2,5596,[318 496 588  98 357],330,5,23095,4.126317670180454,40.0,0.0
25597,2,5597,[318 496 588  98 357],450,5,23100,4.126473740621651,40.0,0.0
25598,2,5598,[276 268 204  64 475],655,2,23102,4.1260939453473835,20.0,0.0
25599,2,5599,[318 496 588  98 357],18,5,23107,4.12625,40.0,0.0
25600,2,5600,[318 496 588  98 357],716,5,23112,4.126405998928763,40.0,0.0
25601,2,5601,[301 210 197 191 294],450,4,23116,4.126383434487683,0.0,0.0
25602,2,5602,[176 175  64 257 216],716,3,23119,4.12618240228449,20.0,0.0
25603,2,5603,[318 496 588  98 357],330,5,23124,4.126338329764454,40.0,0.0
25604,2,5604,[318 496 588  98 357],786,5,23129,4.126494201605709,40.0,0.0
25605,2,5605,[ 11  96 568 200  95],280,4,23133,4.126471637531217,0.0,0.0
25606,2,5606,[238 403 174 294 275],457,4,23137,4.126449081505261,0.0,20.0
25607,2,5607,[ 64 121   1 216 211],151,5,23142,4.12660485021398,20.0,0.0
25608,2,5608,[ 82   1  50   9 238],655,1,23143,4.126047423783206,0.0,20.0
25609,2,5609,[318 496 588  98 357],716,5,23148,4.1262032085561495,40.0,0.0
25610,2,5610,[318 496 588  98 357],796,5,23153,4.126358937800749,40.0,0.0
25611,2,5611,[ 28 216 313  98 174],236,4,23157,4.126336421952958,0.0,0.0
25612,2,5612,[318 496 588  98 357],786,5,23162,4.126492071975771,40.0,0.0
25613,2,5613,[318 496 588  98 357],18,5,23167,4.126647666547916,40.0,0.0
25614,2,5614,[ 11 168 403 117 265],457,5,23172,4.12680320569902,0.0,0.0
25615,2,5615,[318 496 588  98 357],450,5,23177,4.126958689458689,40.0,0.0
25616,2,5616,[318 496 588  98 357],18,5,23182,4.127114117856507,40.0,0.0
25617,2,5617,[197  28 282 191 182],655,2,23184,4.126735493058027,0.0,0.0
25618,2,5618,[318 496 588  98 357],796,5,23189,4.126890905855134,40.0,0.0
25619,2,5619,[ 79 265  50 216 215],577,5,23194,4.127046263345195,0.0,20.0
25620,2,5620,[318 496 588  98 357],450,5,23199,4.12720156555773,40.0,0.0
25621,2,5621,[318 496 588  98 357],450,5,23204,4.127356812522234,40.0,0.0
25622,2,5622,[318 496 588  98 357],716,5,23209,4.127512004268184,40.0,0.0
25623,2,5623,[318 496 588  98 357],450,5,23214,4.127667140825036,40.0,0.0
25624,2,5624,[144  89 427 546  71],450,4,23218,4.127644444444444,20.0,0.0
25625,2,5625,[ 15 288 118  28  11],457,5,23223,4.1277995023107,0.0,0.0
25626,2,5626,[318 496 588  98 357],716,5,23228,4.127954505064865,40.0,0.0
25627,2,5627,[185 265 175   7  11],655,1,23229,4.127398720682303,0.0,0.0
25628,2,5628,[546  95 245 603  15],796,4,23233,4.127376088115118,20.0,0.0
25629,2,5629,[235  22 496 127 175],269,3,23236,4.127175843694494,20.0,20.0
25630,2,5630,[318 496 588  98 357],786,5,23241,4.12733084709643,40.0,0.0
25631,2,5631,[318 496 588  98 357],330,5,23246,4.127485795454546,40.0,0.0
25632,2,5632,[318 496 588  98 357],18,5,23251,4.127640688798154,40.0,0.0
25633,2,5633,[318 496 588  98 357],796,5,23256,4.127795527156549,40.0,0.0
25634,2,5634,[258 215   8 405 427],655,1,23257,4.127240461401952,20.0,0.0
25635,2,5635,[318 496 588  98 357],330,5,23262,4.127395315826828,40.0,0.0
25636,2,5636,[318 496 588  98 357],450,5,23267,4.127550115309562,40.0,0.0
25637,2,5637,[318 496 588  98 357],450,5,23272,4.1277048598793895,40.0,0.0
25638,2,5638,[318 496 588  98 357],450,5,23277,4.1278595495655255,40.0,0.0
25639,2,5639,[318 496 588  98 357],450,5,23282,4.128014184397163,40.0,0.0
25640,2,5640,[ 97 216 597  11 186],450,4,23286,4.127991490870413,0.0,0.0
25641,2,5641,[318 496 588  98 357],796,5,23291,4.128146047500886,40.0,0.0
25642,2,5642,[318 496 588  98 357],786,5,23296,4.128300549353181,40.0,0.0
25643,2,5643,[181  82  28   4  70],716,4,23300,4.128277817150956,0.0,0.0
25644,2,5644,[185 282  89 168 234],457,5,23305,4.128432240921169,0.0,0.0
25645,2,5645,[318 496 588  98 357],786,5,23310,4.128586609989373,40.0,0.0
25646,2,5646,[318 496 588  98 357],796,5,23315,4.128740924384629,40.0,0.0
25647,2,5647,[245 238 328 132  11],629,2,23317,4.12836402266289,0.0,0.0
25648,2,5648,[318 496 588  98 357],330,5,23322,4.128518321826872,40.0,0.0
25649,2,5649,[318 496 588  98 357],18,5,23327,4.128672566371681,40.0,0.0
25650,2,5650,[118 435 172  22 180],716,3,23330,4.128472836666077,0.0,0.0
25651,2,5651,[182  56  50 195 181],256,4,23334,4.128450106157112,0.0,20.0
25652,2,5652,[197 323 748 313 117],796,3,23337,4.128250486467363,0.0,0.0
25653,2,5653,[318 496 588  98 357],786,5,23342,4.128404669260701,40.0,0.0
25654,2,5654,[ 50 405 195 204  95],450,4,23346,4.128381962864721,0.0,20.0
25655,2,5655,[318 496 588  98 357],18,5,23351,4.128536067892504,40.0,0.0
25656,2,5656,[318 496 588  98 357],330,5,23356,4.128690118437334,40.0,0.0
25657,2,5657,[151 228  88 121 179],577,2,23358,4.12831389183457,0.0,0.0
25658,2,5658,[318 496 588  98 357],18,5,23363,4.128467927195618,40.0,0.0
25659,2,5659,[127 204 121  70  50],655,2,23365,4.1280918727915195,0.0,40.0
25660,2,5660,[ 12 222   7 176 288],280,3,23368,4.127892598480834,0.0,0.0
25661,2,5661,[318 496 588  98 357],716,5,23373,4.128046626633698,40.0,0.0
25662,2,5662,[318 496 588  98 357],786,5,23378,4.128200600388487,40.0,0.0
25663,2,5663,[313 127 222 294  96],296,4,23382,4.128177966101695,0.0,20.0
25664,2,5664,[423 127 546 385 173],457,4,23386,4.128155339805825,0.0,20.0
25665,2,5665,[ 96 121 153 258  22],796,5,23391,4.1283092128485706,0.0,0.0
25666,2,5666,[435 215 183 187 172],716,3,23394,4.128110111169931,0.0,0.0
25667,2,5667,[151   4 197 423 265],535,3,23397,4.127911079745942,0.0,0.0
25668,2,5668,[174 210   1 215 245],450,4,23401,4.127888516493209,0.0,0.0
25669,2,5669,[318 496 588  98 357],18,5,23406,4.128042328042328,40.0,0.0
25670,2,5670,[118 300 655 357 127],655,2,23408,4.127667078116734,0.0,20.0
25671,2,5671,[318 496 588  98 357],716,5,23413,4.1278208744710865,40.0,0.0
25672,2,5672,[187 202  70 135 508],269,3,23416,4.127622069451789,0.0,0.0
25673,2,5673,[318 496 588  98 357],716,5,23421,4.12777581952767,40.0,0.0
25674,2,5674,[ 56   4 121 257 185],796,5,23426,4.1279295154185025,0.0,0.0
25675,2,5675,[318 496 588  98 357],330,5,23431,4.128083157152925,40.0,0.0
25676,2,5676,[318 496 588  98 357],786,5,23436,4.1282367447595565,40.0,0.0
25677,2,5677,[318 496 588  98 357],786,5,23441,4.128390278266996,40.0,0.0
25678,2,5678,[258   1 471 125 289],655,0,23441,4.12766332100722,0.0,0.0
25679,2,5679,[318 496 588  98 357],796,5,23446,4.127816901408451,40.0,0.0
25680,2,5680,[318 496 588  98 357],786,5,23451,4.1279704277415945,40.0,0.0
25681,2,5681,[318 496 588  98 357],716,5,23456,4.128123900035199,40.0,0.0
25682,2,5682,[318 496 588  98 357],330,5,23461,4.12827731831779,40.0,0.0
25683,2,5683,[294 423  11 288  28],655,0,23461,4.127551020408164,0.0,0.0
25684,2,5684,[318 496 588  98 357],18,5,23466,4.127704485488127,40.0,0.0
25685,2,5685,[318 496 588  98 357],786,5,23471,4.127857896588111,40.0,0.0
25686,2,5686,[161  79  69 294 427],655,2,23473,4.127483734833832,20.0,0.0
25687,2,5687,[318 496 588  98 357],450,5,23478,4.127637130801688,40.0,0.0
25688,2,5688,[289 265 117 282 483],655,1,23479,4.1270873615749695,0.0,0.0
25689,2,5689,[318 496 588  98 357],330,5,23484,4.127240773286467,40.0,0.0
25690,2,5690,[318 496 588  98 357],450,5,23489,4.127394131084168,40.0,0.0
25691,2,5691,[318 496 588  98 357],786,5,23494,4.127547434996487,40.0,0.0
25692,2,5692,[151 678 176 181 117],344,2,23496,4.127173722114878,0.0,0.0
25693,2,5693,[318 496 588  98 357],796,5,23501,4.127327010888655,40.0,0.0
25694,2,5694,[403 161  71 173 187],450,4,23505,4.127304653204566,0.0,0.0
25695,2,5695,[318 496 588  98 357],450,5,23510,4.127457865168539,40.0,0.0
25696,2,5696,[427 179  56 182  15],269,4,23514,4.127435492364402,20.0,0.0
25697,2,5697,[318 496 588  98 357],450,5,23519,4.1275886275886275,40.0,0.0
25698,2,5698,[318 496 588  98 357],330,5,23524,4.127741709071767,40.0,0.0
25699,2,5699,[475 603 144 191 228],655,2,23526,4.127368421052632,20.0,0.0
25700,2,5700,[318 496 588  98 357],716,5,23531,4.127521487458341,40.0,0.0
25701,2,5701,[318 496 588  98 357],796,5,23536,4.127674500175377,40.0,0.0
25702,2,5702,[275 204 185   4  79],535,3,23539,4.127476766614063,0.0,20.0
25703,2,5703,[318 496 588  98 357],330,5,23544,4.127629733520337,40.0,0.0
25704,2,5704,[  1 215 228 269  89],796,3,23547,4.127432077125329,0.0,0.0
25705,2,5705,[127 175 173 282   8],457,5,23552,4.127584998247459,0.0,20.0
25706,2,5706,[132 265 269 245 483],796,3,23555,4.127387418959173,0.0,0.0
25707,2,5707,[318 496 588  98 357],796,5,23560,4.127540294323756,40.0,0.0
25708,2,5708,[318 496 588  98 357],716,5,23565,4.127693116132423,40.0,0.0
25709,2,5709,[153 185 265 181 427],535,4,23569,4.127670753064798,20.0,0.0
25710,2,5710,[318 496 588  98 357],18,5,23574,4.127823498511644,40.0,0.0
25711,2,5711,[318 496 588  98 357],330,5,23579,4.127976190476191,40.0,0.0
25712,2,5712,[318 496 588  98 357],796,5,23584,4.128128828986522,40.0,0.0
25713,2,5713,[ 97   8  89 323 289],756,3,23587,4.127931396569829,0.0,0.0
25714,2,5714,[237 269 100 286 151],796,2,23589,4.12755905511811,0.0,40.0
25715,2,5715,[100  50 174 186 508],269,2,23591,4.127186843946816,0.0,40.0
25716,2,5716,[117 211 228 748 121],450,4,23595,4.127164596816512,0.0,0.0
25717,2,5717,[216  71 215 385  11],330,5,23600,4.127317243791535,0.0,0.0
25718,2,5718,[318 496 588  98 357],18,5,23605,4.127469837384158,40.0,0.0
25719,2,5719,[318 496 588  98 357],786,5,23610,4.1276223776223775,40.0,0.0
25720,2,5720,[318 496 588  98 357],18,5,23615,4.127774864534173,40.0,0.0
25721,2,5721,[318 496 588  98 357],330,5,23620,4.127927298147501,40.0,0.0
25722,2,5722,[427 161 185 174 135],716,3,23623,4.127730211427573,20.0,0.0
25723,2,5723,[385 186 161 144 196],457,5,23628,4.127882599580713,0.0,0.0
25724,2,5724,[318 496 588  98 357],330,5,23633,4.128034934497816,40.0,0.0
25725,2,5725,[318 496 588  98 357],330,5,23638,4.1281872162067765,40.0,0.0
25726,2,5726,[678 288 121  11 204],344,2,23640,4.127815610267156,0.0,0.0
25727,2,5727,[318 496 588  98 357],786,5,23645,4.127967877094972,40.0,0.0
25728,2,5728,[282 238 357  98 181],450,5,23650,4.128120090766277,0.0,0.0
25729,2,5729,[318 496 588  98 357],716,5,23655,4.128272251308901,40.0,0.0
25730,2,5730,[127 125 180 546 111],796,4,23659,4.1282498691327865,0.0,20.0
25731,2,5731,[186 258 182 173   7],457,5,23664,4.128401953942777,0.0,0.0
25732,2,5732,[318 496 588  98 357],18,5,23669,4.1285539856968425,40.0,0.0
25733,2,5733,[318 496 588  98 357],18,5,23674,4.128705964422742,40.0,0.0
25734,2,5734,[294  70 161 181 471],457,4,23678,4.128683522231909,0.0,0.0
25735,2,5735,[568 100 742  28 222],796,2,23680,4.128312412831241,0.0,20.0
25736,2,5736,[423 144 257 282 215],457,4,23684,4.128290047062925,0.0,0.0
25737,2,5737,[318 496 588  98 357],18,5,23689,4.128441965841756,40.0,0.0
25738,2,5738,[143  79  69 132 275],655,3,23692,4.128245338909218,0.0,20.0
25739,2,5739,[179   1 568  95 176],389,3,23695,4.128048780487805,0.0,0.0
25740,2,5740,[238 153 273 202   8],655,1,23696,4.127503919177844,0.0,0.0
25741,2,5741,[ 22 111 655 288 276],457,4,23700,4.12748171368861,0.0,0.0
25742,2,5742,[180 222 210 238 471],716,3,23703,4.127285390910674,0.0,0.0
25743,2,5743,[318 496 588  98 357],786,5,23708,4.1274373259052926,40.0,0.0
25744,2,5744,[172 403  12 294 187],256,2,23710,4.127067014795474,0.0,0.0
25745,2,5745,[210 286   4 597 546],450,3,23713,4.126870866689871,0.0,20.0
25746,2,5746,[318 496 588  98 357],330,5,23718,4.127022794501479,40.0,0.0
25747,2,5747,[257 144  88   1 655],457,4,23722,4.127000695894224,0.0,0.0
25748,2,5748,[318 496 588  98 357],786,5,23727,4.127152548269264,40.0,0.0
25749,2,5749,[143 183  97 275  88],756,2,23729,4.1267826086956525,0.0,20.0
25750,2,5750,[318 496 588  98 357],18,5,23734,4.126934446183273,40.0,0.0
25751,2,5751,[405 185 118 111  12],151,3,23737,4.126738525730181,0.0,0.0
25752,2,5752,[197 215 174  28 222],655,0,23737,4.126021206327134,0.0,0.0
25753,2,5753,[508  22 135 185 357],535,2,23739,4.125651720542232,0.0,0.0
25754,2,5754,[318 496 588  98 357],450,5,23744,4.1258036490008685,40.0,0.0
25755,2,5755,[546   7 427 143 135],693,4,23748,4.125781792911744,20.0,0.0
25756,2,5756,[318 496 588  98 357],18,5,23753,4.125933645996178,40.0,0.0
25757,2,5757,[318 496 588  98 357],716,5,23758,4.126085446335533,40.0,0.0
25758,2,5758,[194 161 204   8 176],269,1,23759,4.125542628928634,0.0,0.0
25759,2,5759,[318 496 588  98 357],786,5,23764,4.125694444444444,40.0,0.0
25760,2,5760,[245  69 238 153  56],450,5,23769,4.125846207255685,0.0,0.0
25761,2,5761,[318 496 588  98 357],796,5,23774,4.125997917389795,40.0,0.0
25762,2,5762,[318 496 588  98 357],786,5,23779,4.126149574874198,40.0,0.0
25763,2,5763,[318 496 588  98 357],18,5,23784,4.126301179736294,40.0,0.0
25764,2,5764,[318 496 588  98 357],786,5,23789,4.126452732003469,40.0,0.0
25765,2,5765,[100 588 483  11 161],401,2,23791,4.126083940339924,0.0,20.0
25766,2,5766,[271 196 174 185  79],655,2,23793,4.125715276573608,0.0,0.0
25767,2,5767,[318 496 588  98 357],450,5,23798,4.125866851595007,40.0,0.0
25768,2,5768,[286 237 216 181   9],236,5,23803,4.126018374068296,0.0,20.0
25769,2,5769,[318 496 588  98 357],716,5,23808,4.126169844020797,40.0,0.0
25770,2,5770,[385   8 100 117 496],280,4,23812,4.126147981285739,20.0,20.0
25771,2,5771,[318 496 588  98 357],330,5,23817,4.126299376299376,40.0,0.0
25772,2,5772,[318 496 588  98 357],786,5,23822,4.126450718863675,40.0,0.0
25773,2,5773,[174 268 318 238   1],535,3,23825,4.126255628680291,20.0,0.0
25774,2,5774,[318 496 588  98 357],450,5,23830,4.1264069264069265,40.0,0.0
25775,2,5775,[318 496 588  98 357],18,5,23835,4.1265581717451525,40.0,0.0
25776,2,5776,[318 496 588  98 357],18,5,23840,4.126709364722174,40.0,0.0
25777,2,5777,[318 496 588  98 357],796,5,23845,4.126860505365178,40.0,0.0
25778,2,5778,[ 82 228 204 238 181],450,4,23849,4.126838553382938,0.0,0.0
25779,2,5779,[318 496 588  98 357],786,5,23854,4.126989619377163,40.0,0.0
25780,2,5780,[318 496 588  98 357],18,5,23859,4.127140633108459,40.0,0.0
25781,2,5781,[161 237  56 483 301],655,1,23860,4.1265997924593565,0.0,0.0
25782,2,5782,[318 496 588  98 357],716,5,23865,4.1267508213729895,40.0,0.0
25783,2,5783,[318 496 588  98 357],330,5,23870,4.126901798063624,40.0,0.0
25784,2,5784,[318 496 588  98 357],716,5,23875,4.12705272255834,40.0,0.0
25785,2,5785,[546 655  28 143 603],796,3,23878,4.126857932941583,20.0,0.0
25786,2,5786,[ 96 403   8 161 174],796,5,23883,4.127008812856403,0.0,0.0
25787,2,5787,[269 117 313 357 176],655,2,23885,4.126641326883207,0.0,0.0
25788,2,5788,[318 496 588  98 357],18,5,23890,4.126792192088444,40.0,0.0
25789,2,5789,[211  71 265 288 483],450,2,23892,4.126424870466321,0.0,0.0
25790,2,5790,[385 222 357 328 111],450,4,23896,4.126403039198757,0.0,0.0
25791,2,5791,[194  71 204 234   8],807,4,23900,4.126381215469613,0.0,0.0
25792,2,5792,[117 127 151 313 176],344,3,23903,4.12618677714483,0.0,20.0
25793,2,5793,[318 496 588  98 357],18,5,23908,4.1263375906109765,40.0,0.0
25794,2,5794,[318 496 588  98 357],330,5,23913,4.12648835202761,40.0,0.0
25795,2,5795,[273 179 211  89   1],655,3,23916,4.126293995859213,0.0,0.0
25796,2,5796,[318 496 588  98 357],450,5,23921,4.126444712782473,40.0,0.0
25797,2,5797,[318 496 588  98 357],786,5,23926,4.126595377716454,40.0,0.0
25798,2,5798,[318 496 588  98 357],796,5,23931,4.1267459906880495,40.0,0.0
25799,2,5799,[318 496 588  98 357],18,5,23936,4.126896551724138,40.0,0.0
25800,2,5800,[318 496 588  98 357],716,5,23941,4.127047060851577,40.0,0.0
25801,2,5801,[228 200 385 742 237],796,4,23945,4.127025163736643,0.0,0.0
25802,2,5802,[181 235 186 435 655],716,3,23948,4.126830949508875,0.0,0.0
25803,2,5803,[322 200 235   7 132],280,5,23953,4.12698139214335,0.0,0.0
25804,2,5804,[318 496 588  98 357],330,5,23958,4.127131782945736,40.0,0.0
25805,2,5805,[318 496 588  98 357],716,5,23963,4.127282121942818,40.0,0.0
25806,2,5806,[127 385 276 210   8],344,4,23967,4.127260203203031,0.0,20.0
25807,2,5807,[318 496 588  98 357],786,5,23972,4.127410468319559,40.0,0.0
25808,2,5808,[318 496 588  98 357],716,5,23977,4.1275606817008095,40.0,0.0
25809,2,5809,[318 496 588  98 357],796,5,23982,4.127710843373494,40.0,0.0
25810,2,5810,[  9 588 210 173   1],786,5,23987,4.127860953364309,0.0,0.0
25811,2,5811,[318 496 588  98 357],450,5,23992,4.128011011699932,40.0,0.0
25812,2,5812,[655 168 328 179  71],450,4,23996,4.127988990194392,0.0,0.0
25813,2,5813,[183 172 121 143 168],716,4,24000,4.12796697626419,0.0,0.0
25814,2,5814,[318 496 588  98 357],330,5,24005,4.128116938950988,40.0,0.0
25815,2,5815,[318 496 588  98 357],716,5,24010,4.128266850068775,40.0,0.0
25816,2,5816,[185  15 603 183  71],450,3,24013,4.1280728898057415,20.0,0.0
25817,2,5817,[318 496 588  98 357],716,5,24018,4.128222756961155,40.0,0.0
25818,2,5818,[318 496 588  98 357],18,5,24023,4.1283725726069775,40.0,0.0
25819,2,5819,[318 496 588  98 357],450,5,24028,4.12852233676976,40.0,0.0
25820,2,5820,[318 496 588  98 357],716,5,24033,4.128672049476035,40.0,0.0
25821,2,5821,[318 496 588  98 357],450,5,24038,4.128821710752319,40.0,0.0
25822,2,5822,[191 111 597  22 678],344,2,24040,4.128456122273742,0.0,0.0
25823,2,5823,[222 216 238  88 228],151,5,24045,4.128605769230769,0.0,0.0
25824,2,5824,[318 496 588  98 357],450,5,24050,4.128755364806867,40.0,0.0
25825,2,5825,[318 496 588  98 357],786,5,24055,4.128904909028493,40.0,0.0
25826,2,5826,[318 496 588  98 357],450,5,24060,4.129054401922087,40.0,0.0
25827,2,5827,[318 496 588  98 357],450,5,24065,4.12920384351407,40.0,0.0
25828,2,5828,[191 471 655 174 288],655,1,24066,4.128667009778693,0.0,0.0
25829,2,5829,[318 496 588  98 357],716,5,24071,4.1288164665523155,40.0,0.0
25830,2,5830,[318 496 588  98 357],796,5,24076,4.128965872063111,40.0,0.0
25831,2,5831,[318 496 588  98 357],18,5,24081,4.129115226337449,40.0,0.0
25832,2,5832,[318 496 588  98 357],330,5,24086,4.12926452940168,40.0,0.0
25833,2,5833,[318 496 588  98 357],330,5,24091,4.129413781282139,40.0,0.0
25834,2,5834,[318 496 588  98 357],18,5,24096,4.129562982005141,40.0,0.0
25835,2,5835,[328 237 117  98 121],796,5,24101,4.1297121315969845,0.0,0.0
25836,2,5836,[127 275  88 181 204],503,4,24105,4.129689909199931,0.0,40.0
25837,2,5837,[ 25 222 273  97  50],344,4,24109,4.129667694415896,0.0,20.0
25838,2,5838,[405 117  79 144 222],716,4,24113,4.129645487240966,0.0,0.0
25839,2,5839,[318 496 588  98 357],330,5,24118,4.129794520547946,40.0,0.0
25840,2,5840,[318 496 588  98 357],796,5,24123,4.129943502824859,40.0,0.0
25841,2,5841,[318 496 588  98 357],716,5,24128,4.130092434097912,40.0,0.0
25842,2,5842,[196  64 427 202 143],389,3,24131,4.129899024473729,40.0,0.0
25843,2,5843,[403 202 191 144  82],655,1,24132,4.129363449691992,0.0,0.0
25844,2,5844,[210 748 423 204 289],807,5,24137,4.129512403763901,0.0,0.0
25845,2,5845,[275 127 210 117   7],457,5,24142,4.129661306876497,0.0,40.0
25846,2,5846,[172 196 174 471 132],450,5,24147,4.129810159055926,0.0,0.0
25847,2,5847,[318 496 588  98 357],18,5,24152,4.1299589603283176,40.0,0.0
25848,2,5848,[318 496 588  98 357],330,5,24157,4.1301077107197814,40.0,0.0
25849,2,5849,[ 98 174 282 176 483],716,3,24160,4.12991452991453,0.0,0.0
25850,2,5850,[318 496 588  98 357],330,5,24165,4.130063237053495,40.0,0.0
25851,2,5851,[318 496 588  98 357],330,5,24170,4.130211893369788,40.0,0.0
25852,2,5852,[318 496 588  98 357],786,5,24175,4.130360498889458,40.0,0.0
25853,2,5853,[318 496 588  98 357],450,5,24180,4.130509053638538,40.0,0.0
25854,2,5854,[318 496 588  98 357],786,5,24185,4.13065755764304,40.0,0.0
25855,2,5855,[318 496 588  98 357],786,5,24190,4.1308060109289615,40.0,0.0
25856,2,5856,[318 496 588  98 357],796,5,24195,4.130954413522281,40.0,0.0
25857,2,5857,[196  56 588 183 135],457,5,24200,4.131102765448959,0.0,0.0
25858,2,5858,[496 174  56 588 403],450,5,24205,4.131251066734937,20.0,0.0
25859,2,5859,[318 496 588  98 357],786,5,24210,4.131399317406143,40.0,0.0
25860,2,5860,[318 496 588  98 357],786,5,24215,4.1315475174884835,40.0,0.0
25861,2,5861,[318 496 588  98 357],716,5,24220,4.131695667007847,40.0,0.0
25862,2,5862,[318 496 588  98 357],796,5,24225,4.131843765990108,40.0,0.0
25863,2,5863,[127 176 180 313  11],450,5,24230,4.131991814461118,0.0,20.0
25864,2,5864,[313 328 597 153 403],796,5,24235,4.1321398124467175,0.0,0.0
25865,2,5865,[215 234 222 301 200],796,3,24238,4.131946812137743,0.0,0.0
25866,2,5866,[546 483 204 174 151],236,2,24240,4.131583432759502,0.0,0.0
25867,2,5867,[ 56 265 172 471  64],450,5,24245,4.13173142467621,20.0,0.0
25868,2,5868,[318 496 588  98 357],796,5,24250,4.1318793661611855,40.0,0.0
25869,2,5869,[318 496 588  98 357],786,5,24255,4.132027257240204,40.0,0.0
25870,2,5870,[ 71 135 313 678 204],807,4,24259,4.132004769204565,0.0,0.0
25871,2,5871,[318 496 588  98 357],786,5,24264,4.132152588555858,40.0,0.0
25872,2,5872,[318 496 588  98 357],450,5,24269,4.132300357568534,40.0,0.0
25873,2,5873,[195 258 179 172  11],535,4,24273,4.132277834525025,0.0,0.0
25874,2,5874,[318 496 588  98 357],450,5,24278,4.132425531914894,40.0,0.0
25875,2,5875,[318 496 588  98 357],18,5,24283,4.132573179033356,40.0,0.0
25876,2,5876,[318 496 588  98 357],450,5,24288,4.1327207759060745,40.0,0.0
25877,2,5877,[318 496 588  98 357],786,5,24293,4.132868322558694,40.0,0.0
25878,2,5878,[132 603  25 483 222],151,5,24298,4.13301581901684,20.0,0.0
25879,2,5879,[289 301 300 435 202],655,0,24298,4.132312925170068,0.0,0.0
25880,2,5880,[161 475 427 204 100],269,3,24301,4.132120387689168,20.0,20.0
25881,2,5881,[318 496 588  98 357],796,5,24306,4.132267936076165,40.0,0.0
25882,2,5882,[318 496 588  98 357],716,5,24311,4.132415434302227,40.0,0.0
25883,2,5883,[318 496 588  98 357],450,5,24316,4.13256288239293,40.0,0.0
25884,2,5884,[ 56 191 185 172   1],389,5,24321,4.132710280373832,0.0,0.0
25885,2,5885,[182 161  28 323 151],796,3,24324,4.132517838939857,0.0,0.0
25886,2,5886,[318 496 588  98 357],716,5,24329,4.132665194496348,40.0,0.0
25887,2,5887,[655 180 151 313 597],796,3,24332,4.132472826086956,0.0,0.0
25888,2,5888,[318 496 588  98 357],716,5,24337,4.132620139242656,40.0,0.0
25889,2,5889,[318 496 588  98 357],450,5,24342,4.13276740237691,40.0,0.0
25890,2,5890,[ 70  12 322  56 318],151,4,24346,4.1327448650483785,20.0,0.0
25891,2,5891,[318 496 588  98 357],716,5,24351,4.132892057026477,40.0,0.0
25892,2,5892,[185 265 271 117   8],655,1,24352,4.132360427625997,0.0,0.0
25893,2,5893,[195  15 125  82   1],450,3,24355,4.13216830675263,0.0,0.0
25894,2,5894,[318 496 588  98 357],796,5,24360,4.132315521628499,40.0,0.0
25895,2,5895,[294 237 195 318 245],280,1,24361,4.131784260515603,20.0,0.0
25896,2,5896,[318 496 588  98 357],786,5,24366,4.131931490588435,40.0,0.0
25897,2,5897,[318 496 588  98 357],786,5,24371,4.132078670735843,40.0,0.0
25898,2,5898,[127  70 238 742  89],450,5,24376,4.132225800983218,0.0,20.0
25899,2,5899,[471   8 483  50 228],807,5,24381,4.132372881355932,0.0,20.0
25900,2,5900,[ 88 603 405  82 265],450,4,24385,4.132350449076427,20.0,0.0
25901,2,5901,[318 496 588  98 357],796,5,24390,4.132497458488648,40.0,0.0
25902,2,5902,[597  89 515 143 132],269,2,24392,4.132136201931221,0.0,0.0
25903,2,5903,[237 318 197 322  95],796,3,24395,4.131944444444445,20.0,0.0
25904,2,5904,[111  79 194 286 435],151,5,24400,4.132091447925487,0.0,20.0
25905,2,5905,[318 496 588  98 357],716,5,24405,4.132238401625465,40.0,0.0
25906,2,5906,[100 174  69 181 168],330,4,24409,4.132216014897579,0.0,20.0
25907,2,5907,[318 496 588  98 357],786,5,24414,4.132362897765741,40.0,0.0
25908,2,5908,[211 435 258 515 276],655,2,24416,4.132002030800474,0.0,0.0
25909,2,5909,[483 196 173  15 234],450,2,24418,4.1316412859560065,0.0,0.0
25910,2,5910,[318 496 588  98 357],18,5,24423,4.1317881915073595,40.0,0.0
25911,2,5911,[183  12 187 275  88],796,5,24428,4.131935047361299,0.0,20.0
25912,2,5912,[318 496 588  98 357],450,5,24433,4.132081853543041,40.0,0.0
25913,2,5913,[269 435 176 228 179],655,1,24434,4.131552248900913,0.0,0.0
25914,2,5914,[475 237 471 191 302],655,2,24436,4.131191885038039,0.0,0.0
25915,2,5915,[318 496 588  98 357],716,5,24441,4.131338742393509,40.0,0.0
25916,2,5916,[318 496 588  98 357],18,5,24446,4.131485550109853,40.0,0.0
25917,2,5917,[238 603 194 204  69],716,5,24451,4.131632308212234,20.0,0.0
25918,2,5918,[405 301 204 496 174],593,4,24455,4.131610069268458,20.0,0.0
25919,2,5919,[318  28 496 546 286],151,4,24459,4.131587837837838,40.0,20.0
25920,2,5920,[483 328 294 186 322],796,2,24461,4.131227833136294,0.0,0.0
25921,2,5921,[655 172  28 357  97],450,5,24466,4.131374535629854,0.0,0.0
25922,2,5922,[405 187 328 173  69],796,5,24471,4.131521188586865,0.0,0.0
25923,2,5923,[ 96 181 238   7 265],655,0,24471,4.13082376772451,0.0,0.0
25924,2,5924,[275 300 161  15  64],389,2,24473,4.130464135021097,20.0,20.0
25925,2,5925,[269 132  82 237  25],655,0,24473,4.129767127910901,0.0,0.0
25926,2,5926,[161  69 748 258  12],450,5,24478,4.129913953096001,0.0,0.0
25927,2,5927,[405  56 234 191 427],655,2,24480,4.129554655870446,20.0,0.0
25928,2,5928,[  9 210 301 153 294],296,3,24483,4.129364142351156,0.0,0.0
25929,2,5929,[318 496 588  98 357],796,5,24488,4.129510961214165,40.0,0.0
25930,2,5930,[318 496 588  98 357],18,5,24493,4.129657730568201,40.0,0.0
25931,2,5931,[318 496 588  98 357],18,5,24498,4.129804450438301,40.0,0.0
25932,2,5932,[269  28   7  88  70],23,2,24500,4.129445474464857,0.0,0.0
25933,2,5933,[318 496 588  98 357],716,5,24505,4.129592180653859,40.0,0.0
25934,2,5934,[  1 318  22 588 202],18,4,24509,4.1295703454085935,20.0,0.0
25935,2,5935,[  9  89 175  97 302],344,4,24513,4.129548517520216,0.0,0.0
25936,2,5936,[318 496 588  98 357],330,5,24518,4.129695132221661,40.0,0.0
25937,2,5937,[318 496 588  98 357],18,5,24523,4.129841697541259,40.0,0.0
25938,2,5938,[183 210  82  95  11],716,4,24527,4.129819834989055,0.0,0.0
25939,2,5939,[318 496 588  98 357],796,5,24532,4.12996632996633,40.0,0.0
25940,2,5940,[182  79  95 100 313],280,2,24534,4.129607810132974,0.0,20.0
25941,2,5941,[603 121 597  15 197],796,4,24538,4.129585997980478,20.0,0.0
25942,2,5942,[151 200 328 117 403],450,4,24542,4.1295641931684335,0.0,0.0
25943,2,5943,[318 496 588  98 357],18,5,24547,4.129710632570659,40.0,0.0
25944,2,5944,[318 496 588  98 357],18,5,24552,4.129857022708158,40.0,0.0
25945,2,5945,[318 496 588  98 357],796,5,24557,4.130003363605786,40.0,0.0
25946,2,5946,[318 496 588  98 357],786,5,24562,4.13014965528838,40.0,0.0
25947,2,5947,[294 508 282 385  96],280,2,24564,4.129791526563551,0.0,0.0
25948,2,5948,[318 496 588  98 357],716,5,24569,4.129937804673054,40.0,0.0
25949,2,5949,[318 496 588  98 357],330,5,24574,4.1300840336134454,40.0,0.0
25950,2,5950,[318 496 588  98 357],716,5,24579,4.130230213409511,40.0,0.0
25951,2,5951,[186  97  70 385 153],503,3,24582,4.130040322580645,0.0,0.0
25952,2,5952,[ 71 286 127 179 234],786,4,24586,4.13001847807828,0.0,40.0
25953,2,5953,[318 496 588  98 357],330,5,24591,4.130164595230098,40.0,0.0
25954,2,5954,[318 496 588  98 357],450,5,24596,4.130310663308144,40.0,0.0
25955,2,5955,[655   4  97 546 181],716,3,24599,4.1301208865010075,0.0,0.0
25956,2,5956,[357  79 568 234  15],655,2,24601,4.129763303676347,0.0,0.0
25957,2,5957,[318 496 588  98 357],786,5,24606,4.1299093655589125,40.0,0.0
25958,2,5958,[318 496 588  98 357],716,5,24611,4.130055378419198,40.0,0.0
25959,2,5959,[318 496 588  98 357],18,5,24616,4.130201342281879,40.0,0.0
25960,2,5960,[222 204  25 302 173],450,3,24619,4.130011742996142,0.0,0.0
25961,2,5961,[385 483 143 257  69],655,2,24621,4.129654478362966,0.0,0.0
25962,2,5962,[301 238 144  50 175],655,1,24622,4.1291296327352,0.0,20.0
25963,2,5963,[194 204   9 238 333],796,3,24625,4.128940308517773,0.0,0.0
25964,2,5964,[143 182 322 405 183],450,5,24630,4.129086336965633,0.0,0.0
25965,2,5965,[181 174  15 603 288],450,3,24633,4.128897083473014,20.0,0.0
25966,2,5966,[ 89   7 328 265 742],655,1,24634,4.128372716608011,0.0,0.0
25967,2,5967,[174 176 197 186 427],450,4,24638,4.128351206434316,20.0,0.0
25968,2,5968,[202 127 357   9 210],401,3,24641,4.1281621712179595,0.0,20.0
25969,2,5969,[318 496 588  98 357],796,5,24646,4.128308207705192,40.0,0.0
25970,2,5970,[202  71  70  95 215],330,5,24651,4.128454195277173,0.0,0.0
25971,2,5971,[318 496 588  98 357],716,5,24656,4.128600133958473,40.0,0.0
25972,2,5972,[282 483 313  97 187],236,4,24660,4.128578603716726,0.0,0.0
25973,2,5973,[318 496 588  98 357],716,5,24665,4.128724472715099,40.0,0.0
25974,2,5974,[143  96 294  64 546],450,5,24670,4.128870292887029,20.0,0.0
25975,2,5975,[318 496 588  98 357],716,5,24675,4.129016064257028,40.0,0.0
25976,2,5976,[318 496 588  98 357],18,5,24680,4.12916178684959,40.0,0.0
25977,2,5977,[568 282 187 328  71],450,4,24684,4.129140180662429,0.0,0.0
25978,2,5978,[153 483 258 187 135],535,3,24687,4.1289513296537885,0.0,0.0
25979,2,5979,[318 496 588  98 357],18,5,24692,4.1290969899665555,40.0,0.0
25980,2,5980,[318 496 588  98 357],786,5,24697,4.129242601571644,40.0,0.0
25981,2,5981,[318 496 588  98 357],330,5,24702,4.129388164493481,40.0,0.0
25982,2,5982,[318 496 588  98 357],450,5,24707,4.129533678756476,40.0,0.0
25983,2,5983,[318 496 588  98 357],716,5,24712,4.129679144385027,40.0,0.0
25984,2,5984,[265  28 118   7   9],292,3,24715,4.129490392648288,0.0,0.0
25985,2,5985,[111 322 234  79 385],796,3,24718,4.129301703975944,0.0,0.0
25986,2,5986,[318 496 588  98 357],330,5,24723,4.129447135460164,40.0,0.0
25987,2,5987,[328  12 238 200 204],655,1,24724,4.1289245156980625,0.0,0.0
25988,2,5988,[318 496 588  98 357],796,5,24729,4.12906996159626,40.0,0.0
25989,2,5989,[318 496 588  98 357],450,5,24734,4.129215358931552,40.0,0.0
25990,2,5990,[403  50 182  70 143],457,5,24739,4.129360707728259,0.0,20.0
25991,2,5991,[318 496 588  98 357],18,5,24744,4.129506008010681,40.0,0.0
25992,2,5992,[ 97  22 275 117  96],450,5,24749,4.129651259803103,0.0,20.0
25993,2,5993,[318 496 588  98 357],786,5,24754,4.1297964631297965,40.0,0.0
25994,2,5994,[318 496 588  98 357],716,5,24759,4.129941618015012,40.0,0.0
25995,2,5995,[318 496 588  98 357],796,5,24764,4.130086724482989,40.0,0.0
25996,2,5996,[ 96  98  22  69 204],280,4,24768,4.130065032516258,0.0,0.0
25997,2,5997,[ 12 427   1 546 183],151,3,24771,4.129876625541847,20.0,0.0
25998,2,5998,[117  56 286 318 118],450,4,24775,4.129854975829305,20.0,20.0
25999,2,5999,[318 496 588  98 357],330,5,24780,4.13,40.0,0.0
26000,2,6000,[483 216 183  97 300],655,3,24783,4.129811698050325,0.0,0.0
26001,2,6001,[318 496 588  98 357],716,5,24788,4.1299566811062975,40.0,0.0
26002,2,6002,[318 496 588  98 357],450,5,24793,4.130101615858737,40.0,0.0
26003,2,6003,[132 121 151 678 118],807,4,24797,4.130079946702199,0.0,0.0
26004,2,6004,[191  28 328 132 245],450,5,24802,4.13022481265612,0.0,0.0
26005,2,6005,[ 50 100 269 125   1],344,3,24805,4.1300366300366305,0.0,40.0
26006,2,6006,[318 496 588  98 357],18,5,24810,4.130181454969202,40.0,0.0
26007,2,6007,[318 496 588  98 357],786,5,24815,4.130326231691079,40.0,0.0
26008,2,6008,[195 135 237  50  97],885,3,24818,4.130138126144117,0.0,20.0
26009,2,6009,[318 496 588  98 357],450,5,24823,4.130282861896839,40.0,0.0
26010,2,6010,[200 300 216 151 197],450,4,24827,4.130261187822326,0.0,0.0
26011,2,6011,[318 496 588  98 357],786,5,24832,4.130405854956753,40.0,0.0
26012,2,6012,[ 97  25   9   7 100],65,3,24835,4.130217861300515,0.0,20.0
26013,2,6013,[318 496 588  98 357],450,5,24840,4.130362487529099,40.0,0.0
26014,2,6014,[318 496 588  98 357],330,5,24845,4.1305070656691605,40.0,0.0
26015,2,6015,[275 211 603 132 301],655,2,24847,4.130152925531915,20.0,20.0
26016,2,6016,[318 496 588  98 357],716,5,24852,4.130297490443743,40.0,0.0
26017,2,6017,[ 22   4 405 228  82],796,4,24856,4.130275839149219,0.0,0.0
26018,2,6018,[318 496 588  98 357],796,5,24861,4.130420335603921,40.0,0.0
26019,2,6019,[183   1 195 238 185],457,5,24866,4.130564784053156,0.0,0.0
26020,2,6020,[385 568  82 100 121],457,5,24871,4.1307091845208435,0.0,20.0
26021,2,6021,[265 176 216 294  96],280,3,24874,4.130521421454667,0.0,0.0
26022,2,6022,[197  28   1 210 318],457,5,24879,4.130665781172174,20.0,0.0
26023,2,6023,[294  22 546  89   4],450,4,24883,4.130644090305445,0.0,0.0
26024,2,6024,[ 50 153 118 186 234],796,3,24886,4.130456431535269,0.0,20.0
26025,2,6025,[ 69 276 483 143 182],18,4,24890,4.130434782608695,0.0,0.0
26026,2,6026,[ 70 194 185   7 228],450,5,24895,4.13057906089265,0.0,0.0
26027,2,6027,[318 496 588  98 357],786,5,24900,4.130723291307233,40.0,0.0
26028,2,6028,[318 496 588  98 357],786,5,24905,4.130867473876265,40.0,0.0
26029,2,6029,[318 496 588  98 357],796,5,24910,4.131011608623549,40.0,0.0
26030,2,6030,[318 496 588  98 357],796,5,24915,4.131155695572874,40.0,0.0
26031,2,6031,[435 282 175 194 222],716,3,24918,4.130968169761273,0.0,0.0
26032,2,6032,[318 496 588  98 357],716,5,24923,4.131112216144539,40.0,0.0
26033,2,6033,[211   1 238 100 118],655,0,24923,4.130427577063308,0.0,20.0
26034,2,6034,[318 496 588  98 357],796,5,24928,4.130571665285832,40.0,0.0
26035,2,6035,[318 496 588  98 357],330,5,24933,4.130715705765407,40.0,0.0
26036,2,6036,[385  70 125 100 176],450,5,24938,4.130859698525758,0.0,20.0
26037,2,6037,[318 496 588  98 357],786,5,24943,4.131003643590593,40.0,0.0
26038,2,6038,[238  12 175 385 496],151,4,24947,4.130981950654082,20.0,0.0
26039,2,6039,[183  89 211 118 483],796,4,24951,4.130960264900662,0.0,0.0
26040,2,6040,[ 96 265 161 228 508],655,0,24951,4.1302764442973015,0.0,0.0
26041,2,6041,[180  97 216 282  88],693,3,24954,4.130089374379344,0.0,0.0
26042,2,6042,[318 496 588  98 357],786,5,24959,4.130233327817309,40.0,0.0
26043,2,6043,[  7 282  64 603 172],450,5,24964,4.130377233620119,40.0,0.0
26044,2,6044,[318 496 588  98 357],18,5,24969,4.130521091811414,40.0,0.0
26045,2,6045,[151 471 121 294  25],577,4,24973,4.130499503804168,0.0,0.0
26046,2,6046,[748 282 204  98 125],450,5,24978,4.130643294195469,0.0,0.0
26047,2,6047,[215 655 333 194 403],796,4,24982,4.130621693121693,0.0,0.0
26048,2,6048,[318 496 588  98 357],716,5,24987,4.130765415771202,40.0,0.0
26049,2,6049,[ 56 588  96 135 655],280,4,24991,4.130743801652892,0.0,0.0
26050,2,6050,[186 435  82 496 475],389,4,24995,4.130722194678565,20.0,0.0
26051,2,6051,[318 496 588  98 357],450,5,25000,4.130865829477859,40.0,0.0
26052,2,6052,[ 79 318  97 423  95],796,4,25004,4.130844209482901,20.0,0.0
26053,2,6053,[318 496 588  98 357],450,5,25009,4.1309877766765775,40.0,0.0
26054,2,6054,[318 496 588  98 357],18,5,25014,4.131131296449215,40.0,0.0
26055,2,6055,[405   8 211   9 168],269,3,25017,4.130944517833553,0.0,0.0
26056,2,6056,[143 181 127 301 191],655,3,25020,4.130757800891531,0.0,20.0
26057,2,6057,[ 79 234 143 194 121],5,2,25022,4.130406074612083,0.0,0.0
26058,2,6058,[196 265 318  28 237],716,5,25027,4.1305495956428455,20.0,0.0
26059,2,6059,[194  79   1 135 496],151,5,25032,4.130693069306931,20.0,0.0
26060,2,6060,[228  79 168 385 186],450,4,25036,4.130671506352087,0.0,0.0
26061,2,6061,[318 496 588  98 357],450,5,25041,4.130814912570109,40.0,0.0
26062,2,6062,[ 71 322 237  98 275],593,3,25044,4.130628401781296,0.0,20.0
26063,2,6063,[ 71 153 423 161 238],389,3,25047,4.1304419525065965,0.0,0.0
26064,2,6064,[183 275  22 216 748],450,5,25052,4.130585325638912,0.0,20.0
26065,2,6065,[318 496 588  98 357],716,5,25057,4.130728651500164,40.0,0.0
26066,2,6066,[508 196 405   1 238],655,0,25057,4.130047799571452,0.0,0.0
26067,2,6067,[175 655 183 191 471],655,2,25059,4.129696769940672,0.0,0.0
26068,2,6068,[318 496 588  98 357],786,5,25064,4.1298401713626625,40.0,0.0
26069,2,6069,[191 508 215 121 183],693,1,25065,4.129324546952224,0.0,0.0
26070,2,6070,[132 313 222 181 194],807,5,25070,4.129467962444408,0.0,0.0
26071,2,6071,[237 245 273 235 328],450,3,25073,4.129281949934124,0.0,0.0
26072,2,6072,[318 496 588  98 357],786,5,25078,4.1294253252099455,40.0,0.0
26073,2,6073,[174 238 318 301  97],535,5,25083,4.12956865327626,20.0,0.0
26074,2,6074,[237 742  22 181  96],256,5,25088,4.129711934156378,0.0,0.0
26075,2,6075,[151 405 318   4 143],796,5,25093,4.129855167873601,20.0,0.0
26076,2,6076,[202 423 318  79 215],577,5,25098,4.129998354451209,20.0,0.0
26077,2,6077,[318 496 588  98 357],796,5,25103,4.130141493912471,40.0,0.0
26078,2,6078,[318 496 588  98 357],786,5,25108,4.130284586280638,40.0,0.0
26079,2,6079,[655 187 215 168 172],796,4,25112,4.130263157894737,0.0,0.0
26080,2,6080,[318 496 588  98 357],786,5,25117,4.1304061831935535,40.0,0.0
26081,2,6081,[318 496 588  98 357],450,5,25122,4.1305491614600465,40.0,0.0
26082,2,6082,[318 496 588  98 357],450,5,25127,4.13069209271741,40.0,0.0
26083,2,6083,[197 181 204 202  64],269,2,25129,4.130341880341881,20.0,0.0
26084,2,6084,[318 496 588  98 357],716,5,25134,4.130484798685291,40.0,0.0
26085,2,6085,[210 742 202 237 125],457,5,25139,4.130627670062438,0.0,0.0
26086,2,6086,[333  50 568 313 289],655,2,25141,4.130277640873993,0.0,20.0
26087,2,6087,[403 313 197  15   9],655,1,25142,4.129763469119579,0.0,0.0
26088,2,6088,[318 496 588  98 357],450,5,25147,4.129906388569552,40.0,0.0
26089,2,6089,[318 496 588  98 357],796,5,25152,4.130049261083744,40.0,0.0
26090,2,6090,[174 195 204 100 197],330,4,25156,4.130027910031194,0.0,20.0
26091,2,6091,[427 151 132 483 121],716,5,25161,4.130170715692712,20.0,0.0
26092,2,6092,[ 69 216 273 318  97],401,3,25164,4.129985228951256,20.0,0.0
26093,2,6093,[435 210 357 269 238],18,5,25169,4.130127994748934,0.0,0.0
26094,2,6094,[318 496 588  98 357],716,5,25174,4.130270713699754,40.0,0.0
26095,2,6095,[ 96  22 195 483  69],655,1,25175,4.129757217847769,0.0,0.0
26096,2,6096,[ 95 271 187   9 183],796,4,25179,4.129735935706085,0.0,0.0
26097,2,6097,[174 216 269 143 100],338,4,25183,4.12971466054444,0.0,20.0
26098,2,6098,[333 475 187   8 153],655,1,25184,4.129201508444007,0.0,0.0
26099,2,6099,[508 275  96 121 216],655,2,25186,4.128852459016393,0.0,20.0
26100,2,6100,[318 496 588  98 357],450,5,25191,4.128995246680872,40.0,0.0
26101,2,6101,[228 202 237 132 175],457,5,25196,4.129137987545067,0.0,0.0
26102,2,6102,[318 496 588  98 357],796,5,25201,4.129280681631984,40.0,0.0
26103,2,6103,[318 496 588  98 357],796,5,25206,4.129423328964613,40.0,0.0
26104,2,6104,[  4 121 194 197 200],716,4,25210,4.12940212940213,0.0,0.0
26105,2,6105,[ 98 196  15 328 121],450,3,25213,4.129217163445791,0.0,0.0
26106,2,6106,[483  96  70 269 186],655,1,25214,4.128704765023743,0.0,0.0
26107,2,6107,[318 496 588  98 357],18,5,25219,4.128847413228553,40.0,0.0
26108,2,6108,[286  89 269 211 173],450,5,25224,4.128990014732362,0.0,20.0
26109,2,6109,[318 496 588  98 357],330,5,25229,4.129132569558101,40.0,0.0
26110,2,6110,[  9 237 483 215 151],18,2,25231,4.128784159711995,0.0,0.0
26111,2,6111,[132 328 286 403 216],796,4,25235,4.128763089005235,0.0,20.0
26112,2,6112,[318 496 588  98 357],796,5,25240,4.128905610992966,40.0,0.0
26113,2,6113,[  1 405 423   9 181],292,4,25244,4.12888452731436,0.0,0.0
26114,2,6114,[318 496 588  98 357],716,5,25249,4.129026982829108,40.0,0.0
26115,2,6115,[228 483 210 118 318],716,4,25253,4.12900588620013,20.0,0.0
26116,2,6116,[182 216 135 286 423],450,4,25257,4.128984796468857,0.0,20.0
26117,2,6117,[194   1  70  22 300],535,2,25259,4.128636809414841,0.0,0.0
26118,2,6118,[318 496 588  98 357],796,5,25264,4.12877921228959,40.0,0.0
26119,2,6119,[318 496 588  98 357],786,5,25269,4.128921568627451,40.0,0.0
26120,2,6120,[318 496 588  98 357],18,5,25274,4.129063878451233,40.0,0.0
26121,2,6121,[118 403  96 322 194],796,4,25278,4.129042796471741,0.0,0.0
26122,2,6122,[176 183   7 127 508],280,2,25280,4.128695084109097,0.0,20.0
26123,2,6123,[318 496 588  98 357],330,5,25285,4.128837361201829,40.0,0.0
26124,2,6124,[318 496 588  98 357],450,5,25290,4.1289795918367345,40.0,0.0
26125,2,6125,[318 496 588  98 357],330,5,25295,4.129121776036565,40.0,0.0
26126,2,6126,[222   9 282  56 742],457,5,25300,4.129263913824057,0.0,0.0
26127,2,6127,[318 496 588  98 357],450,5,25305,4.129406005221932,40.0,0.0
26128,2,6128,[181 144 196  89 172],450,5,25310,4.129548050252896,0.0,0.0
26129,2,6129,[318 496 588  98 357],786,5,25315,4.129690048939641,40.0,0.0
26130,2,6130,[318 496 588  98 357],716,5,25320,4.129832001304845,40.0,0.0
26131,2,6131,[318 496 588  98 357],786,5,25325,4.129973907371167,40.0,0.0
26132,2,6132,[ 97 210 228 121 257],796,3,25328,4.129789662481657,0.0,0.0
26133,2,6133,[318 496 588  98 357],716,5,25333,4.1299315291816105,40.0,0.0
26134,2,6134,[318 496 588  98 357],18,5,25338,4.130073349633252,40.0,0.0
26135,2,6135,[318 496 588  98 357],450,5,25343,4.130215123859192,40.0,0.0
26136,2,6136,[318 496 588  98 357],786,5,25348,4.130356851882027,40.0,0.0
26137,2,6137,[ 98 286   4 121 483],655,2,25350,4.130009775171065,0.0,20.0
26138,2,6138,[318 496 588  98 357],786,5,25355,4.130151490470761,40.0,0.0
26139,2,6139,[183  95  71   7 202],786,5,25360,4.130293159609121,0.0,0.0
26140,2,6140,[135   7 211 181 427],450,4,25364,4.130271942680345,20.0,0.0
26141,2,6141,[318 496 588  98 357],716,5,25369,4.130413546076197,40.0,0.0
26142,2,6142,[318 496 588  98 357],18,5,25374,4.130555103369689,40.0,0.0
26143,2,6143,[  4   9 238 181  25],655,0,25374,4.1298828125,0.0,0.0
26144,2,6144,[302 471  11 153 197],655,1,25375,4.129373474369406,0.0,0.0
26145,2,6145,[318 496 588  98 357],18,5,25380,4.1295151317930365,40.0,0.0
26146,2,6146,[318 496 588  98 357],786,5,25385,4.129656743126729,40.0,0.0
26147,2,6147,[ 97 483  98 153 742],450,4,25389,4.129635653871178,0.0,0.0
26148,2,6148,[185  82  88 265 111],796,4,25393,4.129614571475036,0.0,0.0
26149,2,6149,[275 202  56   1 210],457,5,25398,4.129756097560976,0.0,20.0
26150,2,6150,[588 234 405 161 135],807,4,25402,4.129735002438628,0.0,0.0
26151,2,6151,[318 496 588  98 357],786,5,25407,4.129876462938881,40.0,0.0
26152,2,6152,[318 496 588  98 357],18,5,25412,4.13001787745815,40.0,0.0
26153,2,6153,[318 496 588  98 357],18,5,25417,4.13015924601885,40.0,0.0
26154,2,6154,[318 496 588  98 357],330,5,25422,4.13030056864338,40.0,0.0
26155,2,6155,[151 238 435 153 204],151,4,25426,4.130279402209227,0.0,0.0
26156,2,6156,[318 496 588  98 357],330,5,25431,4.130420659412051,40.0,0.0
26157,2,6157,[318 496 588  98 357],450,5,25436,4.130561870737252,40.0,0.0
26158,2,6158,[318 496 588  98 357],450,5,25441,4.130703036207176,40.0,0.0
26159,2,6159,[269  70 275 168  15],707,3,25444,4.130519480519481,0.0,20.0
26160,2,6160,[183 143 186  98 211],450,4,25448,4.130498295731212,0.0,0.0
26161,2,6161,[173 121 318 603  98],535,4,25452,4.13047711781889,40.0,0.0
26162,2,6162,[  4 125 427 237 423],577,5,25457,4.130618205419439,20.0,0.0
26163,2,6163,[318 496 588  98 357],786,5,25462,4.13075924724205,40.0,0.0
26164,2,6164,[318 496 588  98 357],330,5,25467,4.130900243309003,40.0,0.0
26165,2,6165,[187 127 143 194  97],835,5,25472,4.131041193642556,0.0,20.0
26166,2,6166,[568 265  25  56  89],256,4,25476,4.131019944867845,0.0,0.0
26167,2,6167,[ 25  79  95 245 111],344,4,25480,4.130998702983139,0.0,0.0
26168,2,6168,[318 496 588  98 357],18,5,25485,4.131139568811801,40.0,0.0
26169,2,6169,[318 496 588  98 357],450,5,25490,4.13128038897893,40.0,0.0
26170,2,6170,[ 71 127 289 132 174],807,4,25494,4.131259115216334,0.0,20.0
26171,2,6171,[323  56 385 423  71],504,4,25498,4.131237848347375,0.0,0.0
26172,2,6172,[265 301 269 176 182],796,3,25501,4.131054592580593,0.0,0.0
26173,2,6173,[117  82 228 185  28],330,5,25506,4.131195335276968,0.0,0.0
26174,2,6174,[234 742 144 215 127],796,3,25509,4.131012145748988,0.0,20.0
26175,2,6175,[318 496 588  98 357],450,5,25514,4.131152849740933,40.0,0.0
26176,2,6176,[ 95  56  70  98 245],450,4,25518,4.131131617289946,0.0,0.0
26177,2,6177,[276  98 216 186 237],786,4,25522,4.131110391712529,0.0,0.0
26178,2,6178,[318 496 588  98 357],786,5,25527,4.131251011490533,40.0,0.0
26179,2,6179,[ 15 423 655 183 588],457,5,25532,4.131391585760518,0.0,0.0
26180,2,6180,[318 496 588  98 357],450,5,25537,4.131532114544572,40.0,0.0
26181,2,6181,[318 496 588  98 357],450,5,25542,4.131672597864768,40.0,0.0
26182,2,6182,[174 269  79 357 135],942,3,25545,4.131489568170791,0.0,0.0
26183,2,6183,[100 568 202 357 132],796,4,25549,4.13146830530401,0.0,20.0
26184,2,6184,[  9 172   4 546 265],280,3,25552,4.131285367825384,0.0,0.0
26185,2,6185,[ 28 182 176  89 111],450,5,25557,4.131425800193987,0.0,0.0
26186,2,6186,[273 175 176  15 172],655,2,25559,4.131081299498949,0.0,0.0
26187,2,6187,[318 496 588  98 357],18,5,25564,4.131221719457014,40.0,0.0
26188,2,6188,[318 496 588  98 357],796,5,25569,4.131362094037809,40.0,0.0
26189,2,6189,[318 496 588  98 357],796,5,25574,4.131502423263328,40.0,0.0
26190,2,6190,[144 294 204  79 245],796,3,25577,4.1313196575674365,0.0,0.0
26191,2,6191,[318 496 588  98 357],716,5,25582,4.131459948320414,40.0,0.0
26192,2,6192,[117 183  12  82 423],280,3,25585,4.131277248506378,0.0,0.0
26193,2,6193,[405 275   4  50 187],655,3,25588,4.131094607684856,0.0,40.0
26194,2,6194,[318 496 588  98 357],786,5,25593,4.131234866828088,40.0,0.0
26195,2,6195,[318 496 588  98 357],450,5,25598,4.131375080697224,40.0,0.0
26196,2,6196,[301 265 300 357 742],450,5,25603,4.131515249314185,0.0,0.0
26197,2,6197,[318 496 588  98 357],330,5,25608,4.131655372700871,40.0,0.0
26198,2,6198,[234 286 173 117 195],786,4,25612,4.131634134537829,0.0,20.0
26199,2,6199,[  7 228 111 204 603],151,5,25617,4.131774193548387,20.0,0.0
26200,2,6200,[301 210 179 216 357],593,4,25621,4.131752943073698,0.0,0.0
26201,2,6201,[423 427 191 211 100],23,3,25624,4.131570461141568,20.0,20.0
26202,2,6202,[ 50   4 132 200 471],280,2,25626,4.1312268257294855,0.0,20.0
26203,2,6203,[318 496 588  98 357],330,5,25631,4.131366860090265,40.0,0.0
26204,2,6204,[172 496 237 403 210],18,2,25633,4.131023368251411,20.0,0.0
26205,2,6205,[588 176 301 181 144],450,5,25638,4.131163390267483,0.0,0.0
26206,2,6206,[265 143 196  88 127],457,5,25643,4.131303367166103,0.0,20.0
26207,2,6207,[288 655 100 318 215],457,5,25648,4.131443298969073,20.0,20.0
26208,2,6208,[318 496 588  98 357],450,5,25653,4.13158318569818,40.0,0.0
26209,2,6209,[ 89 216 597 423  15],796,5,25658,4.131723027375202,0.0,0.0
26210,2,6210,[318 496 588  98 357],786,5,25663,4.131862824021897,40.0,0.0
26211,2,6211,[318 496 588  98 357],18,5,25668,4.132002575660013,40.0,0.0
26212,2,6212,[318 496 588  98 357],450,5,25673,4.132142282311283,40.0,0.0
26213,2,6213,[318 496 588  98 357],450,5,25678,4.132281943997425,40.0,0.0
26214,2,6214,[176  12 268 515 301],655,1,25679,4.131777956556718,0.0,0.0
26215,2,6215,[111 127 427 288 191],655,3,25682,4.1315958815958815,20.0,20.0
26216,2,6216,[318 269 588  71 174],878,3,25685,4.1314138652083,20.0,0.0
26217,2,6217,[318 496 588  98 357],450,5,25690,4.131553554197491,40.0,0.0
26218,2,6218,[200 202   7  15 186],577,2,25692,4.131210805595755,0.0,0.0
26219,2,6219,[318 496 588  98 357],450,5,25697,4.131350482315113,40.0,0.0
26220,2,6220,[275 257  50 121 204],798,5,25702,4.131490114129561,0.0,40.0
26221,2,6221,[742 118 191 125 181],344,1,25703,4.130986820957891,0.0,0.0
26222,2,6222,[471  71  28  79 568],450,4,25707,4.130965772135626,0.0,0.0
26223,2,6223,[238 423 151 195 194],796,4,25711,4.130944730077121,0.0,0.0
26224,2,6224,[ 89 174 202 132 211],450,5,25716,4.131084337349398,0.0,0.0
26225,2,6225,[183 515 234 172  70],655,3,25719,4.130902666238355,0.0,0.0
26226,2,6226,[318 496 588  98 357],330,5,25724,4.131042235426369,40.0,0.0
26227,2,6227,[318 496 588  98 357],716,5,25729,4.131181759794477,40.0,0.0
26228,2,6228,[385 191 144 175 257],716,2,25731,4.130839621126987,0.0,0.0
26229,2,6229,[172  56 181  88 174],269,1,25732,4.130337078651685,0.0,0.0
26230,2,6230,[318 496 588  98 357],716,5,25737,4.130476649013,40.0,0.0
26231,2,6231,[318 496 588  98 357],450,5,25742,4.130616174582799,40.0,0.0
26232,2,6232,[204 238  22  11 211],450,5,25747,4.130755655382641,0.0,0.0
26233,2,6233,[318 496 588  98 357],786,5,25752,4.130895091434072,40.0,0.0
26234,2,6234,[143 204 174  15 202],796,5,25757,4.13103448275862,0.0,0.0
26235,2,6235,[318 496 588  98 357],330,5,25762,4.131173829377806,40.0,0.0
26236,2,6236,[175 210  12  95  11],344,4,25766,4.131152797819465,0.0,0.0
26237,2,6237,[318 496 588  98 357],786,5,25771,4.131292080795126,40.0,0.0
26238,2,6238,[318 496 588  98 357],716,5,25776,4.1314313191216545,40.0,0.0
26239,2,6239,[318 496 588  98 357],330,5,25781,4.131570512820513,40.0,0.0
26240,2,6240,[ 22 385 202   4 471],716,2,25783,4.131228969716392,0.0,0.0
26241,2,6241,[318 496 588  98 357],716,5,25788,4.131368151233579,40.0,0.0
26242,2,6242,[318 496 588  98 357],796,5,25793,4.131507288162743,40.0,0.0
26243,2,6243,[318 496 588  98 357],716,5,25798,4.1316463805253045,40.0,0.0
26244,2,6244,[318 496 588  98 357],716,5,25803,4.131785428342674,40.0,0.0
26245,2,6245,[180  89 144  98 258],296,5,25808,4.131924431636247,0.0,0.0
26246,2,6246,[405  56 237  88 196],450,5,25813,4.132063390427406,0.0,0.0
26247,2,6247,[655 121 204 196 168],716,5,25818,4.132202304737516,0.0,0.0
26248,2,6248,[318 496 588  98 357],716,5,25823,4.132341174587934,40.0,0.0
26249,2,6249,[333  82 238 200 195],796,3,25826,4.13216,0.0,0.0
26250,2,6250,[496 275 216 191  28],716,5,25831,4.13229883218685,20.0,20.0
26251,2,6251,[215 183 289 508 483],693,1,25832,4.131797824696097,0.0,0.0
26252,2,6252,[174 508 200 216  69],280,3,25835,4.131616823924516,0.0,0.0
26253,2,6253,[318 496 588  98 357],450,5,25840,4.131755676367125,40.0,0.0
26254,2,6254,[508 202 132 268 196],269,3,25843,4.131574740207833,0.0,0.0
26255,2,6255,[318 496 588  98 357],796,5,25848,4.131713554987212,40.0,0.0
26256,2,6256,[603 235  71 546  82],23,1,25849,4.131213041393639,20.0,0.0
26257,2,6257,[318 496 588  98 357],716,5,25854,4.131351869606903,40.0,0.0
26258,2,6258,[318 496 588  98 357],796,5,25859,4.131490653459019,40.0,0.0
26259,2,6259,[318 496 588  98 357],18,5,25864,4.131629392971246,40.0,0.0
26260,2,6260,[151 302 405 427 273],450,4,25868,4.131608369270085,20.0,0.0
26261,2,6261,[318 496 588  98 357],330,5,25873,4.131747045672309,40.0,0.0
26262,2,6262,[269 125 118  89 742],450,4,25877,4.131726009899409,0.0,0.0
26263,2,6263,[ 64   4 197 121  96],450,3,25880,4.1315453384418905,20.0,0.0
26264,2,6264,[176 117 143 127 202],655,2,25882,4.131205107741421,0.0,20.0
26265,2,6265,[318 496 588  98 357],18,5,25887,4.131343759974466,40.0,0.0
26266,2,6266,[318 496 588  98 357],796,5,25892,4.131482367959151,40.0,0.0
26267,2,6267,[176 265 211   7 357],786,5,25897,4.131620931716656,0.0,0.0
26268,2,6268,[318 496 588  98 357],450,5,25902,4.131759451268145,40.0,0.0
26269,2,6269,[194 234  22 176 265],796,4,25906,4.131738437001595,0.0,0.0
26270,2,6270,[ 11  50 175 508 182],655,2,25908,4.131398501036517,0.0,20.0
26271,2,6271,[405 286 313 265 161],655,1,25909,4.130899234693878,0.0,20.0
26272,2,6272,[ 95 282  71 111 195],450,3,25912,4.130718954248366,0.0,0.0
26273,2,6273,[282 546 403 423  64],693,1,25913,4.130219955371374,20.0,0.0
26274,2,6274,[318 496 588  98 357],330,5,25918,4.130358565737052,40.0,0.0
26275,2,6275,[318 496 588  98 357],716,5,25923,4.1304971319311665,40.0,0.0
26276,2,6276,[301  89 183  64 496],151,4,25927,4.130476342201689,40.0,0.0
26277,2,6277,[318 496 588  98 357],786,5,25932,4.130614845492195,40.0,0.0
26278,2,6278,[508 127 228 275  89],655,3,25935,4.130434782608695,0.0,40.0
26279,2,6279,[403 265  88 603  95],450,4,25939,4.130414012738854,20.0,0.0
26280,2,6280,[161 748 222 328 655],796,4,25943,4.130393249482567,0.0,0.0
26281,2,6281,[318 496 588  98 357],450,5,25948,4.130531677809615,40.0,0.0
26282,2,6282,[318 496 588  98 357],786,5,25953,4.130670062072259,40.0,0.0
26283,2,6283,[318 496 588  98 357],450,5,25958,4.130808402291534,40.0,0.0
26284,2,6284,[318 496 588  98 357],716,5,25963,4.130946698488464,40.0,0.0
26285,2,6285,[318 496 588  98 357],796,5,25968,4.13108495068406,40.0,0.0
26286,2,6286,[603 174 475  88  11],269,2,25970,4.130745983776046,20.0,0.0
26287,2,6287,[318 496 588  98 357],716,5,25975,4.130884223918575,40.0,0.0
26288,2,6288,[117 471 176  96 237],344,2,25977,4.13054539672444,0.0,0.0
26289,2,6289,[318 496 588  98 357],450,5,25982,4.1306836248012715,40.0,0.0
26290,2,6290,[318 496 588  98 357],786,5,25987,4.130821808933397,40.0,0.0
26291,2,6291,[191 210  56 143 211],18,5,25992,4.130959949141768,0.0,0.0
26292,2,6292,[318 496 588  98 357],18,5,25997,4.131098045447322,40.0,0.0
26293,2,6293,[318 496 588  98 357],18,5,26002,4.131236097870988,40.0,0.0
26294,2,6294,[318 496 588  98 357],18,5,26007,4.131374106433677,40.0,0.0
26295,2,6295,[318 496 588  98 357],18,5,26012,4.13151207115629,40.0,0.0
26296,2,6296,[318 496 588  98 357],18,5,26017,4.131649992059711,40.0,0.0
26297,2,6297,[318 496 588  98 357],330,5,26022,4.131787869164814,40.0,0.0
26298,2,6298,[318 496 588  98 357],786,5,26027,4.131925702492459,40.0,0.0
26299,2,6299,[286 200  11  12 125],655,1,26028,4.131428571428572,0.0,20.0
26300,2,6300,[318 496 588  98 357],450,5,26033,4.131566418028885,40.0,0.0
26301,2,6301,[318 496 588  98 357],786,5,26038,4.131704220882259,40.0,0.0
26302,2,6302,[237 182  88   4 200],457,5,26043,4.131841980009519,0.0,0.0
26303,2,6303,[318 496 588  98 357],786,5,26048,4.131979695431472,40.0,0.0
26304,2,6304,[318 496 588  98 357],18,5,26053,4.132117367168914,40.0,0.0
26305,2,6305,[318 496 588  98 357],716,5,26058,4.132254995242626,40.0,0.0
26306,2,6306,[125 127 234  98 313],436,4,26062,4.132234025685746,0.0,20.0
26307,2,6307,[ 71  95 202 216 282],450,3,26065,4.132054533925174,0.0,0.0
26308,2,6308,[ 70 191 211  12 100],11,3,26068,4.131875099064828,0.0,20.0
26309,2,6309,[132 135 235 185 215],716,3,26071,4.131695721077654,0.0,0.0
26310,2,6310,[  1 100 323 132 191],796,2,26073,4.131357946442719,0.0,20.0
26311,2,6311,[216  11 182  22 288],280,4,26077,4.131337135614702,0.0,0.0
26312,2,6312,[318 496 588  98 357],716,5,26082,4.131474734674481,40.0,0.0
26313,2,6313,[385 294 180 100 588],796,2,26084,4.1311371555274,0.0,20.0
26314,2,6314,[318 496 588  98 357],18,5,26089,4.131274742676168,40.0,0.0
26315,2,6315,[173 423 196 172 405],798,3,26092,4.131095630145662,0.0,0.0
26316,2,6316,[273  11 153 175 568],655,1,26093,4.130599968339402,0.0,0.0
26317,2,6317,[  9  96 496  56 185],796,4,26097,4.130579297245964,20.0,0.0
26318,2,6318,[318 496 588  98 357],786,5,26102,4.130716885583162,40.0,0.0
26319,2,6319,[174 322 194  95 546],450,4,26106,4.130696202531645,0.0,0.0
26320,2,6320,[143 132 186 313 172],693,3,26109,4.130517323208353,0.0,0.0
26321,2,6321,[318 496 588  98 357],18,5,26114,4.130654856058209,40.0,0.0
26322,2,6322,[318 496 588  98 357],796,5,26119,4.130792345405662,40.0,0.0
26323,2,6323,[ 97 276  22 742 202],256,3,26122,4.130613535736876,0.0,0.0
26324,2,6324,[318 496 588  98 357],450,5,26127,4.130750988142292,40.0,0.0
26325,2,6325,[318 496 588  98 357],450,5,26132,4.130888397091369,40.0,0.0
26326,2,6326,[405 234 172 237  69],593,3,26135,4.130709657025447,0.0,0.0
26327,2,6327,[194  98 742  96  88],577,4,26139,4.130689001264223,0.0,0.0
26328,2,6328,[318 496 588  98 357],786,5,26144,4.1308263548743875,40.0,0.0
26329,2,6329,[318 496 588  98 357],796,5,26149,4.130963665086888,40.0,0.0
26330,2,6330,[ 96 237 111 210 265],796,4,26153,4.130942978992261,0.0,0.0
26331,2,6331,[179 153   1  79 144],450,5,26158,4.131080227416298,0.0,0.0
26332,2,6332,[427 151 405 282  70],450,5,26163,4.131217432496447,20.0,0.0
26333,2,6333,[318 496 588  98 357],716,5,26168,4.131354594253237,40.0,0.0
26334,2,6334,[318 496 588  98 357],796,5,26173,4.131491712707183,40.0,0.0
26335,2,6335,[ 70  82  98 117 179],655,2,26175,4.131155303030303,0.0,0.0
26336,2,6336,[ 88 143  56 200  28],18,2,26177,4.13081899952659,0.0,0.0
26337,2,6337,[  1 121 265  82  95],807,5,26182,4.130956137582833,0.0,0.0
26338,2,6338,[176 742 132 121 282],693,2,26184,4.130619971604354,0.0,0.0
26339,2,6339,[300 405  70 186  71],885,5,26189,4.130757097791798,0.0,0.0
26340,2,6340,[318 496 588  98 357],330,5,26194,4.130894180728592,40.0,0.0
26341,2,6341,[318 496 588  98 357],450,5,26199,4.131031220435194,40.0,0.0
26342,2,6342,[ 79 235 132 282 183],292,4,26203,4.131010562825161,0.0,0.0
26343,2,6343,[318 496 588  98 357],18,5,26208,4.131147540983607,40.0,0.0
26344,2,6344,[191  79 172 195  64],457,5,26213,4.131284475965327,20.0,0.0
26345,2,6345,[471 132 197 302 153],389,4,26217,4.131263788213047,0.0,0.0
26346,2,6346,[173   4  89 286   9],786,5,26222,4.131400661729951,0.0,20.0
26347,2,6347,[132 515 161 135 471],655,2,26224,4.131064902331443,0.0,0.0
26348,2,6348,[ 69 127 210 180 742],504,5,26229,4.131201764057332,0.0,20.0
26349,2,6349,[318 496 588  98 357],330,5,26234,4.131338582677166,40.0,0.0
26350,2,6350,[228 151   7 678 322],344,3,26237,4.131160447173674,0.0,0.0
26351,2,6351,[294 216 282 127 238],655,2,26239,4.1308249370277075,0.0,20.0
26352,2,6352,[318 496 588  98 357],330,5,26244,4.130961750354164,40.0,0.0
26353,2,6353,[ 15 172 121 385 111],786,3,26247,4.1307837582625115,0.0,0.0
26354,2,6354,[238 182  98 313 301],796,3,26250,4.130605822187254,0.0,0.0
26355,2,6355,[195 405 423 748 121],151,2,26252,4.130270610446822,0.0,0.0
26356,2,6356,[117 191  25 228 333],693,2,26254,4.129935504168633,0.0,0.0
26357,2,6357,[ 88 144 235 483 173],280,2,26256,4.1296005033029255,0.0,0.0
26358,2,6358,[318 496 588  98 357],796,5,26261,4.12973738009121,40.0,0.0
26359,2,6359,[318 496 588  98 357],786,5,26266,4.129874213836478,40.0,0.0
26360,2,6360,[185 318 286 125 405],796,4,26270,4.129853796572866,20.0,20.0
26361,2,6361,[318 496 588  98 357],330,5,26275,4.129990569003458,40.0,0.0
26362,2,6362,[234 313 282 483 183],280,1,26276,4.12949866415213,0.0,0.0
26363,2,6363,[301 385 187   7  70],450,5,26281,4.129635449402891,0.0,0.0
26364,2,6364,[ 70 258 172 483 200],457,5,26286,4.129772191673213,0.0,0.0
26365,2,6365,[234 216  70  28 403],450,4,26290,4.129751806471882,0.0,0.0
26366,2,6366,[153  69 197 276 294],280,3,26293,4.129574367834145,0.0,0.0
26367,2,6367,[180   7 210 215 597],450,4,26297,4.129554020100502,0.0,0.0
26368,2,6368,[228  82 180 405  89],72,1,26298,4.129062647197363,0.0,0.0
26369,2,6369,[318 496 588  98 357],796,5,26303,4.129199372056515,40.0,0.0
26370,2,6370,[143 176 275  88 427],655,3,26306,4.129022131533511,20.0,20.0
26371,2,6371,[318 496 588  98 357],18,5,26311,4.129158819836786,40.0,0.0
26372,2,6372,[300 204 179  95 748],450,4,26315,4.1291385532716145,0.0,0.0
26373,2,6373,[748 276 117 288 125],938,1,26316,4.128647631000941,0.0,0.0
26374,2,6374,[318 496 588  98 357],796,5,26321,4.1287843137254905,40.0,0.0
26375,2,6375,[211 496  88 194  64],236,1,26322,4.128293601003764,40.0,0.0
26376,2,6376,[318 496 588  98 357],18,5,26327,4.128430296377607,40.0,0.0
26377,2,6377,[496 127 143   4 182],389,4,26331,4.128410159924742,20.0,20.0
26378,2,6378,[318 496 588  98 357],796,5,26336,4.128546794168365,40.0,0.0
26379,2,6379,[318 496 588  98 357],716,5,26341,4.128683385579937,40.0,0.0
26380,2,6380,[318 496 588  98 357],330,5,26346,4.128819934179596,40.0,0.0
26381,2,6381,[ 56 196 111 268 175],655,0,26346,4.128172986524601,0.0,0.0
26382,2,6382,[318 496 588  98 357],450,5,26351,4.128309572301426,40.0,0.0
26383,2,6383,[318 496 588  98 357],796,5,26356,4.12844611528822,40.0,0.0
26384,2,6384,[318 496 588  98 357],18,5,26361,4.12858261550509,40.0,0.0
26385,2,6385,[318 496 588  98 357],716,5,26366,4.128719072972126,40.0,0.0
26386,2,6386,[318 496 588  98 357],450,5,26371,4.1288554877094095,40.0,0.0
26387,2,6387,[302 197 257 174 191],389,4,26375,4.128835316217908,0.0,0.0
26388,2,6388,[318 496 588  98 357],786,5,26380,4.128971670057912,40.0,0.0
26389,2,6389,[318 496 588  98 357],450,5,26385,4.129107981220657,40.0,0.0
26390,2,6390,[318 496 588  98 357],716,5,26390,4.129244249726177,40.0,0.0
26391,2,6391,[202 125 603 265 385],655,1,26391,4.128754693366709,20.0,0.0
26392,2,6392,[318 496 588  98 357],786,5,26396,4.128890974503363,40.0,0.0
26393,2,6393,[318 496 588  98 357],18,5,26401,4.129027213012199,40.0,0.0
26394,2,6394,[318 496 588  98 357],330,5,26406,4.129163408913214,40.0,0.0
26395,2,6395,[568  70 228 135 238],716,4,26410,4.129143214509068,0.0,0.0
26396,2,6396,[191 257 271   1  11],655,1,26411,4.128654056589026,0.0,0.0
26397,2,6397,[182 403 185 475 175],655,2,26413,4.128321350422007,0.0,0.0
26398,2,6398,[318 496 588  98 357],716,5,26418,4.128457571495546,40.0,0.0
26399,2,6399,[328   1 117  70 286],655,0,26418,4.1278125,0.0,20.0
26400,2,6400,[174 202 357  70 200],18,3,26421,4.127636306827058,0.0,0.0
26401,2,6401,[318 496 588  98 357],450,5,26426,4.1277725710715405,40.0,0.0
26402,2,6402,[318 496 588  98 357],786,5,26431,4.127908792753397,40.0,0.0
26403,2,6403,[318 496 588  98 357],716,5,26436,4.128044971892567,40.0,0.0
26404,2,6404,[185  56 151  50 210],504,3,26439,4.127868852459017,0.0,20.0
26405,2,6405,[318 496 588  98 357],330,5,26444,4.12800499531689,40.0,0.0
26406,2,6406,[515 183  69   9 238],655,2,26446,4.127672857811769,0.0,0.0
26407,2,6407,[211 182  98 135 405],269,4,26450,4.127652933832709,0.0,0.0
26408,2,6408,[318 496 588  98 357],786,5,26455,4.127789046653144,40.0,0.0
26409,2,6409,[301 588 191 300 742],796,3,26458,4.127613104524181,0.0,0.0
26410,2,6410,[742  15 237 132  25],450,3,26461,4.127437217282795,0.0,0.0
26411,2,6411,[318 496 588  98 357],786,5,26466,4.127573300062383,40.0,0.0
26412,2,6412,[318 496 588  98 357],716,5,26471,4.1277093404023075,40.0,0.0
26413,2,6413,[318 496 588  98 357],18,5,26476,4.12784533832242,40.0,0.0
26414,2,6414,[318 496 588  98 357],716,5,26481,4.127981293842557,40.0,0.0
26415,2,6415,[132  88 186 187 423],269,3,26484,4.12780548628429,0.0,0.0
26416,2,6416,[202 125 742  28  56],450,5,26489,4.127941405641265,0.0,0.0
26417,2,6417,[182 202   1 187 282],450,5,26494,4.128077282642567,0.0,0.0
26418,2,6418,[318 496 588  98 357],786,5,26499,4.128213117307992,40.0,0.0
26419,2,6419,[ 88 234 121 300 357],796,4,26503,4.128193146417446,0.0,0.0
26420,2,6420,[318 496 588  98 357],786,5,26508,4.128328920728858,40.0,0.0
26421,2,6421,[204 258 282 288 211],450,4,26512,4.128308938025537,0.0,0.0
26422,2,6422,[471 173  71 186 180],535,5,26517,4.128444652031761,0.0,0.0
26423,2,6423,[215 234  82 191 300],716,5,26522,4.128580323785803,0.0,0.0
26424,2,6424,[186 300 174 215 483],535,4,26526,4.128560311284047,0.0,0.0
26425,2,6425,[318 496 588  98 357],450,5,26531,4.12869592281357,40.0,0.0
26426,2,6426,[318 496 588  98 357],18,5,26536,4.128831492142524,40.0,0.0
26427,2,6427,[197  22 603 204 100],655,1,26537,4.128344741754822,20.0,20.0
26428,2,6428,[318 496 588  98 357],330,5,26542,4.128480323533987,40.0,0.0
26429,2,6429,[318 496 588  98 357],450,5,26547,4.128615863141524,40.0,0.0
26430,2,6430,[318 496 588  98 357],450,5,26552,4.128751360597108,40.0,0.0
26431,2,6431,[132 427 588 405 322],796,4,26556,4.128731343283582,20.0,0.0
26432,2,6432,[ 56 423 161 195  28],72,5,26561,4.128866780662211,0.0,0.0
26433,2,6433,[328 143  25  71 357],450,3,26564,4.128691327323593,0.0,0.0
26434,2,6434,[403 546 228 405 234],807,4,26568,4.128671328671329,0.0,0.0
26435,2,6435,[237  98 257 475 508],655,1,26569,4.1281852082038535,0.0,0.0
26436,2,6436,[546 322   1 197   4],796,2,26571,4.127854590647817,0.0,0.0
26437,2,6437,[318 496 588  98 357],796,5,26576,4.127990059024542,40.0,0.0
26438,2,6438,[546 318 235 483 161],457,3,26579,4.127814878086659,20.0,0.0
26439,2,6439,[318 496 588  98 357],330,5,26584,4.127950310559006,40.0,0.0
26440,2,6440,[ 82  50 127 100 568],457,5,26589,4.128085700978109,0.0,60.0
26441,2,6441,[  1  22 288  12 265],450,4,26593,4.128065818068922,0.0,0.0
26442,2,6442,[318 496 588  98 357],716,5,26598,4.128201148533292,40.0,0.0
26443,2,6443,[588   1 423  79 294],450,5,26603,4.128336436995655,0.0,0.0
26444,2,6444,[742 195 161 357 275],457,5,26608,4.128471683475563,0.0,20.0
26445,2,6445,[318 496 588  98 357],450,5,26613,4.128606887992554,40.0,0.0
26446,2,6446,[318 496 588  98 357],450,5,26618,4.128742050566155,40.0,0.0
26447,2,6447,[286  88  25 318  97],18,3,26621,4.12856699751861,20.0,20.0
26448,2,6448,[318 496 588  98 357],796,5,26626,4.128702124360366,40.0,0.0
26449,2,6449,[678 181 496 196 269],344,3,26629,4.1285271317829455,20.0,0.0
26450,2,6450,[ 96 185 286 748 172],450,5,26634,4.128662222911177,0.0,20.0
26451,2,6451,[210 185 200 238 111],450,3,26637,4.128487290762554,0.0,0.0
26452,2,6452,[185 210 271 742 234],796,2,26639,4.1281574461490775,0.0,0.0
26453,2,6453,[318 496 588  98 357],796,5,26644,4.128292531763248,40.0,0.0
26454,2,6454,[318 496 588  98 357],330,5,26649,4.12842757552285,40.0,0.0
26455,2,6455,[ 15 117 471 222 405],256,5,26654,4.128562577447336,0.0,0.0
26456,2,6456,[282 328 211 197 182],450,5,26659,4.128697537556141,0.0,0.0
26457,2,6457,[318 496 588  98 357],716,5,26664,4.12883245586869,40.0,0.0
26458,2,6458,[186 471 135 273 275],450,2,26666,4.128502864220468,0.0,20.0
26459,2,6459,[427 195 204 496  22],269,2,26668,4.128173374613003,40.0,0.0
26460,2,6460,[  8 603  98 187  25],503,4,26672,4.128153536604241,20.0,0.0
26461,2,6461,[318 496 588  98 357],18,5,26677,4.128288455586506,40.0,0.0
26462,2,6462,[318 496 588  98 357],18,5,26682,4.128423332817577,40.0,0.0
26463,2,6463,[294 655 286   7 153],629,3,26685,4.128248762376238,0.0,20.0
26464,2,6464,[ 50 194 483  82 181],796,4,26689,4.128228924980665,0.0,20.0
26465,2,6465,[ 25   7  89 151 423],151,5,26694,4.128363748840086,0.0,0.0
26466,2,6466,[  4 181 228 423   1],577,4,26698,4.128343899798979,0.0,0.0
26467,2,6467,[174  96 300 127 100],450,5,26703,4.12847866419295,0.0,40.0
26468,2,6468,[318 496 588  98 357],450,5,26708,4.128613386922244,40.0,0.0
26469,2,6469,[318 496 588  98 357],786,5,26713,4.128748068006183,40.0,0.0
26470,2,6470,[318 496 588  98 357],18,5,26718,4.12888270746407,40.0,0.0
26471,2,6471,[318 496 588  98 357],330,5,26723,4.129017305315204,40.0,0.0
26472,2,6472,[318 496 588  98 357],18,5,26728,4.129151861578866,40.0,0.0
26473,2,6473,[318 496 588  98 357],330,5,26733,4.129286376274328,40.0,0.0
26474,2,6474,[ 88 161 286 483  71],389,2,26735,4.128957528957529,0.0,20.0
26475,2,6475,[403 175 151  97 742],457,5,26740,4.129092032118591,0.0,0.0
26476,2,6476,[237 182 301  98 471],655,2,26742,4.128763316350162,0.0,0.0
26477,2,6477,[ 22 568  82  56 435],269,1,26743,4.128280333436246,0.0,0.0
26478,2,6478,[175 333 282 195 302],655,1,26744,4.127797499614138,0.0,0.0
26479,2,6479,[318 496 588  98 357],786,5,26749,4.127932098765432,40.0,0.0
26480,2,6480,[318 496 588  98 357],330,5,26754,4.128066656380188,40.0,0.0
26481,2,6481,[210 215 588 211 194],18,3,26757,4.127892625732798,0.0,0.0
26482,2,6482,[318 496 588  98 357],330,5,26762,4.128027147925343,40.0,0.0
26483,2,6483,[318 496 588  98 357],716,5,26767,4.128161628624306,40.0,0.0
26484,2,6484,[318 496 588  98 357],330,5,26772,4.128296067848882,40.0,0.0
26485,2,6485,[318 496 588  98 357],716,5,26777,4.128430465618255,40.0,0.0
26486,2,6486,[318 496 588  98 357],716,5,26782,4.128564821951596,40.0,0.0
26487,2,6487,[318 496 588  98 357],716,5,26787,4.128699136868065,40.0,0.0
26488,2,6488,[318 496 588  98 357],716,5,26792,4.128833410386808,40.0,0.0
26489,2,6489,[318 496 588  98 357],716,5,26797,4.128967642526964,40.0,0.0
26490,2,6490,[173  95 742 153 197],796,3,26800,4.1287937143737485,0.0,0.0
26491,2,6491,[435 234 143  25 286],389,2,26802,4.128465804066543,0.0,20.0
26492,2,6492,[276 100 210 405 204],280,1,26803,4.127983982750655,0.0,20.0
26493,2,6493,[483 215 257 282 121],655,1,26804,4.127502309824453,0.0,0.0
26494,2,6494,[204 143  89 121 117],450,4,26808,4.127482678983834,0.0,0.0
26495,2,6495,[318 496 588  98 357],450,5,26813,4.1276169950738915,40.0,0.0
26496,2,6496,[286 210  98 678 121],344,2,26815,4.127289518239187,0.0,20.0
26497,2,6497,[318 496 588  98 357],796,5,26820,4.127423822714682,40.0,0.0
26498,2,6498,[210 237 151  88 496],236,1,26821,4.126942606554855,20.0,0.0
26499,2,6499,[182 125  71 132 234],796,4,26825,4.126923076923077,0.0,0.0
26500,2,6500,[191 423 125 258 210],151,4,26829,4.126903553299492,0.0,0.0
26501,2,6501,[318 496 588  98 357],330,5,26834,4.127037834512458,40.0,0.0
26502,2,6502,[318 496 588  98 357],786,5,26839,4.127172074427188,40.0,0.0
26503,2,6503,[318 496 588  98 357],786,5,26844,4.127306273062731,40.0,0.0
26504,2,6504,[318 496 588  98 357],716,5,26849,4.127440430438124,40.0,0.0
26505,2,6505,[125 180 195 174 204],450,5,26854,4.1275745465723945,0.0,0.0
26506,2,6506,[435 322   4 173  88],151,4,26858,4.127554940832949,0.0,0.0
26507,2,6507,[403 182 275 475  50],655,3,26861,4.127381684081131,0.0,40.0
26508,2,6508,[111 286 435  50 191],655,2,26863,4.127054847134737,0.0,40.0
26509,2,6509,[237 258  89  22 151],450,5,26868,4.127188940092166,0.0,0.0
26510,2,6510,[257 194 655 132 588],23,3,26871,4.127015819382583,0.0,0.0
26511,2,6511,[318 496 588  98 357],450,5,26876,4.127149877149877,40.0,0.0
26512,2,6512,[318 496 588  98 357],716,5,26881,4.12728389375096,40.0,0.0
26513,2,6513,[196 175   1  22 357],457,5,26886,4.127417869204789,0.0,0.0
26514,2,6514,[ 11 333  79 175 268],655,1,26887,4.126937835763623,0.0,0.0
26515,2,6515,[191 427 216 257 196],23,2,26889,4.126611418047882,20.0,0.0
26516,2,6516,[318 496 588  98 357],786,5,26894,4.126745435016112,40.0,0.0
26517,2,6517,[318 496 588  98 357],716,5,26899,4.1268794108622275,40.0,0.0
26518,2,6518,[318 496 588  98 357],330,5,26904,4.127013345605154,40.0,0.0
26519,2,6519,[318 496 588  98 357],786,5,26909,4.127147239263803,40.0,0.0
26520,2,6520,[318 496 588  98 357],716,5,26914,4.1272810918570775,40.0,0.0
26521,2,6521,[179 748 176 121 153],450,4,26918,4.127261576203619,0.0,0.0
26522,2,6522,[318 496 588  98 357],796,5,26923,4.127395370228422,40.0,0.0
26523,2,6523,[187  50 127 748 100],450,5,26928,4.127529123237278,0.0,60.0
26524,2,6524,[ 15  79  89  22 322],256,5,26933,4.127662835249042,0.0,0.0
26525,2,6525,[302 195 210 228 173],352,2,26935,4.127336806619675,0.0,0.0
26526,2,6526,[318 496 588  98 357],18,5,26940,4.1274705071242535,40.0,0.0
26527,2,6527,[318 496 588  98 357],786,5,26945,4.127604166666667,40.0,0.0
26528,2,6528,[204 423 588 197 182],796,4,26949,4.127584622453668,0.0,0.0
26529,2,6529,[168   8 202 197 121],269,2,26951,4.127258805513017,0.0,0.0
26530,2,6530,[  4 173 546 228 385],280,2,26953,4.126933088347879,0.0,0.0
26531,2,6531,[318 496 588  98 357],716,5,26958,4.127066748315983,40.0,0.0
26532,2,6532,[  7  98 161 655 135],450,4,26962,4.127047298331547,0.0,0.0
26533,2,6533,[182 301 403 546 742],450,5,26967,4.127180899908173,0.0,0.0
26534,2,6534,[  4  98 294 269 186],450,3,26970,4.1270084162203515,0.0,0.0
26535,2,6535,[318 496 588  98 357],450,5,26975,4.127141982864137,40.0,0.0
26536,2,6536,[ 89 257  98 204  28],457,4,26979,4.127122533272143,0.0,0.0
26537,2,6537,[197 111 117  98  56],174,5,26984,4.127256041602936,0.0,0.0
26538,2,6538,[742 423 132 195 153],280,4,26988,4.1272365805168985,0.0,0.0
26539,2,6539,[318 496 588  98 357],786,5,26993,4.12737003058104,40.0,0.0
26540,2,6540,[172 194  12 202 273],450,4,26997,4.127350558018652,0.0,0.0
26541,2,6541,[318 496 588  98 357],716,5,27002,4.127483949862428,40.0,0.0
26542,2,6542,[216  25 182 135  79],450,3,27005,4.1273116307504205,0.0,0.0
26543,2,6543,[318 496 588  98 357],330,5,27010,4.127444987775061,40.0,0.0
26544,2,6544,[318 496 588  98 357],18,5,27015,4.1275783040488925,40.0,0.0
26545,2,6545,[318 496 588  98 357],716,5,27020,4.127711579590589,40.0,0.0
26546,2,6546,[568  15 742  50 211],796,3,27023,4.1275393309912936,0.0,20.0
26547,2,6547,[318 496 588  98 357],786,5,27028,4.127672571777642,40.0,0.0
26548,2,6548,[568 132 168 234 210],457,5,27033,4.127805771873568,0.0,0.0
26549,2,6549,[328  98  97 435  50],655,2,27035,4.127480916030534,0.0,20.0
26550,2,6550,[ 50 357 183   1 181],796,4,27039,4.127461456266219,0.0,20.0
26551,2,6551,[318 496 588  98 357],450,5,27044,4.127594627594628,40.0,0.0
26552,2,6552,[265 257   8  79 100],796,4,27048,4.127575156416908,0.0,20.0
26553,2,6553,[603 289  22 294 423],655,1,27049,4.127097955447055,20.0,0.0
26554,2,6554,[318 496 588  98 357],18,5,27054,4.127231121281465,40.0,0.0
26555,2,6555,[202 210 405 483 186],796,3,27057,4.12705918242831,0.0,0.0
26556,2,6556,[318 496 588  98 357],450,5,27062,4.127192313558029,40.0,0.0
26557,2,6557,[235  89   8 127  69],269,1,27063,4.126715462031107,0.0,20.0
26558,2,6558,[197 125 144 568  98],655,1,27064,4.126238755907913,0.0,0.0
26559,2,6559,[318 496 588  98 357],330,5,27069,4.126371951219512,40.0,0.0
26560,2,6560,[301 191 118  64  79],450,4,27073,4.126352690138698,20.0,0.0
26561,2,6561,[  9 143 275  98 748],796,4,27077,4.126333434928376,0.0,20.0
26562,2,6562,[318 496 588  98 357],330,5,27082,4.126466554929149,40.0,0.0
26563,2,6563,[174 176 118 269  15],796,4,27086,4.126447288238879,0.0,0.0
26564,2,6564,[318 496 588  98 357],18,5,27091,4.126580350342727,40.0,0.0
26565,2,6565,[318 496 588  98 357],716,5,27096,4.126713371915931,40.0,0.0
26566,2,6566,[318 496 588  98 357],716,5,27101,4.126846352977006,40.0,0.0
26567,2,6567,[318 496 588  98 357],796,5,27106,4.126979293544458,40.0,0.0
26568,2,6568,[ 69  64 196 179   7],655,2,27108,4.126655503120719,20.0,0.0
26569,2,6569,[318 496 588  98 357],786,5,27113,4.126788432267884,40.0,0.0
26570,2,6570,[100 257 202 118 127],504,3,27116,4.126616953279561,0.0,40.0
26571,2,6571,[318 496 588  98 357],716,5,27121,4.126749847839318,40.0,0.0
26572,2,6572,[282 132  82 748 172],796,4,27125,4.126730564430245,0.0,0.0
26573,2,6573,[318 496 588  98 357],450,5,27130,4.1268634012777605,40.0,0.0
26574,2,6574,[318 496 588  98 357],18,5,27135,4.126996197718631,40.0,0.0
26575,2,6575,[318 496 588  98 357],786,5,27140,4.127128953771289,40.0,0.0
26576,2,6576,[196 234 238 322 435],151,4,27144,4.1271096244488366,0.0,0.0
26577,2,6577,[318 496 588  98 357],18,5,27149,4.127242322894497,40.0,0.0
26578,2,6578,[318 496 588  98 357],796,5,27154,4.127374981000152,40.0,0.0
26579,2,6579,[318 496 588  98 357],786,5,27159,4.127507598784194,40.0,0.0
26580,2,6580,[318 496 588  98 357],450,5,27164,4.127640176265006,40.0,0.0
26581,2,6581,[318 496 588  98 357],450,5,27169,4.1277727134609545,40.0,0.0
26582,2,6582,[194 111  69 127 173],716,5,27174,4.1279052103903995,0.0,20.0
26583,2,6583,[318 496 588  98 357],796,5,27179,4.1280376670716885,40.0,0.0
26584,2,6584,[318 496 588  98 357],330,5,27184,4.128170083523159,40.0,0.0
26585,2,6585,[238 186  15 161 118],389,1,27185,4.127695110841178,0.0,0.0
26586,2,6586,[318 496 588  98 357],786,5,27190,4.127827539092151,40.0,0.0
26587,2,6587,[ 69  64 196 237 294],236,3,27193,4.127656344869459,20.0,0.0
26588,2,6588,[318 496 588  98 357],786,5,27198,4.127788738807102,40.0,0.0
26589,2,6589,[144 294 742 228  89],450,5,27203,4.127921092564492,0.0,0.0
26590,2,6590,[179   4 597  28 197],457,4,27207,4.127901684114702,0.0,0.0
26591,2,6591,[ 64   7 182  88 234],655,2,27209,4.127578883495145,20.0,0.0
26592,2,6592,[ 97   8 276 196 427],535,4,27213,4.127559532837858,20.0,0.0
26593,2,6593,[271  89 546 294 313],796,4,27217,4.127540188049742,0.0,0.0
26594,2,6594,[168 111 357 216 405],11,2,27219,4.127217589082639,0.0,0.0
26595,2,6595,[187 301 200 237 161],796,4,27223,4.127198302001213,0.0,0.0
26596,2,6596,[427  89 196 195  98],796,5,27228,4.127330604820373,20.0,0.0
26597,2,6597,[318 496 588  98 357],796,5,27233,4.127462867535617,40.0,0.0
26598,2,6598,[181  98 202 100   9],878,3,27236,4.127292013941506,0.0,20.0
26599,2,6599,[202 127 179 195   9],18,3,27239,4.127121212121212,0.0,20.0
26600,2,6600,[ 69 204 294 496 117],450,5,27244,4.127253446447508,20.0,0.0
26601,2,6601,[318 496 588  98 357],330,5,27249,4.127385640714935,40.0,0.0
26602,2,6602,[318 496 588  98 357],796,5,27254,4.127517794941693,40.0,0.0
26603,2,6603,[318 496 588  98 357],18,5,27259,4.127649909145972,40.0,0.0
26604,2,6604,[318 496 588  98 357],796,5,27264,4.12778198334595,40.0,0.0
26605,2,6605,[405 403 748 100  56],256,4,27268,4.12776264002422,0.0,20.0
26606,2,6606,[161 186  50 179 176],457,5,27273,4.127894657181777,0.0,20.0
26607,2,6607,[161  69 568 181 265],716,4,27277,4.127875302663438,0.0,0.0
26608,2,6608,[318 496 588  98 357],330,5,27282,4.128007262823423,40.0,0.0
26609,2,6609,[318 496 588  98 357],786,5,27287,4.128139183055976,40.0,0.0
26610,2,6610,[318 496 588  98 357],716,5,27292,4.128271063379216,40.0,0.0
26611,2,6611,[318 496 588  98 357],796,5,27297,4.128402903811252,40.0,0.0
26612,2,6612,[322 174 403 204  95],450,4,27301,4.128383487070921,0.0,0.0
26613,2,6613,[200  71 132 294 237],236,2,27303,4.1280616873299065,0.0,0.0
26614,2,6614,[194   4 748 173 237],450,4,27307,4.128042328042328,0.0,0.0
26615,2,6615,[318 496 588  98 357],716,5,27312,4.128174123337364,40.0,0.0
26616,2,6616,[318 496 588  98 357],786,5,27317,4.128305878797038,40.0,0.0
26617,2,6617,[204  50 121 185 194],401,3,27320,4.128135388334845,0.0,20.0
26618,2,6618,[385 210  82 117  79],807,5,27325,4.128267109835322,0.0,0.0
26619,2,6619,[318 496 588  98 357],450,5,27330,4.128398791540786,40.0,0.0
26620,2,6620,[117 313 172 678 202],280,1,27331,4.127926295121583,0.0,0.0
26621,2,6621,[423 748  28 318 195],151,3,27334,4.127755964965267,20.0,0.0
26622,2,6622,[318 496 588  98 357],450,5,27339,4.127887664200514,40.0,0.0
26623,2,6623,[237 180 144 238  88],457,5,27344,4.128019323671498,0.0,0.0
26624,2,6624,[318 496 588  98 357],796,5,27349,4.128150943396227,40.0,0.0
26625,2,6625,[143  71 210 655 301],796,2,27351,4.127829761545427,0.0,0.0
26626,2,6626,[318 496 588  98 357],330,5,27356,4.1279613701524065,40.0,0.0
26627,2,6627,[234  64   7  88 357],450,4,27360,4.127942063971032,20.0,0.0
26628,2,6628,[318 496 588  98 357],796,5,27365,4.128073615930004,40.0,0.0
26629,2,6629,[ 71 181 742 215 168],504,4,27369,4.128054298642534,0.0,0.0
26630,2,6630,[318 496 588  98 357],786,5,27374,4.128185793997889,40.0,0.0
26631,2,6631,[318 496 588  98 357],796,5,27379,4.128317249698432,40.0,0.0
26632,2,6632,[ 70 568 180 175   4],457,5,27384,4.1284486657620985,0.0,0.0
26633,2,6633,[  8 546   1 313  64],577,4,27388,4.128429303587579,20.0,0.0
26634,2,6634,[ 69  50 234  95 210],716,5,27393,4.128560663149963,0.0,20.0
26635,2,6635,[210 173 245 323 186],796,1,27394,4.128089210367691,0.0,0.0
26636,2,6636,[318 496 588  98 357],716,5,27399,4.128220581588067,40.0,0.0
26637,2,6637,[318 496 588  98 357],450,5,27404,4.128351913226876,40.0,0.0
26638,2,6638,[318 496 588  98 357],786,5,27409,4.128483205302003,40.0,0.0
26639,2,6639,[318 496 588  98 357],330,5,27414,4.1286144578313255,40.0,0.0
26640,2,6640,[318 496 588  98 357],786,5,27419,4.128745670832706,40.0,0.0
26641,2,6641,[172 196 176 234  82],389,4,27423,4.1287262872628725,0.0,0.0
26642,2,6642,[257  15 265 357 182],796,5,27428,4.128857443925937,0.0,0.0
26643,2,6643,[318 496 588  98 357],330,5,27433,4.128988561107766,40.0,0.0
26644,2,6644,[ 89  64 143 174  70],269,1,27434,4.128517682468021,20.0,0.0
26645,2,6645,[318 496 588  98 357],330,5,27439,4.1286488113150765,40.0,0.0
26646,2,6646,[183 276 265  89 210],786,4,27443,4.1286294568978485,0.0,0.0
26647,2,6647,[318 195 588   1 185],457,5,27448,4.128760529482551,20.0,0.0
26648,2,6648,[318 496 588  98 357],796,5,27453,4.128891562640999,40.0,0.0
26649,2,6649,[ 98 588 405 161 181],457,5,27458,4.129022556390978,0.0,0.0
26650,2,6650,[318 496 588  98 357],796,5,27463,4.129153510750263,40.0,0.0
26651,2,6651,[ 70 483 194  89 172],450,4,27467,4.12913409500902,0.0,0.0
26652,2,6652,[318 496 588  98 357],716,5,27472,4.129264993236134,40.0,0.0
26653,2,6653,[271 273 603  12 385],796,4,27476,4.129245566576495,20.0,0.0
26654,2,6654,[228  69 423 135 273],450,3,27479,4.129075882794891,0.0,0.0
26655,2,6655,[546 202 222 181 318],786,5,27484,4.129206730769231,20.0,0.0
26656,2,6656,[318 496 588  98 357],330,5,27489,4.129337539432177,40.0,0.0
26657,2,6657,[ 15 143  50 302 181],389,3,27492,4.129167918293782,0.0,20.0
26658,2,6658,[318 496 588  98 357],18,5,27497,4.129298693497522,40.0,0.0
26659,2,6659,[318 496 588  98 357],716,5,27502,4.12942942942943,40.0,0.0
26660,2,6660,[ 22 597 294 175 357],457,3,27505,4.129259870890257,0.0,0.0
26661,2,6661,[ 89 216  95 176 258],23,4,27509,4.129240468327829,0.0,0.0
26662,2,6662,[135 508 302 237  88],655,2,27511,4.128920906498574,0.0,0.0
26663,2,6663,[318 496 588  98 357],796,5,27516,4.1290516206482595,40.0,0.0
26664,2,6664,[ 50 210 153 318 357],535,4,27520,4.129032258064516,20.0,20.0
26665,2,6665,[318 496 588  98 357],18,5,27525,4.129162916291629,40.0,0.0
26666,2,6666,[216 405  28 275 273],450,4,27529,4.129143542822859,0.0,20.0
26667,2,6667,[318 496 588  98 357],330,5,27534,4.129274145170966,40.0,0.0
26668,2,6668,[318 496 588  98 357],450,5,27539,4.129404708352077,40.0,0.0
26669,2,6669,[237 748 265 678  71],280,2,27541,4.129085457271365,0.0,0.0
26670,2,6670,[318 496 588  98 357],716,5,27546,4.1292160095937644,40.0,0.0
26671,2,6671,[318 496 588  98 357],330,5,27551,4.129346522781774,40.0,0.0
26672,2,6672,[318 496 588  98 357],786,5,27556,4.12947699685299,40.0,0.0
26673,2,6673,[318 496 588  98 357],796,5,27561,4.129607431824993,40.0,0.0
26674,2,6674,[318 496 588  98 357],330,5,27566,4.129737827715356,40.0,0.0
26675,2,6675,[238  56 323 176 403],504,1,27567,4.129269023367286,0.0,0.0
26676,2,6676,[318 496 588  98 357],716,5,27572,4.129399430882133,40.0,0.0
26677,2,6677,[318 496 588  98 357],18,5,27577,4.12952979934112,40.0,0.0
26678,2,6678,[215 228 191 300 427],11,2,27579,4.129210959724509,20.0,0.0
26679,2,6679,[196  88 546 275 215],450,5,27584,4.129341317365269,0.0,20.0
26680,2,6680,[318 496 588  98 357],450,5,27589,4.129471635982637,40.0,0.0
26681,2,6681,[318 496 588  98 357],796,5,27594,4.129601915594134,40.0,0.0
26682,2,6682,[186 385 515 471 121],716,2,27596,4.129283256022744,0.0,0.0
26683,2,6683,[ 71  56  88 191 265],450,4,27600,4.129263913824057,0.0,0.0
26684,2,6684,[318 496 588  98 357],716,5,27605,4.12939416604338,40.0,0.0
26685,2,6685,[318 496 588  98 357],786,5,27610,4.12952437930003,40.0,0.0
26686,2,6686,[318 496 588  98 357],450,5,27615,4.129654553611485,40.0,0.0
26687,2,6687,[318 496 588  98 357],330,5,27620,4.1297846889952154,40.0,0.0
26688,2,6688,[172  98 357 196 222],344,5,27625,4.12991478546868,0.0,0.0
26689,2,6689,[275 237 173   1  28],457,5,27630,4.130044843049327,0.0,20.0
26690,2,6690,[318 496 588  98 357],786,5,27635,4.130174861754596,40.0,0.0
26691,2,6691,[318 496 588  98 357],786,5,27640,4.130304841601912,40.0,0.0
26692,2,6692,[357 300   9 194  64],796,4,27644,4.130285372777529,20.0,0.0
26693,2,6693,[403  97   1 423 210],72,4,27648,4.1302659097699435,0.0,0.0
26694,2,6694,[282 173 211 111 118],716,3,27651,4.1300970873786405,0.0,0.0
26695,2,6695,[ 50 288 423  70 125],280,3,27654,4.129928315412187,0.0,20.0
26696,2,6696,[318 496 588  98 357],450,5,27659,4.130058235030611,40.0,0.0
26697,2,6697,[286  22 135 161 235],330,4,27663,4.13003881755748,0.0,20.0
26698,2,6698,[204   1 111  70 234],18,2,27665,4.129720853858785,0.0,0.0
26699,2,6699,[288 182 427 191 125],655,3,27668,4.12955223880597,20.0,0.0
26700,2,6700,[176 742   1 288 568],655,0,27668,4.128935979704521,0.0,0.0
26701,2,6701,[318 496 588  98 357],330,5,27673,4.129065950462548,40.0,0.0
26702,2,6702,[318 496 588  98 357],18,5,27678,4.1291958824406985,40.0,0.0
26703,2,6703,[200   9  97  28 228],655,1,27679,4.128729116945108,0.0,0.0
26704,2,6704,[403 313  22 742 546],450,5,27684,4.128859060402685,0.0,0.0
26705,2,6705,[  8 111  71 313 153],280,4,27688,4.128839844915001,0.0,0.0
26706,2,6706,[313  28 182 196 322],450,5,27693,4.128969733114657,0.0,0.0
26707,2,6707,[294 202 173  25 196],450,4,27697,4.128950506857484,0.0,0.0
26708,2,6708,[183 174 234 496 235],280,2,27699,4.128633179311373,20.0,0.0
26709,2,6709,[318 496 588  98 357],330,5,27704,4.12876304023845,40.0,0.0
26710,2,6710,[245  88  70  50 143],450,5,27709,4.12889286246461,0.0,20.0
26711,2,6711,[435 121 234 194 300],450,3,27712,4.128724672228844,0.0,0.0
26712,2,6712,[174 172 118  98 234],450,3,27715,4.128556532101892,0.0,0.0
26713,2,6713,[ 82 318 496 357 176],450,4,27719,4.128537384569556,40.0,0.0
26714,2,6714,[318 496 588  98 357],716,5,27724,4.1286671630677585,40.0,0.0
26715,2,6715,[318 496 588  98 357],796,5,27729,4.1287969029184035,40.0,0.0
26716,2,6716,[143 186 282 174 161],693,3,27732,4.128628852166146,0.0,0.0
26717,2,6717,[153 151 174 423 328],236,2,27734,4.128311997618339,0.0,0.0
26718,2,6718,[318 496 588  98 357],786,5,27739,4.128441732400655,40.0,0.0
26719,2,6719,[318 496 588  98 357],786,5,27744,4.128571428571429,40.0,0.0
26720,2,6720,[318 496 588  98 357],450,5,27749,4.1287010861478946,40.0,0.0
26721,2,6721,[318 496 588  98 357],18,5,27754,4.128830705147277,40.0,0.0
26722,2,6722,[ 88 405 234 471  56],716,4,27758,4.128811542466161,0.0,0.0
26723,2,6723,[196 100 143 135   7],457,5,27763,4.128941106484236,0.0,20.0
26724,2,6724,[161  28 216 200  69],655,2,27765,4.128624535315985,0.0,0.0
26725,2,6725,[175 127 515   9 197],321,3,27768,4.128456735057984,0.0,20.0
26726,2,6726,[144 496 197   7 597],450,5,27773,4.128586294038947,20.0,0.0
26727,2,6727,[318 496 588  98 357],716,5,27778,4.12871581450654,40.0,0.0
26728,2,6728,[313 294 200 182  50],450,4,27782,4.12869668598603,0.0,20.0
26729,2,6729,[268 265 174   7 435],535,3,27785,4.128528974739971,0.0,0.0
26730,2,6730,[  1 195  88  69 313],280,2,27787,4.128212746991531,0.0,0.0
26731,2,6731,[318 496 588  98 357],796,5,27792,4.128342245989304,40.0,0.0
26732,2,6732,[144 175  95 195 423],23,3,27795,4.128174662111986,0.0,0.0
26733,2,6733,[ 11 322 568 288  71],344,2,27797,4.127858627858628,0.0,0.0
26734,2,6734,[286   7  88  69 196],450,5,27802,4.1279881217520416,0.0,20.0
26735,2,6735,[318 496 588  98 357],716,5,27807,4.128117577197149,40.0,0.0
26736,2,6736,[  7 403 111 385 118],280,3,27810,4.127950126168918,0.0,0.0
26737,2,6737,[173  98 318   7 385],280,4,27814,4.127931136835857,20.0,0.0
26738,2,6738,[111 423   1  71 151],18,3,27817,4.12776376316961,0.0,0.0
26739,2,6739,[318 496 588  98 357],18,5,27822,4.127893175074184,40.0,0.0
26740,2,6740,[568 273 186 204 195],655,1,27823,4.127429164812343,0.0,0.0
26741,2,6741,[144 588 194 118 176],450,4,27827,4.127410264016612,0.0,0.0
26742,2,6742,[742 323  88 197  28],174,4,27831,4.127391368826932,0.0,0.0
26743,2,6743,[318 496 588  98 357],786,5,27836,4.127520759193357,40.0,0.0
26744,2,6744,[318 496 588  98 357],786,5,27841,4.127650111193477,40.0,0.0
26745,2,6745,[471  28  25 289 117],655,0,27841,4.127038244885858,0.0,0.0
26746,2,6746,[318 496 588  98 357],796,5,27846,4.127167630057803,40.0,0.0
26747,2,6747,[191 216 385  12  28],450,5,27851,4.12729697688204,0.0,0.0
26748,2,6748,[318 496 588  98 357],330,5,27856,4.127426285375611,40.0,0.0
26749,2,6749,[318 496 588  98 357],716,5,27861,4.127555555555555,40.0,0.0
26750,2,6750,[318 496 588  98 357],450,5,27866,4.1276847874388976,40.0,0.0
26751,2,6751,[318 496 588  98 357],716,5,27871,4.127813981042654,40.0,0.0
26752,2,6752,[603 176 234 235  69],269,1,27872,4.127350807048719,20.0,0.0
26753,2,6753,[318 496 588  98 357],786,5,27877,4.127480011844833,40.0,0.0
26754,2,6754,[318 496 588  98 357],330,5,27882,4.127609178386381,40.0,0.0
26755,2,6755,[318 496 588  98 357],786,5,27887,4.1277383066903495,40.0,0.0
26756,2,6756,[ 22 176 175 276 135],655,2,27889,4.127423412757141,0.0,0.0
26757,2,6757,[318 496 588  98 357],716,5,27894,4.127552530334419,40.0,0.0
26758,2,6758,[742 194 183 427  70],450,5,27899,4.1276816097055775,20.0,0.0
26759,2,6759,[318 496 588  98 357],450,5,27904,4.127810650887574,40.0,0.0
26760,2,6760,[161  89 125 127 597],450,5,27909,4.127939653897353,0.0,20.0
26761,2,6761,[742 257 235 194  82],457,3,27912,4.127772848269743,0.0,0.0
26762,2,6762,[318 496 588  98 357],796,5,27917,4.127901818719503,40.0,0.0
26763,2,6763,[318 496 588  98 357],450,5,27922,4.128030751034891,40.0,0.0
26764,2,6764,[318 496 588  98 357],450,5,27927,4.128159645232816,40.0,0.0
26765,2,6765,[174  69 423 568 187],72,5,27932,4.12828850133018,0.0,0.0
26766,2,6766,[194 153 121 182 588],796,5,27937,4.128417319343875,0.0,0.0
26767,2,6767,[318 496 588  98 357],18,5,27942,4.12854609929078,40.0,0.0
26768,2,6768,[216 143 151 196  98],18,3,27945,4.128379376569656,0.0,0.0
26769,2,6769,[121 194 271 125 215],796,5,27950,4.128508124076809,0.0,0.0
26770,2,6770,[200 222 475 742 271],655,1,27951,4.128046078865751,0.0,0.0
26771,2,6771,[117 172   9 202  89],796,4,27955,4.128027170702894,0.0,0.0
26772,2,6772,[318 496 588  98 357],716,5,27960,4.128155913184704,40.0,0.0
26773,2,6773,[200 222  88 228 238],655,1,27961,4.127694124594036,0.0,0.0
26774,2,6774,[185  89 151 180   8],269,2,27963,4.127380073800738,0.0,0.0
26775,2,6775,[318 496 588  98 357],716,5,27968,4.127508854781582,40.0,0.0
26776,2,6776,[318 496 588  98 357],330,5,27973,4.127637597757119,40.0,0.0
26777,2,6777,[234  56  98 118 655],151,4,27977,4.127618766597816,0.0,0.0
26778,2,6778,[318 496 588  98 357],450,5,27982,4.127747455376899,40.0,0.0
26779,2,6779,[258   4  50 257 153],504,3,27985,4.127581120943953,0.0,20.0
26780,2,6780,[318 496 588  98 357],330,5,27990,4.127709777318979,40.0,0.0
26781,2,6781,[294 161 742 125 313],280,2,27992,4.127396048363314,0.0,0.0
26782,2,6782,[318 496 588  98 357],330,5,27997,4.127524694088161,40.0,0.0
26783,2,6783,[269 483 211 228 143],796,3,28000,4.127358490566038,0.0,0.0
26784,2,6784,[318 496 588  98 357],786,5,28005,4.127487103905675,40.0,0.0
26785,2,6785,[318 496 588  98 357],796,5,28010,4.127615679339817,40.0,0.0
26786,2,6786,[318 496 588  98 357],786,5,28015,4.127744216885222,40.0,0.0
26787,2,6787,[318 496 588  98 357],330,5,28020,4.127872716558633,40.0,0.0
26788,2,6788,[ 69 111  50  22   4],457,4,28024,4.127853881278539,0.0,20.0
26789,2,6789,[318 496 588  98 357],330,5,28029,4.1279823269513995,40.0,0.0
26790,2,6790,[ 71  28 187 132 475],389,5,28034,4.128110734796054,0.0,0.0
26791,2,6791,[186 211 258 403 175],655,0,28034,4.127502944640754,0.0,0.0
26792,2,6792,[318 496 588  98 357],716,5,28039,4.127631385249521,40.0,0.0
26793,2,6793,[318 496 588  98 357],716,5,28044,4.1277597880482775,40.0,0.0
26794,2,6794,[405 194 237 238 276],269,3,28047,4.127593818984548,0.0,0.0
26795,2,6795,[181 172 357 216 257],457,4,28051,4.127575044143614,0.0,0.0
26796,2,6796,[318 496 588  98 357],796,5,28056,4.127703398558188,40.0,0.0
26797,2,6797,[318 496 588  98 357],450,5,28061,4.127831715210356,40.0,0.0
26798,2,6798,[151 288 245 179  79],450,4,28065,4.1278129136637745,0.0,0.0
26799,2,6799,[318 496 588  98 357],18,5,28070,4.127941176470588,40.0,0.0
26800,2,6800,[328 127 121 273 222],655,2,28072,4.127628289957359,0.0,20.0
26801,2,6801,[ 28 357 276  25 180],504,4,28076,4.12760952660982,0.0,0.0
26802,2,6802,[318 496 588  98 357],18,5,28081,4.127737762751727,40.0,0.0
26803,2,6803,[211 603  71 257 187],796,4,28085,4.1277189888301,20.0,0.0
26804,2,6804,[194  25 405 318 603],503,3,28088,4.1275532696546655,40.0,0.0
26805,2,6805,[318 496 588  98 357],716,5,28093,4.1276814575374665,40.0,0.0
26806,2,6806,[318 496 588  98 357],796,5,28098,4.1278096077567215,40.0,0.0
26807,2,6807,[  8 294 173 237 300],796,4,28102,4.127790834312574,0.0,0.0
26808,2,6808,[328  11  88 568 234],655,0,28102,4.127184608606257,0.0,0.0
26809,2,6809,[318 496 588  98 357],716,5,28107,4.127312775330396,40.0,0.0
26810,2,6810,[ 98 127 182 172 322],796,4,28111,4.127294083100867,0.0,20.0
26811,2,6811,[187 515 210 471 234],655,2,28113,4.126981796829125,0.0,0.0
26812,2,6812,[235 294 185 328  70],450,4,28117,4.1269631586672535,0.0,0.0
26813,2,6813,[196 143 322 127 235],450,4,28121,4.126944525975932,0.0,20.0
26814,2,6814,[318 496 588  98 357],786,5,28126,4.127072633895818,40.0,0.0
26815,2,6815,[  9 211 186 385 185],796,2,28128,4.126760563380282,0.0,0.0
26816,2,6816,[318 496 588  98 357],450,5,28133,4.126888660701188,40.0,0.0
26817,2,6817,[286   9 144 546 194],796,3,28136,4.126723379290114,0.0,20.0
26818,2,6818,[318 496 588  98 357],786,5,28141,4.126851444493328,40.0,0.0
26819,2,6819,[172 118 515 135 235],716,2,28143,4.126539589442816,0.0,0.0
26820,2,6820,[161 357 168 655 471],401,2,28145,4.1262278258319895,0.0,0.0
26821,2,6821,[318 496 588  98 357],330,5,28150,4.126355907358546,40.0,0.0
26822,2,6822,[238 300 403 546  70],450,5,28155,4.1264839513410525,0.0,0.0
26823,2,6823,[403 276 196 132  12],457,5,28160,4.126611957796014,0.0,0.0
26824,2,6824,[318 496 588  98 357],716,5,28165,4.126739926739927,40.0,0.0
26825,2,6825,[ 88   1 100 655 180],450,5,28170,4.126867858189276,0.0,20.0
26826,2,6826,[  9 265 423 194 117],629,5,28175,4.126995752160539,0.0,0.0
26827,2,6827,[318 496 588  98 357],330,5,28180,4.127123608670182,40.0,0.0
26828,2,6828,[ 79  95 385 118   1],807,5,28185,4.127251427734661,0.0,0.0
26829,2,6829,[216 427 174 301 294],655,2,28187,4.126939970717423,20.0,0.0
26830,2,6830,[100 568  28 301 238],389,4,28191,4.126921387790953,0.0,20.0
26831,2,6831,[194 568 183 173  82],716,4,28195,4.12690281030445,0.0,0.0
26832,2,6832,[318 496 588  98 357],450,5,28200,4.127030586857895,40.0,0.0
26833,2,6833,[269 748 161   7 182],450,5,28205,4.127158326016974,0.0,0.0
26834,2,6834,[ 82 655 435   7 228],450,4,28209,4.127139722019019,0.0,0.0
26835,2,6835,[318 496 588  98 357],796,5,28214,4.127267407840843,40.0,0.0
26836,2,6836,[318 496 588  98 357],716,5,28219,4.127395056311248,40.0,0.0
26837,2,6837,[568 288 276 127 187],256,3,28222,4.127230184264405,0.0,20.0
26838,2,6838,[318 496 588  98 357],330,5,28227,4.127357800848078,40.0,0.0
26839,2,6839,[318 496 588  98 357],786,5,28232,4.127485380116959,40.0,0.0
26840,2,6840,[294  25 288 202  56],457,4,28236,4.127466744627978,0.0,0.0
26841,2,6841,[318 496 588  98 357],450,5,28241,4.1275942706810875,40.0,0.0
26842,2,6842,[318 496 588  98 357],18,5,28246,4.127721759462224,40.0,0.0
26843,2,6843,[ 96  12 186 118 132],693,3,28249,4.127556984219755,0.0,0.0
26844,2,6844,[318 496 588  98 357],330,5,28254,4.127684441197955,40.0,0.0
26845,2,6845,[294 174 322 301 179],450,5,28259,4.127811860940695,0.0,0.0
26846,2,6846,[318 496 588  98 357],716,5,28264,4.127939243464291,40.0,0.0
26847,2,6847,[258   4 183 100 176],457,5,28269,4.128066588785047,0.0,20.0
26848,2,6848,[ 98 423 403  89 496],450,5,28274,4.128193896919258,20.0,0.0
26849,2,6849,[151  97 597 546   9],256,5,28279,4.128321167883212,0.0,0.0
26850,2,6850,[237 121  69 423  25],72,3,28282,4.128156473507517,0.0,0.0
26851,2,6851,[318 496 588  98 357],716,5,28287,4.128283712784588,40.0,0.0
26852,2,6852,[318 496 588  98 357],18,5,28292,4.128410914927769,40.0,0.0
26853,2,6853,[ 96 186 313 180 568],450,4,28296,4.128392179749052,0.0,0.0
26854,2,6854,[318 496 588  98 357],786,5,28301,4.1285193289569655,40.0,0.0
26855,2,6855,[318 496 588  98 357],18,5,28306,4.128646441073513,40.0,0.0
26856,2,6856,[275 144 151 185 300],716,4,28310,4.128627679743328,0.0,20.0
26857,2,6857,[235 172  56 185 313],450,4,28314,4.1286089238845145,0.0,0.0
26858,2,6858,[294 161 222 385 282],457,4,28318,4.128590173494678,0.0,0.0
26859,2,6859,[318 496 588  98 357],450,5,28323,4.128717201166181,40.0,0.0
26860,2,6860,[194 151 748 111   4],796,5,28328,4.128844191808774,0.0,0.0
26861,2,6861,[318 496 588  98 357],796,5,28333,4.128971145438648,40.0,0.0
26862,2,6862,[318 496 588  98 357],18,5,28338,4.12909806207198,40.0,0.0
26863,2,6863,[318 496 588  98 357],786,5,28343,4.129224941724941,40.0,0.0
26864,2,6864,[318 496 588  98 357],796,5,28348,4.129351784413693,40.0,0.0
26865,2,6865,[196 258  56 195 222],151,4,28352,4.129332944946111,0.0,0.0
26866,2,6866,[318 496 588  98 357],450,5,28357,4.129459734964322,40.0,0.0
26867,2,6867,[318 496 588  98 357],18,5,28362,4.12958648806057,40.0,0.0
26868,2,6868,[318 496 588  98 357],716,5,28367,4.129713204250983,40.0,0.0
26869,2,6869,[172  15 228 222 215],457,5,28372,4.129839883551674,0.0,0.0
26870,2,6870,[ 50 678 153  70  88],280,2,28374,4.12952990831029,0.0,20.0
26871,2,6871,[318 496 588  98 357],330,5,28379,4.1296565774155995,40.0,0.0
26872,2,6872,[318 496 588  98 357],786,5,28384,4.129783209660992,40.0,0.0
26873,2,6873,[318 496 588  98 357],450,5,28389,4.129909805062555,40.0,0.0
26874,2,6874,[318 496 588  98 357],450,5,28394,4.130036363636363,40.0,0.0
26875,2,6875,[ 71 265 186 245 294],450,3,28397,4.129872018615474,0.0,0.0
26876,2,6876,[318 496 588  98 357],330,5,28402,4.129998545877563,40.0,0.0
26877,2,6877,[318 496 588  98 357],330,5,28407,4.130125036347776,40.0,0.0
26878,2,6878,[ 98 405  95 125 678],280,2,28409,4.129815380142462,0.0,0.0
26879,2,6879,[318 496 588  98 357],716,5,28414,4.129941860465117,40.0,0.0
26880,2,6880,[655 301 403 181  96],450,5,28419,4.130068304025578,0.0,0.0
26881,2,6881,[318 496 588  98 357],716,5,28424,4.130194710839872,40.0,0.0
26882,2,6882,[318 496 588  98 357],330,5,28429,4.130321080924015,40.0,0.0
26883,2,6883,[318 496 588  98 357],786,5,28434,4.130447414294015,40.0,0.0
26884,2,6884,[121 200 195 588 313],450,3,28437,4.130283224400872,0.0,0.0
26885,2,6885,[318 496 588  98 357],450,5,28442,4.130409526575661,40.0,0.0
26886,2,6886,[  7 282 222 210 748],450,3,28445,4.130245389864963,0.0,0.0
26887,2,6887,[  8  22 568  97 204],457,5,28450,4.130371660859466,0.0,0.0
26888,2,6888,[111 423  56 237 234],457,4,28454,4.13035273624619,0.0,0.0
26889,2,6889,[385 132 222 258 176],23,4,28458,4.13033381712627,0.0,0.0
26890,2,6890,[222 603 403 180 191],450,4,28462,4.1303149034973154,20.0,0.0
26891,2,6891,[318 496 588  98 357],716,5,28467,4.130441091120139,40.0,0.0
26892,2,6892,[181 238  11  69 191],716,5,28472,4.130567242129697,0.0,0.0
26893,2,6893,[318 496 588  98 357],18,5,28477,4.13069335654192,40.0,0.0
26894,2,6894,[318 496 588  98 357],796,5,28482,4.130819434372734,40.0,0.0
26895,2,6895,[318 496 588  98 357],786,5,28487,4.130945475638051,40.0,0.0
26896,2,6896,[191   7 181 151  98],457,5,28492,4.131071480353777,0.0,0.0
26897,2,6897,[318 496 588  98 357],796,5,28497,4.131197448535808,40.0,0.0
26898,2,6898,[318 496 588  98 357],786,5,28502,4.131323380200029,40.0,0.0
26899,2,6899,[258 210 271  69 276],655,1,28503,4.130869565217392,0.0,0.0
26900,2,6900,[222 100 216 151 132],344,5,28508,4.130995507897406,0.0,20.0
26901,2,6901,[318 496 588  98 357],786,5,28513,4.131121414082875,40.0,0.0
26902,2,6902,[318 496 588  98 357],18,5,28518,4.131247283789657,40.0,0.0
26903,2,6903,[483 235 216 143 568],716,4,28522,4.131228273464658,0.0,0.0
26904,2,6904,[318 496 588  98 357],330,5,28527,4.131354091238233,40.0,0.0
26905,2,6905,[318 496 588  98 357],716,5,28532,4.131479872574573,40.0,0.0
26906,2,6906,[318 496 588  98 357],18,5,28537,4.1316056174895035,40.0,0.0
26907,2,6907,[202 228 161  12 237],577,4,28541,4.1315865662999425,0.0,0.0
26908,2,6908,[318 496 588  98 357],450,5,28546,4.131712259371834,40.0,0.0
26909,2,6909,[318 496 588  98 357],796,5,28551,4.131837916063676,40.0,0.0
26910,2,6910,[318 496 588  98 357],786,5,28556,4.13196353639126,40.0,0.0
26911,2,6911,[187  82 181 100 168],389,5,28561,4.13208912037037,0.0,20.0
26912,2,6912,[318 496 588  98 357],796,5,28566,4.13221466801678,40.0,0.0
26913,2,6913,[151 121 357   1 588],796,4,28570,4.1321955452704655,0.0,0.0
26914,2,6914,[318 496 588  98 357],716,5,28575,4.132321041214751,40.0,0.0
26915,2,6915,[318 496 588  98 357],330,5,28580,4.1324465008675535,40.0,0.0
26916,2,6916,[  9  56   4 313 515],655,2,28582,4.132138210206737,0.0,0.0
26917,2,6917,[228   7 161 588 257],23,3,28585,4.131974559121133,0.0,0.0
26918,2,6918,[318 496 588  98 357],330,5,28590,4.132100014452956,40.0,0.0
26919,2,6919,[318 496 588  98 357],330,5,28595,4.132225433526012,40.0,0.0
26920,2,6920,[742 288 546 245 216],280,4,28599,4.132206328565236,0.0,0.0
26921,2,6921,[294 202 181 245 173],280,0,28599,4.131609361456227,0.0,0.0
26922,2,6922,[  9 423 132  64 546],796,4,28603,4.1315903510039,20.0,0.0
26923,2,6923,[204  25 237 100  15],577,4,28607,4.13157134604275,0.0,20.0
26924,2,6924,[318 496 588  98 357],796,5,28612,4.131696750902527,40.0,0.0
26925,2,6925,[748 423   7  69 210],151,4,28616,4.131677736066994,0.0,0.0
26926,2,6926,[318 496 588  98 357],18,5,28621,4.131803089360473,40.0,0.0
26927,2,6927,[318 496 588  98 357],786,5,28626,4.131928406466512,40.0,0.0
26928,2,6928,[301 183 117 176 111],655,1,28627,4.1314764035214315,0.0,0.0
26929,2,6929,[318 496 588  98 357],330,5,28632,4.131601731601732,40.0,0.0
26930,2,6930,[318 496 588  98 357],796,5,28637,4.13172702351753,40.0,0.0
26931,2,6931,[318 496 588  98 357],330,5,28642,4.131852279284478,40.0,0.0
26932,2,6932,[318 496 588  98 357],18,5,28647,4.131977498918217,40.0,0.0
26933,2,6933,[161 204 496  71 179],593,5,28652,4.132102682434382,20.0,0.0
26934,2,6934,[318 496 588  98 357],786,5,28657,4.132227829848594,40.0,0.0
26935,2,6935,[318 496 588  98 357],796,5,28662,4.132352941176471,40.0,0.0
26936,2,6936,[318 496 588  98 357],18,5,28667,4.132478016433617,40.0,0.0
26937,2,6937,[ 97 187 132  88  69],504,3,28670,4.132314788123378,0.0,0.0
26938,2,6938,[655 111 216 180   1],457,4,28674,4.132295719844358,0.0,0.0
26939,2,6939,[318 496 588  98 357],716,5,28679,4.132420749279539,40.0,0.0
26940,2,6940,[204 181 300   4 132],151,5,28684,4.132545742688373,0.0,0.0
26941,2,6941,[318 496 588  98 357],18,5,28689,4.132670700086431,40.0,0.0
26942,2,6942,[318 496 588  98 357],330,5,28694,4.13279562148927,40.0,0.0
26943,2,6943,[318 496 588  98 357],786,5,28699,4.132920506912442,40.0,0.0
26944,2,6944,[318 496 588  98 357],330,5,28704,4.133045356371491,40.0,0.0
26945,2,6945,[318 496 588  98 357],330,5,28709,4.1331701698819465,40.0,0.0
26946,2,6946,[357 216 568 405 237],330,5,28714,4.133294947459335,0.0,0.0
26947,2,6947,[318 496 588  98 357],796,5,28719,4.133419689119171,40.0,0.0
26948,2,6948,[318 496 588  98 357],796,5,28724,4.133544394876961,40.0,0.0
26949,2,6949,[ 88 286 135 357   1],655,2,28726,4.133237410071942,0.0,20.0
26950,2,6950,[318 496 588  98 357],716,5,28731,4.133362106171774,40.0,0.0
26951,2,6951,[318 496 588  98 357],786,5,28736,4.133486766398159,40.0,0.0
26952,2,6952,[318 496 588  98 357],330,5,28741,4.133611390766576,40.0,0.0
26953,2,6953,[173 483 328   9 151],401,2,28743,4.133304572907679,0.0,0.0
26954,2,6954,[100  98 127 222 211],450,4,28747,4.133285406182602,0.0,40.0
26955,2,6955,[318 496 588  98 357],18,5,28752,4.133410005750432,40.0,0.0
26956,2,6956,[318 496 588  98 357],18,5,28757,4.133534569498347,40.0,0.0
26957,2,6957,[318 496 588  98 357],330,5,28762,4.133659097441794,40.0,0.0
26958,2,6958,[318 496 588  98 357],18,5,28767,4.133783589596207,40.0,0.0
26959,2,6959,[318 496 588  98 357],450,5,28772,4.1339080459770114,40.0,0.0
26960,2,6960,[515 161 435 471 313],807,4,28776,4.1338888090791555,0.0,0.0
26961,2,6961,[318 496 588  98 357],786,5,28781,4.134013214593508,40.0,0.0
26962,2,6962,[318 496 588  98 357],786,5,28786,4.134137584374551,40.0,0.0
26963,2,6963,[483 265 546   8 143],796,5,28791,4.134261918437679,0.0,0.0
26964,2,6964,[318 496 588  98 357],796,5,28796,4.134386216798277,40.0,0.0
26965,2,6965,[318 496 588  98 357],18,5,28801,4.13451047947172,40.0,0.0
26966,2,6966,[318 496 588  98 357],330,5,28806,4.134634706473374,40.0,0.0
26967,2,6967,[318 496 588  98 357],18,5,28811,4.1347588978186,40.0,0.0
26968,2,6968,[118 655 185 333 286],655,1,28812,4.134309083082221,0.0,20.0
26969,2,6969,[318 496 588  98 357],786,5,28817,4.134433285509326,40.0,0.0
26970,2,6970,[144  69 151 172 423],457,5,28822,4.134557452302396,0.0,0.0
26971,2,6971,[318 496 588  98 357],796,5,28827,4.134681583476764,40.0,0.0
26972,2,6972,[318 496 588  98 357],796,5,28832,4.134805679047756,40.0,0.0
26973,2,6973,[318 496 588  98 357],450,5,28837,4.134929739030685,40.0,0.0
26974,2,6974,[228 181 603 144 271],796,5,28842,4.13505376344086,20.0,0.0
26975,2,6975,[318 496 588  98 357],716,5,28847,4.135177752293578,40.0,0.0
26976,2,6976,[318 496 588  98 357],330,5,28852,4.135301705604128,40.0,0.0
26977,2,6977,[282 144  11 168   4],457,5,28857,4.13542562338779,0.0,0.0
26978,2,6978,[471 423 185 100  56],65,3,28860,4.1352629316520995,0.0,20.0
26979,2,6979,[153   8 174 427 655],535,5,28865,4.135386819484241,20.0,0.0
26980,2,6980,[183 234  12  98 603],796,4,28869,4.1353674258702195,20.0,0.0
26981,2,6981,[568  22 183 294 173],457,4,28873,4.135348037811515,0.0,0.0
26982,2,6982,[318 496 588  98 357],786,5,28878,4.135471860231992,40.0,0.0
26983,2,6983,[  8 603 211 132 100],321,5,28883,4.135595647193585,20.0,20.0
26984,2,6984,[318 496 588  98 357],450,5,28888,4.135719398711525,40.0,0.0
26985,2,6985,[318 496 588  98 357],330,5,28893,4.13584311480103,40.0,0.0
26986,2,6986,[ 95 603 186 121 153],796,4,28897,4.135823672534707,20.0,0.0
26987,2,6987,[187  11 185 100  70],269,3,28900,4.135661133371494,0.0,20.0
26988,2,6988,[183   8 210 118  11],457,5,28905,4.135784804693089,0.0,0.0
26989,2,6989,[318 496 588  98 357],796,5,28910,4.13590844062947,40.0,0.0
26990,2,6990,[318 496 588  98 357],786,5,28915,4.136032041195823,40.0,0.0
26991,2,6991,[318 496 588  98 357],330,5,28920,4.136155606407323,40.0,0.0
26992,2,6992,[269 215  82 153 483],450,3,28923,4.135993135993136,0.0,0.0
26993,2,6993,[282 655 300 168  69],716,4,28927,4.1359736917357734,0.0,0.0
26994,2,6994,[318 496 588  98 357],716,5,28932,4.136097212294496,40.0,0.0
26995,2,6995,[318 496 588  98 357],786,5,28937,4.136220697541452,40.0,0.0
26996,2,6996,[318 496 588  98 357],716,5,28942,4.136344147491783,40.0,0.0
26997,2,6997,[318 496 588  98 357],330,5,28947,4.136467562160617,40.0,0.0
26998,2,6998,[318 496 588  98 357],786,5,28952,4.136590941563081,40.0,0.0
26999,2,6999,[318  98 568   9 127],280,4,28956,4.136571428571429,20.0,20.0
27000,2,7000,[318 496 588  98 357],786,5,28961,4.13669475789173,40.0,0.0
27001,2,7001,[ 96 191 143 286 179],655,3,28964,4.136532419308769,0.0,20.0
27002,2,7002,[265 117 118 185 181],457,5,28969,4.136655718977581,0.0,0.0
27003,2,7003,[258 202  56 121 568],655,0,28969,4.136065105653912,0.0,0.0
27004,2,7004,[588 210 204  96 603],716,4,28973,4.13604568165596,20.0,0.0
27005,2,7005,[  1 168 161 405  22],807,5,28978,4.136168998001713,0.0,0.0
27006,2,7006,[318 496 588  98 357],786,5,28983,4.136292279149422,40.0,0.0
27007,2,7007,[435   1 181 211 215],450,5,28988,4.136415525114155,0.0,0.0
27008,2,7008,[161 228 183 471 222],280,1,28989,4.1359680410900275,0.0,0.0
27009,2,7009,[151 143 257  69 117],807,5,28994,4.136091298145506,0.0,0.0
27010,2,7010,[ 97 100  15 111 269],18,4,28998,4.13607188703466,0.0,20.0
27011,2,7011,[318 496 588  98 357],450,5,29003,4.136195094124358,40.0,0.0
27012,2,7012,[318 496 588  98 357],330,5,29008,4.136318266077285,40.0,0.0
27013,2,7013,[318 496 588  98 357],450,5,29013,4.136441402908469,40.0,0.0
27014,2,7014,[318 496 588  98 357],18,5,29018,4.136564504632929,40.0,0.0
27015,2,7015,[318 496 588  98 357],450,5,29023,4.1366875712656785,40.0,0.0
27016,2,7016,[318 496 588  98 357],786,5,29028,4.136810602821718,40.0,0.0
27017,2,7017,[ 89 172 173 222  95],23,5,29033,4.136933599316045,0.0,0.0
27018,2,7018,[318 496 588  98 357],786,5,29038,4.137056560763641,40.0,0.0
27019,2,7019,[318 496 588  98 357],330,5,29043,4.137179487179488,40.0,0.0
27020,2,7020,[ 22   4 173 678 216],344,3,29046,4.137017518871955,0.0,0.0
27021,2,7021,[318 496 588  98 357],786,5,29051,4.137140415835944,40.0,0.0
27022,2,7022,[318 496 588  98 357],18,5,29056,4.13726327780151,40.0,0.0
27023,2,7023,[ 22 322  71 161 216],796,4,29060,4.137243735763098,0.0,0.0
27024,2,7024,[318 496 588  98 357],450,5,29065,4.137366548042705,40.0,0.0
27025,2,7025,[318 496 588  98 357],786,5,29070,4.137489325362938,40.0,0.0
27026,2,7026,[318 496 588  98 357],330,5,29075,4.137612067738722,40.0,0.0
27027,2,7027,[ 25   8 135  82 132],389,3,29078,4.137450199203188,0.0,0.0
27028,2,7028,[204 237 286 196 194],401,3,29081,4.137288376724997,0.0,20.0
27029,2,7029,[318 496 588  98 357],796,5,29086,4.137411095305832,40.0,0.0
27030,2,7030,[235 183 118 216 273],344,3,29089,4.137249324420424,0.0,0.0
27031,2,7031,[328 301 655 435 275],655,1,29090,4.136803185437998,0.0,20.0
27032,2,7032,[318 496 588  98 357],18,5,29095,4.136925920659747,40.0,0.0
27033,2,7033,[423 333 181  82  69],655,0,29095,4.136337787887404,0.0,0.0
27034,2,7034,[742 215 268  82 161],655,0,29095,4.135749822316987,0.0,0.0
27035,2,7035,[111 153  56 385 318],655,1,29096,4.135304150085275,20.0,0.0
27036,2,7036,[318 496 588  98 357],716,5,29101,4.135427028563308,40.0,0.0
27037,2,7037,[655 237  15  95 435],450,3,29104,4.1352657004830915,0.0,0.0
27038,2,7038,[333  70 161  64 742],655,1,29105,4.134820286972581,20.0,0.0
27039,2,7039,[588 172 181 405  95],796,5,29110,4.134943181818182,0.0,0.0
27040,2,7040,[318 496 588  98 357],330,5,29115,4.135066041755432,40.0,0.0
27041,2,7041,[202 100   7 191 427],577,4,29119,4.13504686168702,20.0,20.0
27042,2,7042,[318 496 588  98 357],786,5,29124,4.135169672014767,40.0,0.0
27043,2,7043,[  1 435 300   8 302],535,2,29126,4.134866553094833,0.0,0.0
27044,2,7044,[313 265 568 196 257],796,5,29131,4.134989354151881,0.0,0.0
27045,2,7045,[385 275 258 678 172],344,2,29133,4.134686346863469,0.0,20.0
27046,2,7046,[183 423   7 216 258],693,3,29136,4.134525329927628,0.0,0.0
27047,2,7047,[257 427 181 200 210],655,2,29138,4.13422247446084,20.0,0.0
27048,2,7048,[202 245 194 196 168],796,4,29142,4.13420343311108,0.0,0.0
27049,2,7049,[143 204 118 568 318],330,5,29147,4.134326241134752,20.0,0.0
27050,2,7050,[405 234 475  89 100],655,1,29148,4.13388171890512,0.0,20.0
27051,2,7051,[568 300 234 173 742],796,3,29151,4.133720930232558,0.0,0.0
27052,2,7052,[318 496 588  98 357],786,5,29156,4.133843754430739,40.0,0.0
27053,2,7053,[318 496 588  98 357],450,5,29161,4.133966543804934,40.0,0.0
27054,2,7054,[318 496 588  98 357],18,5,29166,4.13408929836995,40.0,0.0
27055,2,7055,[318   8 313 197 135],707,3,29169,4.133928571428571,20.0,0.0
27056,2,7056,[234 132 179 100  97],450,4,29173,4.133909593311605,0.0,20.0
27057,2,7057,[271 204 143  79  22],655,2,29175,4.133607254179655,0.0,0.0
27058,2,7058,[318 496 588  98 357],796,5,29180,4.133729990083581,40.0,0.0
27059,2,7059,[318 496 588  98 357],18,5,29185,4.13385269121813,40.0,0.0
27060,2,7060,[318 496 588  98 357],450,5,29190,4.133975357598074,40.0,0.0
27061,2,7061,[318 496 588  98 357],450,5,29195,4.134097989238176,40.0,0.0
27062,2,7062,[151  98 271  82 100],796,3,29198,4.13393742035962,0.0,20.0
27063,2,7063,[ 96  97 196 568 301],450,5,29203,4.134060022650057,0.0,0.0
27064,2,7064,[318 496 588  98 357],716,5,29208,4.134182590233546,40.0,0.0
27065,2,7065,[318 496 588  98 357],796,5,29213,4.134305123124823,40.0,0.0
27066,2,7066,[318 496 588  98 357],450,5,29218,4.134427621338616,40.0,0.0
27067,2,7067,[ 64  22 405  88 180],796,4,29222,4.134408602150538,20.0,0.0
27068,2,7068,[318 496 588  98 357],18,5,29227,4.134531051068044,40.0,0.0
27069,2,7069,[318 496 588  98 357],330,5,29232,4.134653465346535,40.0,0.0
27070,2,7070,[318 496 588  98 357],450,5,29237,4.134775845000707,40.0,0.0
27071,2,7071,[204 483 200 191 181],655,3,29240,4.134615384615385,0.0,0.0
27072,2,7072,[183 202 197 588 173],457,5,29245,4.134737735048777,0.0,0.0
27073,2,7073,[118 100 186 546 127],796,3,29248,4.13457732541702,0.0,40.0
27074,2,7074,[318 496 588  98 357],786,5,29253,4.134699646643109,40.0,0.0
27075,2,7075,[153 515 111  97 175],655,1,29254,4.134256642170718,0.0,0.0
27076,2,7076,[318 496 588  98 357],786,5,29259,4.134378974141585,40.0,0.0
27077,2,7077,[257 153 222  22  11],655,0,29259,4.1337948573043235,0.0,0.0
27078,2,7078,[210   9  28 118 175],457,5,29264,4.13391721994632,0.0,0.0
27079,2,7079,[328 301 265 172 168],796,4,29268,4.133898305084746,0.0,0.0
27080,2,7080,[ 97 118 172 655 187],450,4,29272,4.133879395565598,0.0,0.0
27081,2,7081,[202   9 318 175  96],457,5,29277,4.1340016944366,20.0,0.0
27082,2,7082,[204  71 215 273 118],450,2,29279,4.133700409431032,0.0,0.0
27083,2,7083,[318 496 588  98 357],786,5,29284,4.13382269904009,40.0,0.0
27084,2,7084,[318 496 588  98 357],716,5,29289,4.133944954128441,40.0,0.0
27085,2,7085,[265 182  56 186 197],796,3,29292,4.1337849280270955,0.0,0.0
27086,2,7086,[153 172 127 238   4],450,4,29296,4.133766050515027,0.0,20.0
27087,2,7087,[121  50  28  64 180],450,4,29300,4.133747178329571,20.0,20.0
27088,2,7088,[318 496 588  98 357],796,5,29305,4.133869375088165,40.0,0.0
27089,2,7089,[135   7  96 194 182],269,3,29308,4.133709449929478,0.0,0.0
27090,2,7090,[318 496 588  98 357],796,5,29313,4.133831617543365,40.0,0.0
27091,2,7091,[318 496 588  98 357],450,5,29318,4.13395375070502,40.0,0.0
27092,2,7092,[318 496 588  98 357],18,5,29323,4.134075849429014,40.0,0.0
27093,2,7093,[318 496 588  98 357],716,5,29328,4.1341979137299125,40.0,0.0
27094,2,7094,[  8 121 210 151 403],457,5,29333,4.134319943622269,0.0,0.0
27095,2,7095,[191 186 294 194 121],716,4,29337,4.1343010146561445,0.0,0.0
27096,2,7096,[318 496 588  98 357],716,5,29342,4.134422995631957,40.0,0.0
27097,2,7097,[ 25 405  50 322  56],593,2,29344,4.134122287968442,0.0,20.0
27098,2,7098,[318 496 588  98 357],18,5,29349,4.134244259754895,40.0,0.0
27099,2,7099,[318 496 588  98 357],796,5,29354,4.134366197183098,40.0,0.0
27100,2,7100,[273 195  98 132 176],236,2,29356,4.134065624559921,0.0,0.0
27101,2,7101,[318 496 588  98 357],786,5,29361,4.134187552802028,40.0,0.0
27102,2,7102,[318 496 588  98 357],450,5,29366,4.134309446712656,40.0,0.0
27103,2,7103,[318 496 588  98 357],450,5,29371,4.134431306306307,40.0,0.0
27104,2,7104,[322 222 210 423  12],450,3,29374,4.1342716396903585,0.0,0.0
27105,2,7105,[318 496 588  98 357],18,5,29379,4.134393470306783,40.0,0.0
27106,2,7106,[179 210 186  82 385],655,1,29380,4.133952441255101,0.0,0.0
27107,2,7107,[318 496 588  98 357],716,5,29385,4.134074282498593,40.0,0.0
27108,2,7108,[ 89 265 210 328 258],655,1,29386,4.133633422422282,0.0,0.0
27109,2,7109,[127 187 273 215  98],693,3,29389,4.133473980309423,0.0,20.0
27110,2,7110,[ 79 215 655  11  64],655,2,29391,4.13317395584306,20.0,0.0
27111,2,7111,[318 496 588  98 357],786,5,29396,4.133295838020247,40.0,0.0
27112,2,7112,[318 496 588  98 357],18,5,29401,4.133417685927175,40.0,0.0
27113,2,7113,[ 11 546 196 186 210],450,3,29404,4.13325836378971,0.0,0.0
27114,2,7114,[742 328 194 174 196],450,5,29409,4.133380182712579,0.0,0.0
27115,2,7115,[ 28 275 318 121 185],330,5,29414,4.1335019673974145,20.0,20.0
27116,2,7116,[318 496 588  98 357],786,5,29419,4.133623717858648,40.0,0.0
27117,2,7117,[111 276 475 144 405],655,1,29420,4.133183478505198,0.0,0.0
27118,2,7118,[318 496 588  98 357],330,5,29425,4.13330523949993,40.0,0.0
27119,2,7119,[318 496 588  98 357],330,5,29430,4.133426966292135,40.0,0.0
27120,2,7120,[196 143  15 186 423],457,5,29435,4.133548658896222,0.0,0.0
27121,2,7121,[258 568 313 174 235],344,2,29437,4.1332490873350185,0.0,0.0
27122,2,7122,[318 496 588  98 357],18,5,29442,4.133370770742665,40.0,0.0
27123,2,7123,[265 180 183  28 176],796,3,29445,4.133211678832117,0.0,0.0
27124,2,7124,[ 69  71 265 174 318],807,5,29450,4.133333333333334,20.0,0.0
27125,2,7125,[143 202  69 568 204],389,3,29453,4.133174291327533,0.0,0.0
27126,2,7126,[186 423 191 282 289],655,1,29454,4.132734670969552,0.0,0.0
27127,2,7127,[179 289   7 286 318],786,5,29459,4.132856341189674,20.0,20.0
27128,2,7128,[183 313 191 300 323],796,4,29463,4.132837705147987,0.0,0.0
27129,2,7129,[318 496 588  98 357],450,5,29468,4.132959326788219,40.0,0.0
27130,2,7130,[ 96 302   7 176 742],450,5,29473,4.133080914317768,0.0,0.0
27131,2,7131,[318 496 588  98 357],786,5,29478,4.133202467750982,40.0,0.0
27132,2,7132,[ 15 237  82 117 121],457,5,29483,4.133323987102201,0.0,0.0
27133,2,7133,[196 238  95 117  50],786,5,29488,4.133445472385758,0.0,20.0
27134,2,7134,[215  82 125 235 234],450,2,29490,4.133146461107218,0.0,0.0
27135,2,7135,[  8 121  98 276 182],535,2,29492,4.132847533632287,0.0,0.0
27136,2,7136,[318 496 588  98 357],786,5,29497,4.1329690346083785,40.0,0.0
27137,2,7137,[  8   9 200   7 204],655,1,29498,4.132530120481928,0.0,0.0
27138,2,7138,[228 194 271 117   1],796,4,29502,4.132511556240369,0.0,0.0
27139,2,7139,[318 496 588  98 357],450,5,29507,4.132633053221289,40.0,0.0
27140,2,7140,[318 496 588  98 357],716,5,29512,4.132754516174205,40.0,0.0
27141,2,7141,[328 186 216  28  97],151,4,29516,4.132735928311398,0.0,0.0
27142,2,7142,[153  69 144 216 546],716,3,29519,4.132577348453031,0.0,0.0
27143,2,7143,[176 197 200 174 179],504,3,29522,4.132418812989922,0.0,0.0
27144,2,7144,[318 496 588  98 357],716,5,29527,4.132540237928621,40.0,0.0
27145,2,7145,[191 176   9 194 100],269,4,29531,4.132521690456199,0.0,20.0
27146,2,7146,[286  88 318 471 144],401,4,29535,4.132503148174059,20.0,20.0
27147,2,7147,[748 121  64 655 258],796,4,29539,4.132484611080022,20.0,0.0
27148,2,7148,[185 173  95  56  88],796,5,29544,4.132605958875367,0.0,0.0
27149,2,7149,[216 121 174 597 144],450,4,29548,4.132587412587412,0.0,0.0
27150,2,7150,[318 403  12 195  69],655,1,29549,4.132149349741295,20.0,0.0
27151,2,7151,[228  69  70 172 222],151,5,29554,4.132270693512305,0.0,0.0
27152,2,7152,[318 496 588  98 357],450,5,29559,4.1323920033552355,40.0,0.0
27153,2,7153,[286 144 179  89 100],296,5,29564,4.132513279284317,0.0,40.0
27154,2,7154,[322 210  82 215  28],450,3,29567,4.13235499650594,0.0,0.0
27155,2,7155,[318 496 588  98 357],786,5,29572,4.1324762437115705,40.0,0.0
27156,2,7156,[ 95 175 286 204  11],344,3,29575,4.132318010339528,0.0,20.0
27157,2,7157,[179  89  64 182 313],450,5,29580,4.13243922883487,20.0,0.0
27158,2,7158,[ 89 196 282 185 269],450,5,29585,4.132560413465568,0.0,0.0
27159,2,7159,[118 176  15 187 275],655,2,29587,4.1322625698324025,0.0,20.0
27160,2,7160,[318 496 588  98 357],786,5,29592,4.132383745286971,40.0,0.0
27161,2,7161,[318 496 588  98 357],796,5,29597,4.132504886903099,40.0,0.0
27162,2,7162,[187 132 483 282 302],655,3,29600,4.13234678207455,0.0,0.0
27163,2,7163,[153 318 234 265 655],878,2,29602,4.132049134561697,20.0,0.0
27164,2,7164,[175 496  12 603 515],18,4,29606,4.132030704815073,40.0,0.0
27165,2,7165,[318 496 588  98 357],330,5,29611,4.13215182807703,40.0,0.0
27166,2,7166,[655 161 742 173 597],796,3,29614,4.131993860750662,0.0,0.0
27167,2,7167,[ 50  64   9 185 173],269,3,29617,4.1318359375,20.0,20.0
27168,2,7168,[328 181 125  15 271],655,0,29617,4.131259589900963,0.0,0.0
27169,2,7169,[ 70 191  96 235 117],450,4,29621,4.131241283124129,0.0,0.0
27170,2,7170,[318 496 588  98 357],450,5,29626,4.131362432017849,40.0,0.0
27171,2,7171,[318 496 588  98 357],796,5,29631,4.1314835471277185,40.0,0.0
27172,2,7172,[318 496 588  98 357],18,5,29636,4.131604628467866,40.0,0.0
27173,2,7173,[318 496 588  98 357],716,5,29641,4.131725676052412,40.0,0.0
27174,2,7174,[318 496 588  98 357],450,5,29646,4.13184668989547,40.0,0.0
27175,2,7175,[318 496 588  98 357],796,5,29651,4.131967670011148,40.0,0.0
27176,2,7176,[ 89 475 179 183  88],269,2,29653,4.131670614462868,0.0,0.0
27177,2,7177,[ 22  97  88 161  50],716,4,29657,4.131652270827528,0.0,20.0
27178,2,7178,[276  22 179 228 282],296,5,29662,4.131773227469007,0.0,0.0
27179,2,7179,[318 496 588  98 357],796,5,29667,4.1318941504178275,40.0,0.0
27180,2,7180,[328 318 210 216  11],401,4,29671,4.131875783317087,20.0,0.0
27181,2,7181,[318 496 588  98 357],18,5,29676,4.131996658312448,40.0,0.0
27182,2,7182,[318 496 588  98 357],786,5,29681,4.132117499651956,40.0,0.0
27183,2,7183,[328 258 174  89 222],151,4,29685,4.132099109131403,0.0,0.0
27184,2,7184,[318 496 588  98 357],716,5,29690,4.132219902574809,40.0,0.0
27185,2,7185,[318 496 588  98 357],796,5,29695,4.132340662399109,40.0,0.0
27186,2,7186,[174 210 237 204   1],716,5,29700,4.132461388618339,0.0,0.0
27187,2,7187,[318 496 588  98 357],786,5,29705,4.132582081246522,40.0,0.0
27188,2,7188,[ 22 111  98 313 132],796,5,29710,4.132702740297677,0.0,0.0
27189,2,7189,[318 496 588  98 357],18,5,29715,4.132823365785813,40.0,0.0
27190,2,7190,[318 496 588  98 357],786,5,29720,4.132943957724934,40.0,0.0
27191,2,7191,[173 186 385 423  71],796,4,29724,4.132925472747497,0.0,0.0
27192,2,7192,[427 182  97 176 197],450,5,29729,4.133046016960934,20.0,0.0
27193,2,7193,[318 496 588  98 357],716,5,29734,4.133166527661941,40.0,0.0
27194,2,7194,[318 496 588  98 357],716,5,29739,4.133287004864489,40.0,0.0
27195,2,7195,[318 496 588  98 357],18,5,29744,4.133407448582546,40.0,0.0
27196,2,7196,[ 64 202 228 216  89],151,5,29749,4.133527858830068,20.0,0.0
27197,2,7197,[ 15 742 176 322  64],796,3,29752,4.133370380661295,20.0,0.0
27198,2,7198,[318 496 588  98 357],18,5,29757,4.133490762605917,40.0,0.0
27199,2,7199,[385  79 268 132 286],655,1,29758,4.133055555555556,0.0,20.0
27200,2,7200,[ 89 228 546 183 121],457,4,29762,4.133037078183586,0.0,0.0
27201,2,7201,[168 742  64 121 118],577,4,29766,4.133018605942794,20.0,0.0
27202,2,7202,[318 496 588  98 357],786,5,29771,4.133138969873664,40.0,0.0
27203,2,7203,[ 22 237 174 742  88],457,5,29776,4.133259300388673,0.0,0.0
27204,2,7204,[176 144 313 237  22],450,5,29781,4.133379597501735,0.0,0.0
27205,2,7205,[318 496 588  98 357],450,5,29786,4.133499861226755,40.0,0.0
27206,2,7206,[265 748  96 289 235],807,3,29789,4.133342583599278,0.0,0.0
27207,2,7207,[318 496 588  98 357],18,5,29794,4.1334628190899005,40.0,0.0
27208,2,7208,[318 496 588  98 357],716,5,29799,4.133583021223471,40.0,0.0
27209,2,7209,[  7  96 173 161 216],577,4,29803,4.133564493758668,0.0,0.0
27210,2,7210,[318 496 588  98 357],786,5,29808,4.133684648453751,40.0,0.0
27211,2,7211,[181 174 168 357 127],450,5,29813,4.133804769828064,0.0,20.0
27212,2,7212,[318 496 588  98 357],330,5,29818,4.133924857895466,40.0,0.0
27213,2,7213,[318 496 588  98 357],450,5,29823,4.1340449126698084,40.0,0.0
27214,2,7214,[318 496 588  98 357],18,5,29828,4.134164934164934,40.0,0.0
27215,2,7215,[318 496 588  98 357],330,5,29833,4.134284922394679,40.0,0.0
27216,2,7216,[318 496 588  98 357],330,5,29838,4.134404877372869,40.0,0.0
27217,2,7217,[655 742 161 186 181],693,0,29838,4.13383208645054,0.0,0.0
27218,2,7218,[ 56 328 286  95 200],796,4,29842,4.1338135475827675,0.0,20.0
27219,2,7219,[269   4 210 204 173],450,3,29845,4.133656509695291,0.0,0.0
27220,2,7220,[195 568  64 268 313],344,3,29848,4.1334995153025895,20.0,0.0
27221,2,7221,[318 269  95 282 333],796,4,29852,4.1334810301855445,20.0,0.0
27222,2,7222,[318 496 588  98 357],450,5,29857,4.133600996815727,40.0,0.0
27223,2,7223,[111  82 301 475 483],389,4,29861,4.133582502768549,0.0,0.0
27224,2,7224,[318 496 588  98 357],786,5,29866,4.133702422145329,40.0,0.0
27225,2,7225,[191 237 125 200 655],577,4,29870,4.133683919180736,0.0,0.0
27226,2,7226,[471 175 405  11 588],457,5,29875,4.133803791338038,0.0,0.0
27227,2,7227,[318 496 588  98 357],716,5,29880,4.133923630326508,40.0,0.0
27228,2,7228,[318 496 588  98 357],330,5,29885,4.134043436159912,40.0,0.0
27229,2,7229,[405 471 191 508 216],401,3,29888,4.133886583679115,0.0,0.0
27230,2,7230,[318 496 588  98 357],716,5,29893,4.134006361499101,40.0,0.0
27231,2,7231,[318 496 588  98 357],716,5,29898,4.134126106194691,40.0,0.0
27232,2,7232,[318 496 588  98 357],786,5,29903,4.134245817779621,40.0,0.0
27233,2,7233,[318 496 588  98 357],450,5,29908,4.134365496267625,40.0,0.0
27234,2,7234,[318 496 588  98 357],18,5,29913,4.1344851416724255,40.0,0.0
27235,2,7235,[ 28   9 216 183  79],236,4,29917,4.134466556108348,0.0,0.0
27236,2,7236,[318 496 588  98 357],796,5,29922,4.134586154483902,40.0,0.0
27237,2,7237,[742 322   7 127  64],256,5,29927,4.134705719812103,20.0,20.0
27238,2,7238,[318 496 588  98 357],18,5,29932,4.134825252106644,40.0,0.0
27239,2,7239,[ 95 483 144  96 742],280,4,29936,4.134806629834254,0.0,0.0
27240,2,7240,[318 496 588  98 357],18,5,29941,4.1349261151774614,40.0,0.0
27241,2,7241,[318 496 588  98 357],330,5,29946,4.135045567522784,40.0,0.0
27242,2,7242,[118 143  88 385 174],716,3,29949,4.134888858207925,0.0,0.0
27243,2,7243,[318 496 588  98 357],716,5,29954,4.135008282716731,40.0,0.0
27244,2,7244,[174 257 289  28 271],807,4,29958,4.134989648033126,0.0,0.0
27245,2,7245,[180 174 151 245 127],504,5,29963,4.135109025669335,0.0,20.0
27246,2,7246,[210 183 269 288 118],655,1,29964,4.134676417828067,0.0,0.0
27247,2,7247,[275 175 183 313 125],344,3,29967,4.134519867549669,0.0,20.0
27248,2,7248,[318 496 588  98 357],796,5,29972,4.134639260587667,40.0,0.0
27249,2,7249,[568  12 186  96 276],655,1,29973,4.134206896551724,0.0,0.0
27250,2,7250,[ 12 238 202 172  82],796,3,29976,4.134050475796442,0.0,0.0
27251,2,7251,[318 496 588  98 357],330,5,29981,4.134169884169884,40.0,0.0
27252,2,7252,[ 89 427 258  50 273],796,4,29985,4.134151385633531,20.0,20.0
27253,2,7253,[ 22 211   8 282 168],796,4,29989,4.1341328921974085,0.0,0.0
27254,2,7254,[318 496 588  98 357],796,5,29994,4.134252239834597,40.0,0.0
27255,2,7255,[318 496 588  98 357],796,5,29999,4.134371554575524,40.0,0.0
27256,2,7256,[168 405 222 204 121],151,4,30003,4.134353038445639,0.0,0.0
27257,2,7257,[202 182 742 111 127],280,3,30006,4.134196748415541,0.0,20.0
27258,2,7258,[ 98 111 200 132 183],450,4,30010,4.134178261468522,0.0,0.0
27259,2,7259,[ 96 323 215 742 196],504,5,30015,4.134297520661157,0.0,0.0
27260,2,7260,[215 222  96 301  79],796,4,30019,4.134279024927696,0.0,0.0
27261,2,7261,[483  70  12 318 357],457,5,30024,4.134398237400165,20.0,0.0
27262,2,7262,[318 496 588  98 357],450,5,30029,4.1345174170452985,40.0,0.0
27263,2,7263,[ 12 211 210 200 385],450,3,30032,4.134361233480176,0.0,0.0
27264,2,7264,[ 15  69 216 496 175],151,5,30037,4.134480385409498,20.0,0.0
27265,2,7265,[269 185 496 302  89],704,5,30042,4.134599504541701,20.0,0.0
27266,2,7266,[185 258 151   4 238],457,5,30047,4.134718590890326,0.0,0.0
27267,2,7267,[318 496 588  98 357],716,5,30052,4.134837644468905,40.0,0.0
27268,2,7268,[655 603 173 496 183],151,4,30056,4.134819094786078,40.0,0.0
27269,2,7269,[318 496 588  98 357],786,5,30061,4.134938101788171,40.0,0.0
27270,2,7270,[318 496 588  98 357],18,5,30066,4.135057076055563,40.0,0.0
27271,2,7271,[318 496 588  98 357],716,5,30071,4.1351760176017605,40.0,0.0
27272,2,7272,[318 496 588  98 357],786,5,30076,4.135294926440259,40.0,0.0
27273,2,7273,[210 204 237  79 269],503,4,30080,4.135276326642837,0.0,0.0
27274,2,7274,[ 88 546 265 483  96],457,4,30084,4.135257731958763,0.0,0.0
27275,2,7275,[318 496 588  98 357],786,5,30089,4.1353765805387575,40.0,0.0
27276,2,7276,[318 496 588  98 357],786,5,30094,4.135495396454583,40.0,0.0
27277,2,7277,[222 125   4 435 185],450,3,30097,4.1353393789502615,0.0,0.0
27278,2,7278,[318 496 588  98 357],18,5,30102,4.135458167330677,40.0,0.0
27279,2,7279,[318 496 588  98 357],330,5,30107,4.135576923076923,40.0,0.0
27280,2,7280,[318 496 588  98 357],18,5,30112,4.135695646202445,40.0,0.0
27281,2,7281,[210  82 121 282 228],796,3,30115,4.135539686899204,0.0,0.0
27282,2,7282,[318 496 588  98 357],716,5,30120,4.13565838253467,40.0,0.0
27283,2,7283,[ 98 143 282 275  97],457,5,30125,4.135777045579352,0.0,20.0
27284,2,7284,[161  71 276 288 117],280,5,30130,4.135895676046672,0.0,0.0
27285,2,7285,[318 496 588  98 357],786,5,30135,4.136014273950041,40.0,0.0
27286,2,7286,[318 496 588  98 357],18,5,30140,4.136132839302868,40.0,0.0
27287,2,7287,[132 423   8  69 143],18,4,30144,4.136114160263447,0.0,0.0
27288,2,7288,[318 496 588  98 357],450,5,30149,4.136232679379887,40.0,0.0
27289,2,7289,[318 222 121  89 228],807,5,30154,4.136351165980796,20.0,0.0
27290,2,7290,[318 496 588  98 357],330,5,30159,4.13646962007955,40.0,0.0
27291,2,7291,[318 496 588  98 357],18,5,30164,4.136588041689523,40.0,0.0
27292,2,7292,[100 282 258 144 508],296,5,30169,4.136706430824078,0.0,20.0
27293,2,7293,[265 385  15   9  50],256,5,30174,4.136824787496573,0.0,20.0
27294,2,7294,[318 496 588  98 357],330,5,30179,4.136943111720356,40.0,0.0
27295,2,7295,[182  11   9 257 111],655,1,30180,4.136513157894737,0.0,0.0
27296,2,7296,[318 496 588  98 357],716,5,30185,4.136631492394135,40.0,0.0
27297,2,7297,[318 496 588  98 357],786,5,30190,4.136749794464237,40.0,0.0
27298,2,7298,[318 496 588  98 357],786,5,30195,4.136868064118373,40.0,0.0
27299,2,7299,[257  70 215  56 168],504,3,30198,4.136712328767123,0.0,0.0
27300,2,7300,[318 496 588  98 357],18,5,30203,4.136830571154636,40.0,0.0
27301,2,7301,[318 496 588  98 357],796,5,30208,4.136948781155848,40.0,0.0
27302,2,7302,[318 496 588  98 357],786,5,30213,4.137066958784061,40.0,0.0
27303,2,7303,[318 496 588  98 357],330,5,30218,4.137185104052574,40.0,0.0
27304,2,7304,[125  98 144 174 197],796,4,30222,4.137166324435318,0.0,0.0
27305,2,7305,[318 496 588  98 357],18,5,30227,4.137284423761292,40.0,0.0
27306,2,7306,[318 496 588  98 357],796,5,30232,4.137402490762283,40.0,0.0
27307,2,7307,[191  69 196   1 127],72,5,30237,4.13752052545156,0.0,20.0
27308,2,7308,[318 496 588  98 357],330,5,30242,4.137638527842386,40.0,0.0
27309,2,7309,[655   9 125 300  71],796,3,30245,4.137482900136799,0.0,0.0
27310,2,7310,[ 69 204 286 276 144],401,3,30248,4.137327315004788,0.0,20.0
27311,2,7311,[  7  11 191 176 313],693,3,30251,4.137171772428884,0.0,0.0
27312,2,7312,[318 496 588  98 357],18,5,30256,4.137289757965267,40.0,0.0
27313,2,7313,[318 496 588  98 357],330,5,30261,4.13740771123872,40.0,0.0
27314,2,7314,[318 100 588 245 153],885,2,30263,4.1371155160628845,20.0,20.0
27315,2,7315,[318 496 588  98 357],330,5,30268,4.137233460907599,40.0,0.0
27316,2,7316,[288 313 483 125 271],655,2,30270,4.1369413694136945,0.0,0.0
27317,2,7317,[ 88 237  82  98 196],269,1,30271,4.136512708390271,0.0,0.0
27318,2,7318,[176  88 228 181 195],450,5,30276,4.136630687252357,0.0,0.0
27319,2,7319,[318 496 588  98 357],330,5,30281,4.136748633879781,40.0,0.0
27320,2,7320,[318 496 588  98 357],796,5,30286,4.136866548285753,40.0,0.0
27321,2,7321,[508 197  25 161 403],655,0,30286,4.136301556951652,0.0,0.0
27322,2,7322,[318 496 588  98 357],716,5,30291,4.136419500204834,40.0,0.0
27323,2,7323,[211 405 100 301 144],450,5,30296,4.136537411250683,0.0,20.0
27324,2,7324,[318 496 588  98 357],330,5,30301,4.136655290102389,40.0,0.0
27325,2,7325,[318 496 588  98 357],716,5,30306,4.136773136773137,40.0,0.0
27326,2,7326,[318 496 588  98 357],716,5,30311,4.1368909512761025,40.0,0.0
27327,2,7327,[318 496 588  98 357],716,5,30316,4.137008733624454,40.0,0.0
27328,2,7328,[318 496 588  98 357],716,5,30321,4.137126483831355,40.0,0.0
27329,2,7329,[318 496 588  98 357],716,5,30326,4.137244201909959,40.0,0.0
27330,2,7330,[180 385  79 322 288],450,4,30330,4.137225480834811,0.0,0.0
27331,2,7331,[ 89 268 423 508 238],655,1,30331,4.136797599563557,0.0,0.0
27332,2,7332,[121  12  95  71 132],796,5,30336,4.1369153143324695,0.0,0.0
27333,2,7333,[318 496 588  98 357],330,5,30341,4.137032997000273,40.0,0.0
27334,2,7334,[172   7  64 176 228],151,4,30345,4.137014314928425,20.0,0.0
27335,2,7335,[318 496 588  98 357],796,5,30350,4.137131952017448,40.0,0.0
27336,2,7336,[ 89 185 288 282 237],655,2,30352,4.136840670573804,0.0,0.0
27337,2,7337,[ 50 200 153 222 211],236,1,30353,4.136413191605342,0.0,20.0
27338,2,7338,[191 603 185 176 196],11,4,30357,4.136394604169506,20.0,0.0
27339,2,7339,[405 483 275  69 300],151,4,30361,4.136376021798365,0.0,20.0
27340,2,7340,[318 496 588  98 357],330,5,30366,4.136493665713118,40.0,0.0
27341,2,7341,[427 111 168 173 238],716,5,30371,4.13661127758104,20.0,0.0
27342,2,7342,[282 144 435 328 568],450,5,30376,4.136728857415226,0.0,0.0
27343,2,7343,[237  71 300 168 127],450,4,30380,4.136710239651416,0.0,20.0
27344,2,7344,[318 496 588  98 357],716,5,30385,4.136827773995916,40.0,0.0
27345,2,7345,[185 257 568 143 234],716,5,30390,4.136945276340866,0.0,0.0
27346,2,7346,[ 82 294 111 161 265],655,0,30390,4.136382196815027,0.0,0.0
27347,2,7347,[318 496 588  98 357],330,5,30395,4.136499727817093,40.0,0.0
27348,2,7348,[173 196   8 210 168],457,5,30400,4.136617226833583,0.0,0.0
27349,2,7349,[318 496 588  98 357],450,5,30405,4.136734693877551,40.0,0.0
27350,2,7350,[318 294 210 191 204],796,3,30408,4.136580057135084,20.0,0.0
27351,2,7351,[151 546 300 181  71],796,5,30413,4.136697497279652,0.0,0.0
27352,2,7352,[318 496 588  98 357],330,5,30418,4.136814905480756,40.0,0.0
27353,2,7353,[318 496 588  98 357],716,5,30423,4.136932281751427,40.0,0.0
27354,2,7354,[245 286 475 275  69],629,4,30427,4.136913664174031,0.0,40.0
27355,2,7355,[318 496 588  98 357],786,5,30432,4.137030995106036,40.0,0.0
27356,2,7356,[ 64  89 182 515 204],18,3,30435,4.1368764442028,20.0,0.0
27357,2,7357,[318 496 588  98 357],330,5,30440,4.136993748301169,40.0,0.0
27358,2,7358,[483 153 111 202  56],796,5,30445,4.137111020519092,0.0,0.0
27359,2,7359,[318 496 588  98 357],796,5,30450,4.137228260869565,40.0,0.0
27360,2,7360,[318 496 588  98 357],330,5,30455,4.137345469365576,40.0,0.0
27361,2,7361,[ 22  82 289 127 515],655,2,30457,4.137055148057593,0.0,20.0
27362,2,7362,[200  98 301 191 275],796,4,30461,4.137036534021458,0.0,20.0
27363,2,7363,[300  79   1   4   9],796,3,30464,4.136882129277566,0.0,0.0
27364,2,7364,[222 301  25 282 313],450,3,30467,4.136727766463001,0.0,0.0
27365,2,7365,[318 496 588  98 357],330,5,30472,4.136844963345099,40.0,0.0
27366,2,7366,[318 496 588  98 357],796,5,30477,4.136962128410479,40.0,0.0
27367,2,7367,[200 215 161 286 245],450,4,30481,4.136943539630836,0.0,20.0
27368,2,7368,[ 15 655 275 265 228],151,5,30486,4.1370606595196096,0.0,20.0
27369,2,7369,[318 496 588  98 357],330,5,30491,4.1371777476255085,40.0,0.0
27370,2,7370,[ 96 100 427 423  12],421,4,30495,4.137159137159137,20.0,20.0
27371,2,7371,[282  70 237 216 132],450,5,30500,4.1372761801410745,0.0,0.0
27372,2,7372,[238 202 168  97  96],450,5,30505,4.137393191373932,0.0,0.0
27373,2,7373,[318 496 588  98 357],716,5,30510,4.137510170870627,40.0,0.0
27374,2,7374,[ 22  88 191 405 234],269,1,30511,4.137084745762712,0.0,0.0
27375,2,7375,[216  98 228  69 175],716,4,30515,4.137066160520607,0.0,0.0
27376,2,7376,[318 496 588  98 357],786,5,30520,4.137183136776468,40.0,0.0
27377,2,7377,[ 69 200 168 496  22],450,4,30524,4.13716454323665,20.0,0.0
27378,2,7378,[318 496 588  98 357],330,5,30529,4.137281474454533,40.0,0.0
27379,2,7379,[322 357 186 153 423],796,3,30532,4.137127371273713,0.0,0.0
27380,2,7380,[318 496 588  98 357],786,5,30537,4.137244275843382,40.0,0.0
27381,2,7381,[ 98 204 176 238   9],504,2,30539,4.136954754808995,0.0,0.0
27382,2,7382,[238 568 127  82 176],450,4,30543,4.136936204794799,0.0,20.0
27383,2,7383,[265  15 275 174 228],151,5,30548,4.137053087757313,0.0,20.0
27384,2,7384,[483  89  56  88 603],269,3,30551,4.1368991198375085,20.0,0.0
27385,2,7385,[318 496 588  98 357],716,5,30556,4.137015976171135,40.0,0.0
27386,2,7386,[318 496 588  98 357],716,5,30561,4.137132800866387,40.0,0.0
27387,2,7387,[333 275 286 265 185],655,2,30563,4.136843530048727,0.0,40.0
27388,2,7388,[318 496 588  98 357],796,5,30568,4.136960346460955,40.0,0.0
27389,2,7389,[318 496 588  98 357],796,5,30573,4.137077131258457,40.0,0.0
27390,2,7390,[ 69 546   1  79 153],503,4,30577,4.1370585847652555,0.0,0.0
27391,2,7391,[257 322  69 118 181],796,4,30581,4.137040043290043,0.0,0.0
27392,2,7392,[127 100 318 427 135],72,5,30586,4.13715676991749,40.0,40.0
27393,2,7393,[318 496 588  98 357],786,5,30591,4.1372734649715985,40.0,0.0
27394,2,7394,[215 181 276   1  98],18,3,30594,4.13711967545639,0.0,0.0
27395,2,7395,[423 216  22 275 313],655,3,30597,4.136965927528394,0.0,20.0
27396,2,7396,[318 496 588  98 357],450,5,30602,4.137082601054481,40.0,0.0
27397,2,7397,[483 117 196 204 568],450,4,30606,4.137064071370641,0.0,0.0
27398,2,7398,[427 357 121 300 435],151,5,30611,4.137180700094607,20.0,0.0
27399,2,7399,[ 82 186 187  56 234],796,2,30613,4.136891891891892,0.0,0.0
27400,2,7400,[318 496 588  98 357],18,5,30618,4.137008512363194,40.0,0.0
27401,2,7401,[ 98 187 275 111  50],796,5,30623,4.137125101323966,0.0,40.0
27402,2,7402,[318 496 588  98 357],330,5,30628,4.137241658786978,40.0,0.0
27403,2,7403,[215 435 183 234 211],151,3,30631,4.137088060507834,0.0,0.0
27404,2,7404,[ 69 286 181 200 471],655,1,30632,4.136664415935179,0.0,20.0
27405,2,7405,[271 172 748  88 185],796,5,30637,4.136780988387794,0.0,0.0
27406,2,7406,[318 496 588  98 357],716,5,30642,4.136897529364115,40.0,0.0
27407,2,7407,[282 153 175 117 300],716,3,30645,4.136744060475162,0.0,0.0
27408,2,7408,[318 496 588  98 357],18,5,30650,4.13686057497638,40.0,0.0
27409,2,7409,[318 496 588  98 357],330,5,30655,4.136977058029689,40.0,0.0
27410,2,7410,[211 191 168 118 496],450,4,30659,4.1369585750910804,20.0,0.0
27411,2,7411,[318 496 588  98 357],450,5,30664,4.137075013491635,40.0,0.0
27412,2,7412,[258  98 568 403  15],450,4,30668,4.137056522325644,0.0,0.0
27413,2,7413,[235 183 228 151 385],23,2,30670,4.136768276234152,0.0,0.0
27414,2,7414,[318 496 588  98 357],796,5,30675,4.136884693189481,40.0,0.0
27415,2,7415,[318 496 588  98 357],796,5,30680,4.137001078748652,40.0,0.0
27416,2,7416,[318 496 588  98 357],796,5,30685,4.137117432924363,40.0,0.0
27417,2,7417,[245  71 144 186 403],796,3,30688,4.136964141277972,0.0,0.0
27418,2,7418,[211 588 117 271 258],796,4,30692,4.1369456800107836,0.0,0.0
27419,2,7419,[318 496 588  98 357],716,5,30697,4.137061994609164,40.0,0.0
27420,2,7420,[ 96  69 427  88  64],716,4,30701,4.137043525131384,40.0,0.0
27421,2,7421,[275 132 385  82 174],330,5,30706,4.137159795203449,0.0,20.0
27422,2,7422,[318 496 588  98 357],786,5,30711,4.137276033948538,40.0,0.0
27423,2,7423,[318 496 588  98 357],796,5,30716,4.1373922413793105,40.0,0.0
27424,2,7424,[318 496 588  98 357],330,5,30721,4.137508417508418,40.0,0.0
27425,2,7425,[318 496 588  98 357],450,5,30726,4.137624562348505,40.0,0.0
27426,2,7426,[318 496 588  98 357],330,5,30731,4.137740675912212,40.0,0.0
27427,2,7427,[302 265 179 235  98],450,4,30735,4.137722132471729,0.0,0.0
27428,2,7428,[ 15  25 215  79 294],457,4,30739,4.137703594023422,0.0,0.0
27429,2,7429,[318 496 588  98 357],716,5,30744,4.137819650067295,40.0,0.0
27430,2,7430,[318 496 588  98 357],786,5,30749,4.137935674875521,40.0,0.0
27431,2,7431,[ 11 427  95 748 144],436,3,30752,4.13778256189451,20.0,0.0
27432,2,7432,[318 496 588  98 357],18,5,30757,4.137898560473563,40.0,0.0
27433,2,7433,[197 238 153 483 275],151,4,30761,4.137880010761367,0.0,20.0
27434,2,7434,[ 89  88  98 202  70],655,2,30763,4.137592468056489,0.0,0.0
27435,2,7435,[318 496 588  98 357],716,5,30768,4.137708445400753,40.0,0.0
27436,2,7436,[318 496 588  98 357],786,5,30773,4.137824391555735,40.0,0.0
27437,2,7437,[318 496 588  98 357],796,5,30778,4.137940306534015,40.0,0.0
27438,2,7438,[318 496 588  98 357],330,5,30783,4.138056190348165,40.0,0.0
27439,2,7439,[385 153  97 118  98],151,2,30785,4.137768817204301,0.0,0.0
27440,2,7440,[  9 333  28 237 323],174,4,30789,4.137750302378713,0.0,0.0
27441,2,7441,[318 496 588  98 357],450,5,30794,4.137866165009406,40.0,0.0
27442,2,7442,[318 496 588  98 357],450,5,30799,4.1379819965067846,40.0,0.0
27443,2,7443,[318 496 588  98 357],450,5,30804,4.138097796883396,40.0,0.0
27444,2,7444,[318 496 588  98 357],330,5,30809,4.13821356615178,40.0,0.0
27445,2,7445,[318 496 588  98 357],450,5,30814,4.138329304324469,40.0,0.0
27446,2,7446,[318 496 588  98 357],716,5,30819,4.138445011413992,40.0,0.0
27447,2,7447,[288 222 182 568 118],450,2,30821,4.1381578947368425,0.0,0.0
27448,2,7448,[318 496 588  98 357],450,5,30826,4.138273593770976,40.0,0.0
27449,2,7449,[258 185 546 245  50],504,4,30830,4.138255033557047,0.0,20.0
27450,2,7450,[318 496 588  98 357],716,5,30835,4.138370688498188,40.0,0.0
27451,2,7451,[318 496 588  98 357],330,5,30840,4.138486312399356,40.0,0.0
27452,2,7452,[318 496 588  98 357],796,5,30845,4.1386019052730445,40.0,0.0
27453,2,7453,[275 175 228   1 176],655,1,30846,4.138180842500671,0.0,20.0
27454,2,7454,[318 496 588  98 357],450,5,30851,4.138296445338699,40.0,0.0
27455,2,7455,[318 496 588  98 357],716,5,30856,4.138412017167382,40.0,0.0
27456,2,7456,[318 496 588  98 357],796,5,30861,4.138527557999195,40.0,0.0
27457,2,7457,[318 496 588  98 357],796,5,30866,4.1386430678466075,40.0,0.0
27458,2,7458,[318 496 588  98 357],716,5,30871,4.138758546722081,40.0,0.0
27459,2,7459,[202  64   9 588 678],344,4,30875,4.138739946380697,20.0,0.0
27460,2,7460,[318 496 588  98 357],330,5,30880,4.138855381316177,40.0,0.0
27461,2,7461,[196  15 202 172 471],655,1,30881,4.138434735995712,0.0,0.0
27462,2,7462,[318 496 588  98 357],796,5,30886,4.138550180892403,40.0,0.0
27463,2,7463,[ 56 186 215 100 603],655,1,30887,4.138129689174705,20.0,20.0
27464,2,7464,[127  69 181 423 268],655,1,30888,4.1377093101138644,0.0,20.0
27465,2,7465,[318 496 588  98 357],18,5,30893,4.137824805786231,40.0,0.0
27466,2,7466,[ 69 357 403 273 282],655,2,30895,4.1375385027454135,0.0,0.0
27467,2,7467,[318 496 588  98 357],330,5,30900,4.1376539903588645,40.0,0.0
27468,2,7468,[318 496 588  98 357],796,5,30905,4.1377694470477975,40.0,0.0
27469,2,7469,[ 98 161 175 196 174],23,3,30908,4.137617135207496,0.0,0.0
27470,2,7470,[318 496 588  98 357],716,5,30913,4.137732565921564,40.0,0.0
27471,2,7471,[  4 471 151 176 546],577,3,30916,4.137580299785867,0.0,0.0
27472,2,7472,[318 496 588  98 357],450,5,30921,4.1376957045363305,40.0,0.0
27473,2,7473,[200  69 483 265 127],716,5,30926,4.137811078405138,0.0,20.0
27474,2,7474,[496 237 286 118 132],280,3,30929,4.137658862876254,20.0,20.0
27475,2,7475,[210 496 271 197 100],796,2,30931,4.137372926698769,20.0,20.0
27476,2,7476,[318 496 588  98 357],330,5,30936,4.1374882974455,40.0,0.0
27477,2,7477,[  8 678 385  95 196],344,3,30939,4.137336186146029,0.0,0.0
27478,2,7478,[153  22  98 385 603],330,5,30944,4.137451530953336,20.0,0.0
27479,2,7479,[318 496 588  98 357],330,5,30949,4.137566844919786,40.0,0.0
27480,2,7480,[  9 111 210 216 483],151,5,30954,4.1376821280577465,0.0,0.0
27481,2,7481,[318 496 588  98 357],18,5,30959,4.137797380379578,40.0,0.0
27482,2,7482,[318 496 588  98 357],330,5,30964,4.137912601897635,40.0,0.0
27483,2,7483,[  1 143  89 210 222],796,3,30967,4.137760555852485,0.0,0.0
27484,2,7484,[318 496 588  98 357],796,5,30972,4.137875751503006,40.0,0.0
27485,2,7485,[318 496 588  98 357],716,5,30977,4.1379909163772375,40.0,0.0
27486,2,7486,[318 496 588  98 357],796,5,30982,4.138106050487512,40.0,0.0
27487,2,7487,[197  70 181  69 121],503,4,30986,4.1380876068376065,0.0,0.0
27488,2,7488,[318 496 588  98 357],18,5,30991,4.1382026972893575,40.0,0.0
27489,2,7489,[318 496 588  98 357],450,5,30996,4.138317757009346,40.0,0.0
27490,2,7490,[318 496 588  98 357],796,5,31001,4.138432786009878,40.0,0.0
27491,2,7491,[318 496 588  98 357],786,5,31006,4.138547784303257,40.0,0.0
27492,2,7492,[318 496 588  98 357],450,5,31011,4.138662751901775,40.0,0.0
27493,2,7493,[318 496 588  98 357],796,5,31016,4.138777688817721,40.0,0.0
27494,2,7494,[  8 435 228 121  89],756,2,31018,4.138492328218812,0.0,0.0
27495,2,7495,[118   4 655  97 144],716,2,31020,4.13820704375667,0.0,0.0
27496,2,7496,[222  98 276 121 111],457,4,31024,4.1381886087768445,0.0,0.0
27497,2,7497,[318 496 588  98 357],18,5,31029,4.138303547612697,40.0,0.0
27498,2,7498,[269 196 211  15  64],655,1,31030,4.137885051340179,20.0,0.0
27499,2,7499,[318 496 588  98 357],450,5,31035,4.138,40.0,0.0
27500,2,7500,[196 423 655  69  89],655,1,31036,4.137581655779229,0.0,0.0
27501,2,7501,[196  12 153 111 568],655,0,31036,4.13703012529992,0.0,0.0
27502,2,7502,[125 132 216 258 100],504,5,31041,4.137145141943223,0.0,20.0
27503,2,7503,[318 496 588  98 357],18,5,31046,4.13726012793177,40.0,0.0
27504,2,7504,[318 496 588  98 357],18,5,31051,4.1373750832778144,40.0,0.0
27505,2,7505,[483 238  69 111 294],716,5,31056,4.1374900079936054,0.0,0.0
27506,2,7506,[179 215 100 423 161],450,5,31061,4.137604902091382,0.0,20.0
27507,2,7507,[318 496 588  98 357],18,5,31066,4.137719765583378,40.0,0.0
27508,2,7508,[318 496 588  98 357],796,5,31071,4.137834598481822,40.0,0.0
27509,2,7509,[318 496 588  98 357],716,5,31076,4.137949400798934,40.0,0.0
27510,2,7510,[245 385 216 427  89],450,5,31081,4.138064172546931,20.0,0.0
27511,2,7511,[318 496 588  98 357],786,5,31086,4.138178913738019,40.0,0.0
27512,2,7512,[318 496 588  98 357],796,5,31091,4.1382936243844,40.0,0.0
27513,2,7513,[318 496 588  98 357],796,5,31096,4.13840830449827,40.0,0.0
27514,2,7514,[318 496 588  98 357],330,5,31101,4.138522954091816,40.0,0.0
27515,2,7515,[111 211 275 187 496],716,4,31105,4.13850452368281,20.0,20.0
27516,2,7516,[318 496 588  98 357],796,5,31110,4.138619129972064,40.0,0.0
27517,2,7517,[194 508   1  11 179],296,5,31115,4.138733705772812,0.0,0.0
27518,2,7518,[318 496 588  98 357],796,5,31120,4.138848251097221,40.0,0.0
27519,2,7519,[427 475 258 275 118],655,2,31122,4.138563829787234,20.0,20.0
27520,2,7520,[318 496 588  98 357],796,5,31127,4.138678367238399,40.0,0.0
27521,2,7521,[ 64 111 168   7 182],269,3,31130,4.138526987503323,20.0,0.0
27522,2,7522,[318 496 588  98 357],450,5,31135,4.138641499401834,40.0,0.0
27523,2,7523,[153  70 168 234  97],716,5,31140,4.138755980861244,0.0,0.0
27524,2,7524,[318 496 588  98 357],330,5,31145,4.138870431893688,40.0,0.0
27525,2,7525,[318 496 588  98 357],18,5,31150,4.138984852511294,40.0,0.0
27526,2,7526,[318 496 588  98 357],450,5,31155,4.139099242726186,40.0,0.0
27527,2,7527,[144 245  56 153 385],450,5,31160,4.139213602550479,0.0,0.0
27528,2,7528,[318 496 588  98 357],796,5,31165,4.139327931996281,40.0,0.0
27529,2,7529,[318 496 588  98 357],786,5,31170,4.139442231075697,40.0,0.0
27530,2,7530,[173  88 496 185  82],389,3,31173,4.13929093081928,20.0,0.0
27531,2,7531,[597 191 216 483  98],23,3,31176,4.139139670738183,0.0,0.0
27532,2,7532,[301 200 234 403 111],796,3,31179,4.138988450816408,0.0,0.0
27533,2,7533,[ 15 483 282 328 275],655,2,31181,4.1387045394212905,0.0,20.0
27534,2,7534,[204 202  28 483 185],450,4,31185,4.138686131386861,0.0,0.0
27535,2,7535,[318 496 588  98 357],716,5,31190,4.13880042462845,40.0,0.0
27536,2,7536,[153 191 151   1 403],18,3,31193,4.138649329972138,0.0,0.0
27537,2,7537,[276 172 182 265  79],256,3,31196,4.138498275404617,0.0,0.0
27538,2,7538,[318 496 588  98 357],786,5,31201,4.1386125480833,40.0,0.0
27539,2,7539,[328 200 204  11 508],655,1,31202,4.138196286472149,0.0,0.0
27540,2,7540,[181 405 515   8 173],269,1,31203,4.137780135260575,0.0,0.0
27541,2,7541,[318 496 588  98 357],18,5,31208,4.137894457703527,40.0,0.0
27542,2,7542,[318 496 588  98 357],18,5,31213,4.138008749834284,40.0,0.0
27543,2,7543,[318 496 588  98 357],796,5,31218,4.1381230116648995,40.0,0.0
27544,2,7544,[182  82  12  96 276],256,4,31222,4.138104705102717,0.0,0.0
27545,2,7545,[318 496 588  98 357],450,5,31227,4.138218923933209,40.0,0.0
27546,2,7546,[172 427 161 197 204],269,2,31229,4.13793560355108,20.0,0.0
27547,2,7547,[318 496 588  98 357],796,5,31234,4.138049814520403,40.0,0.0
27548,2,7548,[318 496 588  98 357],18,5,31239,4.138163995231157,40.0,0.0
27549,2,7549,[143 173  11  82  28],457,5,31244,4.138278145695364,0.0,0.0
27550,2,7550,[318 496 588  98 357],716,5,31249,4.138392265925043,40.0,0.0
27551,2,7551,[318 496 588  98 357],18,5,31254,4.138506355932203,40.0,0.0
27552,2,7552,[318 496 588  98 357],796,5,31259,4.138620415728849,40.0,0.0
27553,2,7553,[322  82 194 125  12],796,3,31262,4.138469684935134,0.0,0.0
27554,2,7554,[ 79  11  98  88 135],716,4,31266,4.138451356717406,0.0,0.0
27555,2,7555,[257 237  96   7 204],457,4,31270,4.13843303335098,0.0,0.0
27556,2,7556,[174 210  15  12 322],151,4,31274,4.138414714833929,0.0,0.0
27557,2,7557,[174  50 496 204 153],389,4,31278,4.1383964011643295,20.0,20.0
27558,2,7558,[318 496 588  98 357],450,5,31283,4.138510384971557,40.0,0.0
27559,2,7559,[318 496 588  98 357],330,5,31288,4.138624338624338,40.0,0.0
27560,2,7560,[318 496 588  98 357],716,5,31293,4.1387382621346385,40.0,0.0
27561,2,7561,[191 288 215 180  56],693,2,31295,4.138455435070087,0.0,0.0
27562,2,7562,[318 496 588  98 357],716,5,31300,4.1385693507867245,40.0,0.0
27563,2,7563,[211  97 328 273 301],450,4,31304,4.138551031200423,0.0,0.0
27564,2,7564,[318 496 588  98 357],796,5,31309,4.138664904163913,40.0,0.0
27565,2,7565,[ 88 471 282 125  25],457,5,31314,4.13877874702617,0.0,0.0
27566,2,7566,[318 496 588  98 357],796,5,31319,4.138892559799128,40.0,0.0
27567,2,7567,[318 496 588  98 357],18,5,31324,4.1390063424947146,40.0,0.0
27568,2,7568,[210 100  69 271  97],655,0,31324,4.138459505879244,0.0,20.0
27569,2,7569,[318 496 588  98 357],330,5,31329,4.138573315719947,40.0,0.0
27570,2,7570,[195 132 127 655 194],457,5,31334,4.138687095495971,0.0,20.0
27571,2,7571,[318 496 588  98 357],796,5,31339,4.138800845219229,40.0,0.0
27572,2,7572,[318 496 588  98 357],18,5,31344,4.138914564901624,40.0,0.0
27573,2,7573,[237 235  88  25 181],716,4,31348,4.13889622392395,0.0,0.0
27574,2,7574,[318 496 588  98 357],330,5,31353,4.139009900990099,40.0,0.0
27575,2,7575,[196 127 151 318 405],457,5,31358,4.139123548046462,20.0,20.0
27576,2,7576,[301 237 742 655 196],796,2,31360,4.138841230038274,0.0,0.0
27577,2,7577,[265  50   4 405  28],655,1,31361,4.138427025600422,0.0,20.0
27578,2,7578,[678   4 496  79  88],344,3,31364,4.138276817522101,20.0,0.0
27579,2,7579,[318 496 588  98 357],716,5,31369,4.138390501319261,40.0,0.0
27580,2,7580,[ 79 237   1 515 294],655,2,31371,4.138108428967155,0.0,0.0
27581,2,7581,[  1 268 210 174 215],655,0,31371,4.137562648377736,0.0,0.0
27582,2,7582,[318 496 588  98 357],716,5,31376,4.137676381379401,40.0,0.0
27583,2,7583,[318 496 588  98 357],786,5,31381,4.137790084388186,40.0,0.0
27584,2,7584,[318 515 186 286 153],18,5,31386,4.137903757415953,20.0,20.0
27585,2,7585,[180  89 183 234  28],786,4,31390,4.137885578697601,0.0,0.0
27586,2,7586,[496  22 222 301  98],344,4,31394,4.1378674047713195,20.0,0.0
27587,2,7587,[183 515 191  98 181],716,4,31398,4.137849235635214,0.0,0.0
27588,2,7588,[318 496 588  98 357],330,5,31403,4.137962840954012,40.0,0.0
27589,2,7589,[318 496 588  98 357],796,5,31408,4.138076416337286,40.0,0.0
27590,2,7590,[655 515 211 196 210],535,4,31412,4.1380582268475825,0.0,0.0
27591,2,7591,[318 496 588  98 357],786,5,31417,4.138171759747102,40.0,0.0
27592,2,7592,[238 286 143 603  28],796,2,31419,4.137890161991308,20.0,20.0
27593,2,7593,[ 50  88   9 286  15],174,5,31424,4.138003687121412,0.0,40.0
27594,2,7594,[318 496 588  98 357],796,5,31429,4.1381171823568135,40.0,0.0
27595,2,7595,[318 496 588  98 357],18,5,31434,4.138230647709321,40.0,0.0
27596,2,7596,[276 328 294 257 678],401,2,31436,4.137949190469922,0.0,0.0
27597,2,7597,[318 496 588  98 357],18,5,31441,4.13806264806528,40.0,0.0
27598,2,7598,[318 496 588  98 357],18,5,31446,4.138176075799447,40.0,0.0
27599,2,7599,[318 496 588  98 357],18,5,31451,4.13828947368421,40.0,0.0
27600,2,7600,[ 98 269   7 215 302],344,4,31455,4.138271280094725,0.0,0.0
27601,2,7601,[318 496 588  98 357],450,5,31460,4.138384635622205,40.0,0.0
27602,2,7602,[318 496 588  98 357],716,5,31465,4.138497961331054,40.0,0.0
27603,2,7603,[313 191 435 294  22],655,2,31467,4.138216728037875,0.0,0.0
27604,2,7604,[318 496 588  98 357],716,5,31472,4.138330046022354,40.0,0.0
27605,2,7605,[318 496 588  98 357],450,5,31477,4.138443334209835,40.0,0.0
27606,2,7606,[318 496 588  98 357],18,5,31482,4.138556592612068,40.0,0.0
27607,2,7607,[318 496 588  98 357],786,5,31487,4.138669821240799,40.0,0.0
27608,2,7608,[ 82  22 191 211 496],18,4,31491,4.138651596793271,20.0,0.0
27609,2,7609,[ 98  82 185 174  25],330,5,31496,4.138764783180027,0.0,0.0
27610,2,7610,[ 15 216 603 111 496],18,3,31499,4.138615162265142,40.0,0.0
27611,2,7611,[318 496 588  98 357],450,5,31504,4.138728323699422,40.0,0.0
27612,2,7612,[273 161 508 427 568],655,2,31506,4.13844739261789,20.0,0.0
27613,2,7613,[ 15 181 117 200 211],593,5,31511,4.138560546361965,0.0,0.0
27614,2,7614,[151  22 210   8 318],269,2,31513,4.13827971109652,20.0,0.0
27615,2,7615,[ 12 191  96 196  97],655,1,31514,4.137867647058823,0.0,0.0
27616,2,7616,[318 496 588  98 357],796,5,31519,4.137980832348694,40.0,0.0
27617,2,7617,[318 496 588  98 357],796,5,31524,4.138093987923339,40.0,0.0
27618,2,7618,[318 496 588  98 357],716,5,31529,4.138207113794461,40.0,0.0
27619,2,7619,[269 237  97  50 125],796,3,31532,4.138057742782152,0.0,20.0
27620,2,7620,[181  11 132   9 187],655,1,31533,4.137645978218082,0.0,0.0
27621,2,7621,[100  69  98 333 288],655,1,31534,4.137234321700341,0.0,20.0
27622,2,7622,[175 357  79  97 118],716,3,31537,4.137085137085137,0.0,0.0
27623,2,7623,[127 135  50 655  70],280,3,31540,4.136935991605457,0.0,40.0
27624,2,7624,[318 496 588  98 357],716,5,31545,4.137049180327869,40.0,0.0
27625,2,7625,[288 118 265  50 228],256,4,31549,4.137031209021767,0.0,20.0
27626,2,7626,[318 496 588  98 357],450,5,31554,4.137144355578864,40.0,0.0
27627,2,7627,[318 496 588  98 357],796,5,31559,4.137257472469848,40.0,0.0
27628,2,7628,[427 118 187 132 275],796,5,31564,4.137370559706383,20.0,20.0
27629,2,7629,[405 127 301 273  79],344,4,31568,4.137352555701179,0.0,20.0
27630,2,7630,[200 588 385 210 191],716,4,31572,4.137334556414625,0.0,0.0
27631,2,7631,[132 174 125 742 322],344,2,31574,4.137054507337526,0.0,0.0
27632,2,7632,[135  70 173 118 180],450,3,31577,4.136905541726713,0.0,0.0
27633,2,7633,[176 405 161 111 655],457,4,31581,4.136887608069165,0.0,0.0
27634,2,7634,[318 496 588  98 357],796,5,31586,4.137000654878848,40.0,0.0
27635,2,7635,[322 183   4  69 121],151,3,31589,4.136851754845469,0.0,0.0
27636,2,7636,[318 496 588  98 357],450,5,31594,4.1369647767447955,40.0,0.0
27637,2,7637,[135 286 546 275 385],450,4,31598,4.13694684472375,0.0,40.0
27638,2,7638,[117 172 286 216 187],236,2,31600,4.136667103023956,0.0,20.0
27639,2,7639,[318 496 588  98 357],716,5,31605,4.136780104712042,40.0,0.0
27640,2,7640,[318 496 588  98 357],450,5,31610,4.136893076822405,40.0,0.0
27641,2,7641,[151 100 237 191 117],236,2,31612,4.136613451975922,0.0,20.0
27642,2,7642,[257  88 302 181 173],401,1,31613,4.136203061625016,0.0,0.0
27643,2,7643,[118   9 258 322  71],796,3,31616,4.136054421768708,0.0,0.0
27644,2,7644,[568 288   8 471 271],655,0,31616,4.1355134074558535,0.0,0.0
27645,2,7645,[234 202  98 546 323],504,3,31619,4.135364896678001,0.0,0.0
27646,2,7646,[ 96 273 135 496 269],450,3,31622,4.135216424741729,20.0,0.0
27647,2,7647,[318 496 588  98 357],330,5,31627,4.13532949790795,40.0,0.0
27648,2,7648,[318 496 588  98 357],450,5,31632,4.135442541508694,40.0,0.0
27649,2,7649,[222  15 257   7 294],655,0,31632,4.134901960784314,0.0,0.0
27650,2,7650,[483 216   9 302 183],151,3,31635,4.134753626976866,0.0,0.0
27651,2,7651,[271 175 655 121  25],655,0,31635,4.13421327757449,0.0,0.0
27652,2,7652,[318 496 588  98 357],330,5,31640,4.134326407944597,40.0,0.0
27653,2,7653,[318 496 588  98 357],450,5,31645,4.134439508753593,40.0,0.0
27654,2,7654,[318 496 588  98 357],796,5,31650,4.134552580013064,40.0,0.0
27655,2,7655,[318 496 588  98 357],796,5,31655,4.134665621734587,40.0,0.0
27656,2,7656,[318 228  79 300 172],716,5,31660,4.134778633929738,20.0,0.0
27657,2,7657,[121   1 153 435 132],450,4,31664,4.1347610342125884,0.0,0.0
27658,2,7658,[318 496 588  98 357],796,5,31669,4.134874004439222,40.0,0.0
27659,2,7659,[185 405 132  56  88],716,5,31674,4.134986945169713,0.0,0.0
27660,2,7660,[318 496 588  98 357],716,5,31679,4.135099856415612,40.0,0.0
27661,2,7661,[318 496 588  98 357],716,5,31684,4.1352127381884625,40.0,0.0
27662,2,7662,[318 496 588  98 357],450,5,31689,4.1353255904998045,40.0,0.0
27663,2,7663,[318 496 588  98 357],786,5,31694,4.135438413361169,40.0,0.0
27664,2,7664,[318 496 588  98 357],450,5,31699,4.135551206784084,40.0,0.0
27665,2,7665,[318 496 588  98 357],716,5,31704,4.135663970780068,40.0,0.0
27666,2,7666,[318 496 588  98 357],330,5,31709,4.1357767053606365,40.0,0.0
27667,2,7667,[144 143  88  79 210],796,4,31713,4.135758998435055,0.0,0.0
27668,2,7668,[238  12 483 423 197],796,3,31716,4.135610901030121,0.0,0.0
27669,2,7669,[318 496 588  98 357],716,5,31721,4.1357235984354626,40.0,0.0
27670,2,7670,[269 245 237 143 496],450,5,31726,4.135836266458089,20.0,0.0
27671,2,7671,[318 496 588  98 357],18,5,31731,4.135948905109489,40.0,0.0
27672,2,7672,[318 496 588  98 357],786,5,31736,4.136061514401147,40.0,0.0
27673,2,7673,[318 496 588  98 357],330,5,31741,4.13617409434454,40.0,0.0
27674,2,7674,[172 195 191 288 161],457,5,31746,4.13628664495114,0.0,0.0
27675,2,7675,[318 496 588  98 357],796,5,31751,4.136399166232413,40.0,0.0
27676,2,7676,[204 286 211 210 269],264,4,31755,4.136381398983978,0.0,20.0
27677,2,7677,[161 174  71 228 385],23,3,31758,4.1362333941130505,0.0,0.0
27678,2,7678,[228 282 301   1 222],655,0,31758,4.135694751920823,0.0,0.0
27679,2,7679,[125  56 196 143   8],655,1,31759,4.135286458333334,0.0,0.0
27680,2,7680,[161  79  11 182 655],457,5,31764,4.135399036583778,0.0,0.0
27681,2,7681,[318 496 588  98 357],330,5,31769,4.135511585524603,40.0,0.0
27682,2,7682,[318 322 265 132 471],786,4,31773,4.1354939476766885,20.0,0.0
27683,2,7683,[318 496 588  98 357],796,5,31778,4.135606454971369,40.0,0.0
27684,2,7684,[195 603 222 588 121],796,5,31783,4.135718932986337,20.0,0.0
27685,2,7685,[318 496 588  98 357],450,5,31788,4.135831381733021,40.0,0.0
27686,2,7686,[161 294  96 172  15],577,4,31792,4.135813711460908,0.0,0.0
27687,2,7687,[318 496 588  98 357],18,5,31797,4.135926118626431,40.0,0.0
27688,2,7688,[318 496 588  98 357],18,5,31802,4.136038496553518,40.0,0.0
27689,2,7689,[318 496 588  98 357],786,5,31807,4.136150845253576,40.0,0.0
27690,2,7690,[318 496 588  98 357],450,5,31812,4.136263164738005,40.0,0.0
27691,2,7691,[180  97 568 427 597],450,5,31817,4.136375455018201,20.0,0.0
27692,2,7692,[318 496 588  98 357],18,5,31822,4.136487716105551,40.0,0.0
27693,2,7693,[318 496 588  98 357],786,5,31827,4.136599948011438,40.0,0.0
27694,2,7694,[118  96 235 153 121],716,2,31829,4.13632228719948,0.0,0.0
27695,2,7695,[318 496 588  98 357],716,5,31834,4.136434511434511,40.0,0.0
27696,2,7696,[318 496 588  98 357],716,5,31839,4.136546706509029,40.0,0.0
27697,2,7697,[143 191 655 742  89],796,3,31842,4.136399064692128,0.0,0.0
27698,2,7698,[ 97 204  96 144  95],716,3,31845,4.136251461228731,0.0,0.0
27699,2,7699,[194   1 435 181 385],151,4,31849,4.136233766233766,0.0,0.0
27700,2,7700,[318 496 588  98 357],450,5,31854,4.136345929100117,40.0,0.0
27701,2,7701,[211 187 471  82 210],786,5,31859,4.136458062840821,0.0,0.0
27702,2,7702,[318 496 588  98 357],716,5,31864,4.13657016746722,40.0,0.0
27703,2,7703,[318 496 588  98 357],330,5,31869,4.136682242990654,40.0,0.0
27704,2,7704,[318 496 588  98 357],18,5,31874,4.136794289422453,40.0,0.0
27705,2,7705,[200 143  97  79 176],796,4,31878,4.136776537762782,0.0,0.0
27706,2,7706,[175 196 125 597 191],344,3,31881,4.1366290385363955,0.0,0.0
27707,2,7707,[318 496 588  98 357],716,5,31886,4.1367410482615465,40.0,0.0
27708,2,7708,[318 496 588  98 357],18,5,31891,4.136853028927228,40.0,0.0
27709,2,7709,[318 496 588  98 357],796,5,31896,4.1369649805447475,40.0,0.0
27710,2,7710,[318 496 588  98 357],330,5,31901,4.137076903125405,40.0,0.0
27711,2,7711,[ 15  82 215   4 245],796,3,31904,4.136929460580913,0.0,0.0
27712,2,7712,[318 496 588  98 357],450,5,31909,4.137041358744976,40.0,0.0
27713,2,7713,[273 483 286 435 237],401,2,31911,4.136764324604615,0.0,20.0
27714,2,7714,[121 125 748  11 603],401,1,31912,4.136357744653273,20.0,0.0
27715,2,7715,[318 496 588  98 357],330,5,31917,4.13646967340591,40.0,0.0
27716,2,7716,[185 200 301 300  88],655,2,31919,4.136192821044447,0.0,0.0
27717,2,7717,[ 56 546 323 196 210],796,3,31922,4.136045607670381,0.0,0.0
27718,2,7718,[185 515   1 301 603],655,3,31925,4.1358984324394354,20.0,0.0
27719,2,7719,[318 496 588  98 357],18,5,31930,4.1360103626943,40.0,0.0
27720,2,7720,[269 197 483 135  25],450,2,31932,4.1357337132495795,0.0,0.0
27721,2,7721,[ 25 427 423 405 143],450,4,31936,4.135716135716136,20.0,0.0
27722,2,7722,[111 186 215  79 173],457,4,31940,4.135698562734689,0.0,0.0
27723,2,7723,[318 496 588  98 357],18,5,31945,4.135810460901087,40.0,0.0
27724,2,7724,[318 496 588  98 357],330,5,31950,4.135922330097087,40.0,0.0
27725,2,7725,[318 496 588  98 357],18,5,31955,4.136034170333938,40.0,0.0
27726,2,7726,[318 496 588  98 357],18,5,31960,4.136145981622881,40.0,0.0
27727,2,7727,[191  89 405 181  82],23,3,31963,4.135998964803313,0.0,0.0
27728,2,7728,[271 125 183 216 215],655,2,31965,4.135722603182818,0.0,0.0
27729,2,7729,[318 496 588  98 357],330,5,31970,4.135834411384217,40.0,0.0
27730,2,7730,[194 211 153 161 185],401,3,31973,4.1356874919156645,0.0,0.0
27731,2,7731,[318 496 588  98 357],796,5,31978,4.135799275737196,40.0,0.0
27732,2,7732,[318 496 588  98 357],796,5,31983,4.135911030647873,40.0,0.0
27733,2,7733,[194 282 196 172 151],457,5,31988,4.1360227566589085,0.0,0.0
27734,2,7734,[257 183 271 286 187],655,2,31990,4.135746606334842,0.0,20.0
27735,2,7735,[318 496 588  98 357],450,5,31995,4.135858324715615,40.0,0.0
27736,2,7736,[186 127 435 144 195],807,2,31997,4.135582267028564,0.0,20.0
27737,2,7737,[318 496 588  98 357],796,5,32002,4.135693977772034,40.0,0.0
27738,2,7738,[258 202  22 181   9],457,5,32007,4.135805659645949,0.0,0.0
27739,2,7739,[328  22 515  88   9],655,1,32008,4.135400516795865,0.0,0.0
27740,2,7740,[174 143 197 118 210],796,3,32011,4.135253843172717,0.0,0.0
27741,2,7741,[423 300  79 143 191],151,4,32015,4.135236373030224,0.0,0.0
27742,2,7742,[742 568 655  82  71],280,2,32017,4.134960609582849,0.0,0.0
27743,2,7743,[318 496 588  98 357],18,5,32022,4.135072314049586,40.0,0.0
27744,2,7744,[318 496 588  98 357],18,5,32027,4.135183989670756,40.0,0.0
27745,2,7745,[ 98 385 286 185 275],151,4,32031,4.135166537567777,0.0,40.0
27746,2,7746,[318 496 588  98 357],786,5,32036,4.135278172195688,40.0,0.0
27747,2,7747,[ 15 742 144 181 265],450,4,32040,4.13526071244192,0.0,0.0
27748,2,7748,[318 496 588  98 357],716,5,32045,4.1353723061040135,40.0,0.0
27749,2,7749,[318 496 588  98 357],796,5,32050,4.135483870967742,40.0,0.0
27750,2,7750,[ 89  98 204  69 100],151,4,32054,4.135466391433363,0.0,20.0
27751,2,7751,[318 496 588  98 357],716,5,32059,4.135577915376677,40.0,0.0
27752,2,7752,[318 496 588  98 357],18,5,32064,4.1356894105507545,40.0,0.0
27753,2,7753,[318 496 588  98 357],330,5,32069,4.1358008769667265,40.0,0.0
27754,2,7754,[318 496 588  98 357],330,5,32074,4.135912314635719,40.0,0.0
27755,2,7755,[318 496 588  98 357],716,5,32079,4.13602372356885,40.0,0.0
27756,2,7756,[318 496 588  98 357],450,5,32084,4.136135103777233,40.0,0.0
27757,2,7757,[318 496 588  98 357],330,5,32089,4.136246455271977,40.0,0.0
27758,2,7758,[318 496 588  98 357],330,5,32094,4.136357778064183,40.0,0.0
27759,2,7759,[318 496 588  98 357],716,5,32099,4.136469072164949,40.0,0.0
27760,2,7760,[191 286  22 568 282],655,1,32100,4.13606494008504,0.0,20.0
27761,2,7761,[318 496 588  98 357],786,5,32105,4.136176243236279,40.0,0.0
27762,2,7762,[546   7 328  96 211],450,5,32110,4.1362875177122245,0.0,0.0
27763,2,7763,[742 234 121 238 181],504,2,32112,4.1360123647604325,0.0,0.0
27764,2,7764,[403 175 191 181 117],457,5,32117,4.1361236316806185,0.0,0.0
27765,2,7765,[ 28 173  56 121  12],796,4,32121,4.1361061035282,0.0,0.0
27766,2,7766,[ 70 135 265 322 357],151,4,32125,4.136088579889275,0.0,0.0
27767,2,7767,[318 496 588  98 357],796,5,32130,4.136199794026776,40.0,0.0
27768,2,7768,[318 496 588  98 357],450,5,32135,4.136310979534046,40.0,0.0
27769,2,7769,[275 182 282 237 181],655,2,32137,4.136036036036036,0.0,20.0
27770,2,7770,[318 496 588  98 357],716,5,32142,4.136147214000772,40.0,0.0
27771,2,7771,[318 496 588  98 357],330,5,32147,4.136258363355636,40.0,0.0
27772,2,7772,[318 496 588  98 357],18,5,32152,4.136369484111668,40.0,0.0
27773,2,7773,[174  70 194 196 235],401,4,32156,4.136351942372009,0.0,0.0
27774,2,7774,[318 496 588  98 357],18,5,32161,4.136463022508039,40.0,0.0
27775,2,7775,[318 496 588  98 357],330,5,32166,4.136574074074074,40.0,0.0
27776,2,7776,[318 496 588  98 357],716,5,32171,4.136685097081137,40.0,0.0
27777,2,7777,[318 313  79  28 200],796,4,32175,4.136667523785035,20.0,0.0
27778,2,7778,[135  71 435 300 268],535,2,32177,4.136392852551742,0.0,0.0
27779,2,7779,[ 28 168 151 204 385],151,4,32181,4.136375321336761,0.0,0.0
27780,2,7780,[ 82 302 161  50  98],450,4,32185,4.13635779462794,0.0,20.0
27781,2,7781,[318 496 588  98 357],786,5,32190,4.136468774094063,40.0,0.0
27782,2,7782,[318 496 588  98 357],330,5,32195,4.1365797250417575,40.0,0.0
27783,2,7783,[216  15  70 179 427],18,5,32200,4.136690647482014,20.0,0.0
27784,2,7784,[435  89 237  11 161],450,5,32205,4.136801541425819,0.0,0.0
27785,2,7785,[318 496 588  98 357],716,5,32210,4.136912406884151,40.0,0.0
27786,2,7786,[318 496 588  98 357],450,5,32215,4.1370232438679855,40.0,0.0
27787,2,7787,[318 496 588  98 357],786,5,32220,4.13713405238829,40.0,0.0
27788,2,7788,[186 655 322 117 300],450,4,32224,4.137116446270381,0.0,0.0
27789,2,7789,[318 496 588  98 357],450,5,32229,4.137227214377407,40.0,0.0
27790,2,7790,[385   9 234 111 257],655,0,32229,4.136696187909126,0.0,0.0
27791,2,7791,[121 204 183  25 194],504,2,32231,4.136421971252567,0.0,0.0
27792,2,7792,[318 496 588  98 357],330,5,32236,4.13653278583344,40.0,0.0
27793,2,7793,[301 496 100 318 300],151,4,32240,4.136515268154991,40.0,20.0
27794,2,7794,[300 125 183 118 181],796,5,32245,4.1366260423348304,0.0,0.0
27795,2,7795,[405 191  88  25  95],344,3,32248,4.1364802462801435,0.0,0.0
27796,2,7796,[318 215 168 405   8],577,4,32252,4.136462742080287,20.0,0.0
27797,2,7797,[318 496 588  98 357],796,5,32257,4.136573480379584,40.0,0.0
27798,2,7798,[257 191 215 183  88],457,4,32261,4.136555968713938,0.0,0.0
27799,2,7799,[268 153 182 195 403],269,2,32263,4.136282051282051,0.0,0.0
27800,2,7800,[318 496 588  98 357],330,5,32268,4.136392770157672,40.0,0.0
27801,2,7801,[318 496 588  98 357],796,5,32273,4.136503460651115,40.0,0.0
27802,2,7802,[318 496 588  98 357],796,5,32278,4.136614122773293,40.0,0.0
27803,2,7803,[655 403 182 181  82],450,4,32282,4.136596617119426,0.0,0.0
27804,2,7804,[318 496 588  98 357],450,5,32287,4.136707238949391,40.0,0.0
27805,2,7805,[183 125 322 655 568],450,5,32292,4.136817832436587,0.0,0.0
27806,2,7806,[118 301   4 471 403],655,0,32292,4.136287946714487,0.0,0.0
27807,2,7807,[257 175  22 195 403],457,4,32296,4.136270491803279,0.0,0.0
27808,2,7808,[194   7   4 202 275],450,4,32300,4.13625304136253,0.0,20.0
27809,2,7809,[  4 144 496 181 286],280,2,32302,4.135979513444302,20.0,20.0
27810,2,7810,[318 496 588  98 357],786,5,32307,4.136090129304827,40.0,0.0
27811,2,7811,[318 496 588  98 357],18,5,32312,4.136200716845878,40.0,0.0
27812,2,7812,[318 496 588  98 357],716,5,32317,4.136311276078331,40.0,0.0
27813,2,7813,[318 496 588  98 357],450,5,32322,4.136421807013053,40.0,0.0
27814,2,7814,[318 496 588  98 357],786,5,32327,4.136532309660908,40.0,0.0
27815,2,7815,[ 88 179 176   4 568],577,2,32329,4.136258955987717,0.0,0.0
27816,2,7816,[181 435 216   9  56],269,2,32331,4.135985672252782,0.0,0.0
27817,2,7817,[143 121 176 235 191],716,3,32334,4.13584036838066,0.0,0.0
27818,2,7818,[153 200 318 151 172],716,5,32339,4.135950888860468,20.0,0.0
27819,2,7819,[328 294  25 144 237],450,4,32343,4.135933503836317,0.0,0.0
27820,2,7820,[318 496 588  98 357],330,5,32348,4.13604398414525,40.0,0.0
27821,2,7821,[318 496 588  98 357],786,5,32353,4.136154436205574,40.0,0.0
27822,2,7822,[318 496 588  98 357],330,5,32358,4.136264860028122,40.0,0.0
27823,2,7823,[318 496 588  98 357],796,5,32363,4.136375255623722,40.0,0.0
27824,2,7824,[318 496 588  98 357],450,5,32368,4.136485623003195,40.0,0.0
27825,2,7825,[118 179 194 222 288],457,5,32373,4.136595962177357,0.0,0.0
27826,2,7826,[333 180 118 313 405],796,4,32377,4.136578510284911,0.0,0.0
27827,2,7827,[405 357  82  50 144],655,2,32379,4.1363055697496165,0.0,20.0
27828,2,7828,[196 423  97 603  15],796,4,32383,4.136288159407331,20.0,0.0
27829,2,7829,[127 588   4 257 276],457,4,32387,4.136270753512133,0.0,20.0
27830,2,7830,[405  28 568 257  95],796,4,32391,4.136253352062316,0.0,0.0
27831,2,7831,[318 496 588  98 357],796,5,32396,4.136363636363637,40.0,0.0
27832,2,7832,[195 176 475 265 423],292,5,32401,4.136473892506064,0.0,0.0
27833,2,7833,[318 496 588  98 357],786,5,32406,4.136584120500383,40.0,0.0
27834,2,7834,[132  22 173 257 215],796,5,32411,4.136694320357371,0.0,0.0
27835,2,7835,[318 496 588  98 357],796,5,32416,4.1368044920877995,40.0,0.0
27836,2,7836,[ 22 211 132  71 174],535,4,32420,4.136787035855557,0.0,0.0
27837,2,7837,[ 22 172 191 546 228],450,5,32425,4.136897167644808,0.0,0.0
27838,2,7838,[318 496 588  98 357],450,5,32430,4.137007271335629,40.0,0.0
27839,2,7839,[ 69 135 288 176 234],693,1,32431,4.136607142857143,0.0,0.0
27840,2,7840,[318 496 588  98 357],18,5,32436,4.136717255452111,40.0,0.0
27841,2,7841,[271 111 357  69 210],629,5,32441,4.136827339964295,0.0,0.0
27842,2,7842,[268  12 328 237 313],655,1,32442,4.136427387479281,0.0,0.0
27843,2,7843,[144 228 357 197 273],655,2,32444,4.1361550229474755,0.0,0.0
27844,2,7844,[318 496 588  98 357],796,5,32449,4.136265137029955,40.0,0.0
27845,2,7845,[318 496 588  98 357],796,5,32454,4.136375223043589,40.0,0.0
27846,2,7846,[ 50  56 357  97  15],72,4,32458,4.136357843761947,0.0,20.0
27847,2,7847,[318 496 588  98 357],796,5,32463,4.136467889908257,40.0,0.0
27848,2,7848,[318 496 588  98 357],18,5,32468,4.13657790801376,40.0,0.0
27849,2,7849,[318 496 588  98 357],330,5,32473,4.136687898089172,40.0,0.0
27850,2,7850,[282  82 183 403 597],450,4,32477,4.136670487835945,0.0,0.0
27851,2,7851,[318 496 588  98 357],330,5,32482,4.136780438104942,40.0,0.0
27852,2,7852,[318 496 588  98 357],330,5,32487,4.136890360371832,40.0,0.0
27853,2,7853,[318 496 588  98 357],450,5,32492,4.1370002546473135,40.0,0.0
27854,2,7854,[318 496 588  98 357],786,5,32497,4.137110120942075,40.0,0.0
27855,2,7855,[185 183 357 191  22],796,5,32502,4.137219959266803,0.0,0.0
27856,2,7856,[ 22  50   9 427 269],878,4,32506,4.13720249459081,20.0,20.0
27857,2,7857,[ 88   8 100 151 357],457,5,32511,4.137312293204378,0.0,20.0
27858,2,7858,[318 496 588  98 357],330,5,32516,4.137422063875811,40.0,0.0
27859,2,7859,[318 496 588  98 357],786,5,32521,4.137531806615776,40.0,0.0
27860,2,7860,[ 89 235 210 191 268],344,3,32524,4.137387100877751,0.0,0.0
27861,2,7861,[ 50  89  28  98 515],18,3,32527,4.137242431951157,0.0,20.0
27862,2,7862,[161 508  70  89 655],655,1,32528,4.136843443978125,0.0,0.0
27863,2,7863,[318 496 588  98 357],786,5,32533,4.136953204476094,40.0,0.0
27864,2,7864,[318 496 588  98 357],330,5,32538,4.137062937062937,40.0,0.0
27865,2,7865,[318 496 588  98 357],796,5,32543,4.1371726417493,40.0,0.0
27866,2,7866,[ 64  50 168 181 588],330,4,32547,4.137155205287912,20.0,20.0
27867,2,7867,[271 185 435 603 269],655,2,32549,4.136883579054397,20.0,0.0
27868,2,7868,[318 496 588  98 357],716,5,32554,4.13699326470962,40.0,0.0
27869,2,7869,[318 496 588  98 357],330,5,32559,4.13710292249047,40.0,0.0
27870,2,7870,[318 496 588  98 357],330,5,32564,4.137212552407572,40.0,0.0
27871,2,7871,[318 496 588  98 357],716,5,32569,4.137322154471545,40.0,0.0
27872,2,7872,[  7 275 121 180 234],450,3,32572,4.137177695922774,0.0,20.0
27873,2,7873,[318 496 588  98 357],18,5,32577,4.1372872745745495,40.0,0.0
27874,2,7874,[172 174 405 204 322],280,1,32578,4.136888888888889,0.0,0.0
27875,2,7875,[597 294  70 121 748],450,4,32582,4.136871508379889,0.0,0.0
27876,2,7876,[269  96 175 176 323],23,3,32585,4.136727180398629,0.0,0.0
27877,2,7877,[318 496 588  98 357],330,5,32590,4.136836760599137,40.0,0.0
27878,2,7878,[318 496 588  98 357],450,5,32595,4.1369463129838815,40.0,0.0
27879,2,7879,[318 496 588  98 357],716,5,32600,4.137055837563452,40.0,0.0
27880,2,7880,[100 121  11 181  12],457,5,32605,4.137165334348433,0.0,20.0
27881,2,7881,[194 195 168 196  22],269,2,32607,4.136894189292057,0.0,0.0
27882,2,7882,[216 144   9 318 191],693,3,32610,4.1367499682861855,20.0,0.0
27883,2,7883,[318 496 588  98 357],796,5,32615,4.136859462201928,40.0,0.0
27884,2,7884,[318 496 588  98 357],450,5,32620,4.136968928344959,40.0,0.0
27885,2,7885,[135 132 210 228 174],280,2,32622,4.136697945726604,0.0,0.0
27886,2,7886,[405 496 435 568 515],716,5,32627,4.136807404589831,20.0,0.0
27887,2,7887,[318 496 588  98 357],716,5,32632,4.136916835699797,40.0,0.0
27888,2,7888,[ 71  82  64 121  28],330,5,32637,4.137026239067056,20.0,0.0
27889,2,7889,[318 496 588  98 357],716,5,32642,4.137135614702155,40.0,0.0
27890,2,7890,[318 496 588  98 357],796,5,32647,4.137244962615638,40.0,0.0
27891,2,7891,[210 271 234   8 117],796,3,32650,4.137100861632033,0.0,0.0
27892,2,7892,[197 195  88   1  95],796,3,32653,4.136956797162043,0.0,0.0
27893,2,7893,[318 496 588  98 357],450,5,32658,4.137066126171776,40.0,0.0
27894,2,7894,[313 357 333 282 195],796,5,32663,4.137175427485751,0.0,0.0
27895,2,7895,[151 194 222 183 257],796,5,32668,4.137284701114488,0.0,0.0
27896,2,7896,[318 496 588  98 357],796,5,32673,4.137393947068507,40.0,0.0
27897,2,7897,[748 195  70 222  82],280,1,32674,4.136996708027349,0.0,0.0
27898,2,7898,[318 143 204 168 496],716,5,32679,4.137105962780098,40.0,0.0
27899,2,7899,[ 28 135 204 196 471],450,4,32683,4.1370886075949365,0.0,0.0
27900,2,7900,[125 301  89 151 197],450,5,32688,4.137197823060372,0.0,0.0
27901,2,7901,[197 111 215 121 238],151,4,32692,4.137180460642875,0.0,0.0
27902,2,7902,[ 64  69 269 194 288],450,4,32696,4.137163102619258,20.0,0.0
27903,2,7903,[655 100 265 202 210],577,4,32700,4.137145748987854,0.0,20.0
27904,2,7904,[318 496 588  98 357],330,5,32705,4.137254901960785,40.0,0.0
27905,2,7905,[318 496 588  98 357],18,5,32710,4.137364027321022,40.0,0.0
27906,2,7906,[318 496 588  98 357],786,5,32715,4.137473125079044,40.0,0.0
27907,2,7907,[318 496 588  98 357],18,5,32720,4.137582195245321,40.0,0.0
27908,2,7908,[318 496 588  98 357],786,5,32725,4.13769123783032,40.0,0.0
27909,2,7909,[318 496 588  98 357],450,5,32730,4.1378002528445,40.0,0.0
27910,2,7910,[161 132 194 168 179],457,5,32735,4.137909240298319,0.0,0.0
27911,2,7911,[161  96 121  15 678],256,5,32740,4.138018200202224,0.0,0.0
27912,2,7912,[100 742 151 323 117],256,5,32745,4.138127132566662,0.0,20.0
27913,2,7913,[173 174 405 143 245],885,4,32749,4.138109679049785,0.0,0.0
27914,2,7914,[318  79 228 215  96],457,5,32754,4.138218572331017,20.0,0.0
27915,2,7915,[318 496 588  98 357],716,5,32759,4.138327438100051,40.0,0.0
27916,2,7916,[318 496 588  98 357],716,5,32764,4.138436276367311,40.0,0.0
27917,2,7917,[318 496 588  98 357],786,5,32769,4.138545087143218,40.0,0.0
27918,2,7918,[ 64  56 161 197 313],450,5,32774,4.138653870438187,20.0,0.0
27919,2,7919,[318 496 588  98 357],18,5,32779,4.1387626262626265,40.0,0.0
27920,2,7920,[318 496 588  98 357],716,5,32784,4.138871354626941,40.0,0.0
27921,2,7921,[318 496 588  98 357],18,5,32789,4.13898005554153,40.0,0.0
27922,2,7922,[273 143 748 173 176],796,4,32793,4.138962514199167,0.0,0.0
27923,2,7923,[ 98 194 180 153 237],504,2,32795,4.1386925795053005,0.0,0.0
27924,2,7924,[318 496 588  98 357],18,5,32800,4.138801261829653,40.0,0.0
27925,2,7925,[  7 125 313 275 235],938,3,32803,4.138657582639414,0.0,20.0
27926,2,7926,[  4 211 385 471 405],716,2,32805,4.138387788570708,0.0,0.0
27927,2,7927,[318 496 588  98 357],786,5,32810,4.138496468213925,40.0,0.0
27928,2,7928,[ 64 276 117 182 271],629,5,32815,4.13860512044394,20.0,0.0
27929,2,7929,[301 546 121 323  88],796,3,32818,4.138461538461539,0.0,0.0
27930,2,7930,[318 496 588  98 357],786,5,32823,4.138570167696381,40.0,0.0
27931,2,7931,[ 96 742 125 515 172],655,2,32825,4.138300554715078,0.0,0.0
27932,2,7932,[117 496  97 268  69],344,1,32826,4.137904953989663,20.0,0.0
27933,2,7933,[318 496 588  98 357],18,5,32831,4.138013612301488,40.0,0.0
27934,2,7934,[  9 196 568 276 194],457,5,32836,4.138122243226213,0.0,0.0
27935,2,7935,[318 496 588  98 357],450,5,32841,4.138230846774194,40.0,0.0
27936,2,7936,[318 496 588  98 357],786,5,32846,4.138339422955776,40.0,0.0
27937,2,7937,[222 210 318 202 118],450,2,32848,4.138070042831948,20.0,0.0
27938,2,7938,[100   4   7 182 294],655,1,32849,4.137674770122182,0.0,20.0
27939,2,7939,[168 196 173 135 179],535,4,32853,4.137657430730479,0.0,0.0
27940,2,7940,[318 496 588  98 357],796,5,32858,4.137766024430173,40.0,0.0
27941,2,7941,[318 496 588  98 357],786,5,32863,4.137874590783178,40.0,0.0
27942,2,7942,[143  56 172 546 265],450,5,32868,4.1379831297998235,0.0,0.0
27943,2,7943,[318 496 588  98 357],18,5,32873,4.138091641490433,40.0,0.0
27944,2,7944,[117 286 153 135  69],401,0,32873,4.137570799244808,0.0,20.0
27945,2,7945,[318 496 588  98 357],716,5,32878,4.137679335514725,40.0,0.0
27946,2,7946,[318 496 588  98 357],330,5,32883,4.137787844469611,40.0,0.0
27947,2,7947,[151 161 546 496 471],716,2,32885,4.137518872672371,20.0,0.0
27948,2,7948,[  9  15 197  11 286],174,5,32890,4.137627374512517,0.0,20.0
27949,2,7949,[318 496 588  98 357],18,5,32895,4.137735849056604,40.0,0.0
27950,2,7950,[173 161 301 127 100],389,3,32898,4.137592755628223,0.0,40.0
27951,2,7951,[357 172 132 258 216],344,4,32902,4.137575452716298,0.0,0.0
27952,2,7952,[318 496 588  98 357],796,5,32907,4.137683892870615,40.0,0.0
27953,2,7953,[143 515 301  89 200],655,4,32911,4.137666582851396,0.0,0.0
27954,2,7954,[121  70 151 678  95],344,2,32913,4.137397862979259,0.0,0.0
27955,2,7955,[318 496 588  98 357],786,5,32918,4.1375062845651085,40.0,0.0
27956,2,7956,[318 496 588  98 357],786,5,32923,4.137614678899083,40.0,0.0
27957,2,7957,[  9 302  71 405 151],344,3,32926,4.137471726564463,0.0,0.0
27958,2,7958,[318 496 588  98 357],330,5,32931,4.137580098002261,40.0,0.0
27959,2,7959,[179 322  56 121 234],504,2,32933,4.137311557788944,0.0,0.0
27960,2,7960,[ 96 568 257 186  28],655,0,32933,4.136791860319056,0.0,0.0
27961,2,7961,[ 12 655   4 273  15],629,3,32936,4.136649083144938,0.0,0.0
27962,2,7962,[318 496 588  98 357],18,5,32941,4.136757503453472,40.0,0.0
27963,2,7963,[ 12 216 294 187 385],796,4,32945,4.136740331491713,0.0,0.0
27964,2,7964,[132 403  79 228 121],693,2,32947,4.136472065285624,0.0,0.0
27965,2,7965,[ 15 234 161 211  70],593,4,32951,4.136454933467236,0.0,0.0
27966,2,7966,[318 496 588  98 357],450,5,32956,4.136563323710305,40.0,0.0
27967,2,7967,[ 88 191 294 216 135],707,1,32957,4.136169678714859,0.0,0.0
27968,2,7968,[318 496 588  98 357],450,5,32962,4.136278077550508,40.0,0.0
27969,2,7969,[127 117  69  64 125],450,5,32967,4.1363864491844415,20.0,20.0
27970,2,7970,[ 88 508 333 275 276],655,2,32969,4.136118429306235,0.0,20.0
27971,2,7971,[318 496 588  98 357],796,5,32974,4.136226793778224,40.0,0.0
27972,2,7972,[318 496 588  98 357],330,5,32979,4.136335131067352,40.0,0.0
27973,2,7973,[ 15 275   4  98 301],389,4,32983,4.13631803360923,0.0,20.0
27974,2,7974,[318 496 588  98 357],796,5,32988,4.136426332288401,40.0,0.0
27975,2,7975,[318 496 588  98 357],450,5,32993,4.136534603811434,40.0,0.0
27976,2,7976,[318 496 588  98 357],796,5,32998,4.136642848188542,40.0,0.0
27977,2,7977,[597 151 265 215  50],450,5,33003,4.136751065429932,0.0,20.0
27978,2,7978,[318 496 588  98 357],330,5,33008,4.136859255545808,40.0,0.0
27979,2,7979,[318 496 588  98 357],786,5,33013,4.136967418546366,40.0,0.0
27980,2,7980,[318 496 588  98 357],18,5,33018,4.137075554441799,40.0,0.0
27981,2,7981,[318 496 588  98 357],330,5,33023,4.137183663242295,40.0,0.0
27982,2,7982,[318 496 588  98 357],716,5,33028,4.137291744958036,40.0,0.0
27983,2,7983,[385 301  15 132 125],450,4,33032,4.137274549098197,0.0,0.0
27984,2,7984,[210 143 216  70 496],330,5,33037,4.137382592360677,20.0,0.0
27985,2,7985,[276  11 403 143   4],457,5,33042,4.137490608564988,0.0,0.0
27986,2,7986,[318 496 588  98 357],330,5,33047,4.137598597721297,40.0,0.0
27987,2,7987,[318 496 588  98 357],796,5,33052,4.13770655983976,40.0,0.0
27988,2,7988,[742  79 265 403 597],457,4,33056,4.137689322818876,0.0,0.0
27989,2,7989,[318 496 588  98 357],18,5,33061,4.137797246558198,40.0,0.0
27990,2,7990,[185  98 742 238 245],796,2,33063,4.137529720936053,0.0,0.0
27991,2,7991,[204 234 185 288 161],457,5,33068,4.137637637637638,0.0,0.0
27992,2,7992,[318 496 588  98 357],786,5,33073,4.13774552733642,40.0,0.0
27993,2,7993,[173  25 111  88 427],450,4,33077,4.137728296222167,20.0,0.0
27994,2,7994,[313 568  15 276 161],593,4,33081,4.137711069418386,0.0,0.0
27995,2,7995,[ 69 568 185 132 135],269,3,33084,4.137568784392196,0.0,0.0
27996,2,7996,[186 546 427 300 568],716,3,33087,4.137426534950606,20.0,0.0
27997,2,7997,[318 496 588  98 357],796,5,33092,4.137534383595899,40.0,0.0
27998,2,7998,[597 174 228 328 127],450,5,33097,4.137642205275659,0.0,20.0
27999,2,7999,[ 70  97 257 174 234],504,3,33100,4.1375,0.0,0.0
28000,2,8000,[118  95 204 294 313],280,1,33101,4.13710786151731,0.0,0.0
28001,2,8001,[318 496 588  98 357],716,5,33106,4.137215696075981,40.0,0.0
28002,2,8002,[318 496 588  98 357],786,5,33111,4.137323503686118,40.0,0.0
28003,2,8003,[222 294  71  82 403],280,1,33112,4.136931534232883,0.0,0.0
28004,2,8004,[318 496 588  98 357],786,5,33117,4.137039350405996,40.0,0.0
28005,2,8005,[161 210 117 195 191],693,2,33119,4.136772420684487,0.0,0.0
28006,2,8006,[318 496 588  98 357],796,5,33124,4.136880229798926,40.0,0.0
28007,2,8007,[ 50 202 153 125 118],280,1,33125,4.136488511488512,0.0,20.0
28008,2,8008,[318 496 588  98 357],450,5,33130,4.136596329129729,40.0,0.0
28009,2,8009,[ 12 194  98 196 191],72,5,33135,4.1367041198501875,0.0,0.0
28010,2,8010,[127 471 143  25 121],457,5,33140,4.136811883659967,0.0,20.0
28011,2,8011,[318 496 588  98 357],796,5,33145,4.136919620569146,40.0,0.0
28012,2,8012,[237 144 191 211 181],296,5,33150,4.137027330587795,0.0,0.0
28013,2,8013,[318 496 588  98 357],330,5,33155,4.137135013725979,40.0,0.0
28014,2,8014,[318 496 588  98 357],716,5,33160,4.1372426699937614,40.0,0.0
28015,2,8015,[318 496 588  98 357],330,5,33165,4.137350299401198,40.0,0.0
28016,2,8016,[216 475 127 168   1],503,4,33169,4.137333167020082,0.0,20.0
28017,2,8017,[318 496 588  98 357],796,5,33174,4.137440758293839,40.0,0.0
28018,2,8018,[318 496 588  98 357],18,5,33179,4.137548322733508,40.0,0.0
28019,2,8019,[318 496 588  98 357],796,5,33184,4.137655860349128,40.0,0.0
28020,2,8020,[333 234  97 742 183],655,1,33185,4.137264680214437,0.0,0.0
28021,2,8021,[357 288 258 471 176],457,5,33190,4.137372226377462,0.0,0.0
28022,2,8022,[318 496 588  98 357],330,5,33195,4.1374797457310235,40.0,0.0
28023,2,8023,[143  79 333  70  96],655,2,33197,4.137213359920239,0.0,0.0
28024,2,8024,[294 161 588 153 546],23,2,33199,4.136947040498442,0.0,0.0
28025,2,8025,[117 182 144 204 111],450,5,33204,4.137054572638924,0.0,0.0
28026,2,8026,[318 496 588  98 357],450,5,33209,4.137162077986795,40.0,0.0
28027,2,8027,[475  88 423 187 175],655,1,33210,4.13677130044843,0.0,0.0
28028,2,8028,[127 144 195 483 294],280,2,33212,4.136505168763233,0.0,20.0
28029,2,8029,[216  28 588 195 496],450,5,33217,4.136612702366127,20.0,0.0
28030,2,8030,[318 496 588  98 357],716,5,33222,4.1367202091893915,40.0,0.0
28031,2,8031,[318 496 588  98 357],796,5,33227,4.136827689243028,40.0,0.0
28032,2,8032,[318 496 588  98 357],716,5,33232,4.136935142537035,40.0,0.0
28033,2,8033,[318 496 588  98 357],450,5,33237,4.137042569081404,40.0,0.0
28034,2,8034,[318 496 588  98 357],330,5,33242,4.137149968886123,40.0,0.0
28035,2,8035,[ 82  70 176   1 228],457,5,33247,4.137257341961175,0.0,0.0
28036,2,8036,[132  89 135 235 276],457,4,33251,4.137240263780018,0.0,0.0
28037,2,8037,[161  22 471 118 385],280,3,33254,4.137098780791241,0.0,0.0
28038,2,8038,[508 748 483 328 216],401,3,33257,4.136957333001617,0.0,0.0
28039,2,8039,[ 71 216 483 195 132],236,3,33260,4.13681592039801,0.0,0.0
28040,2,8040,[132 168 196 210  64],535,5,33265,4.136923268250218,20.0,0.0
28041,2,8041,[318 496 588  98 357],716,5,33270,4.1370305894056205,40.0,0.0
28042,2,8042,[117 143 211 357 385],401,3,33273,4.136889220440135,0.0,0.0
28043,2,8043,[318 496 588  98 357],796,5,33278,4.136996519144704,40.0,0.0
28044,2,8044,[318 496 588  98 357],796,5,33283,4.137103791174643,40.0,0.0
28045,2,8045,[ 28  98 483 204 187],796,4,33287,4.137086751180711,0.0,0.0
28046,2,8046,[168 403 742 423 568],457,5,33292,4.13719398533615,0.0,0.0
28047,2,8047,[238 515 273 216 175],655,3,33295,4.13705268389662,0.0,0.0
28048,2,8048,[318 496 588  98 357],786,5,33300,4.1371598956392095,40.0,0.0
28049,2,8049,[215 222 435 204 273],450,3,33303,4.1370186335403725,0.0,0.0
28050,2,8050,[ 88  28 125   4 191],577,4,33307,4.137001614706247,0.0,0.0
28051,2,8051,[318 496 588  98 357],786,5,33312,4.137108792846497,40.0,0.0
28052,2,8052,[302 100 265 282 588],450,5,33317,4.137215944368558,0.0,20.0
28053,2,8053,[  4 237 161  50   9],256,5,33322,4.137323069282345,0.0,20.0
28054,2,8054,[318 496 588  98 357],716,5,33327,4.137430167597765,40.0,0.0
28055,2,8055,[318 496 588  98 357],450,5,33332,4.137537239324727,40.0,0.0
28056,2,8056,[282 118 111 132 423],796,5,33337,4.137644284473129,0.0,0.0
28057,2,8057,[385 742 238 210   9],655,0,33337,4.137130801687764,0.0,0.0
28058,2,8058,[  7 168 143  11 258],457,5,33342,4.1372378707035615,0.0,0.0
28059,2,8059,[318 496 588  98 357],786,5,33347,4.137344913151365,40.0,0.0
28060,2,8060,[132  82 294 153 235],23,2,33349,4.1370797667783155,0.0,0.0
28061,2,8061,[294  82 588 742  56],450,4,33353,4.137062763582238,0.0,0.0
28062,2,8062,[318 496 588  98 357],796,5,33358,4.137169787920129,40.0,0.0
28063,2,8063,[318 496 588  98 357],18,5,33363,4.137276785714286,40.0,0.0
28064,2,8064,[318 496 588  98 357],796,5,33368,4.1373837569745815,40.0,0.0
28065,2,8065,[318 496 588  98 357],450,5,33373,4.1374907017108855,40.0,0.0
28066,2,8066,[ 88   7 748  70 423],151,4,33377,4.137473658113301,0.0,0.0
28067,2,8067,[183 300 515   4 234],655,2,33379,4.137208725830441,0.0,0.0
28068,2,8068,[183  69  15 328 210],450,3,33382,4.137067790308588,0.0,0.0
28069,2,8069,[435 153 204 286 118],562,3,33385,4.136926889714994,0.0,20.0
28070,2,8070,[318 496 588  98 357],18,5,33390,4.137033824804857,40.0,0.0
28071,2,8071,[318 496 588  98 357],18,5,33395,4.137140733399406,40.0,0.0
28072,2,8072,[237  97 276 655 125],593,3,33398,4.136999876130311,0.0,0.0
28073,2,8073,[  8  98 182 435 196],18,4,33402,4.136982908100074,0.0,0.0
28074,2,8074,[318 496 588  98 357],716,5,33407,4.137089783281734,40.0,0.0
28075,2,8075,[318 496 588  98 357],716,5,33412,4.137196631996038,40.0,0.0
28076,2,8076,[ 15 655 117  12 135],72,5,33417,4.137303454252817,0.0,0.0
28077,2,8077,[ 28 197  70  64 275],457,5,33422,4.1374102500618966,20.0,20.0
28078,2,8078,[318 496 588  98 357],450,5,33427,4.137517019433099,40.0,0.0
28079,2,8079,[318 496 588  98 357],796,5,33432,4.137623762376237,40.0,0.0
28080,2,8080,[318 496 588  98 357],796,5,33437,4.137730478901126,40.0,0.0
28081,2,8081,[ 70 182 222   9 603],655,2,33439,4.137465973768869,20.0,0.0
28082,2,8082,[318 496 588  98 357],18,5,33444,4.137572683409625,40.0,0.0
28083,2,8083,[228 234 603 187  50],72,3,33447,4.1374319643740725,20.0,20.0
28084,2,8084,[ 64 333 144 515 269],655,2,33449,4.137167594310451,20.0,0.0
28085,2,8085,[ 79   7 603 161 258],450,5,33454,4.1372743012614395,20.0,0.0
28086,2,8086,[ 88 151 161 197 257],457,4,33458,4.137257326573513,0.0,0.0
28087,2,8087,[318 496 588  98 357],450,5,33463,4.137363996043521,40.0,0.0
28088,2,8088,[258 100 153 121  11],655,0,33463,4.136852515762146,0.0,20.0
28089,2,8089,[318 496 588  98 357],796,5,33468,4.136959208899876,40.0,0.0
28090,2,8090,[318 496 588  98 357],786,5,33473,4.137065875664319,40.0,0.0
28091,2,8091,[318 496 588  98 357],330,5,33478,4.13717251606525,40.0,0.0
28092,2,8092,[318 496 588  98 357],796,5,33483,4.137279130112443,40.0,0.0
28093,2,8093,[180 121 238 300  28],11,1,33484,4.1368915245861135,0.0,0.0
28094,2,8094,[318 496 588  98 357],786,5,33489,4.136998147004324,40.0,0.0
28095,2,8095,[318 496 588  98 357],330,5,33494,4.137104743083004,40.0,0.0
28096,2,8096,[318 496 588  98 357],786,5,33499,4.137211312831913,40.0,0.0
28097,2,8097,[318 496 588  98 357],796,5,33504,4.137317856260805,40.0,0.0
28098,2,8098,[268  22 271 210  15],629,5,33509,4.13742437337943,0.0,0.0
28099,2,8099,[318 496 588  98 357],330,5,33514,4.137530864197531,40.0,0.0
28100,2,8100,[748 216 313  98 196],450,5,33519,4.137637328724849,0.0,0.0
28101,2,8101,[234 427 286 300 742],796,2,33521,4.137373488027648,20.0,20.0
28102,2,8102,[197 186 118 423 132],504,3,33524,4.137233123534493,0.0,0.0
28103,2,8103,[211 179 204 210 153],389,3,33527,4.1370927936821325,0.0,0.0
28104,2,8104,[318 496 588  98 357],796,5,33532,4.137199259716224,40.0,0.0
28105,2,8105,[318 496 588  98 357],786,5,33537,4.137305699481865,40.0,0.0
28106,2,8106,[191 603 118 357 655],151,3,33540,4.1371654126063895,20.0,0.0
28107,2,8107,[318 496 588  98 357],796,5,33545,4.137271830291071,40.0,0.0
28108,2,8108,[318 496 588  98 357],330,5,33550,4.137378221728943,40.0,0.0
28109,2,8109,[318 496 588  98 357],330,5,33555,4.137484586929716,40.0,0.0
28110,2,8110,[318 496 588  98 357],330,5,33560,4.137590925903095,40.0,0.0
28111,2,8111,[318 496 588  98 357],18,5,33565,4.137697238658777,40.0,0.0
28112,2,8112,[195 222  12 678  69],344,3,33568,4.137557007272279,0.0,0.0
28113,2,8113,[318 496 588  98 357],796,5,33573,4.137663298003451,40.0,0.0
28114,2,8114,[318 496 588  98 357],450,5,33578,4.137769562538509,40.0,0.0
28115,2,8115,[318 496 588  98 357],18,5,33583,4.137875800887136,40.0,0.0
28116,2,8116,[258 215 153 182 269],535,4,33587,4.137858814833066,0.0,0.0
28117,2,8117,[197 234 153 200  88],18,2,33589,4.137595466863759,0.0,0.0
28118,2,8118,[318 496 588  98 357],786,5,33594,4.137701687399926,40.0,0.0
28119,2,8119,[588   8   4 186 235],457,4,33598,4.1376847290640395,0.0,0.0
28120,2,8120,[318 496 588  98 357],450,5,33603,4.137790912449206,40.0,0.0
28121,2,8121,[234 265  89 202   8],796,4,33607,4.13777394730362,0.0,0.0
28122,2,8122,[318 496 588  98 357],330,5,33612,4.137880093561492,40.0,0.0
28123,2,8123,[318 496 588  98 357],786,5,33617,4.137986213687839,40.0,0.0
28124,2,8124,[546 234 127 187 471],256,4,33621,4.13796923076923,0.0,20.0
28125,2,8125,[423  82 403  28 546],450,4,33625,4.137952252030519,0.0,0.0
28126,2,8126,[202  15  95 151  89],796,5,33630,4.138058324104835,0.0,0.0
28127,2,8127,[318 496 588  98 357],18,5,33635,4.13816437007874,40.0,0.0
28128,2,8128,[318 496 588  98 357],18,5,33640,4.138270389961865,40.0,0.0
28129,2,8129,[318 496 588  98 357],18,5,33645,4.138376383763838,40.0,0.0
28130,2,8130,[318 496 588  98 357],786,5,33650,4.1384823514942815,40.0,0.0
28131,2,8131,[ 50 323 180 196 546],796,3,33653,4.138342351205115,0.0,20.0
28132,2,8132,[318 496 588  98 357],18,5,33658,4.1384482970613545,40.0,0.0
28133,2,8133,[318 496 588  98 357],450,5,33663,4.13855421686747,40.0,0.0
28134,2,8134,[323   8 191 202 385],23,2,33665,4.138291333743085,0.0,0.0
28135,2,8135,[318 496 588  98 357],796,5,33670,4.138397246804327,40.0,0.0
28136,2,8136,[318 496 588  98 357],18,5,33675,4.138503133833108,40.0,0.0
28137,2,8137,[318 496 588  98 357],786,5,33680,4.138608994839027,40.0,0.0
28138,2,8138,[318 496 588  98 357],18,5,33685,4.138714829831675,40.0,0.0
28139,2,8139,[318 496 588  98 357],330,5,33690,4.138820638820639,40.0,0.0
28140,2,8140,[204 222 118 100 200],457,5,33695,4.138926421815502,0.0,20.0
28141,2,8141,[  8 268  64  15 475],269,3,33698,4.138786538933923,20.0,0.0
28142,2,8142,[ 25 172 222 258 228],151,5,33703,4.138892300135085,0.0,0.0
28143,2,8143,[568 173 275  70 288],450,4,33707,4.138875245579568,0.0,20.0
28144,2,8144,[318 496 588  98 357],786,5,33712,4.138980969920197,40.0,0.0
28145,2,8145,[318 496 588  98 357],786,5,33717,4.139086668303462,40.0,0.0
28146,2,8146,[302 483 405 211 435],401,3,33720,4.138946851601816,0.0,0.0
28147,2,8147,[318 496 588  98 357],716,5,33725,4.139052528227786,40.0,0.0
28148,2,8148,[403 100   9  88 603],18,2,33727,4.1387900355871885,20.0,20.0
28149,2,8149,[135  28  98 588  88],450,4,33731,4.1387730061349695,0.0,0.0
28150,2,8150,[204  97   7 127 286],344,3,33734,4.138633296528034,0.0,40.0
28151,2,8151,[318 496 588  98 357],716,5,33739,4.138738959764475,40.0,0.0
28152,2,8152,[318 496 588  98 357],18,5,33744,4.138844597080829,40.0,0.0
28153,2,8153,[ 71 603 172   1 588],796,4,33748,4.138827569291146,20.0,0.0
28154,2,8154,[508  97 385  50 228],655,1,33749,4.1384426732066215,0.0,20.0
28155,2,8155,[ 79 118 294 286 301],655,1,33750,4.13805787150564,0.0,20.0
28156,2,8156,[143 385  64  82 127],450,4,33754,4.138040946426382,20.0,20.0
28157,2,8157,[318 496 588  98 357],18,5,33759,4.1381466045599415,40.0,0.0
28158,2,8158,[  1 228 168 603  98],716,5,33764,4.138252236793725,20.0,0.0
28159,2,8159,[318 496 588  98 357],18,5,33769,4.138357843137255,40.0,0.0
28160,2,8160,[318 496 588  98 357],786,5,33774,4.138463423600049,40.0,0.0
28161,2,8161,[ 56 161 294 179  97],457,4,33778,4.138446459201176,0.0,0.0
28162,2,8162,[318 496 588  98 357],450,5,33783,4.138552002940096,40.0,0.0
28163,2,8163,[183 257 176 275  82],23,1,33784,4.138167564919157,0.0,20.0
28164,2,8164,[318 496 588  98 357],716,5,33789,4.138273116962646,40.0,0.0
28165,2,8165,[216  28 237  98 176],655,2,33791,4.138011266225814,0.0,0.0
28166,2,8166,[546 237 144 185  88],716,3,33794,4.137871923594956,0.0,0.0
28167,2,8167,[318 496 588  98 357],796,5,33799,4.137977473065622,40.0,0.0
28168,2,8168,[318 496 588  98 357],786,5,33804,4.138082996694822,40.0,0.0
28169,2,8169,[318 496 588  98 357],796,5,33809,4.138188494492044,40.0,0.0
28170,2,8170,[257 121   1 153 182],655,1,33810,4.137804430302289,0.0,0.0
28171,2,8171,[483  28 655  70 204],450,4,33814,4.137787567302986,0.0,0.0
28172,2,8172,[202 423 238  95  89],450,4,33818,4.137770708430197,0.0,0.0
28173,2,8173,[318 496 588  98 357],796,5,33823,4.137876192806459,40.0,0.0
28174,2,8174,[318 496 588  98 357],450,5,33828,4.137981651376147,40.0,0.0
28175,2,8175,[117 276 172 288 197],655,2,33830,4.137720156555773,0.0,0.0
28176,2,8176,[318 496 588  98 357],18,5,33835,4.137825608413844,40.0,0.0
28177,2,8177,[ 12 237 211 185   9],18,3,33838,4.13768647591098,0.0,0.0
28178,2,8178,[ 56 268 471 597   9],174,4,33842,4.137669641765497,0.0,0.0
28179,2,8179,[318 496 588  98 357],786,5,33847,4.137775061124694,40.0,0.0
28180,2,8180,[318 496 588  98 357],796,5,33852,4.137880454712138,40.0,0.0
28181,2,8181,[318 496 588  98 357],716,5,33857,4.137985822537277,40.0,0.0
28182,2,8182,[318 496 588  98 357],18,5,33862,4.138091164609556,40.0,0.0
28183,2,8183,[237 181  64 318  70],269,2,33864,4.13782991202346,40.0,0.0
28184,2,8184,[546 175  98 588 294],716,3,33867,4.137690897984117,0.0,0.0
28185,2,8185,[ 71 294 174 153 271],796,4,33871,4.137674077693624,0.0,0.0
28186,2,8186,[  4 211 202 194 151],796,4,33875,4.137657261512153,0.0,0.0
28187,2,8187,[282  82 144 333  96],796,4,33879,4.137640449438202,0.0,0.0
28188,2,8188,[318 496 588  98 357],786,5,33884,4.137745756502626,40.0,0.0
28189,2,8189,[318 496 588  98 357],18,5,33889,4.137851037851038,40.0,0.0
28190,2,8190,[483 173  50 168 275],151,5,33894,4.137956293492858,0.0,40.0
28191,2,8191,[ 96 235 496  15 135],269,2,33896,4.1376953125,20.0,0.0
28192,2,8192,[318 496 588  98 357],716,5,33901,4.137800561454901,40.0,0.0
28193,2,8193,[ 98 568 194 118  71],796,5,33906,4.137905784720528,0.0,0.0
28194,2,8194,[318 496 588  98 357],450,5,33911,4.138010982306285,40.0,0.0
28195,2,8195,[318 496 588  98 357],786,5,33916,4.138116154221572,40.0,0.0
28196,2,8196,[318 496 588  98 357],796,5,33921,4.1382213004757835,40.0,0.0
28197,2,8197,[318 496 588  98 357],786,5,33926,4.138326421078312,40.0,0.0
28198,2,8198,[318 496 588  98 357],786,5,33931,4.138431516038541,40.0,0.0
28199,2,8199,[179 172 483 286  56],236,3,33934,4.13829268292683,0.0,20.0
28200,2,8200,[318 496 588  98 357],18,5,33939,4.138397756371174,40.0,0.0
28201,2,8201,[318 496 588  98 357],716,5,33944,4.138502804194099,40.0,0.0
28202,2,8202,[318 496 588  98 357],796,5,33949,4.138607826404974,40.0,0.0
28203,2,8203,[471 275 118  15  88],655,1,33950,4.138225255972697,0.0,20.0
28204,2,8204,[ 69 121  82 143 237],450,3,33953,4.138086532602072,0.0,0.0
28205,2,8205,[228 423  11 294  71],577,3,33956,4.137947843041677,0.0,0.0
28206,2,8206,[135   9 174 173 168],151,5,33961,4.138052881686365,0.0,0.0
28207,2,8207,[273  11  98 186 195],450,3,33964,4.1379142300194935,0.0,0.0
28208,2,8208,[318 496 588  98 357],796,5,33969,4.138019247167743,40.0,0.0
28209,2,8209,[175 603 200 318 427],269,5,33974,4.138124238733252,60.0,0.0
28210,2,8210,[318 496 588  98 357],796,5,33979,4.138229204725368,40.0,0.0
28211,2,8211,[318 496 588  98 357],18,5,33984,4.138334145153434,40.0,0.0
28212,2,8212,[ 71 300 271 168   9],796,4,33988,4.138317301838549,0.0,0.0
28213,2,8213,[655 435 282  97   7],655,0,33988,4.137813489164841,0.0,0.0
28214,2,8214,[318 496 588  98 357],450,5,33993,4.1379184418746195,40.0,0.0
28215,2,8215,[111 174 222  11 655],716,5,33998,4.138023369036027,0.0,0.0
28216,2,8216,[318 496 588  98 357],450,5,34003,4.138128270658391,40.0,0.0
28217,2,8217,[318 496 588  98 357],330,5,34008,4.138233146751034,40.0,0.0
28218,2,8218,[288   8 181   1 282],593,3,34011,4.1380946587176055,0.0,0.0
28219,2,8219,[196 172 202 603  11],450,5,34016,4.138199513381995,20.0,0.0
28220,2,8220,[125 215 237 269 111],18,1,34017,4.137817783724608,0.0,0.0
28221,2,8221,[496 245 471 302 187],450,5,34022,4.137922646558015,20.0,0.0
28222,2,8222,[ 82 176 257  71 423],504,4,34026,4.137905873768697,0.0,0.0
28223,2,8223,[318 496 588  98 357],796,5,34031,4.138010700389105,40.0,0.0
28224,2,8224,[318 496 588  98 357],786,5,34036,4.138115501519757,40.0,0.0
28225,2,8225,[186 117  79 237 181],655,1,34037,4.137734014101629,0.0,0.0
28226,2,8226,[318 496 588  98 357],18,5,34042,4.137838823386411,40.0,0.0
28227,2,8227,[  1  64  11 185 132],716,5,34047,4.137943607194944,20.0,0.0
28228,2,8228,[318 496 588  98 357],18,5,34052,4.138048365536517,40.0,0.0
28229,2,8229,[318 496 588  98 357],716,5,34057,4.138153098420413,40.0,0.0
28230,2,8230,[318 496 588  98 357],716,5,34062,4.13825780585591,40.0,0.0
28231,2,8231,[318 496 588  98 357],786,5,34067,4.138362487852284,40.0,0.0
28232,2,8232,[161 195   1 235 187],256,3,34070,4.138224219604033,0.0,0.0
28233,2,8233,[191  96 435 176 228],450,5,34075,4.138328880252611,0.0,0.0
28234,2,8234,[271  64 182 194 403],796,5,34080,4.138433515482696,20.0,0.0
28235,2,8235,[318 496 588  98 357],330,5,34085,4.138538125303546,40.0,0.0
28236,2,8236,[210 423 269 301 195],629,3,34088,4.138399902877262,0.0,0.0
28237,2,8237,[172 546 222   1  96],716,3,34091,4.138261714008254,0.0,0.0
28238,2,8238,[318 496 588  98 357],716,5,34096,4.138366306590606,40.0,0.0
28239,2,8239,[286 168 176  28  25],450,4,34100,4.138349514563107,0.0,20.0
28240,2,8240,[318 496 588  98 357],786,5,34105,4.138454071107875,40.0,0.0
28241,2,8241,[318 496 588  98 357],330,5,34110,4.138558602281,40.0,0.0
28242,2,8242,[182 180 655 313 176],280,1,34111,4.138177847870921,0.0,0.0
28243,2,8243,[318 496 588  98 357],716,5,34116,4.138282387190684,40.0,0.0
28244,2,8244,[318 496 588  98 357],18,5,34121,4.138386901152214,40.0,0.0
28245,2,8245,[318 496 588  98 357],18,5,34126,4.138491389764734,40.0,0.0
28246,2,8246,[269 168 172 181 132],796,4,34130,4.138474596823087,0.0,0.0
28247,2,8247,[742 568 546 200 286],593,4,34134,4.1384578079534435,0.0,20.0
28248,2,8248,[182 603 302 211 301],535,3,34137,4.13831979633895,20.0,0.0
28249,2,8249,[318 496 588  98 357],330,5,34142,4.138424242424242,40.0,0.0
28250,2,8250,[269 180  50 235   7],450,4,34146,4.138407465761726,0.0,20.0
28251,2,8251,[483 211 200 172 289],655,3,34149,4.138269510421716,0.0,0.0
28252,2,8252,[318 496 588  98 357],330,5,34154,4.138373924633466,40.0,0.0
28253,2,8253,[185 435 588 173 118],389,3,34157,4.138236006784589,0.0,0.0
28254,2,8254,[144 204 313  28  69],450,5,34162,4.138340399757722,0.0,0.0
28255,2,8255,[276   8 100 161  28],655,1,34163,4.137960271317829,0.0,20.0
28256,2,8256,[185 269 196  97 211],535,5,34168,4.138064672399176,0.0,0.0
28257,2,8257,[318 496 588  98 357],18,5,34173,4.138169048195689,40.0,0.0
28258,2,8258,[318 496 588  98 357],796,5,34178,4.138273398716551,40.0,0.0
28259,2,8259,[168 194 322 385   4],504,4,34182,4.138256658595641,0.0,0.0
28260,2,8260,[318 496 588  98 357],796,5,34187,4.13836097324779,40.0,0.0
28261,2,8261,[318 496 588  98 357],716,5,34192,4.138465262648269,40.0,0.0
28262,2,8262,[ 71 111  50 318 258],878,4,34196,4.138448505385453,20.0,20.0
28263,2,8263,[153 183 204 234 286],450,4,34200,4.138431752178122,0.0,20.0
28264,2,8264,[268 191 222  97  25],655,1,34201,4.138052026618269,0.0,0.0
28265,2,8265,[318 496 588  98 357],330,5,34206,4.138156302927656,40.0,0.0
28266,2,8266,[161   9 210   1 588],786,5,34211,4.138260554009919,0.0,0.0
28267,2,8267,[191 237 125 423 153],18,3,34214,4.138122883405902,0.0,0.0
28268,2,8268,[318 496 588  98 357],330,5,34219,4.13822711331479,40.0,0.0
28269,2,8269,[222 125  69 228 172],151,5,34224,4.138331318016928,0.0,0.0
28270,2,8270,[168 234 655 216 196],577,4,34228,4.138314593156813,0.0,0.0
28271,2,8271,[222 333 427  70  12],655,1,34229,4.137935203094777,20.0,0.0
28272,2,8272,[318 496 588  98 357],796,5,34234,4.138039405294331,40.0,0.0
28273,2,8273,[546 568  25  12 202],577,3,34237,4.137901861252115,0.0,0.0
28274,2,8274,[173 245 742 185 655],450,5,34242,4.138006042296072,0.0,0.0
28275,2,8275,[318 496 588  98 357],450,5,34247,4.138110198163364,40.0,0.0
28276,2,8276,[318 496 588  98 357],450,5,34252,4.138214328863115,40.0,0.0
28277,2,8277,[318 496 588  98 357],18,5,34257,4.138318434404446,40.0,0.0
28278,2,8278,[318 496 588  98 357],450,5,34262,4.138422514796473,40.0,0.0
28279,2,8279,[180  95 313 427 568],450,4,34266,4.138405797101449,20.0,0.0
28280,2,8280,[328 568 100 132 273],655,1,34267,4.138026808356479,0.0,20.0
28281,2,8281,[318 496 588  98 357],18,5,34272,4.138130886259358,40.0,0.0
28282,2,8282,[318 496 588  98 357],716,5,34277,4.138234939031752,40.0,0.0
28283,2,8283,[318 496 588  98 357],796,5,34282,4.138338966682762,40.0,0.0
28284,2,8284,[210 515   7 121 318],72,3,34285,4.138201569100785,20.0,0.0
28285,2,8285,[273 143 423 195 127],655,3,34288,4.138064204682597,0.0,20.0
28286,2,8286,[301 181 121  25   4],151,5,34293,4.13816821527694,0.0,0.0
28287,2,8287,[ 22  96 333 318 204],655,1,34294,4.137789575289576,20.0,0.0
28288,2,8288,[318 496 588  98 357],796,5,34299,4.137893593919652,40.0,0.0
28289,2,8289,[173   1 185 357 144],562,3,34302,4.137756332931242,0.0,0.0
28290,2,8290,[603 135 204  88 111],401,4,34306,4.1377397177662525,20.0,0.0
28291,2,8291,[265 174 742   1 125],577,5,34311,4.137843704775688,0.0,0.0
28292,2,8292,[ 98 161 174 496 301],796,4,34315,4.137827083082118,20.0,0.0
28293,2,8293,[269 174 423 515 179],655,2,34317,4.1375693272245,0.0,0.0
28294,2,8294,[318 496 588  98 357],716,5,34322,4.137673297166968,40.0,0.0
28295,2,8295,[318 496 588  98 357],450,5,34327,4.137777242044359,40.0,0.0
28296,2,8296,[318 496 588  98 357],330,5,34332,4.137881161865734,40.0,0.0
28297,2,8297,[475  96 228 187   1],296,5,34337,4.137985056640154,0.0,0.0
28298,2,8298,[318 496 588  98 357],450,5,34342,4.138088926376672,40.0,0.0
28299,2,8299,[269 185 100 181 742],796,2,34344,4.137831325301205,0.0,20.0
28300,2,8300,[ 97 288 301 568  96],344,4,34348,4.1378147211179375,0.0,0.0
28301,2,8301,[318 496 588  98 357],716,5,34353,4.13791857383763,40.0,0.0
28302,2,8302,[318 496 588  98 357],796,5,34358,4.138022401541612,40.0,0.0
28303,2,8303,[318 496 588  98 357],716,5,34363,4.138126204238921,40.0,0.0
28304,2,8304,[318 496 588  98 357],330,5,34368,4.138229981938591,40.0,0.0
28305,2,8305,[153 302 121 185 172],401,1,34369,4.137852155068625,0.0,0.0
28306,2,8306,[318 496 588  98 357],786,5,34374,4.137955940772843,40.0,0.0
28307,2,8307,[318 496 588  98 357],786,5,34379,4.138059701492537,40.0,0.0
28308,2,8308,[ 98 237 302 496 161],269,2,34381,4.137802382958238,20.0,0.0
28309,2,8309,[318 496 588  98 357],716,5,34386,4.137906137184116,40.0,0.0
28310,2,8310,[117 174  15 300 301],629,4,34390,4.1378895439778605,0.0,0.0
28311,2,8311,[185 318 496 222 357],716,5,34395,4.137993262752647,40.0,0.0
28312,2,8312,[403 215 144 294 204],280,0,34395,4.137495488993143,0.0,0.0
28313,2,8313,[318 496 588  98 357],330,5,34400,4.1375992302140965,40.0,0.0
28314,2,8314,[318 496 588  98 357],786,5,34405,4.137702946482261,40.0,0.0
28315,2,8315,[318 496 588  98 357],796,5,34410,4.137806637806638,40.0,0.0
28316,2,8316,[318 496 588  98 357],786,5,34415,4.137910304196224,40.0,0.0
28317,2,8317,[238 405 588 546  82],450,4,34419,4.137893724452994,0.0,0.0
28318,2,8318,[ 56 427 215 313  98],796,5,34424,4.137997355451376,20.0,0.0
28319,2,8319,[318 496 588  98 357],330,5,34429,4.138100961538462,40.0,0.0
28320,2,8320,[318 496 588  98 357],450,5,34434,4.138204542723231,40.0,0.0
28321,2,8321,[318 496 588  98 357],330,5,34439,4.13830809901466,40.0,0.0
28322,2,8322,[121 181  82  70 143],269,0,34439,4.137810885498017,0.0,0.0
28323,2,8323,[318 496 588  98 357],786,5,34444,4.137914464199904,40.0,0.0
28324,2,8324,[318 496 588  98 357],796,5,34449,4.138018018018018,40.0,0.0
28325,2,8325,[294 144 111 257  89],655,1,34450,4.137641124189287,0.0,0.0
28326,2,8326,[179  69 211 111 222],236,3,34453,4.137504503422601,0.0,0.0
28327,2,8327,[271 268 471 423 265],655,0,34453,4.1370076849183475,0.0,0.0
28328,2,8328,[318 496 588  98 357],786,5,34458,4.1371112978748945,40.0,0.0
28329,2,8329,[318 496 588  98 357],330,5,34463,4.137214885954382,40.0,0.0
28330,2,8330,[318 496 588  98 357],450,5,34468,4.137318449165766,40.0,0.0
28331,2,8331,[143   8 546 210 195],796,4,34472,4.13730196831493,0.0,0.0
28332,2,8332,[318 496 588  98 357],786,5,34477,4.1374054962198485,40.0,0.0
28333,2,8333,[318 496 588  98 357],796,5,34482,4.137508999280057,40.0,0.0
28334,2,8334,[151 127  97  70 403],504,3,34485,4.137372525494901,0.0,20.0
28335,2,8335,[172  22 118  50 471],280,1,34486,4.1369961612284065,0.0,20.0
28336,2,8336,[318 496 588  98 357],330,5,34491,4.137099676142498,40.0,0.0
28337,2,8337,[318 496 588  98 357],330,5,34496,4.137203166226913,40.0,0.0
28338,2,8338,[121 471 238 200  79],450,3,34499,4.1370667945796855,0.0,0.0
28339,2,8339,[238 127 194   1  64],457,5,34504,4.137170263788969,20.0,20.0
28340,2,8340,[318 496 588  98 357],716,5,34509,4.1372737081884665,40.0,0.0
28341,2,8341,[ 64 222 204 237 568],716,5,34514,4.137377127787102,20.0,0.0
28342,2,8342,[357 328 435 153 322],629,3,34517,4.137240800671221,0.0,0.0
28343,2,8343,[318 496 588  98 357],18,5,34522,4.137344199424736,40.0,0.0
28344,2,8344,[ 82 496 322 183 258],151,2,34524,4.13708807669263,20.0,0.0
28345,2,8345,[210  28  97 435 748],450,4,34528,4.137071651090342,0.0,0.0
28346,2,8346,[ 50 215 204 195 294],457,4,34532,4.137055229423745,0.0,20.0
28347,2,8347,[238 151 471 427 125],450,5,34537,4.137158600862482,20.0,0.0
28348,2,8348,[328 144 258 405 200],450,4,34541,4.137142172715295,0.0,0.0
28349,2,8349,[173 742 195 257  98],457,4,34545,4.137125748502994,0.0,0.0
28350,2,8350,[318 496 588  98 357],786,5,34550,4.137229074362351,40.0,0.0
28351,2,8351,[318 496 588  98 357],716,5,34555,4.137332375478927,40.0,0.0
28352,2,8352,[318 496 588  98 357],786,5,34560,4.1374356518616064,40.0,0.0
28353,2,8353,[318 496 588  98 357],18,5,34565,4.137538903519272,40.0,0.0
28354,2,8354,[318 496 588  98 357],18,5,34570,4.137642130460802,40.0,0.0
28355,2,8355,[318 496 588  98 357],716,5,34575,4.1377453326950695,40.0,0.0
28356,2,8356,[603 403  25  50 151],330,5,34580,4.137848510230944,20.0,20.0
28357,2,8357,[ 69 742  12  15 143],577,3,34583,4.137712371380713,0.0,0.0
28358,2,8358,[318 496 588  98 357],716,5,34588,4.137815528173227,40.0,0.0
28359,2,8359,[318 496 588  98 357],716,5,34593,4.137918660287081,40.0,0.0
28360,2,8360,[294 172  98 168 302],450,5,34598,4.138021767731133,0.0,0.0
28361,2,8361,[144 181 204 655 294],450,5,34603,4.138124850514231,0.0,0.0
28362,2,8362,[318 496 588  98 357],18,5,34608,4.138227908645223,40.0,0.0
28363,2,8363,[  7 180 176 181 143],457,5,34613,4.138330942132951,0.0,0.0
28364,2,8364,[180 127 300 483 257],796,4,34617,4.138314405260012,0.0,20.0
28365,2,8365,[318 496 588  98 357],450,5,34622,4.1384174037771935,40.0,0.0
28366,2,8366,[655  15 210 357  98],450,3,34625,4.138281343372774,0.0,0.0
28367,2,8367,[318 496 588  98 357],450,5,34630,4.138384321223709,40.0,0.0
28368,2,8368,[ 56 200  69  82  95],577,3,34633,4.138248297287609,0.0,0.0
28369,2,8369,[187 176 427 153 286],450,5,34638,4.138351254480287,20.0,20.0
28370,2,8370,[357   1 313 211 144],450,5,34643,4.138454187074424,0.0,0.0
28371,2,8371,[182 185 187  12  56],256,3,34646,4.1383182035355945,0.0,0.0
28372,2,8372,[196 204 118  69  70],457,5,34651,4.138421115490266,0.0,0.0
28373,2,8373,[588 276 496 182   1],280,4,34655,4.138404585622164,20.0,0.0
28374,2,8374,[655 180 216 144 176],716,2,34657,4.138149253731343,0.0,0.0
28375,2,8375,[318 496 588  98 357],716,5,34662,4.138252148997134,40.0,0.0
28376,2,8376,[423   7 187 475 568],655,1,34663,4.137877521785843,0.0,0.0
28377,2,8377,[318 496 588  98 357],18,5,34668,4.137980424922416,40.0,0.0
28378,2,8378,[405   7  64  25  98],344,4,34672,4.13796395751283,20.0,0.0
28379,2,8379,[172   8 215  69 237],280,2,34674,4.137708830548926,0.0,0.0
28380,2,8380,[ 96 323 204 471   4],280,1,34675,4.1373344469633695,0.0,0.0
28381,2,8381,[196 286 427 135 180],535,3,34678,4.1371987592460036,20.0,20.0
28382,2,8382,[191 289 100  50 357],655,3,34681,4.1370631039007515,0.0,40.0
28383,2,8383,[318 496 588  98 357],796,5,34686,4.137166030534351,40.0,0.0
28384,2,8384,[318 496 588  98 357],786,5,34691,4.137268932617769,40.0,0.0
28385,2,8385,[318 496 588  98 357],786,5,34696,4.13737181015979,40.0,0.0
28386,2,8386,[318 496 588  98 357],18,5,34701,4.137474663169191,40.0,0.0
28387,2,8387,[318 496 588  98 357],716,5,34706,4.137577491654745,40.0,0.0
28388,2,8388,[322 597 333 237 568],796,4,34710,4.1375610919060675,0.0,0.0
28389,2,8389,[318 496 588  98 357],786,5,34715,4.137663885578069,40.0,0.0
28390,2,8390,[318 496 588  98 357],716,5,34720,4.137766654749136,40.0,0.0
28391,2,8391,[318 496 588  98 357],786,5,34725,4.137869399428027,40.0,0.0
28392,2,8392,[318 496 588  98 357],716,5,34730,4.1379721196234955,40.0,0.0
28393,2,8393,[127  79 427 215 423],655,3,34733,4.137836549916607,20.0,20.0
28394,2,8394,[318 496 588  98 357],716,5,34738,4.137939249553305,40.0,0.0
28395,2,8395,[100 151 435  82  98],878,2,34740,4.137684611719867,0.0,20.0
28396,2,8396,[276 678 161 183 655],280,2,34742,4.137430034536144,0.0,0.0
28397,2,8397,[318 496 588  98 357],450,5,34747,4.137532745891879,40.0,0.0
28398,2,8398,[318 496 588  98 357],796,5,34752,4.137635432789618,40.0,0.0
28399,2,8399,[ 64  70  97 175 185],655,2,34754,4.137380952380952,20.0,0.0
28400,2,8400,[ 97  28 265 185  64],655,2,34756,4.137126532555648,20.0,0.0
28401,2,8401,[ 97  96 111 194 294],796,3,34759,4.136991192573197,0.0,0.0
28402,2,8402,[496   1 234 181 186],450,3,34762,4.136855884803047,20.0,0.0
28403,2,8403,[318 496 588  98 357],796,5,34767,4.1369585911470725,40.0,0.0
28404,2,8404,[318 496 588  98 357],18,5,34772,4.137061273051755,40.0,0.0
28405,2,8405,[ 56 144  96 302 172],655,2,34774,4.136807042588627,0.0,0.0
28406,2,8406,[121 118 748  56   7],151,3,34777,4.136671821101463,0.0,0.0
28407,2,8407,[318 496 588  98 357],450,5,34782,4.136774500475737,40.0,0.0
28408,2,8408,[483 282 202 196 197],655,1,34783,4.136401474610536,0.0,0.0
28409,2,8409,[ 96 222  15   1  69],796,4,34787,4.136385255648038,0.0,0.0
28410,2,8410,[ 64 257 181 111 222],796,5,34792,4.136487932469385,20.0,0.0
28411,2,8411,[125 294  79 179 258],450,5,34797,4.1365905848787445,0.0,0.0
28412,2,8412,[318 496 588  98 357],18,5,34802,4.136693212884821,40.0,0.0
28413,2,8413,[ 64  97 568 742 127],256,5,34807,4.136795816496315,20.0,20.0
28414,2,8414,[655   9 127 118 204],280,2,34809,4.136541889483066,0.0,20.0
28415,2,8415,[173 196 515 268 210],269,2,34811,4.136288022813688,0.0,0.0
28416,2,8416,[318 496 588  98 357],330,5,34816,4.136390637994535,40.0,0.0
28417,2,8417,[ 28 191  82 185  70],151,3,34819,4.136255642670468,0.0,0.0
28418,2,8418,[318 496 588  98 357],18,5,34824,4.136358237320347,40.0,0.0
28419,2,8419,[238 127 435 179  89],655,3,34827,4.136223277909739,0.0,20.0
28420,2,8420,[318 496 588  98 357],716,5,34832,4.136325852036575,40.0,0.0
28421,2,8421,[211 100 210 588 286],786,5,34837,4.136428401804797,0.0,40.0
28422,2,8422,[143 186  79 118 194],796,4,34841,4.136412204677669,0.0,0.0
28423,2,8423,[318 496 588  98 357],18,5,34846,4.136514719848053,40.0,0.0
28424,2,8424,[143 597 210 180 185],796,3,34849,4.136379821958457,0.0,0.0
28425,2,8425,[318 496 588  98 357],716,5,34854,4.136482316638975,40.0,0.0
28426,2,8426,[318 496 588  98 357],450,5,34859,4.136584786994185,40.0,0.0
28427,2,8427,[ 69 153 275 125 191],796,5,34864,4.136687233032748,0.0,20.0
28428,2,8428,[405 286  15 237 121],796,4,34868,4.136671016727963,0.0,20.0
28429,2,8429,[318 496 588  98 357],330,5,34873,4.136773428232503,40.0,0.0
28430,2,8430,[  7   4 655 180 748],450,4,34877,4.136757205550943,0.0,0.0
28431,2,8431,[318 496 588  98 357],450,5,34882,4.136859582542694,40.0,0.0
28432,2,8432,[143 322 153 186   4],796,3,34885,4.136724771730108,0.0,0.0
28433,2,8433,[318 496 588  98 357],786,5,34890,4.136827128290253,40.0,0.0
28434,2,8434,[405 185 121 168  82],269,2,34892,4.1365737996443395,0.0,0.0
28435,2,8435,[318 496 588  98 357],18,5,34897,4.136676149834044,40.0,0.0
28436,2,8436,[238  95 568 403 174],330,5,34902,4.136778475761527,0.0,0.0
28437,2,8437,[258   1 302 176 200],151,2,34904,4.136525242948566,0.0,0.0
28438,2,8438,[318 496 588  98 357],796,5,34909,4.136627562507406,40.0,0.0
28439,2,8439,[318 496 588  98 357],18,5,34914,4.136729857819906,40.0,0.0
28440,2,8440,[318 496 588  98 357],786,5,34919,4.136832128894681,40.0,0.0
28441,2,8441,[318 496 588  98 357],330,5,34924,4.136934375740346,40.0,0.0
28442,2,8442,[318 496 588  98 357],796,5,34929,4.13703659836551,40.0,0.0
28443,2,8443,[603 276 144  97 191],401,5,34934,4.137138796778778,20.0,0.0
28444,2,8444,[318 496 588  98 357],18,5,34939,4.137240970988751,40.0,0.0
28445,2,8445,[318 496 588  98 357],330,5,34944,4.137343121004026,40.0,0.0
28446,2,8446,[318 496 588  98 357],716,5,34949,4.137445246833195,40.0,0.0
28447,2,8447,[ 70 427 210 135 202],450,3,34952,4.137310606060606,20.0,0.0
28448,2,8448,[318 496 588  98 357],330,5,34957,4.137412711563498,40.0,0.0
28449,2,8449,[318 496 588  98 357],716,5,34962,4.137514792899409,40.0,0.0
28450,2,8450,[257   4 655 121  22],457,4,34966,4.137498520885102,0.0,0.0
28451,2,8451,[ 12 301 288 245 185],450,4,34970,4.13748225272125,0.0,0.0
28452,2,8452,[265 211 748   9 357],796,3,34973,4.137347687211641,0.0,0.0
28453,2,8453,[318 496 588  98 357],330,5,34978,4.137449727939437,40.0,0.0
28454,2,8454,[237 318 301 183   9],796,3,34981,4.137315198107629,20.0,0.0
28455,2,8455,[ 82  12 196 200 294],457,4,34985,4.1372989593188265,0.0,0.0
28456,2,8456,[318 496 588  98 357],330,5,34990,4.137400969610973,40.0,0.0
28457,2,8457,[508 300 153  50 385],655,1,34991,4.137030030740128,0.0,20.0
28458,2,8458,[318 496 588  98 357],330,5,34996,4.137132048705521,40.0,0.0
28459,2,8459,[546 153 176  28 228],796,4,35000,4.137115839243499,0.0,0.0
28460,2,8460,[ 98 210 258  82 168],457,5,35005,4.13721782295237,0.0,0.0
28461,2,8461,[318 496 588  98 357],18,5,35010,4.137319782557315,40.0,0.0
28462,2,8462,[318 496 588  98 357],786,5,35015,4.1374217180668795,40.0,0.0
28463,2,8463,[282 186 100  12 183],450,4,35019,4.137405482041588,0.0,20.0
28464,2,8464,[ 12 234 405 185 237],796,4,35023,4.137389249852333,0.0,0.0
28465,2,8465,[318 496 588  98 357],450,5,35028,4.137491141034727,40.0,0.0
28466,2,8466,[318 496 588  98 357],330,5,35033,4.1375930081492855,40.0,0.0
28467,2,8467,[318 496 588  98 357],450,5,35038,4.137694851204535,40.0,0.0
28468,2,8468,[318 496 588  98 357],796,5,35043,4.137796670208997,40.0,0.0
28469,2,8469,[318 496 588  98 357],796,5,35048,4.137898465171192,40.0,0.0
28470,2,8470,[318 496 588  98 357],716,5,35053,4.138000236099634,40.0,0.0
28471,2,8471,[742 174 204  11 175],457,5,35058,4.138101983002833,0.0,0.0
28472,2,8472,[  8  79 515 118 127],807,4,35062,4.138085683937212,0.0,20.0
28473,2,8473,[173 237 471 228 273],344,3,35065,4.137951380693887,0.0,0.0
28474,2,8474,[ 96 144  22 238 125],450,5,35070,4.138053097345133,0.0,0.0
28475,2,8475,[318 496 588  98 357],450,5,35075,4.138154789995281,40.0,0.0
28476,2,8476,[318 496 588  98 357],716,5,35080,4.138256458652825,40.0,0.0
28477,2,8477,[111  50 515 748 282],292,4,35084,4.138240150979004,0.0,20.0
28478,2,8478,[318 496 588  98 357],716,5,35089,4.138341785587923,40.0,0.0
28479,2,8479,[153 588 546 228 655],450,5,35094,4.138443396226415,0.0,0.0
28480,2,8480,[ 12 265 318 144 423],457,5,35099,4.1385449829029595,20.0,0.0
28481,2,8481,[202 186 257  82  96],457,4,35103,4.13852864890356,0.0,0.0
28482,2,8482,[318 496 588  98 357],330,5,35108,4.1386302015796295,40.0,0.0
28483,2,8483,[ 96  89 185 174  56],23,5,35113,4.138731730315889,0.0,0.0
28484,2,8484,[318 496 588  98 357],450,5,35118,4.138833235120801,40.0,0.0
28485,2,8485,[318 496 588  98 357],330,5,35123,4.1389347160028285,40.0,0.0
28486,2,8486,[318 496 588  98 357],716,5,35128,4.1390361729704255,40.0,0.0
28487,2,8487,[211 328 385 546 202],796,4,35132,4.139019792648445,0.0,0.0
28488,2,8488,[  9  11 168 435 111],401,2,35134,4.138767817175168,0.0,0.0
28489,2,8489,[195 357  98 200  12],18,3,35137,4.138633686690223,0.0,0.0
28490,2,8490,[ 98 195 282 228 111],796,5,35142,4.138735131315511,0.0,0.0
28491,2,8491,[318 496 588  98 357],18,5,35147,4.138836552048987,40.0,0.0
28492,2,8492,[318 496 588  98 357],716,5,35152,4.138937948899093,40.0,0.0
28493,2,8493,[318 496 588  98 357],330,5,35157,4.1390393218742645,40.0,0.0
28494,2,8494,[ 79  15 132 210 195],450,3,35160,4.138905238375515,0.0,0.0
28495,2,8495,[318 496 588  98 357],450,5,35165,4.1390065913370995,40.0,0.0
28496,2,8496,[228 143  98 204 172],151,5,35170,4.139107920442509,0.0,0.0
28497,2,8497,[ 98  82 288 202  69],450,3,35173,4.138973876206166,0.0,0.0
28498,2,8498,[318 496 588  98 357],330,5,35178,4.139075185315919,40.0,0.0
28499,2,8499,[405  98  89 294 273],450,4,35182,4.139058823529412,0.0,0.0
28500,2,8500,[318 496 588  98 357],786,5,35187,4.139160098811905,40.0,0.0
28501,2,8501,[100 515 405  96 603],655,2,35189,4.138908492119501,20.0,20.0
28502,2,8502,[318 496 588  98 357],450,5,35194,4.1390097612607315,40.0,0.0
28503,2,8503,[ 88 496 182 204 385],503,2,35196,4.138758231420508,20.0,0.0
28504,2,8504,[318 496 588  98 357],18,5,35201,4.13885949441505,40.0,0.0
28505,2,8505,[ 25 211 197 191  89],450,4,35205,4.138843169527393,0.0,0.0
28506,2,8506,[508 302 471  22 237],655,1,35206,4.138474197719525,0.0,0.0
28507,2,8507,[300 568 168 748   8],796,5,35211,4.1385754583921015,0.0,0.0
28508,2,8508,[191 289 211  15 275],786,4,35215,4.138559172640734,0.0,20.0
28509,2,8509,[318 496 588  98 357],450,5,35220,4.1386603995299645,40.0,0.0
28510,2,8510,[508 202 475  25  89],655,1,35221,4.138291622606039,0.0,0.0
28511,2,8511,[258 216 655  70 403],504,3,35224,4.1381578947368425,0.0,0.0
28512,2,8512,[301 127 357  56 153],539,3,35227,4.138024198284976,0.0,20.0
28513,2,8513,[318 496 588  98 357],330,5,35232,4.138125440451022,40.0,0.0
28514,2,8514,[318 496 588  98 357],786,5,35237,4.138226658837346,40.0,0.0
28515,2,8515,[385 333  12 196 143],796,5,35242,4.138327853452325,0.0,0.0
28516,2,8516,[132  50 216 172 143],18,4,35246,4.138311612069978,0.0,20.0
28517,2,8517,[180 276 151 269 257],296,4,35250,4.138295374501056,0.0,0.0
28518,2,8518,[318 496 588  98 357],786,5,35255,4.138396525413781,40.0,0.0
28519,2,8519,[318 496 588  98 357],450,5,35260,4.13849765258216,40.0,0.0
28520,2,8520,[318 496 588  98 357],796,5,35265,4.138598756014552,40.0,0.0
28521,2,8521,[318 496 588  98 357],786,5,35270,4.138699835719315,40.0,0.0
28522,2,8522,[117 200 294 211   4],504,4,35274,4.138683562126012,0.0,0.0
28523,2,8523,[172  15 117 496   1],786,4,35278,4.138667292351009,20.0,0.0
28524,2,8524,[318 496 588  98 357],330,5,35283,4.138768328445748,40.0,0.0
28525,2,8525,[ 97 143 423   1  71],450,4,35287,4.138752052545156,0.0,0.0
28526,2,8526,[216 322 202  88 276],504,2,35289,4.138501231382667,0.0,0.0
28527,2,8527,[197 174   8 328 471],655,0,35289,4.138015947467167,0.0,0.0
28528,2,8528,[144 301  89 655   1],450,5,35294,4.138117012545433,0.0,0.0
28529,2,8529,[237 100 289 546 111],786,5,35299,4.138218053927315,0.0,20.0
28530,2,8530,[318 496 588  98 357],796,5,35304,4.138319071621146,40.0,0.0
28531,2,8531,[318 496 588  98 357],786,5,35309,4.138420065635255,40.0,0.0
28532,2,8532,[318 496 588  98 357],18,5,35314,4.138521035977968,40.0,0.0
28533,2,8533,[215 237 182 181 508],535,4,35318,4.138504804312163,0.0,0.0
28534,2,8534,[423 195  82  12  97],450,4,35322,4.138488576449912,0.0,0.0
28535,2,8535,[318 496 588  98 357],330,5,35327,4.138589503280225,40.0,0.0
28536,2,8536,[318 496 588  98 357],796,5,35332,4.1386904064659715,40.0,0.0
28537,2,8537,[268 211   4 117 215],655,0,35332,4.138205668774889,0.0,0.0
28538,2,8538,[318 496 588  98 357],786,5,35337,4.1383065932779015,40.0,0.0
28539,2,8539,[318 496 588  98 357],786,5,35342,4.138407494145199,40.0,0.0
28540,2,8540,[172 176 222 215 276],344,4,35346,4.13839128907622,0.0,0.0
28541,2,8541,[ 50 173   8  97 181],756,3,35349,4.138258019199251,0.0,20.0
28542,2,8542,[200 597 357 313  82],796,4,35353,4.138241835420812,0.0,0.0
28543,2,8543,[318 496 588  98 357],796,5,35358,4.138342696629214,40.0,0.0
28544,2,8544,[ 28 183 288 323 196],504,4,35362,4.138326506729081,0.0,0.0
28545,2,8545,[ 88 313 180  71  79],450,4,35366,4.138310320617833,0.0,0.0
28546,2,8546,[318 496 588  98 357],796,5,35371,4.138411138411138,40.0,0.0
28547,2,8547,[318 496 588  98 357],330,5,35376,4.138511932615817,40.0,0.0
28548,2,8548,[202 174 300 168 204],450,5,35381,4.138612703240145,0.0,0.0
28549,2,8549,[318 496 588  98 357],450,5,35386,4.138713450292397,40.0,0.0
28550,2,8550,[245 318 210 423 385],504,5,35391,4.138814173780844,20.0,0.0
28551,2,8551,[ 15  28 118 100 132],174,3,35394,4.13868101028999,0.0,20.0
28552,2,8552,[ 98 215 300 173 357],796,5,35399,4.138781714018473,0.0,0.0
28553,2,8553,[427 273 471 161 210],655,2,35401,4.1385316810848725,20.0,0.0
28554,2,8554,[182 200 265  22 237],450,4,35405,4.138515488018703,0.0,0.0
28555,2,8555,[588 121  82 288 273],450,1,35406,4.138148667601683,0.0,0.0
28556,2,8556,[168 100  12 288 588],450,4,35410,4.138132523080519,0.0,20.0
28557,2,8557,[318 496 588  98 357],330,5,35415,4.138233232063566,40.0,0.0
28558,2,8558,[197 135 161 300 508],693,1,35416,4.137866573197804,0.0,0.0
28559,2,8559,[318 496 588  98 357],450,5,35421,4.137967289719626,40.0,0.0
28560,2,8560,[597 286 237 245  28],450,5,35426,4.1380679827123,0.0,20.0
28561,2,8561,[318 496 588  98 357],716,5,35431,4.138168652184069,40.0,0.0
28562,2,8562,[300 181 423 471 117],716,4,35435,4.138152516641364,0.0,0.0
28563,2,8563,[318 496 588  98 357],716,5,35440,4.138253152732368,40.0,0.0
28564,2,8564,[318 496 588  98 357],450,5,35445,4.138353765323993,40.0,0.0
28565,2,8565,[ 22 181 269 286 191],296,5,35450,4.138454354424469,0.0,20.0
28566,2,8566,[318 496 588  98 357],796,5,35455,4.138554920042021,40.0,0.0
28567,2,8567,[318 496 588  98 357],450,5,35460,4.138655462184874,40.0,0.0
28568,2,8568,[318 496 588  98 357],450,5,35465,4.138755980861244,40.0,0.0
28569,2,8569,[318 496 588  98 357],18,5,35470,4.138856476079346,40.0,0.0
28570,2,8570,[318 496 588  98 357],450,5,35475,4.138956947847392,40.0,0.0
28571,2,8571,[318 496 588  98 357],796,5,35480,4.139057396173588,40.0,0.0
28572,2,8572,[318 496 588  98 357],796,5,35485,4.139157821066138,40.0,0.0
28573,2,8573,[318 496 588  98 357],18,5,35490,4.13925822253324,40.0,0.0
28574,2,8574,[182 196  96 238 111],457,4,35494,4.139241982507289,0.0,0.0
28575,2,8575,[151 196 271 258 245],796,4,35498,4.139225746268656,0.0,0.0
28576,2,8576,[182 117 237 483 597],457,4,35502,4.139209513816019,0.0,0.0
28577,2,8577,[ 50  88  69 238   1],457,5,35507,4.139309862438797,0.0,20.0
28578,2,8578,[265 322 403 183 125],280,2,35509,4.13906049656137,0.0,0.0
28579,2,8579,[ 64 187   1 273 182],450,4,35513,4.139044289044289,20.0,0.0
28580,2,8580,[275 211 100 153 174],18,5,35518,4.1391446218389465,0.0,40.0
28581,2,8581,[318 496 588  98 357],786,5,35523,4.139244931251456,40.0,0.0
28582,2,8582,[318 496 588  98 357],716,5,35528,4.139345217289992,40.0,0.0
28583,2,8583,[678 144 508 168 357],401,2,35530,4.139095992544268,0.0,0.0
28584,2,8584,[  1 196 210 318 174],716,5,35535,4.139196272568434,20.0,0.0
28585,2,8585,[318 496 588  98 357],786,5,35540,4.139296529233636,40.0,0.0
28586,2,8586,[318 496 588  98 357],786,5,35545,4.139396762548038,40.0,0.0
28587,2,8587,[483 435   1  64 125],655,2,35547,4.139147647880764,20.0,0.0
28588,2,8588,[173   4  98 357 385],562,2,35549,4.13889859122133,0.0,0.0
28589,2,8589,[ 98  22 168 204 172],18,2,35551,4.138649592549476,0.0,0.0
28590,2,8590,[318 496 588  98 357],796,5,35556,4.1387498544988945,40.0,0.0
28591,2,8591,[318 496 588  98 357],450,5,35561,4.13885009310987,40.0,0.0
28592,2,8592,[318 496 588  98 357],786,5,35566,4.138950308390551,40.0,0.0
28593,2,8593,[180 237 111 238 181],716,4,35570,4.138934140097742,0.0,0.0
28594,2,8594,[318 496 588  98 357],786,5,35575,4.139034322280396,40.0,0.0
28595,2,8595,[318 496 588  98 357],716,5,35580,4.139134481154025,40.0,0.0
28596,2,8596,[427 269 211 483 257],296,5,35585,4.139234616726765,20.0,0.0
28597,2,8597,[135 742 196  28 597],457,4,35589,4.139218422889044,0.0,0.0
28598,2,8598,[125 117 132 257 174],457,4,35593,4.1392022328177696,0.0,0.0
28599,2,8599,[216  50  97  25 215],344,3,35596,4.13906976744186,0.0,20.0
28600,2,8600,[318 496 588  98 357],330,5,35601,4.139169863969306,40.0,0.0
28601,2,8601,[318 496 588  98 357],796,5,35606,4.139269937223902,40.0,0.0
28602,2,8602,[288 300 237 118 197],504,3,35609,4.139137510170871,0.0,0.0
28603,2,8603,[318 496 588  98 357],786,5,35614,4.139237563923756,40.0,0.0
28604,2,8604,[210 202  15  88 318],655,1,35615,4.1388727484020915,20.0,0.0
28605,2,8605,[182 100  98 176 546],796,4,35619,4.138856611666279,0.0,20.0
28606,2,8606,[175 237 294   1 258],655,0,35619,4.138375740676194,0.0,0.0
28607,2,8607,[234 423  96 318 125],796,4,35623,4.138359665427509,20.0,0.0
28608,2,8608,[ 70  88 385   4 322],151,3,35626,4.1382274364037634,0.0,0.0
28609,2,8609,[318 496 588  98 357],330,5,35631,4.138327526132405,40.0,0.0
28610,2,8610,[318 496 588  98 357],796,5,35636,4.138427592614098,40.0,0.0
28611,2,8611,[318 496 588  98 357],18,5,35641,4.138527635856944,40.0,0.0
28612,2,8612,[318 496 588  98 357],18,5,35646,4.138627655869035,40.0,0.0
28613,2,8613,[100  69 132 185 182],457,5,35651,4.138727652658463,0.0,20.0
28614,2,8614,[269  12 265 200 655],655,1,35652,4.138363319791062,0.0,0.0
28615,2,8615,[125 496 127 237 286],503,3,35655,4.138231197771588,20.0,40.0
28616,2,8616,[ 50  97 385 216 302],151,3,35658,4.138099106417546,0.0,20.0
28617,2,8617,[318 496 588  98 357],330,5,35663,4.138199118124855,40.0,0.0
28618,2,8618,[318 496 588  98 357],450,5,35668,4.138299106624898,40.0,0.0
28619,2,8619,[172 603  88  56 183],151,4,35672,4.138283062645011,20.0,0.0
28620,2,8620,[265 215 282  69 655],280,2,35674,4.138035030738894,0.0,0.0
28621,2,8621,[318 496 588  98 357],450,5,35679,4.138135003479471,40.0,0.0
28622,2,8622,[ 69 603 328 423 151],796,5,35684,4.138234953032588,20.0,0.0
28623,2,8623,[318 496 588  98 357],18,5,35689,4.138334879406308,40.0,0.0
28624,2,8624,[179 238 435 132 143],269,3,35692,4.138202898550724,0.0,0.0
28625,2,8625,[318 496 588  98 357],18,5,35697,4.138302805471829,40.0,0.0
28626,2,8626,[161 180 132 179 275],786,5,35702,4.138402689231483,0.0,20.0
28627,2,8627,[318 496 588  98 357],796,5,35707,4.138502549837738,40.0,0.0
28628,2,8628,[211 132   7 271 222],655,0,35707,4.138022945880172,0.0,0.0
28629,2,8629,[294  64 257 301 197],655,1,35708,4.1376593279258405,20.0,0.0
28630,2,8630,[ 64  15 202  69 282],655,1,35709,4.137295794230101,20.0,0.0
28631,2,8631,[318 496 588  98 357],18,5,35714,4.137395736793327,40.0,0.0
28632,2,8632,[318 496 588  98 357],18,5,35719,4.137495656202942,40.0,0.0
28633,2,8633,[318 496 588  98 357],450,5,35724,4.137595552466991,40.0,0.0
28634,2,8634,[237  71 215 132   1],450,4,35728,4.137579617834395,0.0,0.0
28635,2,8635,[ 97   1 405 215 588],577,4,35732,4.137563686892079,0.0,0.0
28636,2,8636,[196  70 471 132 405],450,5,35737,4.1376635405812205,0.0,0.0
28637,2,8637,[191 125 132 228 176],786,5,35742,4.137763371150729,0.0,0.0
28638,2,8638,[318 496 588  98 357],18,5,35747,4.137863178608635,40.0,0.0
28639,2,8639,[318 496 588  98 357],796,5,35752,4.137962962962963,40.0,0.0
28640,2,8640,[318 496 588  98 357],786,5,35757,4.138062724221734,40.0,0.0
28641,2,8641,[318 496 588  98 357],330,5,35762,4.138162462392964,40.0,0.0
28642,2,8642,[210 187 197 181 180],535,4,35766,4.138146476917737,0.0,0.0
28643,2,8643,[ 15 210  11   1  28],330,5,35771,4.138246182322999,0.0,0.0
28644,2,8644,[318 496 588  98 357],786,5,35776,4.138345864661654,40.0,0.0
28645,2,8645,[318 496 588  98 357],330,5,35781,4.138445523941707,40.0,0.0
28646,2,8646,[423 202 127 117 294],504,3,35784,4.138313866080722,0.0,20.0
28647,2,8647,[118 423 265 180  79],716,3,35787,4.1381822386679,0.0,0.0
28648,2,8648,[318  50 194 655 245],450,5,35792,4.138281882298531,20.0,20.0
28649,2,8649,[172 515 234 135 132],716,4,35796,4.138265895953757,0.0,0.0
28650,2,8650,[ 56   9 172 127 385],655,2,35798,4.138018726158825,0.0,20.0
28651,2,8651,[318 496 588  98 357],786,5,35803,4.138118354137772,40.0,0.0
28652,2,8652,[318 496 588  98 357],450,5,35808,4.138217959089333,40.0,0.0
28653,2,8653,[222   7 288  69 197],693,1,35809,4.137855327016409,0.0,0.0
28654,2,8654,[ 88 357  98 183 196],457,5,35814,4.137954939341421,0.0,0.0
28655,2,8655,[318 496 588  98 357],716,5,35819,4.138054528650647,40.0,0.0
28656,2,8656,[318 496 588  98 357],716,5,35824,4.138154094952062,40.0,0.0
28657,2,8657,[ 11  15 313  28 273],450,3,35827,4.138022638022638,0.0,0.0
28658,2,8658,[318 496 588  98 357],330,5,35832,4.138122185009816,40.0,0.0
28659,2,8659,[111 603 271 318   7],655,2,35834,4.1378752886836025,40.0,0.0
28660,2,8660,[276   1 172 328 423],655,2,35836,4.137628449370743,0.0,0.0
28661,2,8661,[258 222 100 245 423],756,1,35837,4.137266220272455,0.0,20.0
28662,2,8662,[318 496 588  98 357],450,5,35842,4.137365808611335,40.0,0.0
28663,2,8663,[ 50 301 496 435 234],450,4,35846,4.137349953831948,20.0,20.0
28664,2,8664,[318 496 588  98 357],450,5,35851,4.137449509521062,40.0,0.0
28665,2,8665,[235 153  88 496  28],450,4,35855,4.137433648742211,20.0,0.0
28666,2,8666,[427 143 588  56 275],450,5,35860,4.137533171801085,20.0,20.0
28667,2,8667,[318 496 588  98 357],786,5,35865,4.137632671896632,40.0,0.0
28668,2,8668,[318 496 588  98 357],716,5,35870,4.137732149036798,40.0,0.0
28669,2,8669,[318 496 588  98 357],18,5,35875,4.137831603229527,40.0,0.0
28670,2,8670,[318 496 588  98 357],18,5,35880,4.137931034482759,40.0,0.0
28671,2,8671,[186 603 210 245  96],450,3,35883,4.137799815498155,20.0,0.0
28672,2,8672,[318 496 588  98 357],330,5,35888,4.137899227487606,40.0,0.0
28673,2,8673,[273 328 313 237 228],655,2,35890,4.137652755360849,0.0,0.0
28674,2,8674,[200 204 597  12 186],457,4,35894,4.137636887608069,0.0,0.0
28675,2,8675,[200 234 546 216 282],457,4,35898,4.13762102351314,0.0,0.0
28676,2,8676,[183  28 294 215 313],577,5,35903,4.137720410280051,0.0,0.0
28677,2,8677,[ 98 153 195 183 151],269,2,35905,4.137474072366905,0.0,0.0
28678,2,8678,[222 121 174   1 161],450,3,35908,4.137343011867727,0.0,0.0
28679,2,8679,[168 202  88 269 328],796,4,35912,4.137327188940092,0.0,0.0
28680,2,8680,[318 496 588  98 357],18,5,35917,4.137426563759935,40.0,0.0
28681,2,8681,[ 97 302 174 748 187],450,5,35922,4.13752591568763,0.0,0.0
28682,2,8682,[318 496 588  98 357],716,5,35927,4.137625244731083,40.0,0.0
28683,2,8683,[215 175  50 238 222],151,4,35931,4.137609396591433,0.0,20.0
28684,2,8684,[318 496 588  98 357],786,5,35936,4.137708693149108,40.0,0.0
28685,2,8685,[318 496 588  98 357],796,5,35941,4.137807966843196,40.0,0.0
28686,2,8686,[ 56 483 258 237 282],655,1,35942,4.137446759525728,0.0,0.0
28687,2,8687,[318 496 588  98 357],716,5,35947,4.1375460405156534,40.0,0.0
28688,2,8688,[318 496 588  98 357],450,5,35952,4.13764529865347,40.0,0.0
28689,2,8689,[318 496 588  98 357],786,5,35957,4.137744533947066,40.0,0.0
28690,2,8690,[318 496 588  98 357],330,5,35962,4.137843746404326,40.0,0.0
28691,2,8691,[210 179 483   8 282],655,2,35964,4.137597791072251,0.0,0.0
28692,2,8692,[183 200 111  50  97],786,5,35969,4.137696997584263,0.0,20.0
28693,2,8693,[ 15 742 161  12 603],655,1,35970,4.137336093857833,20.0,0.0
28694,2,8694,[357 294 238  88  50],23,2,35972,4.137090281771133,0.0,20.0
28695,2,8695,[471 655 111 200 496],593,3,35975,4.1369595216191355,20.0,0.0
28696,2,8696,[  8  50 196 194 185],457,5,35980,4.137058755892837,0.0,20.0
28697,2,8697,[318 496 588  98 357],450,5,35985,4.1371579673488155,40.0,0.0
28698,2,8698,[318 496 588  98 357],450,5,35990,4.137257155994942,40.0,0.0
28699,2,8699,[271 161 403 265 597],807,4,35994,4.137241379310344,0.0,0.0
28700,2,8700,[318 496 588  98 357],450,5,35999,4.137340535570624,40.0,0.0
28701,2,8701,[186 194  88 200  56],796,4,36003,4.137324752930361,0.0,0.0
28702,2,8702,[318 496 588  98 357],716,5,36008,4.137423876824084,40.0,0.0
28703,2,8703,[135 173  70 258 153],535,4,36012,4.137408088235294,0.0,0.0
28704,2,8704,[318 496 588  98 357],796,5,36017,4.137507179781735,40.0,0.0
28705,2,8705,[191 121 216 132 271],796,5,36022,4.137606248564208,0.0,0.0
28706,2,8706,[318 496 588  98 357],450,5,36027,4.1377052945905595,40.0,0.0
28707,2,8707,[318 496 588  98 357],18,5,36032,4.137804317868627,40.0,0.0
28708,2,8708,[318 496 588  98 357],330,5,36037,4.137903318406247,40.0,0.0
28709,2,8709,[182  22  56 546 385],796,5,36042,4.138002296211251,0.0,0.0
28710,2,8710,[235 655 403 135 282],457,4,36046,4.137986453908851,0.0,0.0
28711,2,8711,[144 161 655 197  64],457,5,36051,4.138085399449036,20.0,0.0
28712,2,8712,[318 496 588  98 357],450,5,36056,4.138184322277057,40.0,0.0
28713,2,8713,[318 496 588  98 357],796,5,36061,4.138283222400735,40.0,0.0
28714,2,8714,[318 496 588  98 357],18,5,36066,4.138382099827883,40.0,0.0
28715,2,8715,[318 496 588  98 357],450,5,36071,4.138480954566315,40.0,0.0
28716,2,8716,[121  64 118 258 182],796,5,36076,4.138579786623838,20.0,0.0
28717,2,8717,[318 496 588  98 357],716,5,36081,4.138678596008258,40.0,0.0
28718,2,8718,[318 496 588  98 357],330,5,36086,4.138777382727377,40.0,0.0
28719,2,8719,[318 496 588  98 357],796,5,36091,4.1388761467889905,40.0,0.0
28720,2,8720,[187 300 405 111 200],655,2,36093,4.138630890952872,0.0,0.0
28721,2,8721,[423 318  82  88 135],450,3,36096,4.138500343957808,20.0,0.0
28722,2,8722,[216 234  69 135 423],151,5,36101,4.1385991058122205,0.0,0.0
28723,2,8723,[318 496 588  98 357],796,5,36106,4.138697845025217,40.0,0.0
28724,2,8724,[318 496 588  98 357],450,5,36111,4.138796561604584,40.0,0.0
28725,2,8725,[ 96 191  64 187  22],716,3,36114,4.138666055466422,20.0,0.0
28726,2,8726,[173  50 238  56 191],389,4,36118,4.1386501661510255,0.0,20.0
28727,2,8727,[ 79  69 125  28 742],577,5,36123,4.138748854262145,0.0,0.0
28728,2,8728,[237  89 161 405 179],655,2,36125,4.138503837782106,0.0,0.0
28729,2,8729,[183 191  25  89 196],457,5,36130,4.138602520045819,0.0,0.0
28730,2,8730,[200  97 333 568  70],655,1,36131,4.138243042034131,0.0,0.0
28731,2,8731,[318 496 588  98 357],796,5,36136,4.138341731562071,40.0,0.0
28732,2,8732,[ 97  50 174 546 121],786,4,36140,4.138325890301156,0.0,20.0
28733,2,8733,[357 195 228  79 273],796,4,36144,4.138310052667736,0.0,0.0
28734,2,8734,[318 496 588  98 357],786,5,36149,4.138408700629651,40.0,0.0
28735,2,8735,[318 496 588  98 357],716,5,36154,4.138507326007326,40.0,0.0
28736,2,8736,[210 603 175 187 515],655,3,36157,4.13837701728282,20.0,0.0
28737,2,8737,[318 496 588  98 357],796,5,36162,4.13847562371252,40.0,0.0
28738,2,8738,[318 496 588  98 357],786,5,36167,4.138574207575237,40.0,0.0
28739,2,8739,[318 496 588  98 357],716,5,36172,4.138672768878719,40.0,0.0
28740,2,8740,[405 196 245 300 121],450,4,36176,4.138656904244366,0.0,0.0
28741,2,8741,[318 496 588  98 357],330,5,36181,4.138755433539236,40.0,0.0
28742,2,8742,[318 496 588  98 357],18,5,36186,4.1388539402950935,40.0,0.0
28743,2,8743,[318 496 588  98 357],450,5,36191,4.138952424519671,40.0,0.0
28744,2,8744,[194 117 603 151 144],401,3,36194,4.138822184105203,20.0,0.0
28745,2,8745,[318 496 588  98 357],796,5,36199,4.1389206494397435,40.0,0.0
28746,2,8746,[318 496 588  98 357],796,5,36204,4.139019092260203,40.0,0.0
28747,2,8747,[333 301 435   7 300],629,3,36207,4.138888888888889,0.0,0.0
28748,2,8748,[180 127 125 175 197],18,4,36211,4.13887301405875,0.0,20.0
28749,2,8749,[180 275 204 132 483],796,4,36215,4.138857142857143,0.0,20.0
28750,2,8750,[ 96 228 176 483 118],292,4,36219,4.138841275282825,0.0,0.0
28751,2,8751,[210 603  64 483   7],151,5,36224,4.138939670932358,40.0,0.0
28752,2,8752,[211 197 483 143 127],269,4,36228,4.138923797555124,0.0,20.0
28753,2,8753,[318 496 588  98 357],786,5,36233,4.139022161297692,40.0,0.0
28754,2,8754,[385 100 568 294 185],256,4,36237,4.1390062821245,0.0,20.0
28755,2,8755,[ 22  71 235 289 228],756,1,36238,4.1386477843764276,0.0,0.0
28756,2,8756,[318 496 588  98 357],450,5,36243,4.138746145940391,40.0,0.0
28757,2,8757,[318 496 588  98 357],786,5,36248,4.138844485042247,40.0,0.0
28758,2,8758,[318 496 588  98 357],786,5,36253,4.138942801689691,40.0,0.0
28759,2,8759,[194  71 265 125  15],577,4,36257,4.138926940639269,0.0,0.0
28760,2,8760,[318 496 588  98 357],18,5,36262,4.139025225430887,40.0,0.0
28761,2,8761,[  7  64  22 181  96],655,1,36263,4.138666971011185,20.0,0.0
28762,2,8762,[ 88 127 132 235 181],450,4,36267,4.138651146867511,0.0,20.0
28763,2,8763,[328 183 302 195  96],655,2,36269,4.138407120036513,0.0,0.0
28764,2,8764,[ 98 427 357 204 216],450,5,36274,4.138505419281232,20.0,0.0
28765,2,8765,[318 496 588  98 357],796,5,36279,4.138603696098563,40.0,0.0
28766,2,8766,[204 194 125 423 135],18,1,36280,4.138245694080073,0.0,0.0
28767,2,8767,[237  82 211 568 100],269,2,36282,4.138001824817518,0.0,20.0
28768,2,8768,[185 215 258 655 271],796,4,36286,4.137986087353176,0.0,0.0
28769,2,8769,[318 496 588  98 357],330,5,36291,4.138084378563284,40.0,0.0
28770,2,8770,[496 181  88   8 100],18,3,36294,4.137954623190058,20.0,20.0
28771,2,8771,[ 95 125 117 168  28],450,4,36298,4.137938896488828,0.0,0.0
28772,2,8772,[318 496 588  98 357],796,5,36303,4.1380371594665455,40.0,0.0
28773,2,8773,[288 127 132 194   1],457,5,36308,4.13813540004559,0.0,20.0
28774,2,8774,[318 496 588  98 357],796,5,36313,4.138233618233619,40.0,0.0
28775,2,8775,[318 496 588  98 357],18,5,36318,4.1383318140382865,40.0,0.0
28776,2,8776,[275 202 435 172  79],18,3,36321,4.138202119175117,0.0,20.0
28777,2,8777,[318 496 588  98 357],330,5,36326,4.138300296195033,40.0,0.0
28778,2,8778,[318 496 588  98 357],450,5,36331,4.138398450848616,40.0,0.0
28779,2,8779,[318 496 588  98 357],786,5,36336,4.138496583143508,40.0,0.0
28780,2,8780,[318 496 588  98 357],450,5,36341,4.138594693087348,40.0,0.0
28781,2,8781,[318 496 588  98 357],716,5,36346,4.13869278068777,40.0,0.0
28782,2,8782,[202 294  50 191  64],796,4,36350,4.138676989639076,20.0,20.0
28783,2,8783,[ 50 237 568 588  70],885,4,36354,4.1386612021857925,0.0,20.0
28784,2,8784,[318 496 588  98 357],796,5,36359,4.138759248719408,40.0,0.0
28785,2,8785,[275  97 173 182 496],535,4,36363,4.138743455497382,20.0,20.0
28786,2,8786,[282 117  25 185 135],450,3,36366,4.138613861386139,0.0,0.0
28787,2,8787,[318 496 588  98 357],330,5,36371,4.13871187983614,40.0,0.0
28788,2,8788,[385 655 143 153 174],716,4,36375,4.138696097394471,0.0,0.0
28789,2,8789,[  7 300  79 568 286],450,5,36380,4.138794084186576,0.0,20.0
28790,2,8790,[318 496 588  98 357],786,5,36385,4.138892048686157,40.0,0.0
28791,2,8791,[318 496 588  98 357],450,5,36390,4.138989990900819,40.0,0.0
28792,2,8792,[318 496 588  98 357],450,5,36395,4.139087910838167,40.0,0.0
28793,2,8793,[318 496 588  98 357],716,5,36400,4.1391858085057995,40.0,0.0
28794,2,8794,[216 508 603 127   8],269,3,36403,4.139056281978397,20.0,20.0
28795,2,8795,[318 496 588  98 357],786,5,36408,4.139154160982264,40.0,0.0
28796,2,8796,[318 496 588  98 357],450,5,36413,4.139252017733318,40.0,0.0
28797,2,8797,[318 496 588  98 357],796,5,36418,4.139349852239145,40.0,0.0
28798,2,8798,[191  89 216  98 210],269,2,36420,4.139106716672349,0.0,0.0
28799,2,8799,[ 71 333 300 323  98],796,4,36424,4.139090909090909,0.0,0.0
28800,2,8800,[318 496 588  98 357],18,5,36429,4.139188728553574,40.0,0.0
28801,2,8801,[185 294 568  98  22],457,4,36433,4.139172915246535,0.0,0.0
28802,2,8802,[318 496 588  98 357],796,5,36438,4.139270703169374,40.0,0.0
28803,2,8803,[318 496 588  98 357],796,5,36443,4.139368468877783,40.0,0.0
28804,2,8804,[210 125 286   8  28],796,2,36445,4.139125496876774,0.0,20.0
28805,2,8805,[318 496 588  98 357],450,5,36450,4.139223256870316,40.0,0.0
28806,2,8806,[273 210  82 204 187],450,2,36452,4.138980356534574,0.0,0.0
28807,2,8807,[ 25 257 318 568 118],716,4,36456,4.138964577656676,20.0,0.0
28808,2,8808,[318 496 588  98 357],796,5,36461,4.139062322624588,40.0,0.0
28809,2,8809,[191 302 125 172 275],151,3,36464,4.138933030646992,0.0,20.0
28810,2,8810,[181 742  15   9  97],655,0,36464,4.1384632845307,0.0,0.0
28811,2,8811,[318 496 588  98 357],786,5,36469,4.138561053109396,40.0,0.0
28812,2,8812,[318 496 588  98 357],796,5,36474,4.138658799500737,40.0,0.0
28813,2,8813,[318 496 588  98 357],796,5,36479,4.138756523712276,40.0,0.0
28814,2,8814,[ 71  96 228 173 216],280,3,36482,4.138627339761769,0.0,0.0
28815,2,8815,[132 328 423 302 200],151,2,36484,4.138384754990925,0.0,0.0
28816,2,8816,[318 496 588  98 357],450,5,36489,4.138482477033004,40.0,0.0
28817,2,8817,[318 496 588  98 357],18,5,36494,4.138580176910864,40.0,0.0
28818,2,8818,[318 496 588  98 357],330,5,36499,4.138677854632045,40.0,0.0
28819,2,8819,[318 496 588  98 357],18,5,36504,4.1387755102040815,40.0,0.0
28820,2,8820,[ 12   7  97  70 144],457,5,36509,4.138873143634509,0.0,0.0
28821,2,8821,[318 496 588  98 357],330,5,36514,4.138970754930854,40.0,0.0
28822,2,8822,[318 496 588  98 357],716,5,36519,4.139068344100646,40.0,0.0
28823,2,8823,[195 286 210 204 183],786,5,36524,4.139165911151405,0.0,20.0
28824,2,8824,[175 210 655 211 195],151,4,36528,4.13915014164306,0.0,0.0
28825,2,8825,[318 496 588  98 357],330,5,36533,4.139247677317018,40.0,0.0
28826,2,8826,[357 195 515 174 211],716,4,36537,4.1392319021185005,0.0,0.0
28827,2,8827,[318 496 588  98 357],18,5,36542,4.139329406434073,40.0,0.0
28828,2,8828,[318 496 588  98 357],786,5,36547,4.139426888662363,40.0,0.0
28829,2,8829,[435  50 496 151 245],450,5,36552,4.139524348810872,20.0,20.0
28830,2,8830,[187 197  98 238 222],796,3,36555,4.139395311969199,0.0,0.0
28831,2,8831,[318 496 588  98 357],796,5,36560,4.1394927536231885,40.0,0.0
28832,2,8832,[318 496 588  98 357],786,5,36565,4.139590173214083,40.0,0.0
28833,2,8833,[597 276 180 265 168],457,4,36569,4.139574371745528,0.0,0.0
28834,2,8834,[318 496 588  98 357],796,5,36574,4.139671760045275,40.0,0.0
28835,2,8835,[318 496 588  98 357],786,5,36579,4.139769126301494,40.0,0.0
28836,2,8836,[318 496 588  98 357],796,5,36584,4.13986647052167,40.0,0.0
28837,2,8837,[144 238 282 197 172],535,2,36586,4.139624349400317,0.0,0.0
28838,2,8838,[318 496 588  98 357],330,5,36591,4.139721687973752,40.0,0.0
28839,2,8839,[127 111 183 153 187],450,5,36596,4.139819004524887,0.0,20.0
28840,2,8840,[318 496 588  98 357],716,5,36601,4.139916299061192,40.0,0.0
28841,2,8841,[258 286 678 405 196],344,1,36602,4.139561185252205,0.0,20.0
28842,2,8842,[318 496 588  98 357],786,5,36607,4.1396584869388215,40.0,0.0
28843,2,8843,[318 496 588  98 357],786,5,36612,4.139755766621438,40.0,0.0
28844,2,8844,[ 64 125  11 258  96],655,1,36613,4.139400791407575,20.0,0.0
28845,2,8845,[318 496 588  98 357],18,5,36618,4.139498078227447,40.0,0.0
28846,2,8846,[318 496 588  98 357],18,5,36623,4.139595343054142,40.0,0.0
28847,2,8847,[318 496 588  98 357],450,5,36628,4.1396925858951175,40.0,0.0
28848,2,8848,[515 196 185 471 313],655,3,36631,4.139563792518929,0.0,0.0
28849,2,8849,[ 56 471   1 127 215],280,3,36634,4.139435028248587,0.0,20.0
28850,2,8850,[228 191 603 288 183],450,4,36638,4.139419274658231,20.0,0.0
28851,2,8851,[435 173  12 215  97],450,5,36643,4.139516493447808,0.0,0.0
28852,2,8852,[318 496 588  98 357],796,5,36648,4.139613690274484,40.0,0.0
28853,2,8853,[318 496 588  98 357],796,5,36653,4.139710865145696,40.0,0.0
28854,2,8854,[204 144  89 211  82],807,5,36658,4.139808018068887,0.0,0.0
28855,2,8855,[271  50 294 196  22],629,4,36662,4.139792231255646,0.0,20.0
28856,2,8856,[318 496 588  98 357],18,5,36667,4.139889353054081,40.0,0.0
28857,2,8857,[483 237 269 195  97],655,1,36668,4.1395348837209305,0.0,0.0
28858,2,8858,[318 496 588  98 357],450,5,36673,4.139632012642511,40.0,0.0
28859,2,8859,[187 202 234  64  22],18,3,36676,4.139503386004515,20.0,0.0
28860,2,8860,[118 655 302 151 588],450,4,36680,4.139487642478276,0.0,0.0
28861,2,8861,[318 496 588  98 357],786,5,36685,4.139584743850147,40.0,0.0
28862,2,8862,[318 496 588  98 357],450,5,36690,4.139681823310392,40.0,0.0
28863,2,8863,[318 496 588  98 357],450,5,36695,4.139778880866426,40.0,0.0
28864,2,8864,[228 117  69 271 333],796,5,36700,4.1398759165256624,0.0,0.0
28865,2,8865,[318 496 588  98 357],796,5,36705,4.139972930295511,40.0,0.0
28866,2,8866,[318 496 588  98 357],796,5,36710,4.140069922183376,40.0,0.0
28867,2,8867,[168 211  69 546   9],504,5,36715,4.140166892196662,0.0,0.0
28868,2,8868,[318 496 588  98 357],796,5,36720,4.140263840342767,40.0,0.0
28869,2,8869,[  1  50  95 508 186],523,3,36723,4.140135287485908,0.0,20.0
28870,2,8870,[318 496 588  98 357],450,5,36728,4.140232217337392,40.0,0.0
28871,2,8871,[318 496 588  98 357],450,5,36733,4.140329125338143,40.0,0.0
28872,2,8872,[  1  88 151 748 588],796,4,36737,4.1403133100417,0.0,0.0
28873,2,8873,[273 234 357  22 200],450,2,36739,4.140072120802344,0.0,0.0
28874,2,8874,[318 496 588  98 357],450,5,36744,4.140169014084507,40.0,0.0
28875,2,8875,[ 64 216 357 117 568],693,4,36748,4.14015322217215,20.0,0.0
28876,2,8876,[282 275 210  50 186],535,4,36752,4.140137433817731,0.0,40.0
28877,2,8877,[655 173 235 210 234],716,4,36756,4.14012164902005,0.0,0.0
28878,2,8878,[ 11  12 483 172 176],693,2,36758,4.13988061718662,0.0,0.0
28879,2,8879,[471 318 216 117 546],577,3,36761,4.1397522522522525,20.0,0.0
28880,2,8880,[318 496 588  98 357],18,5,36766,4.13984911609053,40.0,0.0
28881,2,8881,[  7 385 288 117 121],457,5,36771,4.139945958117541,0.0,0.0
28882,2,8882,[318 496 588  98 357],330,5,36776,4.140042778340651,40.0,0.0
28883,2,8883,[318 496 588  98 357],786,5,36781,4.140139576767222,40.0,0.0
28884,2,8884,[ 25 151 216 423 385],151,4,36785,4.140123804164322,0.0,0.0
28885,2,8885,[ 11 288 176 294 132],655,0,36785,4.139657888813865,0.0,0.0
28886,2,8886,[318 496 588  98 357],716,5,36790,4.139754697873298,40.0,0.0
28887,2,8887,[216 265  50 275 471],457,5,36795,4.139851485148514,0.0,40.0
28888,2,8888,[318 496 588  98 357],18,5,36800,4.139948250646867,40.0,0.0
28889,2,8889,[275 181 318 403 194],450,5,36805,4.140044994375703,20.0,20.0
28890,2,8890,[588 276 385 117 318],280,5,36810,4.140141716342368,20.0,0.0
28891,2,8891,[301 313 144 427 294],796,3,36813,4.140013495276653,20.0,0.0
28892,2,8892,[318 496 588  98 357],786,5,36818,4.140110199032947,40.0,0.0
28893,2,8893,[161  25 234 216   4],716,3,36821,4.1399820103440526,0.0,0.0
28894,2,8894,[ 56 328  22 748  88],796,5,36826,4.140078695896571,0.0,0.0
28895,2,8895,[ 71  82 143 172 742],450,3,36829,4.139950539568345,0.0,0.0
28896,2,8896,[318 496 588  98 357],18,5,36834,4.140047206923682,40.0,0.0
28897,2,8897,[234 288 405 742 435],655,0,36834,4.139581928523263,0.0,0.0
28898,2,8898,[204 151  64 197 100],330,5,36839,4.139678615574784,20.0,20.0
28899,2,8899,[318 496 588  98 357],450,5,36844,4.139775280898877,40.0,0.0
28900,2,8900,[ 25 471 202 269  89],344,4,36848,4.139759577575553,0.0,0.0
28901,2,8901,[313   8 111 211 216],655,2,36850,4.13951920916648,0.0,0.0
28902,2,8902,[200 144 405 211  95],796,4,36854,4.139503538133214,0.0,0.0
28903,2,8903,[288 118 143 742  69],655,1,36855,4.139150943396227,0.0,0.0
28904,2,8904,[  1 276 286 237  88],655,1,36856,4.1387984278495225,0.0,20.0
28905,2,8905,[ 97 427 237  96 318],796,4,36860,4.1387828430271725,40.0,0.0
28906,2,8906,[318 496 588  98 357],450,5,36865,4.138879532951611,40.0,0.0
28907,2,8907,[318 496 588  98 357],716,5,36870,4.13897620116749,40.0,0.0
28908,2,8908,[318 496 588  98 357],786,5,36875,4.139072847682119,40.0,0.0
28909,2,8909,[195 655  79 222 496],796,4,36879,4.139057239057239,20.0,0.0
28910,2,8910,[318 496 588  98 357],450,5,36884,4.139153854786219,40.0,0.0
28911,2,8911,[318 496 588  98 357],716,5,36889,4.139250448833034,40.0,0.0
28912,2,8912,[143 121 161 328 117],401,2,36891,4.13901043419724,0.0,0.0
28913,2,8913,[200 215 357 204 118],796,5,36896,4.1391070226609825,0.0,0.0
28914,2,8914,[144 215 100 405 117],457,5,36901,4.139203589455973,0.0,20.0
28915,2,8915,[318 496 588  98 357],796,5,36906,4.139300134589502,40.0,0.0
28916,2,8916,[318 496 588  98 357],330,5,36911,4.139396658068857,40.0,0.0
28917,2,8917,[318 496 588  98 357],18,5,36916,4.139493159901323,40.0,0.0
28918,2,8918,[258  79 185 385 180],450,5,36921,4.139589640094181,0.0,0.0
28919,2,8919,[318 496 588  98 357],450,5,36926,4.139686098654709,40.0,0.0
28920,2,8920,[318 496 588  98 357],18,5,36931,4.1397825355901805,40.0,0.0
28921,2,8921,[197 127  98 258  82],655,2,36933,4.139542703429724,0.0,20.0
28922,2,8922,[318 496 588  98 357],18,5,36938,4.139639134820127,40.0,0.0
28923,2,8923,[  7 282 127 121 183],693,3,36941,4.139511429852084,0.0,20.0
28924,2,8924,[289 121 161 117 135],655,1,36942,4.139159663865546,0.0,0.0
28925,2,8925,[318 496 588  98 357],716,5,36947,4.1392561057584585,40.0,0.0
28926,2,8926,[318 496 588  98 357],716,5,36952,4.139352526044584,40.0,0.0
28927,2,8927,[318 496 588  98 357],450,5,36957,4.139448924731183,40.0,0.0
28928,2,8928,[318 496 588  98 357],330,5,36962,4.139545301825512,40.0,0.0
28929,2,8929,[318 496 588  98 357],330,5,36967,4.139641657334827,40.0,0.0
28930,2,8930,[187 181 238 143 211],786,5,36972,4.139737991266376,0.0,0.0
28931,2,8931,[318 496 588  98 357],18,5,36977,4.139834303627407,40.0,0.0
28932,2,8932,[318 496 588  98 357],796,5,36982,4.139930594425165,40.0,0.0
28933,2,8933,[318 496 588  98 357],716,5,36987,4.140026863666891,40.0,0.0
28934,2,8934,[318 496 588  98 357],786,5,36992,4.140123111359821,40.0,0.0
28935,2,8935,[318 496 588  98 357],796,5,36997,4.140219337511191,40.0,0.0
28936,2,8936,[318 496 588  98 357],796,5,37002,4.140315542128231,40.0,0.0
28937,2,8937,[318 496 588  98 357],450,5,37007,4.140411725218169,40.0,0.0
28938,2,8938,[174 191 200 195 655],796,4,37011,4.140396017451616,0.0,0.0
28939,2,8939,[174 200 603 111 228],655,2,37013,4.140156599552573,20.0,0.0
28940,2,8940,[228 471  95 318  71],280,3,37016,4.140029079521306,20.0,0.0
28941,2,8941,[318 496 588  98 357],18,5,37021,4.140125251621561,40.0,0.0
28942,2,8942,[318 496 588  98 357],450,5,37026,4.1402214022140225,40.0,0.0
28943,2,8943,[258  56 222 294  64],457,4,37030,4.14020572450805,20.0,0.0
28944,2,8944,[318 496 588  98 357],786,5,37035,4.140301844605925,40.0,0.0
28945,2,8945,[357 168 258 179  95],450,4,37039,4.140286161412922,0.0,0.0
28946,2,8946,[318 496 588  98 357],18,5,37044,4.140382251033866,40.0,0.0
28947,2,8947,[  1 180 151  96 173],450,5,37049,4.14047831917747,0.0,0.0
28948,2,8948,[ 25 275 216 496  97],450,4,37053,4.140462621521958,20.0,20.0
28949,2,8949,[ 96 435 427 515 237],296,5,37058,4.140558659217877,20.0,0.0
28950,2,8950,[318 496 588  98 357],18,5,37063,4.140654675455257,40.0,0.0
28951,2,8951,[117 265 210  50 655],457,5,37068,4.140750670241287,0.0,20.0
28952,2,8952,[173 118 265 117 125],280,2,37070,4.140511560370825,0.0,0.0
28953,2,8953,[228 300 597 111 483],450,4,37074,4.140495867768595,0.0,0.0
28954,2,8954,[318 496 588  98 357],716,5,37079,4.140591848129537,40.0,0.0
28955,2,8955,[318 496 588  98 357],330,5,37084,4.140687807056722,40.0,0.0
28956,2,8956,[318 496 588  98 357],18,5,37089,4.1407837445573294,40.0,0.0
28957,2,8957,[191   7  79 180  96],296,5,37094,4.140879660638535,0.0,0.0
28958,2,8958,[318 496 588  98 357],716,5,37099,4.140975555307512,40.0,0.0
28959,2,8959,[318 496 588  98 357],18,5,37104,4.141071428571428,40.0,0.0
28960,2,8960,[318 496 588  98 357],450,5,37109,4.141167280437451,40.0,0.0
28961,2,8961,[742 300 161 135   9],693,1,37110,4.140816781968311,0.0,0.0
28962,2,8962,[318 496 588  98 357],330,5,37115,4.140912640856856,40.0,0.0
28963,2,8963,[318 496 588  98 357],796,5,37120,4.141008478357876,40.0,0.0
28964,2,8964,[318 496 588  98 357],330,5,37125,4.141104294478527,40.0,0.0
28965,2,8965,[228 182 597  98 568],450,5,37130,4.141200089225965,0.0,0.0
28966,2,8966,[318 496 588  98 357],330,5,37135,4.141295862607338,40.0,0.0
28967,2,8967,[318 496 588  98 357],18,5,37140,4.141391614629795,40.0,0.0
28968,2,8968,[603  70 435 202 216],591,4,37144,4.141375850150518,20.0,0.0
28969,2,8969,[318 496 588  98 357],330,5,37149,4.141471571906354,40.0,0.0
28970,2,8970,[168  98  56 179 132],269,5,37154,4.141567272321926,0.0,0.0
28971,2,8971,[318 496 588  98 357],716,5,37159,4.141662951404369,40.0,0.0
28972,2,8972,[211 238   4  50 127],450,4,37163,4.141647163713363,0.0,40.0
28973,2,8973,[286 194  88 597  64],450,5,37168,4.141742812569646,20.0,20.0
28974,2,8974,[318 496 588  98 357],786,5,37173,4.141838440111421,40.0,0.0
28975,2,8975,[318 496 588  98 357],18,5,37178,4.141934046345811,40.0,0.0
28976,2,8976,[318 496 588  98 357],330,5,37183,4.142029631279938,40.0,0.0
28977,2,8977,[318 496 588  98 357],450,5,37188,4.142125194920918,40.0,0.0
28978,2,8978,[588 216   9 269 403],18,4,37192,4.142109366299143,0.0,0.0
28979,2,8979,[179 174 216 100 237],450,5,37197,4.1422048997772825,0.0,20.0
28980,2,8980,[328 127 289  89  50],655,3,37200,4.142077719630331,0.0,40.0
28981,2,8981,[318 496 588  98 357],330,5,37205,4.142173235359608,40.0,0.0
28982,2,8982,[318 496 588  98 357],716,5,37210,4.142268729822999,40.0,0.0
28983,2,8983,[ 71 153 403  50   7],280,3,37213,4.142141585040071,0.0,20.0
28984,2,8984,[211 196 403  64 186],450,4,37217,4.142125765164162,20.0,0.0
28985,2,8985,[ 22  79  88 195 132],450,5,37222,4.142221233029156,0.0,0.0
28986,2,8986,[385 322 215 508 301],344,2,37224,4.141982864137087,0.0,0.0
28987,2,8987,[318 496 588  98 357],716,5,37229,4.142078326657766,40.0,0.0
28988,2,8988,[318 496 588  98 357],796,5,37234,4.1421737679385915,40.0,0.0
28989,2,8989,[318 496 588  98 357],18,5,37239,4.142269187986652,40.0,0.0
28990,2,8990,[118  56 153 215  95],796,5,37244,4.142364586809031,0.0,0.0
28991,2,8991,[318 496 588  98 357],330,5,37249,4.1424599644128115,40.0,0.0
28992,2,8992,[  8 182 313  28  12],796,4,37253,4.142444123206939,0.0,0.0
28993,2,8993,[135 151 357  88 196],18,1,37254,4.14209472981988,0.0,0.0
28994,2,8994,[121 588 405  79   8],457,5,37259,4.1421901056142305,0.0,0.0
28995,2,8995,[318 496 588  98 357],716,5,37264,4.142285460204535,40.0,0.0
28996,2,8996,[318 496 588  98 357],450,5,37269,4.142380793597866,40.0,0.0
28997,2,8997,[318 496 588  98 357],330,5,37274,4.142476105801289,40.0,0.0
28998,2,8998,[318 496 588  98 357],716,5,37279,4.142571396821869,40.0,0.0
28999,2,8999,[191 286  69  89   9],786,5,37284,4.142666666666667,0.0,20.0
29000,2,9000,[222 546 161 265 597],796,5,37289,4.1427619153427395,0.0,0.0
29001,2,9001,[318 496 588  98 357],786,5,37294,4.142857142857143,40.0,0.0
29002,2,9002,[265 200 301 385 161],655,1,37295,4.142508052871265,0.0,0.0
29003,2,9003,[318 496 588  98 357],330,5,37300,4.14260328742781,40.0,0.0
29004,2,9004,[161 196 186 132 179],655,1,37301,4.142254303164909,0.0,0.0
29005,2,9005,[318 496 588  98 357],18,5,37306,4.142349544747946,40.0,0.0
29006,2,9006,[318 496 588  98 357],450,5,37311,4.142444765182636,40.0,0.0
29007,2,9007,[318 496 588  98 357],330,5,37316,4.142539964476021,40.0,0.0
29008,2,9008,[318 496 588  98 357],796,5,37321,4.142635142635142,40.0,0.0
29009,2,9009,[215 194 603 197 187],716,4,37325,4.142619311875694,20.0,0.0
29010,2,9010,[ 25 174 191 135 748],450,3,37328,4.142492509155477,0.0,0.0
29011,2,9011,[ 22 153 403 118 125],450,4,37332,4.142476697736352,0.0,0.0
29012,2,9012,[ 22 197 238 173 471],535,4,37336,4.1424608898258075,0.0,0.0
29013,2,9013,[ 79 125 323  88 174],796,4,37340,4.1424450854226755,0.0,0.0
29014,2,9014,[204 197  25  70 385],151,4,37344,4.14242928452579,0.0,0.0
29015,2,9015,[ 79 121 117   7  70],72,3,37347,4.142302573203194,0.0,0.0
29016,2,9016,[ 98 403 237 200 118],655,2,37349,4.142064988355329,0.0,0.0
29017,2,9017,[318 496 588  98 357],330,5,37354,4.142160124196052,40.0,0.0
29018,2,9018,[318 496 588  98 357],716,5,37359,4.142255238940016,40.0,0.0
29019,2,9019,[318 496 588  98 357],716,5,37364,4.142350332594235,40.0,0.0
29020,2,9020,[357  98 125  15  25],457,5,37369,4.1424454051657245,0.0,0.0
29021,2,9021,[ 98 191 496 568 127],389,4,37373,4.142429616493017,20.0,20.0
29022,2,9022,[318 496 588  98 357],796,5,37378,4.1425246592042555,40.0,0.0
29023,2,9023,[288 186 121 302 301],450,2,37380,4.142287234042553,0.0,0.0
29024,2,9024,[403  96  28   8 144],655,0,37380,4.1418282548476455,0.0,0.0
29025,2,9025,[318 496 588  98 357],796,5,37385,4.141923332594726,40.0,0.0
29026,2,9026,[228 204  56 127 202],457,5,37390,4.142018389276615,0.0,20.0
29027,2,9027,[282 180 405 276  56],280,3,37393,4.141891891891892,0.0,0.0
29028,2,9028,[318 496 588  98 357],450,5,37398,4.141986931000111,40.0,0.0
29029,2,9029,[318 496 588  98 357],716,5,37403,4.142081949058693,40.0,0.0
29030,2,9030,[318 496 588  98 357],786,5,37408,4.142176946074632,40.0,0.0
29031,2,9031,[111 118 357 322 210],796,3,37411,4.142050487156776,0.0,0.0
29032,2,9032,[111 125  15 742 173],457,4,37415,4.1420347614303115,0.0,0.0
29033,2,9033,[318 496 588  98 357],716,5,37420,4.142129732123091,40.0,0.0
29034,2,9034,[183 258 151 222  71],756,2,37422,4.141892639734366,0.0,0.0
29035,2,9035,[318 496 588  98 357],716,5,37427,4.141987605135015,40.0,0.0
29036,2,9036,[318 496 588  98 357],786,5,37432,4.142082549518646,40.0,0.0
29037,2,9037,[318 496 588  98 357],450,5,37437,4.142177472892233,40.0,0.0
29038,2,9038,[318 496 588  98 357],18,5,37442,4.14227237526275,40.0,0.0
29039,2,9039,[ 25 435 403 265 125],655,0,37442,4.141814159292036,0.0,0.0
29040,2,9040,[153 125 318 300 222],796,5,37447,4.141909080853888,20.0,0.0
29041,2,9041,[318 496 588  98 357],716,5,37452,4.14200398142004,40.0,0.0
29042,2,9042,[318 496 588  98 357],716,5,37457,4.142098860997456,40.0,0.0
29043,2,9043,[742 427 195  25 135],693,4,37461,4.1420831490490935,20.0,0.0
29044,2,9044,[ 56 125 100 153   4],151,3,37464,4.14195688225539,0.0,20.0
29045,2,9045,[ 89 228  50  96  15],450,4,37468,4.141941189476012,0.0,20.0
29046,2,9046,[ 97 161 172 546  79],577,4,37472,4.141925500165801,0.0,0.0
29047,2,9047,[318 496 588  98 357],716,5,37477,4.142020335985853,40.0,0.0
29048,2,9048,[318 496 588  98 357],18,5,37482,4.142115150845397,40.0,0.0
29049,2,9049,[318 496 588  98 357],796,5,37487,4.142209944751381,40.0,0.0
29050,2,9050,[ 79  88 135  98 125],280,3,37490,4.142083747652193,0.0,0.0
29051,2,9051,[496 282 174 328 100],236,2,37492,4.14184710561202,20.0,20.0
29052,2,9052,[318 588 496  98 357],716,5,37497,4.141941897713465,40.0,0.0
29053,2,9053,[405 200   4   7 237],450,3,37500,4.14181577203446,0.0,0.0
29054,2,9054,[515 121 301 191 111],296,4,37504,4.141800110436223,0.0,0.0
29055,2,9055,[318 588 496  98 357],786,5,37509,4.141894876325089,40.0,0.0
29056,2,9056,[ 70  56  28 496 211],450,5,37514,4.141989621287402,20.0,0.0
29057,2,9057,[196 174 302 121 483],151,4,37518,4.1419739456833735,0.0,0.0
29058,2,9058,[ 97 238 185 471  82],457,5,37523,4.142068661000111,0.0,0.0
29059,2,9059,[318 588 496  98 357],716,5,37528,4.142163355408388,40.0,0.0
29060,2,9060,[318 588 496  98 357],18,5,37533,4.142258028915131,40.0,0.0
29061,2,9061,[318 588 496  98 357],450,5,37538,4.142352681527257,40.0,0.0
29062,2,9062,[568 143  70 197  97],457,5,37543,4.142447313251683,0.0,0.0
29063,2,9063,[ 28 238 323 269  95],23,3,37546,4.142321270962047,0.0,0.0
29064,2,9064,[318 588 496  98 357],786,5,37551,4.142415885273028,40.0,0.0
29065,2,9065,[186 200 276 161 546],457,4,37555,4.142400176483565,0.0,0.0
29066,2,9066,[ 28 568 179 210 197],450,4,37559,4.142384471159149,0.0,0.0
29067,2,9067,[ 22  88 125  97 191],655,1,37560,4.142037935597706,0.0,0.0
29068,2,9068,[ 12 496 678  88 222],344,3,37563,4.141912007939133,20.0,0.0
29069,2,9069,[168  98 300 238 153],716,5,37568,4.142006615214995,0.0,0.0
29070,2,9070,[318 588 496  98 357],716,5,37573,4.142101201631573,40.0,0.0
29071,2,9071,[318 588 496  98 357],786,5,37578,4.142195767195767,40.0,0.0
29072,2,9072,[ 82 237 245  69 182],796,3,37581,4.142069877658988,0.0,0.0
29073,2,9073,[318 588 496  98 357],796,5,37586,4.142164425832048,40.0,0.0
29074,2,9074,[  9 195 403 182 151],269,3,37589,4.142038567493113,0.0,0.0
29075,2,9075,[423 143 176 135 235],716,2,37591,4.141802556192155,0.0,0.0
29076,2,9076,[302 211  22  12 288],450,4,37595,4.141786934009033,0.0,0.0
29077,2,9077,[403  79  95 100 187],796,4,37599,4.14177131526768,0.0,20.0
29078,2,9078,[318 588 496  98 357],796,5,37604,4.1418658442559755,40.0,0.0
29079,2,9079,[100 435 197 282  97],655,0,37604,4.141409691629956,0.0,20.0
29080,2,9080,[235  25 496 294  82],716,4,37608,4.141394119590354,20.0,0.0
29081,2,9081,[234 202 191 273 403],796,3,37611,4.141268443074213,0.0,0.0
29082,2,9082,[318 588 496  98 357],450,5,37616,4.141362985797644,40.0,0.0
29083,2,9083,[318 588 496  98 357],716,5,37621,4.141457507705857,40.0,0.0
29084,2,9084,[183 111  64  12 496],344,5,37626,4.141552008805724,40.0,0.0
29085,2,9085,[210 271 333 202 276],629,5,37631,4.141646489104116,0.0,0.0
29086,2,9086,[318 588 496  98 357],796,5,37636,4.141740948607901,40.0,0.0
29087,2,9087,[318 588 496  98 357],18,5,37641,4.141835387323944,40.0,0.0
29088,2,9088,[318 588 496  98 357],796,5,37646,4.141929805259104,40.0,0.0
29089,2,9089,[151 121 144 282 496],716,3,37649,4.141804180418042,20.0,0.0
29090,2,9090,[143 301 271 322 153],796,3,37652,4.141678583214168,0.0,0.0
29091,2,9091,[318 588 496  98 357],18,5,37657,4.141772987241531,40.0,0.0
29092,2,9092,[318 588 496  98 357],786,5,37662,4.141867370504784,40.0,0.0
29093,2,9093,[318 588 496  98 357],786,5,37667,4.141961733010777,40.0,0.0
29094,2,9094,[132 151 210  95 174],577,4,37671,4.1419461242440905,0.0,0.0
29095,2,9095,[282 127 111 276   1],296,4,37675,4.141930518909411,0.0,20.0
29096,2,9096,[318 588 496  98 357],18,5,37680,4.142024843354952,40.0,0.0
29097,2,9097,[318 588 496  98 357],18,5,37685,4.142119147065289,40.0,0.0
29098,2,9098,[  4 546  11 265 471],577,2,37687,4.141883723486098,0.0,0.0
29099,2,9099,[318 588 496  98 357],18,5,37692,4.141978021978022,40.0,0.0
29100,2,9100,[276 258   8 282 269],535,3,37695,4.141852543676519,0.0,0.0
29101,2,9101,[403 100 288 294  22],256,4,37699,4.14183695891013,0.0,20.0
29102,2,9102,[200 183 202 228  96],280,2,37701,4.1416016697791935,0.0,0.0
29103,2,9103,[318 588 496  98 357],450,5,37706,4.141695957820738,40.0,0.0
29104,2,9104,[318 588 496  98 357],18,5,37711,4.141790225151016,40.0,0.0
29105,2,9105,[215 153 127 275 301],539,4,37715,4.141774654074236,0.0,40.0
29106,2,9106,[742 288 423 357 471],693,1,37716,4.141429669485012,0.0,0.0
29107,2,9107,[385 237  70  11 568],280,3,37719,4.141304347826087,0.0,0.0
29108,2,9108,[269 151  56 204 286],174,4,37723,4.1412888352179165,0.0,20.0
29109,2,9109,[318 588 496  98 357],18,5,37728,4.141383095499451,40.0,0.0
29110,2,9110,[237 127 328 385 597],796,5,37733,4.141477335089452,0.0,20.0
29111,2,9111,[118 168 187 125   1],796,4,37737,4.1414618086040385,0.0,0.0
29112,2,9112,[328  97 234 403 286],655,0,37737,4.141007352134314,0.0,20.0
29113,2,9113,[301 483  15  69 318],450,3,37740,4.140882159315339,20.0,0.0
29114,2,9114,[183  96 318 300 515],716,3,37743,4.14075699396599,20.0,0.0
29115,2,9115,[318 588 496  98 357],716,5,37748,4.1408512505484865,40.0,0.0
29116,2,9116,[546 313 234 273 496],450,3,37751,4.140726116046945,20.0,0.0
29117,2,9117,[318 588 496  98 357],716,5,37756,4.140820355341083,40.0,0.0
29118,2,9118,[318 588 496  98 357],786,5,37761,4.140914573966444,40.0,0.0
29119,2,9119,[603 204 294 235 282],450,4,37765,4.140899122807017,20.0,0.0
29120,2,9120,[153 182 132 172 174],629,5,37770,4.140993312136827,0.0,0.0
29121,2,9121,[318 588 496  98 357],18,5,37775,4.14108748081561,40.0,0.0
29122,2,9122,[318 588 496  98 357],716,5,37780,4.141181628850159,40.0,0.0
29123,2,9123,[427 234 318  82 405],716,5,37785,4.14127575624726,40.0,0.0
29124,2,9124,[228 222   9  69 118],693,0,37785,4.1408219178082195,0.0,0.0
29125,2,9125,[318 588 496  98 357],786,5,37790,4.140916063992987,40.0,0.0
29126,2,9126,[318 588 496  98 357],330,5,37795,4.1410101895474964,40.0,0.0
29127,2,9127,[173 200 153 742 182],796,4,37799,4.140994741454864,0.0,0.0
29128,2,9128,[318 588 496  98 357],18,5,37804,4.141088837769745,40.0,0.0
29129,2,9129,[ 50 603 275 168 175],151,5,37809,4.14118291347207,20.0,40.0
29130,2,9130,[318 588 496  98 357],330,5,37814,4.141276968568612,40.0,0.0
29131,2,9131,[ 98  15  69  96 508],655,1,37815,4.140932982917215,0.0,0.0
29132,2,9132,[318 588 496  98 357],786,5,37820,4.141027044782656,40.0,0.0
29133,2,9133,[161  25 180 568 385],457,5,37825,4.141121086052113,0.0,0.0
29134,2,9134,[318 588 496  98 357],716,5,37830,4.141215106732348,40.0,0.0
29135,2,9135,[151 313  79 117 588],807,5,37835,4.141309106830122,0.0,0.0
29136,2,9136,[318 588 496  98 357],716,5,37840,4.141403086352194,40.0,0.0
29137,2,9137,[144  89 132 333 197],796,4,37844,4.141387612168964,0.0,0.0
29138,2,9138,[318 588 496  98 357],18,5,37849,4.141481562534194,40.0,0.0
29139,2,9139,[405 202  82 127 168],269,2,37851,4.14124726477024,0.0,20.0
29140,2,9140,[318 588 496  98 357],786,5,37856,4.141341209933268,40.0,0.0
29141,2,9141,[318 588 496  98 357],796,5,37861,4.141435134543864,40.0,0.0
29142,2,9142,[282 132  12 742 318],796,4,37865,4.14141966531773,20.0,0.0
29143,2,9143,[318 588 496  98 357],716,5,37870,4.141513560804899,40.0,0.0
29144,2,9144,[318 588 496  98 357],796,5,37875,4.141607435757244,40.0,0.0
29145,2,9145,[318 588 496  98 357],786,5,37880,4.1417012901815005,40.0,0.0
29146,2,9146,[168 215   8 496 125],796,5,37885,4.141795124084399,20.0,0.0
29147,2,9147,[318 588 496  98 357],796,5,37890,4.141888937472672,40.0,0.0
29148,2,9148,[117 181 174 172   9],236,2,37892,4.141654825664007,0.0,0.0
29149,2,9149,[258 135  97   8  22],655,1,37893,4.141311475409836,0.0,0.0
29150,2,9150,[318 588 496  98 357],450,5,37898,4.141405310894984,40.0,0.0
29151,2,9151,[172 357 210 151 186],796,3,37901,4.141280594405594,0.0,0.0
29152,2,9152,[318 588 496  98 357],786,5,37906,4.141374412760843,40.0,0.0
29153,2,9153,[318 588 496  98 357],18,5,37911,4.141468210618309,40.0,0.0
29154,2,9154,[271 182 515 161 195],655,2,37913,4.141234298197706,0.0,0.0
29155,2,9155,[183 269 483 286 161],450,4,37917,4.141218872870249,0.0,20.0
29156,2,9156,[153 328 197 294 210],655,0,37917,4.1407666266244405,0.0,0.0
29157,2,9157,[186  64  12 588 405],457,5,37922,4.140860449879886,20.0,0.0
29158,2,9158,[ 25 176 427 185 210],450,3,37925,4.140735888197401,20.0,0.0
29159,2,9159,[ 69 151 286  79 289],236,4,37929,4.140720524017468,0.0,20.0
29160,2,9160,[318 588 496  98 357],330,5,37934,4.1408143215806135,40.0,0.0
29161,2,9161,[  8 181 268 153 200],269,2,37936,4.140580659244707,0.0,0.0
29162,2,9162,[318 588 496  98 357],716,5,37941,4.140674451598821,40.0,0.0
29163,2,9163,[ 97 181 132 168   1],796,3,37944,4.1405499781754695,0.0,0.0
29164,2,9164,[318 588 496  98 357],716,5,37949,4.1406437534097105,40.0,0.0
29165,2,9165,[318 588 496  98 357],796,5,37954,4.140737508182413,40.0,0.0
29166,2,9166,[318 588 496  98 357],796,5,37959,4.140831242500273,40.0,0.0
29167,2,9167,[174 200  95  64  28],796,4,37963,4.140815881326352,20.0,0.0
29168,2,9168,[318 588 496  98 357],330,5,37968,4.140909586650671,40.0,0.0
29169,2,9169,[191  79 125 222 258],798,3,37971,4.140785169029444,0.0,0.0
29170,2,9170,[546  95  12 100 197],796,3,37974,4.140660778541053,0.0,20.0
29171,2,9171,[197 238 174 153  79],796,3,37977,4.140536415176625,0.0,0.0
29172,2,9172,[ 22 100 135  25  88],11,3,37980,4.1404120789272865,0.0,20.0
29173,2,9173,[179 100 168 403  97],457,5,37985,4.140505777196425,0.0,20.0
29174,2,9174,[318 588 496  98 357],450,5,37990,4.140599455040872,40.0,0.0
29175,2,9175,[ 56 111 286  15 483],151,5,37995,4.140693112467306,0.0,20.0
29176,2,9176,[ 96  95 174 222 173],716,4,37999,4.140677781410047,0.0,0.0
29177,2,9177,[168  71 132 100   1],577,5,38004,4.140771409893223,0.0,20.0
29178,2,9178,[216  22 237  69 423],11,3,38007,4.140647129316919,0.0,0.0
29179,2,9179,[318 588 496  98 357],716,5,38012,4.140740740740741,40.0,0.0
29180,2,9180,[546 132 269   9 302],344,4,38016,4.140725411175254,0.0,0.0
29181,2,9181,[194 202 196 357 183],504,2,38018,4.140492267479852,0.0,0.0
29182,2,9182,[144 153 215 222 742],796,4,38022,4.14047696831101,0.0,0.0
29183,2,9183,[318 588 496  98 357],786,5,38027,4.140570557491289,40.0,0.0
29184,2,9184,[176  71 597 196 204],796,5,38032,4.140664126292869,0.0,0.0
29185,2,9185,[318 588 496  98 357],716,5,38037,4.140757674722404,40.0,0.0
29186,2,9186,[210 322 132 245 275],344,3,38040,4.140633503864156,0.0,20.0
29187,2,9187,[318 143 197 161 211],450,5,38045,4.140727035263387,20.0,0.0
29188,2,9188,[603  98 144  97  28],716,4,38049,4.140711720535423,20.0,0.0
29189,2,9189,[132 258 222 357 403],655,1,38050,4.140369967355822,0.0,0.0
29190,2,9190,[496 385 301 258 191],151,3,38053,4.14024589272114,20.0,0.0
29191,2,9191,[ 89 302 435  50 322],450,5,38058,4.1403394255874675,0.0,20.0
29192,2,9192,[161 182 288 471 678],280,2,38060,4.140106602849994,0.0,0.0
29193,2,9193,[603 153  71 168 151],389,4,38064,4.140091363933,20.0,0.0
29194,2,9194,[603 313 187 200 268],655,4,38068,4.140076128330614,20.0,0.0
29195,2,9195,[318 588 496  98 357],450,5,38073,4.140169638973466,40.0,0.0
29196,2,9196,[ 64  50 597 181 265],796,5,38078,4.140263129281287,20.0,20.0
29197,2,9197,[318 588 496  98 357],786,5,38083,4.140356599260709,40.0,0.0
29198,2,9198,[655 275  11 546 200],457,4,38087,4.140341341450157,0.0,20.0
29199,2,9199,[111 568 423 187 748],450,5,38092,4.140434782608696,0.0,0.0
29200,2,9200,[151 191 496 173 210],389,3,38095,4.1403108357787195,20.0,0.0
29201,2,9201,[318 588 496  98 357],796,5,38100,4.140404259943491,40.0,0.0
29202,2,9202,[ 82 143  98 181 216],450,4,38104,4.1403890035857875,0.0,0.0
29203,2,9203,[ 15  25 179 180 132],18,4,38108,4.140373750543242,0.0,0.0
29204,2,9204,[318 588 496  98 357],450,5,38113,4.140467137425312,40.0,0.0
29205,2,9205,[742 182 435 357 328],450,5,38118,4.140560504019118,0.0,0.0
29206,2,9206,[318 588 496  98 357],796,5,38123,4.14065385033127,40.0,0.0
29207,2,9207,[121 173 194 603  96],796,5,38128,4.140747176368375,20.0,0.0
29208,2,9208,[176 197 546 265 174],457,4,38132,4.140731892713649,0.0,0.0
29209,2,9209,[328 127  12 435 210],450,4,38136,4.14071661237785,0.0,20.0
29210,2,9210,[ 56 234 187   8 216],655,2,38138,4.1404842036695255,0.0,0.0
29211,2,9211,[215  98  56   9 194],504,3,38141,4.140360399478941,0.0,0.0
29212,2,9212,[318 588 496  98 357],450,5,38146,4.140453706718767,40.0,0.0
29213,2,9213,[  7 176 168  95 204],577,4,38150,4.140438463208161,0.0,0.0
29214,2,9214,[318 588 496  98 357],18,5,38155,4.1405317417254475,40.0,0.0
29215,2,9215,[211 196   9  70  89],18,3,38158,4.140407986111111,0.0,0.0
29216,2,9216,[318 588 496  98 357],796,5,38163,4.140501247694478,40.0,0.0
29217,2,9217,[215 275   4  69 182],457,5,38168,4.140594489043177,0.0,20.0
29218,2,9218,[301 357 322 211 153],593,4,38172,4.140579238529124,0.0,0.0
29219,2,9219,[318 588 496  98 357],18,5,38177,4.140672451193058,40.0,0.0
29220,2,9220,[318 588 496  98 357],716,5,38182,4.140765643639519,40.0,0.0
29221,2,9221,[132  12 202 423 742],655,0,38182,4.140316634135762,0.0,0.0
29222,2,9222,[318 588 496  98 357],18,5,38187,4.140409844952836,40.0,0.0
29223,2,9223,[125  28 588 423 132],450,5,38192,4.14050303555941,0.0,0.0
29224,2,9224,[405 273   7 237 288],344,3,38195,4.140379403794038,0.0,0.0
29225,2,9225,[235 328 100 403 210],450,3,38198,4.140255798829395,0.0,20.0
29226,2,9226,[ 96   9 117  97   4],256,5,38203,4.140348975831798,0.0,0.0
29227,2,9227,[ 15 357 127 603 655],731,5,38208,4.140442132639792,20.0,20.0
29228,2,9228,[  8  82 117 204 186],457,5,38213,4.140535269259941,0.0,0.0
29229,2,9229,[318 588 496  98 357],796,5,38218,4.140628385698808,40.0,0.0
29230,2,9230,[318 588 496  98 357],796,5,38223,4.1407214819629505,40.0,0.0
29231,2,9231,[318 588 496  98 357],786,5,38228,4.140814558058925,40.0,0.0
29232,2,9232,[257 153 197  69 588],330,5,38233,4.140907613993285,0.0,0.0
29233,2,9233,[282 118 200 117 143],716,3,38236,4.140784058912714,0.0,0.0
29234,2,9234,[282  12 655 237  89],457,5,38241,4.140877097996752,0.0,0.0
29235,2,9235,[  1 742 423   4 302],450,4,38245,4.140861844954526,0.0,0.0
29236,2,9236,[318 588 496  98 357],796,5,38250,4.140954855472556,40.0,0.0
29237,2,9237,[318 588 496  98 357],330,5,38255,4.141047845854081,40.0,0.0
29238,2,9238,[318 588 496  98 357],786,5,38260,4.141140816105639,40.0,0.0
29239,2,9239,[318 588 496  98 357],716,5,38265,4.141233766233766,40.0,0.0
29240,2,9240,[127 180  79 135 194],18,3,38268,4.141110269451358,0.0,20.0
29241,2,9241,[118 135   8 238 111],655,1,38269,4.140770396018178,0.0,0.0
29242,2,9242,[678 318  95 118 181],280,2,38271,4.140538786108406,20.0,0.0
29243,2,9243,[318 588 496  98 357],330,5,38276,4.140631761142362,40.0,0.0
29244,2,9244,[318 588 496  98 357],796,5,38281,4.140724716062737,40.0,0.0
29245,2,9245,[ 12 568 196  69 222],450,4,38285,4.140709495998269,0.0,0.0
29246,2,9246,[318 588 496  98 357],450,5,38290,4.140802422407267,40.0,0.0
29247,2,9247,[288 435  25 318 289],655,1,38291,4.140462802768166,20.0,0.0
29248,2,9248,[423 258 313  96 144],450,5,38296,4.140555735755217,0.0,0.0
29249,2,9249,[  4 275 185 222 508],655,2,38298,4.140324324324324,0.0,20.0
29250,2,9250,[191  79 597  71 237],796,5,38303,4.140417252188953,0.0,0.0
29251,2,9251,[318 588 496  98 357],450,5,38308,4.140510159965413,40.0,0.0
29252,2,9252,[318 588 496  98 357],716,5,38313,4.1406030476602185,40.0,0.0
29253,2,9253,[265 289 153 333 385],655,0,38313,4.140155608385563,0.0,0.0
29254,2,9254,[161  56 117 204 301],796,4,38317,4.140140464613722,0.0,0.0
29255,2,9255,[265 210 300 174  98],151,5,38322,4.140233362143475,0.0,0.0
29256,2,9256,[318 588 496  98 357],450,5,38327,4.140326239602463,40.0,0.0
29257,2,9257,[318 588 496  98 357],330,5,38332,4.140419096997191,40.0,0.0
29258,2,9258,[125 173 357   4  89],151,5,38337,4.140511934334161,0.0,0.0
29259,2,9259,[318 588 496  98 357],716,5,38342,4.14060475161987,40.0,0.0
29260,2,9260,[318 588 496  98 357],716,5,38347,4.140697548860814,40.0,0.0
29261,2,9261,[318 588 496  98 357],716,5,38352,4.1407903260634855,40.0,0.0
29262,2,9262,[318 588 496  98 357],716,5,38357,4.140883083234374,40.0,0.0
29263,2,9263,[588 258  25 185  11],450,4,38361,4.140867875647668,0.0,0.0
29264,2,9264,[318 588 496  98 357],786,5,38366,4.140960604425256,40.0,0.0
29265,2,9265,[318 588 496  98 357],716,5,38371,4.141053313187999,40.0,0.0
29266,2,9266,[318 588 496  98 357],450,5,38376,4.141146001942376,40.0,0.0
29267,2,9267,[276 403  25 194  97],504,2,38378,4.140914976262408,0.0,0.0
29268,2,9268,[302  11  25 228 237],344,3,38381,4.140791886934944,0.0,0.0
29269,2,9269,[194 127  79 265  56],450,5,38386,4.140884573894283,0.0,20.0
29270,2,9270,[318 588 496  98 357],716,5,38391,4.140977240858591,40.0,0.0
29271,2,9271,[318 588 496  98 357],330,5,38396,4.14106988783434,40.0,0.0
29272,2,9272,[  9 200 475  89 204],269,3,38399,4.140946834897012,0.0,0.0
29273,2,9273,[  7 483 172 117 191],450,4,38403,4.14093163683416,0.0,0.0
29274,2,9274,[318 588 496  98 357],796,5,38408,4.141024258760107,40.0,0.0
29275,2,9275,[172  96 161 121  12],256,4,38412,4.141009055627426,0.0,0.0
29276,2,9276,[  7 153 144 111 265],292,4,38416,4.14099385577234,0.0,0.0
29277,2,9277,[318 588 496  98 357],786,5,38421,4.141086441043329,40.0,0.0
29278,2,9278,[118   1 403 161 135],72,3,38424,4.140963465890721,0.0,0.0
29279,2,9279,[ 97  71  69 187   8],18,4,38428,4.140948275862069,0.0,0.0
29280,2,9280,[ 15 172 238 483  95],389,3,38431,4.140825342096757,0.0,0.0
29281,2,9281,[318 588 496  98 357],716,5,38436,4.140917905623788,40.0,0.0
29282,2,9282,[318 588 496  98 357],450,5,38441,4.14101044920823,40.0,0.0
29283,2,9283,[318 588 496  98 357],18,5,38446,4.141102972856527,40.0,0.0
29284,2,9284,[318 588 496  98 357],18,5,38451,4.141195476575121,40.0,0.0
29285,2,9285,[118 222 385 191  11],457,5,38456,4.14128796037045,0.0,0.0
29286,2,9286,[ 82 202 180 161  64],269,1,38457,4.140949714654894,20.0,0.0
29287,2,9287,[318  28 153 275 273],796,3,38460,4.140826873385013,20.0,20.0
29288,2,9288,[176  28 117 234 385],504,3,38463,4.140704058563893,0.0,0.0
29289,2,9289,[318 588 496  98 357],786,5,38468,4.140796555435952,40.0,0.0
29290,2,9290,[191  71 143 235  95],23,1,38469,4.140458508233775,0.0,0.0
29291,2,9291,[ 97   9   7 328 313],655,1,38470,4.140120533792509,0.0,0.0
29292,2,9292,[318 588 496  98 357],18,5,38475,4.1402130635962555,40.0,0.0
29293,2,9293,[258 322 228 197 273],796,2,38477,4.13998278459221,0.0,0.0
29294,2,9294,[318 588 496  98 357],716,5,38482,4.140075309306079,40.0,0.0
29295,2,9295,[318 588 496  98 357],786,5,38487,4.140167814113597,40.0,0.0
29296,2,9296,[597 127  98 228 313],450,5,38492,4.14026029902119,0.0,20.0
29297,2,9297,[318 588 496  98 357],18,5,38497,4.140352764035276,40.0,0.0
29298,2,9298,[318 588 496  98 357],330,5,38502,4.140445209162276,40.0,0.0
29299,2,9299,[318 588 496  98 357],786,5,38507,4.140537634408602,40.0,0.0
29300,2,9300,[403  15 196 172 222],655,1,38508,4.140199978496936,0.0,0.0
29301,2,9301,[318 588 496  98 357],330,5,38513,4.140292410234358,40.0,0.0
29302,2,9302,[ 88 301 194  82 655],796,2,38515,4.1400623454799526,0.0,0.0
29303,2,9303,[ 79 385   7 235 322],344,2,38517,4.1398323301805675,0.0,0.0
29304,2,9304,[176 174  56 403 289],655,0,38517,4.139387426114992,0.0,0.0
29305,2,9305,[318 588 496  98 357],796,5,38522,4.139479905437352,40.0,0.0
29306,2,9306,[318 588 496  98 357],330,5,38527,4.139572364886645,40.0,0.0
29307,2,9307,[258 195  12  64 222],450,4,38531,4.139557370004297,20.0,0.0
29308,2,9308,[ 88 357 286 153  50],450,5,38536,4.13964980126759,0.0,40.0
29309,2,9309,[118  97 328 144 405],655,0,38536,4.1392051557465095,0.0,0.0
29310,2,9310,[318 588 496  98 357],786,5,38541,4.139297604983353,40.0,0.0
29311,2,9311,[318 588 496  98 357],450,5,38546,4.139390034364261,40.0,0.0
29312,2,9312,[318 588 496  98 357],716,5,38551,4.13948244389563,40.0,0.0
29313,2,9313,[318 588 496  98 357],450,5,38556,4.139574833583852,40.0,0.0
29314,2,9314,[ 88 111 194 127 265],878,4,38560,4.139559849704777,0.0,20.0
29315,2,9315,[655 238 328 286 273],796,1,38561,4.13922284242164,0.0,20.0
29316,2,9316,[211  22 153  28  96],796,3,38564,4.139100568852635,0.0,0.0
29317,2,9317,[318 588 496  98 357],786,5,38569,4.139192959862632,40.0,0.0
29318,2,9318,[ 12 300 216   9 211],796,3,38572,4.139070715742032,0.0,0.0
29319,2,9319,[318 588 496  98 357],716,5,38577,4.139163090128755,40.0,0.0
29320,2,9320,[318 588 496  98 357],450,5,38582,4.139255444694776,40.0,0.0
29321,2,9321,[185 742 483 135  98],450,3,38585,4.139133233211757,0.0,0.0
29322,2,9322,[318 588 496  98 357],330,5,38590,4.139225571168079,40.0,0.0
29323,2,9323,[318 588 496  98 357],796,5,38595,4.13931788931789,40.0,0.0
29324,2,9324,[603  79 265 179 196],535,3,38598,4.139195710455764,20.0,0.0
29325,2,9325,[222 357 100 183   4],450,3,38601,4.1390735577954105,0.0,20.0
29326,2,9326,[318 588 496  98 357],796,5,38606,4.1391658625495875,40.0,0.0
29327,2,9327,[174 176   9 403 385],280,2,38608,4.138936535162951,0.0,0.0
29328,2,9328,[318 588 496  98 357],18,5,38613,4.139028834816164,40.0,0.0
29329,2,9329,[318 588 496  98 357],330,5,38618,4.139121114683816,40.0,0.0
29330,2,9330,[318 588 496  98 357],796,5,38623,4.139213374772265,40.0,0.0
29331,2,9331,[ 64 282 234  97 179],450,4,38627,4.139198456922418,20.0,0.0
29332,2,9332,[313 655 176 435   7],450,5,38632,4.139290688953177,0.0,0.0
29333,2,9333,[318 588 496  98 357],450,5,38637,4.1393829012213414,40.0,0.0
29334,2,9334,[151 176 132  50  22],716,4,38641,4.139367970005356,0.0,20.0
29335,2,9335,[ 82  28 202 111 168],151,4,38645,4.139353041988003,0.0,0.0
29336,2,9336,[  1 182  64 222 471],655,2,38647,4.139123915604584,20.0,0.0
29337,2,9337,[318 588 496  98 357],450,5,38652,4.139216106232598,40.0,0.0
29338,2,9338,[318 588 496  98 357],786,5,38657,4.139308277117465,40.0,0.0
29339,2,9339,[ 82 276 195 405 117],786,4,38661,4.139293361884368,0.0,0.0
29340,2,9340,[182 197 282 546  70],457,4,38665,4.13927844984477,0.0,0.0
29341,2,9341,[318 588 496  98 357],18,5,38670,4.139370584457289,40.0,0.0
29342,2,9342,[318 588 496  98 357],330,5,38675,4.139462699347105,40.0,0.0
29343,2,9343,[318 588 496  98 357],796,5,38680,4.1395547945205475,40.0,0.0
29344,2,9344,[216 210 222  28   7],450,3,38683,4.139432851792402,0.0,0.0
29345,2,9345,[186 515 197 180  98],716,3,38686,4.139310935159426,0.0,0.0
29346,2,9346,[318 588 496  98 357],786,5,38691,4.139403017010806,40.0,0.0
29347,2,9347,[174 286 181 185  56],151,5,38696,4.139495079161318,0.0,20.0
29348,2,9348,[222 186 117 423 168],796,4,38700,4.139480158305701,0.0,0.0
29349,2,9349,[318 588 496  98 357],18,5,38705,4.139572192513369,40.0,0.0
29350,2,9350,[318 588 496  98 357],450,5,38710,4.139664207036681,40.0,0.0
29351,2,9351,[121  71 265 186 172],577,5,38715,4.1397562018819505,0.0,0.0
29352,2,9352,[318 588 496  98 357],786,5,38720,4.13984817705549,40.0,0.0
29353,2,9353,[318 588 496  98 357],796,5,38725,4.139940132563609,40.0,0.0
29354,2,9354,[211  50 195  79 238],716,4,38729,4.139925173703902,0.0,20.0
29355,2,9355,[186 318 322 125 275],450,4,38733,4.139910218041898,20.0,20.0
29356,2,9356,[318 588 496  98 357],796,5,38738,4.140002137437213,40.0,0.0
29357,2,9357,[196 168 385 275 403],457,5,38743,4.140094037187433,0.0,20.0
29358,2,9358,[427  69 597  56  70],269,2,38745,4.139865370231862,20.0,0.0
29359,2,9359,[318 588 496  98 357],786,5,38750,4.139957264957265,40.0,0.0
29360,2,9360,[318 588 496  98 357],330,5,38755,4.14004914004914,40.0,0.0
29361,2,9361,[405 100 173 742  96],344,3,38758,4.139927365947447,0.0,20.0
29362,2,9362,[ 15 222 100 496 117],450,3,38761,4.139805617857524,20.0,20.0
29363,2,9363,[187 196 269 215 245],450,5,38766,4.139897479709526,0.0,0.0
29364,2,9364,[496 215 603 121 196],151,4,38770,4.139882541377469,40.0,0.0
29365,2,9365,[197 180 301 153 258],450,5,38775,4.139974375400384,0.0,0.0
29366,2,9366,[187  50 318 168  71],316,1,38776,4.139639158748799,20.0,20.0
29367,2,9367,[357 237  96 318 143],504,4,38780,4.1396242527754055,20.0,0.0
29368,2,9368,[318 588 496  98 357],18,5,38785,4.139716084961042,40.0,0.0
29369,2,9369,[200 172 235 597  98],457,3,38788,4.139594450373533,0.0,0.0
29370,2,9370,[118 191 100 603 185],655,3,38791,4.139472841745811,20.0,20.0
29371,2,9371,[318 588 496  98 357],716,5,38796,4.139564660691422,40.0,0.0
29372,2,9372,[318 588 496  98 357],796,5,38801,4.13965646004481,40.0,0.0
29373,2,9373,[168 405 286 742 258],11,2,38803,4.139428205675272,0.0,20.0
29374,2,9374,[161 117  64 210 403],655,1,38804,4.139093333333333,20.0,0.0
29375,2,9375,[496 153 144 483   9],796,4,38808,4.139078498293515,20.0,0.0
29376,2,9376,[318 588 496  98 357],330,5,38813,4.139170310333795,40.0,0.0
29377,2,9377,[318 588 496  98 357],330,5,38818,4.139262102793773,40.0,0.0
29378,2,9378,[173  98  28 174 111],577,5,38823,4.13935387567971,0.0,0.0
29379,2,9379,[318 588 496  98 357],18,5,38828,4.139445628997867,40.0,0.0
29380,2,9380,[  7 211 180 435 515],535,4,38832,4.139430764310841,0.0,0.0
29381,2,9381,[318 588 496  98 357],330,5,38837,4.139522489874227,40.0,0.0
29382,2,9382,[318 588 496  98 357],716,5,38842,4.139614195886177,40.0,0.0
29383,2,9383,[121  89 234 172 185],269,1,38843,4.139279624893436,0.0,0.0
29384,2,9384,[ 71 215 118 168   7],450,3,38846,4.139158231220032,0.0,0.0
29385,2,9385,[182 496  56 275 204],796,5,38851,4.139249946729171,20.0,20.0
29386,2,9386,[318 588 496  98 357],330,5,38856,4.139341642697348,40.0,0.0
29387,2,9387,[318 588 496  98 357],18,5,38861,4.139433319130806,40.0,0.0
29388,2,9388,[471   8 301 508   7],344,4,38865,4.139418468420492,0.0,0.0
29389,2,9389,[318 588 496  98 357],786,5,38870,4.1395101171459,40.0,0.0
29390,2,9390,[191 603 186 127  89],655,4,38874,4.139495261420509,20.0,20.0
29391,2,9391,[318 588 496  98 357],450,5,38879,4.139586882453152,40.0,0.0
29392,2,9392,[318 588 496  98 357],716,5,38884,4.13967848397743,40.0,0.0
29393,2,9393,[333 568 195  11  88],655,0,38884,4.139237811368959,0.0,0.0
29394,2,9394,[300 357  22 176 245],796,4,38888,4.139222990952635,0.0,0.0
29395,2,9395,[318 588 496  98 357],330,5,38893,4.13931460195828,40.0,0.0
29396,2,9396,[318 588 496  98 357],796,5,38898,4.139406193466,40.0,0.0
29397,2,9397,[318 289 427 435 282],655,2,38900,4.139178548627368,40.0,0.0
29398,2,9398,[234 228 471 427 289],807,4,38904,4.139163740823492,20.0,0.0
29399,2,9399,[318 588 496  98 357],330,5,38909,4.139255319148936,40.0,0.0
29400,2,9400,[318 588 496  98 357],450,5,38914,4.139346877991703,40.0,0.0
29401,2,9401,[318 588 496  98 357],716,5,38919,4.139438417358009,40.0,0.0
29402,2,9402,[423  50 405  96  82],655,1,38920,4.139104541103903,0.0,20.0
29403,2,9403,[318 588 496  98 357],330,5,38925,4.1391960867715865,40.0,0.0
29404,2,9404,[568 175  11  56  12],655,0,38925,4.138755980861244,0.0,0.0
29405,2,9405,[471 483 127  69 405],807,4,38929,4.138741229002764,0.0,20.0
29406,2,9406,[245 271 257 151 118],796,4,38933,4.138726480280642,0.0,0.0
29407,2,9407,[318 588 496  98 357],716,5,38938,4.138818027210885,40.0,0.0
29408,2,9408,[269 200 176 294 135],450,3,38941,4.138696992241471,0.0,0.0
29409,2,9409,[318 588 496  98 357],786,5,38946,4.138788522848034,40.0,0.0
29410,2,9410,[318 588 496  98 357],716,5,38951,4.138880034002763,40.0,0.0
29411,2,9411,[318 588 496  98 357],18,5,38956,4.138971525711857,40.0,0.0
29412,2,9412,[318 588 496  98 357],18,5,38961,4.139062997981515,40.0,0.0
29413,2,9413,[318 588 496  98 357],716,5,38966,4.139154450817931,40.0,0.0
29414,2,9414,[318 588 496  98 357],330,5,38971,4.139245884227297,40.0,0.0
29415,2,9415,[318 588 496  98 357],450,5,38976,4.1393372982158025,40.0,0.0
29416,2,9416,[318 588 496  98 357],716,5,38981,4.139428692789636,40.0,0.0
29417,2,9417,[318 588 496  98 357],330,5,38986,4.1395200679549795,40.0,0.0
29418,2,9418,[318 588 496  98 357],796,5,38991,4.139611423718017,40.0,0.0
29419,2,9419,[194  11   1 202  56],716,5,38996,4.139702760084925,0.0,0.0
29420,2,9420,[318 588 496  98 357],18,5,39001,4.139794077061883,40.0,0.0
29421,2,9421,[238 318 237 597  15],457,4,39005,4.139779240076417,20.0,0.0
29422,2,9422,[153  50 132 100  95],450,4,39009,4.139764406240051,0.0,40.0
29423,2,9423,[194 125 655 143  82],450,4,39013,4.139749575551782,0.0,0.0
29424,2,9424,[318 588 496  98 357],450,5,39018,4.139840848806366,40.0,0.0
29425,2,9425,[318 588 496  98 357],716,5,39023,4.139932102694674,40.0,0.0
29426,2,9426,[ 28 323 179 100 313],639,1,39024,4.139599024079771,0.0,20.0
29427,2,9427,[318 588 496  98 357],330,5,39029,4.139690284259652,40.0,0.0
29428,2,9428,[191 132 258 286 215],450,5,39034,4.139781525082193,0.0,20.0
29429,2,9429,[ 88  11 216 301 132],344,3,39037,4.13966065747614,0.0,0.0
29430,2,9430,[276 195 202  96 265],280,3,39040,4.139539815502068,0.0,0.0
29431,2,9431,[196  88 186 222 202],151,5,39045,4.139631043256998,0.0,0.0
29432,2,9432,[318 588 496  98 357],18,5,39050,4.13972225166967,40.0,0.0
29433,2,9433,[ 50  64 216 403 181],796,5,39055,4.139813440746237,20.0,20.0
29434,2,9434,[118  70 471 194 228],450,4,39059,4.139798622151563,0.0,0.0
29435,2,9435,[318 588 496  98 357],716,5,39064,4.139889783806698,40.0,0.0
29436,2,9436,[318 588 496  98 357],716,5,39069,4.139980926141782,40.0,0.0
29437,2,9437,[174  70 222 294 483],457,4,39073,4.139966094511549,0.0,0.0
29438,2,9438,[403  95 182 238 172],450,4,39077,4.139951266023943,0.0,0.0
29439,2,9439,[265 194 121  50 423],151,5,39082,4.140042372881356,0.0,20.0
29440,2,9440,[515 191 216 288  82],655,3,39085,4.139921618472619,0.0,0.0
29441,2,9441,[318 588 496  98 357],796,5,39090,4.140012709171786,40.0,0.0
29442,2,9442,[603 313   1 385  11],655,2,39092,4.139786084930637,20.0,0.0
29443,2,9443,[  1  70 216 288   4],457,5,39097,4.139877170690386,0.0,0.0
29444,2,9444,[151 143 300 144 222],796,5,39102,4.1399682371625195,0.0,0.0
29445,2,9445,[118  97  56 568  89],457,5,39107,4.140059284353165,0.0,0.0
29446,2,9446,[194 423 301 197  15],450,4,39111,4.140044458558273,0.0,0.0
29447,2,9447,[183 588 100 318 405],796,4,39115,4.1400296359017785,20.0,20.0
29448,2,9448,[318 588 496  98 357],450,5,39120,4.140120647687586,40.0,0.0
29449,2,9449,[318 588 496  98 357],796,5,39125,4.14021164021164,40.0,0.0
29450,2,9450,[181 496 111 228 385],796,5,39130,4.140302613480055,20.0,0.0
29451,2,9451,[318 588 496  98 357],450,5,39135,4.140393567498942,40.0,0.0
29452,2,9452,[181  82  28 186   7],577,4,39139,4.140378715751614,0.0,0.0
29453,2,9453,[318 588 496  98 357],786,5,39144,4.140469642479374,40.0,0.0
29454,2,9454,[318 588 496  98 357],330,5,39149,4.140560549973559,40.0,0.0
29455,2,9455,[318 588 496  98 357],716,5,39154,4.140651438240271,40.0,0.0
29456,2,9456,[318 588 496  98 357],786,5,39159,4.140742307285609,40.0,0.0
29457,2,9457,[318 588 496  98 357],796,5,39164,4.14083315711567,40.0,0.0
29458,2,9458,[222 300  95 181 210],450,2,39166,4.140606829474574,0.0,0.0
29459,2,9459,[185 127 238 328 655],450,5,39171,4.140697674418605,0.0,20.0
29460,2,9460,[318 588 496  98 357],716,5,39176,4.140788500158545,40.0,0.0
29461,2,9461,[111 211  15 328  22],796,4,39180,4.140773620798986,0.0,0.0
29462,2,9462,[318 588 496  98 357],796,5,39185,4.140864419317341,40.0,0.0
29463,2,9463,[427  97 318  88 405],796,4,39189,4.140849535080305,40.0,0.0
29464,2,9464,[ 69 173  95 111 385],796,5,39194,4.14094030639197,0.0,0.0
29465,2,9465,[318 588 496  98 357],796,5,39199,4.1410310585252486,40.0,0.0
29466,2,9466,[318 588 496  98 357],786,5,39204,4.141121791486215,40.0,0.0
29467,2,9467,[318 588 496  98 357],18,5,39209,4.141212505280946,40.0,0.0
29468,2,9468,[234 216 483 196 357],693,2,39211,4.140986376597318,0.0,0.0
29469,2,9469,[318 588 496  98 357],330,5,39216,4.141077085533263,40.0,0.0
29470,2,9470,[222 427 187  28 546],450,4,39220,4.141062189842677,20.0,0.0
29471,2,9471,[135 427  96 597 435],450,4,39224,4.141047297297297,20.0,0.0
29472,2,9472,[318 588 496  98 357],18,5,39229,4.141137971075689,40.0,0.0
29473,2,9473,[318 588 496  98 357],786,5,39234,4.141228625712476,40.0,0.0
29474,2,9474,[318 588 496  98 357],796,5,39239,4.14131926121372,40.0,0.0
29475,2,9475,[318 588 496  98 357],796,5,39244,4.141409877585479,40.0,0.0
29476,2,9476,[118 204 568 508  69],655,0,39244,4.140972881713623,0.0,0.0
29477,2,9477,[289 385 111  95 191],786,5,39249,4.141063515509601,0.0,0.0
29478,2,9478,[318 588 496  98 357],330,5,39254,4.1411541301825086,40.0,0.0
29479,2,9479,[357  64  96 258 182],796,5,39259,4.141244725738397,20.0,0.0
29480,2,9480,[318 588 496  98 357],450,5,39264,4.141335302183314,40.0,0.0
29481,2,9481,[318 588 496  98 357],786,5,39269,4.1414258595233076,40.0,0.0
29482,2,9482,[  7  88 196  50 423],151,5,39274,4.141516397764421,0.0,20.0
29483,2,9483,[ 96 742 215 182 216],280,3,39277,4.141396035428089,0.0,0.0
29484,2,9484,[318 588 496  98 357],796,5,39282,4.14148655772272,40.0,0.0
29485,2,9485,[ 64 185 496 483   4],796,5,39287,4.141577060931899,40.0,0.0
29486,2,9486,[125  88 161 385 185],796,5,39292,4.141667545061663,0.0,0.0
29487,2,9487,[318 588 496  98 357],18,5,39297,4.141758010118044,40.0,0.0
29488,2,9488,[258 210   4 174  56],629,4,39301,4.141743070924228,0.0,0.0
29489,2,9489,[318 588 496  98 357],786,5,39306,4.141833508956797,40.0,0.0
29490,2,9490,[ 50 151 191 289 204],296,3,39309,4.141713201980824,0.0,20.0
29491,2,9491,[200  28 204 483 121],796,4,39313,4.141698272229245,0.0,0.0
29492,2,9492,[204 182 100 403  88],280,0,39313,4.141261982513431,0.0,20.0
29493,2,9493,[318 588 496  98 357],330,5,39318,4.141352433115652,40.0,0.0
29494,2,9494,[318 588 496  98 357],716,5,39323,4.141442864665613,40.0,0.0
29495,2,9495,[182 117 179 135 161],450,4,39327,4.14142796967144,0.0,0.0
29496,2,9496,[357 191 127 271 117],796,5,39332,4.141518374223439,0.0,20.0
29497,2,9497,[144 748 234 275 265],450,4,39336,4.141503474415666,0.0,20.0
29498,2,9498,[318 588 496  98 357],450,5,39341,4.141593851984419,40.0,0.0
29499,2,9499,[318 588 496  98 357],716,5,39346,4.141684210526316,40.0,0.0
29500,2,9500,[471  88 546 196 322],786,4,39350,4.141669297968635,0.0,0.0
29501,2,9501,[318 588 496  98 357],330,5,39355,4.141759629551673,40.0,0.0
29502,2,9502,[127 185  88 121  56],256,4,39359,4.141744712196148,0.0,20.0
29503,2,9503,[ 97 111   4  64 286],151,5,39364,4.141835016835016,20.0,20.0
29504,2,9504,[143 238 197 181 161],716,4,39368,4.141820094687007,0.0,0.0
29505,2,9505,[ 95 185 181 235 183],23,3,39371,4.141699978960657,0.0,0.0
29506,2,9506,[588 471 143 597 118],807,5,39376,4.1417902598085625,0.0,0.0
29507,2,9507,[318 588 496  98 357],18,5,39381,4.141880521665965,40.0,0.0
29508,2,9508,[174 175 127 197  69],655,1,39382,4.141550110421706,0.0,20.0
29509,2,9509,[ 50 222 323 276 748],256,4,39386,4.141535226077813,0.0,20.0
29510,2,9510,[318 588 496  98 357],18,5,39391,4.141625486279045,40.0,0.0
29511,2,9511,[100 405 471 125 302],401,2,39393,4.141400336417157,0.0,20.0
29512,2,9512,[318 588 496  98 357],796,5,39398,4.141490591821718,40.0,0.0
29513,2,9513,[318 588 496  98 357],796,5,39403,4.141580828253101,40.0,0.0
29514,2,9514,[318 588 496  98 357],796,5,39408,4.141671045717288,40.0,0.0
29515,2,9515,[318 588 496  98 357],786,5,39413,4.141761244220261,40.0,0.0
29516,2,9516,[318 588 496  98 357],330,5,39418,4.141851423767994,40.0,0.0
29517,2,9517,[ 28 275 435  97  89],655,2,39420,4.14162639209918,0.0,20.0
29518,2,9518,[318 588 496  98 357],330,5,39425,4.141716566866267,40.0,0.0
29519,2,9519,[183 318 191 496   7],450,5,39430,4.141806722689076,40.0,0.0
29520,2,9520,[111  28  64 496  12],450,5,39435,4.141896859573574,40.0,0.0
29521,2,9521,[181  50  64 215   1],796,4,39439,4.141881957571939,20.0,20.0
29522,2,9522,[121 181 237  79 151],256,5,39444,4.1419720676257485,0.0,0.0
29523,2,9523,[135  22  70 182 276],280,4,39448,4.141957160856783,0.0,0.0
29524,2,9524,[ 69  25 222 235 204],5,3,39451,4.141837270341207,0.0,0.0
29525,2,9525,[ 97  22   7 282 118],457,5,39456,4.141927356707957,0.0,0.0
29526,2,9526,[318 588 496  98 357],18,5,39461,4.142017424162906,40.0,0.0
29527,2,9527,[ 64 216 175 100  98],655,3,39464,4.1418975650713685,20.0,20.0
29528,2,9528,[318 588 496  98 357],450,5,39469,4.141987616748872,40.0,0.0
29529,2,9529,[318 588 496  98 357],796,5,39474,4.142077649527807,40.0,0.0
29530,2,9530,[318 588 496  98 357],330,5,39479,4.1421676634141225,40.0,0.0
29531,2,9531,[318 588 496  98 357],330,5,39484,4.142257658413764,40.0,0.0
29532,2,9532,[318 588 496  98 357],450,5,39489,4.142347634532676,40.0,0.0
29533,2,9533,[423 197 204  15 135],151,5,39494,4.142437591776799,0.0,0.0
29534,2,9534,[318 588 496  98 357],450,5,39499,4.142527530152071,40.0,0.0
29535,2,9535,[318 588 496  98 357],796,5,39504,4.14261744966443,40.0,0.0
29536,2,9536,[245 588 216 237 144],796,4,39508,4.142602495543672,0.0,0.0
29537,2,9537,[196 216 195  56 182],269,2,39510,4.142377856993081,0.0,0.0
29538,2,9538,[ 79  95 655 237 568],716,5,39515,4.142467763916553,0.0,0.0
29539,2,9539,[318 588 496  98 357],786,5,39520,4.1425576519916145,40.0,0.0
29540,2,9540,[318 588 496  98 357],796,5,39525,4.14264752122419,40.0,0.0
29541,2,9541,[318 588 496  98 357],716,5,39530,4.142737371620205,40.0,0.0
29542,2,9542,[183  98 234 196 603],269,2,39532,4.142512836634182,20.0,0.0
29543,2,9543,[318 588 496  98 357],786,5,39537,4.142602682313496,40.0,0.0
29544,2,9544,[318 588 496  98 357],330,5,39542,4.142692509167103,40.0,0.0
29545,2,9545,[318 588 496  98 357],18,5,39547,4.142782317200922,40.0,0.0
29546,2,9546,[318 588 496  98 357],450,5,39552,4.142872106420866,40.0,0.0
29547,2,9547,[ 97  28 204 196 172],798,3,39555,4.142752408881441,0.0,0.0
29548,2,9548,[405 322  22  82 194],796,3,39558,4.14263273641219,0.0,0.0
29549,2,9549,[568 423 183  56 117],693,3,39561,4.142513089005235,0.0,0.0
29550,2,9550,[318 588 496  98 357],18,5,39566,4.142602868809549,40.0,0.0
29551,2,9551,[318 588 496  98 357],786,5,39571,4.142692629815746,40.0,0.0
29552,2,9552,[318 588 496  98 357],796,5,39576,4.142782372029729,40.0,0.0
29553,2,9553,[173 301 197 300 100],450,5,39581,4.1428720954574,0.0,20.0
29554,2,9554,[318 588 496  98 357],18,5,39586,4.142961800104657,40.0,0.0
29555,2,9555,[318 588 496  98 357],716,5,39591,4.143051485977397,40.0,0.0
29556,2,9556,[195 100  12 742 405],796,3,39594,4.142931882389871,0.0,20.0
29557,2,9557,[318 588 496  98 357],450,5,39599,4.143021552626072,40.0,0.0
29558,2,9558,[ 98 186 118   7 483],450,2,39601,4.142797363740977,0.0,0.0
29559,2,9559,[318 588 496  98 357],796,5,39606,4.142887029288703,40.0,0.0
29560,2,9560,[318 588 496  98 357],796,5,39611,4.142976676079908,40.0,0.0
29561,2,9561,[318 588 496  98 357],330,5,39616,4.1430663041204765,40.0,0.0
29562,2,9562,[257 144 302 655 185],655,2,39618,4.1428422043291855,0.0,0.0
29563,2,9563,[318 588 496  98 357],796,5,39623,4.1429318276871605,40.0,0.0
29564,2,9564,[180  22 191 588  88],18,4,39627,4.142916884474647,0.0,0.0
29565,2,9565,[ 50 423 228 181 179],577,3,39630,4.142797407484842,0.0,20.0
29566,2,9566,[318 588 496  98 357],796,5,39635,4.142887007421344,40.0,0.0
29567,2,9567,[318 588 496  98 357],330,5,39640,4.142976588628763,40.0,0.0
29568,2,9568,[191 228 282 211 275],450,5,39645,4.143066151112969,0.0,20.0
29569,2,9569,[194  64 204 275  25],151,5,39650,4.143155694879833,20.0,20.0
29570,2,9570,[471 435   1 235 222],450,3,39653,4.143036255354717,0.0,0.0
29571,2,9571,[ 69 210 427  56  12],151,5,39658,4.143125783535312,20.0,0.0
29572,2,9572,[318 588 496  98 357],786,5,39663,4.143215293011595,40.0,0.0
29573,2,9573,[ 79 153 204 286 111],236,3,39666,4.143095884687696,0.0,20.0
29574,2,9574,[258 181 196 271 172],796,5,39671,4.143185378590078,0.0,0.0
29575,2,9575,[  4  25  56 117 289],655,0,39671,4.142752715121136,0.0,0.0
29576,2,9576,[318 588 496  98 357],18,5,39676,4.1428422261668585,40.0,0.0
29577,2,9577,[318 588 496  98 357],716,5,39681,4.142931718521612,40.0,0.0
29578,2,9578,[423 568 403 237  96],280,2,39683,4.142708007098862,0.0,0.0
29579,2,9579,[318 588 496  98 357],18,5,39688,4.142797494780793,40.0,0.0
29580,2,9580,[ 88  11 132 235  56],716,4,39692,4.142782590543785,0.0,0.0
29581,2,9581,[ 12  11 265  89  64],450,5,39697,4.142872051763724,20.0,0.0
29582,2,9582,[318 588 496  98 357],18,5,39702,4.142961494312845,40.0,0.0
29583,2,9583,[  4 302 196 172 127],344,5,39707,4.143050918196995,0.0,20.0
29584,2,9584,[405 195 183  22 202],796,5,39712,4.143140323422013,0.0,0.0
29585,2,9585,[  8  89 144 216 423],457,5,39717,4.143229709993741,0.0,0.0
29586,2,9586,[ 22 118 294 195 546],450,4,39721,4.143214770001043,0.0,0.0
29587,2,9587,[ 89 187  95 144 471],450,4,39725,4.143199833124739,0.0,0.0
29588,2,9588,[318 588 496  98 357],330,5,39730,4.143289185525081,40.0,0.0
29589,2,9589,[191 275 301 151  98],152,3,39733,4.143169968717414,0.0,20.0
29590,2,9590,[318 588 496  98 357],450,5,39738,4.143259305598999,40.0,0.0
29591,2,9591,[318 588 496  98 357],796,5,39743,4.143348623853211,40.0,0.0
29592,2,9592,[318 588 496  98 357],796,5,39748,4.143437923485875,40.0,0.0
29593,2,9593,[318 588 496  98 357],786,5,39753,4.143527204502814,40.0,0.0
29594,2,9594,[318 588 496  98 357],786,5,39758,4.143616466909849,40.0,0.0
29595,2,9595,[197 237 323 385 471],280,1,39759,4.143288870362651,0.0,0.0
29596,2,9596,[318 588 496  98 357],330,5,39764,4.143378139001771,40.0,0.0
29597,2,9597,[200 222 300  50 238],716,5,39769,4.143467389039383,0.0,20.0
29598,2,9598,[318 588 496  98 357],330,5,39774,4.1435566204813,40.0,0.0
29599,2,9599,[318 588 496  98 357],716,5,39779,4.143645833333333,40.0,0.0
29600,2,9600,[318 588 496  98 357],18,5,39784,4.143735027601291,40.0,0.0
29601,2,9601,[318 588 496  98 357],786,5,39789,4.143824203290981,40.0,0.0
29602,2,9602,[318 588 496  98 357],330,5,39794,4.143913360408206,40.0,0.0
29603,2,9603,[  4  89 423 237 161],457,5,39799,4.144002498958767,0.0,0.0
29604,2,9604,[318 588 496  98 357],330,5,39804,4.1440916189484645,40.0,0.0
29605,2,9605,[300 234 191 546 153],796,4,39808,4.14407661877993,0.0,0.0
29606,2,9606,[318 588 496  98 357],18,5,39813,4.144165712501301,40.0,0.0
29607,2,9607,[181 228 172 258 202],457,5,39818,4.144254787676936,0.0,0.0
29608,2,9608,[275 173 405  28  82],457,5,39823,4.1443438443126235,0.0,20.0
29609,2,9609,[318 588 496  98 357],18,5,39828,4.144432882414152,40.0,0.0
29610,2,9610,[181 294 568 423  71],796,4,39832,4.144417854541671,0.0,0.0
29611,2,9611,[176 216  98 282 294],450,5,39837,4.144506866416979,0.0,0.0
29612,2,9612,[318 588 496  98 357],450,5,39842,4.144595859773224,40.0,0.0
29613,2,9613,[318 588 496  98 357],786,5,39847,4.144684834616185,40.0,0.0
29614,2,9614,[318 588 496  98 357],796,5,39852,4.144773790951638,40.0,0.0
29615,2,9615,[318 588 496  98 357],18,5,39857,4.144862728785358,40.0,0.0
29616,2,9616,[318 588 496  98 357],786,5,39862,4.144951648123115,40.0,0.0
29617,2,9617,[210 125 423  50  15],655,1,39863,4.144624662091911,0.0,20.0
29618,2,9618,[ 56 153 427  64 603],269,4,39867,4.144609626780331,60.0,0.0
29619,2,9619,[318 588 496  98 357],796,5,39872,4.144698544698545,40.0,0.0
29620,2,9620,[385 117 286   9 153],401,0,39872,4.144267747635381,0.0,20.0
29621,2,9621,[318 588 496  98 357],796,5,39877,4.1443566826023694,40.0,0.0
29622,2,9622,[135  56 508   1 265],655,1,39878,4.1440299282967885,0.0,0.0
29623,2,9623,[318 588 496  98 357],330,5,39883,4.144118869492934,40.0,0.0
29624,2,9624,[423 143   9  89 187],655,3,39886,4.144,0.0,0.0
29625,2,9625,[318 588 496  98 357],450,5,39891,4.144088925825888,40.0,0.0
29626,2,9626,[403   1 748 508  70],280,2,39893,4.14386620961878,0.0,0.0
29627,2,9627,[318 588 496  98 357],18,5,39898,4.143955130868301,40.0,0.0
29628,2,9628,[318 588 496  98 357],716,5,39903,4.1440440336483535,40.0,0.0
29629,2,9629,[ 97 273  64 588 111],344,4,39907,4.144029075804776,20.0,0.0
29630,2,9630,[215 153  11 202  88],450,5,39912,4.144117952445229,0.0,0.0
29631,2,9631,[427 176  88 125 322],450,5,39917,4.144206810631229,20.0,0.0
29632,2,9632,[288 197 181 121 135],655,1,39918,4.143880411086889,0.0,0.0
29633,2,9633,[ 50  56 237 496 204],796,5,39923,4.143969275482665,20.0,20.0
29634,2,9634,[318 588 496  98 357],786,5,39928,4.144058121432278,40.0,0.0
29635,2,9635,[318 588 496  98 357],786,5,39933,4.1441469489414695,40.0,0.0
29636,2,9636,[318 588 496  98 357],450,5,39938,4.14423575801598,40.0,0.0
29637,2,9637,[235 183 268 125   8],344,2,39940,4.144013280763644,0.0,0.0
29638,2,9638,[289  88 121 210 222],693,0,39940,4.143583359269634,0.0,0.0
29639,2,9639,[318 403  25 181 191],655,2,39942,4.143360995850623,20.0,0.0
29640,2,9640,[318 588 496  98 357],18,5,39947,4.143449849600664,40.0,0.0
29641,2,9641,[742 185  96 328 202],450,5,39952,4.143538684920141,0.0,0.0
29642,2,9642,[186  88 194 496 405],450,4,39956,4.143523799647412,20.0,0.0
29643,2,9643,[318 588 496  98 357],18,5,39961,4.143612608875985,40.0,0.0
29644,2,9644,[318 588 496  98 357],716,5,39966,4.1437013996889585,40.0,0.0
29645,2,9645,[ 98  28 742  97 588],450,5,39971,4.143790172092059,0.0,0.0
29646,2,9646,[228 185   4  79  69],457,5,39976,4.143878926091013,0.0,0.0
29647,2,9647,[132 125 318 173 237],457,5,39981,4.143967661691542,20.0,0.0
29648,2,9648,[318 588 496  98 357],716,5,39986,4.144056378899368,40.0,0.0
29649,2,9649,[318 588 496  98 357],716,5,39991,4.144145077720207,40.0,0.0
29650,2,9650,[318 588 496  98 357],796,5,39996,4.144233758159777,40.0,0.0
29651,2,9651,[318 588 496  98 357],716,5,40001,4.144322420223788,40.0,0.0
29652,2,9652,[318 588 496  98 357],796,5,40006,4.1444110639179526,40.0,0.0
29653,2,9653,[238 294  28 179 282],450,5,40011,4.14449968924798,0.0,0.0
29654,2,9654,[318 588 496  98 357],450,5,40016,4.144588296219576,40.0,0.0
29655,2,9655,[568 197 235 742 195],280,2,40018,4.144366197183099,0.0,0.0
29656,2,9656,[273 289 483 195  98],693,2,40020,4.1441441441441444,0.0,0.0
29657,2,9657,[318 588 496  98 357],330,5,40025,4.144232760405881,40.0,0.0
29658,2,9658,[318 588 496  98 357],786,5,40030,4.144321358318667,40.0,0.0
29659,2,9659,[318 588 496  98 357],786,5,40035,4.144409937888199,40.0,0.0
29660,2,9660,[216  28 196 403 655],693,1,40036,4.144084463306076,0.0,0.0
29661,2,9661,[748 185 144 234 483],450,3,40039,4.143966052577106,0.0,0.0
29662,2,9662,[ 71 179 237  69 238],504,2,40041,4.143744178826451,0.0,0.0
29663,2,9663,[318 588 496  98 357],786,5,40046,4.143832781456954,40.0,0.0
29664,2,9664,[173 357 742  95  12],344,4,40050,4.1438178996378685,0.0,0.0
29665,2,9665,[204 183   8 174  12],655,1,40051,4.143492654665839,0.0,0.0
29666,2,9666,[318 588 496  98 357],716,5,40056,4.143581255818765,40.0,0.0
29667,2,9667,[185  64 423 471 211],535,5,40061,4.143669838642945,20.0,0.0
29668,2,9668,[318 588 496  98 357],450,5,40066,4.143758403144068,40.0,0.0
29669,2,9669,[318 588 496  98 357],786,5,40071,4.143846949327818,40.0,0.0
29670,2,9670,[318 588 496  98 357],18,5,40076,4.143935477199876,40.0,0.0
29671,2,9671,[100 435 168 237  22],535,4,40080,4.143920595533499,0.0,20.0
29672,2,9672,[318 588 496  98 357],18,5,40085,4.144009097487853,40.0,0.0
29673,2,9673,[322 151 197 301 182],796,2,40087,4.143787471573289,0.0,0.0
29674,2,9674,[318 588 496  98 357],786,5,40092,4.143875968992248,40.0,0.0
29675,2,9675,[196 215 143 186 211],655,1,40093,4.143551054154609,0.0,0.0
29676,2,9676,[ 98 216 174  22 196],269,1,40094,4.143226206468947,0.0,0.0
29677,2,9677,[318 588 496  98 357],716,5,40099,4.143314734449266,40.0,0.0
29678,2,9678,[143  88 234 655 385],577,2,40101,4.143093294761855,0.0,0.0
29679,2,9679,[ 70 237 185   8 235],269,1,40102,4.142768595041322,0.0,0.0
29680,2,9680,[318 588 496  98 357],18,5,40107,4.142857142857143,40.0,0.0
29681,2,9681,[318 588 496  98 357],716,5,40112,4.14294567238174,40.0,0.0
29682,2,9682,[ 12 195 238  56 161],655,0,40112,4.14251781472684,0.0,0.0
29683,2,9683,[197  98 258 111 268],655,1,40113,4.142193308550186,0.0,0.0
29684,2,9684,[318 588 496  98 357],796,5,40118,4.1422818791946305,40.0,0.0
29685,2,9685,[ 82  89  97 423 172],796,3,40121,4.142163947966137,0.0,0.0
29686,2,9686,[318 588 496  98 357],716,5,40126,4.142252503355012,40.0,0.0
29687,2,9687,[ 69 121 204 195  64],796,5,40131,4.142341040462428,20.0,0.0
29688,2,9688,[318 588 496  98 357],716,5,40136,4.142429559294045,40.0,0.0
29689,2,9689,[100 191 202 302 237],401,3,40139,4.142311661506708,0.0,20.0
29690,2,9690,[318 588 496  98 357],796,5,40144,4.142400165101641,40.0,0.0
29691,2,9691,[258 181 117 211 200],450,4,40148,4.142385472554684,0.0,0.0
29692,2,9692,[186  79  89 238 132],457,5,40153,4.142473950273393,0.0,0.0
29693,2,9693,[204 546 237 117 174],593,4,40157,4.142459253146276,0.0,0.0
29694,2,9694,[318 588 496  98 357],796,5,40162,4.1425477050025785,40.0,0.0
29695,2,9695,[318 588 496  98 357],716,5,40167,4.142636138613861,40.0,0.0
29696,2,9696,[237 385   8 268 197],655,0,40167,4.142208930597092,0.0,0.0
29697,2,9697,[742 318 172 385 181],796,4,40171,4.142194266859146,20.0,0.0
29698,2,9698,[318 588 496  98 357],796,5,40176,4.142282709557686,40.0,0.0
29699,2,9699,[ 79 186 496 175 185],18,4,40180,4.142268041237114,20.0,0.0
29700,2,9700,[597  28 222 546 179],457,3,40183,4.142150293784146,0.0,0.0
29701,2,9701,[216   8  97 183   7],344,4,40187,4.142135642135642,0.0,0.0
29702,2,9702,[318 588 496  98 357],716,5,40192,4.14222405441616,40.0,0.0
29703,2,9703,[117  12  79 202 483],796,5,40197,4.142312448474856,0.0,0.0
29704,2,9704,[191  28 471 289 135],693,1,40198,4.14198866563627,0.0,0.0
29705,2,9705,[318 588 496  98 357],450,5,40203,4.142077065732536,40.0,0.0
29706,2,9706,[318 588 496  98 357],450,5,40208,4.142165447615123,40.0,0.0
29707,2,9707,[127 678 245 288 100],344,3,40211,4.142047795632468,0.0,40.0
29708,2,9708,[318 588 496  98 357],716,5,40216,4.1421361623236175,40.0,0.0
29709,2,9709,[181 161 117 275 588],450,5,40221,4.142224510813595,0.0,20.0
29710,2,9710,[ 56 186  96 568   1],450,4,40225,4.142209865101432,0.0,0.0
29711,2,9711,[318 588 496  98 357],796,5,40230,4.142298187808896,40.0,0.0
29712,2,9712,[238   1 132 427 215],535,4,40234,4.1422835375270255,20.0,0.0
29713,2,9713,[318 588 496  98 357],18,5,40239,4.142371834465719,40.0,0.0
29714,2,9714,[268  97 172 195 245],344,2,40241,4.1421513124035,0.0,0.0
29715,2,9715,[318 588 496  98 357],796,5,40246,4.142239604775628,40.0,0.0
29716,2,9716,[318 588 496  98 357],786,5,40251,4.142327878974992,40.0,0.0
29717,2,9717,[318 588 496  98 357],716,5,40256,4.1424161350072035,40.0,0.0
29718,2,9718,[318 588 496  98 357],450,5,40261,4.142504372877868,40.0,0.0
29719,2,9719,[ 69 471 234 423 179],450,4,40265,4.142489711934156,0.0,0.0
29720,2,9720,[276  79  56 328 318],655,3,40268,4.142372183931695,20.0,0.0
29721,2,9721,[318 588 496  98 357],796,5,40273,4.142460399094836,40.0,0.0
29722,2,9722,[655  22  64  50 100],878,2,40275,4.142240049367479,20.0,40.0
29723,2,9723,[  9 204 237 471 127],401,2,40277,4.142019744960922,0.0,20.0
29724,2,9724,[289 200 435  97 234],655,1,40278,4.141696658097686,0.0,0.0
29725,2,9725,[318 588 496  98 357],716,5,40283,4.1417849064363566,40.0,0.0
29726,2,9726,[318 588 496  98 357],450,5,40288,4.141873136629999,40.0,0.0
29727,2,9727,[318 588 496  98 357],786,5,40293,4.141961348684211,40.0,0.0
29728,2,9728,[318 588 496  98 357],18,5,40298,4.1420495426045845,40.0,0.0
29729,2,9729,[318 588 496  98 357],450,5,40303,4.142137718396711,40.0,0.0
29730,2,9730,[318 588 496  98 357],796,5,40308,4.14222587606618,40.0,0.0
29731,2,9731,[318 588 496  98 357],330,5,40313,4.142314015618578,40.0,0.0
29732,2,9732,[318 588 496  98 357],450,5,40318,4.142402137059488,40.0,0.0
29733,2,9733,[318 588 496  98 357],18,5,40323,4.142490240394493,40.0,0.0
29734,2,9734,[318 588 496  98 357],796,5,40328,4.142578325629173,40.0,0.0
29735,2,9735,[318 588 496  98 357],450,5,40333,4.1426663927691045,40.0,0.0
29736,2,9736,[143 237 276 268  15],655,2,40335,4.142446338708021,0.0,0.0
29737,2,9737,[318 588 496  98 357],18,5,40340,4.142534401314438,40.0,0.0
29738,2,9738,[318 588 496  98 357],796,5,40345,4.142622445836328,40.0,0.0
29739,2,9739,[318 588 496  98 357],330,5,40350,4.142710472279261,40.0,0.0
29740,2,9740,[288 135 655 258 483],693,2,40352,4.142490504055025,0.0,0.0
29741,2,9741,[318 588 496  98 357],716,5,40357,4.142578525970027,40.0,0.0
29742,2,9742,[ 15 176  97  82 471],655,0,40357,4.142153340860105,0.0,0.0
29743,2,9743,[318 588 496  98 357],450,5,40362,4.142241379310345,40.0,0.0
29744,2,9744,[318 588 496  98 357],330,5,40367,4.14232939969215,40.0,0.0
29745,2,9745,[318 588 496  98 357],330,5,40372,4.142417402011081,40.0,0.0
29746,2,9746,[318 588 496  98 357],18,5,40377,4.142505386272699,40.0,0.0
29747,2,9747,[655   9   8 427 403],655,1,40378,4.142183011899877,20.0,0.0
29748,2,9748,[286 357 172 181 153],655,2,40380,4.141963278284952,0.0,20.0
29749,2,9749,[318 588 496  98 357],450,5,40385,4.142051282051282,40.0,0.0
29750,2,9750,[204 235 143 427  79],807,4,40389,4.142036714183161,20.0,0.0
29751,2,9751,[483 234 568 588  71],796,4,40393,4.142022149302707,0.0,0.0
29752,2,9752,[318 588 496  98 357],18,5,40398,4.142110119963088,40.0,0.0
29753,2,9753,[302 151  70 300 423],450,5,40403,4.142198072585606,0.0,0.0
29754,2,9754,[ 79 111 174 117 546],796,5,40408,4.142286007175807,0.0,0.0
29755,2,9755,[174  11 144   7  97],693,5,40413,4.142373923739237,0.0,0.0
29756,2,9756,[318 588 496  98 357],18,5,40418,4.142461822281439,40.0,0.0
29757,2,9757,[515   9 196 191  12],18,4,40422,4.142447222791556,0.0,0.0
29758,2,9758,[273 183 132 144 117],796,4,40426,4.142432626293678,0.0,0.0
29759,2,9759,[318 588 496  98 357],796,5,40431,4.142520491803278,40.0,0.0
29760,2,9760,[135 403 333 301 323],224,1,40432,4.142198545231022,0.0,0.0
29761,2,9761,[318 588 496  98 357],450,5,40437,4.1422864167178854,40.0,0.0
29762,2,9762,[118 204 174   1 282],450,4,40441,4.14227184267131,0.0,0.0
29763,2,9763,[318 588 496  98 357],330,5,40446,4.142359688652192,40.0,0.0
29764,2,9764,[ 98 427 286  82 515],655,3,40449,4.142242703533026,20.0,20.0
29765,2,9765,[568 175 168 172  15],269,2,40451,4.142023346303502,0.0,0.0
29766,2,9766,[318 588 496  98 357],450,5,40456,4.142111190744343,40.0,0.0
29767,2,9767,[318 588 496  98 357],716,5,40461,4.142199017199017,40.0,0.0
29768,2,9768,[318 588 496  98 357],716,5,40466,4.142286825673048,40.0,0.0
29769,2,9769,[273 300 423 471 118],450,3,40469,4.142169907881269,0.0,0.0
29770,2,9770,[ 28 196  50 186 197],18,3,40472,4.142053014021083,0.0,20.0
29771,2,9771,[318 588 496  98 357],716,5,40477,4.142140810478919,40.0,0.0
29772,2,9772,[318 588 496  98 357],18,5,40482,4.14222858896961,40.0,0.0
29773,2,9773,[127 435 187  50 204],436,5,40487,4.14231634949867,0.0,40.0
29774,2,9774,[318 588 496  98 357],796,5,40492,4.142404092071612,40.0,0.0
29775,2,9775,[ 12 294 132 313   7],577,4,40496,4.142389525368249,0.0,0.0
29776,2,9776,[ 56 172  70  69  15],450,4,40500,4.142374961644676,0.0,0.0
29777,2,9777,[ 15  82 194  64 496],389,4,40504,4.14236040089998,40.0,0.0
29778,2,9778,[318 588 496  98 357],18,5,40509,4.142448103078024,40.0,0.0
29779,2,9779,[318 588 496  98 357],796,5,40514,4.142535787321063,40.0,0.0
29780,2,9780,[318 588 496  98 357],716,5,40519,4.142623453634598,40.0,0.0
29781,2,9781,[161 215 173 546 197],796,4,40523,4.142608873441014,0.0,0.0
29782,2,9782,[318 588 496  98 357],716,5,40528,4.142696514361647,40.0,0.0
29783,2,9783,[318 588 496  98 357],716,5,40533,4.14278413736713,40.0,0.0
29784,2,9784,[318 588 496  98 357],786,5,40538,4.142871742462954,40.0,0.0
29785,2,9785,[318 588 496  98 357],786,5,40543,4.142959329654609,40.0,0.0
29786,2,9786,[318 588 496  98 357],716,5,40548,4.143046898947584,40.0,0.0
29787,2,9787,[ 79  71 151 210 111],389,3,40551,4.1429301185124645,0.0,0.0
29788,2,9788,[318 588 496  98 357],18,5,40556,4.143017672898151,40.0,0.0
29789,2,9789,[318 588 496  98 357],330,5,40561,4.143105209397344,40.0,0.0
29790,2,9790,[210  11 313 742 111],280,3,40564,4.142988458788683,0.0,0.0
29791,2,9791,[318 588 496  98 357],450,5,40569,4.143075980392157,40.0,0.0
29792,2,9792,[ 69 181 191 135 568],389,3,40572,4.142959256611865,0.0,0.0
29793,2,9793,[318 588 496  98 357],450,5,40577,4.1430467633244845,40.0,0.0
29794,2,9794,[318 588 496  98 357],330,5,40582,4.1431342521694745,40.0,0.0
29795,2,9795,[174 210 546  64  82],796,3,40585,4.143017558187015,20.0,0.0
29796,2,9796,[318 588 496  98 357],796,5,40590,4.143105032152699,40.0,0.0
29797,2,9797,[132  69  22  15 273],796,4,40594,4.143090426617677,0.0,0.0
29798,2,9798,[318 588 496  98 357],796,5,40599,4.143177875293397,40.0,0.0
29799,2,9799,[318 588 496  98 357],716,5,40604,4.143265306122449,40.0,0.0
29800,2,9800,[222 275 117 357 403],796,5,40609,4.143352719110295,0.0,20.0
29801,2,9801,[318 588 496  98 357],786,5,40614,4.143440114262395,40.0,0.0
29802,2,9802,[161 234 222 655 182],655,1,40615,4.1431194532286035,0.0,0.0
29803,2,9803,[357 153 132 210 173],716,5,40620,4.1432068543451654,0.0,0.0
29804,2,9804,[196  89 282  88 328],796,5,40625,4.14329423763386,0.0,0.0
29805,2,9805,[ 25  96 195 234 100],450,3,40628,4.143177646338976,0.0,20.0
29806,2,9806,[318 588 496  98 357],18,5,40633,4.143265014785357,40.0,0.0
29807,2,9807,[318 588 496  98 357],716,5,40638,4.143352365415987,40.0,0.0
29808,2,9808,[318 588 496  98 357],330,5,40643,4.143439698236314,40.0,0.0
29809,2,9809,[318 588 496  98 357],330,5,40648,4.143527013251784,40.0,0.0
29810,2,9810,[385  96 318 172 237],796,5,40653,4.143614310467842,20.0,0.0
29811,2,9811,[ 69 195  82 275   7],457,5,40658,4.143701589889931,0.0,20.0
29812,2,9812,[318 588 496  98 357],18,5,40663,4.143788851523489,40.0,0.0
29813,2,9813,[318 588 496  98 357],450,5,40668,4.1438760953739555,40.0,0.0
29814,2,9814,[195 508 175 483 132],269,4,40672,4.143861436576668,0.0,0.0
29815,2,9815,[ 82  15 176 200 172],450,2,40674,4.143643031784841,0.0,0.0
29816,2,9816,[118 215 294  69   8],457,4,40678,4.143628399714781,0.0,0.0
29817,2,9817,[318 588 496  98 357],786,5,40683,4.143715624363415,40.0,0.0
29818,2,9818,[318 588 496  98 357],450,5,40688,4.143802831245544,40.0,0.0
29819,2,9819,[318 588 496  98 357],18,5,40693,4.143890020366599,40.0,0.0
29820,2,9820,[ 89 268 222 100 125],655,1,40694,4.143569901232054,0.0,20.0
29821,2,9821,[318 588 496  98 357],18,5,40699,4.143657096314397,40.0,0.0
29822,2,9822,[ 56  70  79 173 357],450,5,40704,4.14374427364349,0.0,0.0
29823,2,9823,[588 121 187 215 546],716,3,40707,4.143627850162867,0.0,0.0
29824,2,9824,[318 588 496  98 357],716,5,40712,4.143715012722646,40.0,0.0
29825,2,9825,[318 588 496  98 357],450,5,40717,4.143802157541217,40.0,0.0
29826,2,9826,[318 588 496  98 357],716,5,40722,4.143889284623995,40.0,0.0
29827,2,9827,[ 79 181 151 258 385],457,5,40727,4.143976393976394,0.0,0.0
29828,2,9828,[  1 132 182 546 210],280,3,40730,4.143860006104385,0.0,0.0
29829,2,9829,[100 187 313 181 180],296,5,40735,4.143947100712106,0.0,20.0
29830,2,9830,[196  79  98 423 186],151,5,40740,4.144034177601465,0.0,0.0
29831,2,9831,[318 588 496  98 357],330,5,40745,4.144121236777869,40.0,0.0
29832,2,9832,[282 427 385 191 186],796,4,40749,4.144106579884064,20.0,0.0
29833,2,9833,[318 588 496  98 357],716,5,40754,4.144193613992272,40.0,0.0
29834,2,9834,[318 588 496  98 357],330,5,40759,4.144280630401627,40.0,0.0
29835,2,9835,[ 11 118  70  69 216],716,4,40763,4.144265961773079,0.0,0.0
29836,2,9836,[318 588 496  98 357],716,5,40768,4.144352953136119,40.0,0.0
29837,2,9837,[318 588 496  98 357],786,5,40773,4.144439926814393,40.0,0.0
29838,2,9838,[318 588 496  98 357],330,5,40778,4.144526882813294,40.0,0.0
29839,2,9839,[ 25 176 183  12  15],457,5,40783,4.144613821138211,0.0,0.0
29840,2,9840,[191   9 211 181  71],401,2,40785,4.144395894726146,0.0,0.0
29841,2,9841,[318 588 496  98 357],716,5,40790,4.144482828693355,40.0,0.0
29842,2,9842,[318 588 496  98 357],796,5,40795,4.144569744996444,40.0,0.0
29843,2,9843,[182 322 194 195 257],796,4,40799,4.1445550589191384,0.0,0.0
29844,2,9844,[ 89   1 172 143 385],5,4,40803,4.144540375825292,0.0,0.0
29845,2,9845,[202 181 173 176  50],280,0,40803,4.14411943936624,0.0,20.0
29846,2,9846,[318 588 496  98 357],796,5,40808,4.144206357266173,40.0,0.0
29847,2,9847,[174 265 357  98  69],716,5,40813,4.144293257514216,0.0,0.0
29848,2,9848,[318 588 496  98 357],786,5,40818,4.144380140115747,40.0,0.0
29849,2,9849,[483 194 357  96 427],716,4,40822,4.1443654822335025,20.0,0.0
29850,2,9850,[258 176 161 742  28],796,3,40825,4.144249314790376,0.0,0.0
29851,2,9851,[ 79 318   9 211 357],593,4,40829,4.14423467316281,20.0,0.0
29852,2,9852,[318 588 496  98 357],330,5,40834,4.144321526438648,40.0,0.0
29853,2,9853,[271 568 210 318 185],655,2,40836,4.144103917190988,20.0,0.0
29854,2,9854,[318 588 496  98 357],330,5,40841,4.144190766108574,40.0,0.0
29855,2,9855,[333 161   8 185 302],655,2,40843,4.143973214285714,0.0,0.0
29856,2,9856,[435 427 200 385  98],716,4,40847,4.14395860809577,20.0,0.0
29857,2,9857,[318 588 496  98 357],450,5,40852,4.144045445323595,40.0,0.0
29858,2,9858,[238 174 197 385  15],330,5,40857,4.144132264935592,0.0,0.0
29859,2,9859,[318 588 496  98 357],18,5,40862,4.1442190669371195,40.0,0.0
29860,2,9860,[187  97 127 143 174],18,5,40867,4.144305851333536,0.0,20.0
29861,2,9861,[318 588 496  98 357],18,5,40872,4.144392618130197,40.0,0.0
29862,2,9862,[180   1  50 111 216],786,5,40877,4.144479367332455,0.0,20.0
29863,2,9863,[318 588 496  98 357],330,5,40882,4.144566098945661,40.0,0.0
29864,2,9864,[318 588 496  98 357],716,5,40887,4.144652812975164,40.0,0.0
29865,2,9865,[318 588 496  98 357],330,5,40892,4.144739509426312,40.0,0.0
29866,2,9866,[318 588 496  98 357],786,5,40897,4.1448261883044495,40.0,0.0
29867,2,9867,[302 294  15 200 228],655,2,40899,4.144608836643696,0.0,0.0
29868,2,9868,[ 11 187 282 191 151],450,5,40904,4.144695511196677,0.0,0.0
29869,2,9869,[318 588 496  98 357],796,5,40909,4.144782168186423,40.0,0.0
29870,2,9870,[318 588 496  98 357],18,5,40914,4.144868807618276,40.0,0.0
29871,2,9871,[318 588 496  98 357],18,5,40919,4.144955429497569,40.0,0.0
29872,2,9872,[318 588 496  98 357],796,5,40924,4.145042033829636,40.0,0.0
29873,2,9873,[318 588 496  98 357],18,5,40929,4.1451286206198095,40.0,0.0
29874,2,9874,[318 588 496  98 357],450,5,40934,4.145215189873418,40.0,0.0
29875,2,9875,[125 655   8  69 286],796,3,40937,4.145099230457675,0.0,20.0
29876,2,9876,[202 748 228 210 655],280,0,40937,4.144679558570416,0.0,0.0
29877,2,9877,[318 588 496  98 357],18,5,40942,4.144766146993319,40.0,0.0
29878,2,9878,[318 588 496  98 357],330,5,40947,4.144852717886426,40.0,0.0
29879,2,9879,[318 588 496  98 357],330,5,40952,4.144939271255061,40.0,0.0
29880,2,9880,[318 588 496  98 357],18,5,40957,4.1450258071045445,40.0,0.0
29881,2,9881,[179  15 302  22  50],450,4,40961,4.145011131349929,0.0,20.0
29882,2,9882,[275 125 118   4 144],450,3,40964,4.144895274714155,0.0,20.0
29883,2,9883,[357 100 748 483 655],151,3,40967,4.144779441521651,0.0,20.0
29884,2,9884,[318 588 496  98 357],330,5,40972,4.144865958523015,40.0,0.0
29885,2,9885,[ 28 172   1  88 427],716,5,40977,4.144952458021445,20.0,0.0
29886,2,9886,[144  88 186 179 215],457,5,40982,4.145038940022252,0.0,0.0
29887,2,9887,[195 655  71 275 568],796,4,40986,4.14502427184466,0.0,20.0
29888,2,9888,[ 82  28 588   8 185],457,5,40991,4.145110729092932,0.0,0.0
29889,2,9889,[ 69 275 515   7 176],655,2,40993,4.144893832153691,0.0,20.0
29890,2,9890,[318 588 496  98 357],330,5,40998,4.144980285107674,40.0,0.0
29891,2,9891,[204 183 176 151  96],504,2,41000,4.144763445208249,0.0,0.0
29892,2,9892,[234 215 568 168 265],450,4,41004,4.144748812291519,0.0,0.0
29893,2,9893,[ 96 216 153  69 276],504,3,41007,4.14463311097635,0.0,0.0
29894,2,9894,[235 405 427 127 294],716,4,41011,4.144618494188984,20.0,20.0
29895,2,9895,[ 22  70 435 385  15],450,4,41015,4.1446038803556995,0.0,0.0
29896,2,9896,[318 588 496  98 357],18,5,41020,4.144690310195009,40.0,0.0
29897,2,9897,[318 588 496  98 357],450,5,41025,4.144776722570216,40.0,0.0
29898,2,9898,[117   9 483  22 357],796,4,41029,4.144762097181533,0.0,0.0
29899,2,9899,[655 176 222  82 187],786,5,41034,4.144848484848485,0.0,0.0
29900,2,9900,[196  69 183  64 286],796,4,41038,4.144833855166145,20.0,20.0
29901,2,9901,[333 265 328 268  12],655,0,41038,4.144415269642496,0.0,0.0
29902,2,9902,[318 588 496  98 357],330,5,41043,4.144501666161769,40.0,0.0
29903,2,9903,[286  56 546 202  28],174,4,41047,4.144487075928917,0.0,20.0
29904,2,9904,[276 258 471 118 202],457,5,41052,4.14457344775366,0.0,0.0
29905,2,9905,[  4 318  96 235 197],280,3,41055,4.144457904300424,20.0,0.0
29906,2,9906,[318 588 496  98 357],330,5,41060,4.144544261633189,40.0,0.0
29907,2,9907,[483 403 423 215 357],450,4,41064,4.144529672991522,0.0,0.0
29908,2,9908,[318 588 496  98 357],330,5,41069,4.144616005651428,40.0,0.0
29909,2,9909,[318 588 496  98 357],18,5,41074,4.144702320887992,40.0,0.0
29910,2,9910,[ 22 222 748 508 405],280,1,41075,4.144385026737968,0.0,0.0
29911,2,9911,[318 588 496  98 357],796,5,41080,4.144471347861178,40.0,0.0
29912,2,9912,[176  89  97 385 132],655,1,41081,4.1441541410269345,0.0,0.0
29913,2,9913,[318 588 496  98 357],330,5,41086,4.144240468025015,40.0,0.0
29914,2,9914,[ 79  64 183 174 200],457,5,41091,4.144326777609682,20.0,0.0
29915,2,9915,[318 588 496  98 357],330,5,41096,4.1444130697862045,40.0,0.0
29916,2,9916,[318 588 496  98 357],450,5,41101,4.144499344559847,40.0,0.0
29917,2,9917,[318 588 496  98 357],450,5,41106,4.144585601935874,40.0,0.0
29918,2,9918,[318 588 496  98 357],330,5,41111,4.144671841919548,40.0,0.0
29919,2,9919,[318 588 496  98 357],716,5,41116,4.144758064516129,40.0,0.0
29920,2,9920,[318 588 496  98 357],796,5,41121,4.144844269730874,40.0,0.0
29921,2,9921,[318 588 496  98 357],786,5,41126,4.144930457569038,40.0,0.0
29922,2,9922,[174 118 323 222 210],796,3,41129,4.1448150760858615,0.0,0.0
29923,2,9923,[318 588 496  98 357],18,5,41134,4.144901249496171,40.0,0.0
29924,2,9924,[318 588 496  98 357],330,5,41139,4.144987405541562,40.0,0.0
29925,2,9925,[235   1 185 153  89],450,4,41143,4.144972798710457,0.0,0.0
29926,2,9926,[333   9 125  89  15],655,1,41144,4.144655988717639,0.0,0.0
29927,2,9927,[318 588 496  98 357],450,5,41149,4.144742143432715,40.0,0.0
29928,2,9928,[318 588 496  98 357],18,5,41154,4.144828280793635,40.0,0.0
29929,2,9929,[ 1 12 82 97  4],151,4,41158,4.144813695871098,0.0,0.0
29930,2,9930,[  7 742 603 211 403],450,5,41163,4.144899808679892,20.0,0.0
29931,2,9931,[318 588 496  98 357],796,5,41168,4.144985904148208,40.0,0.0
29932,2,9932,[176  98 127 237 202],655,2,41170,4.1447699587234474,0.0,20.0
29933,2,9933,[111 289 471 151 678],938,2,41172,4.144554056774713,0.0,0.0
29934,2,9934,[191 357 174 257 204],655,2,41174,4.144338198288878,0.0,0.0
29935,2,9935,[143 265  71 333 237],236,2,41176,4.144122383252818,0.0,0.0
29936,2,9936,[318 588 496  98 357],18,5,41181,4.144208513635906,40.0,0.0
29937,2,9937,[ 64 196 508 135 195],269,3,41184,4.144093378949487,20.0,0.0
29938,2,9938,[318 588 496  98 357],330,5,41189,4.144179494919006,40.0,0.0
29939,2,9939,[286   4 265 135 211],450,3,41192,4.144064386317908,0.0,20.0
29940,2,9940,[318 588 496  98 357],450,5,41197,4.144150487878483,40.0,0.0
29941,2,9941,[318 588 496  98 357],786,5,41202,4.144236572118286,40.0,0.0
29942,2,9942,[318 588 496  98 357],450,5,41207,4.144322639042542,40.0,0.0
29943,2,9943,[318 588 496  98 357],796,5,41212,4.144408688656476,40.0,0.0
29944,2,9944,[  1 245  25 151 204],885,4,41216,4.14439416792358,0.0,0.0
29945,2,9945,[318 588 496  98 357],796,5,41221,4.144480193042429,40.0,0.0
29946,2,9946,[318 588 496  98 357],786,5,41226,4.144566200864582,40.0,0.0
29947,2,9947,[318 588 496  98 357],450,5,41231,4.144652191395255,40.0,0.0
29948,2,9948,[183 210 268 182 200],655,3,41234,4.144537139410996,0.0,0.0
29949,2,9949,[143 202 135 546 216],450,4,41238,4.144522613065327,0.0,0.0
29950,2,9950,[313 127 322  79 245],450,5,41243,4.144608582052055,0.0,20.0
29951,2,9951,[186 588 300 210 172],389,2,41245,4.14439308681672,0.0,0.0
29952,2,9952,[318 588 496  98 357],18,5,41250,4.144479051542248,40.0,0.0
29953,2,9953,[286 182 300  69 288],450,4,41254,4.1444645368696005,0.0,20.0
29954,2,9954,[318 588 496  98 357],716,5,41259,4.144550477147162,40.0,0.0
29955,2,9955,[471 176  50 245 294],450,5,41264,4.1446364001607074,0.0,20.0
29956,2,9956,[318 588 496  98 357],18,5,41269,4.144722305915437,40.0,0.0
29957,2,9957,[318 588 496  98 357],18,5,41274,4.14480819441655,40.0,0.0
29958,2,9958,[  7  89 135 273 258],450,3,41277,4.144693242293403,0.0,0.0
29959,2,9959,[318 588 496  98 357],330,5,41282,4.144779116465863,40.0,0.0
29960,2,9960,[318 588 496  98 357],786,5,41287,4.1448649733962455,40.0,0.0
29961,2,9961,[322 186 276   7 181],786,3,41290,4.144750050190725,0.0,0.0
29962,2,9962,[ 97 197 135  88  82],330,4,41294,4.144735521429288,0.0,0.0
29963,2,9963,[318 588 496  98 357],330,5,41299,4.144821356884785,40.0,0.0
29964,2,9964,[ 88 172 294 483 405],716,5,41304,4.144907175112895,0.0,0.0
29965,2,9965,[318 588 496  98 357],18,5,41309,4.144992976118804,40.0,0.0
29966,2,9966,[318 588 496  98 357],786,5,41314,4.145078759907696,40.0,0.0
29967,2,9967,[172 135 237 173 194],716,4,41318,4.145064205457464,0.0,0.0
29968,2,9968,[174  97 161 197 748],798,2,41320,4.144849031999198,0.0,0.0
29969,2,9969,[318 588 496  98 357],786,5,41325,4.14493480441324,40.0,0.0
29970,2,9970,[200  97 357   4  98],716,4,41329,4.144920268779461,0.0,0.0
29971,2,9971,[195 185 322 125 655],796,3,41332,4.14480545527477,0.0,0.0
29972,2,9972,[318 588 496  98 357],796,5,41337,4.144891206256894,40.0,0.0
29973,2,9973,[200 117  56 385 300],655,1,41338,4.144575897333066,0.0,0.0
29974,2,9974,[318 588 496  98 357],786,5,41343,4.144661654135338,40.0,0.0
29975,2,9975,[318 588 496  98 357],786,5,41348,4.144747393744988,40.0,0.0
29976,2,9976,[588 238 202   4 185],18,2,41350,4.144532424576526,0.0,0.0
29977,2,9977,[301   8 153 210 174],535,5,41355,4.144618159951894,0.0,0.0
29978,2,9978,[318 588 496  98 357],330,5,41360,4.144703878144103,40.0,0.0
29979,2,9979,[318 588 496  98 357],450,5,41365,4.144789579158316,40.0,0.0
29980,2,9980,[318 588 496  98 357],18,5,41370,4.144875262999699,40.0,0.0
29981,2,9981,[222  69 168 257 132],807,5,41375,4.144960929673412,0.0,0.0
29982,2,9982,[508 333  98  15 357],655,2,41377,4.144746068316137,0.0,0.0
29983,2,9983,[318 588 496  98 357],330,5,41382,4.144831730769231,40.0,0.0
29984,2,9984,[202 357 172 153 151],23,2,41384,4.144616925388082,0.0,0.0
29985,2,9985,[153 174 202  89  15],450,4,41388,4.144602443420789,0.0,0.0
29986,2,9986,[318 588 496  98 357],796,5,41393,4.14468809452288,40.0,0.0
29987,2,9987,[603  56 135 186   8],321,5,41398,4.144773728474169,20.0,0.0
29988,2,9988,[180 257 121 265 216],716,4,41402,4.144759235158674,0.0,0.0
29989,2,9989,[ 56  98 132 748 197],292,4,41406,4.144744744744744,0.0,0.0
29990,2,9990,[318 588 496  98 357],330,5,41411,4.144830347312581,40.0,0.0
29991,2,9991,[191 427 194 173  96],269,3,41414,4.1447157726180945,20.0,0.0
29992,2,9992,[318 588 496  98 357],450,5,41419,4.144801360952667,40.0,0.0
29993,2,9993,[273 471 483 568 423],450,3,41422,4.144686812087253,0.0,0.0
29994,2,9994,[216 153 168 100 302],401,2,41424,4.144472236118059,0.0,20.0
29995,2,9995,[257 483  89  69 328],796,5,41429,4.144557823129252,0.0,0.0
29996,2,9996,[318 588 496  98 357],796,5,41434,4.144643393017906,40.0,0.0
29997,2,9997,[318 588 496  98 357],786,5,41439,4.144728945789158,40.0,0.0
29998,2,9998,[ 82 328 603 423 742],655,1,41440,4.144414441444145,20.0,0.0
29999,2,9999,[318 588 496  98 357],716,5,41445,4.1445,40.0,0.0
30000,3,0,[ 15 271 185 180  28],796,3,3,3.0,0.0,0.0
30001,3,1,[271 185  15 273 403],796,4,7,3.5,0.0,0.0
30002,3,2,[403 271 185  15 273],796,4,11,3.6666666666666665,0.0,0.0
30003,3,3,[100 125 234 181 269],450,4,15,3.75,0.0,20.0
30004,3,4,[403 181 125 271 269],796,4,19,3.8,0.0,0.0
30005,3,5,[172 202 282  50 153],655,2,21,3.5,0.0,20.0
30006,3,6,[357  71 273 269 237],450,3,24,3.4285714285714284,0.0,0.0
30007,3,7,[ 50 172 403 181 100],577,5,29,3.625,0.0,40.0
30008,3,8,[ 50 172 403 181 100],450,5,34,3.7777777777777777,0.0,40.0
30009,3,9,[403 191 222 748 238],450,4,38,3.8,0.0,0.0
30010,3,10,[215 257 275 238 196],23,2,40,3.6363636363636362,0.0,20.0
30011,3,11,[125 100 275 357 748],151,3,43,3.5833333333333335,0.0,40.0
30012,3,12,[135 187 127 216 117],716,3,46,3.5384615384615383,0.0,20.0
30013,3,13,[234  28  15  89 194],450,3,49,3.5,0.0,0.0
30014,3,14,[ 69 127 258 234 132],655,1,50,3.3333333333333335,0.0,20.0
30015,3,15,[228 174 288 183 111],280,2,52,3.25,0.0,0.0
30016,3,16,[  4 568   1  25 200],457,5,57,3.3529411764705883,0.0,0.0
30017,3,17,[127 185 568  50  25],256,5,62,3.4444444444444446,0.0,40.0
30018,3,18,[127 185 568  50  25],256,5,67,3.526315789473684,0.0,40.0
30019,3,19,[127 185 568  50  25],655,3,70,3.5,0.0,40.0
30020,3,20,[ 11 143 265 300 172],655,2,72,3.4285714285714284,0.0,0.0
30021,3,21,[ 64  25 121 183 182],655,3,75,3.409090909090909,20.0,0.0
30022,3,22,[ 28 173 471 196  70],65,3,78,3.391304347826087,0.0,0.0
30023,3,23,[151  25 301  88 125],450,4,82,3.4166666666666665,0.0,0.0
30024,3,24,[127 471 191 357 151],344,4,86,3.44,0.0,20.0
30025,3,25,[222 313   7 200 276],655,3,89,3.423076923076923,0.0,0.0
30026,3,26,[265   9 176 215 322],796,3,92,3.4074074074074074,0.0,0.0
30027,3,27,[ 64  98 483 275  69],18,4,96,3.4285714285714284,20.0,20.0
30028,3,28,[191   9 282 172 216],401,2,98,3.3793103448275863,0.0,0.0
30029,3,29,[168  95 273 211  71],450,2,100,3.3333333333333335,0.0,0.0
30030,3,30,[127 194 117 288 168],450,4,104,3.3548387096774195,0.0,20.0
30031,3,31,[175  88 180   4 235],716,1,105,3.28125,0.0,0.0
30032,3,32,[127 403 181  50   1],450,5,110,3.3333333333333335,0.0,40.0
30033,3,33,[187 161 275  98 176],450,5,115,3.3823529411764706,0.0,20.0
30034,3,34,[294 168  95 204 196],450,4,119,3.4,0.0,0.0
30035,3,35,[127 182 143 168 111],796,5,124,3.4444444444444446,0.0,20.0
30036,3,36,[183 318 100 288  96],280,3,127,3.4324324324324325,20.0,20.0
30037,3,37,[127 151   1  50 161],401,0,127,3.3421052631578947,0.0,40.0
30038,3,38,[186 302  69 151 168],389,4,131,3.358974358974359,0.0,0.0
30039,3,39,[174 100  98 423  11],269,3,134,3.35,0.0,20.0
30040,3,40,[568 172 151  25  71],344,4,138,3.3658536585365852,0.0,0.0
30041,3,41,[302  64 313 423 168],450,5,143,3.4047619047619047,20.0,0.0
30042,3,42,[245  15 144 655 135],450,3,146,3.395348837209302,0.0,0.0
30043,3,43,[121 211 118  70 238],504,2,148,3.3636363636363638,0.0,0.0
30044,3,44,[121 258  28 333  82],655,0,148,3.2888888888888888,0.0,0.0
30045,3,45,[483 423 385  70 132],23,3,151,3.282608695652174,0.0,0.0
30046,3,46,[186 301 655 294  96],655,0,151,3.2127659574468086,0.0,0.0
30047,3,47,[265 275 496 471 191],716,4,155,3.2291666666666665,20.0,20.0
30048,3,48,[269 273 265 655 143],796,2,157,3.204081632653061,0.0,0.0
30049,3,49,[603  28  79  22 435],716,5,162,3.24,20.0,0.0
30050,3,50,[ 50 194 151 289 183],236,1,163,3.196078431372549,0.0,20.0
30051,3,51,[302 403 168 144 111],450,5,168,3.230769230769231,0.0,0.0
30052,3,52,[  7 196 313 655  98],693,3,171,3.2264150943396226,0.0,0.0
30053,3,53,[234  12  79 187 172],796,4,175,3.240740740740741,0.0,0.0
30054,3,54,[216  69 111 194  95],716,5,180,3.272727272727273,0.0,0.0
30055,3,55,[ 64 176 275   1 268],344,3,183,3.267857142857143,20.0,20.0
30056,3,56,[211 275 168  69 238],796,3,186,3.263157894736842,0.0,20.0
30057,3,57,[302 403 168 144 111],450,5,191,3.293103448275862,0.0,0.0
30058,3,58,[151 269 211  12 196],450,5,196,3.3220338983050848,0.0,0.0
30059,3,59,[302 234 132 153  71],389,4,200,3.3333333333333335,0.0,0.0
30060,3,60,[185 151 175 172 235],457,4,204,3.3442622950819674,0.0,0.0
30061,3,61,[ 50 151   9 515   1],401,1,205,3.306451612903226,0.0,20.0
30062,3,62,[318  98 742 228  15],457,5,210,3.3333333333333335,20.0,0.0
30063,3,63,[ 97 191 204 265 197],450,5,215,3.359375,0.0,0.0
30064,3,64,[118 282 423 276 471],593,3,218,3.353846153846154,0.0,0.0
30065,3,65,[483 135 197  89 204],562,3,221,3.3484848484848486,0.0,0.0
30066,3,66,[271 204 328 210 258],655,0,221,3.298507462686567,0.0,0.0
30067,3,67,[302 318 168 144 111],401,3,224,3.2941176470588234,20.0,0.0
30068,3,68,[269 211 195 276  56],18,4,228,3.3043478260869565,0.0,0.0
30069,3,69,[276 483  50  64  56],321,3,231,3.3,20.0,20.0
30070,3,70,[  8 195 588 187 185],796,5,236,3.323943661971831,0.0,0.0
30071,3,71,[603 153 568  12  79],796,5,241,3.3472222222222223,20.0,0.0
30072,3,72,[294  25  95 423  28],577,5,246,3.3698630136986303,0.0,0.0
30073,3,73,[ 79 333 546 195 153],796,5,251,3.391891891891892,0.0,0.0
30074,3,74,[275  98  64 179 276],457,5,256,3.4133333333333336,20.0,20.0
30075,3,75,[  8 496  22 405 302],344,3,259,3.4078947368421053,20.0,0.0
30076,3,76,[235 127   7 403 568],457,4,263,3.4155844155844157,0.0,20.0
30077,3,77,[268 289  96 111 183],655,1,264,3.3846153846153846,0.0,0.0
30078,3,78,[ 56 313 144  12 245],450,5,269,3.4050632911392404,0.0,0.0
30079,3,79,[228 237   4 183 276],344,4,273,3.4125,0.0,0.0
30080,3,80,[175 385 286 228 118],655,0,273,3.3703703703703702,0.0,20.0
30081,3,81,[ 82 265 210 300 135],655,1,274,3.341463414634146,0.0,0.0
30082,3,82,[ 25 235 179 173 471],457,4,278,3.3493975903614457,0.0,0.0
30083,3,83,[ 12 483 245 144 191],450,4,282,3.357142857142857,0.0,0.0
30084,3,84,[ 12 125 191 144 318],457,5,287,3.376470588235294,20.0,0.0
30085,3,85,[100 121   7  28 143],450,4,291,3.383720930232558,0.0,20.0
30086,3,86,[187 275 603 202 328],450,5,296,3.4022988505747125,20.0,20.0
30087,3,87,[ 12 125 191 144 318],796,5,301,3.4204545454545454,20.0,0.0
30088,3,88,[ 12 125 191 144 318],796,5,306,3.438202247191011,20.0,0.0
30089,3,89,[ 12 125 191 144 318],450,5,311,3.4555555555555557,20.0,0.0
30090,3,90,[197  11 403 405  79],457,5,316,3.4725274725274726,0.0,0.0
30091,3,91,[515 265  56 294 180],716,4,320,3.4782608695652173,0.0,0.0
30092,3,92,[742 117 185 258 328],655,1,321,3.4516129032258065,0.0,0.0
30093,3,93,[ 64 144 546   9 568],457,4,325,3.4574468085106385,20.0,0.0
30094,3,94,[ 69 475 125 286 111],655,0,325,3.4210526315789473,0.0,20.0
30095,3,95,[588  88 215 200 197],450,4,329,3.4270833333333335,0.0,0.0
30096,3,96,[568 265 222  88 196],716,5,334,3.443298969072165,0.0,0.0
30097,3,97,[196 228 265 125 121],577,4,338,3.4489795918367347,0.0,0.0
30098,3,98,[143  82 568 273  15],450,2,340,3.4343434343434343,0.0,0.0
30099,3,99,[180 483  50 655 151],269,3,343,3.43,0.0,20.0
30100,3,100,[186  12 185 234  11],693,3,346,3.4257425742574257,0.0,0.0
30101,3,101,[215   9 216 405 194],457,5,351,3.4411764705882355,0.0,0.0
30102,3,102,[483 175 328 196   9],655,1,352,3.4174757281553396,0.0,0.0
30103,3,103,[  8 185  69 210 423],18,3,355,3.4134615384615383,0.0,0.0
30104,3,104,[ 79  89 202 322 238],796,3,358,3.4095238095238094,0.0,0.0
30105,3,105,[  1  69 288 222  64],344,3,361,3.4056603773584904,20.0,0.0
30106,3,106,[173   4  25 181 471],593,3,364,3.4018691588785046,0.0,0.0
30107,3,107,[ 89   1  12 258 235],344,2,366,3.388888888888889,0.0,0.0
30108,3,108,[ 88 313 323  11  82],280,1,367,3.36697247706422,0.0,0.0
30109,3,109,[194 546 143 603 197],450,5,372,3.381818181818182,20.0,0.0
30110,3,110,[ 96  98 318 216 144],693,5,377,3.3963963963963963,20.0,0.0
30111,3,111,[471 210 742 318 127],457,5,382,3.4107142857142856,20.0,20.0
30112,3,112,[211 237 405  56  11],716,5,387,3.424778761061947,0.0,0.0
30113,3,113,[ 11 168   1 121 318],401,1,388,3.4035087719298245,20.0,0.0
30114,3,114,[135 238 127  79  56],655,3,391,3.4,0.0,20.0
30115,3,115,[ 12 216  25  11  64],457,5,396,3.413793103448276,20.0,0.0
30116,3,116,[ 98  28 357 117 175],457,5,401,3.427350427350427,0.0,0.0
30117,3,117,[496 237 182 195  88],796,5,406,3.440677966101695,20.0,0.0
30118,3,118,[405 276 323  96 228],280,2,408,3.4285714285714284,0.0,0.0
30119,3,119,[216 269 211 234 423],655,1,409,3.408333333333333,0.0,0.0
30120,3,120,[117 196 132 286  79],236,3,412,3.4049586776859506,0.0,20.0
30121,3,121,[182 265 151 234 118],457,5,417,3.418032786885246,0.0,0.0
30122,3,122,[655  89  50 216 125],655,3,420,3.4146341463414633,0.0,20.0
30123,3,123,[318 435 176 182 515],269,3,423,3.411290322580645,20.0,0.0
30124,3,124,[302  15 180 183 176],269,0,423,3.384,0.0,0.0
30125,3,125,[ 89  95 294  82  22],450,3,426,3.380952380952381,0.0,0.0
30126,3,126,[144 496 181 515 603],908,4,430,3.3858267716535435,40.0,0.0
30127,3,127,[ 82 294   9  50 748],256,4,434,3.390625,0.0,20.0
30128,3,128,[403 121 211 200 172],269,2,436,3.37984496124031,0.0,0.0
30129,3,129,[568 186 172  70  69],450,4,440,3.3846153846153846,0.0,0.0
30130,3,130,[ 82 269 275 257   8],796,3,443,3.381679389312977,0.0,20.0
30131,3,131,[161 111 174 172 195],885,4,447,3.3863636363636362,0.0,0.0
30132,3,132,[216  98  97 144 357],450,5,452,3.398496240601504,0.0,0.0
30133,3,133,[294 313 127 117 318],280,3,455,3.3955223880597014,20.0,20.0
30134,3,134,[228 194 237 403 546],796,5,460,3.4074074074074074,0.0,0.0
30135,3,135,[111 318 237 187 179],655,3,463,3.4044117647058822,20.0,0.0
30136,3,136,[275 748 655 172  28],151,4,467,3.408759124087591,0.0,20.0
30137,3,137,[423 187 276 265 515],535,1,468,3.391304347826087,0.0,0.0
30138,3,138,[179   7 197 180 195],457,5,473,3.402877697841727,0.0,0.0
30139,3,139,[222 216 471 405 204],457,5,478,3.414285714285714,0.0,0.0
30140,3,140,[197 318 245  12 496],796,3,481,3.4113475177304964,40.0,0.0
30141,3,141,[197 100 228   1 125],292,4,485,3.415492957746479,0.0,20.0
30142,3,142,[216 143 496  98 191],716,5,490,3.4265734265734267,20.0,0.0
30143,3,143,[216 143 496  98 191],389,3,493,3.423611111111111,20.0,0.0
30144,3,144,[  4 197 423  96 222],450,3,496,3.420689655172414,0.0,0.0
30145,3,145,[357 183 588  56 172],450,5,501,3.4315068493150687,0.0,0.0
30146,3,146,[185  98 187 135  82],269,4,505,3.435374149659864,0.0,0.0
30147,3,147,[144  79 603 357  97],796,4,509,3.439189189189189,20.0,0.0
30148,3,148,[ 28   8 121 357 322],796,3,512,3.436241610738255,0.0,0.0
30149,3,149,[153 174 143 182 238],389,3,515,3.433333333333333,0.0,0.0
30150,3,150,[568  71 196 237 471],450,4,519,3.437086092715232,0.0,0.0
30151,3,151,[  4 742   7 197 423],280,3,522,3.4342105263157894,0.0,0.0
30152,3,152,[357   8  12 318  98],655,3,525,3.4313725490196076,20.0,0.0
30153,3,153,[496 275 588 179 182],389,5,530,3.4415584415584415,20.0,20.0
30154,3,154,[546  97 496  98 286],344,2,532,3.432258064516129,20.0,20.0
30155,3,155,[318  98 275 588 179],878,4,536,3.4358974358974357,20.0,20.0
30156,3,156,[ 98 275 182 179 144],450,5,541,3.445859872611465,0.0,20.0
30157,3,157,[237 127  71 288 174],280,3,544,3.4430379746835444,0.0,20.0
30158,3,158,[ 98 275 182 179 144],655,4,548,3.4465408805031448,0.0,20.0
30159,3,159,[546 269 405  12 286],503,2,550,3.4375,0.0,20.0
30160,3,160,[318 275 182 179 603],655,5,555,3.4472049689440993,40.0,20.0
30161,3,161,[ 25   1  71 403 328],450,3,558,3.4444444444444446,0.0,0.0
30162,3,162,[121 597 289 132 174],807,5,563,3.4539877300613497,0.0,0.0
30163,3,163,[403 748 196  25 161],450,4,567,3.457317073170732,0.0,0.0
30164,3,164,[  4 202 286 269 245],450,4,571,3.4606060606060605,0.0,20.0
30165,3,165,[182  98 275 603 179],389,5,576,3.4698795180722892,20.0,20.0
30166,3,166,[182  98 275 603 179],450,5,581,3.4790419161676644,20.0,20.0
30167,3,167,[182  98 275 603 179],18,4,585,3.482142857142857,20.0,20.0
30168,3,168,[275  98 197 483  22],316,5,590,3.4911242603550297,0.0,20.0
30169,3,169,[238 121 181  25 257],655,0,590,3.4705882352941178,0.0,0.0
30170,3,170,[182  79 275 357 179],535,2,592,3.461988304093567,0.0,20.0
30171,3,171,[ 88 271 187 385 405],655,1,593,3.447674418604651,0.0,0.0
30172,3,172,[121 237  89 318 127],457,5,598,3.4566473988439306,20.0,20.0
30173,3,173,[655 427   7 172 405],450,5,603,3.4655172413793105,20.0,0.0
30174,3,174,[ 79 175 216 742 215],457,5,608,3.474285714285714,0.0,0.0
30175,3,175,[245 288 151 286 322],344,2,610,3.465909090909091,0.0,20.0
30176,3,176,[202 471   9 197  50],655,1,611,3.4519774011299433,0.0,20.0
30177,3,177,[121 427  69 265 237],655,1,612,3.438202247191011,20.0,0.0
30178,3,178,[ 98 275 427 179 318],236,3,615,3.435754189944134,40.0,20.0
30179,3,179,[ 98 427 318 191 597],11,3,618,3.433333333333333,40.0,0.0
30180,3,180,[161 313 197 181 423],280,2,620,3.425414364640884,0.0,0.0
30181,3,181,[238   1 194  79  95],389,4,624,3.4285714285714284,0.0,0.0
30182,3,182,[655  96  15 100 143],457,5,629,3.4371584699453552,0.0,20.0
30183,3,183,[427 318 191 496  98],878,5,634,3.4456521739130435,60.0,0.0
30184,3,184,[427 318 191 496  98],577,5,639,3.454054054054054,60.0,0.0
30185,3,185,[275 181  64 175 603],18,3,642,3.4516129032258065,40.0,20.0
30186,3,186,[318  15 125  69  82],655,1,643,3.4385026737967914,20.0,0.0
30187,3,187,[427 318 191 496  98],716,5,648,3.4468085106382977,60.0,0.0
30188,3,188,[427 318 191 496  98],151,4,652,3.4497354497354498,60.0,0.0
30189,3,189,[427 318 496  98 275],503,5,657,3.457894736842105,60.0,20.0
30190,3,190,[475 183  98 216 172],269,2,659,3.450261780104712,0.0,0.0
30191,3,191,[427 318 496  98 275],796,5,664,3.4583333333333335,60.0,20.0
30192,3,192,[ 79 181 403   1 172],72,2,666,3.4507772020725387,0.0,0.0
30193,3,193,[427 318 496  98 275],18,5,671,3.4587628865979383,60.0,20.0
30194,3,194,[322   4  69  89  64],450,4,675,3.4615384615384617,20.0,0.0
30195,3,195,[174 286 168 496 258],796,4,679,3.4642857142857144,20.0,20.0
30196,3,196,[427 318 496  98 275],450,5,684,3.472081218274112,60.0,20.0
30197,3,197,[427 318 496  98 275],535,4,688,3.474747474747475,60.0,20.0
30198,3,198,[216 181   1 333  12],655,1,689,3.4623115577889445,0.0,0.0
30199,3,199,[121 275 294 237 238],296,4,693,3.465,0.0,20.0
30200,3,200,[427 318 496 275 144],796,5,698,3.472636815920398,60.0,20.0
30201,3,201,[427 318 496 275 144],450,5,703,3.48019801980198,60.0,20.0
30202,3,202,[427 318 496 275 144],716,4,707,3.4827586206896552,60.0,20.0
30203,3,203,[427 318 496 275 191],707,4,711,3.485294117647059,60.0,20.0
30204,3,204,[427 318 275 496 191],236,3,714,3.4829268292682927,60.0,20.0
30205,3,205,[ 97  15 197 111 275],457,4,718,3.4854368932038833,0.0,20.0
30206,3,206,[427 318 191 275  98],316,5,723,3.4927536231884058,40.0,20.0
30207,3,207,[427 318 191 275  98],450,5,728,3.5,40.0,20.0
30208,3,208,[427 318 191 275  98],878,5,733,3.507177033492823,40.0,20.0
30209,3,209,[427 318 191 275  98],450,5,738,3.5142857142857142,40.0,20.0
30210,3,210,[427 318 191 275  98],655,5,743,3.5213270142180093,40.0,20.0
30211,3,211,[427 318 191 275  98],316,5,748,3.5283018867924527,40.0,20.0
30212,3,212,[427 318 191 275  98],796,5,753,3.535211267605634,40.0,20.0
30213,3,213,[ 50 273 597 174 222],450,3,756,3.532710280373832,0.0,20.0
30214,3,214,[161 235 204 135  56],269,2,758,3.525581395348837,0.0,0.0
30215,3,215,[427 318 191 275  98],796,5,763,3.5324074074074074,40.0,20.0
30216,3,216,[427 318 191 275  98],878,5,768,3.5391705069124426,40.0,20.0
30217,3,217,[161  79  64 191 195],457,5,773,3.5458715596330275,20.0,0.0
30218,3,218,[475 172 135  64 181],269,3,776,3.5433789954337898,20.0,0.0
30219,3,219,[427 318 191 275  98],151,4,780,3.5454545454545454,40.0,20.0
30220,3,220,[427 318 275  98 127],236,4,784,3.5475113122171944,40.0,40.0
30221,3,221,[427 318  98 127 275],316,4,788,3.5495495495495497,40.0,40.0
30222,3,222,[427 318  98 275 191],878,5,793,3.5560538116591927,40.0,20.0
30223,3,223,[427 318  98 275 191],236,4,797,3.5580357142857144,40.0,20.0
30224,3,224,[427 318  98 191 182],72,5,802,3.5644444444444443,40.0,0.0
30225,3,225,[427 318  98 191 182],72,5,807,3.5707964601769913,40.0,0.0
30226,3,226,[427 318  98 191 182],18,5,812,3.5770925110132157,40.0,0.0
30227,3,227,[427 318  98 191 182],18,5,817,3.5833333333333335,40.0,0.0
30228,3,228,[222 313 276 176 289],655,2,819,3.576419213973799,0.0,0.0
30229,3,229,[427 318  98 191 182],655,5,824,3.582608695652174,40.0,0.0
30230,3,230,[427 318  98 182 191],796,5,829,3.588744588744589,40.0,0.0
30231,3,231,[427 318  98 182 191],655,5,834,3.5948275862068964,40.0,0.0
30232,3,232,[427 318  98 182 191],796,5,839,3.6008583690987126,40.0,0.0
30233,3,233,[427 318  98 182 191],450,5,844,3.606837606837607,40.0,0.0
30234,3,234,[153 173 186 288 135],450,2,846,3.6,0.0,0.0
30235,3,235,[118 181 180 405 200],280,2,848,3.593220338983051,0.0,0.0
30236,3,236,[427 318  98 182 191],450,5,853,3.5991561181434597,40.0,0.0
30237,3,237,[427 318  98 182 191],269,5,858,3.6050420168067228,40.0,0.0
30238,3,238,[172 175 300 302 143],151,4,862,3.6066945606694563,0.0,0.0
30239,3,239,[144  22  95 161 265],807,5,867,3.6125,0.0,0.0
30240,3,240,[588  15 222 215 181],450,3,870,3.6099585062240664,0.0,0.0
30241,3,241,[427 318  98 182 191],269,5,875,3.615702479338843,40.0,0.0
30242,3,242,[427 318  98 182 191],796,5,880,3.6213991769547325,40.0,0.0
30243,3,243,[427 318  98 182 191],450,5,885,3.627049180327869,40.0,0.0
30244,3,244,[427 318  98 182 191],72,5,890,3.63265306122449,40.0,0.0
30245,3,245,[ 97  98 276 496  56],18,5,895,3.638211382113821,20.0,0.0
30246,3,246,[111  97 748 172   7],450,5,900,3.6437246963562755,0.0,0.0
30247,3,247,[427 318  98 182 191],796,5,905,3.649193548387097,40.0,0.0
30248,3,248,[496 286 597 161  88],796,4,909,3.6506024096385543,20.0,20.0
30249,3,249,[427 318  98 182 191],450,5,914,3.656,40.0,0.0
30250,3,250,[151  98  70  50 173],457,5,919,3.6613545816733066,0.0,20.0
30251,3,251,[427 318  98 182 191],655,5,924,3.6666666666666665,40.0,0.0
30252,3,252,[427 318  98 182 191],655,5,929,3.6719367588932808,40.0,0.0
30253,3,253,[176 655 748 182 195],450,5,934,3.677165354330709,0.0,0.0
30254,3,254,[427 318  98 182 191],655,5,939,3.6823529411764704,40.0,0.0
30255,3,255,[111  69  12 215 238],457,4,943,3.68359375,0.0,0.0
30256,3,256,[427 318 182  98 191],18,5,948,3.688715953307393,40.0,0.0
30257,3,257,[185 318 216 125 204],450,5,953,3.693798449612403,20.0,0.0
30258,3,258,[151 748 183 186 288],450,3,956,3.6911196911196913,0.0,0.0
30259,3,259,[588 125 174   7 176],786,5,961,3.6961538461538463,0.0,0.0
30260,3,260,[234 118 328 161 282],796,4,965,3.6973180076628354,0.0,0.0
30261,3,261,[427 318 182  98 191],450,5,970,3.7022900763358777,40.0,0.0
30262,3,262,[ 69 423  11 196 176],457,5,975,3.7072243346007605,0.0,0.0
30263,3,263,[  9 161 195 323 216],280,3,978,3.7045454545454546,0.0,0.0
30264,3,264,[294 174  22 313 181],577,5,983,3.709433962264151,0.0,0.0
30265,3,265,[318 427 182  98 191],269,5,988,3.7142857142857144,40.0,0.0
30266,3,266,[176 173  71  25 215],344,3,991,3.7116104868913857,0.0,0.0
30267,3,267,[427 318 182  98 191],18,5,996,3.716417910447761,40.0,0.0
30268,3,268,[286 282  82 403 125],450,4,1000,3.717472118959108,0.0,20.0
30269,3,269,[427 318 182  98 191],269,5,1005,3.7222222222222223,40.0,0.0
30270,3,270,[427 318 182  98 191],18,5,1010,3.726937269372694,40.0,0.0
30271,3,271,[111 238 121 301 132],450,4,1014,3.7279411764705883,0.0,0.0
30272,3,272,[318 427 182  98 191],450,5,1019,3.7326007326007327,40.0,0.0
30273,3,273,[318 427 182  98 191],18,5,1024,3.7372262773722627,40.0,0.0
30274,3,274,[318 427 182  98 191],18,5,1029,3.7418181818181817,40.0,0.0
30275,3,275,[603 234 204 475 185],655,2,1031,3.7355072463768115,20.0,0.0
30276,3,276,[196 151 111  64 294],796,4,1035,3.7364620938628157,20.0,0.0
30277,3,277,[318 427 182  98 191],655,5,1040,3.741007194244604,40.0,0.0
30278,3,278,[318 427 182  98 191],796,5,1045,3.7455197132616487,40.0,0.0
30279,3,279,[318 427 182  98 191],269,5,1050,3.75,40.0,0.0
30280,3,280,[ 70 273 197 328 111],450,4,1054,3.7508896797153026,0.0,0.0
30281,3,281,[ 25 216 210 282  82],457,5,1059,3.75531914893617,0.0,0.0
30282,3,282,[  1 125  98 286  50],450,5,1064,3.7597173144876326,0.0,40.0
30283,3,283,[427 318 182  98 191],450,5,1069,3.7640845070422535,40.0,0.0
30284,3,284,[427 318 182  98 191],72,5,1074,3.768421052631579,40.0,0.0
30285,3,285,[427 318 182  98 191],72,5,1079,3.772727272727273,40.0,0.0
30286,3,286,[135 210  98 197  28],693,2,1081,3.7665505226480835,0.0,0.0
30287,3,287,[427 318 182  98 191],72,5,1086,3.7708333333333335,40.0,0.0
30288,3,288,[427 318 182  98 191],18,5,1091,3.7750865051903113,40.0,0.0
30289,3,289,[427 318 182  98 191],72,5,1096,3.779310344827586,40.0,0.0
30290,3,290,[210 216 186 286  79],18,5,1101,3.783505154639175,0.0,20.0
30291,3,291,[427 318 182  98 191],796,5,1106,3.787671232876712,40.0,0.0
30292,3,292,[427 318 182  98 191],655,5,1111,3.7918088737201363,40.0,0.0
30293,3,293,[427 318 182  98 191],72,5,1116,3.795918367346939,40.0,0.0
30294,3,294,[245 333 197 603 143],796,3,1119,3.7932203389830508,20.0,0.0
30295,3,295,[427 318 182  98 191],72,5,1124,3.7972972972972974,40.0,0.0
30296,3,296,[385 210 245 237   4],593,3,1127,3.7946127946127945,0.0,0.0
30297,3,297,[ 15 276 268 515 211],296,4,1131,3.795302013422819,0.0,0.0
30298,3,298,[176  50 132  70 100],786,5,1136,3.79933110367893,0.0,40.0
30299,3,299,[318 427 182  98 191],18,5,1141,3.8033333333333332,40.0,0.0
30300,3,300,[546 118 191  50 204],716,3,1144,3.8006644518272426,0.0,20.0
30301,3,301,[427 318 182  98 191],796,5,1149,3.8046357615894038,40.0,0.0
30302,3,302,[427 318 182  98 191],72,5,1154,3.8085808580858087,40.0,0.0
30303,3,303,[427 318 182  98 191],450,5,1159,3.8125,40.0,0.0
30304,3,304,[427 318 182  98 191],18,5,1164,3.816393442622951,40.0,0.0
30305,3,305,[427 318 182  98 191],655,5,1169,3.820261437908497,40.0,0.0
30306,3,306,[121 286 127  89 174],796,4,1173,3.820846905537459,0.0,40.0
30307,3,307,[427 318 182  98 191],796,5,1178,3.824675324675325,40.0,0.0
30308,3,308,[ 28 748 237 322 182],450,5,1183,3.8284789644012944,0.0,0.0
30309,3,309,[318 427 182  98 191],796,5,1188,3.832258064516129,40.0,0.0
30310,3,310,[222 268 117 258  11],655,0,1188,3.819935691318328,0.0,0.0
30311,3,311,[427 318 182  98 191],450,5,1193,3.823717948717949,40.0,0.0
30312,3,312,[427 318 182  98 191],18,5,1198,3.8274760383386583,40.0,0.0
30313,3,313,[ 64 228 275 202 222],716,5,1203,3.8312101910828025,20.0,20.0
30314,3,314,[ 71  56 245 235 180],280,4,1207,3.831746031746032,0.0,0.0
30315,3,315,[318 427 182  98 191],796,5,1212,3.8354430379746836,40.0,0.0
30316,3,316,[245  56   1 235 161],280,4,1216,3.8359621451104102,0.0,0.0
30317,3,317,[405 216 173 179 125],457,5,1221,3.839622641509434,0.0,0.0
30318,3,318,[318 427 182  98 191],655,5,1226,3.843260188087774,40.0,0.0
30319,3,319,[318 427 182  98 191],796,5,1231,3.846875,40.0,0.0
30320,3,320,[318 427 182  98 191],450,5,1236,3.850467289719626,40.0,0.0
30321,3,321,[427 357 121 423 435],11,4,1240,3.8509316770186337,20.0,0.0
30322,3,322,[318 427 182  98 191],18,5,1245,3.8544891640866874,40.0,0.0
30323,3,323,[318 427 182  98 191],450,5,1250,3.8580246913580245,40.0,0.0
30324,3,324,[318 427 182  98 191],655,5,1255,3.8615384615384616,40.0,0.0
30325,3,325,[183  50 385 215  82],23,2,1257,3.855828220858896,0.0,20.0
30326,3,326,[ 22 435 228 187 273],450,4,1261,3.856269113149847,0.0,0.0
30327,3,327,[135 318 427 168 211],151,5,1266,3.8597560975609757,40.0,0.0
30328,3,328,[282 245 179 111 176],450,5,1271,3.86322188449848,0.0,0.0
30329,3,329,[427 318 182  98 191],18,5,1276,3.8666666666666667,40.0,0.0
30330,3,330,[195 323 286 245 111],796,2,1278,3.8610271903323263,0.0,20.0
30331,3,331,[ 56 176 222 215 175],151,3,1281,3.858433734939759,0.0,0.0
30332,3,332,[ 88 204 496 161 237],450,5,1286,3.8618618618618616,20.0,0.0
30333,3,333,[318 427 182  98 191],450,5,1291,3.8652694610778444,40.0,0.0
30334,3,334,[318 427 182  98 191],72,5,1296,3.8686567164179104,40.0,0.0
30335,3,335,[318 427 182  98 191],796,5,1301,3.8720238095238093,40.0,0.0
30336,3,336,[318 427 182  98 191],655,5,1306,3.8753709198813056,40.0,0.0
30337,3,337,[318 427 182  98 191],450,5,1311,3.878698224852071,40.0,0.0
30338,3,338,[ 71 100   9  50 238],593,4,1315,3.8790560471976403,0.0,40.0
30339,3,339,[111 153 265  56 435],236,3,1318,3.876470588235294,0.0,0.0
30340,3,340,[483 222  50  97 435],716,5,1323,3.8797653958944283,0.0,20.0
30341,3,341,[405 286 181  25 301],655,0,1323,3.8684210526315788,0.0,20.0
30342,3,342,[289  69 127   9  79],655,2,1325,3.8629737609329444,0.0,20.0
30343,3,343,[318 427 182  98 191],18,5,1330,3.866279069767442,40.0,0.0
30344,3,344,[216 135 117 286 111],236,3,1333,3.863768115942029,0.0,20.0
30345,3,345,[318 427 182  98 191],72,5,1338,3.867052023121387,40.0,0.0
30346,3,346,[318 427 182  98 191],269,5,1343,3.8703170028818445,40.0,0.0
30347,3,347,[318 427 182  98 191],72,5,1348,3.8735632183908044,40.0,0.0
30348,3,348,[318 427 182  98 191],18,5,1353,3.8767908309455588,40.0,0.0
30349,3,349,[117 238  95  82 357],716,5,1358,3.88,0.0,0.0
30350,3,350,[  4 286 111 603  88],450,4,1362,3.8803418803418803,20.0,20.0
30351,3,351,[318 427 182  98 191],796,5,1367,3.883522727272727,40.0,0.0
30352,3,352,[ 22 185 151  97 568],450,5,1372,3.8866855524079322,0.0,0.0
30353,3,353,[318 427 182  98 191],655,5,1377,3.889830508474576,40.0,0.0
30354,3,354,[ 95  50   8 202  56],523,4,1381,3.8901408450704227,0.0,20.0
30355,3,355,[318 427 182  98 191],655,5,1386,3.893258426966292,40.0,0.0
30356,3,356,[318 427 182  98 191],72,5,1391,3.896358543417367,40.0,0.0
30357,3,357,[161 211   4  22  96],716,2,1393,3.8910614525139664,0.0,0.0
30358,3,358,[427 318 182  98 191],18,5,1398,3.894150417827298,40.0,0.0
30359,3,359,[427 318 182  98 191],72,5,1403,3.897222222222222,40.0,0.0
30360,3,360,[427 318 182  98 191],72,5,1408,3.9002770083102494,40.0,0.0
30361,3,361,[  4 183 216 179 132],457,5,1413,3.903314917127072,0.0,0.0
30362,3,362,[427 318 182  98 191],18,5,1418,3.90633608815427,40.0,0.0
30363,3,363,[265 181 301 216 483],151,5,1423,3.909340659340659,0.0,0.0
30364,3,364,[318 427 182  98 191],450,5,1428,3.9123287671232876,40.0,0.0
30365,3,365,[318 427 182  98 191],450,5,1433,3.9153005464480874,40.0,0.0
30366,3,366,[ 50 405  69 191 185],796,5,1438,3.9182561307901906,0.0,20.0
30367,3,367,[211 568  50 328 204],655,1,1439,3.910326086956522,0.0,20.0
30368,3,368,[568 186 181 151  25],577,4,1443,3.910569105691057,0.0,0.0
30369,3,369,[318 427 182  98 191],18,5,1448,3.9135135135135135,40.0,0.0
30370,3,370,[318 427 182  98 191],655,5,1453,3.91644204851752,40.0,0.0
30371,3,371,[318 427 182  98 191],655,5,1458,3.9193548387096775,40.0,0.0
30372,3,372,[318 427 182  98 191],269,5,1463,3.9222520107238608,40.0,0.0
30373,3,373,[181  11  56 144 423],280,3,1466,3.9197860962566846,0.0,0.0
30374,3,374,[194 117 655 215 235],457,4,1470,3.92,0.0,0.0
30375,3,375,[318 427 182  98 191],655,5,1475,3.922872340425532,40.0,0.0
30376,3,376,[328 742 153 265 385],655,0,1475,3.9124668435013263,0.0,0.0
30377,3,377,[427 318 182  98 191],18,5,1480,3.9153439153439153,40.0,0.0
30378,3,378,[215  69 180  12 118],72,4,1484,3.9155672823219,0.0,0.0
30379,3,379,[301   9   8 200 195],655,1,1485,3.9078947368421053,0.0,0.0
30380,3,380,[ 50 151  82 483 196],151,4,1489,3.9081364829396326,0.0,20.0
30381,3,381,[318 427 182  98 191],18,5,1494,3.910994764397906,40.0,0.0
30382,3,382,[ 97 313 143  71 200],796,4,1498,3.911227154046997,0.0,0.0
30383,3,383,[318 427 182  98 191],269,5,1503,3.9140625,40.0,0.0
30384,3,384,[202 235 151 742 405],457,4,1507,3.914285714285714,0.0,0.0
30385,3,385,[655 135  89 172 546],450,4,1511,3.9145077720207255,0.0,0.0
30386,3,386,[276  12 258 238  50],629,5,1516,3.917312661498708,0.0,20.0
30387,3,387,[265 269  22 186 515],535,2,1518,3.9123711340206184,0.0,0.0
30388,3,388,[318 427 182  98 191],796,5,1523,3.9151670951156814,40.0,0.0
30389,3,389,[318 427 182  98 191],796,5,1528,3.917948717948718,40.0,0.0
30390,3,390,[318 427 182  98 191],655,5,1533,3.920716112531969,40.0,0.0
30391,3,391,[435 187  22 269  82],18,4,1537,3.920918367346939,0.0,0.0
30392,3,392,[318 427 182  98 191],450,5,1542,3.9236641221374047,40.0,0.0
30393,3,393,[ 15 301 423  11   9],11,4,1546,3.9238578680203045,0.0,0.0
30394,3,394,[496 603 210   7  11],535,5,1551,3.9265822784810127,40.0,0.0
30395,3,395,[318 427 182  98 191],18,5,1556,3.9292929292929295,40.0,0.0
30396,3,396,[483 153 172 275 186],389,3,1559,3.9269521410579347,0.0,20.0
30397,3,397,[318 427 182  98 191],269,5,1564,3.92964824120603,40.0,0.0
30398,3,398,[144   4 180  79 191],796,4,1568,3.9298245614035086,0.0,0.0
30399,3,399,[318 427 182  98 191],796,5,1573,3.9325,40.0,0.0
30400,3,400,[318 427 182  98 191],72,5,1578,3.935162094763092,40.0,0.0
30401,3,401,[318 427 182  98 191],450,5,1583,3.9378109452736316,40.0,0.0
30402,3,402,[125 168   4 183  97],796,4,1587,3.937965260545906,0.0,0.0
30403,3,403,[168 111   9 135  82],457,4,1591,3.9381188118811883,0.0,0.0
30404,3,404,[204 176 269 194  98],23,3,1594,3.9358024691358025,0.0,0.0
30405,3,405,[125 546 294 318 216],577,4,1598,3.935960591133005,20.0,0.0
30406,3,406,[318 427 182  98 191],18,5,1603,3.9385749385749387,40.0,0.0
30407,3,407,[318 427 182  98 191],450,5,1608,3.9411764705882355,40.0,0.0
30408,3,408,[318 427 182  98 191],655,5,1613,3.943765281173594,40.0,0.0
30409,3,409,[216 271 427 151 403],796,5,1618,3.946341463414634,20.0,0.0
30410,3,410,[ 12 135 196 180   8],11,3,1621,3.9440389294403895,0.0,0.0
30411,3,411,[318 427 182  98 191],72,5,1626,3.9466019417475726,40.0,0.0
30412,3,412,[172 423 176 318  82],269,2,1628,3.9418886198547214,20.0,0.0
30413,3,413,[318 427 182  98 191],450,5,1633,3.9444444444444446,40.0,0.0
30414,3,414,[546 742  82 216 202],280,3,1636,3.942168674698795,0.0,0.0
30415,3,415,[385 185 183   9 568],655,2,1638,3.9375,0.0,0.0
30416,3,416,[318 427 182  98 191],450,5,1643,3.9400479616306954,40.0,0.0
30417,3,417,[ 97 568   4 172  79],577,4,1647,3.9401913875598087,0.0,0.0
30418,3,418,[186  50 237 176 153],269,0,1647,3.9307875894988067,0.0,20.0
30419,3,419,[427 318 182  98 191],269,5,1652,3.933333333333333,40.0,0.0
30420,3,420,[427 318 182  98 191],269,5,1657,3.9358669833729216,40.0,0.0
30421,3,421,[197 235 186 204  64],269,2,1659,3.9312796208530805,20.0,0.0
30422,3,422,[204  89 180  96 195],72,4,1663,3.9314420803782504,0.0,0.0
30423,3,423,[ 79  88 258 289 403],798,4,1667,3.931603773584906,0.0,0.0
30424,3,424,[318 427 182  98 191],18,5,1672,3.9341176470588235,40.0,0.0
30425,3,425,[318 427 182  98 191],450,5,1677,3.936619718309859,40.0,0.0
30426,3,426,[127 423 300  97 328],796,4,1681,3.936768149882904,0.0,20.0
30427,3,427,[318 427 182  98 191],18,5,1686,3.939252336448598,40.0,0.0
30428,3,428,[235 423  28 405 275],457,4,1690,3.9393939393939394,0.0,20.0
30429,3,429,[318 427 182  98 191],796,5,1695,3.941860465116279,40.0,0.0
30430,3,430,[318 427 182  98 191],18,5,1700,3.9443155452436196,40.0,0.0
30431,3,431,[318 427 182  98 191],655,5,1705,3.946759259259259,40.0,0.0
30432,3,432,[318 427 182  98 191],655,5,1710,3.9491916859122402,40.0,0.0
30433,3,433,[318 427 182  98 191],655,5,1715,3.9516129032258065,40.0,0.0
30434,3,434,[125 603 483 265  82],796,4,1719,3.9517241379310346,20.0,0.0
30435,3,435,[318 427 182  98 191],655,5,1724,3.9541284403669725,40.0,0.0
30436,3,436,[318 427 182  98 191],655,5,1729,3.9565217391304346,40.0,0.0
30437,3,437,[204  50 183 222 257],5,5,1734,3.958904109589041,0.0,20.0
30438,3,438,[318 427 182  98 191],18,5,1739,3.9612756264236904,40.0,0.0
30439,3,439,[385 322  15  50 132],450,4,1743,3.9613636363636364,0.0,20.0
30440,3,440,[318 427 182  98 191],72,5,1748,3.963718820861678,40.0,0.0
30441,3,441,[318 427 182  98 191],269,5,1753,3.9660633484162897,40.0,0.0
30442,3,442,[328 204 269 301 588],450,5,1758,3.9683972911963883,0.0,0.0
30443,3,443,[318 427 182  98 191],796,5,1763,3.970720720720721,40.0,0.0
30444,3,444,[300 427 273 197 405],450,4,1767,3.9707865168539325,20.0,0.0
30445,3,445,[318 427 182  98 191],269,5,1772,3.9730941704035874,40.0,0.0
30446,3,446,[ 1 97 96 79 98],344,3,1775,3.970917225950783,0.0,0.0
30447,3,447,[318 427 182  98 191],796,5,1780,3.9732142857142856,40.0,0.0
30448,3,448,[318 427 182  98 191],18,5,1785,3.975501113585746,40.0,0.0
30449,3,449,[100 403 181 200 269],796,3,1788,3.973333333333333,0.0,20.0
30450,3,450,[318 427 182  98 191],72,5,1793,3.975609756097561,40.0,0.0
30451,3,451,[ 79 144 200 228 568],716,4,1797,3.975663716814159,0.0,0.0
30452,3,452,[742 175 238 185  28],655,1,1798,3.9690949227373067,0.0,0.0
30453,3,453,[180 151 655 204   1],716,4,1802,3.9691629955947136,0.0,0.0
30454,3,454,[161 153 597  64   9],269,2,1804,3.964835164835165,20.0,0.0
30455,3,455,[183 143 211  82 161],655,2,1806,3.960526315789474,0.0,0.0
30456,3,456,[132  70 655 216 118],716,4,1810,3.9606126914660833,0.0,0.0
30457,3,457,[200 185 180 678  50],504,4,1814,3.960698689956332,0.0,20.0
30458,3,458,[597 161 294   4 202],457,3,1817,3.9586056644880174,0.0,0.0
30459,3,459,[435  22   8  95  69],18,4,1821,3.958695652173913,0.0,0.0
30460,3,460,[180 300   8 228  98],796,4,1825,3.9587852494577005,0.0,0.0
30461,3,461,[568 276 100 269 435],655,1,1826,3.9523809523809526,0.0,20.0
30462,3,462,[ 50 748  89  56 357],450,5,1831,3.9546436285097193,0.0,20.0
30463,3,463,[191 174 313   7 546],577,3,1834,3.9525862068965516,0.0,0.0
30464,3,464,[ 97 483 111 125 172],151,5,1839,3.9548387096774196,0.0,0.0
30465,3,465,[151 121 127 143 125],457,5,1844,3.9570815450643777,0.0,20.0
30466,3,466,[294  64 655  96 357],655,2,1846,3.9528907922912206,20.0,0.0
30467,3,467,[ 11 318 282 423 144],593,5,1851,3.9551282051282053,20.0,0.0
30468,3,468,[  8 200  70 568 191],269,2,1853,3.9509594882729213,0.0,0.0
30469,3,469,[238 210  98 181 127],450,4,1857,3.951063829787234,0.0,20.0
30470,3,470,[568 515 196 318 483],269,3,1860,3.949044585987261,20.0,0.0
30471,3,471,[405 318 234  56 385],716,4,1864,3.9491525423728815,20.0,0.0
30472,3,472,[ 11 211 228  96 132],655,0,1864,3.940803382663848,0.0,0.0
30473,3,473,[174 197 318 237 125],504,4,1868,3.940928270042194,20.0,0.0
30474,3,474,[742 405  11 471 179],457,5,1873,3.943157894736842,0.0,0.0
30475,3,475,[471  28 385 405 183],655,1,1874,3.936974789915966,0.0,0.0
30476,3,476,[286 405   7 597 176],344,2,1876,3.9329140461215935,0.0,20.0
30477,3,477,[  9  89 235 202  97],457,4,1880,3.933054393305439,0.0,0.0
30478,3,478,[215 294 132  98 234],457,4,1884,3.933194154488518,0.0,0.0
30479,3,479,[182 496 204 151 197],796,4,1888,3.933333333333333,20.0,0.0
30480,3,480,[235 269 127 471 204],450,4,1892,3.9334719334719335,0.0,20.0
30481,3,481,[ 11 294 125  79  89],296,4,1896,3.933609958506224,0.0,0.0
30482,3,482,[ 69   7 257 655  88],655,0,1896,3.9254658385093166,0.0,0.0
30483,3,483,[568 144 204 185 210],450,4,1900,3.925619834710744,0.0,0.0
30484,3,484,[546 196   8 318 216],457,4,1904,3.9257731958762885,20.0,0.0
30485,3,485,[294  11 313   7 204],450,5,1909,3.92798353909465,0.0,0.0
30486,3,486,[183 301 196 237 238],655,1,1910,3.921971252566735,0.0,0.0
30487,3,487,[117 175 258  56 294],655,0,1910,3.9139344262295084,0.0,0.0
30488,3,488,[121 385 196  71 183],450,3,1913,3.912065439672802,0.0,0.0
30489,3,489,[471 143 161 211 204],401,4,1917,3.9122448979591837,0.0,0.0
30490,3,490,[655 196  97  56 118],655,0,1917,3.904276985743381,0.0,0.0
30491,3,491,[ 88 135  69 125 174],280,2,1919,3.9004065040650406,0.0,0.0
30492,3,492,[265  69 655 282 318],236,3,1922,3.898580121703854,20.0,0.0
30493,3,493,[  8 174 265 288 186],457,5,1927,3.9008097165991904,0.0,0.0
30494,3,494,[181 245 271  12 568],796,4,1931,3.901010101010101,0.0,0.0
30495,3,495,[427 328  12 100 286],450,5,1936,3.903225806451613,20.0,40.0
30496,3,496,[475  71 176 435 568],389,4,1940,3.903420523138833,0.0,0.0
30497,3,497,[238 172 204 125 273],450,4,1944,3.9036144578313254,0.0,0.0
30498,3,498,[301 288 357 568 215],450,4,1948,3.903807615230461,0.0,0.0
30499,3,499,[100 234 568 238 186],389,3,1951,3.902,0.0,20.0
30500,3,500,[  9 117 183 172 546],280,3,1954,3.900199600798403,0.0,0.0
30501,3,501,[100  71  56 742  25],577,4,1958,3.900398406374502,0.0,20.0
30502,3,502,[180 132 546 427 185],450,5,1963,3.9025844930417497,20.0,0.0
30503,3,503,[179  56 127 301 173],450,5,1968,3.9047619047619047,0.0,20.0
30504,3,504,[118 423  22 174 151],450,4,1972,3.904950495049505,0.0,0.0
30505,3,505,[210 196 200 435  64],236,2,1974,3.9011857707509883,20.0,0.0
30506,3,506,[ 95  28 180  98  22],450,4,1978,3.90138067061144,0.0,0.0
30507,3,507,[176 197  12  56 496],280,3,1981,3.8996062992125986,20.0,0.0
30508,3,508,[  8 597 286 318  28],11,4,1985,3.899803536345776,20.0,20.0
30509,3,509,[273 143  82 153 282],796,3,1988,3.8980392156862744,0.0,0.0
30510,3,510,[275  82  96   9 194],796,3,1991,3.8962818003913893,0.0,20.0
30511,3,511,[118 257 435 271 183],655,1,1992,3.890625,0.0,0.0
30512,3,512,[ 96 180 435 496 211],716,3,1995,3.888888888888889,20.0,0.0
30513,3,513,[ 11 357 269 210 245],344,3,1998,3.88715953307393,0.0,0.0
30514,3,514,[172 176 318 135  88],151,4,2002,3.887378640776699,20.0,0.0
30515,3,515,[183 135  56  98 318],693,4,2006,3.887596899224806,20.0,0.0
30516,3,516,[202 265 118  89 275],655,2,2008,3.88394584139265,0.0,20.0
30517,3,517,[288 597  95 144 328],450,3,2011,3.882239382239382,0.0,0.0
30518,3,518,[216  69  25 235   1],716,4,2015,3.882466281310212,0.0,0.0
30519,3,519,[  1 288 276 603 183],292,4,2019,3.8826923076923077,20.0,0.0
30520,3,520,[333 273 271 357 186],796,3,2022,3.8809980806142033,0.0,0.0
30521,3,521,[357 161 125 258 118],796,5,2027,3.8831417624521074,0.0,0.0
30522,3,522,[ 69 100  97 216 211],11,2,2029,3.879541108986616,0.0,20.0
30523,3,523,[143 357 403  95 237],330,5,2034,3.881679389312977,0.0,0.0
30524,3,524,[ 22  12  97 200 195],18,3,2037,3.88,0.0,0.0
30525,3,525,[196   1 215 204 222],23,2,2039,3.876425855513308,0.0,0.0
30526,3,526,[222 143 196 125 197],450,4,2043,3.876660341555977,0.0,0.0
30527,3,527,[  8  89  98 100 194],269,3,2046,3.875,0.0,20.0
30528,3,528,[588 191  56 215 234],23,2,2048,3.8714555765595464,0.0,0.0
30529,3,529,[  7 195 496 245  69],450,5,2053,3.8735849056603775,20.0,0.0
30530,3,530,[238  88 228  15 288],457,5,2058,3.8757062146892656,0.0,0.0
30531,3,531,[385  15 286  88 282],450,4,2062,3.8759398496240602,0.0,20.0
30532,3,532,[265 508 273 215 301],655,1,2063,3.8705440900562853,0.0,0.0
30533,3,533,[173 328 135 185 318],65,4,2067,3.8707865168539324,20.0,0.0
30534,3,534,[294  50 568 238 144],716,4,2071,3.8710280373831774,0.0,20.0
30535,3,535,[483 222 655 174 318],236,3,2074,3.8694029850746268,20.0,0.0
30536,3,536,[748 286 151 427 100],450,5,2079,3.8715083798882683,20.0,40.0
30537,3,537,[237 175 245  98   9],344,3,2082,3.869888475836431,0.0,0.0
30538,3,538,[ 98 289 127  89 237],296,4,2086,3.8701298701298703,0.0,20.0
30539,3,539,[204  71  96 435   1],807,3,2089,3.8685185185185187,0.0,0.0
30540,3,540,[ 89 385 174 111  97],450,5,2094,3.870609981515712,0.0,0.0
30541,3,541,[211 183  95  28 187],796,3,2097,3.8690036900369003,0.0,0.0
30542,3,542,[204 423 144 172 211],716,4,2101,3.869244935543278,0.0,0.0
30543,3,543,[427 168 200 403 151],330,4,2105,3.869485294117647,20.0,0.0
30544,3,544,[187  71 117 546  96],796,5,2110,3.871559633027523,0.0,0.0
30545,3,545,[180 181 496 111   1],796,3,2113,3.86996336996337,20.0,0.0
30546,3,546,[258 100  70 435 196],535,5,2118,3.8720292504570386,0.0,20.0
30547,3,547,[322  25  95 328 313],450,3,2121,3.8704379562043796,0.0,0.0
30548,3,548,[258  89 210 100 215],457,5,2126,3.8724954462659382,0.0,20.0
30549,3,549,[183 211 302 118 181],450,4,2130,3.8727272727272726,0.0,0.0
30550,3,550,[183 186 294 144  15],450,3,2133,3.871143375680581,0.0,0.0
30551,3,551,[483 275 258   4   9],535,4,2137,3.871376811594203,0.0,20.0
30552,3,552,[191 427 153 111 222],151,3,2140,3.8698010849909585,20.0,0.0
30553,3,553,[ 95 322  71  69 143],450,3,2143,3.868231046931408,0.0,0.0
30554,3,554,[ 50 143  28 196 173],389,2,2145,3.864864864864865,0.0,20.0
30555,3,555,[135 257 202  88  15],655,1,2146,3.8597122302158273,0.0,0.0
30556,3,556,[204 323 471  22 265],280,2,2148,3.8563734290843805,0.0,0.0
30557,3,557,[483 238 118   8   1],457,5,2153,3.8584229390681,0.0,0.0
30558,3,558,[135 318 132 196 515],269,4,2157,3.8586762075134167,20.0,0.0
30559,3,559,[257 273 286  15   9],277,4,2161,3.8589285714285713,0.0,20.0
30560,3,560,[204  15 175   4 172],18,2,2163,3.855614973262032,0.0,0.0
30561,3,561,[180  98  56 282 179],535,2,2165,3.8523131672597866,0.0,0.0
30562,3,562,[ 64 238  71  15   9],18,5,2170,3.8543516873889874,20.0,0.0
30563,3,563,[568 143 195 288 180],693,3,2173,3.852836879432624,0.0,0.0
30564,3,564,[294  79 328 168 282],796,4,2177,3.8530973451327433,0.0,0.0
30565,3,565,[427 132 742 238  64],450,5,2182,3.8551236749116606,40.0,0.0
30566,3,566,[588 168 195   4 111],18,1,2183,3.8500881834215166,0.0,0.0
30567,3,567,[168   4 151 427  15],707,3,2186,3.8485915492957745,20.0,0.0
30568,3,568,[216 176 471 301 313],450,5,2191,3.850615114235501,0.0,0.0
30569,3,569,[195 187 483 161 423],796,5,2196,3.8526315789473684,0.0,0.0
30570,3,570,[111  56 196 168  12],796,5,2201,3.8546409807355517,0.0,0.0
30571,3,571,[100 228 187 655 257],655,1,2202,3.8496503496503496,0.0,20.0
30572,3,572,[ 15 405  25 202 151],151,4,2206,3.849912739965096,0.0,0.0
30573,3,573,[483 216 161 302   4],655,3,2209,3.8484320557491287,0.0,0.0
30574,3,574,[597 742 258  70  25],450,4,2213,3.848695652173913,0.0,0.0
30575,3,575,[143 211 245 568 100],450,5,2218,3.8506944444444446,0.0,20.0
30576,3,576,[238 111 405 187 235],450,4,2222,3.850953206239168,0.0,0.0
30577,3,577,[100 508 742 153 323],280,2,2224,3.847750865051903,0.0,20.0
30578,3,578,[183 234 357 172 265],457,5,2229,3.849740932642487,0.0,0.0
30579,3,579,[ 98 271 228  28  79],72,3,2232,3.8482758620689657,0.0,0.0
30580,3,580,[237  25 151 282 302],535,3,2235,3.846815834767642,0.0,0.0
30581,3,581,[210 742 322 144 125],450,4,2239,3.8470790378006874,0.0,0.0
30582,3,582,[153 172 125 257 588],796,5,2244,3.849056603773585,0.0,0.0
30583,3,583,[ 98 121 215 588 168],796,5,2249,3.8510273972602738,0.0,0.0
30584,3,584,[ 50  15  12 127 172],72,3,2252,3.8495726495726497,0.0,40.0
30585,3,585,[210 121 194 234 211],807,4,2256,3.849829351535836,0.0,0.0
30586,3,586,[204  56 269 111 405],450,5,2261,3.851788756388416,0.0,0.0
30587,3,587,[125  22 234 151 121],457,5,2266,3.8537414965986394,0.0,0.0
30588,3,588,[269 186 288  22 182],655,1,2267,3.8488964346349746,0.0,0.0
30589,3,589,[151 204  79  50 121],807,5,2272,3.8508474576271188,0.0,20.0
30590,3,590,[168  25 483  56 496],151,5,2277,3.8527918781725887,20.0,0.0
30591,3,591,[191 196  22 174 100],450,5,2282,3.85472972972973,0.0,20.0
30592,3,592,[288 187  97   9 678],504,4,2286,3.8549747048903877,0.0,0.0
30593,3,593,[204 161  95 215 597],23,1,2287,3.8501683501683504,0.0,0.0
30594,3,594,[194 471 318 181 176],450,5,2292,3.8521008403361345,20.0,0.0
30595,3,595,[196 234 265 471  71],786,4,2296,3.8523489932885906,0.0,0.0
30596,3,596,[322 655 172 228  71],796,3,2299,3.8509212730318256,0.0,0.0
30597,3,597,[403 181 175  15 357],457,5,2304,3.8528428093645486,0.0,0.0
30598,3,598,[237 118 161   7 405],457,5,2309,3.8547579298831387,0.0,0.0
30599,3,599,[300 597  71  56 258],796,5,2314,3.8566666666666665,0.0,0.0
30600,3,600,[125 187 471 117 748],450,5,2319,3.858569051580699,0.0,0.0
30601,3,601,[187  89  50 328 271],655,3,2322,3.857142857142857,0.0,20.0
30602,3,602,[127 161  70 172 655],401,1,2323,3.8524046434494195,0.0,20.0
30603,3,603,[172 111 483 357  56],655,3,2326,3.8509933774834435,0.0,0.0
30604,3,604,[323 423  70 132 588],23,2,2328,3.847933884297521,0.0,0.0
30605,3,605,[273 118 127 275 423],796,4,2332,3.8481848184818483,0.0,40.0
30606,3,606,[211 181 385 655  64],796,3,2335,3.8467874794069195,20.0,0.0
30607,3,607,[179  88 405 265 216],786,5,2340,3.848684210526316,0.0,0.0
30608,3,608,[118 135 475 187 423],655,2,2342,3.845648604269294,0.0,0.0
30609,3,609,[  1 405 174 323 204],798,5,2347,3.8475409836065575,0.0,0.0
30610,3,610,[117 172 385 302   1],401,0,2347,3.841243862520458,0.0,0.0
30611,3,611,[742 215 357 181  70],457,5,2352,3.843137254901961,0.0,0.0
30612,3,612,[175 186 100 423 210],457,5,2357,3.8450244698205545,0.0,20.0
30613,3,613,[ 22  98 435 282 265],716,4,2361,3.8452768729641695,0.0,0.0
30614,3,614,[151  50 176  82  69],450,4,2365,3.845528455284553,0.0,20.0
30615,3,615,[187 427 282  22 237],450,5,2370,3.8474025974025974,20.0,0.0
30616,3,616,[176 168 143 151 655],457,5,2375,3.8492706645056725,0.0,0.0
30617,3,617,[187 186 294 204 200],835,3,2378,3.8478964401294498,0.0,0.0
30618,3,618,[144 197 143 655  79],655,2,2380,3.8449111470113086,0.0,0.0
30619,3,619,[257 245 125 471 508],938,2,2382,3.8419354838709676,0.0,0.0
30620,3,620,[ 96 151  98  71   7],577,4,2386,3.8421900161030598,0.0,0.0
30621,3,621,[183 546 216  98 245],280,3,2389,3.8408360128617365,0.0,0.0
30622,3,622,[185 427  79 269 286],796,3,2392,3.839486356340289,20.0,20.0
30623,3,623,[289 121 403 183 191],655,2,2394,3.8365384615384617,0.0,0.0
30624,3,624,[ 25 211  71 216 568],389,2,2396,3.8336,0.0,0.0
30625,3,625,[174 603 238 423  88],450,5,2401,3.8354632587859423,20.0,0.0
30626,3,626,[127 357 144 269 508],655,2,2403,3.8325358851674642,0.0,20.0
30627,3,627,[118 655 200 100 143],504,4,2407,3.832802547770701,0.0,20.0
30628,3,628,[ 25   1 282  15  11],256,4,2411,3.833068362480127,0.0,0.0
30629,3,629,[423 222 186 300 271],655,0,2411,3.826984126984127,0.0,0.0
30630,3,630,[204  25 132 423 258],655,0,2411,3.820919175911252,0.0,0.0
30631,3,631,[294 286 135 405 143],835,2,2413,3.8180379746835444,0.0,20.0
30632,3,632,[185  28 100  79  50],450,5,2418,3.8199052132701423,0.0,40.0
30633,3,633,[197 496 144  22 180],280,3,2421,3.8186119873817033,20.0,0.0
30634,3,634,[427  82 100 275 125],796,3,2424,3.8173228346456693,20.0,40.0
30635,3,635,[196 655 132 302  95],450,4,2428,3.8176100628930816,0.0,0.0
30636,3,636,[423 215 161 405  22],330,5,2433,3.8194662480376764,0.0,0.0
30637,3,637,[357 151 427   9 313],796,4,2437,3.8197492163009406,20.0,0.0
30638,3,638,[288  12 258 161 385],655,0,2437,3.8137715179968703,0.0,0.0
30639,3,639,[475 127  28  69   8],655,1,2438,3.809375,0.0,20.0
30640,3,640,[301 234 161 603 194],796,3,2441,3.8081123244929795,20.0,0.0
30641,3,641,[117  88 282   1 273],401,1,2442,3.803738317757009,0.0,0.0
30642,3,642,[183 748  79 271 265],796,5,2447,3.805598755832037,0.0,0.0
30643,3,643,[  9  64 597 742 151],457,4,2451,3.8059006211180124,20.0,0.0
30644,3,644,[ 64 403 196  97 515],655,2,2453,3.8031007751937986,20.0,0.0
30645,3,645,[286 182 300  25 568],655,1,2454,3.7987616099071206,0.0,20.0
30646,3,646,[186 423  70 405  12],457,5,2459,3.8006182380216385,0.0,0.0
30647,3,647,[210  71  22 196 275],344,3,2462,3.799382716049383,0.0,20.0
30648,3,648,[174 100 172 117 132],577,5,2467,3.8012326656394455,0.0,20.0
30649,3,649,[  9 183 118 588 121],457,5,2472,3.8030769230769232,0.0,0.0
30650,3,650,[ 88 100 269 328 427],655,1,2473,3.7987711213517663,20.0,20.0
30651,3,651,[100  88 496  50 286],236,1,2474,3.794478527607362,20.0,60.0
30652,3,652,[427 144  97 195 257],716,3,2477,3.7932618683001533,20.0,0.0
30653,3,653,[403  15 273  89 588],796,4,2481,3.793577981651376,0.0,0.0
30654,3,654,[151 144 215 282 187],716,2,2483,3.7908396946564884,0.0,0.0
30655,3,655,[271  28 182 286 655],655,1,2484,3.7865853658536586,0.0,20.0
30656,3,656,[294 405  50 174 202],280,0,2484,3.780821917808219,0.0,20.0
30657,3,657,[  7 235  12 678 222],256,4,2488,3.7811550151975686,0.0,0.0
30658,3,658,[121  28  25 238 180],11,1,2489,3.7769347496206374,0.0,0.0
30659,3,659,[234 172  82  64 423],389,5,2494,3.778787878787879,20.0,0.0
30660,3,660,[ 95  70 748 168 174],450,4,2498,3.779122541603631,0.0,0.0
30661,3,661,[318  56  98  25 111],716,5,2503,3.780966767371601,20.0,0.0
30662,3,662,[471 195 191 200  11],716,3,2506,3.779788838612368,0.0,0.0
30663,3,663,[ 96 286 176  22 423],655,0,2506,3.7740963855421685,0.0,20.0
30664,3,664,[ 28 197 117 234 265],796,2,2508,3.7714285714285714,0.0,0.0
30665,3,665,[588 204   4  98 211],450,4,2512,3.7717717717717716,0.0,0.0
30666,3,666,[ 25 235 403 144 174],457,4,2516,3.7721139430284856,0.0,0.0
30667,3,667,[117  56 182 210  22],280,3,2519,3.7709580838323356,0.0,0.0
30668,3,668,[ 88 427 294 118 144],716,3,2522,3.7698056801195814,20.0,0.0
30669,3,669,[183 151 153 318 427],151,3,2525,3.7686567164179103,40.0,0.0
30670,3,670,[328 313 127  97 748],796,4,2529,3.7690014903129656,0.0,20.0
30671,3,671,[117 180 215 423 427],450,5,2534,3.7708333333333335,20.0,0.0
30672,3,672,[161 168  71 121 117],450,3,2537,3.7696879643387815,0.0,0.0
30673,3,673,[265 176   1 161 185],655,1,2538,3.765578635014837,0.0,0.0
30674,3,674,[191 127   7  70 197],450,5,2543,3.7674074074074073,0.0,20.0
30675,3,675,[117  96 181 483   9],280,4,2547,3.7677514792899407,0.0,0.0
30676,3,676,[282 185 568  98 318],716,4,2551,3.7680945347119645,20.0,0.0
30677,3,677,[313 597 125 117 357],796,5,2556,3.769911504424779,0.0,0.0
30678,3,678,[173 211 196 153 597],450,5,2561,3.771723122238586,0.0,0.0
30679,3,679,[191  11 153 427 197],450,5,2566,3.773529411764706,20.0,0.0
30680,3,680,[194 181 228 568 210],577,2,2568,3.7709251101321586,0.0,0.0
30681,3,681,[294 588 238  12 427],450,5,2573,3.772727272727273,20.0,0.0
30682,3,682,[ 28  64  22 603 269],655,2,2575,3.7701317715959006,40.0,0.0
30683,3,683,[ 89 357 191 180 196],450,5,2580,3.7719298245614037,0.0,0.0
30684,3,684,[597 183 191 313 237],796,5,2585,3.7737226277372264,0.0,0.0
30685,3,685,[118 265 183 172 228],457,5,2590,3.7755102040816326,0.0,0.0
30686,3,686,[127 174 546 742   9],344,3,2593,3.7743813682678313,0.0,20.0
30687,3,687,[268 143 328 200  56],655,2,2595,3.7718023255813953,0.0,0.0
30688,3,688,[ 22   1  28 111 168],716,5,2600,3.7735849056603774,0.0,0.0
30689,3,689,[222  28 180 100  95],450,3,2603,3.772463768115942,0.0,20.0
30690,3,690,[403 265 385  79 427],450,5,2608,3.7742402315484807,20.0,0.0
30691,3,691,[ 50 186 300   7 176],450,4,2612,3.7745664739884393,0.0,20.0
30692,3,692,[200 265 318 143 204],577,3,2615,3.7734487734487736,20.0,0.0
30693,3,693,[186 135 202 182 655],450,3,2618,3.7723342939481266,0.0,0.0
30694,3,694,[237 427 273 238 200],450,3,2621,3.771223021582734,20.0,0.0
30695,3,695,[216 496 197 275 121],503,4,2625,3.771551724137931,20.0,20.0
30696,3,696,[204 186 127  15 222],457,5,2630,3.7733142037302727,0.0,20.0
30697,3,697,[111 151  70 300 215],151,4,2634,3.773638968481375,0.0,0.0
30698,3,698,[172 475 333 143 603],655,3,2637,3.772532188841202,20.0,0.0
30699,3,699,[496 301 271 204 546],796,4,2641,3.7728571428571427,20.0,0.0
30700,3,700,[228 313 245 318  96],280,2,2643,3.7703281027104136,20.0,0.0
30701,3,701,[ 11 245  50  98  69],344,2,2645,3.7678062678062676,0.0,20.0
30702,3,702,[186 228 215 185 196],655,1,2646,3.7638691322901847,0.0,0.0
30703,3,703,[ 56 301 234 318 323],796,2,2648,3.7613636363636362,20.0,0.0
30704,3,704,[132 121 328  50  95],796,5,2653,3.7631205673758865,0.0,20.0
30705,3,705,[  1  79 202 357   7],344,4,2657,3.763456090651558,0.0,0.0
30706,3,706,[175 328 276  70 204],655,1,2658,3.7595473833097595,0.0,0.0
30707,3,707,[185 172  12  88 144],450,5,2663,3.7612994350282487,0.0,0.0
30708,3,708,[100 200 282 196   8],796,4,2667,3.76163610719323,0.0,20.0
30709,3,709,[144  69 215 423 403],693,2,2669,3.759154929577465,0.0,0.0
30710,3,710,[405 202 186  22  98],577,4,2673,3.759493670886076,0.0,0.0
30711,3,711,[427 195 216 546 161],450,5,2678,3.7612359550561796,20.0,0.0
30712,3,712,[111  71 405 435 597],450,4,2682,3.7615708274894812,0.0,0.0
30713,3,713,[100  97   1 427 215],151,3,2685,3.7605042016806722,20.0,20.0
30714,3,714,[153  56 568 127  70],269,2,2687,3.758041958041958,0.0,20.0
30715,3,715,[405 186  71 273 483],796,3,2690,3.7569832402234637,0.0,0.0
30716,3,716,[144  28  22 187 357],796,4,2694,3.7573221757322175,0.0,0.0
30717,3,717,[215 294 186  22 200],457,4,2698,3.7576601671309193,0.0,0.0
30718,3,718,[ 56 179 210 175 127],655,2,2700,3.755215577190542,0.0,20.0
30719,3,719,[385  71 546 742 258],450,4,2704,3.7555555555555555,0.0,0.0
30720,3,720,[ 11 144  25 143  69],655,1,2705,3.751733703190014,0.0,0.0
30721,3,721,[191 175 423  28 271],655,1,2706,3.74792243767313,0.0,0.0
30722,3,722,[245 204  12 173 357],450,5,2711,3.7496542185338866,0.0,0.0
30723,3,723,[235 237 275 132  50],450,4,2715,3.75,0.0,40.0
30724,3,724,[210 568 132 185 195],796,4,2719,3.750344827586207,0.0,0.0
30725,3,725,[286 181 174 127 185],503,4,2723,3.7506887052341598,0.0,40.0
30726,3,726,[357 282 100 172 333],655,2,2725,3.74828060522696,0.0,20.0
30727,3,727,[215 222  28 161  11],693,2,2727,3.745879120879121,0.0,0.0
30728,3,728,[234 121 403 175 222],655,0,2727,3.740740740740741,0.0,0.0
30729,3,729,[ 71 471  82  25 265],577,4,2731,3.741095890410959,0.0,0.0
30730,3,730,[197  79 121 143 211],655,2,2733,3.7387140902872775,0.0,0.0
30731,3,731,[228 161  98 200 121],457,5,2738,3.740437158469945,0.0,0.0
30732,3,732,[275 405 471 175 597],457,4,2742,3.7407912687585267,0.0,20.0
30733,3,733,[237  15 742 181 222],655,0,2742,3.7356948228882834,0.0,0.0
30734,3,734,[ 79   1 435 144  12],655,1,2743,3.7319727891156464,0.0,0.0
30735,3,735,[ 96 333 187 603   9],655,2,2745,3.729619565217391,20.0,0.0
30736,3,736,[180 181 268 182  22],269,2,2747,3.727272727272727,0.0,0.0
30737,3,737,[655 144 328 294  64],401,2,2749,3.7249322493224932,20.0,0.0
30738,3,738,[121 100   9 211 181],655,0,2749,3.719891745602165,0.0,20.0
30739,3,739,[483  88 210  25 515],655,2,2751,3.7175675675675675,0.0,0.0
30740,3,740,[258 172 161 215  98],693,3,2754,3.716599190283401,0.0,0.0
30741,3,741,[328 195 111  28 204],151,3,2757,3.715633423180593,0.0,0.0
30742,3,742,[  4 174 245  11 300],629,2,2759,3.7133243606998656,0.0,0.0
30743,3,743,[211  98 568 204 180],450,5,2764,3.71505376344086,0.0,0.0
30744,3,744,[405   1  70   9  11],401,1,2765,3.7114093959731544,0.0,0.0
30745,3,745,[ 11 197 187   7 245],629,2,2767,3.7091152815013406,0.0,0.0
30746,3,746,[294 423 143 403  28],457,4,2771,3.7095046854083,0.0,0.0
30747,3,747,[ 22 385 257  89 202],796,5,2776,3.7112299465240643,0.0,0.0
30748,3,748,[ 89 228   1 568 176],450,5,2781,3.712950600801068,0.0,0.0
30749,3,749,[215 568 275 111 118],716,4,2785,3.7133333333333334,0.0,20.0
30750,3,750,[678   8 273  11 508],344,3,2788,3.7123834886817577,0.0,0.0
30751,3,751,[427 318 182  98 191],18,5,2793,3.714095744680851,40.0,0.0
30752,3,752,[427 318 182  98 191],655,5,2798,3.7158034528552455,40.0,0.0
30753,3,753,[427 318 182  98 191],450,5,2803,3.717506631299735,40.0,0.0
30754,3,754,[427 318 182  98 191],450,5,2808,3.719205298013245,40.0,0.0
30755,3,755,[132 302 179 173  50],535,4,2812,3.7195767195767195,0.0,20.0
30756,3,756,[427 318 182  98 191],655,5,2817,3.7212681638044915,40.0,0.0
30757,3,757,[427 318 182  98 191],72,5,2822,3.7229551451187337,40.0,0.0
30758,3,758,[273   1  69 269 423],655,1,2823,3.719367588932806,0.0,0.0
30759,3,759,[318 427 182  98 191],269,5,2828,3.721052631578947,40.0,0.0
30760,3,760,[318 427 182  98 191],796,5,2833,3.7227332457293034,40.0,0.0
30761,3,761,[ 64  22  71  82 196],450,3,2836,3.7217847769028873,20.0,0.0
30762,3,762,[176 187 183 181 168],796,5,2841,3.7234600262123196,0.0,0.0
30763,3,763,[ 64 173  88 269  95],450,4,2845,3.723821989528796,20.0,0.0
30764,3,764,[318 427 182  98 191],269,5,2850,3.7254901960784315,40.0,0.0
30765,3,765,[ 82  79 269 322 275],450,4,2854,3.7258485639686683,0.0,20.0
30766,3,766,[180  22 168  56  95],796,4,2858,3.726205997392438,0.0,0.0
30767,3,767,[318 186 176  98 228],796,4,2862,3.7265625,20.0,0.0
30768,3,768,[318 427 182  98 191],655,5,2867,3.728218465539662,40.0,0.0
30769,3,769,[318 427 182  98 191],450,5,2872,3.72987012987013,40.0,0.0
30770,3,770,[127   1 268 475   9],296,5,2877,3.7315175097276265,0.0,20.0
30771,3,771,[405  69 121 475 435],655,0,2877,3.726683937823834,0.0,0.0
30772,3,772,[269 132 125  89 275],344,4,2881,3.727037516170763,0.0,20.0
30773,3,773,[271 176 318  12 742],655,1,2882,3.7235142118863047,20.0,0.0
30774,3,774,[318 427 182  98 191],269,5,2887,3.7251612903225806,40.0,0.0
30775,3,775,[318 427 182  98 191],72,5,2892,3.7268041237113403,40.0,0.0
30776,3,776,[318 427 182  98 191],655,5,2897,3.7284427284427286,40.0,0.0
30777,3,777,[195 258 211  25 275],535,5,2902,3.730077120822622,0.0,20.0
30778,3,778,[127  11 132 435 300],450,5,2907,3.731707317073171,0.0,20.0
30779,3,779,[185   9 258 515 300],655,2,2909,3.7294871794871796,0.0,0.0
30780,3,780,[427 318 182  98 191],72,5,2914,3.731113956466069,40.0,0.0
30781,3,781,[483 132 435 135   9],535,4,2918,3.731457800511509,0.0,0.0
30782,3,782,[427 318 182  98 191],450,5,2923,3.7330779054916987,40.0,0.0
30783,3,783,[ 56   1 655 294 100],796,1,2924,3.729591836734694,0.0,20.0
30784,3,784,[  8 385 187  25 216],503,4,2928,3.729936305732484,0.0,0.0
30785,3,785,[427 318 182  98 191],796,5,2933,3.731552162849873,40.0,0.0
30786,3,786,[427 318 182  98 191],18,5,2938,3.733163913595934,40.0,0.0
30787,3,787,[183 234 121 423 235],716,3,2941,3.732233502538071,0.0,0.0
30788,3,788,[  9 275 269 471  22],535,4,2945,3.732572877059569,0.0,20.0
30789,3,789,[ 15 357 655 182 195],629,5,2950,3.7341772151898733,0.0,0.0
30790,3,790,[427 318 182  98 191],655,5,2955,3.735777496839444,40.0,0.0
30791,3,791,[318 435 276 125 603],655,3,2958,3.734848484848485,40.0,0.0
30792,3,792,[234  28 294 403 197],504,2,2960,3.7326607818411097,0.0,0.0
30793,3,793,[202 215  12 288  22],655,0,2960,3.7279596977329974,0.0,0.0
30794,3,794,[427 318 182  98 191],72,5,2965,3.729559748427673,40.0,0.0
30795,3,795,[172  96 185 144 258],796,5,2970,3.7311557788944723,0.0,0.0
30796,3,796,[427 318 182  98 191],269,5,2975,3.7327478042659976,40.0,0.0
30797,3,797,[568 186 121   4 215],796,4,2979,3.7330827067669174,0.0,0.0
30798,3,798,[427 318 182  98 191],450,5,2984,3.7346683354192742,40.0,0.0
30799,3,799,[427 318 182  98 191],269,5,2989,3.73625,40.0,0.0
30800,3,800,[427 318 182  98 191],72,5,2994,3.737827715355805,40.0,0.0
30801,3,801,[  1 196 143 603  71],450,4,2998,3.7381546134663344,20.0,0.0
30802,3,802,[742 210 172 183 204],796,3,3001,3.7372353673723535,0.0,0.0
30803,3,803,[196 121 216  70 176],716,4,3005,3.737562189054726,0.0,0.0
30804,3,804,[318 427 182  98 191],269,5,3010,3.739130434782609,40.0,0.0
30805,3,805,[318 427 182  98 191],655,5,3015,3.740694789081886,40.0,0.0
30806,3,806,[435 172  89 181 237],72,1,3016,3.73729863692689,0.0,0.0
30807,3,807,[  4 111 423  70 403],450,4,3020,3.737623762376238,0.0,0.0
30808,3,808,[ 89 237 132 385 496],450,5,3025,3.7391841779975277,20.0,0.0
30809,3,809,[258  96 180 183  70],457,5,3030,3.740740740740741,0.0,0.0
30810,3,810,[318 427 182  98 191],796,5,3035,3.7422934648581996,40.0,0.0
30811,3,811,[318 427 182  98 191],796,5,3040,3.7438423645320196,40.0,0.0
30812,3,812,[318 427 182  98 191],655,5,3045,3.745387453874539,40.0,0.0
30813,3,813,[204 100 181 174 191],494,5,3050,3.746928746928747,0.0,20.0
30814,3,814,[427 318 182  98 191],18,5,3055,3.7484662576687118,40.0,0.0
30815,3,815,[427 318 182  98 191],72,5,3060,3.75,40.0,0.0
30816,3,816,[427 318 182  98 191],269,5,3065,3.751529987760098,40.0,0.0
30817,3,817,[204 234  98  50 235],457,4,3069,3.751833740831296,0.0,20.0
30818,3,818,[427 318 182  98 191],72,5,3074,3.7533577533577533,40.0,0.0
30819,3,819,[427 318 182  98 191],18,5,3079,3.754878048780488,40.0,0.0
30820,3,820,[ 12   4 210 125 302],151,4,3083,3.7551766138855056,0.0,0.0
30821,3,821,[318 427 182  98 191],269,5,3088,3.75669099756691,40.0,0.0
30822,3,822,[ 96 322 496 111 127],908,3,3091,3.755771567436209,20.0,20.0
30823,3,823,[427 318 182  98 191],269,5,3096,3.7572815533980584,40.0,0.0
30824,3,824,[118 117 258 222 568],756,1,3097,3.753939393939394,0.0,0.0
30825,3,825,[318 427 182  98 191],796,5,3102,3.7554479418886197,40.0,0.0
30826,3,826,[318 427 182  98 191],450,5,3107,3.7569528415961306,40.0,0.0
30827,3,827,[318 427 182  98 191],72,5,3112,3.758454106280193,40.0,0.0
30828,3,828,[322 121 328 234  79],796,3,3115,3.7575392038600723,0.0,0.0
30829,3,829,[318 427 182  98 191],72,5,3120,3.7590361445783134,40.0,0.0
30830,3,830,[ 64 181 273 211 258],693,1,3121,3.7557160048134777,20.0,0.0
30831,3,831,[210  98 282 172 655],796,3,3124,3.7548076923076925,0.0,0.0
30832,3,832,[318 427 182  98 191],450,5,3129,3.7563025210084033,40.0,0.0
30833,3,833,[318 427 182  98 191],450,5,3134,3.7577937649880098,40.0,0.0
30834,3,834,[ 28 132 228 153 222],655,0,3134,3.753293413173653,0.0,0.0
30835,3,835,[318 427 182  98 191],72,5,3139,3.7547846889952154,40.0,0.0
30836,3,836,[ 56 172 186 216 132],577,4,3143,3.7550776583034646,0.0,0.0
30837,3,837,[318 427 182  98 191],450,5,3148,3.756563245823389,40.0,0.0
30838,3,838,[ 95 515 187  82  56],716,4,3152,3.756853396901073,0.0,0.0
30839,3,839,[ 79 215 151  22 748],450,5,3157,3.7583333333333333,0.0,0.0
30840,3,840,[ 69 204  79 237  97],236,4,3161,3.7586206896551726,0.0,0.0
30841,3,841,[318 427 182  98 191],269,5,3166,3.7600950118764844,40.0,0.0
30842,3,842,[318 427 182  98 191],72,5,3171,3.7615658362989324,40.0,0.0
30843,3,843,[483 211 185  97 603],450,4,3175,3.7618483412322274,20.0,0.0
30844,3,844,[318 427 182  98 191],18,5,3180,3.7633136094674557,40.0,0.0
30845,3,845,[301 235 742 748 405],450,4,3184,3.7635933806146573,0.0,0.0
30846,3,846,[318 427 182  98 191],796,5,3189,3.7650531286894924,40.0,0.0
30847,3,847,[204 427 196  79 143],577,4,3193,3.765330188679245,20.0,0.0
30848,3,848,[234 655 204 275 173],151,5,3198,3.76678445229682,0.0,20.0
30849,3,849,[318 427 182  98 191],18,5,3203,3.768235294117647,40.0,0.0
30850,3,850,[153  79 191 117 483],655,3,3206,3.7673325499412456,0.0,0.0
30851,3,851,[179 286 187 197 405],835,3,3209,3.766431924882629,0.0,20.0
30852,3,852,[318 427 182  98 191],450,5,3214,3.7678780773739744,40.0,0.0
30853,3,853,[118  56 215 173 186],450,3,3217,3.7669789227166275,0.0,0.0
30854,3,854,[588 121 181 294 322],450,4,3221,3.767251461988304,0.0,0.0
30855,3,855,[742 173 195  28   1],457,5,3226,3.7686915887850465,0.0,0.0
30856,3,856,[742 210   9  70 234],457,5,3231,3.7701283547257876,0.0,0.0
30857,3,857,[318 427 182  98 191],796,5,3236,3.7715617715617715,40.0,0.0
30858,3,858,[318 427 182  98 191],72,5,3241,3.7729918509895226,40.0,0.0
30859,3,859,[ 56 117 185 288 496],450,4,3245,3.7732558139534884,20.0,0.0
30860,3,860,[ 28  11 294 176 172],577,4,3249,3.773519163763066,0.0,0.0
30861,3,861,[597  89  79 357 273],796,4,3253,3.773781902552204,0.0,0.0
30862,3,862,[318 427 182  98 191],450,5,3258,3.7752027809965236,40.0,0.0
30863,3,863,[144 174  25 483 588],401,4,3262,3.775462962962963,0.0,0.0
30864,3,864,[318 427 182  98 191],655,5,3267,3.776878612716763,40.0,0.0
30865,3,865,[318 427 182  98 191],655,5,3272,3.7782909930715936,40.0,0.0
30866,3,866,[111 302 483  22 423],269,2,3274,3.776239907727797,0.0,0.0
30867,3,867,[ 98 435 187 127 238],296,5,3279,3.7776497695852536,0.0,20.0
30868,3,868,[318 427 182  98 191],796,5,3284,3.779056386651323,40.0,0.0
30869,3,869,[318 427 182  98 191],796,5,3289,3.7804597701149425,40.0,0.0
30870,3,870,[318 427 182  98 191],796,5,3294,3.7818599311136625,40.0,0.0
30871,3,871,[318 427 182  98 191],450,5,3299,3.783256880733945,40.0,0.0
30872,3,872,[318 427 182  98 191],796,5,3304,3.7846506300114546,40.0,0.0
30873,3,873,[515 132  88 210 196],269,2,3306,3.782608695652174,0.0,0.0
30874,3,874,[318 427 182  98 191],72,5,3311,3.784,40.0,0.0
30875,3,875,[216  25 405 234 318],577,3,3314,3.7831050228310503,20.0,0.0
30876,3,876,[195  56 471 222 515],716,3,3317,3.782212086659065,0.0,0.0
30877,3,877,[125 427 275 161 153],450,5,3322,3.783599088838269,20.0,20.0
30878,3,878,[135 235 234 183 168],457,4,3326,3.783845278725825,0.0,0.0
30879,3,879,[318 427 182  98 191],72,5,3331,3.7852272727272727,40.0,0.0
30880,3,880,[318 427 182  98 191],796,5,3336,3.786606129398411,40.0,0.0
30881,3,881,[318 427 182  98 191],269,5,3341,3.7879818594104306,40.0,0.0
30882,3,882,[197 196 742 175 269],655,0,3341,3.783691959229898,0.0,0.0
30883,3,883,[187  89  50 238 423],796,4,3345,3.7839366515837103,0.0,20.0
30884,3,884,[318 427 182  98 191],269,5,3350,3.785310734463277,40.0,0.0
30885,3,885,[294   4 496 275   1],796,3,3353,3.784424379232506,20.0,20.0
30886,3,886,[216 121  56 100 471],65,3,3356,3.783540022547914,0.0,20.0
30887,3,887,[318 427 182  98 191],796,5,3361,3.78490990990991,40.0,0.0
30888,3,888,[ 11 135 313 237 258],224,1,3362,3.78177727784027,0.0,0.0
30889,3,889,[318 427 182  98 191],450,5,3367,3.7831460674157302,40.0,0.0
30890,3,890,[318 427 182  98 191],450,5,3372,3.7845117845117846,40.0,0.0
30891,3,891,[318 427 182  98 191],450,5,3377,3.7858744394618835,40.0,0.0
30892,3,892,[183  56 153   8 176],796,5,3382,3.7872340425531914,0.0,0.0
30893,3,893,[318 427 182  98 191],18,5,3387,3.7885906040268456,40.0,0.0
30894,3,894,[318 427 182  98 191],655,5,3392,3.7899441340782123,40.0,0.0
30895,3,895,[ 88 276 323 153 125],504,2,3394,3.7879464285714284,0.0,0.0
30896,3,896,[ 22 125 197   4 181],655,0,3394,3.7837235228539576,0.0,0.0
30897,3,897,[318 427 182  98 191],269,5,3399,3.785077951002227,40.0,0.0
30898,3,898,[318 427 182  98 191],18,5,3404,3.78642936596218,40.0,0.0
30899,3,899,[546 322 202  12   4],450,4,3408,3.7866666666666666,0.0,0.0
30900,3,900,[125 268 202  12  82],174,4,3412,3.786903440621532,0.0,0.0
30901,3,901,[318 427 182  98 191],655,5,3417,3.7882483370288247,40.0,0.0
30902,3,902,[318 427 182  98 191],450,5,3422,3.7895902547065337,40.0,0.0
30903,3,903,[318 427 182  98 191],655,5,3427,3.790929203539823,40.0,0.0
30904,3,904,[111  22  79 168 215],716,5,3432,3.7922651933701657,0.0,0.0
30905,3,905,[318 427 182  98 191],655,5,3437,3.793598233995585,40.0,0.0
30906,3,906,[423 196 204   4 200],151,4,3441,3.7938257993384785,0.0,0.0
30907,3,907,[  9 186 603 234 748],151,4,3445,3.7940528634361232,20.0,0.0
30908,3,908,[318 427 182  98 191],796,5,3450,3.7953795379537953,40.0,0.0
30909,3,909,[181  50 168 200 405],577,3,3453,3.7945054945054943,0.0,20.0
30910,3,910,[318 427 182  98 191],269,5,3458,3.79582875960483,40.0,0.0
30911,3,911,[318 427 182  98 191],18,5,3463,3.7971491228070176,40.0,0.0
30912,3,912,[318 427 182  98 191],269,5,3468,3.7984665936473165,40.0,0.0
30913,3,913,[483 300 546 228 151],807,5,3473,3.799781181619256,0.0,0.0
30914,3,914,[318 427 182  98 191],450,5,3478,3.8010928961748633,40.0,0.0
30915,3,915,[200 328 333 204   8],655,1,3479,3.7980349344978164,0.0,0.0
30916,3,916,[318 427 182  98 191],269,5,3484,3.7993456924754634,40.0,0.0
30917,3,917,[318 427 182  98 191],72,5,3489,3.8006535947712417,40.0,0.0
30918,3,918,[172 655  69 471 423],280,2,3491,3.7986942328618065,0.0,0.0
30919,3,919,[318 427 182  98 191],655,5,3496,3.8,40.0,0.0
30920,3,920,[483 196 427 282   7],693,3,3499,3.799131378935939,20.0,0.0
30921,3,921,[153 603  98 202  69],151,4,3503,3.799349240780911,20.0,0.0
30922,3,922,[318 427 182  98 191],18,5,3508,3.800650054171181,40.0,0.0
30923,3,923,[300 333 186 194  15],796,4,3512,3.8008658008658007,0.0,0.0
30924,3,924,[200 475 318 127 423],655,3,3515,3.8,20.0,20.0
30925,3,925,[202 204 176  50  69],796,5,3520,3.801295896328294,0.0,20.0
30926,3,926,[ 96  64 194 268 127],269,4,3524,3.80151024811219,20.0,20.0
30927,3,927,[427 318 182  98 191],655,5,3529,3.802801724137931,40.0,0.0
30928,3,928,[427 318 182  98 191],72,5,3534,3.804090419806243,40.0,0.0
30929,3,929,[427 318 182  98 191],450,5,3539,3.8053763440860213,40.0,0.0
30930,3,930,[427 318 182  98 191],269,5,3544,3.8066595059076263,40.0,0.0
30931,3,931,[427 318 182  98 191],655,5,3549,3.8079399141630903,40.0,0.0
30932,3,932,[427 318 182  98 191],269,5,3554,3.8092175777063235,40.0,0.0
30933,3,933,[427 318 182  98 191],269,5,3559,3.810492505353319,40.0,0.0
30934,3,934,[275  15   7 508 597],463,4,3563,3.8106951871657753,0.0,20.0
30935,3,935,[ 50 200 333  96 357],655,3,3566,3.8098290598290596,0.0,20.0
30936,3,936,[301  97 168 118 125],796,3,3569,3.8089647812166487,0.0,0.0
30937,3,937,[318 427 182  98 191],72,5,3574,3.810234541577825,40.0,0.0
30938,3,938,[197  50 183 228 175],151,4,3578,3.8104366347177847,0.0,20.0
30939,3,939,[318 195  71 194  98],796,5,3583,3.8117021276595744,20.0,0.0
30940,3,940,[318 427 182  98 191],450,5,3588,3.812964930924548,40.0,0.0
30941,3,941,[  1 118 318 202 483],655,2,3590,3.81104033970276,20.0,0.0
30942,3,942,[271 423 135   1 273],655,2,3592,3.809119830328738,0.0,0.0
30943,3,943,[ 50  56 288  12  25],655,1,3593,3.8061440677966103,0.0,20.0
30944,3,944,[195 185  82  56 121],504,4,3597,3.806349206349206,0.0,0.0
30945,3,945,[268 471 403 215 234],655,0,3597,3.802325581395349,0.0,0.0
30946,3,946,[318 427 182  98 191],18,5,3602,3.8035902851108765,40.0,0.0
30947,3,947,[318 427 182  98 191],796,5,3607,3.8048523206751055,40.0,0.0
30948,3,948,[318 427 182  98 191],796,5,3612,3.8061116965226556,40.0,0.0
30949,3,949,[182  25 435  15  11],655,1,3613,3.803157894736842,0.0,0.0
30950,3,950,[318 427 182  98 191],655,5,3618,3.804416403785489,40.0,0.0
30951,3,951,[197   4  82 111 202],796,3,3621,3.8035714285714284,0.0,0.0
30952,3,952,[318 427 182  98 191],450,5,3626,3.8048268625393495,40.0,0.0
30953,3,953,[318 427 182  98 191],796,5,3631,3.8060796645702304,40.0,0.0
30954,3,954,[174   9 276  56 197],18,5,3636,3.8073298429319373,0.0,0.0
30955,3,955,[282 238 655 118  70],450,4,3640,3.807531380753138,0.0,0.0
30956,3,956,[197   8 405 333 435],655,0,3640,3.8035527690700106,0.0,0.0
30957,3,957,[588 423 172 258 300],807,4,3644,3.8037578288100207,0.0,0.0
30958,3,958,[211 471 176 322 742],450,5,3649,3.8050052137643378,0.0,0.0
30959,3,959,[318 427 182  98 191],796,5,3654,3.80625,40.0,0.0
30960,3,960,[  1 132 143 275 185],23,4,3658,3.806451612903226,0.0,20.0
30961,3,961,[ 82 423 258 742 196],796,3,3661,3.8056133056133055,0.0,0.0
30962,3,962,[427 318 182  98 191],269,5,3666,3.8068535825545173,40.0,0.0
30963,3,963,[427 318 182  98 191],72,5,3671,3.8080912863070537,40.0,0.0
30964,3,964,[ 96 235 202 117 118],344,2,3673,3.806217616580311,0.0,0.0
30965,3,965,[135  79 204 182 161],280,3,3676,3.8053830227743273,0.0,0.0
30966,3,966,[100   1 210 238   9],65,2,3678,3.8035160289555328,0.0,20.0
30967,3,967,[318 427  98 182 191],450,5,3683,3.8047520661157024,40.0,0.0
30968,3,968,[318 427  98 182 191],655,5,3688,3.805985552115583,40.0,0.0
30969,3,969,[318 427  98 182 191],18,5,3693,3.8072164948453606,40.0,0.0
30970,3,970,[318 427  98 182 191],269,5,3698,3.808444902162719,40.0,0.0
30971,3,971,[  7 546 655 191   1],457,4,3702,3.808641975308642,0.0,0.0
30972,3,972,[471  79 197 204  28],450,5,3707,3.8098663926002057,0.0,0.0
30973,3,973,[318 427  98 182 191],18,5,3712,3.811088295687885,40.0,0.0
30974,3,974,[180  96 357 173  79],457,5,3717,3.812307692307692,0.0,0.0
30975,3,975,[318 427  98 182 191],450,5,3722,3.8135245901639343,40.0,0.0
30976,3,976,[318 427  98 182 191],269,5,3727,3.8147389969293757,40.0,0.0
30977,3,977,[318 427  98 182 191],796,5,3732,3.815950920245399,40.0,0.0
30978,3,978,[546 172 318 180 568],450,5,3737,3.8171603677221655,20.0,0.0
30979,3,979,[318 427  98 182 191],655,5,3742,3.8183673469387753,40.0,0.0
30980,3,980,[318 427  98 182 191],450,5,3747,3.819571865443425,40.0,0.0
30981,3,981,[318 427  98 182 191],72,5,3752,3.820773930753564,40.0,0.0
30982,3,982,[318  97 742 238  88],450,5,3757,3.821973550356053,20.0,0.0
30983,3,983,[271  12 275 127  79],796,5,3762,3.823170731707317,0.0,40.0
30984,3,984,[318 427  98 182 191],18,5,3767,3.8243654822335027,40.0,0.0
30985,3,985,[318 427  98 182 191],450,5,3772,3.8255578093306286,40.0,0.0
30986,3,986,[117 118  69 196 496],577,4,3776,3.8257345491388044,20.0,0.0
30987,3,987,[588 183  25 210 302],344,5,3781,3.826923076923077,0.0,0.0
30988,3,988,[427 318  98 182 191],18,5,3786,3.828109201213347,40.0,0.0
30989,3,989,[144 286 288 603 228],450,4,3790,3.8282828282828283,20.0,20.0
30990,3,990,[427 318  98 182 191],269,5,3795,3.829465186680121,40.0,0.0
30991,3,991,[427 318  98 182 191],72,5,3800,3.8306451612903225,40.0,0.0
30992,3,992,[328 196 234 301 118],450,3,3803,3.8298086606243706,0.0,0.0
30993,3,993,[269 204 181 228 215],344,3,3806,3.82897384305835,0.0,0.0
30994,3,994,[118 179 235 471 175],457,4,3810,3.829145728643216,0.0,0.0
30995,3,995,[ 70 257 172 228 405],330,5,3815,3.8303212851405624,0.0,0.0
30996,3,996,[176 655 151  64 216],269,3,3818,3.8294884653961887,20.0,0.0
30997,3,997,[318 427  98 182 191],655,5,3823,3.8306613226452906,40.0,0.0
30998,3,998,[318 294 300 211 127],716,5,3828,3.8318318318318316,20.0,20.0
30999,3,999,[ 22 121 238 215 127],450,4,3832,3.832,0.0,20.0
31000,3,1000,[423 191  50  12 568],655,2,3834,3.8301698301698304,0.0,20.0
31001,3,1001,[603 182 186 135   4],655,3,3837,3.8293413173652695,20.0,0.0
31002,3,1002,[318 427  98 182 191],18,5,3842,3.830508474576271,40.0,0.0
31003,3,1003,[318 427  98 182 191],450,5,3847,3.8316733067729083,40.0,0.0
31004,3,1004,[273 515 271 318 211],655,3,3850,3.8308457711442787,20.0,0.0
31005,3,1005,[318 427  98 182 191],18,5,3855,3.832007952286282,40.0,0.0
31006,3,1006,[546   4 678 385 127],344,2,3857,3.830188679245283,0.0,20.0
31007,3,1007,[435 286 200 202   4],18,2,3859,3.828373015873016,0.0,20.0
31008,3,1008,[318 427  98 182 191],18,5,3864,3.829534192269574,40.0,0.0
31009,3,1009,[191   1  22 132 174],457,5,3869,3.8306930693069305,0.0,0.0
31010,3,1010,[318 427  98 182 191],72,5,3874,3.831849653808111,40.0,0.0
31011,3,1011,[172 282  56  70  22],535,1,3875,3.8290513833992095,0.0,0.0
31012,3,1012,[427 318  98 182 191],269,5,3880,3.8302073050345506,40.0,0.0
31013,3,1013,[427 318  98 182 191],450,5,3885,3.831360946745562,40.0,0.0
31014,3,1014,[182 195 403 222 328],796,5,3890,3.832512315270936,0.0,0.0
31015,3,1015,[427 318  98 182 191],450,5,3895,3.8336614173228347,40.0,0.0
31016,3,1016,[ 89 294  98 176  70],450,5,3900,3.8348082595870205,0.0,0.0
31017,3,1017,[127 603 257 322 180],796,3,3903,3.8339882121807465,20.0,20.0
31018,3,1018,[183 176 216 238 172],796,4,3907,3.834151128557409,0.0,0.0
31019,3,1019,[245  96 118 655  64],796,3,3910,3.8333333333333335,20.0,0.0
31020,3,1020,[181   9  79  50 180],18,4,3914,3.833496571988247,0.0,20.0
31021,3,1021,[427 318  98 182 191],72,5,3919,3.834637964774951,40.0,0.0
31022,3,1022,[427 318  98 182 191],655,5,3924,3.835777126099707,40.0,0.0
31023,3,1023,[ 22  96 197 385 196],655,0,3924,3.83203125,0.0,0.0
31024,3,1024,[ 28 427 183  69 179],450,5,3929,3.833170731707317,20.0,0.0
31025,3,1025,[215 182 186 237 185],457,5,3934,3.834307992202729,0.0,0.0
31026,3,1026,[427 318  98 182 191],450,5,3939,3.8354430379746836,40.0,0.0
31027,3,1027,[427 318  98 182 191],269,5,3944,3.8365758754863815,40.0,0.0
31028,3,1028,[100  79 202  50 286],796,3,3947,3.835762876579203,0.0,60.0
31029,3,1029,[125 235 180 111 257],457,2,3949,3.833980582524272,0.0,0.0
31030,3,1030,[235  69 168 174  15],269,1,3950,3.831231813773036,0.0,0.0
31031,3,1031,[357  28 300  71  56],796,4,3954,3.8313953488372094,0.0,0.0
31032,3,1032,[427 318  98 182 191],18,5,3959,3.8325266214908034,40.0,0.0
31033,3,1033,[100  69  98  88 118],593,5,3964,3.8336557059961316,0.0,20.0
31034,3,1034,[427 318  98 182 191],796,5,3969,3.8347826086956522,40.0,0.0
31035,3,1035,[427 318  98 182 191],269,5,3974,3.835907335907336,40.0,0.0
31036,3,1036,[269 135 174 427  96],655,2,3976,3.8341369334619095,20.0,0.0
31037,3,1037,[357 144 265 181  82],655,1,3977,3.83140655105973,0.0,0.0
31038,3,1038,[427 318  98 182 191],18,5,3982,3.832531280076997,40.0,0.0
31039,3,1039,[603  50 151 678 125],401,1,3983,3.8298076923076922,20.0,20.0
31040,3,1040,[427 318  98 182 191],450,5,3988,3.8309317963496636,40.0,0.0
31041,3,1041,[427 318  98 182 191],655,5,3993,3.8320537428023034,40.0,0.0
31042,3,1042,[127 237  79  11 475],655,2,3995,3.8302972195589646,0.0,20.0
31043,3,1043,[117 222 176 302  95],344,4,3999,3.8304597701149423,0.0,0.0
31044,3,1044,[427 318  98 182 191],655,5,4004,3.831578947368421,40.0,0.0
31045,3,1045,[258 300  95 176 168],796,5,4009,3.832695984703633,0.0,0.0
31046,3,1046,[603 144 357 125 423],450,5,4014,3.833810888252149,20.0,0.0
31047,3,1047,[427 318  98 182 191],18,5,4019,3.8349236641221376,40.0,0.0
31048,3,1048,[318 144 132 322 125],450,5,4024,3.836034318398475,20.0,0.0
31049,3,1049,[427 318  98 182 191],796,5,4029,3.837142857142857,40.0,0.0
31050,3,1050,[427 318  98 182 191],450,5,4034,3.8382492863939106,40.0,0.0
31051,3,1051,[194 546  25 180  50],716,3,4037,3.83745247148289,0.0,20.0
31052,3,1052,[318 427  98 182 191],655,5,4042,3.838556505223172,40.0,0.0
31053,3,1053,[318 427  98 182 191],18,5,4047,3.8396584440227706,40.0,0.0
31054,3,1054,[194 271 153 216 258],796,5,4052,3.8407582938388627,0.0,0.0
31055,3,1055,[195 427 197 210 185],535,5,4057,3.8418560606060606,20.0,0.0
31056,3,1056,[187 328 273  56 238],655,2,4059,3.840113528855251,0.0,0.0
31057,3,1057,[179 185 258  97 151],504,4,4063,3.840264650283554,0.0,0.0
31058,3,1058,[427 318  98 182 191],450,5,4068,3.8413597733711047,40.0,0.0
31059,3,1059,[176 210 143 216 275],389,2,4070,3.839622641509434,0.0,20.0
31060,3,1060,[427 318  98 182 191],72,5,4075,3.84071630537229,40.0,0.0
31061,3,1061,[427 318  98 182 191],269,5,4080,3.84180790960452,40.0,0.0
31062,3,1062,[151 175  89 423  28],23,2,4082,3.8400752587017872,0.0,0.0
31063,3,1063,[318 427  98 182 191],450,5,4087,3.8411654135338344,40.0,0.0
31064,3,1064,[318 427  98 182 191],72,5,4092,3.8422535211267608,40.0,0.0
31065,3,1065,[182 197 427   4 496],18,4,4096,3.8424015009380863,40.0,0.0
31066,3,1066,[181 143  15 483 127],389,3,4099,3.8416119962511717,0.0,20.0
31067,3,1067,[318 427  98 182 191],18,5,4104,3.842696629213483,40.0,0.0
31068,3,1068,[301 603 117   4 471],655,1,4105,3.840037418147802,20.0,0.0
31069,3,1069,[215   7 194 181 237],577,4,4109,3.8401869158878505,0.0,0.0
31070,3,1070,[318 427  98 182 191],655,5,4114,3.8412698412698414,40.0,0.0
31071,3,1071,[318 427  98 182 191],450,5,4119,3.842350746268657,40.0,0.0
31072,3,1072,[117 588 173 172  97],716,5,4124,3.843429636533085,0.0,0.0
31073,3,1073,[318 427  98 182 191],18,5,4129,3.844506517690875,40.0,0.0
31074,3,1074,[318 427  98 182 191],796,5,4134,3.8455813953488374,40.0,0.0
31075,3,1075,[405 276 151   1  25],277,3,4137,3.8447955390334574,0.0,0.0
31076,3,1076,[273  64 258  88 300],693,1,4138,3.842154131847725,20.0,0.0
31077,3,1077,[427 318  98 182 191],450,5,4143,3.8432282003710574,40.0,0.0
31078,3,1078,[ 98 176 318 313 288],450,4,4147,3.8433734939759034,20.0,0.0
31079,3,1079,[ 82  22 182 427 180],450,4,4151,3.8435185185185183,20.0,0.0
31080,3,1080,[ 82 301 265  50 194],450,4,4155,3.843663274745606,0.0,20.0
31081,3,1081,[483 125 237 161 186],450,3,4158,3.842883548983364,0.0,0.0
31082,3,1082,[286 215 196 135 234],151,4,4162,3.8430286241920593,0.0,20.0
31083,3,1083,[318 427  98 182 191],269,5,4167,3.8440959409594098,40.0,0.0
31084,3,1084,[318 427  98 182 191],18,5,4172,3.8451612903225807,40.0,0.0
31085,3,1085,[318 427  98 182 191],796,5,4177,3.8462246777163904,40.0,0.0
31086,3,1086,[318 427  98 182 191],18,5,4182,3.847286108555658,40.0,0.0
31087,3,1087,[318 427  98 182 191],450,5,4187,3.848345588235294,40.0,0.0
31088,3,1088,[185 176 475 118 161],389,3,4190,3.847566574839302,0.0,0.0
31089,3,1089,[313 546 117 144 195],796,5,4195,3.8486238532110093,0.0,0.0
31090,3,1090,[  4 268 182  12  50],629,4,4199,3.848762603116407,0.0,20.0
31091,3,1091,[427 318  98 182 191],450,5,4204,3.84981684981685,40.0,0.0
31092,3,1092,[191  69 176 423 183],655,2,4206,3.848124428179323,0.0,0.0
31093,3,1093,[427 318  98 182 191],18,5,4211,3.8491773308957953,40.0,0.0
31094,3,1094,[427 318  98 182 191],796,5,4216,3.850228310502283,40.0,0.0
31095,3,1095,[588 168  56 597 234],796,4,4220,3.8503649635036497,0.0,0.0
31096,3,1096,[237  12 235  11 603],450,4,4224,3.8505013673655424,20.0,0.0
31097,3,1097,[483  64  82   4  97],457,5,4229,3.8515482695810563,20.0,0.0
31098,3,1098,[265 423 288  79 748],450,4,4233,3.8516833484986353,0.0,0.0
31099,3,1099,[  7 195 385  56 151],457,5,4238,3.8527272727272726,0.0,0.0
31100,3,1100,[427 318  98 182 191],18,5,4243,3.853769300635786,40.0,0.0
31101,3,1101,[427 318  98 182 191],269,5,4248,3.85480943738657,40.0,0.0
31102,3,1102,[302 204 174 742 268],344,3,4251,3.85403445149592,0.0,0.0
31103,3,1103,[427 318  98 182 191],18,5,4256,3.8550724637681157,40.0,0.0
31104,3,1104,[ 28 275 204 515 286],18,3,4259,3.8542986425339367,0.0,40.0
31105,3,1105,[238 603 186 125  50],450,4,4263,3.8544303797468356,20.0,20.0
31106,3,1106,[427 318  98 182 191],269,5,4268,3.85546522131888,40.0,0.0
31107,3,1107,[427 318  98 182 191],796,5,4273,3.8564981949458486,40.0,0.0
31108,3,1108,[211 204 179 180 238],18,4,4277,3.8566275924256086,0.0,0.0
31109,3,1109,[427 318  98 182 191],18,5,4282,3.857657657657658,40.0,0.0
31110,3,1110,[496   8  70 179 204],593,4,4286,3.857785778577858,20.0,0.0
31111,3,1111,[423 132  15 427 313],236,5,4291,3.8588129496402876,20.0,0.0
31112,3,1112,[427 318  98 182 191],18,5,4296,3.8598382749326148,40.0,0.0
31113,3,1113,[427 318  98 182 191],450,5,4301,3.860861759425494,40.0,0.0
31114,3,1114,[121 173 191  22  11],269,1,4302,3.8582959641255608,0.0,0.0
31115,3,1115,[173 655 385 597  69],796,4,4306,3.8584229390681,0.0,0.0
31116,3,1116,[  9  12  28 125 269],655,0,4306,3.85496866606983,0.0,0.0
31117,3,1117,[181 288 294  15 180],450,3,4309,3.8542039355992843,0.0,0.0
31118,3,1118,[427 318  98 182 191],450,5,4314,3.8552278820375334,40.0,0.0
31119,3,1119,[427 318  98 182 191],269,5,4319,3.85625,40.0,0.0
31120,3,1120,[471  88 182 588  82],450,4,4323,3.856378233719893,0.0,0.0
31121,3,1121,[ 70 294  69 185 125],401,2,4325,3.854723707664884,0.0,0.0
31122,3,1122,[195 323 187  79 597],256,4,4329,3.854853072128228,0.0,0.0
31123,3,1123,[180  98  25 265 144],535,2,4331,3.8532028469750887,0.0,0.0
31124,3,1124,[176 302 127 125  88],344,3,4334,3.8524444444444446,0.0,20.0
31125,3,1125,[313 216   4  71 172],450,3,4337,3.8516873889875667,0.0,0.0
31126,3,1126,[427 318 182  98 191],72,5,4342,3.8527062999112687,40.0,0.0
31127,3,1127,[427 318 182  98 191],655,5,4347,3.853723404255319,40.0,0.0
31128,3,1128,[427 318 182  98 191],18,5,4352,3.854738706820195,40.0,0.0
31129,3,1129,[ 22 200 172  56 588],450,4,4356,3.854867256637168,0.0,0.0
31130,3,1130,[427 318 182  98 191],655,5,4361,3.8558797524314765,40.0,0.0
31131,3,1131,[187 210 161 197 174],796,3,4364,3.8551236749116606,0.0,0.0
31132,3,1132,[427 318 182  98 191],655,5,4369,3.8561341571050307,40.0,0.0
31133,3,1133,[427 318 182  98 191],269,5,4374,3.857142857142857,40.0,0.0
31134,3,1134,[427 318 182  98 191],450,5,4379,3.8581497797356827,40.0,0.0
31135,3,1135,[300  64 197 183 161],655,2,4381,3.8565140845070425,20.0,0.0
31136,3,1136,[427 318 182  98 191],655,5,4386,3.857519788918206,40.0,0.0
31137,3,1137,[427 318 182  98 191],796,5,4391,3.858523725834798,40.0,0.0
31138,3,1138,[168 125 215 588 234],450,4,4395,3.858647936786655,0.0,0.0
31139,3,1139,[427 318 182  98 191],18,5,4400,3.8596491228070176,40.0,0.0
31140,3,1140,[204 194 423 228 483],151,5,4405,3.8606485539000874,0.0,0.0
31141,3,1141,[ 89 222 228  64 235],344,4,4409,3.86077057793345,20.0,0.0
31142,3,1142,[194 153 427 302  70],535,4,4413,3.8608923884514437,20.0,0.0
31143,3,1143,[427 318 182  98 191],655,5,4418,3.861888111888112,40.0,0.0
31144,3,1144,[ 69  98 568 111 471],655,1,4419,3.8593886462882097,0.0,0.0
31145,3,1145,[427 318 182  98 191],450,5,4424,3.8603839441535777,40.0,0.0
31146,3,1146,[427 318 182  98 191],72,5,4429,3.8613775065387967,40.0,0.0
31147,3,1147,[427 318 182  98 191],269,5,4434,3.862369337979094,40.0,0.0
31148,3,1148,[427 318 182  98 191],72,5,4439,3.8633594429939078,40.0,0.0
31149,3,1149,[427 318 182  98 191],72,5,4444,3.8643478260869566,40.0,0.0
31150,3,1150,[191 427 195 132 423],655,2,4446,3.8627280625543006,20.0,0.0
31151,3,1151,[237 111 228  69  11],450,5,4451,3.8637152777777777,0.0,0.0
31152,3,1152,[427 318 182  98 191],655,5,4456,3.8647007805724196,40.0,0.0
31153,3,1153,[483 210 118  79 132],716,4,4460,3.8648180242634314,0.0,0.0
31154,3,1154,[427 318 182  98 191],18,5,4465,3.865800865800866,40.0,0.0
31155,3,1155,[181 194  79 427  56],23,5,4470,3.866782006920415,20.0,0.0
31156,3,1156,[ 50  79 144 423   7],535,3,4473,3.8660328435609332,0.0,20.0
31157,3,1157,[427 318 182  98 191],72,5,4478,3.867012089810017,40.0,0.0
31158,3,1158,[127 215  95  12 423],796,5,4483,3.8679896462467647,0.0,20.0
31159,3,1159,[427  89 200 215 748],151,2,4485,3.8663793103448274,20.0,0.0
31160,3,1160,[427 318 182  98 191],72,5,4490,3.867355727820844,40.0,0.0
31161,3,1161,[427 318 182  98 191],269,5,4495,3.868330464716007,40.0,0.0
31162,3,1162,[427 318 182  98 191],18,5,4500,3.869303525365434,40.0,0.0
31163,3,1163,[ 56 228 118 117 515],292,4,4504,3.8694158075601375,0.0,0.0
31164,3,1164,[168 186 182 144  97],535,3,4507,3.8686695278969956,0.0,0.0
31165,3,1165,[427 318  98 191 182],796,5,4512,3.869639794168096,40.0,0.0
31166,3,1166,[568 294 234 174 357],796,3,4515,3.8688946015424164,0.0,0.0
31167,3,1167,[143 265 174 216 183],577,4,4519,3.8690068493150687,0.0,0.0
31168,3,1168,[ 89 265 405  25 153],151,3,4522,3.8682634730538923,0.0,0.0
31169,3,1169,[  8 127  79 176  22],457,5,4527,3.8692307692307693,0.0,20.0
31170,3,1170,[195 483 111   8  70],18,3,4530,3.8684884713919727,0.0,0.0
31171,3,1171,[427 318  98 191 182],655,5,4535,3.8694539249146755,40.0,0.0
31172,3,1172,[427 318  98 191 182],72,5,4540,3.8704177323103153,40.0,0.0
31173,3,1173,[427 318  98 191 182],655,5,4545,3.8713798977853493,40.0,0.0
31174,3,1174,[427 318  98 191 182],18,5,4550,3.872340425531915,40.0,0.0
31175,3,1175,[ 98 196  70 200  69],655,2,4552,3.870748299319728,0.0,0.0
31176,3,1176,[427 318  98 191 182],72,5,4557,3.8717077315208157,40.0,0.0
31177,3,1177,[183 597 153 302 603],450,5,4562,3.872665534804754,20.0,0.0
31178,3,1178,[427 318  98 191 182],72,5,4567,3.87362171331637,40.0,0.0
31179,3,1179,[ 82 143 603 151  98],716,5,4572,3.8745762711864407,20.0,0.0
31180,3,1180,[143 216 228 328  82],796,4,4576,3.8746824724809485,0.0,0.0
31181,3,1181,[427 318  98 191 182],655,5,4581,3.8756345177664975,40.0,0.0
31182,3,1182,[435 405 235 318 174],716,4,4585,3.8757396449704142,20.0,0.0
31183,3,1183,[427 318  98 191 182],72,5,4590,3.876689189189189,40.0,0.0
31184,3,1184,[ 82 135 603 496 238],151,4,4594,3.8767932489451478,40.0,0.0
31185,3,1185,[427 318  98 191 182],796,5,4599,3.8777403035413154,40.0,0.0
31186,3,1186,[427 318  98 191 182],269,5,4604,3.8786857624262847,40.0,0.0
31187,3,1187,[ 71  12  96 191 173],344,4,4608,3.878787878787879,0.0,0.0
31188,3,1188,[427 318  98 191 182],18,5,4613,3.87973086627418,40.0,0.0
31189,3,1189,[151 403 235 132 100],269,3,4616,3.8789915966386554,0.0,20.0
31190,3,1190,[427 318  98 191 182],269,5,4621,3.879932829554996,40.0,0.0
31191,3,1191,[173 427 121 313 245],450,4,4625,3.8800335570469797,20.0,0.0
31192,3,1192,[427 318  98 191 182],18,5,4630,3.8809723386420787,40.0,0.0
31193,3,1193,[173 546  22 210 568],577,2,4632,3.879396984924623,0.0,0.0
31194,3,1194,[385 234 180 423 197],457,5,4637,3.880334728033473,0.0,0.0
31195,3,1195,[302  88 175  50 172],344,4,4641,3.880434782608696,0.0,20.0
31196,3,1196,[161 423 288 282   8],280,4,4645,3.880534670008354,0.0,0.0
31197,3,1197,[191 234 202 117 194],577,4,4649,3.880634390651085,0.0,0.0
31198,3,1198,[427 318  98 191 182],269,5,4654,3.8815679733110926,40.0,0.0
31199,3,1199,[427 318  98 191 182],18,5,4659,3.8825,40.0,0.0
31200,3,1200,[302 427 161  88 286],450,5,4664,3.8834304746044963,20.0,20.0
31201,3,1201,[427 318  98 191 182],269,5,4669,3.884359400998336,40.0,0.0
31202,3,1202,[427 318  98 191 182],655,5,4674,3.885286783042394,40.0,0.0
31203,3,1203,[483 180 300 144 215],796,4,4678,3.8853820598006643,0.0,0.0
31204,3,1204,[427 318  98 191 182],269,5,4683,3.8863070539419087,40.0,0.0
31205,3,1205,[ 97 322 245 405  88],796,2,4685,3.884742951907131,0.0,0.0
31206,3,1206,[427 318  98 191 182],796,5,4690,3.8856669428334714,40.0,0.0
31207,3,1207,[121 427  89 183 118],151,3,4693,3.8849337748344372,20.0,0.0
31208,3,1208,[357 132 195 245 181],796,4,4697,3.8850289495450787,0.0,0.0
31209,3,1209,[ 98 257  56 597 144],796,5,4702,3.8859504132231404,0.0,0.0
31210,3,1210,[ 96 186 313 117 318],796,4,4706,3.8860445912469035,20.0,0.0
31211,3,1211,[197 185 186 168 118],450,3,4709,3.8853135313531353,0.0,0.0
31212,3,1212,[427 318  98 191 182],450,5,4714,3.886232481450948,40.0,0.0
31213,3,1213,[427 318  98 191 182],18,5,4719,3.887149917627677,40.0,0.0
31214,3,1214,[276  69 475 111 515],269,3,4722,3.88641975308642,0.0,0.0
31215,3,1215,[427 318  98 191 182],18,5,4727,3.8873355263157894,40.0,0.0
31216,3,1216,[742 265 222 144 286],655,0,4727,3.884141331142153,0.0,20.0
31217,3,1217,[427 318  98 191 182],796,5,4732,3.8850574712643677,40.0,0.0
31218,3,1218,[427 318  98 191 182],18,5,4737,3.88597210828548,40.0,0.0
31219,3,1219,[182  50 748 313 100],450,5,4742,3.8868852459016394,0.0,40.0
31220,3,1220,[427 318  98 191 182],72,5,4747,3.887796887796888,40.0,0.0
31221,3,1221,[427 202 215 323 181],23,2,4749,3.886252045826514,20.0,0.0
31222,3,1222,[186  82 191 288 182],450,2,4751,3.884709730171709,0.0,0.0
31223,3,1223,[245 318 143 427  95],450,4,4755,3.8848039215686274,40.0,0.0
31224,3,1224,[427 318  98 191 182],796,5,4760,3.8857142857142857,40.0,0.0
31225,3,1225,[ 95 483 301 742 185],796,3,4763,3.8849918433931485,0.0,0.0
31226,3,1226,[427 318  98 191 182],450,5,4768,3.8859005704971477,40.0,0.0
31227,3,1227,[427 318  98 191 182],655,5,4773,3.8868078175895766,40.0,0.0
31228,3,1228,[ 97 269 144  15 173],796,3,4776,3.886086248982913,0.0,0.0
31229,3,1229,[179 655 172 202  96],457,5,4781,3.8869918699186994,0.0,0.0
31230,3,1230,[181 357 195  89  71],23,3,4784,3.886271324126726,0.0,0.0
31231,3,1231,[195 127  96 357  69],72,5,4789,3.887175324675325,0.0,20.0
31232,3,1232,[427 318  98 191 182],655,5,4794,3.8880778588807785,40.0,0.0
31233,3,1233,[  9 196  69 127 333],655,1,4795,3.885737439222042,0.0,20.0
31234,3,1234,[427 318  98 191 182],796,5,4800,3.88663967611336,40.0,0.0
31235,3,1235,[100  96 357 173 275],796,4,4804,3.8867313915857604,0.0,40.0
31236,3,1236,[313 282 273 568  12],655,2,4806,3.8852061438965237,0.0,0.0
31237,3,1237,[588 405 187  82 118],796,4,4810,3.88529886914378,0.0,0.0
31238,3,1238,[427 318  98 191 182],450,5,4815,3.8861985472154963,40.0,0.0
31239,3,1239,[216 282   9  12 181],693,3,4818,3.8854838709677417,0.0,0.0
31240,3,1240,[ 89 318 176 271 186],655,2,4820,3.8839645447219984,20.0,0.0
31241,3,1241,[271 125 195 655  82],796,3,4823,3.8832528180354267,0.0,0.0
31242,3,1242,[ 50 172 117 204  97],655,2,4825,3.8817377312952535,0.0,20.0
31243,3,1243,[427 318  98 191 182],18,5,4830,3.882636655948553,40.0,0.0
31244,3,1244,[ 71 655 168  97  50],878,3,4833,3.8819277108433736,0.0,20.0
31245,3,1245,[288 258 269 294 276],655,1,4834,3.879614767255217,0.0,0.0
31246,3,1246,[ 89 215  50  15 265],655,2,4836,3.8781074578989574,0.0,20.0
31247,3,1247,[191 655 742 215  64],655,2,4838,3.8766025641025643,20.0,0.0
31248,3,1248,[405  70 132  11 257],457,4,4842,3.876701361088871,0.0,0.0
31249,3,1249,[655 357  50 385 197],504,4,4846,3.8768,0.0,20.0
31250,3,1250,[423 496 238 185 357],330,5,4851,3.8776978417266186,20.0,0.0
31251,3,1251,[546 496  64 197 161],716,3,4854,3.876996805111821,40.0,0.0
31252,3,1252,[427 318  98 191 182],18,5,4859,3.877893056664006,40.0,0.0
31253,3,1253,[427 318  98 191 182],18,5,4864,3.878787878787879,40.0,0.0
31254,3,1254,[427 318  98 191 182],450,5,4869,3.8796812749003986,40.0,0.0
31255,3,1255,[427 318  98 191 182],269,5,4874,3.8805732484076434,40.0,0.0
31256,3,1256,[176 286 183 508 678],344,3,4877,3.8798727128082735,0.0,20.0
31257,3,1257,[151  25 403 174 185],457,5,4882,3.8807631160572336,0.0,0.0
31258,3,1258,[427 318  98 191 182],269,5,4887,3.881652104845115,40.0,0.0
31259,3,1259,[427 318  98 191 182],796,5,4892,3.8825396825396825,40.0,0.0
31260,3,1260,[322 196   4 546 176],344,3,4895,3.881839809674861,0.0,0.0
31261,3,1261,[185 385 174 245 117],450,5,4900,3.882725832012678,0.0,0.0
31262,3,1262,[313 196 300 222 268],655,1,4901,3.880443388756928,0.0,0.0
31263,3,1263,[427 318  98 191 182],655,5,4906,3.8813291139240507,40.0,0.0
31264,3,1264,[216 185 405 197 423],796,4,4910,3.8814229249011856,0.0,0.0
31265,3,1265,[427 318  98 191 182],72,5,4915,3.882306477093207,40.0,0.0
31266,3,1266,[173 258  98 118  12],450,4,4919,3.882399368587214,0.0,0.0
31267,3,1267,[427 318  98 191 182],72,5,4924,3.8832807570977916,40.0,0.0
31268,3,1268,[ 88 175 172 161  11],716,3,4927,3.8825847123719464,0.0,0.0
31269,3,1269,[288  70 132 258 196],457,5,4932,3.883464566929134,0.0,0.0
31270,3,1270,[427 318  98 191 182],18,5,4937,3.884343036978757,40.0,0.0
31271,3,1271,[427 318  98 191 182],72,5,4942,3.8852201257861636,40.0,0.0
31272,3,1272,[  8  28 483 153 175],18,4,4946,3.885310290652003,0.0,0.0
31273,3,1273,[427 318  98 191 182],269,5,4951,3.8861852433281006,40.0,0.0
31274,3,1274,[427 318  98 191 182],18,5,4956,3.887058823529412,40.0,0.0
31275,3,1275,[127 172 191 301 286],450,5,4961,3.8879310344827585,0.0,40.0
31276,3,1276,[427 318  98 191 182],72,5,4966,3.888801879404855,40.0,0.0
31277,3,1277,[427 318  98 191 182],655,5,4971,3.8896713615023475,40.0,0.0
31278,3,1278,[427 318  98 191 182],72,5,4976,3.8905394839718532,40.0,0.0
31279,3,1279,[427 318  98 191 182],18,5,4981,3.89140625,40.0,0.0
31280,3,1280,[ 25 238 181 179   4],450,3,4984,3.890710382513661,0.0,0.0
31281,3,1281,[427 318  98 191 182],796,5,4989,3.8915756630265212,40.0,0.0
31282,3,1282,[185 181 168 742 288],450,4,4993,3.89166017147311,0.0,0.0
31283,3,1283,[228 173 211 234 265],807,3,4996,3.8909657320872273,0.0,0.0
31284,3,1284,[118 265  96 546 245],796,4,5000,3.8910505836575875,0.0,0.0
31285,3,1285,[597 301  96 191  56],450,5,5005,3.8919129082426127,0.0,0.0
31286,3,1286,[427 318  98 191 182],72,5,5010,3.8927738927738926,40.0,0.0
31287,3,1287,[427 318  98 191 182],450,5,5015,3.893633540372671,40.0,0.0
31288,3,1288,[427 318  98 191 182],796,5,5020,3.8944918541505045,40.0,0.0
31289,3,1289,[125  98 197 132 121],655,1,5021,3.8922480620155038,0.0,0.0
31290,3,1290,[427 318  98 191 182],450,5,5026,3.893106119287374,40.0,0.0
31291,3,1291,[427 318  98 191 182],655,5,5031,3.8939628482972135,40.0,0.0
31292,3,1292,[191 174 180 568 222],693,2,5033,3.8924980665119877,0.0,0.0
31293,3,1293,[427 318  98 182 191],655,5,5038,3.893353941267388,40.0,0.0
31294,3,1294,[427 318  98 182 191],655,5,5043,3.894208494208494,40.0,0.0
31295,3,1295,[427 318  98 182 191],269,5,5048,3.8950617283950617,40.0,0.0
31296,3,1296,[427 318  98 182 191],655,5,5053,3.8959136468774096,40.0,0.0
31297,3,1297,[427 318  98 182 191],450,5,5058,3.896764252696456,40.0,0.0
31298,3,1298,[427 318  98 182 191],655,5,5063,3.897613548883757,40.0,0.0
31299,3,1299,[427 318  98 182 191],269,5,5068,3.8984615384615386,40.0,0.0
31300,3,1300,[181 161 176 228 132],796,5,5073,3.8993082244427364,0.0,0.0
31301,3,1301,[ 12 588 269 183 357],450,5,5078,3.900153609831029,0.0,0.0
31302,3,1302,[202 100 182  88 328],655,1,5079,3.8979278587874138,0.0,20.0
31303,3,1303,[173 151 294 172 174],450,5,5084,3.8987730061349692,0.0,0.0
31304,3,1304,[427 318  98 182 191],450,5,5089,3.899616858237548,40.0,0.0
31305,3,1305,[125 483 211 435 202],655,1,5090,3.89739663093415,0.0,0.0
31306,3,1306,[ 64 286 322 210  79],796,2,5092,3.895944912012242,20.0,20.0
31307,3,1307,[228 186 328 385 471],450,4,5096,3.8960244648318043,0.0,0.0
31308,3,1308,[168 423 191  88 143],18,3,5099,3.8953399541634837,0.0,0.0
31309,3,1309,[427 318  98 182 191],18,5,5104,3.8961832061068704,40.0,0.0
31310,3,1310,[427 318  98 182 191],18,5,5109,3.897025171624714,40.0,0.0
31311,3,1311,[427 318  98 182 191],796,5,5114,3.8978658536585367,40.0,0.0
31312,3,1312,[597 435  25  95 228],450,3,5117,3.8971820258948973,0.0,0.0
31313,3,1313,[427 191  64  69 483],18,4,5121,3.8972602739726026,40.0,0.0
31314,3,1314,[427 318  98 182 191],450,5,5126,3.8980988593155894,40.0,0.0
31315,3,1315,[ 82 496 216 135 357],18,3,5129,3.8974164133738602,20.0,0.0
31316,3,1316,[204  82 228 144 403],457,5,5134,3.8982536066818527,0.0,0.0
31317,3,1317,[385 257 204 258 403],796,5,5139,3.899089529590288,0.0,0.0
31318,3,1318,[172 186 257 179 301],389,3,5142,3.8984078847611827,0.0,0.0
31319,3,1319,[265  50 194 435 185],535,4,5146,3.8984848484848484,0.0,20.0
31320,3,1320,[176  64 100 216 300],655,2,5148,3.8970476911430736,20.0,20.0
31321,3,1321,[427 318  98 182 191],655,5,5153,3.8978819969742813,40.0,0.0
31322,3,1322,[427 318  98 182 191],450,5,5158,3.8987150415721845,40.0,0.0
31323,3,1323,[427 318  98 182 191],450,5,5163,3.8995468277945617,40.0,0.0
31324,3,1324,[427 318  98 182 191],655,5,5168,3.900377358490566,40.0,0.0
31325,3,1325,[427 318  98 182 191],72,5,5173,3.901206636500754,40.0,0.0
31326,3,1326,[ 56 269 427 172 111],450,5,5178,3.9020346646571213,20.0,0.0
31327,3,1327,[427 318  98 182 191],450,5,5183,3.9028614457831323,40.0,0.0
31328,3,1328,[427 318  98 182 191],72,5,5188,3.903686982693755,40.0,0.0
31329,3,1329,[427 318  98 182 191],269,5,5193,3.9045112781954887,40.0,0.0
31330,3,1330,[427 318  98 182 191],655,5,5198,3.905334335086401,40.0,0.0
31331,3,1331,[427 318  98 182 191],269,5,5203,3.906156156156156,40.0,0.0
31332,3,1332,[427 318  98 182 191],72,5,5208,3.9069767441860463,40.0,0.0
31333,3,1333,[427 318  98 182 191],450,5,5213,3.9077961019490255,40.0,0.0
31334,3,1334,[427 318  98 182 191],269,5,5218,3.9086142322097377,40.0,0.0
31335,3,1335,[427 318  98 182 191],18,5,5223,3.909431137724551,40.0,0.0
31336,3,1336,[427 318  98 182 191],450,5,5228,3.9102468212415857,40.0,0.0
31337,3,1337,[195 172 174 286 742],280,2,5230,3.90881913303438,0.0,20.0
31338,3,1338,[427 318  98 182 191],18,5,5235,3.909634055265123,40.0,0.0
31339,3,1339,[742 168 183 322 427],450,5,5240,3.91044776119403,20.0,0.0
31340,3,1340,[269 127  12 215 121],796,4,5244,3.9105145413870246,0.0,20.0
31341,3,1341,[427 318  98 182 191],450,5,5249,3.9113263785394934,40.0,0.0
31342,3,1342,[427 318  98 182 191],269,5,5254,3.912137006701415,40.0,0.0
31343,3,1343,[ 98 180  82 257  79],796,3,5257,3.9114583333333335,0.0,0.0
31344,3,1344,[427 318  98 182 191],269,5,5262,3.9122676579925653,40.0,0.0
31345,3,1345,[302 118 301 289  25],15,2,5264,3.9108469539375927,0.0,0.0
31346,3,1346,[748 180 597 216 127],450,5,5269,3.9116555308092056,0.0,20.0
31347,3,1347,[118   1 313 238 127],450,4,5273,3.9117210682492582,0.0,20.0
31348,3,1348,[427 318  98 182 191],269,5,5278,3.912527798369162,40.0,0.0
31349,3,1349,[427 318  98 182 191],655,5,5283,3.9133333333333336,40.0,0.0
31350,3,1350,[ 11 483 318  79 597],450,4,5287,3.91339748334567,20.0,0.0
31351,3,1351,[161 258 294   7 181],655,0,5287,3.910502958579882,0.0,0.0
31352,3,1352,[427 318  98 182 191],450,5,5292,3.9113082039911307,40.0,0.0
31353,3,1353,[176 196 427 238 181],23,3,5295,3.9106351550960117,20.0,0.0
31354,3,1354,[161 117 678 427 318],807,4,5299,3.91070110701107,40.0,0.0
31355,3,1355,[427 318  98 182 191],269,5,5304,3.911504424778761,40.0,0.0
31356,3,1356,[496  11  98 216 176],280,4,5308,3.911569638909359,20.0,0.0
31357,3,1357,[234 265 742 258 172],796,3,5311,3.910898379970545,0.0,0.0
31358,3,1358,[322 211 144 182  97],796,2,5313,3.9094922737306845,0.0,0.0
31359,3,1359,[427 318  98 182 191],18,5,5318,3.9102941176470587,40.0,0.0
31360,3,1360,[427 318  98 182 191],796,5,5323,3.911094783247612,40.0,0.0
31361,3,1361,[588 403 204 313 603],796,5,5328,3.9118942731277535,20.0,0.0
31362,3,1362,[237 100  56 168 194],450,5,5333,3.912692589875275,0.0,20.0
31363,3,1363,[427 318  98 182 191],18,5,5338,3.9134897360703813,40.0,0.0
31364,3,1364,[ 56 269 427  79 597],23,4,5342,3.9135531135531134,20.0,0.0
31365,3,1365,[197  70 151 276 318],878,2,5344,3.9121522693997073,20.0,0.0
31366,3,1366,[427 318  98 182 191],796,5,5349,3.9129480614484273,40.0,0.0
31367,3,1367,[333 258  15 186 742],655,0,5349,3.9100877192982457,0.0,0.0
31368,3,1368,[427 318  98 182 191],450,5,5354,3.9108838568298028,40.0,0.0
31369,3,1369,[238 175 172 135 180],716,2,5356,3.9094890510948903,0.0,0.0
31370,3,1370,[ 97 121  50 286   8],535,4,5360,3.9095550692924874,0.0,40.0
31371,3,1371,[427 318  98 182 191],72,5,5365,3.9103498542274053,40.0,0.0
31372,3,1372,[427 318  98 182 191],655,5,5370,3.9111434814275308,40.0,0.0
31373,3,1373,[427 318  98 182 191],450,5,5375,3.9119359534206697,40.0,0.0
31374,3,1374,[427 318  98 182 191],450,5,5380,3.9127272727272726,40.0,0.0
31375,3,1375,[427 318  98 182 191],450,5,5385,3.9135174418604652,40.0,0.0
31376,3,1376,[423 323 118   8  97],756,1,5386,3.9114015976761074,0.0,0.0
31377,3,1377,[427 318  98 182 191],72,5,5391,3.9121915820029027,40.0,0.0
31378,3,1378,[427 318  98 182 191],72,5,5396,3.912980420594634,40.0,0.0
31379,3,1379,[151  70  97 175   4],457,5,5401,3.913768115942029,0.0,0.0
31380,3,1380,[276   7 182 222  11],655,2,5403,3.9123823316437365,0.0,0.0
31381,3,1381,[318 427  98 182 191],18,5,5408,3.9131693198263386,40.0,0.0
31382,3,1382,[275 423 294 200  97],716,5,5413,3.9139551699204627,0.0,20.0
31383,3,1383,[ 22  95 385 127 748],807,4,5417,3.9140173410404624,0.0,20.0
31384,3,1384,[ 88 181  70 127 151],450,5,5422,3.9148014440433214,0.0,20.0
31385,3,1385,[210 588  25 403 202],577,4,5426,3.914862914862915,0.0,0.0
31386,3,1386,[427 318  98 182 191],18,5,5431,3.9156452775775055,40.0,0.0
31387,3,1387,[427 318  98 182 191],269,5,5436,3.9164265129683,40.0,0.0
31388,3,1388,[427 318  98 182 191],655,5,5441,3.9172066234701224,40.0,0.0
31389,3,1389,[427 318  98 182 191],655,5,5446,3.917985611510791,40.0,0.0
31390,3,1390,[427 318  98 182 191],18,5,5451,3.918763479511143,40.0,0.0
31391,3,1391,[ 82 245  28 496 265],450,4,5455,3.9188218390804597,20.0,0.0
31392,3,1392,[ 95 235 603 357  88],330,5,5460,3.919597989949749,20.0,0.0
31393,3,1393,[405 125 161 200 121],450,3,5463,3.918938307030129,0.0,0.0
31394,3,1394,[427 318  98 182 191],72,5,5468,3.9197132616487456,40.0,0.0
31395,3,1395,[427 318  98 182 191],72,5,5473,3.920487106017192,40.0,0.0
31396,3,1396,[427 318  98 182 191],796,5,5478,3.921259842519685,40.0,0.0
31397,3,1397,[234 176 238   7 197],269,2,5480,3.919885550786838,0.0,0.0
31398,3,1398,[742 288 135  69  95],280,5,5485,3.9206576125804147,0.0,0.0
31399,3,1399,[ 98 496 318 222 127],796,5,5490,3.9214285714285713,40.0,20.0
31400,3,1400,[427 318  98 182 191],269,5,5495,3.9221984296930765,40.0,0.0
31401,3,1401,[427 318  98 182 191],450,5,5500,3.9229671897289586,40.0,0.0
31402,3,1402,[100 204 216 427 174],269,2,5502,3.9215965787598006,20.0,20.0
31403,3,1403,[427 318  98 182 191],796,5,5507,3.9223646723646723,40.0,0.0
31404,3,1404,[427 318  98 182 191],72,5,5512,3.9231316725978647,40.0,0.0
31405,3,1405,[427 318  98 182 191],796,5,5517,3.9238975817923185,40.0,0.0
31406,3,1406,[172 222 546 191 182],796,5,5522,3.9246624022743424,0.0,0.0
31407,3,1407,[742  96 176   7 125],457,5,5527,3.9254261363636362,0.0,0.0
31408,3,1408,[118 204 176 117 302],344,3,5530,3.9247693399574164,0.0,0.0
31409,3,1409,[427 318  98 182 191],450,5,5535,3.925531914893617,40.0,0.0
31410,3,1410,[427 318  98 182 191],72,5,5540,3.926293408929837,40.0,0.0
31411,3,1411,[151 275 234 191  69],796,4,5544,3.9263456090651556,0.0,20.0
31412,3,1412,[269 196 117 301 403],796,3,5547,3.9256900212314223,0.0,0.0
31413,3,1413,[172  70  28 294 222],23,2,5549,3.9243281471004243,0.0,0.0
31414,3,1414,[588 186 135  70 117],885,4,5553,3.924381625441696,0.0,0.0
31415,3,1415,[427 318  98 182 191],655,5,5558,3.925141242937853,40.0,0.0
31416,3,1416,[427 318  98 182 191],18,5,5563,3.9258997882851094,40.0,0.0
31417,3,1417,[427 318  98 182 191],18,5,5568,3.926657263751763,40.0,0.0
31418,3,1418,[269 423 286 318 597],796,3,5571,3.9260042283298096,20.0,20.0
31419,3,1419,[427 318  98 182 191],18,5,5576,3.926760563380282,40.0,0.0
31420,3,1420,[427 318  98 182 191],450,5,5581,3.9275158339197747,40.0,0.0
31421,3,1421,[427 318  98 182 191],796,5,5586,3.928270042194093,40.0,0.0
31422,3,1422,[202  82 357 216 196],655,2,5588,3.926914968376669,0.0,0.0
31423,3,1423,[258 423 111 742 301],655,0,5588,3.9241573033707864,0.0,0.0
31424,3,1424,[427 318  98 182 191],450,5,5593,3.9249122807017542,40.0,0.0
31425,3,1425,[200 405 174 197 357],835,4,5597,3.9249649368863957,0.0,0.0
31426,3,1426,[318 300 286 269  96],450,5,5602,3.925718290119131,20.0,20.0
31427,3,1427,[318 427  98 182 191],269,5,5607,3.926470588235294,40.0,0.0
31428,3,1428,[427 153 179  95 187],389,3,5610,3.925822253324003,20.0,0.0
31429,3,1429,[318 427  98 182 191],450,5,5615,3.9265734265734267,40.0,0.0
31430,3,1430,[318 427  98 182 191],18,5,5620,3.9273235499650596,40.0,0.0
31431,3,1431,[655 275 300 328  70],450,5,5625,3.928072625698324,0.0,20.0
31432,3,1432,[185 182 405 475  98],655,3,5628,3.9274249825540823,0.0,0.0
31433,3,1433,[318 427  98 182 191],18,5,5633,3.9281729428172945,40.0,0.0
31434,3,1434,[161 471  89 195 222],655,1,5634,3.9261324041811845,0.0,0.0
31435,3,1435,[322 143 187 118  64],796,4,5638,3.926183844011142,20.0,0.0
31436,3,1436,[423 300 294 228   1],655,0,5638,3.9234516353514266,0.0,0.0
31437,3,1437,[318 427  98 182 191],655,5,5643,3.924200278164117,40.0,0.0
31438,3,1438,[183 302 318 111 258],655,3,5646,3.9235580264072274,20.0,0.0
31439,3,1439,[323 282 191 118   1],796,3,5649,3.9229166666666666,0.0,0.0
31440,3,1440,[603   9 222 427 173],11,4,5653,3.922970159611381,40.0,0.0
31441,3,1441,[  4 228  28 385 597],450,4,5657,3.923023578363384,0.0,0.0
31442,3,1442,[200  88  98 196 483],18,2,5659,3.9216909216909217,0.0,0.0
31443,3,1443,[318 427  98 182 191],18,5,5664,3.9224376731301938,40.0,0.0
31444,3,1444,[742 202 182 121 405],655,1,5665,3.9204152249134947,0.0,0.0
31445,3,1445,[318 427  98 182 191],269,5,5670,3.921161825726141,40.0,0.0
31446,3,1446,[318 427  98 182 191],72,5,5675,3.921907394609537,40.0,0.0
31447,3,1447,[135 288 300 258 191],693,2,5677,3.9205801104972378,0.0,0.0
31448,3,1448,[318 427  98 182 191],269,5,5682,3.9213250517598346,40.0,0.0
31449,3,1449,[318 427  98 182 191],796,5,5687,3.9220689655172416,40.0,0.0
31450,3,1450,[318 427  98 182 191],72,5,5692,3.922811853893866,40.0,0.0
31451,3,1451,[318 427  98 182 191],72,5,5697,3.9235537190082646,40.0,0.0
31452,3,1452,[385  82 423 235  98],450,3,5700,3.9229181004817617,0.0,0.0
31453,3,1453,[ 79 183 483 357  96],693,3,5703,3.922283356258597,0.0,0.0
31454,3,1454,[181 302 204  25 179],655,2,5705,3.9209621993127146,0.0,0.0
31455,3,1455,[125 191  22 245 237],224,2,5707,3.919642857142857,0.0,0.0
31456,3,1456,[427 318  98 182 191],796,5,5712,3.9203843514070007,40.0,0.0
31457,3,1457,[427 318  98 182 191],450,5,5717,3.921124828532236,40.0,0.0
31458,3,1458,[427 318  98 182 191],796,5,5722,3.921864290610007,40.0,0.0
31459,3,1459,[197  98 222 100 144],292,4,5726,3.921917808219178,0.0,20.0
31460,3,1460,[427 318  98 182 191],655,5,5731,3.922655715263518,40.0,0.0
31461,3,1461,[427 318  98 182 191],796,5,5736,3.923392612859097,40.0,0.0
31462,3,1462,[202   4 237 180 143],450,4,5740,3.923444976076555,0.0,0.0
31463,3,1463,[427 318  98 182 191],18,5,5745,3.9241803278688523,40.0,0.0
31464,3,1464,[427 318  98 182 191],655,5,5750,3.9249146757679183,40.0,0.0
31465,3,1465,[168  82 153 173  15],450,3,5753,3.9242837653478855,0.0,0.0
31466,3,1466,[427 318  98 182 191],655,5,5758,3.9250170415814587,40.0,0.0
31467,3,1467,[427 318  98 182 191],269,5,5763,3.92574931880109,40.0,0.0
31468,3,1468,[427 318  98 182 191],269,5,5768,3.926480599046971,40.0,0.0
31469,3,1469,[ 88 276   9 228 258],457,5,5773,3.9272108843537414,0.0,0.0
31470,3,1470,[427 318  98 182 191],655,5,5778,3.9279401767505098,40.0,0.0
31471,3,1471,[135 508 300 211 197],693,1,5779,3.925951086956522,0.0,0.0
31472,3,1472,[427 318  98 182 191],796,5,5784,3.9266802443991855,40.0,0.0
31473,3,1473,[275 216   9  28 427],655,3,5787,3.9260515603799186,20.0,20.0
31474,3,1474,[237 176 210 125 313],655,1,5788,3.9240677966101694,0.0,0.0
31475,3,1475,[276 423 175 427 187],655,3,5791,3.9234417344173442,20.0,0.0
31476,3,1476,[427 318  98 182 191],655,5,5796,3.924170616113744,40.0,0.0
31477,3,1477,[427 318  98 182 191],269,5,5801,3.92489851150203,40.0,0.0
31478,3,1478,[238 111 196   7 234],151,5,5806,3.925625422582826,0.0,0.0
31479,3,1479,[121 508 195  25 289],655,0,5806,3.922972972972973,0.0,0.0
31480,3,1480,[427 318  98 182 191],655,5,5811,3.923700202565834,40.0,0.0
31481,3,1481,[235  79 151 204  96],344,4,5815,3.9237516869095814,0.0,0.0
31482,3,1482,[427 318  98 182 191],72,5,5820,3.9244774106540796,40.0,0.0
31483,3,1483,[118  50  12 143 269],796,4,5824,3.9245283018867925,0.0,20.0
31484,3,1484,[427 318  98 182 191],450,5,5829,3.9252525252525254,40.0,0.0
31485,3,1485,[ 88 245 265  95 181],280,2,5831,3.923956931359354,0.0,0.0
31486,3,1486,[427 318  98 182 191],655,5,5836,3.9246805648957634,40.0,0.0
31487,3,1487,[427 318  98 182 191],450,5,5841,3.9254032258064515,40.0,0.0
31488,3,1488,[191 168 300 186 132],151,4,5845,3.9254533243787777,0.0,0.0
31489,3,1489,[ 70 427 222 357  50],716,5,5850,3.9261744966442955,20.0,20.0
31490,3,1490,[655 182 187 210 286],450,4,5854,3.926224010731053,0.0,20.0
31491,3,1491,[508 313 215  28 187],655,2,5856,3.9249329758713136,0.0,0.0
31492,3,1492,[427 318  98 182 191],269,5,5861,3.925653047555258,40.0,0.0
31493,3,1493,[427 318  98 182 191],269,5,5866,3.926372155287818,40.0,0.0
31494,3,1494,[427 318  98 182 191],269,5,5871,3.9270903010033447,40.0,0.0
31495,3,1495,[143 117  28 282  70],457,5,5876,3.927807486631016,0.0,0.0
31496,3,1496,[182 237 180 186  70],450,4,5880,3.9278557114228456,0.0,0.0
31497,3,1497,[318 427  98 182 191],655,5,5885,3.9285714285714284,40.0,0.0
31498,3,1498,[318 427  98 182 191],72,5,5890,3.9292861907938628,40.0,0.0
31499,3,1499,[318 427  98 182 191],269,5,5895,3.93,40.0,0.0
31500,3,1500,[318 427  98 182 191],72,5,5900,3.9307128580946036,40.0,0.0
31501,3,1501,[118 234 151 182 276],457,5,5905,3.9314247669773636,0.0,0.0
31502,3,1502,[237 603 174 235  88],401,3,5908,3.9308050565535595,20.0,0.0
31503,3,1503,[546 161  79 483 423],23,2,5910,3.929521276595745,0.0,0.0
31504,3,1504,[176 515 235 191 196],716,3,5913,3.9289036544850497,0.0,0.0
31505,3,1505,[ 70 125 655 174  15],593,4,5917,3.9289508632138115,0.0,0.0
31506,3,1506,[427 318  98 182 191],450,5,5922,3.929661579296616,40.0,0.0
31507,3,1507,[191  96  28  98 132],655,2,5924,3.9283819628647216,0.0,0.0
31508,3,1508,[238 483 153 183  89],796,4,5928,3.9284294234592445,0.0,0.0
31509,3,1509,[ 25 151 282 183 235],457,4,5932,3.928476821192053,0.0,0.0
31510,3,1510,[427 318  98 182 191],269,5,5937,3.929185969556585,40.0,0.0
31511,3,1511,[427 318  98 182 191],655,5,5942,3.92989417989418,40.0,0.0
31512,3,1512,[427 318  98 182 191],655,5,5947,3.930601454064772,40.0,0.0
31513,3,1513,[427 318  98 182 191],796,5,5952,3.9313077939233816,40.0,0.0
31514,3,1514,[328 179 181  71 187],450,4,5956,3.931353135313531,0.0,0.0
31515,3,1515,[183 269 210 195 742],344,4,5960,3.9313984168865437,0.0,0.0
31516,3,1516,[427 318  98 182 191],450,5,5965,3.9321028345418587,40.0,0.0
31517,3,1517,[265 143  96 603 357],450,5,5970,3.932806324110672,20.0,0.0
31518,3,1518,[405 276 302 475   8],269,2,5972,3.931533903884134,0.0,0.0
31519,3,1519,[215 423 508 183  22],280,2,5974,3.930263157894737,0.0,0.0
31520,3,1520,[318 427  98 182 191],655,5,5979,3.9309664694280078,40.0,0.0
31521,3,1521,[318 427  98 182 191],796,5,5984,3.9316688567674114,40.0,0.0
31522,3,1522,[318 427  98 182 191],655,5,5989,3.932370321733421,40.0,0.0
31523,3,1523,[318 427  98 182 191],18,5,5994,3.9330708661417324,40.0,0.0
31524,3,1524,[125 313 181 357 216],344,2,5996,3.9318032786885246,0.0,0.0
31525,3,1525,[318 427  98 182 191],18,5,6001,3.9325032765399737,40.0,0.0
31526,3,1526,[357 294 144 302 151],450,5,6006,3.9332023575638506,0.0,0.0
31527,3,1527,[318 427  98 182 191],18,5,6011,3.9339005235602094,40.0,0.0
31528,3,1528,[ 98 333  28 132  15],655,1,6012,3.931981687377371,0.0,0.0
31529,3,1529,[318 427  98 182 191],796,5,6017,3.9326797385620913,40.0,0.0
31530,3,1530,[318 427  98 182 191],72,5,6022,3.9333768778576093,40.0,0.0
31531,3,1531,[318 427  98 182 191],450,5,6027,3.9340731070496084,40.0,0.0
31532,3,1532,[318 427  98 182 191],18,5,6032,3.9347684279191126,40.0,0.0
31533,3,1533,[265 216 301 144  82],450,4,6036,3.934810951760104,0.0,0.0
31534,3,1534,[174 385 187 196 423],655,1,6037,3.932899022801303,0.0,0.0
31535,3,1535,[318 427  98 182 191],796,5,6042,3.93359375,40.0,0.0
31536,3,1536,[196  96 100 197  12],72,5,6047,3.934287573194535,0.0,20.0
31537,3,1537,[508 204 127 276 235],280,3,6050,3.9336801040312093,0.0,20.0
31538,3,1538,[318 427  98 182 191],450,5,6055,3.934372969460689,40.0,0.0
31539,3,1539,[172 127   9 294  25],424,4,6059,3.9344155844155844,0.0,20.0
31540,3,1540,[318 427  98 182 191],796,5,6064,3.935107073329007,40.0,0.0
31541,3,1541,[216 597 427   4 385],796,5,6069,3.9357976653696496,20.0,0.0
31542,3,1542,[318 427  98 182 191],269,5,6074,3.9364873622812704,40.0,0.0
31543,3,1543,[318 427  98 182 191],72,5,6079,3.937176165803109,40.0,0.0
31544,3,1544,[318 427  98 182 191],18,5,6084,3.9378640776699028,40.0,0.0
31545,3,1545,[318 427  98 182 191],72,5,6089,3.9385510996119018,40.0,0.0
31546,3,1546,[318 427  98 182 191],796,5,6094,3.9392372333548806,40.0,0.0
31547,3,1547,[318 427  98 182 191],269,5,6099,3.939922480620155,40.0,0.0
31548,3,1548,[588 313 237 385 172],450,5,6104,3.9406068431245966,0.0,0.0
31549,3,1549,[318 427  98 182 191],655,5,6109,3.9412903225806453,40.0,0.0
31550,3,1550,[318 427  98 182 191],655,5,6114,3.9419729206963248,40.0,0.0
31551,3,1551,[318 427  98 182 191],18,5,6119,3.9426546391752577,40.0,0.0
31552,3,1552,[176  15 238 475   1],389,4,6123,3.9426915647134577,0.0,0.0
31553,3,1553,[318 427  98 182 191],796,5,6128,3.943371943371943,40.0,0.0
31554,3,1554,[ 64 568 135 234  15],655,2,6130,3.942122186495177,20.0,0.0
31555,3,1555,[318 427  98 182 191],796,5,6135,3.9428020565552697,40.0,0.0
31556,3,1556,[173   1  69  12 385],503,3,6138,3.9421965317919074,0.0,0.0
31557,3,1557,[181 245 100 118 385],450,4,6142,3.9422336328626444,0.0,20.0
31558,3,1558,[318 427  98 182 191],655,5,6147,3.9429121231558693,40.0,0.0
31559,3,1559,[318 427  98 182 191],18,5,6152,3.943589743589744,40.0,0.0
31560,3,1560,[  8   7 301 302 269],655,1,6153,3.9417040358744395,0.0,0.0
31561,3,1561,[427 318  98 182 191],796,5,6158,3.942381562099872,40.0,0.0
31562,3,1562,[144 275 237 257 603],796,5,6163,3.943058221369162,20.0,20.0
31563,3,1563,[427 318  98 182 191],450,5,6168,3.9437340153452687,40.0,0.0
31564,3,1564,[427 318  98 182 191],72,5,6173,3.944408945686901,40.0,0.0
31565,3,1565,[427 318  98 182 191],796,5,6178,3.945083014048531,40.0,0.0
31566,3,1566,[427 318  98 182 191],269,5,6183,3.9457562220804085,40.0,0.0
31567,3,1567,[423   8 176  69 237],503,5,6188,3.9464285714285716,0.0,0.0
31568,3,1568,[111 183   4 258 257],457,3,6191,3.945825366475462,0.0,0.0
31569,3,1569,[153 435 135  70 186],716,3,6194,3.9452229299363055,0.0,0.0
31570,3,1570,[427 318  98 182 191],269,5,6199,3.945894334818587,40.0,0.0
31571,3,1571,[118 100  89 215   7],457,5,6204,3.946564885496183,0.0,20.0
31572,3,1572,[427 318  98 182 191],18,5,6209,3.94723458359822,40.0,0.0
31573,3,1573,[427 318  98 182 191],655,5,6214,3.9479034307496823,40.0,0.0
31574,3,1574,[427 318  98 182 191],655,5,6219,3.9485714285714284,40.0,0.0
31575,3,1575,[211 153 318 168 135],535,4,6223,3.9486040609137056,20.0,0.0
31576,3,1576,[234 403 200  89 111],450,3,6226,3.9480025364616362,0.0,0.0
31577,3,1577,[144 318  98 258 204],655,2,6228,3.946768060836502,20.0,0.0
31578,3,1578,[191 237 427 187 172],655,4,6232,3.946801773274224,20.0,0.0
31579,3,1579,[172 174 204 222 257],716,5,6237,3.94746835443038,0.0,0.0
31580,3,1580,[427 318  98 182 191],269,5,6242,3.948134092346616,40.0,0.0
31581,3,1581,[200 132 275 286  97],786,5,6247,3.9487989886219976,0.0,40.0
31582,3,1582,[427 318  98 182 191],18,5,6252,3.9494630448515475,40.0,0.0
31583,3,1583,[427 318  98 182 191],450,5,6257,3.9501262626262625,40.0,0.0
31584,3,1584,[  7  97 151  88 172],450,5,6262,3.950788643533123,0.0,0.0
31585,3,1585,[211 135 301 100 202],655,1,6263,3.9489281210592684,0.0,20.0
31586,3,1586,[194 496 748 191 300],151,3,6266,3.9483301827347197,20.0,0.0
31587,3,1587,[427 318  98 182 191],269,5,6271,3.948992443324937,40.0,0.0
31588,3,1588,[180 216 508   7 118],280,3,6274,3.948395217117684,0.0,0.0
31589,3,1589,[427 318  98 182 191],72,5,6279,3.949056603773585,40.0,0.0
31590,3,1590,[427 318  98 182 191],269,5,6284,3.9497171590194844,40.0,0.0
31591,3,1591,[655 144  96 508   1],655,0,6284,3.9472361809045227,0.0,0.0
31592,3,1592,[318 427  98 182 191],18,5,6289,3.947897049591965,40.0,0.0
31593,3,1593,[204 301 176 300 195],151,3,6292,3.9473023839397743,0.0,0.0
31594,3,1594,[318 427  98 182 191],796,5,6297,3.947962382445141,40.0,0.0
31595,3,1595,[515 211 568 357  89],269,3,6300,3.9473684210526314,0.0,0.0
31596,3,1596,[ 22  95 265 151  96],807,4,6304,3.947401377582968,0.0,0.0
31597,3,1597,[427 318  98 182 191],72,5,6309,3.9480600750938675,40.0,0.0
31598,3,1598,[427 318  98 182 191],655,5,6314,3.948717948717949,40.0,0.0
31599,3,1599,[568 385  15 597 313],796,5,6319,3.949375,0.0,0.0
31600,3,1600,[427 318  98 182 191],655,5,6324,3.9500312304809495,40.0,0.0
31601,3,1601,[222 173 748 405  28],798,4,6328,3.950062421972534,0.0,0.0
31602,3,1602,[427 318  98 182 191],655,5,6333,3.9507174048658764,40.0,0.0
31603,3,1603,[258 118 403 546   7],457,4,6337,3.9507481296758105,0.0,0.0
31604,3,1604,[405  56 121 185 216],655,2,6339,3.9495327102803737,0.0,0.0
31605,3,1605,[427 318  98 182 191],796,5,6344,3.950186799501868,40.0,0.0
31606,3,1606,[427 318  98 182 191],655,5,6349,3.9508400746733043,40.0,0.0
31607,3,1607,[ 96 748 132 216 173],450,5,6354,3.951492537313433,0.0,0.0
31608,3,1608,[357 288 172  25 182],457,5,6359,3.952144188937228,0.0,0.0
31609,3,1609,[748 228  56 742 508],280,2,6361,3.9509316770186333,0.0,0.0
31610,3,1610,[275 276 435 588 496],18,5,6366,3.9515828677839853,20.0,20.0
31611,3,1611,[318 427  98 182 191],269,5,6371,3.9522332506203472,40.0,0.0
31612,3,1612,[318 427  98 182 191],796,5,6376,3.952882827030378,40.0,0.0
31613,3,1613,[211 111 301 742 186],796,1,6377,3.9510532837670382,0.0,0.0
31614,3,1614,[237  97 181   9 144],457,5,6382,3.9517027863777088,0.0,0.0
31615,3,1615,[318 427  98 182 191],450,5,6387,3.952351485148515,40.0,0.0
31616,3,1616,[318 427  98 182 191],655,5,6392,3.95299938157081,40.0,0.0
31617,3,1617,[318 427  98 182 191],655,5,6397,3.953646477132262,40.0,0.0
31618,3,1618,[294 269 427 187 289],655,2,6399,3.9524397776405187,20.0,0.0
31619,3,1619,[318 427  98 182 191],450,5,6404,3.9530864197530864,40.0,0.0
31620,3,1620,[132  50 483 204 100],18,4,6408,3.9531153608883405,0.0,40.0
31621,3,1621,[318 427  98 182 191],269,5,6413,3.9537607891491984,40.0,0.0
31622,3,1622,[318 427  98 182 191],450,5,6418,3.9544054220579175,40.0,0.0
31623,3,1623,[ 89 182 211 427  88],269,3,6421,3.9538177339901477,20.0,0.0
31624,3,1624,[318 427  98 182 191],269,5,6426,3.9544615384615383,40.0,0.0
31625,3,1625,[318 427  98 182 191],269,5,6431,3.9551045510455105,40.0,0.0
31626,3,1626,[  8 211 475 268  98],655,1,6432,3.9532882606023354,0.0,0.0
31627,3,1627,[289 257  82 403 313],807,5,6437,3.953931203931204,0.0,0.0
31628,3,1628,[318 427  98 182 191],450,5,6442,3.954573357888275,40.0,0.0
31629,3,1629,[318 427  98 182 191],269,5,6447,3.9552147239263804,40.0,0.0
31630,3,1630,[269 323 100 117 288],174,3,6450,3.9546290619251994,0.0,20.0
31631,3,1631,[318 427  98 182 191],796,5,6455,3.955269607843137,40.0,0.0
31632,3,1632,[318 427  98 182 191],18,5,6460,3.9559093692590324,40.0,0.0
31633,3,1633,[318 427  98 182 191],18,5,6465,3.9565483476132193,40.0,0.0
31634,3,1634,[318 427  98 182 191],796,5,6470,3.9571865443425076,40.0,0.0
31635,3,1635,[322 288 276 385 127],344,3,6473,3.956601466992665,0.0,20.0
31636,3,1636,[300 483 210 265 153],450,3,6476,3.956017104459377,0.0,0.0
31637,3,1637,[ 71 172 294 597 405],23,2,6478,3.954822954822955,0.0,0.0
31638,3,1638,[183 257 655 194 200],457,4,6482,3.954850518608908,0.0,0.0
31639,3,1639,[427 318  98 182 191],796,5,6487,3.955487804878049,40.0,0.0
31640,3,1640,[ 79 435 427 258 515],296,5,6492,3.956124314442413,20.0,0.0
31641,3,1641,[427 318  98 182 191],72,5,6497,3.9567600487210717,40.0,0.0
31642,3,1642,[588 568 181 288  25],450,3,6500,3.956177723676202,0.0,0.0
31643,3,1643,[427 318  98 182 191],72,5,6505,3.9568126520681264,40.0,0.0
31644,3,1644,[427 318  98 182 191],72,5,6510,3.9574468085106385,40.0,0.0
31645,3,1645,[427 318  98 182 191],72,5,6515,3.9580801944106927,40.0,0.0
31646,3,1646,[427 318  98 182 191],72,5,6520,3.9587128111718277,40.0,0.0
31647,3,1647,[183 546 197  12 117],280,3,6523,3.958131067961165,0.0,0.0
31648,3,1648,[427 318  98 182 191],450,5,6528,3.9587628865979383,40.0,0.0
31649,3,1649,[427 318  98 182 191],72,5,6533,3.9593939393939395,40.0,0.0
31650,3,1650,[427 318  98 182 191],450,5,6538,3.9600242277407633,40.0,0.0
31651,3,1651,[427 318  98 182 191],655,5,6543,3.9606537530266346,40.0,0.0
31652,3,1652,[197 161 176  15 196],389,2,6545,3.959467634603751,0.0,0.0
31653,3,1653,[161 228 125 200  22],450,4,6549,3.959492140266022,0.0,0.0
31654,3,1654,[427 318  98 182 191],72,5,6554,3.96012084592145,40.0,0.0
31655,3,1655,[427 318  98 182 191],655,5,6559,3.9607487922705316,40.0,0.0
31656,3,1656,[427 318  98 182 191],269,5,6564,3.9613759806879902,40.0,0.0
31657,3,1657,[427 318  98 182 191],450,5,6569,3.9620024125452353,40.0,0.0
31658,3,1658,[427 318  98 182 191],796,5,6574,3.9626280892103676,40.0,0.0
31659,3,1659,[204   7 153 357 265],450,5,6579,3.9632530120481926,0.0,0.0
31660,3,1660,[172 427 496 111  69],450,5,6584,3.963877182420229,40.0,0.0
31661,3,1661,[210  15 196 195 180],796,3,6587,3.963297232250301,0.0,0.0
31662,3,1662,[313 275 286 100 435],655,2,6589,3.962116656644618,0.0,60.0
31663,3,1663,[ 12 181  89  50 172],655,3,6592,3.9615384615384617,0.0,20.0
31664,3,1664,[427 318  98 182 191],18,5,6597,3.962162162162162,40.0,0.0
31665,3,1665,[742 211 568  50 286],655,1,6598,3.960384153661465,0.0,40.0
31666,3,1666,[427 318  98 182 191],796,5,6603,3.961007798440312,40.0,0.0
31667,3,1667,[427 318  98 182 191],269,5,6608,3.961630695443645,40.0,0.0
31668,3,1668,[258   1 405 222  98],457,5,6613,3.9622528460155784,0.0,0.0
31669,3,1669,[125   1 294 216 121],450,4,6617,3.962275449101796,0.0,0.0
31670,3,1670,[427 318  98 182 191],655,5,6622,3.962896469180132,40.0,0.0
31671,3,1671,[427 318  98 182 191],72,5,6627,3.963516746411483,40.0,0.0
31672,3,1672,[427 318  98 182 191],796,5,6632,3.964136282127914,40.0,0.0
31673,3,1673,[427 318  98 182 191],18,5,6637,3.9647550776583036,40.0,0.0
31674,3,1674,[427 318  98 182 191],18,5,6642,3.9653731343283583,40.0,0.0
31675,3,1675,[427 318  98 182 191],450,5,6647,3.9659904534606207,40.0,0.0
31676,3,1676,[427 318  98 182 191],72,5,6652,3.9666070363744783,40.0,0.0
31677,3,1677,[427 318  98 182 191],655,5,6657,3.967222884386174,40.0,0.0
31678,3,1678,[265 143 276 135 237],655,3,6660,3.9666468135795117,0.0,0.0
31679,3,1679,[222   8  50 197 328],655,1,6661,3.9648809523809523,0.0,20.0
31680,3,1680,[202 496 135 118 143],330,4,6665,3.9649018441403925,20.0,0.0
31681,3,1681,[427 318  98 182 191],18,5,6670,3.9655172413793105,40.0,0.0
31682,3,1682,[427 318  98 182 191],796,5,6675,3.966131907308378,40.0,0.0
31683,3,1683,[ 12 588   1   7 215],577,4,6679,3.9661520190023754,0.0,0.0
31684,3,1684,[427 318  98 182 191],796,5,6684,3.9667655786350147,40.0,0.0
31685,3,1685,[210 194 597   4 568],450,3,6687,3.9661921708185055,0.0,0.0
31686,3,1686,[318 427  98 182 191],72,5,6692,3.966804979253112,40.0,0.0
31687,3,1687,[318 234  71 143 742],796,3,6695,3.9662322274881516,20.0,0.0
31688,3,1688,[318 427  98 182 191],450,5,6700,3.966844286560095,40.0,0.0
31689,3,1689,[204 117 588  69 194],401,2,6702,3.965680473372781,0.0,0.0
31690,3,1690,[257 196  98  56 194],389,3,6705,3.965109402720284,0.0,0.0
31691,3,1691,[318  96 222 196 100],72,4,6709,3.965130023640662,20.0,20.0
31692,3,1692,[ 70   1 176 508  64],344,3,6712,3.9645599527466038,20.0,0.0
31693,3,1693,[ 22 210   8  98 435],269,1,6713,3.9628099173553717,0.0,0.0
31694,3,1694,[210 237   9 271 117],72,3,6716,3.9622418879056047,0.0,0.0
31695,3,1695,[322  88 197 125  98],796,3,6719,3.9616745283018866,0.0,0.0
31696,3,1696,[258 483   9 269 588],796,3,6722,3.9611078373600472,0.0,0.0
31697,3,1697,[318 427  98 182 191],796,5,6727,3.9617196702002357,40.0,0.0
31698,3,1698,[ 82   1 603  22 143],18,3,6730,3.961153619776339,20.0,0.0
31699,3,1699,[318 427  98 182 191],450,5,6735,3.961764705882353,40.0,0.0
31700,3,1700,[182 265  89  50  56],256,4,6739,3.961787184009406,0.0,20.0
31701,3,1701,[144 276 132 568  96],457,5,6744,3.9623971797884843,0.0,0.0
31702,3,1702,[125 121 117 318 183],450,4,6748,3.9624192601291837,20.0,0.0
31703,3,1703,[748 405 151 496  25],151,3,6751,3.9618544600938965,20.0,0.0
31704,3,1704,[427 318  98 182 191],450,5,6756,3.9624633431085043,40.0,0.0
31705,3,1705,[427 318  98 182 191],450,5,6761,3.963071512309496,40.0,0.0
31706,3,1706,[427 318  98 182 191],18,5,6766,3.9636789689513767,40.0,0.0
31707,3,1707,[427 318  98 182 191],18,5,6771,3.9642857142857144,40.0,0.0
31708,3,1708,[ 50  95 144  79 187],450,4,6775,3.9643066120538326,0.0,20.0
31709,3,1709,[427 318  98 182 191],72,5,6780,3.9649122807017543,40.0,0.0
31710,3,1710,[427 318  98 182 191],655,5,6785,3.9655172413793105,40.0,0.0
31711,3,1711,[427 318  98 182 191],655,5,6790,3.9661214953271027,40.0,0.0
31712,3,1712,[427 318  98 182 191],796,5,6795,3.966725043782837,40.0,0.0
31713,3,1713,[403  70   7  95 313],280,3,6798,3.9661610268378062,0.0,0.0
31714,3,1714,[ 71 197  98 195 174],796,4,6802,3.966180758017493,0.0,0.0
31715,3,1715,[427 318  98 182 191],655,5,6807,3.9667832167832167,40.0,0.0
31716,3,1716,[211 322 275  97  82],151,3,6810,3.9662201514269073,0.0,20.0
31717,3,1717,[427 318  98 182 191],18,5,6815,3.9668218859138533,40.0,0.0
31718,3,1718,[427 318  98 182 191],269,5,6820,3.9674229203025013,40.0,0.0
31719,3,1719,[427 318  98 182 191],72,5,6825,3.9680232558139537,40.0,0.0
31720,3,1720,[ 12 678 405  79 180],280,3,6828,3.9674607786170832,0.0,0.0
31721,3,1721,[427 318  98 182 191],269,5,6833,3.968060394889663,40.0,0.0
31722,3,1722,[176  69 288 144  50],457,5,6838,3.9686593151479976,0.0,20.0
31723,3,1723,[427 318  98 182 191],269,5,6843,3.969257540603248,40.0,0.0
31724,3,1724,[100 228 568 483 678],280,1,6844,3.967536231884058,0.0,20.0
31725,3,1725,[322 405 483 144 276],401,3,6847,3.966975666280417,0.0,0.0
31726,3,1726,[427 318  98 182 191],796,5,6852,3.9675738274464387,40.0,0.0
31727,3,1727,[427 318  98 182 191],269,5,6857,3.9681712962962963,40.0,0.0
31728,3,1728,[405 204 322  71 182],450,4,6861,3.9681897050318105,0.0,0.0
31729,3,1729,[ 22 265 117 111 301],796,4,6865,3.968208092485549,0.0,0.0
31730,3,1730,[ 82 234 603 568 174],72,4,6869,3.9682264586943963,20.0,0.0
31731,3,1731,[196 268  22 265 182],535,1,6870,3.966512702078522,0.0,0.0
31732,3,1732,[318 427  98 182 191],450,5,6875,3.9671090594345064,40.0,0.0
31733,3,1733,[282 289  89  25 427],655,2,6877,3.965974625144175,20.0,0.0
31734,3,1734,[318 427  98 182 191],450,5,6882,3.9665706051873197,40.0,0.0
31735,3,1735,[318 427  98 182 191],269,5,6887,3.9671658986175116,40.0,0.0
31736,3,1736,[322 265 194 132 496],450,5,6892,3.96776050662061,20.0,0.0
31737,3,1737,[200 173 117  98   4],786,5,6897,3.9683544303797467,0.0,0.0
31738,3,1738,[294 161 301   7 121],655,0,6897,3.9660724554341575,0.0,0.0
31739,3,1739,[427 318  98 182 191],18,5,6902,3.966666666666667,40.0,0.0
31740,3,1740,[427 318  98 182 191],450,5,6907,3.9672601952900632,40.0,0.0
31741,3,1741,[ 95 117 216 125 180],450,4,6911,3.9672789896670495,0.0,0.0
31742,3,1742,[427 318  98 182 191],72,5,6916,3.967871485943775,40.0,0.0
31743,3,1743,[427 318  98 182 191],655,5,6921,3.9684633027522938,40.0,0.0
31744,3,1744,[125 742  79 271 276],655,2,6923,3.9673352435530087,0.0,0.0
31745,3,1745,[427 318  98 182 191],72,5,6928,3.9679266895761742,40.0,0.0
31746,3,1746,[ 82 181 597 111 405],450,4,6932,3.967945048654837,0.0,0.0
31747,3,1747,[427 318  98 182 191],269,5,6937,3.9685354691075516,40.0,0.0
31748,3,1748,[427 318  98 182 191],269,5,6942,3.9691252144082334,40.0,0.0
31749,3,1749,[427 318  98 182 191],450,5,6947,3.9697142857142858,40.0,0.0
31750,3,1750,[210 515 182  69 423],72,5,6952,3.9703026841804685,0.0,0.0
31751,3,1751,[427 318  98 182 191],18,5,6957,3.970890410958904,40.0,0.0
31752,3,1752,[ 28 182 185 568  71],389,4,6961,3.970907016543069,0.0,0.0
31753,3,1753,[328 318 132 603 196],151,4,6965,3.9709236031927024,40.0,0.0
31754,3,1754,[ 69 202  12   4 322],629,3,6968,3.9703703703703703,0.0,0.0
31755,3,1755,[427 318  98 182 191],72,5,6973,3.9709567198177678,40.0,0.0
31756,3,1756,[435 215 234 313 427],942,4,6977,3.970973249857712,20.0,0.0
31757,3,1757,[515 195 111 228 483],716,4,6981,3.97098976109215,0.0,0.0
31758,3,1758,[403  50  71  69 257],330,5,6986,3.9715747583854464,0.0,20.0
31759,3,1759,[  1 258 302 471  96],450,5,6991,3.972159090909091,0.0,0.0
31760,3,1760,[271  11 202 228 143],655,1,6992,3.9704713231118682,0.0,0.0
31761,3,1761,[427 318  98 182 191],796,5,6997,3.97105561861521,40.0,0.0
31762,3,1762,[515 276 282 191 318],655,4,7001,3.9710720363017584,20.0,0.0
31763,3,1763,[100 173 228 183 245],796,3,7004,3.9705215419501134,0.0,20.0
31764,3,1764,[100 132 135 194 483],321,4,7008,3.9705382436260623,0.0,20.0
31765,3,1765,[427 318  98 182 191],450,5,7013,3.9711211778029445,40.0,0.0
31766,3,1766,[427 318  98 182 191],796,5,7018,3.971703452178834,40.0,0.0
31767,3,1767,[ 50 275 357 194 300],535,3,7021,3.9711538461538463,0.0,40.0
31768,3,1768,[427 318  98 182 191],450,5,7026,3.9717354437535333,40.0,0.0
31769,3,1769,[301 174  25 318 172],535,4,7030,3.9717514124293785,20.0,0.0
31770,3,1770,[427 318  98 182 191],269,5,7035,3.972332015810277,40.0,0.0
31771,3,1771,[ 56 117 216 288 313],280,4,7039,3.9723476297968396,0.0,0.0
31772,3,1772,[427 318  98 182 191],450,5,7044,3.972927241962775,40.0,0.0
31773,3,1773,[403 118 678  69 168],807,4,7048,3.9729425028184893,0.0,0.0
31774,3,1774,[427 318  98 182 191],72,5,7053,3.9735211267605632,40.0,0.0
31775,3,1775,[427 318  98 182 191],72,5,7058,3.974099099099099,40.0,0.0
31776,3,1776,[427 318  98 182 191],796,5,7063,3.9746764209341587,40.0,0.0
31777,3,1777,[427 318  98 182 191],18,5,7068,3.9752530933633294,40.0,0.0
31778,3,1778,[ 11  56 237 471 197],716,4,7072,3.975267003934795,0.0,0.0
31779,3,1779,[121 117 546 471  89],786,4,7076,3.9752808988764046,0.0,0.0
31780,3,1780,[234 435 100 186 313],655,1,7077,3.973610331274565,0.0,20.0
31781,3,1781,[403 471 210 176 268],655,0,7077,3.9713804713804715,0.0,0.0
31782,3,1782,[427 318  98 182 191],72,5,7082,3.97195737521032,40.0,0.0
31783,3,1783,[427 318  98 182 191],269,5,7087,3.9725336322869955,40.0,0.0
31784,3,1784,[ 82 742 196  22 273],450,3,7090,3.9719887955182074,0.0,0.0
31785,3,1785,[ 95  82 111 168  15],389,2,7092,3.970884658454647,0.0,0.0
31786,3,1786,[ 96  28 403   9 173],796,3,7095,3.970341354224958,0.0,0.0
31787,3,1787,[427 318  98 182 191],655,5,7100,3.970917225950783,40.0,0.0
31788,3,1788,[275   7 173 125 186],151,5,7105,3.971492453884852,0.0,20.0
31789,3,1789,[471  25 135 258 288],457,5,7110,3.9720670391061454,0.0,0.0
31790,3,1790,[117 222 135 234   9],693,2,7112,3.970965940815187,0.0,0.0
31791,3,1791,[132 185 211  12 144],450,5,7117,3.9715401785714284,0.0,0.0
31792,3,1792,[603 174 238 257  28],796,3,7120,3.970998326826548,20.0,0.0
31793,3,1793,[196  70 471  88 301],344,2,7122,3.9698996655518393,0.0,0.0
31794,3,1794,[427 318  98 182 191],72,5,7127,3.9704735376044566,40.0,0.0
31795,3,1795,[282 204 161 275 135],450,4,7131,3.970489977728285,0.0,20.0
31796,3,1796,[  4 357 179 269 742],655,2,7133,3.969393433500278,0.0,0.0
31797,3,1797,[  7  98 181  12   9],344,4,7137,3.9694104560622914,0.0,0.0
31798,3,1798,[ 11 197 210  25  79],457,5,7142,3.9699833240689273,0.0,0.0
31799,3,1799,[ 89 180  82 168 238],450,4,7146,3.97,0.0,0.0
31800,3,1800,[427 318  98 182 191],655,5,7151,3.9705719044975014,40.0,0.0
31801,3,1801,[143 187 328 300 202],796,5,7156,3.9711431742508325,0.0,0.0
31802,3,1802,[269 237 588 197 183],796,3,7159,3.9706045479755963,0.0,0.0
31803,3,1803,[427 318  98 182 191],796,5,7164,3.9711751662971175,40.0,0.0
31804,3,1804,[427 318  98 182 191],450,5,7169,3.9717451523545706,40.0,0.0
31805,3,1805,[125  88 328 121 318],151,4,7173,3.971760797342193,20.0,0.0
31806,3,1806,[ 79 318 196 132 222],457,5,7178,3.9723298284449364,20.0,0.0
31807,3,1807,[427 318  98 182 191],796,5,7183,3.9728982300884956,40.0,0.0
31808,3,1808,[427 318  98 182 191],655,5,7188,3.9734660033167497,40.0,0.0
31809,3,1809,[427 318  98 182 191],655,5,7193,3.974033149171271,40.0,0.0
31810,3,1810,[427 318  98 182 191],655,5,7198,3.9745996686913307,40.0,0.0
31811,3,1811,[269 300  88   4  97],450,4,7202,3.9746136865342163,0.0,0.0
31812,3,1812,[427 318  98 182 191],655,5,7207,3.9751792608935466,40.0,0.0
31813,3,1813,[471 427 302 238   8],389,5,7212,3.9757442116868797,20.0,0.0
31814,3,1814,[427 318  98 182 191],450,5,7217,3.9763085399449034,40.0,0.0
31815,3,1815,[245 597 588  98 328],796,4,7221,3.976321585903084,0.0,0.0
31816,3,1816,[357   7 471  71 125],786,5,7226,3.976884975233902,0.0,0.0
31817,3,1817,[427 318  98 182 191],450,5,7231,3.9774477447744774,40.0,0.0
31818,3,1818,[603 265 216 153 423],655,2,7233,3.976360637713029,20.0,0.0
31819,3,1819,[742  97  12  82 286],796,1,7234,3.974725274725275,0.0,20.0
31820,3,1820,[427 318  98 182 191],72,5,7239,3.9752883031301485,40.0,0.0
31821,3,1821,[ 88 228 179  12 385],655,1,7240,3.973655323819978,0.0,0.0
31822,3,1822,[176 258 204 282 483],655,1,7241,3.9720241360394954,0.0,0.0
31823,3,1823,[237 427 132  15  50],18,4,7245,3.9720394736842106,20.0,20.0
31824,3,1824,[423 515  56 185 172],716,5,7250,3.9726027397260273,0.0,0.0
31825,3,1825,[427 318  98 182 191],796,5,7255,3.9731653888280394,40.0,0.0
31826,3,1826,[427 318  98 182 191],450,5,7260,3.973727422003284,40.0,0.0
31827,3,1827,[483 121  79 144 181],535,3,7263,3.9731947483588623,0.0,0.0
31828,3,1828,[427 318  98 182 191],655,5,7268,3.9737561509021324,40.0,0.0
31829,3,1829,[568  89 153 282 168],450,5,7273,3.9743169398907106,0.0,0.0
31830,3,1830,[289  97  50 185 257],655,2,7275,3.9732386673948663,0.0,20.0
31831,3,1831,[427 318  98 182 191],18,5,7280,3.9737991266375547,40.0,0.0
31832,3,1832,[268  64 161 195 405],655,1,7281,3.972176759410802,20.0,0.0
31833,3,1833,[427 318  98 182 191],796,5,7286,3.9727371864776444,40.0,0.0
31834,3,1834,[174 405 211 117  95],796,4,7290,3.97275204359673,0.0,0.0
31835,3,1835,[427 318  98 182 191],72,5,7295,3.9733115468409586,40.0,0.0
31836,3,1836,[ 11 194 153   4 195],450,4,7299,3.973326075122482,0.0,0.0
31837,3,1837,[257 222 185 204 135],5,4,7303,3.9733405875952124,0.0,0.0
31838,3,1838,[427 318  98 182 191],655,5,7308,3.973898858075041,40.0,0.0
31839,3,1839,[202 301  28 588 211],796,2,7310,3.972826086956522,0.0,0.0
31840,3,1840,[ 11 238  64 237 273],655,2,7312,3.971754481260185,20.0,0.0
31841,3,1841,[423 286 127 405 655],450,5,7317,3.972312703583062,0.0,40.0
31842,3,1842,[175 271 234  25 179],655,1,7318,3.9706999457406402,0.0,0.0
31843,3,1843,[427 318  98 182 191],796,5,7323,3.9712581344902387,40.0,0.0
31844,3,1844,[143 187  69 173 210],796,4,7327,3.9712737127371276,0.0,0.0
31845,3,1845,[427 318  98 182 191],655,5,7332,3.971830985915493,40.0,0.0
31846,3,1846,[427 318  98 182 191],18,5,7337,3.9723876556578235,40.0,0.0
31847,3,1847,[144 483 742 173 245],796,3,7340,3.9718614718614718,0.0,0.0
31848,3,1848,[427 318  98 182 191],18,5,7345,3.9724175229853973,40.0,0.0
31849,3,1849,[288 222 202 423  56],450,3,7348,3.9718918918918917,0.0,0.0
31850,3,1850,[427 318  98 182 191],72,5,7353,3.972447325769854,40.0,0.0
31851,3,1851,[427 318  98 182 191],796,5,7358,3.973002159827214,40.0,0.0
31852,3,1852,[183 211 196  96 427],450,5,7363,3.9735563950350783,20.0,0.0
31853,3,1853,[174 288 385 144 161],655,0,7363,3.971413160733549,0.0,0.0
31854,3,1854,[172 144 100  69 289],655,1,7364,3.969811320754717,0.0,20.0
31855,3,1855,[427 318  98 182 191],796,5,7369,3.9703663793103448,40.0,0.0
31856,3,1856,[427 318  98 182 191],72,5,7374,3.9709208400646205,40.0,0.0
31857,3,1857,[191 185 215  22 176],716,4,7378,3.970936490850377,0.0,0.0
31858,3,1858,[427 318  98 182 191],450,5,7383,3.9714900484131253,40.0,0.0
31859,3,1859,[427 318  98 182 191],18,5,7388,3.9720430107526883,40.0,0.0
31860,3,1860,[427 318  98 182 191],18,5,7393,3.972595378828587,40.0,0.0
31861,3,1861,[427 318  98 182 191],18,5,7398,3.9731471535982816,40.0,0.0
31862,3,1862,[427 318  98 182 191],655,5,7403,3.9736983360171765,40.0,0.0
31863,3,1863,[  4 282 172 194 144],535,1,7404,3.9721030042918457,0.0,0.0
31864,3,1864,[328 211 496 117 179],450,5,7409,3.9726541554959787,20.0,0.0
31865,3,1865,[197   9 318 483 427],796,3,7412,3.972132904608789,40.0,0.0
31866,3,1866,[196 275 100  71 276],344,4,7416,3.9721478307445097,0.0,40.0
31867,3,1867,[194 403 181 143 257],807,5,7421,3.972698072805139,0.0,0.0
31868,3,1868,[268 333 174 183  98],655,2,7423,3.9716425896201177,0.0,0.0
31869,3,1869,[427 318  98 182 191],450,5,7428,3.972192513368984,40.0,0.0
31870,3,1870,[111 100 194 427 174],639,3,7431,3.9716729021913415,20.0,20.0
31871,3,1871,[ 64 121 200 228 117],330,5,7436,3.9722222222222223,20.0,0.0
31872,3,1872,[427 318  98 182 191],269,5,7441,3.972770955686065,40.0,0.0
31873,3,1873,[202 197 286 318  98],878,5,7446,3.9733191035218782,20.0,20.0
31874,3,1874,[118 211 135 176 185],693,2,7448,3.9722666666666666,0.0,0.0
31875,3,1875,[427 318  98 182 191],655,5,7453,3.972814498933902,40.0,0.0
31876,3,1876,[427 318  98 182 191],72,5,7458,3.973361747469366,40.0,0.0
31877,3,1877,[427 318  98 182 191],18,5,7463,3.973908413205538,40.0,0.0
31878,3,1878,[202 237 191  88 300],716,5,7468,3.974454497072911,0.0,0.0
31879,3,1879,[179 196  69   4 173],389,3,7471,3.973936170212766,0.0,0.0
31880,3,1880,[427 318  98 182 191],450,5,7476,3.974481658692185,40.0,0.0
31881,3,1881,[427 318  98 182 191],796,5,7481,3.975026567481403,40.0,0.0
31882,3,1882,[186 196 176 301  88],389,2,7483,3.973977695167286,0.0,0.0
31883,3,1883,[191 269 196 357 211],450,5,7488,3.9745222929936306,0.0,0.0
31884,3,1884,[427 318  98 182 191],18,5,7493,3.9750663129973476,40.0,0.0
31885,3,1885,[427 318  98 182 191],796,5,7498,3.975609756097561,40.0,0.0
31886,3,1886,[471 357 204 483  96],716,3,7501,3.975092739798622,0.0,0.0
31887,3,1887,[182 161 111 127 176],457,4,7505,3.9751059322033897,0.0,20.0
31888,3,1888,[265   1 172  56 174],256,3,7508,3.9745897300158815,0.0,0.0
31889,3,1889,[427 318  98 182 191],796,5,7513,3.975132275132275,40.0,0.0
31890,3,1890,[196 275 195 423  79],655,2,7515,3.974087784241142,0.0,20.0
31891,3,1891,[228 427 405   7 186],577,2,7517,3.9730443974630023,20.0,0.0
31892,3,1892,[427 318  98 182 191],18,5,7522,3.9735868991019547,40.0,0.0
31893,3,1893,[210 385  70   1 185],450,4,7526,3.9736008447729674,0.0,0.0
31894,3,1894,[427 318  98 182 191],18,5,7531,3.9741424802110816,40.0,0.0
31895,3,1895,[153 748 282  12  50],796,5,7536,3.9746835443037973,0.0,20.0
31896,3,1896,[427 318  98 182 191],269,5,7541,3.975224037954665,40.0,0.0
31897,3,1897,[427 318  98 182 191],450,5,7546,3.975763962065332,40.0,0.0
31898,3,1898,[ 28  70 238  79 258],450,5,7551,3.976303317535545,0.0,0.0
31899,3,1899,[427 318  98 182 191],269,5,7556,3.9768421052631577,40.0,0.0
31900,3,1900,[427 318  98 182 191],796,5,7561,3.9773803261441345,40.0,0.0
31901,3,1901,[588 127 271  89 313],807,3,7564,3.9768664563617246,0.0,20.0
31902,3,1902,[179  22 471 204   4],535,3,7567,3.976353126642144,0.0,0.0
31903,3,1903,[427 318  98 182 191],18,5,7572,3.976890756302521,40.0,0.0
31904,3,1904,[ 69  28 234  22 204],577,4,7576,3.9769028871391074,0.0,0.0
31905,3,1905,[427 318  98 182 191],269,5,7581,3.977439664218258,40.0,0.0
31906,3,1906,[ 56 286 127 100 748],796,3,7584,3.976927110644992,0.0,60.0
31907,3,1907,[427 318  98 182 191],796,5,7589,3.9774633123689727,40.0,0.0
31908,3,1908,[427 318  98 182 191],269,5,7594,3.9779989523310633,40.0,0.0
31909,3,1909,[  1 196 111 211 318],18,3,7597,3.9774869109947644,20.0,0.0
31910,3,1910,[496 237  71 568 125],450,4,7601,3.977498691784406,20.0,0.0
31911,3,1911,[427 318  98 182 191],450,5,7606,3.978033472803347,40.0,0.0
31912,3,1912,[427 318  98 182 191],269,5,7611,3.9785676947203346,40.0,0.0
31913,3,1913,[427 318  98 182 191],18,5,7616,3.9791013584117034,40.0,0.0
31914,3,1914,[427 318  98 182 191],18,5,7621,3.979634464751958,40.0,0.0
31915,3,1915,[ 79 471 135 403 204],450,4,7625,3.97964509394572,0.0,0.0
31916,3,1916,[427 318  98 182 191],269,5,7630,3.9801773604590505,40.0,0.0
31917,3,1917,[427 318  98 182 191],72,5,7635,3.980709071949948,40.0,0.0
31918,3,1918,[546 168 185  22 245],450,5,7640,3.9812402292860867,0.0,0.0
31919,3,1919,[427 318  98 182 191],655,5,7645,3.9817708333333335,40.0,0.0
31920,3,1920,[237 215  89 318 151],796,5,7650,3.982300884955752,20.0,0.0
31921,3,1921,[235  22 196 186 423],450,3,7653,3.981789802289282,0.0,0.0
31922,3,1922,[179 204   7 286  64],655,2,7655,3.9807592303692148,20.0,20.0
31923,3,1923,[423 132  64 121 302],535,4,7659,3.980769230769231,20.0,0.0
31924,3,1924,[427 318  98 182 191],655,5,7664,3.981298701298701,40.0,0.0
31925,3,1925,[427 318  98 182 191],796,5,7669,3.981827622014538,40.0,0.0
31926,3,1926,[427 318  98 182 191],450,5,7674,3.9823559937727038,40.0,0.0
31927,3,1927,[265 245 742 323 143],796,2,7676,3.9813278008298756,0.0,0.0
31928,3,1928,[185 273 117 294 496],236,1,7677,3.979782270606532,20.0,0.0
31929,3,1929,[427 318  98 182 191],72,5,7682,3.9803108808290157,40.0,0.0
31930,3,1930,[427 318  98 182 191],269,5,7687,3.9808389435525635,40.0,0.0
31931,3,1931,[118 282  79 173 196],450,4,7691,3.980848861283644,0.0,0.0
31932,3,1932,[234 174 357   9 121],151,5,7696,3.9813760993274703,0.0,0.0
31933,3,1933,[183 405 179  98  89],457,5,7701,3.9819027921406414,0.0,0.0
31934,3,1934,[427 318  98 182 191],72,5,7706,3.9824289405684756,40.0,0.0
31935,3,1935,[ 50 222 200 286 300],796,4,7710,3.9824380165289255,0.0,40.0
31936,3,1936,[475 258 100 127 204],296,5,7715,3.982963345379453,0.0,40.0
31937,3,1937,[301 228 300  98 546],151,4,7719,3.98297213622291,0.0,0.0
31938,3,1938,[ 95 195 603 238  79],23,5,7724,3.9834966477565756,20.0,0.0
31939,3,1939,[151  22 143 161 211],450,5,7729,3.984020618556701,0.0,0.0
31940,3,1940,[300 318 174 515 172],908,2,7731,3.982998454404946,20.0,0.0
31941,3,1941,[ 22 357  11 117 228],716,5,7736,3.983522142121524,0.0,0.0
31942,3,1942,[427 318  98 182 191],450,5,7741,3.984045290787442,40.0,0.0
31943,3,1943,[ 97 173 183 405 186],786,5,7746,3.984567901234568,0.0,0.0
31944,3,1944,[427 318  98 182 191],655,5,7751,3.985089974293059,40.0,0.0
31945,3,1945,[427 211  25 173  98],65,4,7755,3.9850976361767727,20.0,0.0
31946,3,1946,[403 117 568 475 742],655,0,7755,3.983050847457627,0.0,0.0
31947,3,1947,[257 195 228 742  28],457,4,7759,3.9830595482546203,0.0,0.0
31948,3,1948,[276  70  89  22 179],457,5,7764,3.983581323755772,0.0,0.0
31949,3,1949,[127 118 546   7  95],280,4,7768,3.9835897435897434,0.0,20.0
31950,3,1950,[ 96  50 153 475   7],296,5,7773,3.984110712455151,0.0,20.0
31951,3,1951,[427 318  98 182 191],796,5,7778,3.9846311475409837,40.0,0.0
31952,3,1952,[427 318  98 182 191],450,5,7783,3.9851510496671785,40.0,0.0
31953,3,1953,[ 64 127 153 603 286],450,5,7788,3.985670419651996,40.0,40.0
31954,3,1954,[234 269 210 161 186],450,2,7790,3.9846547314578005,0.0,0.0
31955,3,1955,[135 245  96 322 168],450,4,7794,3.9846625766871164,0.0,0.0
31956,3,1956,[318 427  98 182 191],796,5,7799,3.9851814001021975,40.0,0.0
31957,3,1957,[318 427  98 182 191],269,5,7804,3.9856996935648623,40.0,0.0
31958,3,1958,[153 427 185  50 423],389,4,7808,3.9857069933639613,20.0,20.0
31959,3,1959,[318 427  98 182 191],450,5,7813,3.9862244897959185,40.0,0.0
31960,3,1960,[318 427  98 182 191],655,5,7818,3.9867414584395715,40.0,0.0
31961,3,1961,[318 427  98 182 191],72,5,7823,3.9872579001019366,40.0,0.0
31962,3,1962,[318 427  98 182 191],18,5,7828,3.987773815588385,40.0,0.0
31963,3,1963,[318 427  98 182 191],269,5,7833,3.9882892057026478,40.0,0.0
31964,3,1964,[318 427  98 182 191],269,5,7838,3.988804071246819,40.0,0.0
31965,3,1965,[318 427  98 182 191],18,5,7843,3.9893184130213633,40.0,0.0
31966,3,1966,[318 427  98 182 191],269,5,7848,3.9898322318251145,40.0,0.0
31967,3,1967,[655 117 228  71  79],577,4,7852,3.9898373983739837,0.0,0.0
31968,3,1968,[427 318  98 182 191],796,5,7857,3.9903504316912137,40.0,0.0
31969,3,1969,[153  82  56 546  97],504,3,7860,3.989847715736041,0.0,0.0
31970,3,1970,[179 588 204 125 121],577,4,7864,3.989852866565195,0.0,0.0
31971,3,1971,[427 318  98 182 191],269,5,7869,3.990365111561866,40.0,0.0
31972,3,1972,[300 161  70 228 269],655,0,7869,3.988342625443487,0.0,0.0
31973,3,1973,[427 318  98 182 191],655,5,7874,3.988855116514691,40.0,0.0
31974,3,1974,[ 97 289 403 471   9],693,1,7875,3.9873417721518987,0.0,0.0
31975,3,1975,[427 318  98 182 191],269,5,7880,3.9878542510121457,40.0,0.0
31976,3,1976,[168 127  56 435 568],716,5,7885,3.9883662114314617,0.0,20.0
31977,3,1977,[427 318  98 182 191],269,5,7890,3.9888776541961577,40.0,0.0
31978,3,1978,[427 318  98 182 191],450,5,7895,3.989388580090955,40.0,0.0
31979,3,1979,[546 196 322 216 273],344,3,7898,3.988888888888889,0.0,0.0
31980,3,1980,[427 318  98 182 191],269,5,7903,3.989399293286219,40.0,0.0
31981,3,1981,[427 318  98 182 191],796,5,7908,3.9899091826437942,40.0,0.0
31982,3,1982,[132  79 186 282 144],457,5,7913,3.9904185577407967,0.0,0.0
31983,3,1983,[427 318  98 182 191],269,5,7918,3.9909274193548385,40.0,0.0
31984,3,1984,[427 318  98 182 191],450,5,7923,3.991435768261965,40.0,0.0
31985,3,1985,[405 423  25  70 196],11,3,7926,3.990936555891239,0.0,0.0
31986,3,1986,[117 597 496 143   8],796,5,7931,3.9914443885254154,20.0,0.0
31987,3,1987,[427 318  98 182 191],18,5,7936,3.9919517102615694,40.0,0.0
31988,3,1988,[483 200 161  97 234],457,5,7941,3.9924585218702866,0.0,0.0
31989,3,1989,[427 318  98 182 191],269,5,7946,3.992964824120603,40.0,0.0
31990,3,1990,[357 257 300 508 215],655,1,7947,3.991461577096936,0.0,0.0
31991,3,1991,[496 100  12  22 200],18,4,7951,3.9914658634538154,20.0,20.0
31992,3,1992,[427 318  98 182 191],18,5,7956,3.9919719016557953,40.0,0.0
31993,3,1993,[172 143  79 132 174],796,5,7961,3.992477432296891,0.0,0.0
31994,3,1994,[175  12 185 237 100],655,1,7962,3.9909774436090224,0.0,20.0
31995,3,1995,[427 318  98 182 191],796,5,7967,3.991482965931864,40.0,0.0
31996,3,1996,[427 318  98 182 191],269,5,7972,3.9919879819729593,40.0,0.0
31997,3,1997,[301 181 144 100 655],593,4,7976,3.991991991991992,0.0,20.0
31998,3,1998,[546 742 216 289  79],693,2,7978,3.9909954977488744,0.0,0.0
31999,3,1999,[427 318  98 182 191],72,5,7983,3.9915,40.0,0.0
32000,3,2000,[100 228 269 118   4],450,3,7986,3.9910044977511245,0.0,20.0
32001,3,2001,[427 318  98 182 191],655,5,7991,3.9915084915084913,40.0,0.0
32002,3,2002,[423 742 216 655  28],457,5,7996,3.9920119820269595,0.0,0.0
32003,3,2003,[427 318  98 182 191],18,5,8001,3.9925149700598803,40.0,0.0
32004,3,2004,[172 302 174 186 132],269,1,8002,3.9910224438902744,0.0,0.0
32005,3,2005,[ 95 151 301 194   8],389,4,8006,3.991026919242273,0.0,0.0
32006,3,2006,[427 318  98 182 191],269,5,8011,3.9915296462381664,40.0,0.0
32007,3,2007,[ 97 183 603 186  15],655,2,8013,3.9905378486055776,20.0,0.0
32008,3,2008,[427 318  98 182 191],72,5,8018,3.991040318566451,40.0,0.0
32009,3,2009,[294 100 228 423 435],450,5,8023,3.991542288557214,0.0,20.0
32010,3,2010,[135 153 238 211 174],269,3,8026,3.9910492292391844,0.0,0.0
32011,3,2011,[176 135  97 742 313],693,3,8029,3.9905566600397613,0.0,0.0
32012,3,2012,[318 427  98 182 191],72,5,8034,3.991058122205663,40.0,0.0
32013,3,2013,[187 385 111 172 125],796,5,8039,3.9915590863952333,0.0,0.0
32014,3,2014,[318 427  98 182 191],796,5,8044,3.992059553349876,40.0,0.0
32015,3,2015,[228 318 183 742 215],655,2,8046,3.9910714285714284,20.0,0.0
32016,3,2016,[427 318  98 182 191],18,5,8051,3.991571641051066,40.0,0.0
32017,3,2017,[ 12 275 121 183 143],151,4,8055,3.991575817641229,0.0,20.0
32018,3,2018,[427 318  98 182 191],655,5,8060,3.9920752847944527,40.0,0.0
32019,3,2019,[318 328 238 222 215],655,1,8061,3.990594059405941,20.0,0.0
32020,3,2020,[427 318  98 182 191],269,5,8066,3.991093518060366,40.0,0.0
32021,3,2021,[235 222 742 276  15],256,3,8069,3.9906033630069238,0.0,0.0
32022,3,2022,[427 318  98 182 191],450,5,8074,3.991102323282254,40.0,0.0
32023,3,2023,[427 318  98 182 191],72,5,8079,3.991600790513834,40.0,0.0
32024,3,2024,[427 318  98 182 191],796,5,8084,3.992098765432099,40.0,0.0
32025,3,2025,[403 742 322 318 655],280,3,8087,3.991609081934847,20.0,0.0
32026,3,2026,[427 318  98 182 191],72,5,8092,3.992106561420819,40.0,0.0
32027,3,2027,[271 238  96 185   7],655,1,8093,3.9906311637080867,0.0,0.0
32028,3,2028,[180 216 475 197 100],269,3,8096,3.9901429275505174,0.0,20.0
32029,3,2029,[196 118 423 228   8],796,5,8101,3.99064039408867,0.0,0.0
32030,3,2030,[318 427  98 182 191],72,5,8106,3.9911373707533233,40.0,0.0
32031,3,2031,[318 427  98 182 191],450,5,8111,3.9916338582677167,40.0,0.0
32032,3,2032,[176 300  28 153   9],655,0,8111,3.9896704377766845,0.0,0.0
32033,3,2033,[568 258 187 195 275],796,5,8116,3.990167158308751,0.0,20.0
32034,3,2034,[173   1 235 222 483],280,3,8119,3.9896805896805896,0.0,0.0
32035,3,2035,[322 288 172 111  56],593,4,8123,3.989685658153242,0.0,0.0
32036,3,2036,[427 318  98 182 191],655,5,8128,3.990181639666176,40.0,0.0
32037,3,2037,[ 95   8 174 173 257],807,4,8132,3.9901864573110895,0.0,0.0
32038,3,2038,[135 211 172 111  82],269,2,8134,3.9892103972535558,0.0,0.0
32039,3,2039,[176   7 313 117 181],577,4,8138,3.98921568627451,0.0,0.0
32040,3,2040,[318 427  98 182 191],655,5,8143,3.9897109260166586,40.0,0.0
32041,3,2041,[ 50 215 496 385 216],716,4,8147,3.9897159647404505,20.0,20.0
32042,3,2042,[423 471 238 655  25],655,0,8147,3.9877630934899657,0.0,0.0
32043,3,2043,[318 427  98 182 191],72,5,8152,3.98825831702544,40.0,0.0
32044,3,2044,[186 121   7  25 235],450,1,8153,3.98679706601467,0.0,0.0
32045,3,2045,[313  28 174 118 588],796,4,8157,3.9868035190615836,0.0,0.0
32046,3,2046,[  1 143 515 210 318],401,4,8161,3.986809965803615,20.0,0.0
32047,3,2047,[318 427  98 182 191],655,5,8166,3.9873046875,40.0,0.0
32048,3,2048,[318 427  98 182 191],655,5,8171,3.9877989263055147,40.0,0.0
32049,3,2049,[179 182 294 176 151],457,4,8175,3.9878048780487805,0.0,0.0
32050,3,2050,[471 191  64 603  82],716,4,8179,3.9878108239882986,40.0,0.0
32051,3,2051,[ 15 181 143 216 286],18,4,8183,3.9878167641325537,0.0,20.0
32052,3,2052,[195 496 405  12  71],450,4,8187,3.9878226984900147,20.0,0.0
32053,3,2053,[318 427  98 182 191],72,5,8192,3.988315481986368,40.0,0.0
32054,3,2054,[318 427  98 182 191],18,5,8197,3.9888077858880777,40.0,0.0
32055,3,2055,[318 427  98 182 191],72,5,8202,3.9892996108949417,40.0,0.0
32056,3,2056,[271  79   8 100 111],655,1,8203,3.9878463782207096,0.0,20.0
32057,3,2057,[271 328 153  71 194],796,5,8208,3.988338192419825,0.0,0.0
32058,3,2058,[ 56  64   8  15 515],269,3,8211,3.9878581835842644,20.0,0.0
32059,3,2059,[ 25 111 235 603 151],450,3,8214,3.987378640776699,20.0,0.0
32060,3,2060,[275  82  97 187 403],796,3,8217,3.986899563318777,0.0,20.0
32061,3,2061,[427 318  98 182 191],655,5,8222,3.9873908826382154,40.0,0.0
32062,3,2062,[427 318  98 182 191],269,5,8227,3.9878817256422687,40.0,0.0
32063,3,2063,[427 318  98 182 191],72,5,8232,3.988372093023256,40.0,0.0
32064,3,2064,[234  56  88 275  69],151,5,8237,3.988861985472155,0.0,20.0
32065,3,2065,[515  97  22 197 435],878,3,8240,3.9883833494675702,0.0,0.0
32066,3,2066,[257 385 276 194   4],457,4,8244,3.988388969521045,0.0,0.0
32067,3,2067,[427 318  98 182 191],72,5,8249,3.988878143133462,40.0,0.0
32068,3,2068,[427 318  98 182 191],450,5,8254,3.9893668438859353,40.0,0.0
32069,3,2069,[427 318  98 182 191],655,5,8259,3.9898550724637682,40.0,0.0
32070,3,2070,[427 318  98 182 191],450,5,8264,3.9903428295509418,40.0,0.0
32071,3,2071,[427 318  98 182 191],655,5,8269,3.990830115830116,40.0,0.0
32072,3,2072,[275 195 182 282 204],450,5,8274,3.991316931982634,0.0,20.0
32073,3,2073,[427 318  98 182 191],655,5,8279,3.9918032786885247,40.0,0.0
32074,3,2074,[427 318  98 182 191],18,5,8284,3.992289156626506,40.0,0.0
32075,3,2075,[271 655  15 322 173],796,3,8287,3.9918111753371868,0.0,0.0
32076,3,2076,[427 318  98 182 191],796,5,8292,3.9922965816080884,40.0,0.0
32077,3,2077,[427 318  98 182 191],655,5,8297,3.992781520692974,40.0,0.0
32078,3,2078,[238  70 228 183 273],450,4,8301,3.9927849927849928,0.0,0.0
32079,3,2079,[568 132 194 228 216],450,5,8306,3.9932692307692306,0.0,0.0
32080,3,2080,[196 286 151   7 423],151,5,8311,3.9937530033637674,0.0,20.0
32081,3,2081,[172 202 135 385  22],330,4,8315,3.993756003842459,0.0,0.0
32082,3,2082,[215  11 237 483 175],655,1,8316,3.9923187710033607,0.0,0.0
32083,3,2083,[427 318  98 182 191],269,5,8321,3.992802303262956,40.0,0.0
32084,3,2084,[427 318  98 182 191],796,5,8326,3.9932853717026378,40.0,0.0
32085,3,2085,[174 237 172   7 215],450,5,8331,3.9937679769894534,0.0,0.0
32086,3,2086,[427 318  98 182 191],269,5,8336,3.994250119789171,40.0,0.0
32087,3,2087,[427 318  98 182 191],655,5,8341,3.9947318007662833,40.0,0.0
32088,3,2088,[111 273 195 471 183],655,2,8343,3.993776926759215,0.0,0.0
32089,3,2089,[ 15  56  79 265 257],796,5,8348,3.9942583732057417,0.0,0.0
32090,3,2090,[318 427  98 182 191],796,5,8353,3.9947393591582974,40.0,0.0
32091,3,2091,[318 427  98 182 191],796,5,8358,3.9952198852772467,40.0,0.0
32092,3,2092,[318 427  98 182 191],796,5,8363,3.9956999522216914,40.0,0.0
32093,3,2093,[ 22 508  11   7  97],344,2,8365,3.994746895893028,0.0,0.0
32094,3,2094,[318 427  98 182 191],18,5,8370,3.9952267303102627,40.0,0.0
32095,3,2095,[286 313 273 210 328],655,2,8372,3.9942748091603053,0.0,20.0
32096,3,2096,[ 11 333 125 135   9],655,1,8373,3.992846924177396,0.0,0.0
32097,3,2097,[191 318 202  95 269],18,4,8377,3.9928503336510963,20.0,0.0
32098,3,2098,[427 318  98 182 191],269,5,8382,3.9933301572177227,40.0,0.0
32099,3,2099,[423 173 132  88 125],280,2,8384,3.9923809523809526,0.0,0.0
32100,3,2100,[427 318  98 182 191],655,5,8389,3.9928605425987627,40.0,0.0
32101,3,2101,[118 257  98 258 655],655,1,8390,3.9914367269267363,0.0,0.0
32102,3,2102,[427 318  98 182 191],269,5,8395,3.991916310033286,40.0,0.0
32103,3,2103,[427 318  98 182 191],796,5,8400,3.9923954372623576,40.0,0.0
32104,3,2104,[427 318  98 182 191],450,5,8405,3.992874109263658,40.0,0.0
32105,3,2105,[427 318  98 182 191],655,5,8410,3.99335232668566,40.0,0.0
32106,3,2106,[427 318  98 182 191],269,5,8415,3.993830090175605,40.0,0.0
32107,3,2107,[427 318  98 182 191],450,5,8420,3.9943074003795065,40.0,0.0
32108,3,2108,[427 318  98 182 191],72,5,8425,3.9947842579421526,40.0,0.0
32109,3,2109,[427 318  98 182 191],655,5,8430,3.995260663507109,40.0,0.0
32110,3,2110,[427 318  98 182 191],655,5,8435,3.9957366177167217,40.0,0.0
32111,3,2111,[427 318  98 182 191],72,5,8440,3.996212121212121,40.0,0.0
32112,3,2112,[194 100 202 222 216],264,5,8445,3.996687174633223,0.0,20.0
32113,3,2113,[427 318  98 182 191],18,5,8450,3.9971617786187323,40.0,0.0
32114,3,2114,[286 161 328   9 200],796,3,8453,3.9966903073286053,0.0,20.0
32115,3,2115,[191 187 181  79 194],796,5,8458,3.997164461247637,0.0,0.0
32116,3,2116,[153  96 181 301   4],450,4,8462,3.997165800661313,0.0,0.0
32117,3,2117,[318 427  98 182 191],796,5,8467,3.997639282341832,40.0,0.0
32118,3,2118,[318 427  98 182 191],72,5,8472,3.998112317130722,40.0,0.0
32119,3,2119,[318 427  98 182 191],450,5,8477,3.9985849056603775,40.0,0.0
32120,3,2120,[202 121 496  97 161],330,5,8482,3.999057048561999,20.0,0.0
32121,3,2121,[427 318  98 182 191],796,5,8487,3.9995287464655984,40.0,0.0
32122,3,2122,[191 175  15   7 423],269,3,8490,3.999057936881771,0.0,0.0
32123,3,2123,[427 318  98 182 191],796,5,8495,3.999529190207156,40.0,0.0
32124,3,2124,[427 318  98 182 191],796,5,8500,4.0,40.0,0.0
32125,3,2125,[427 318  98 182 191],72,5,8505,4.000470366886171,40.0,0.0
32126,3,2126,[427 318  98 182 191],796,5,8510,4.0009402914903625,40.0,0.0
32127,3,2127,[427 318  98 182 191],269,5,8515,4.00140977443609,40.0,0.0
32128,3,2128,[427 172  56  69 151],236,3,8518,4.000939408172851,20.0,0.0
32129,3,2129,[427 318  98 182 191],18,5,8523,4.001408450704226,40.0,0.0
32130,3,2130,[151 294 403 655 168],796,3,8526,4.000938526513374,0.0,0.0
32131,3,2131,[196 197 275  79 183],796,4,8530,4.00093808630394,0.0,20.0
32132,3,2132,[427 318  98 182 191],18,5,8535,4.0014064697609,40.0,0.0
32133,3,2133,[427 318  98 182 191],269,5,8540,4.001874414245548,40.0,0.0
32134,3,2134,[ 64 187 132 276 427],123,2,8542,4.000936768149883,40.0,0.0
32135,3,2135,[174 111  56 211 143],151,5,8547,4.001404494382022,0.0,0.0
32136,3,2136,[318 427  98 182 191],796,5,8552,4.001871782873187,40.0,0.0
32137,3,2137,[176 238  69 655 597],796,3,8555,4.001403180542563,0.0,0.0
32138,3,2138,[  9 423 302 403 475],655,1,8556,4.0,0.0,0.0
32139,3,2139,[153 237 181 258  15],796,5,8561,4.0004672897196265,0.0,0.0
32140,3,2140,[318 427  98 182 191],450,5,8566,4.000934142923867,40.0,0.0
32141,3,2141,[127 748 197 603 405],450,5,8571,4.00140056022409,20.0,20.0
32142,3,2142,[318 427  98 182 191],269,5,8576,4.001866542230518,40.0,0.0
32143,3,2143,[318 427  98 182 191],796,5,8581,4.0023320895522385,40.0,0.0
32144,3,2144,[228  28 121  70   7],457,5,8586,4.002797202797203,0.0,0.0
32145,3,2145,[318 427  98 182 191],18,5,8591,4.003261882572227,40.0,0.0
32146,3,2146,[151 273 471 200 302],450,3,8594,4.00279459711225,0.0,0.0
32147,3,2147,[318 427  98 182 191],655,5,8599,4.003258845437617,40.0,0.0
32148,3,2148,[117 323 245 271 211],796,2,8601,4.002326663564449,0.0,0.0
32149,3,2149,[318 427  98 182 191],269,5,8606,4.002790697674419,40.0,0.0
32150,3,2150,[204   9 183 288 174],457,5,8611,4.00325430032543,0.0,0.0
32151,3,2151,[318 427  98 182 191],655,5,8616,4.003717472118959,40.0,0.0
32152,3,2152,[275 135 200 333 328],236,1,8617,4.002322340919647,0.0,20.0
32153,3,2153,[318 427  98 182 191],450,5,8622,4.002785515320334,40.0,0.0
32154,3,2154,[182 181  69  28 187],389,5,8627,4.003248259860789,0.0,0.0
32155,3,2155,[318 427  98 182 191],269,5,8632,4.003710575139147,40.0,0.0
32156,3,2156,[ 70 194 286 144  25],450,4,8636,4.003708854891053,0.0,20.0
32157,3,2157,[318 427  98 182 191],655,5,8641,4.004170528266914,40.0,0.0
32158,3,2158,[ 88 423   9 603 179],18,3,8644,4.003705419175544,20.0,0.0
32159,3,2159,[318 427  98 182 191],18,5,8649,4.004166666666666,40.0,0.0
32160,3,2160,[385  88  25 742 471],256,5,8654,4.00462748727441,0.0,0.0
32161,3,2161,[127 276 197 222 132],457,5,8659,4.00508788159112,0.0,20.0
32162,3,2162,[742 546 357 228 568],693,2,8661,4.004160887656034,0.0,0.0
32163,3,2163,[318 427  98 182 191],450,5,8666,4.0046210720887245,40.0,0.0
32164,3,2164,[196 172 174 215 568],693,3,8669,4.004157043879908,0.0,0.0
32165,3,2165,[328 385  82 655 302],655,1,8670,4.002770083102493,0.0,0.0
32166,3,2166,[117 127 174 196  64],236,2,8672,4.001845869866174,20.0,20.0
32167,3,2167,[318 427  98 182 191],796,5,8677,4.002306273062731,40.0,0.0
32168,3,2168,[ 11 135  69 215 222],280,3,8680,4.0018441678192715,0.0,0.0
32169,3,2169,[318 427  98 182 191],655,5,8685,4.002304147465438,40.0,0.0
32170,3,2170,[234 174 257   7 185],655,1,8686,4.000921234454169,0.0,0.0
32171,3,2171,[187  50 471 222 186],655,2,8688,4.0,0.0,20.0
32172,3,2172,[318 427  98 182 191],655,5,8693,4.000460193281178,40.0,0.0
32173,3,2173,[237 143 179 215  96],457,5,8698,4.000919963201472,0.0,0.0
32174,3,2174,[318 427  98 182 191],655,5,8703,4.001379310344827,40.0,0.0
32175,3,2175,[180 197  88 568 153],280,2,8705,4.000459558823529,0.0,0.0
32176,3,2176,[313 125 294  28 403],450,5,8710,4.000918695452458,0.0,0.0
32177,3,2177,[318 427  98 182 191],655,5,8715,4.0013774104683195,40.0,0.0
32178,3,2178,[318 427  98 182 191],796,5,8720,4.001835704451583,40.0,0.0
32179,3,2179,[318 427  98 182 191],72,5,8725,4.002293577981652,40.0,0.0
32180,3,2180,[318 427  98 182 191],269,5,8730,4.002751031636864,40.0,0.0
32181,3,2181,[173  88 215 168 742],450,5,8735,4.0032080659945,0.0,0.0
32182,3,2182,[318 427  98 182 191],655,5,8740,4.0036646816307835,40.0,0.0
32183,3,2183,[318 403 238  70  50],330,5,8745,4.0041208791208796,20.0,20.0
32184,3,2184,[423  69 153  96   7],280,5,8750,4.004576659038902,0.0,0.0
32185,3,2185,[174 172 300 176 222],151,4,8754,4.004574565416285,0.0,0.0
32186,3,2186,[318 427  98 182 191],72,5,8759,4.0050297210791035,40.0,0.0
32187,3,2187,[204 174 173 185 144],716,4,8763,4.005027422303473,0.0,0.0
32188,3,2188,[222  11 357 143 423],450,4,8767,4.005025125628141,0.0,0.0
32189,3,2189,[318 427  98 182 191],18,5,8772,4.005479452054795,40.0,0.0
32190,3,2190,[294   4   9 423 655],629,3,8775,4.005020538566864,0.0,0.0
32191,3,2191,[546 435 496 568 176],716,3,8778,4.00456204379562,20.0,0.0
32192,3,2192,[117   4 111  79 322],450,4,8782,4.0045599635202915,0.0,0.0
32193,3,2193,[318 427  98 182 191],450,5,8787,4.005013673655424,40.0,0.0
32194,3,2194,[318 427  98 182 191],72,5,8792,4.005466970387244,40.0,0.0
32195,3,2195,[357 222 238 132  64],716,5,8797,4.00591985428051,20.0,0.0
32196,3,2196,[318 427  98 182 191],796,5,8802,4.006372325898953,40.0,0.0
32197,3,2197,[197   4 172 427 216],18,3,8805,4.005914467697907,20.0,0.0
32198,3,2198,[318 427  98 182 191],796,5,8810,4.006366530241019,40.0,0.0
32199,3,2199,[318 427  98 182 191],72,5,8815,4.006818181818182,40.0,0.0
32200,3,2200,[318 427  98 182 191],18,5,8820,4.00726942298955,40.0,0.0
32201,3,2201,[ 79 258 118  88 357],457,5,8825,4.007720254314259,0.0,0.0
32202,3,2202,[318 427  98 182 191],655,5,8830,4.0081706763504314,40.0,0.0
32203,3,2203,[191 276 172 179 333],655,4,8834,4.008166969147005,0.0,0.0
32204,3,2204,[318 427  98 182 191],450,5,8839,4.008616780045352,40.0,0.0
32205,3,2205,[269 194 202 210  97],639,1,8840,4.00725294650952,0.0,0.0
32206,3,2206,[568 357 191 318 313],693,4,8844,4.00724966017218,20.0,0.0
32207,3,2207,[313 275 269 216 196],796,4,8848,4.007246376811594,0.0,20.0
32208,3,2208,[211  64 385 228 322],450,5,8853,4.007695789950204,20.0,0.0
32209,3,2209,[174 181  25 196 328],401,4,8857,4.007692307692308,0.0,0.0
32210,3,2210,[143 179 117 237  50],593,5,8862,4.008141112618724,0.0,20.0
32211,3,2211,[318 427  98 182 191],796,5,8867,4.008589511754069,40.0,0.0
32212,3,2212,[161 182  95  79   7],450,4,8871,4.008585630366019,0.0,0.0
32213,3,2213,[318 427  98 182 191],796,5,8876,4.00903342366757,40.0,0.0
32214,3,2214,[318 427  98 182 191],796,5,8881,4.009480812641083,40.0,0.0
32215,3,2215,[286 597   8 294  71],796,3,8884,4.009025270758123,0.0,20.0
32216,3,2216,[258   9 655 748 286],796,2,8886,4.008119079837618,0.0,20.0
32217,3,2217,[318 427  98 182 191],269,5,8891,4.008566275924256,40.0,0.0
32218,3,2218,[318 427  98 182 191],18,5,8896,4.009013068949978,40.0,0.0
32219,3,2219,[318 427  98 182 191],796,5,8901,4.0094594594594595,40.0,0.0
32220,3,2220,[210  97 655 121 515],72,4,8905,4.009455200360198,0.0,0.0
32221,3,2221,[318 427  98 182 191],796,5,8910,4.00990099009901,40.0,0.0
32222,3,2222,[318 427  98 182 191],72,5,8915,4.010346378767432,40.0,0.0
32223,3,2223,[300 196 174 333 234],796,4,8919,4.010341726618705,0.0,0.0
32224,3,2224,[125   8 234 200 215],655,1,8920,4.008988764044944,0.0,0.0
32225,3,2225,[318 427  98 182 191],450,5,8925,4.009433962264151,40.0,0.0
32226,3,2226,[288 228 197 238 125],457,5,8930,4.009878760664571,0.0,0.0
32227,3,2227,[269 427 196  22 182],535,3,8933,4.009425493716337,20.0,0.0
32228,3,2228,[318 427  98 182 191],450,5,8938,4.009869896814715,40.0,0.0
32229,3,2229,[ 15  79 185 111 180],11,4,8942,4.009865470852018,0.0,0.0
32230,3,2230,[118  97   4 211 187],504,3,8945,4.009412819363514,0.0,0.0
32231,3,2231,[318 427  98 182 191],269,5,8950,4.009856630824372,40.0,0.0
32232,3,2232,[ 71  50 286 271 301],796,3,8953,4.009404388714733,0.0,40.0
32233,3,2233,[318 427  98 182 191],269,5,8958,4.009847806624888,40.0,0.0
32234,3,2234,[318 427  98 182 191],18,5,8963,4.0102908277404925,40.0,0.0
32235,3,2235,[132 175 179 483  97],457,5,8968,4.010733452593918,0.0,0.0
32236,3,2236,[ 22 211   4 196 318],535,3,8971,4.010281627179258,20.0,0.0
32237,3,2237,[318 427  98 182 191],450,5,8976,4.010723860589812,40.0,0.0
32238,3,2238,[318 427  98 182 191],450,5,8981,4.011165698972755,40.0,0.0
32239,3,2239,[318 427  98 182 191],269,5,8986,4.011607142857143,40.0,0.0
32240,3,2240,[318 427  98 182 191],450,5,8991,4.0120481927710845,40.0,0.0
32241,3,2241,[153  56 269  22 196],796,4,8995,4.012042818911686,0.0,0.0
32242,3,2242,[597 181 153 200 187],269,2,8997,4.011145786892555,0.0,0.0
32243,3,2243,[318 427  98 182 191],72,5,9002,4.0115864527629235,40.0,0.0
32244,3,2244,[318 427  98 182 191],72,5,9007,4.012026726057907,40.0,0.0
32245,3,2245,[265   9 257  82 111],796,3,9010,4.011576135351737,0.0,0.0
32246,3,2246,[318 427  98 182 191],18,5,9015,4.0120160213618155,40.0,0.0
32247,3,2247,[211 161 118 181 273],655,1,9016,4.01067615658363,0.0,0.0
32248,3,2248,[318 427  98 182 191],655,5,9021,4.01111605157848,40.0,0.0
32249,3,2249,[194 117 132 405  12],577,4,9025,4.011111111111111,0.0,0.0
32250,3,2250,[318 427  98 182 191],269,5,9030,4.011550422034651,40.0,0.0
32251,3,2251,[ 96  15 269 197 333],655,0,9030,4.0097690941385435,0.0,0.0
32252,3,2252,[318 427  98 182 191],450,5,9035,4.010208610741234,40.0,0.0
32253,3,2253,[176 748 202 385 269],450,5,9040,4.010647737355812,0.0,0.0
32254,3,2254,[215 282 235 195 546],716,1,9041,4.009312638580932,0.0,0.0
32255,3,2255,[271 323 405   9 427],796,3,9044,4.00886524822695,20.0,0.0
32256,3,2256,[318 427  98 182 191],655,5,9049,4.009304386353567,40.0,0.0
32257,3,2257,[318 427  98 182 191],269,5,9054,4.009743135518158,40.0,0.0
32258,3,2258,[215 597 483  11 168],457,4,9058,4.009738822487827,0.0,0.0
32259,3,2259,[294 282 323 238 194],796,2,9060,4.008849557522124,0.0,0.0
32260,3,2260,[318 427  98 182 191],72,5,9065,4.0092879256965945,40.0,0.0
32261,3,2261,[318 427  98 182 191],18,5,9070,4.00972590627763,40.0,0.0
32262,3,2262,[234   1 202 204 181],389,5,9075,4.010163499779054,0.0,0.0
32263,3,2263,[318 427  98 182 191],655,5,9080,4.010600706713781,40.0,0.0
32264,3,2264,[ 15 427 176 210  82],389,3,9083,4.010154525386313,20.0,0.0
32265,3,2265,[191 228 180 546 186],693,0,9083,4.008384819064431,0.0,0.0
32266,3,2266,[276  64 385  89 117],457,5,9088,4.008822232024702,20.0,0.0
32267,3,2267,[318 427  98 182 191],796,5,9093,4.0092592592592595,40.0,0.0
32268,3,2268,[318 427  98 182 191],72,5,9098,4.009695901278096,40.0,0.0
32269,3,2269,[204 153 269  64 588],796,4,9102,4.009691629955947,20.0,0.0
32270,3,2270,[318 427  98 182 191],72,5,9107,4.010127697049758,40.0,0.0
32271,3,2271,[135 181 197 603 237],72,3,9110,4.009683098591549,20.0,0.0
32272,3,2272,[121 333 483 269 195],655,1,9111,4.00835899692037,0.0,0.0
32273,3,2273,[318 427  98 182 191],655,5,9116,4.008795074758136,40.0,0.0
32274,3,2274,[179 301 118   4 182],593,4,9120,4.008791208791209,0.0,0.0
32275,3,2275,[318 427  98 182 191],655,5,9125,4.009226713532513,40.0,0.0
32276,3,2276,[183 173 322 100 179],450,5,9130,4.009661835748792,0.0,20.0
32277,3,2277,[275 161 144  22 546],796,5,9135,4.010096575943811,0.0,20.0
32278,3,2278,[318 427  98 182 191],72,5,9140,4.010530934620448,40.0,0.0
32279,3,2279,[318 427  98 182 191],655,5,9145,4.010964912280702,40.0,0.0
32280,3,2280,[ 69 313 185  79 275],796,5,9150,4.011398509425691,0.0,20.0
32281,3,2281,[210 215 288 200 294],280,2,9152,4.010517090271692,0.0,0.0
32282,3,2282,[288 508 258 202 191],344,4,9156,4.010512483574244,0.0,0.0
32283,3,2283,[ 69 318 405 144   9],401,2,9158,4.009632224168126,20.0,0.0
32284,3,2284,[  1 185 215 172 515],716,5,9163,4.010065645514223,0.0,0.0
32285,3,2285,[318 427  98 182 191],18,5,9168,4.010498687664042,40.0,0.0
32286,3,2286,[318 427  98 182 191],450,5,9173,4.010931351114998,40.0,0.0
32287,3,2287,[318 427  98 182 191],269,5,9178,4.011363636363637,40.0,0.0
32288,3,2288,[ 95  82 172 173 301],796,3,9181,4.010921799912626,0.0,0.0
32289,3,2289,[568  79  15  28 173],389,2,9183,4.010043668122271,0.0,0.0
32290,3,2290,[318 427  98 182 191],72,5,9188,4.010475774770843,40.0,0.0
32291,3,2291,[597 100 144 181 161],796,4,9192,4.010471204188482,0.0,20.0
32292,3,2292,[204 153   9 238 121],655,0,9192,4.008722197993895,0.0,0.0
32293,3,2293,[318 427  98 182 191],269,5,9197,4.009154315605929,40.0,0.0
32294,3,2294,[318 427  98 182 191],18,5,9202,4.00958605664488,40.0,0.0
32295,3,2295,[318 427  98 182 191],18,5,9207,4.010017421602788,40.0,0.0
32296,3,2296,[275 216 234 515 423],18,4,9211,4.010013060513714,0.0,20.0
32297,3,2297,[282 172 210 318 118],693,2,9213,4.009138381201044,20.0,0.0
32298,3,2298,[318 427  98 182 191],18,5,9218,4.009569377990431,40.0,0.0
32299,3,2299,[289 403 508 143  96],655,1,9219,4.008260869565217,0.0,0.0
32300,3,2300,[318 427  98 182 191],655,5,9224,4.008691873098653,40.0,0.0
32301,3,2301,[318 427  98 182 191],796,5,9229,4.0091225021720245,40.0,0.0
32302,3,2302,[318 427  98 182 191],72,5,9234,4.009552757273122,40.0,0.0
32303,3,2303,[318 427  98 182 191],655,5,9239,4.009982638888889,40.0,0.0
32304,3,2304,[153 111 258 423   1],151,4,9243,4.009978308026031,0.0,0.0
32305,3,2305,[180  69  79 195   7],693,3,9246,4.009540329575022,0.0,0.0
32306,3,2306,[132 118 288 179 185],655,2,9248,4.0086692674469,0.0,0.0
32307,3,2307,[318 427  98 182 191],796,5,9253,4.009098786828423,40.0,0.0
32308,3,2308,[318 427  98 182 191],655,5,9258,4.009527934170636,40.0,0.0
32309,3,2309,[318 427  98 182 191],655,5,9263,4.00995670995671,40.0,0.0
32310,3,2310,[318 427  98 182 191],796,5,9268,4.010385114668974,40.0,0.0
32311,3,2311,[ 82 265 204 151 200],716,5,9273,4.010813148788928,0.0,0.0
32312,3,2312,[496 202 118 210  22],577,3,9276,4.0103761348897535,20.0,0.0
32313,3,2313,[121 238 118 234 288],457,5,9281,4.010803802938635,0.0,0.0
32314,3,2314,[172 186 195  50 194],535,4,9285,4.010799136069115,0.0,20.0
32315,3,2315,[ 88 427  79 276 210],18,4,9289,4.010794473229707,20.0,0.0
32316,3,2316,[125 655 282 300 215],450,5,9294,4.011221406991799,0.0,0.0
32317,3,2317,[ 15 286 228  12 603],655,1,9295,4.0099223468507335,20.0,20.0
32318,3,2318,[318 427  98 182 191],269,5,9300,4.010349288486417,40.0,0.0
32319,3,2319,[318 427  98 182 191],450,5,9305,4.010775862068965,40.0,0.0
32320,3,2320,[318 427  98 182 191],72,5,9310,4.011202068074106,40.0,0.0
32321,3,2321,[172 265  96 211 195],450,5,9315,4.011627906976744,0.0,0.0
32322,3,2322,[ 15 286 186 168 179],389,2,9317,4.010761945759794,0.0,20.0
32323,3,2323,[318 427  98 182 191],72,5,9322,4.01118760757315,40.0,0.0
32324,3,2324,[318 427  98 182 191],269,5,9327,4.0116129032258065,40.0,0.0
32325,3,2325,[210 191 174  98 172],72,4,9331,4.011607910576096,0.0,0.0
32326,3,2326,[318 427  98 182 191],796,5,9336,4.012032660077352,40.0,0.0
32327,3,2327,[318 427  98 182 191],18,5,9341,4.01245704467354,40.0,0.0
32328,3,2328,[302 100 121 132  97],151,3,9344,4.0120223271790465,0.0,20.0
32329,3,2329,[318 427  98 182 191],72,5,9349,4.01244635193133,40.0,0.0
32330,3,2330,[  1 179 403  22 258],655,1,9350,4.011154011154011,0.0,0.0
32331,3,2331,[318 427  98 182 191],450,5,9355,4.011578044596913,40.0,0.0
32332,3,2332,[182 176 111  28 100],389,4,9359,4.011573081868838,0.0,20.0
32333,3,2333,[323  25 471 597 127],938,2,9361,4.010711225364181,0.0,20.0
32334,3,2334,[ 50 245 294 265 200],796,3,9364,4.0102783725910065,0.0,20.0
32335,3,2335,[318 427  98 182 191],450,5,9369,4.01070205479452,40.0,0.0
32336,3,2336,[318 427  98 182 191],796,5,9374,4.011125374411638,40.0,0.0
32337,3,2337,[318 427  98 182 191],655,5,9379,4.011548331907614,40.0,0.0
32338,3,2338,[742 265 603 216 748],796,4,9383,4.011543394613082,20.0,0.0
32339,3,2339,[288 191 111 183 172],457,4,9387,4.0115384615384615,0.0,0.0
32340,3,2340,[385 186  96  98 258],504,4,9391,4.011533532678342,0.0,0.0
32341,3,2341,[173  70 234 405 211],503,4,9395,4.011528608027327,0.0,0.0
32342,3,2342,[ 97 318 125 174 185],503,4,9399,4.011523687580025,20.0,0.0
32343,3,2343,[318 427  98 182 191],18,5,9404,4.011945392491468,40.0,0.0
32344,3,2344,[318 427  98 182 191],450,5,9409,4.012366737739872,40.0,0.0
32345,3,2345,[318 427  98 182 191],72,5,9414,4.012787723785166,40.0,0.0
32346,3,2346,[ 96 318  50 222 181],457,5,9419,4.013208351086494,20.0,20.0
32347,3,2347,[318 427  98 182 191],72,5,9424,4.013628620102215,40.0,0.0
32348,3,2348,[ 15  69 117 175 238],457,5,9429,4.014048531289911,0.0,0.0
32349,3,2349,[318 427  98 182 191],450,5,9434,4.014468085106383,40.0,0.0
32350,3,2350,[318 427  98 182 191],18,5,9439,4.014887282007656,40.0,0.0
32351,3,2351,[483 300 111 228  15],450,3,9442,4.014455782312925,0.0,0.0
32352,3,2352,[ 64 180 182  11 125],450,5,9447,4.014874628134296,20.0,0.0
32353,3,2353,[318 427  98 182 191],796,5,9452,4.0152931180968565,40.0,0.0
32354,3,2354,[318 427  98 182 191],796,5,9457,4.015711252653928,40.0,0.0
32355,3,2355,[69 96 89 15 28],450,4,9461,4.015704584040747,0.0,0.0
32356,3,2356,[318 427  98 182 191],269,5,9466,4.016122189223589,40.0,0.0
32357,3,2357,[318 427  98 182 191],72,5,9471,4.016539440203562,40.0,0.0
32358,3,2358,[318 427  98 182 191],72,5,9476,4.016956337431115,40.0,0.0
32359,3,2359,[ 89 216 302  12 322],344,4,9480,4.016949152542373,0.0,0.0
32360,3,2360,[318 427  98 182 191],18,5,9485,4.0173655230834395,40.0,0.0
32361,3,2361,[318 427  98 182 191],18,5,9490,4.017781541066893,40.0,0.0
32362,3,2362,[318 427  98 182 191],72,5,9495,4.0181972069403304,40.0,0.0
32363,3,2363,[318 427  98 182 191],655,5,9500,4.018612521150592,40.0,0.0
32364,3,2364,[269 132 196 125 588],18,3,9503,4.0181818181818185,0.0,0.0
32365,3,2365,[318 427  98 182 191],72,5,9508,4.0185967878275575,40.0,0.0
32366,3,2366,[ 95 385 405 174 228],796,5,9513,4.019011406844107,0.0,0.0
32367,3,2367,[318 427  98 182 191],72,5,9518,4.019425675675675,40.0,0.0
32368,3,2368,[  7 127 288 302 483],655,3,9521,4.018995356690587,0.0,20.0
32369,3,2369,[215 271 294  95 269],796,3,9524,4.018565400843882,0.0,0.0
32370,3,2370,[235 202 183  22 483],716,3,9527,4.018135807676086,0.0,0.0
32371,3,2371,[135 191 435  98  64],236,4,9531,4.0181281618887015,20.0,0.0
32372,3,2372,[  8 216 237  69 204],457,5,9536,4.0185419300463545,0.0,0.0
32373,3,2373,[471 215  22 282 151],450,5,9541,4.018955349620893,0.0,0.0
32374,3,2374,[268  96 275   9 127],344,4,9545,4.018947368421053,0.0,40.0
32375,3,2375,[151 357  98 302 185],151,4,9549,4.018939393939394,0.0,0.0
32376,3,2376,[ 56  88  96 204  82],269,1,9550,4.017669331089609,0.0,0.0
32377,3,2377,[318 427  98 182 191],269,5,9555,4.018082422203532,40.0,0.0
32378,3,2378,[269 111 204 186  70],655,0,9555,4.016393442622951,0.0,0.0
32379,3,2379,[318 427  98 182 191],655,5,9560,4.016806722689076,40.0,0.0
32380,3,2380,[318 427  98 182 191],18,5,9565,4.017219655606888,40.0,0.0
32381,3,2381,[318 427  98 182 191],655,5,9570,4.017632241813602,40.0,0.0
32382,3,2382,[ 96 235 125   1 282],450,4,9574,4.017624842635334,0.0,0.0
32383,3,2383,[385 174 238  22 271],796,4,9578,4.01761744966443,0.0,0.0
32384,3,2384,[183  96 588 603 423],796,5,9583,4.018029350104822,20.0,0.0
32385,3,2385,[ 95 186 328 191 197],450,3,9586,4.017602682313496,0.0,0.0
32386,3,2386,[318 427  98 182 191],269,5,9591,4.018014243820695,40.0,0.0
32387,3,2387,[318 427  98 182 191],72,5,9596,4.018425460636516,40.0,0.0
32388,3,2388,[  4  11  12 187 183],450,4,9600,4.0184177480117205,0.0,0.0
32389,3,2389,[302 173   1  89 197],151,4,9604,4.018410041841004,0.0,0.0
32390,3,2390,[515 423  89 143 357],269,3,9607,4.017984107068172,0.0,0.0
32391,3,2391,[318 427  98 182 191],18,5,9612,4.018394648829432,40.0,0.0
32392,3,2392,[180 228 135  97   7],450,4,9616,4.0183869619724195,0.0,0.0
32393,3,2393,[318 427  98 182 191],450,5,9621,4.018796992481203,40.0,0.0
32394,3,2394,[ 11 197 202 496 151],269,3,9624,4.0183716075156575,20.0,0.0
32395,3,2395,[318 427  98 182 191],18,5,9629,4.018781302170284,40.0,0.0
32396,3,2396,[318 427  98 182 191],18,5,9634,4.019190654985398,40.0,0.0
32397,3,2397,[318 427  98 182 191],72,5,9639,4.0195996663886575,40.0,0.0
32398,3,2398,[204 588 655 121 186],796,3,9642,4.019174656106711,0.0,0.0
32399,3,2399,[117 222 234 423 100],796,3,9645,4.01875,0.0,20.0
32400,3,2400,[318 427  98 182 191],72,5,9650,4.019158683881716,40.0,0.0
32401,3,2401,[318 427  98 182 191],72,5,9655,4.019567027477103,40.0,0.0
32402,3,2402,[194 216 135 235 173],5,4,9659,4.019558884727424,0.0,0.0
32403,3,2403,[318 427  98 182 191],18,5,9664,4.019966722129784,40.0,0.0
32404,3,2404,[318 427  98 182 191],72,5,9669,4.0203742203742205,40.0,0.0
32405,3,2405,[318 427  98 182 191],450,5,9674,4.0207813798836245,40.0,0.0
32406,3,2406,[318 427  98 182 191],269,5,9679,4.021188201080183,40.0,0.0
32407,3,2407,[318 427  98 182 191],72,5,9684,4.0215946843853825,40.0,0.0
32408,3,2408,[318 427  98 182 191],450,5,9689,4.0220008302200085,40.0,0.0
32409,3,2409,[204 302   7 186 508],535,4,9693,4.021991701244813,0.0,0.0
32410,3,2410,[286 216 515  70  96],655,2,9695,4.021153048527582,0.0,20.0
32411,3,2411,[318 427  98 182 191],796,5,9700,4.021558872305141,40.0,0.0
32412,3,2412,[  1 471 181 427 111],655,1,9701,4.020306672192292,20.0,0.0
32413,3,2413,[318 427  98 182 191],269,5,9706,4.0207125103562555,40.0,0.0
32414,3,2414,[318 427  98 182 191],269,5,9711,4.02111801242236,40.0,0.0
32415,3,2415,[318 427  98 182 191],655,5,9716,4.021523178807947,40.0,0.0
32416,3,2416,[318 427  98 182 191],269,5,9721,4.021928009929665,40.0,0.0
32417,3,2417,[318 427  98 182 191],796,5,9726,4.022332506203474,40.0,0.0
32418,3,2418,[318 427  98 182 191],269,5,9731,4.022736668044646,40.0,0.0
32419,3,2419,[318 427  98 182 191],450,5,9736,4.023140495867769,40.0,0.0
32420,3,2420,[269  89 333 211 385],655,1,9737,4.021891780256093,0.0,0.0
32421,3,2421,[179 546  25 118  15],450,2,9739,4.021056977704377,0.0,0.0
32422,3,2422,[655 289 176  28 294],655,0,9739,4.019397441188609,0.0,0.0
32423,3,2423,[318 427  98 182 191],269,5,9744,4.01980198019802,40.0,0.0
32424,3,2424,[318 427  98 182 191],655,5,9749,4.020206185567011,40.0,0.0
32425,3,2425,[318 427  98 182 191],18,5,9754,4.020610057708161,40.0,0.0
32426,3,2426,[ 96 269 181 211  82],796,2,9756,4.019777503090235,0.0,0.0
32427,3,2427,[318 427  98 182 191],269,5,9761,4.020181219110379,40.0,0.0
32428,3,2428,[655 111 515 294  71],401,2,9763,4.019349526554137,0.0,0.0
32429,3,2429,[318 427  98 182 191],796,5,9768,4.019753086419753,40.0,0.0
32430,3,2430,[318 427  98 182 191],655,5,9773,4.020156314273962,40.0,0.0
32431,3,2431,[ 28 191 222 211   9],151,4,9777,4.020148026315789,0.0,0.0
32432,3,2432,[427  97 215 187 435],450,5,9782,4.020550760378134,20.0,0.0
32433,3,2433,[210 135  28  82  22],330,4,9786,4.020542317173377,0.0,0.0
32434,3,2434,[318 427  98 182 191],269,5,9791,4.020944558521561,40.0,0.0
32435,3,2435,[318 427  98 182 191],450,5,9796,4.0213464696223316,40.0,0.0
32436,3,2436,[318 427  98 182 191],796,5,9801,4.021748050882232,40.0,0.0
32437,3,2437,[427 333 168 216  15],796,5,9806,4.022149302707137,20.0,0.0
32438,3,2438,[318 427  98 182 191],655,5,9811,4.022550225502255,40.0,0.0
32439,3,2439,[318 427  98 182 191],269,5,9816,4.022950819672131,40.0,0.0
32440,3,2440,[318 427  98 182 191],655,5,9821,4.023351085620647,40.0,0.0
32441,3,2441,[318 427  98 182 191],18,5,9826,4.023751023751024,40.0,0.0
32442,3,2442,[318 427  98 182 191],18,5,9831,4.024150634465821,40.0,0.0
32443,3,2443,[318 427  98 182 191],269,5,9836,4.024549918166939,40.0,0.0
32444,3,2444,[318 427  98 182 191],450,5,9841,4.024948875255624,40.0,0.0
32445,3,2445,[  1   9 403 546 222],256,5,9846,4.025347506132461,0.0,0.0
32446,3,2446,[318 427  98 182 191],18,5,9851,4.0257458111973845,40.0,0.0
32447,3,2447,[318 427  98 182 191],655,5,9856,4.026143790849673,40.0,0.0
32448,3,2448,[125 222 603  64 111],655,2,9858,4.025316455696203,40.0,0.0
32449,3,2449,[318 427  98 182 191],796,5,9863,4.025714285714286,40.0,0.0
32450,3,2450,[179 423 202   4  28],504,3,9866,4.0252957976336186,0.0,0.0
32451,3,2451,[151 168 185   1 427],5,1,9867,4.024061990212072,20.0,0.0
32452,3,2452,[318 427  98 182 191],655,5,9872,4.024459845087648,40.0,0.0
32453,3,2453,[182 204 215 210   8],457,5,9877,4.024857375713122,0.0,0.0
32454,3,2454,[318 427  98 182 191],269,5,9882,4.025254582484725,40.0,0.0
32455,3,2455,[294 161 204 117 183],280,2,9884,4.02442996742671,0.0,0.0
32456,3,2456,[286  79 153  96 603],796,4,9888,4.024420024420024,20.0,20.0
32457,3,2457,[318 427  98 182 191],269,5,9893,4.024816924328722,40.0,0.0
32458,3,2458,[176 423  97 143 655],655,1,9894,4.02358682391216,0.0,0.0
32459,3,2459,[318 427  98 182 191],72,5,9899,4.023983739837399,40.0,0.0
32460,3,2460,[678 282  50 322 508],401,0,9899,4.02234863876473,0.0,20.0
32461,3,2461,[405 357  12  50 328],796,5,9904,4.022745735174655,0.0,20.0
32462,3,2462,[328 210 125 196 318],450,4,9908,4.022736500203004,20.0,0.0
32463,3,2463,[286 471 210 111 200],280,3,9911,4.022321428571429,0.0,20.0
32464,3,2464,[318 427  98 182 191],450,5,9916,4.022718052738337,40.0,0.0
32465,3,2465,[318 427  98 182 191],18,5,9921,4.023114355231144,40.0,0.0
32466,3,2466,[318 427  98 182 191],72,5,9926,4.023510336441022,40.0,0.0
32467,3,2467,[318 427  98 182 191],655,5,9931,4.023905996758509,40.0,0.0
32468,3,2468,[318 427  98 182 191],18,5,9936,4.024301336573512,40.0,0.0
32469,3,2469,[318 427  98 182 191],796,5,9941,4.024696356275304,40.0,0.0
32470,3,2470,[318 427  98 182 191],450,5,9946,4.0250910562525295,40.0,0.0
32471,3,2471,[318 427  98 182 191],655,5,9951,4.025485436893204,40.0,0.0
32472,3,2472,[318 427  98 182 191],72,5,9956,4.025879498584715,40.0,0.0
32473,3,2473,[318  89 742 196  64],655,3,9959,4.025464834276475,40.0,0.0
32474,3,2474,[318 427  98 182 191],655,5,9964,4.025858585858586,40.0,0.0
32475,3,2475,[216 174 318  71 238],18,5,9969,4.026252019386106,20.0,0.0
32476,3,2476,[173 423 496 196 216],389,2,9971,4.025433992733145,20.0,0.0
32477,3,2477,[318 427  98 182 191],796,5,9976,4.0258272800645685,40.0,0.0
32478,3,2478,[318 427  98 182 191],796,5,9981,4.026220250100847,40.0,0.0
32479,3,2479,[318 427  98 182 191],72,5,9986,4.026612903225806,40.0,0.0
32480,3,2480,[318 427  98 182 191],450,5,9991,4.027005239822652,40.0,0.0
32481,3,2481,[269 210 568 175 125],655,0,9991,4.025382755842063,0.0,0.0
32482,3,2482,[322 118  95 135  69],450,2,9993,4.024567055980668,0.0,0.0
32483,3,2483,[191   4 357  70   8],655,2,9995,4.023752012882448,0.0,0.0
32484,3,2484,[257 125 357 276 515],296,5,10000,4.0241448692152915,0.0,0.0
32485,3,2485,[403 282 678  82 182],280,0,10000,4.022526146419952,0.0,0.0
32486,3,2486,[153   9 117 273 135],655,2,10002,4.021712907117008,0.0,0.0
32487,3,2487,[216 111 265 196 258],450,5,10007,4.022106109324759,0.0,0.0
32488,3,2488,[100 328  98 222 200],796,4,10011,4.02209722780233,0.0,20.0
32489,3,2489,[318 427  98 182 191],796,5,10016,4.0224899598393575,40.0,0.0
32490,3,2490,[ 56 748 234 427 216],151,4,10020,4.02248093135287,20.0,0.0
32491,3,2491,[318 427  98 182 191],269,5,10025,4.022873194221509,40.0,0.0
32492,3,2492,[117 173 238   4 496],786,5,10030,4.023265142398716,20.0,0.0
32493,3,2493,[195  28 238 121  70],457,5,10035,4.0236567762630315,0.0,0.0
32494,3,2494,[  9   4 182 210 483],535,3,10038,4.023246492985972,0.0,0.0
32495,3,2495,[318 427  98 182 191],18,5,10043,4.02363782051282,40.0,0.0
32496,3,2496,[318 427  98 182 191],796,5,10048,4.024028834601522,40.0,0.0
32497,3,2497,[238 181  28 175 211],716,4,10052,4.024019215372298,0.0,0.0
32498,3,2498,[  7 211 268 475 187],655,1,10053,4.02280912364946,0.0,0.0
32499,3,2499,[222 173 118 183  96],280,1,10054,4.0216,0.0,0.0
32500,3,2500,[318 427  98 182 191],72,5,10059,4.021991203518593,40.0,0.0
32501,3,2501,[318 427  98 182 191],450,5,10064,4.0223820943245405,40.0,0.0
32502,3,2502,[318 427  98 182 191],796,5,10069,4.022772672792649,40.0,0.0
32503,3,2503,[ 70 175 200 180 655],716,3,10072,4.022364217252396,0.0,0.0
32504,3,2504,[318 427  98 182 191],796,5,10077,4.022754491017964,40.0,0.0
32505,3,2505,[588 357   7 471 289],786,5,10082,4.023144453312051,0.0,0.0
32506,3,2506,[318 427  98 182 191],655,5,10087,4.023534104507379,40.0,0.0
32507,3,2507,[172   1 168 121  96],716,4,10091,4.023524720893142,0.0,0.0
32508,3,2508,[176 300 403 323 135],756,2,10093,4.022718214428059,0.0,0.0
32509,3,2509,[245  95  89 403  69],796,4,10097,4.022709163346613,0.0,0.0
32510,3,2510,[318 427  98 182 191],18,5,10102,4.023098367184389,40.0,0.0
32511,3,2511,[318 427  98 182 191],796,5,10107,4.023487261146497,40.0,0.0
32512,3,2512,[318 427  98 182 191],796,5,10112,4.023875845602865,40.0,0.0
32513,3,2513,[318 427  98 182 191],269,5,10117,4.024264120922832,40.0,0.0
32514,3,2514,[179  64 197  88 302],269,3,10120,4.023856858846918,20.0,0.0
32515,3,2515,[318 427  98 182 191],796,5,10125,4.024244833068362,40.0,0.0
32516,3,2516,[ 12 234 185 183 435],655,2,10127,4.023440603893524,0.0,0.0
32517,3,2517,[318 427  98 182 191],269,5,10132,4.0238284352660845,40.0,0.0
32518,3,2518,[257  82 357 234 655],23,0,10132,4.022231044065105,0.0,0.0
32519,3,2519,[161 597 117 127 121],457,4,10136,4.022222222222222,0.0,20.0
32520,3,2520,[318 427  98 182 191],796,5,10141,4.022610075366918,40.0,0.0
32521,3,2521,[ 50   9 258 161  89],796,4,10145,4.022601110229976,0.0,20.0
32522,3,2522,[183 194 483  28  15],796,4,10149,4.0225921521997625,0.0,0.0
32523,3,2523,[195 135 111 328 471],450,4,10153,4.022583201267829,0.0,0.0
32524,3,2524,[318 427  98 182 191],655,5,10158,4.022970297029703,40.0,0.0
32525,3,2525,[318 427  98 182 191],450,5,10163,4.023357086302455,40.0,0.0
32526,3,2526,[132 435 294  95 196],450,4,10167,4.023347843292441,0.0,0.0
32527,3,2527,[191 216 238 423 328],655,2,10169,4.02254746835443,0.0,0.0
32528,3,2528,[294 597 173 195 245],796,3,10172,4.022143139580862,0.0,0.0
32529,3,2529,[435  15 111 483  71],236,4,10176,4.0221343873517785,0.0,0.0
32530,3,2530,[180 211 132 111   7],269,2,10178,4.021335440537337,0.0,0.0
32531,3,2531,[318 427  98 182 191],655,5,10183,4.021721958925751,40.0,0.0
32532,3,2532,[318 427  98 182 191],269,5,10188,4.022108172127911,40.0,0.0
32533,3,2533,[318 427  98 182 191],269,5,10193,4.022494080505131,40.0,0.0
32534,3,2534,[318 427  98 182 191],269,5,10198,4.022879684418146,40.0,0.0
32535,3,2535,[427 135 176 100 180],72,4,10202,4.0228706624605675,20.0,20.0
32536,3,2536,[483 135 200 655 111],450,2,10204,4.022073314938904,0.0,0.0
32537,3,2537,[318 427  98 182 191],655,5,10209,4.0224586288416075,40.0,0.0
32538,3,2538,[318 427  98 182 191],18,5,10214,4.022843639228043,40.0,0.0
32539,3,2539,[ 64  28 187 182 204],389,5,10219,4.023228346456693,20.0,0.0
32540,3,2540,[318 427  98 182 191],450,5,10224,4.023612750885478,40.0,0.0
32541,3,2541,[222 174 211 143 496],796,4,10228,4.02360346184107,20.0,0.0
32542,3,2542,[318 427  98 182 191],450,5,10233,4.023987416437278,40.0,0.0
32543,3,2543,[161 235 238 655 194],716,3,10236,4.023584905660377,0.0,0.0
32544,3,2544,[  1 204 385 153 568],280,3,10239,4.023182711198428,0.0,0.0
32545,3,2545,[ 64 196 546 117  89],450,5,10244,4.02356637863315,20.0,0.0
32546,3,2546,[318 427  98 182 191],72,5,10249,4.023949744797801,40.0,0.0
32547,3,2547,[318 427  98 182 191],72,5,10254,4.024332810047095,40.0,0.0
32548,3,2548,[318 427  98 182 191],655,5,10259,4.024715574735191,40.0,0.0
32549,3,2549,[ 82  64  11 257 183],655,2,10261,4.0239215686274505,20.0,0.0
32550,3,2550,[568  96 173 273  25],450,3,10264,4.0235201881615055,0.0,0.0
32551,3,2551,[318 427  98 182 191],18,5,10269,4.023902821316614,40.0,0.0
32552,3,2552,[  4 161 357 195  22],450,4,10273,4.023893458676067,0.0,0.0
32553,3,2553,[172 427 143 475 118],655,3,10276,4.023492560689115,20.0,0.0
32554,3,2554,[318 427  98 182 191],18,5,10281,4.0238747553816046,40.0,0.0
32555,3,2555,[ 70 301  64  12 153],655,1,10282,4.022691705790297,20.0,0.0
32556,3,2556,[742 323  56 118 161],796,3,10285,4.022291748142354,0.0,0.0
32557,3,2557,[ 50 357 289 603 135],655,4,10289,4.022283033620016,20.0,20.0
32558,3,2558,[318 427  98 182 191],18,5,10294,4.0226651035560765,40.0,0.0
32559,3,2559,[318 427  98 182 191],72,5,10299,4.023046875,40.0,0.0
32560,3,2560,[176 153 204 238   9],269,2,10301,4.022256930886373,0.0,0.0
32561,3,2561,[318 427  98 182 191],18,5,10306,4.02263856362217,40.0,0.0
32562,3,2562,[161 111   9 234 173],269,1,10307,4.021459227467811,0.0,0.0
32563,3,2563,[318 427  98 182 191],796,5,10312,4.021840873634946,40.0,0.0
32564,3,2564,[268 211 175 216   8],655,1,10313,4.0206627680311895,0.0,0.0
32565,3,2565,[ 15 228   9 238 405],655,0,10313,4.019095869056898,0.0,0.0
32566,3,2566,[135 269 403 196 215],450,4,10317,4.019088430074016,0.0,0.0
32567,3,2567,[483 234  71 269 275],18,4,10321,4.019080996884735,0.0,20.0
32568,3,2568,[318 427  98 182 191],450,5,10326,4.019462826002336,40.0,0.0
32569,3,2569,[258 174 276   8 143],457,5,10331,4.019844357976654,0.0,0.0
32570,3,2570,[318 427  98 182 191],18,5,10336,4.020225593154414,40.0,0.0
32571,3,2571,[117 678 151 357 173],344,3,10339,4.019828926905133,0.0,0.0
32572,3,2572,[318 427  98 182 191],72,5,10344,4.0202098717450445,40.0,0.0
32573,3,2573,[  4 228  50  56  70],655,1,10345,4.019036519036519,0.0,20.0
32574,3,2574,[318 427  98 182 191],72,5,10350,4.019417475728155,40.0,0.0
32575,3,2575,[318 427  98 182 191],269,5,10355,4.019798136645963,40.0,0.0
32576,3,2576,[423 204 117 179 216],236,2,10357,4.019014357780365,0.0,0.0
32577,3,2577,[318 427  98 182 191],450,5,10362,4.019394879751745,40.0,0.0
32578,3,2578,[  4   1  56 179  50],655,2,10364,4.018611865063979,0.0,20.0
32579,3,2579,[318 427  98 182 191],72,5,10369,4.018992248062015,40.0,0.0
32580,3,2580,[313 195  28 179  71],236,2,10371,4.018209996125533,0.0,0.0
32581,3,2581,[168 235  11  88 318],450,4,10375,4.018202943454686,20.0,0.0
32582,3,2582,[ 64  97   1 197 655],655,1,10376,4.0170344560588465,20.0,0.0
32583,3,2583,[318 427  98 182 191],796,5,10381,4.017414860681114,40.0,0.0
32584,3,2584,[318 427  98 182 191],450,5,10386,4.01779497098646,40.0,0.0
32585,3,2585,[318 427  98 182 191],450,5,10391,4.018174787316319,40.0,0.0
32586,3,2586,[318 427  98 182 191],655,5,10396,4.018554310011597,40.0,0.0
32587,3,2587,[318 427  98 182 191],796,5,10401,4.018933539412674,40.0,0.0
32588,3,2588,[180 435 182   8 276],321,3,10404,4.018539976825029,0.0,0.0
32589,3,2589,[ 89  15 153 161   7],450,4,10408,4.018532818532819,0.0,0.0
32590,3,2590,[318 427  98 182 191],72,5,10413,4.018911617136241,40.0,0.0
32591,3,2591,[318 427  98 182 191],72,5,10418,4.01929012345679,40.0,0.0
32592,3,2592,[257 678 300 161 211],504,5,10423,4.019668337832626,0.0,0.0
32593,3,2593,[  1 385 135 258 405],450,4,10427,4.019660755589823,0.0,0.0
32594,3,2594,[475 435 216 423 234],389,4,10431,4.019653179190751,0.0,0.0
32595,3,2595,[ 88  11  25 483 174],716,5,10436,4.020030816640986,0.0,0.0
32596,3,2596,[318 427  98 182 191],18,5,10441,4.020408163265306,40.0,0.0
32597,3,2597,[318 427  98 182 191],269,5,10446,4.020785219399538,40.0,0.0
32598,3,2598,[427 475 268 357 289],655,2,10448,4.02000769526741,20.0,0.0
32599,3,2599,[318 427  98 182 191],450,5,10453,4.020384615384615,40.0,0.0
32600,3,2600,[318 427  98 182 191],72,5,10458,4.02076124567474,40.0,0.0
32601,3,2601,[318 427  98 182 191],18,5,10463,4.021137586471944,40.0,0.0
32602,3,2602,[ 97 183 143 100  56],593,5,10468,4.021513638109873,0.0,20.0
32603,3,2603,[294 197  56 172  98],629,4,10472,4.021505376344086,0.0,0.0
32604,3,2604,[318 427  98 182 191],18,5,10477,4.021880998080614,40.0,0.0
32605,3,2605,[197 143  97 202 282],457,5,10482,4.022256331542594,0.0,0.0
32606,3,2606,[318 427  98 182 191],796,5,10487,4.0226313770617566,40.0,0.0
32607,3,2607,[194   9  96 202 257],457,4,10491,4.022622699386503,0.0,0.0
32608,3,2608,[234 168 357  28 135],450,3,10494,4.022230739747029,0.0,0.0
32609,3,2609,[  7 385 153 215 568],655,0,10494,4.020689655172414,0.0,0.0
32610,3,2610,[222 132 258 234 269],655,0,10494,4.019149751053236,0.0,0.0
32611,3,2611,[588 181 294 546 235],280,3,10497,4.0187595712098005,0.0,0.0
32612,3,2612,[  4 237 117 322 186],796,3,10500,4.018369690011481,0.0,0.0
32613,3,2613,[ 12  96  88  98 603],796,5,10505,4.018745218056618,20.0,0.0
32614,3,2614,[318 427  98 182 191],655,5,10510,4.019120458891013,40.0,0.0
32615,3,2615,[135 603  69   4 173],151,5,10515,4.019495412844036,20.0,0.0
32616,3,2616,[318 427  98 182 191],18,5,10520,4.019870080244555,40.0,0.0
32617,3,2617,[210 196 127 427 385],450,4,10524,4.019862490450726,20.0,20.0
32618,3,2618,[318 427  98 182 191],796,5,10529,4.020236731576937,40.0,0.0
32619,3,2619,[ 88 322 161 185 197],450,5,10534,4.0206106870229,0.0,0.0
32620,3,2620,[172 318 423  89 202],796,5,10539,4.020984357115605,20.0,0.0
32621,3,2621,[ 50 222 288 385  79],655,2,10541,4.020213577421815,0.0,20.0
32622,3,2622,[318 427  98 182 191],72,5,10546,4.0205871139916125,40.0,0.0
32623,3,2623,[318 427  98 182 191],269,5,10551,4.020960365853658,40.0,0.0
32624,3,2624,[318 427  98 182 191],655,5,10556,4.021333333333334,40.0,0.0
32625,3,2625,[318 427  98 182 191],796,5,10561,4.021706016755521,40.0,0.0
32626,3,2626,[179 258 603 100 210],655,2,10563,4.020936429387134,20.0,20.0
32627,3,2627,[211 228 121 546 210],807,5,10568,4.02130898021309,0.0,0.0
32628,3,2628,[ 22 322 191 269 271],796,3,10571,4.02092050209205,0.0,0.0
32629,3,2629,[405 197 111 471 423],716,4,10575,4.020912547528517,0.0,0.0
32630,3,2630,[427 403 245  12 202],796,4,10579,4.020904599011782,20.0,0.0
32631,3,2631,[318 427  98 182 191],450,5,10584,4.0212765957446805,40.0,0.0
32632,3,2632,[318 427  98 182 191],796,5,10589,4.021648309912647,40.0,0.0
32633,3,2633,[318 427  98 182 191],796,5,10594,4.02201974183751,40.0,0.0
32634,3,2634,[ 56 265 121 197   1],716,5,10599,4.022390891840607,0.0,0.0
32635,3,2635,[568 257 237 183 357],716,4,10603,4.022382397572079,0.0,0.0
32636,3,2636,[200 603 175 186 222],716,3,10606,4.021994690936671,20.0,0.0
32637,3,2637,[ 96 161 210 125 234],280,2,10608,4.02122820318423,0.0,0.0
32638,3,2638,[318 427  98 182 191],450,5,10613,4.0215990905646075,40.0,0.0
32639,3,2639,[210 300 508 132 301],535,4,10617,4.021590909090909,0.0,0.0
32640,3,2640,[ 12 204 132  88 216],280,3,10620,4.021204089360091,0.0,0.0
32641,3,2641,[210 180 302  69 603],269,1,10621,4.020060560181681,20.0,0.0
32642,3,2642,[194 333  22 655  96],796,4,10625,4.020052970109724,0.0,0.0
32643,3,2643,[423 234   4  28 302],655,1,10626,4.018910741301059,0.0,0.0
32644,3,2644,[202  89 215 200 191],655,3,10629,4.0185255198487715,0.0,0.0
32645,3,2645,[318 427  98 182 191],655,5,10634,4.018896447467876,40.0,0.0
32646,3,2646,[191  12 568 117 172],72,4,10638,4.018889308651303,0.0,0.0
32647,3,2647,[318 427  98 182 191],269,5,10643,4.0192598187311175,40.0,0.0
32648,3,2648,[286 185 588 202  56],450,5,10648,4.019630049075123,0.0,20.0
32649,3,2649,[603  97 173 153  69],151,4,10652,4.019622641509434,20.0,0.0
32650,3,2650,[318 427  98 182 191],269,5,10657,4.019992455677103,40.0,0.0
32651,3,2651,[135  50 100 403 405],450,4,10661,4.0199849170437405,0.0,40.0
32652,3,2652,[318 427  98 182 191],72,5,10666,4.020354315868827,40.0,0.0
32653,3,2653,[ 70 318 196 181 357],655,2,10668,4.019593067068576,20.0,0.0
32654,3,2654,[318 427  98 182 191],450,5,10673,4.019962335216572,40.0,0.0
32655,3,2655,[318 427  98 182 191],796,5,10678,4.020331325301205,40.0,0.0
32656,3,2656,[ 96 496 151 173 117],344,4,10682,4.02032367331577,20.0,0.0
32657,3,2657,[318 427  98 182 191],72,5,10687,4.020692249811889,40.0,0.0
32658,3,2658,[ 97 300 294 271 269],655,0,10687,4.0191801429108684,0.0,0.0
32659,3,2659,[234 144 180 405 132],796,3,10690,4.018796992481203,0.0,0.0
32660,3,2660,[318 427  98 182 191],450,5,10695,4.019165727170237,40.0,0.0
32661,3,2661,[318 427  98 182 191],72,5,10700,4.019534184823441,40.0,0.0
32662,3,2662,[ 95 121 357  15 173],796,5,10705,4.01990236575291,0.0,0.0
32663,3,2663,[423 195 258 161 294],796,4,10709,4.019894894894895,0.0,0.0
32664,3,2664,[318 427  98 182 191],450,5,10714,4.020262664165103,40.0,0.0
32665,3,2665,[318 427  98 182 191],72,5,10719,4.020630157539385,40.0,0.0
32666,3,2666,[273 204  15 258 357],796,4,10723,4.020622422197225,0.0,0.0
32667,3,2667,[318 427  98 182 191],450,5,10728,4.0209895052473765,40.0,0.0
32668,3,2668,[173 435  25  97 135],716,4,10732,4.020981641064069,0.0,0.0
32669,3,2669,[385 313 294 265  95],280,3,10735,4.020599250936329,0.0,0.0
32670,3,2670,[245 176 300 211  96],796,3,10738,4.020217147135904,0.0,0.0
32671,3,2671,[ 28 132 357  50  79],450,5,10743,4.020583832335329,0.0,20.0
32672,3,2672,[318 427  98 182 191],796,5,10748,4.020950243172465,40.0,0.0
32673,3,2673,[187 313 423 191   7],655,3,10751,4.020568436798803,0.0,0.0
32674,3,2674,[318 427  98 182 191],18,5,10756,4.020934579439253,40.0,0.0
32675,3,2675,[288 546 678 403 318],504,4,10760,4.0209267563527655,20.0,0.0
32676,3,2676,[318 427  98 182 191],18,5,10765,4.021292491595069,40.0,0.0
32677,3,2677,[318 427  98 182 191],18,5,10770,4.0216579536967885,40.0,0.0
32678,3,2678,[318 427  98 182 191],18,5,10775,4.022023142963793,40.0,0.0
32679,3,2679,[ 70 286  96 125 427],450,5,10780,4.022388059701493,20.0,20.0
32680,3,2680,[196  69 475 483 161],655,1,10781,4.0212607236105935,0.0,0.0
32681,3,2681,[318 427  98 182 191],18,5,10786,4.021625652498136,40.0,0.0
32682,3,2682,[318 427  98 182 191],655,5,10791,4.021990309355199,40.0,0.0
32683,3,2683,[186 603 202 515   7],269,2,10793,4.02123695976155,20.0,0.0
32684,3,2684,[318 427  98 182 191],72,5,10798,4.021601489757915,40.0,0.0
32685,3,2685,[318 427  98 182 191],796,5,10803,4.0219657483246465,40.0,0.0
32686,3,2686,[423 161  98 245 238],796,3,10806,4.0215854112393,0.0,0.0
32687,3,2687,[286   7 173 151 385],151,4,10810,4.021577380952381,0.0,20.0
32688,3,2688,[121 181 118 168 294],450,3,10813,4.021197471178877,0.0,0.0
32689,3,2689,[318 427  98 182 191],450,5,10818,4.021561338289962,40.0,0.0
32690,3,2690,[318 427  98 182 191],72,5,10823,4.021924934968413,40.0,0.0
32691,3,2691,[318 427  98 182 191],72,5,10828,4.022288261515602,40.0,0.0
32692,3,2692,[191 195 318 125 180],786,5,10833,4.022651318232454,20.0,0.0
32693,3,2693,[182 294 211 183   8],655,2,10835,4.021900519673348,0.0,0.0
32694,3,2694,[  4 121 100 294 143],450,3,10838,4.0215213358070505,0.0,20.0
32695,3,2695,[318 427  98 182 191],796,5,10843,4.021884272997033,40.0,0.0
32696,3,2696,[318 427  98 182 191],269,5,10848,4.022246941045606,40.0,0.0
32697,3,2697,[546 748 168 222 180],796,4,10852,4.022238695329874,0.0,0.0
32698,3,2698,[  7 357 185 235 204],457,4,10856,4.022230455724342,0.0,0.0
32699,3,2699,[318 427  98 182 191],269,5,10861,4.022592592592592,40.0,0.0
32700,3,2700,[357 237 294 546 275],457,3,10864,4.022213994816735,0.0,20.0
32701,3,2701,[ 56 302 125 183 289],655,2,10866,4.021465581051073,0.0,0.0
32702,3,2702,[183 405 276 427 357],655,4,10870,4.021457639659637,20.0,0.0
32703,3,2703,[322 357  89 168 143],796,4,10874,4.021449704142012,0.0,0.0
32704,3,2704,[191 275  22 678 357],344,3,10877,4.021072088724584,0.0,20.0
32705,3,2705,[318 427  98 182 191],655,5,10882,4.021433850702143,40.0,0.0
32706,3,2706,[182 195 179 180 215],535,4,10886,4.021425932766901,0.0,0.0
32707,3,2707,[118  97 132  15 204],151,4,10890,4.0214180206794685,0.0,0.0
32708,3,2708,[318 427  98 191 182],655,5,10895,4.021779254337394,40.0,0.0
32709,3,2709,[742  95  96   1 385],577,5,10900,4.022140221402214,0.0,0.0
32710,3,2710,[748 269 403 265  82],796,3,10903,4.021763187015861,0.0,0.0
32711,3,2711,[318 427  98 191 182],269,5,10908,4.022123893805309,40.0,0.0
32712,3,2712,[  4 127 182 282 235],457,4,10912,4.022115739034279,0.0,20.0
32713,3,2713,[318 427  98 191 182],72,5,10917,4.022476050110538,40.0,0.0
32714,3,2714,[423 328 273 174 195],796,4,10921,4.022467771639042,0.0,0.0
32715,3,2715,[ 50 185 427  56 322],796,4,10925,4.022459499263623,20.0,20.0
32716,3,2716,[318 427  98 191 182],18,5,10930,4.022819285977181,40.0,0.0
32717,3,2717,[318 427  98 191 182],450,5,10935,4.02317880794702,40.0,0.0
32718,3,2718,[318 427  98 191 182],18,5,10940,4.023538065465244,40.0,0.0
32719,3,2719,[318 427  98 191 182],796,5,10945,4.023897058823529,40.0,0.0
32720,3,2720,[300 174 183 111 234],796,4,10949,4.023888276368982,0.0,0.0
32721,3,2721,[ 70 294 185 655 471],716,4,10953,4.023879500367377,0.0,0.0
32722,3,2722,[ 56 216 257 328 515],655,2,10955,4.023136246786632,0.0,0.0
32723,3,2723,[318 427  98 191 182],450,5,10960,4.023494860499266,40.0,0.0
32724,3,2724,[318 427  98 191 182],18,5,10965,4.0238532110091745,40.0,0.0
32725,3,2725,[172 216 185 174 100],5,3,10968,4.023477622890682,0.0,20.0
32726,3,2726,[515 197 182 210 301],535,3,10971,4.023102310231023,0.0,0.0
32727,3,2727,[328 275 196 603 318],450,5,10976,4.023460410557185,40.0,20.0
32728,3,2728,[216  79 196 132 302],450,5,10981,4.023818248442653,0.0,0.0
32729,3,2729,[318 403 200 127 546],796,5,10986,4.024175824175824,20.0,20.0
32730,3,2730,[204  64 328   1 588],796,4,10990,4.0241669718052,20.0,0.0
32731,3,2731,[195 196 153 174 405],885,3,10993,4.023792093704246,0.0,0.0
32732,3,2732,[318 427  98 191 182],18,5,10998,4.0241492864983535,40.0,0.0
32733,3,2733,[318 427  98 191 182],72,5,11003,4.024506217995611,40.0,0.0
32734,3,2734,[318 427  98 191 182],450,5,11008,4.024862888482633,40.0,0.0
32735,3,2735,[118 235 228 151 181],716,3,11011,4.024488304093567,0.0,0.0
32736,3,2736,[204 161 144 210 222],457,5,11016,4.024844720496894,0.0,0.0
32737,3,2737,[318 427  98 191 182],18,5,11021,4.025200876552228,40.0,0.0
32738,3,2738,[318 427  98 191 182],18,5,11026,4.025556772544724,40.0,0.0
32739,3,2739,[172 403 132  69 435],269,1,11027,4.024452554744525,0.0,0.0
32740,3,2740,[237 275 183 144 118],450,4,11031,4.024443633710325,0.0,20.0
32741,3,2741,[  1  22 222 228 185],716,5,11036,4.024799416484318,0.0,0.0
32742,3,2742,[313  97 273 127 301],655,3,11039,4.024425811155669,0.0,20.0
32743,3,2743,[185 568 172  25 174],256,4,11043,4.024416909620991,0.0,0.0
32744,3,2744,[318 427  98 191 182],72,5,11048,4.0247723132969035,40.0,0.0
32745,3,2745,[294 322  56 603 313],450,5,11053,4.025127458120903,20.0,0.0
32746,3,2746,[186 196 210   1  96],796,2,11055,4.024390243902439,0.0,0.0
32747,3,2747,[318 427  98 191 182],18,5,11060,4.024745269286754,40.0,0.0
32748,3,2748,[  4 135  28 111 100],389,3,11063,4.024372499090578,0.0,20.0
32749,3,2749,[288 403 182 111   8],655,1,11064,4.023272727272727,0.0,0.0
32750,3,2750,[318 427  98 191 182],18,5,11069,4.023627771719375,40.0,0.0
32751,3,2751,[153 168 182 268  56],269,4,11073,4.023619186046512,0.0,0.0
32752,3,2752,[318 427  98 191 182],18,5,11078,4.023973846712677,40.0,0.0
32753,3,2753,[176 475 515 273 200],655,3,11081,4.023602033405955,0.0,0.0
32754,3,2754,[427 245 313 742 185],450,5,11086,4.023956442831216,20.0,0.0
32755,3,2755,[318 427  98 191 182],269,5,11091,4.024310595065312,40.0,0.0
32756,3,2756,[211   4 172 176 273],655,2,11093,4.023576351106275,0.0,0.0
32757,3,2757,[176 197 427  98 483],389,5,11098,4.0239303843364755,20.0,0.0
32758,3,2758,[655   9 271 191 265],629,4,11102,4.02392171076477,0.0,0.0
32759,3,2759,[318 427  98 191 182],655,5,11107,4.024275362318841,40.0,0.0
32760,3,2760,[118 180 125 235 222],450,2,11109,4.023542194856936,0.0,0.0
32761,3,2761,[318 427  98 191 182],269,5,11114,4.023895727733526,40.0,0.0
32762,3,2762,[318 427  98 191 182],450,5,11119,4.02424900470503,40.0,0.0
32763,3,2763,[238 234 179 172 215],450,4,11123,4.024240231548481,0.0,0.0
32764,3,2764,[318 427  98 191 182],18,5,11128,4.024593128390597,40.0,0.0
32765,3,2765,[318 427  98 191 182],655,5,11133,4.0249457700650755,40.0,0.0
32766,3,2766,[318 427  98 191 182],269,5,11138,4.025298156848573,40.0,0.0
32767,3,2767,[ 88 181 423 258 151],450,5,11143,4.025650289017341,0.0,0.0
32768,3,2768,[318 427  98 191 182],796,5,11148,4.026002166847237,40.0,0.0
32769,3,2769,[318 427  98 191 182],796,5,11153,4.026353790613719,40.0,0.0
32770,3,2770,[179  82 176 286 186],450,3,11156,4.025983399494767,0.0,20.0
32771,3,2771,[318 427  98 191 182],18,5,11161,4.026334776334776,40.0,0.0
32772,3,2772,[118 222 265 202  79],716,4,11165,4.026325279480707,0.0,0.0
32773,3,2773,[655  56 245  69 181],280,2,11167,4.025594808940158,0.0,0.0
32774,3,2774,[318 427  98 191 182],18,5,11172,4.025945945945946,40.0,0.0
32775,3,2775,[318 427  98 191 182],18,5,11177,4.026296829971182,40.0,0.0
32776,3,2776,[588 197  69 135  82],716,4,11181,4.0262873604609295,0.0,0.0
32777,3,2777,[318 427  98 191 182],18,5,11186,4.026637868970482,40.0,0.0
32778,3,2778,[318 427  98 191 182],450,5,11191,4.026988125224901,40.0,0.0
32779,3,2779,[318 427  98 191 182],450,5,11196,4.027338129496403,40.0,0.0
32780,3,2780,[  4 215  56  25 216],577,4,11200,4.027328299172959,0.0,0.0
32781,3,2781,[333   9 265 483  98],796,4,11204,4.027318475916607,0.0,0.0
32782,3,2782,[318 427  98 191 182],18,5,11209,4.027667984189724,40.0,0.0
32783,3,2783,[182  15 175 185 238],269,4,11213,4.027658045977011,0.0,0.0
32784,3,2784,[588  50 322 125 174],450,5,11218,4.028007181328546,0.0,20.0
32785,3,2785,[318 427  98 191 182],269,5,11223,4.028356066044508,40.0,0.0
32786,3,2786,[161 173 245 222 100],796,3,11226,4.027987082884822,0.0,20.0
32787,3,2787,[179 403 200 655 195],655,2,11228,4.02725968436155,0.0,0.0
32788,3,2788,[471 215 423 168 269],535,5,11233,4.02760846181427,0.0,0.0
32789,3,2789,[318 427  98 191 182],72,5,11238,4.027956989247312,40.0,0.0
32790,3,2790,[318 427  98 191 182],655,5,11243,4.028305266929416,40.0,0.0
32791,3,2791,[318 427  98 191 182],450,5,11248,4.02865329512894,40.0,0.0
32792,3,2792,[135 471 268 423  79],655,2,11250,4.027926960257787,0.0,0.0
32793,3,2793,[318 427  98 191 182],72,5,11255,4.028274874731568,40.0,0.0
32794,3,2794,[318 427  98 191 182],18,5,11260,4.028622540250447,40.0,0.0
32795,3,2795,[515 215  89 288 191],655,3,11263,4.028254649499285,0.0,0.0
32796,3,2796,[ 22 100 121 238 435],11,3,11266,4.027887021809081,0.0,20.0
32797,3,2797,[318 427  98 191 182],72,5,11271,4.028234453180843,40.0,0.0
32798,3,2798,[318 427  98 191 182],796,5,11276,4.028581636298678,40.0,0.0
32799,3,2799,[427 183 655 135 237],655,3,11279,4.028214285714285,20.0,0.0
32800,3,2800,[318 427  98 191 182],72,5,11284,4.028561228132809,40.0,0.0
32801,3,2801,[323  22 313 588 195],796,4,11288,4.028551034975018,0.0,0.0
32802,3,2802,[318 427  98 191 182],796,5,11293,4.028897609703889,40.0,0.0
32803,3,2803,[318 427  98 191 182],269,5,11298,4.029243937232525,40.0,0.0
32804,3,2804,[144 288 181 186 127],693,2,11300,4.028520499108734,0.0,20.0
32805,3,2805,[318 427  98 191 182],269,5,11305,4.028866714183891,40.0,0.0
32806,3,2806,[318 427  98 191 182],796,5,11310,4.029212682579266,40.0,0.0
32807,3,2807,[258 357 200   7 183],655,3,11313,4.028846153846154,0.0,0.0
32808,3,2808,[318 427  98 191 182],655,5,11318,4.029191883232467,40.0,0.0
32809,3,2809,[318 427  98 191 182],655,5,11323,4.029537366548043,40.0,0.0
32810,3,2810,[222 132 216 195 405],280,2,11325,4.028815368196371,0.0,0.0
32811,3,2811,[318 427  98 191 182],450,5,11330,4.029160739687056,40.0,0.0
32812,3,2812,[294  97 194 748 173],401,2,11332,4.028439388553146,0.0,0.0
32813,3,2813,[318 427  98 191 182],450,5,11337,4.028784648187633,40.0,0.0
32814,3,2814,[271 385 275 238  56],655,1,11338,4.027708703374778,0.0,20.0
32815,3,2815,[318 427  98 191 182],655,5,11343,4.0280539772727275,40.0,0.0
32816,3,2816,[318 427  98 191 182],450,5,11348,4.028399006034789,40.0,0.0
32817,3,2817,[174 275 176 258 588],344,4,11352,4.028388928317956,0.0,20.0
32818,3,2818,[  9 175 435 385 100],655,0,11352,4.0269599148634265,0.0,20.0
32819,3,2819,[121 300 275 200  28],796,4,11356,4.026950354609929,0.0,20.0
32820,3,2820,[318 427  98 191 182],72,5,11361,4.027295285359801,40.0,0.0
32821,3,2821,[318 427  98 191 182],655,5,11366,4.027639971651311,40.0,0.0
32822,3,2822,[318 427  98 191 182],269,5,11371,4.027984413744243,40.0,0.0
32823,3,2823,[318 427  98 191 182],269,5,11376,4.028328611898017,40.0,0.0
32824,3,2824,[172 427 135 268 200],655,4,11380,4.028318584070797,20.0,0.0
32825,3,2825,[318 427  98 191 182],450,5,11385,4.028662420382165,40.0,0.0
32826,3,2826,[121 222 742 204   1],655,0,11385,4.027237354085603,0.0,0.0
32827,3,2827,[318 427  98 191 182],450,5,11390,4.027581329561528,40.0,0.0
32828,3,2828,[318 427  98 191 182],18,5,11395,4.027925061859314,40.0,0.0
32829,3,2829,[318 427  98 191 182],18,5,11400,4.028268551236749,40.0,0.0
32830,3,2830,[318 427  98 191 182],796,5,11405,4.028611797951254,40.0,0.0
32831,3,2831,[318 427  98 191 182],450,5,11410,4.028954802259887,40.0,0.0
32832,3,2832,[546 234 125 186 228],577,2,11412,4.028238616307801,0.0,0.0
32833,3,2833,[318 427  98 191 182],450,5,11417,4.028581510232886,40.0,0.0
32834,3,2834,[318 427  98 191 182],450,5,11422,4.028924162257495,40.0,0.0
32835,3,2835,[318 427  98 191 182],655,5,11427,4.029266572637518,40.0,0.0
32836,3,2836,[191 100 153 181 211],269,3,11430,4.028903771589707,0.0,20.0
32837,3,2837,[132 603  79 153 475],389,4,11434,4.028893587033122,20.0,0.0
32838,3,2838,[318 427  98 191 182],796,5,11439,4.02923564635435,40.0,0.0
32839,3,2839,[197 186  82 181 187],655,1,11440,4.028169014084507,0.0,0.0
32840,3,2840,[318 427  98 191 182],18,5,11445,4.028511087645195,40.0,0.0
32841,3,2841,[ 56 202 118 210 186],716,3,11448,4.028149190710767,0.0,0.0
32842,3,2842,[ 25 143  28 300 288],450,3,11451,4.027787548364404,0.0,0.0
32843,3,2843,[ 88 275 100 215 222],450,4,11455,4.027777777777778,0.0,40.0
32844,3,2844,[603 153 271  64 742],796,4,11459,4.027768014059754,40.0,0.0
32845,3,2845,[318 427  98 191 182],450,5,11464,4.028109627547435,40.0,0.0
32846,3,2846,[181 323 228 423 118],756,1,11465,4.027046013347383,0.0,0.0
32847,3,2847,[118 144 318 210   9],655,1,11466,4.025983146067416,20.0,0.0
32848,3,2848,[318 427  98 191 182],796,5,11471,4.0263250263250265,40.0,0.0
32849,3,2849,[183 258 204 196 197],450,5,11476,4.026666666666666,0.0,0.0
32850,3,2850,[318 427  98 191 182],269,5,11481,4.027008067344791,40.0,0.0
32851,3,2851,[318 427  98 191 182],655,5,11486,4.0273492286115005,40.0,0.0
32852,3,2852,[318 427  98 191 182],796,5,11491,4.027690150718542,40.0,0.0
32853,3,2853,[318 427  98 191 182],269,5,11496,4.028030833917309,40.0,0.0
32854,3,2854,[515 151 289 300  22],807,5,11501,4.028371278458844,0.0,0.0
32855,3,2855,[168 125 100 282  95],796,4,11505,4.0283613445378155,0.0,20.0
32856,3,2856,[ 71 508 117 678 435],401,1,11506,4.027301365068253,0.0,0.0
32857,3,2857,[318 427  98 191 182],655,5,11511,4.027641707487754,40.0,0.0
32858,3,2858,[318 427  98 191 182],655,5,11516,4.027981811822316,40.0,0.0
32859,3,2859,[183 742 300 179 176],504,2,11518,4.027272727272727,0.0,0.0
32860,3,2860,[483 183 237 202  69],716,4,11522,4.027263194687173,0.0,0.0
32861,3,2861,[318 427  98 191 182],18,5,11527,4.027603074772886,40.0,0.0
32862,3,2862,[143 322 211 100 185],796,2,11529,4.026894865525672,0.0,20.0
32863,3,2863,[318 427  98 191 182],796,5,11534,4.027234636871508,40.0,0.0
32864,3,2864,[318 427  98 191 182],655,5,11539,4.027574171029668,40.0,0.0
32865,3,2865,[318 427  98 191 182],655,5,11544,4.02791346824843,40.0,0.0
32866,3,2866,[318 427  98 191 182],655,5,11549,4.028252528775724,40.0,0.0
32867,3,2867,[  4 202 132 322 405],450,4,11553,4.0282426778242675,0.0,0.0
32868,3,2868,[328 588 742 496  97],450,5,11558,4.028581387242942,20.0,0.0
32869,3,2869,[318 427  98 191 182],796,5,11563,4.028919860627178,40.0,0.0
32870,3,2870,[302 210 194 176  12],151,3,11566,4.028561476837339,0.0,0.0
32871,3,2871,[318 427  98 191 182],72,5,11571,4.028899721448468,40.0,0.0
32872,3,2872,[328 144   7 200 237],450,4,11575,4.0288896623738255,0.0,0.0
32873,3,2873,[318 427  98 191 182],269,5,11580,4.029227557411273,40.0,0.0
32874,3,2874,[328 748 588 176 322],796,4,11584,4.029217391304348,0.0,0.0
32875,3,2875,[ 89 100  70 151 275],23,3,11587,4.028859527121002,0.0,40.0
32876,3,2876,[318 427  98 191 182],796,5,11592,4.029197080291971,40.0,0.0
32877,3,2877,[216 228 153 117 405],280,3,11595,4.028839471855455,0.0,0.0
32878,3,2878,[318 427  98 191 182],269,5,11600,4.029176797499131,40.0,0.0
32879,3,2879,[471 187 174 288  98],693,2,11602,4.028472222222222,0.0,0.0
32880,3,2880,[228 174  15  64 222],655,1,11603,4.027421034363068,20.0,0.0
32881,3,2881,[318 427  98 191 182],72,5,11608,4.027758501040943,40.0,0.0
32882,3,2882,[318 127 144 117 121],807,4,11612,4.0277488727020465,20.0,20.0
32883,3,2883,[357 301 282 211 127],450,5,11617,4.028085991678225,0.0,20.0
32884,3,2884,[403 328 238   9 215],655,0,11617,4.026689774696707,0.0,0.0
32885,3,2885,[318 427  98 191 182],18,5,11622,4.027027027027027,40.0,0.0
32886,3,2886,[ 88 117   7 546  97],577,2,11624,4.026324904745411,0.0,0.0
32887,3,2887,[ 70 234 197 143 483],716,5,11629,4.026662049861496,0.0,0.0
32888,3,2888,[216 200  82  96 168],796,4,11633,4.026652821045344,0.0,0.0
32889,3,2889,[318 427  98 191 182],796,5,11638,4.026989619377162,40.0,0.0
32890,3,2890,[318 427  98 191 182],796,5,11643,4.027326184711173,40.0,0.0
32891,3,2891,[655 135 173 100 234],450,3,11646,4.026970954356846,0.0,20.0
32892,3,2892,[200 423 151 508 276],269,5,11651,4.027307293466989,0.0,0.0
32893,3,2893,[318 427  98 191 182],655,5,11656,4.027643400138217,40.0,0.0
32894,3,2894,[ 96  98 748 282  97],256,4,11660,4.027633851468049,0.0,0.0
32895,3,2895,[132  64 603 403 258],655,2,11662,4.026933701657459,40.0,0.0
32896,3,2896,[318 427  98 191 182],450,5,11667,4.027269589230238,40.0,0.0
32897,3,2897,[318 427  98 191 182],72,5,11672,4.02760524499655,40.0,0.0
32898,3,2898,[318 427  98 191 182],72,5,11677,4.0279406691962745,40.0,0.0
32899,3,2899,[276 269 186 237 423],535,4,11681,4.027931034482759,0.0,0.0
32900,3,2900,[328 313 204 153 197],796,4,11685,4.027921406411582,0.0,0.0
32901,3,2901,[ 28 202 546 282  12],796,4,11689,4.0279117849758785,0.0,0.0
32902,3,2902,[ 96 405 603 357 151],269,3,11692,4.0275576989321396,20.0,0.0
32903,3,2903,[228  82 483 655 234],796,2,11694,4.026859504132231,0.0,0.0
32904,3,2904,[318 427  98 191 182],450,5,11699,4.027194492254734,40.0,0.0
32905,3,2905,[318 427  98 191 182],269,5,11704,4.027529249827942,40.0,0.0
32906,3,2906,[318 427  98 191 182],72,5,11709,4.027863777089784,40.0,0.0
32907,3,2907,[318 427  98 191 182],269,5,11714,4.028198074277854,40.0,0.0
32908,3,2908,[181 182 176 258 183],796,5,11719,4.028532141629426,0.0,0.0
32909,3,2909,[318 427  98 191 182],269,5,11724,4.028865979381443,40.0,0.0
32910,3,2910,[318 427  98 191 182],450,5,11729,4.029199587770526,40.0,0.0
32911,3,2911,[318 427  98 191 182],269,5,11734,4.029532967032967,40.0,0.0
32912,3,2912,[195 258 655  11 597],457,4,11738,4.029522828698936,0.0,0.0
32913,3,2913,[496 182 127 197  15],450,4,11742,4.029512697323267,20.0,20.0
32914,3,2914,[215 196  25 234 588],835,4,11746,4.029502572898799,0.0,0.0
32915,3,2915,[318 427  98 191 182],18,5,11751,4.029835390946502,40.0,0.0
32916,3,2916,[318 427  98 191 182],269,5,11756,4.030167980802194,40.0,0.0
32917,3,2917,[202 300 238  88 187],796,4,11760,4.030157642220699,0.0,0.0
32918,3,2918,[318 427  98 191 182],18,5,11765,4.030489893799246,40.0,0.0
32919,3,2919,[300 121   7 603  89],450,4,11769,4.030479452054794,20.0,0.0
32920,3,2920,[318 427  98 191 182],655,5,11774,4.030811365970558,40.0,0.0
32921,3,2921,[181 202  12 603 235],450,4,11778,4.030800821355236,20.0,0.0
32922,3,2922,[ 11 180 237 118 143],457,5,11783,4.031132398221006,0.0,0.0
32923,3,2923,[546 161 288 328  69],450,4,11787,4.031121751025991,0.0,0.0
32924,3,2924,[318 427  98 191 182],72,5,11792,4.0314529914529915,40.0,0.0
32925,3,2925,[181 588 289  98 202],798,2,11794,4.030758714969242,0.0,0.0
32926,3,2926,[ 12 180  89 333 117],796,4,11798,4.030748206354629,0.0,0.0
32927,3,2927,[ 70  79  12 117 286],655,1,11799,4.029713114754099,0.0,20.0
32928,3,2928,[ 98  79 238 111   9],151,5,11804,4.03004438374872,0.0,0.0
32929,3,2929,[216 211 153 175  11],269,2,11806,4.029351535836177,0.0,0.0
32930,3,2930,[318 427  98 191 182],796,5,11811,4.0296827021494375,40.0,0.0
32931,3,2931,[318 427  98 191 182],450,5,11816,4.0300136425648025,40.0,0.0
32932,3,2932,[191  22 603  11 508],655,2,11818,4.029321513808387,20.0,0.0
32933,3,2933,[195 423  12 588 181],796,5,11823,4.029652351738242,0.0,0.0
32934,3,2934,[269  69 276 275  71],18,4,11827,4.0296422487223165,0.0,20.0
32935,3,2935,[144 597 228 127 275],457,4,11831,4.0296321525885554,0.0,40.0
32936,3,2936,[181 118 204   8 403],457,5,11836,4.0299625468164795,0.0,0.0
32937,3,2937,[318 427  98 191 182],796,5,11841,4.030292716133424,40.0,0.0
32938,3,2938,[195 403 423 282 151],504,4,11845,4.0302824089826474,0.0,0.0
32939,3,2939,[318 427  98 191 182],18,5,11850,4.030612244897959,40.0,0.0
32940,3,2940,[  1 286 153 275 197],389,3,11853,4.0302618157089425,0.0,40.0
32941,3,2941,[318 427  98 191 182],18,5,11858,4.030591434398368,40.0,0.0
32942,3,2942,[603 318 182 215 228],450,5,11863,4.030920829085967,40.0,0.0
32943,3,2943,[183 121  56 196  50],151,4,11867,4.030910326086956,0.0,20.0
32944,3,2944,[318 427  98 191 182],269,5,11872,4.0312393887945674,40.0,0.0
32945,3,2945,[300  70 111 302 173],450,5,11877,4.031568228105907,0.0,0.0
32946,3,2946,[276 655 302 117 385],401,1,11878,4.030539531727181,0.0,0.0
32947,3,2947,[318 427  98 191 182],450,5,11883,4.030868385345998,40.0,0.0
32948,3,2948,[258 194  69 175 483],151,5,11888,4.031197015937606,0.0,0.0
32949,3,2949,[153 471 597 183  95],450,4,11892,4.031186440677966,0.0,0.0
32950,3,2950,[318 427  98 191 182],655,5,11897,4.031514740765842,40.0,0.0
32951,3,2951,[269 175 197 172 135],18,3,11900,4.031165311653116,0.0,0.0
32952,3,2952,[318 427  98 191 182],72,5,11905,4.031493396545885,40.0,0.0
32953,3,2953,[318 427  98 191 182],655,5,11910,4.031821259309411,40.0,0.0
32954,3,2954,[318 435 182 153  82],269,2,11912,4.031133671742809,20.0,0.0
32955,3,2955,[318 427  98 191 182],450,5,11917,4.0314614343707715,40.0,0.0
32956,3,2956,[318 427  98 191 182],72,5,11922,4.031788975312817,40.0,0.0
32957,3,2957,[ 79 125 111  64 187],18,3,11925,4.031440162271806,20.0,0.0
32958,3,2958,[  9  15 228  95 237],796,4,11929,4.031429537005745,0.0,0.0
32959,3,2959,[318 427  98 191 182],796,5,11934,4.0317567567567565,40.0,0.0
32960,3,2960,[313 423  56 228 181],450,5,11939,4.032083755488011,0.0,0.0
32961,3,2961,[ 69 237 211  22 153],796,4,11943,4.032072923700203,0.0,0.0
32962,3,2962,[483 258  69 100 245],450,4,11947,4.03206209922376,0.0,20.0
32963,3,2963,[318 427  98 191 182],18,5,11952,4.032388663967612,40.0,0.0
32964,3,2964,[588 216  12 546  28],457,4,11956,4.0323777403035415,0.0,0.0
32965,3,2965,[318 427  98 191 182],450,5,11961,4.032703978422117,40.0,0.0
32966,3,2966,[ 82 100 175 302  25],151,2,11963,4.032018874283788,0.0,20.0
32967,3,2967,[318 427  98 191 182],450,5,11968,4.032345013477089,40.0,0.0
32968,3,2968,[318 427  98 191 182],72,5,11973,4.0326709329740655,40.0,0.0
32969,3,2969,[318 427  98 191 182],72,5,11978,4.032996632996633,40.0,0.0
32970,3,2970,[405  56 172 222  22],450,4,11982,4.032985526758667,0.0,0.0
32971,3,2971,[318 427  98 191 182],72,5,11987,4.033310901749664,40.0,0.0
32972,3,2972,[318 427  98 191 182],269,5,11992,4.03363605785402,40.0,0.0
32973,3,2973,[318 427  98 191 182],796,5,11997,4.033960995292535,40.0,0.0
32974,3,2974,[ 11 742 215  25 186],693,3,12000,4.033613445378151,0.0,0.0
32975,3,2975,[318 427  98 191 182],450,5,12005,4.033938172043011,40.0,0.0
32976,3,2976,[117 546 200  70 195],786,5,12010,4.03426268055089,0.0,0.0
32977,3,2977,[318 427  98 191 182],18,5,12015,4.034586971121558,40.0,0.0
32978,3,2978,[238  28 234 121 268],655,0,12015,4.033232628398792,0.0,0.0
32979,3,2979,[423  88 191   7 275],786,5,12020,4.033557046979865,0.0,20.0
32980,3,2980,[318 427  98 191 182],655,5,12025,4.0338812479033885,40.0,0.0
32981,3,2981,[180 238 275  98 357],796,3,12028,4.033534540576794,0.0,20.0
32982,3,2982,[275  11 125 204 117],655,1,12029,4.032517599731814,0.0,20.0
32983,3,2983,[357 181 318 191  89],796,5,12034,4.0328418230563,20.0,0.0
32984,3,2984,[125 118 222  15 568],798,3,12037,4.03249581239531,0.0,0.0
32985,3,2985,[294 195 187 357 288],629,4,12041,4.032484929671802,0.0,0.0
32986,3,2986,[234 215 186 125 202],796,3,12044,4.03213927017074,0.0,0.0
32987,3,2987,[318 427  98 191 182],269,5,12049,4.032463186077644,40.0,0.0
32988,3,2988,[268  25 127 302 257],655,2,12051,4.031783205085313,0.0,20.0
32989,3,2989,[318 427  98 191 182],18,5,12056,4.032107023411371,40.0,0.0
32990,3,2990,[257 568  28 288  64],655,1,12057,4.031093279839519,20.0,0.0
32991,3,2991,[318 427  98 191 182],18,5,12062,4.031417112299465,40.0,0.0
32992,3,2992,[194 191  69 237 357],716,5,12067,4.031740728366188,0.0,0.0
32993,3,2993,[ 50 161  95 117 118],450,3,12070,4.031396125584503,0.0,20.0
32994,3,2994,[405 172 143 151 265],807,5,12075,4.031719532554257,0.0,0.0
32995,3,2995,[318 427  98 191 182],796,5,12080,4.032042723631509,40.0,0.0
32996,3,2996,[318 427  98 191 182],18,5,12085,4.032365699032366,40.0,0.0
32997,3,2997,[318 427  98 191 182],269,5,12090,4.032688458972649,40.0,0.0
32998,3,2998,[175  89 471  88  69],655,1,12091,4.031677225741914,0.0,0.0
32999,3,2999,[546 271 289 135 318],807,4,12095,4.031666666666666,20.0,0.0
33000,3,3000,[318 427  98 191 182],269,5,12100,4.031989336887704,40.0,0.0
33001,3,3001,[318 427  98 191 182],269,5,12105,4.032311792138574,40.0,0.0
33002,3,3002,[197 275 286   9 168],878,5,12110,4.032634032634032,0.0,40.0
33003,3,3003,[318 427  98 191 182],72,5,12115,4.032956058588549,40.0,0.0
33004,3,3004,[405 181 546  79  96],23,4,12119,4.032945091514143,0.0,0.0
33005,3,3005,[211 258  28 174 202],450,5,12124,4.033266799733866,0.0,0.0
33006,3,3006,[144  11 174 423 210],655,0,12124,4.0319255071499835,0.0,0.0
33007,3,3007,[ 98 191 357  64 269],450,5,12129,4.032247340425532,20.0,0.0
33008,3,3008,[  1 423 200   9 222],151,4,12133,4.0322366234629445,0.0,0.0
33009,3,3009,[318 427  98 191 182],655,5,12138,4.032558139534884,40.0,0.0
33010,3,3010,[597 286 183 276 191],344,3,12141,4.032215210893391,0.0,20.0
33011,3,3011,[423  71  89 195 483],807,4,12145,4.0322045152722445,0.0,0.0
33012,3,3012,[174 185 194 385 100],457,5,12150,4.032525721871888,0.0,20.0
33013,3,3013,[318 427  98 191 182],796,5,12155,4.032846715328467,40.0,0.0
33014,3,3014,[318 427  98 191 182],72,5,12160,4.033167495854063,40.0,0.0
33015,3,3015,[318 427  98 191 182],18,5,12165,4.033488063660477,40.0,0.0
33016,3,3016,[ 11 197  79 385  25],716,4,12169,4.033476963871395,0.0,0.0
33017,3,3017,[172 174  25  15 176],457,5,12174,4.033797216699801,0.0,0.0
33018,3,3018,[ 69   8 318 181 275],330,5,12179,4.03411725736999,20.0,20.0
33019,3,3019,[300 471   1 748 678],15,2,12181,4.033443708609272,0.0,0.0
33020,3,3020,[202  64 322 546 211],796,3,12184,4.033101621979477,20.0,0.0
33021,3,3021,[182 276 144 257 483],457,4,12188,4.033090668431503,0.0,0.0
33022,3,3022,[196 215 211 187 185],504,4,12192,4.033079722130334,0.0,0.0
33023,3,3023,[ 82  50 125 322 195],151,2,12194,4.032407407407407,0.0,20.0
33024,3,3024,[318 427  98 191 182],655,5,12199,4.032727272727273,40.0,0.0
33025,3,3025,[318 427  98 191 182],450,5,12204,4.033046926635823,40.0,0.0
33026,3,3026,[318 427  98 191 182],72,5,12209,4.033366369342583,40.0,0.0
33027,3,3027,[172  11 204 100  25],401,3,12212,4.033025099075298,0.0,20.0
33028,3,3028,[318 427  98 191 182],655,5,12217,4.033344338065368,40.0,0.0
33029,3,3029,[318 427  98 191 182],72,5,12222,4.033663366336634,40.0,0.0
33030,3,3030,[234  25 286 121  22],450,2,12224,4.032992411745298,0.0,20.0
33031,3,3031,[237  98 265   9 127],786,5,12229,4.033311345646438,0.0,20.0
33032,3,3032,[318 427  98 191 182],796,5,12234,4.033630069238378,40.0,0.0
33033,3,3033,[318 427  98 191 182],796,5,12239,4.033948582729071,40.0,0.0
33034,3,3034,[ 22 302 174 179 435],450,5,12244,4.034266886326194,0.0,0.0
33035,3,3035,[318 427  98 191 182],18,5,12249,4.034584980237154,40.0,0.0
33036,3,3036,[318 427  98 191 182],72,5,12254,4.034902864669081,40.0,0.0
33037,3,3037,[174 655 135 282 191],457,5,12259,4.035220539828835,0.0,0.0
33038,3,3038,[318 427  98 191 182],655,5,12264,4.035538005923001,40.0,0.0
33039,3,3039,[322 181 191 423 222],450,4,12268,4.035526315789474,0.0,0.0
33040,3,3040,[471 282   1 180 265],457,5,12273,4.035843472541927,0.0,0.0
33041,3,3041,[  1 258  56  15 100],450,4,12277,4.035831689677844,0.0,20.0
33042,3,3042,[318 427  98 191 182],655,5,12282,4.036148537627342,40.0,0.0
33043,3,3043,[ 95 172 211 403  50],807,5,12287,4.03646517739816,0.0,20.0
33044,3,3044,[318 427  98 191 182],269,5,12292,4.036781609195402,40.0,0.0
33045,3,3045,[318 427  98 191 182],269,5,12297,4.0370978332239,40.0,0.0
33046,3,3046,[ 56 202  69 471 215],577,3,12300,4.0367574663603545,0.0,0.0
33047,3,3047,[318 427  98 191 182],72,5,12305,4.037073490813648,40.0,0.0
33048,3,3048,[  1 125 568 228 168],796,4,12309,4.037061331584126,0.0,0.0
33049,3,3049,[174 210 234 318 195],280,1,12310,4.036065573770492,20.0,0.0
33050,3,3050,[318 427  98 191 182],72,5,12315,4.03638151425762,40.0,0.0
33051,3,3051,[318 427  98 191 182],796,5,12320,4.036697247706422,40.0,0.0
33052,3,3052,[318 427  98 191 182],450,5,12325,4.037012774320341,40.0,0.0
33053,3,3053,[318 427  98 191 182],18,5,12330,4.037328094302554,40.0,0.0
33054,3,3054,[ 88 234 405 211 127],716,5,12335,4.037643207855973,0.0,20.0
33055,3,3055,[318 427  98 191 182],450,5,12340,4.037958115183246,40.0,0.0
33056,3,3056,[151 655 257 385 132],504,5,12345,4.038272816486752,0.0,0.0
33057,3,3057,[216 301  89  88 181],344,3,12348,4.037933289731851,0.0,0.0
33058,3,3058,[257 269 282  50 111],655,1,12349,4.036940176528277,0.0,20.0
33059,3,3059,[200 127 597  50 405],457,4,12353,4.036928104575163,0.0,40.0
33060,3,3060,[318 427  98 191 182],72,5,12358,4.037242731133617,40.0,0.0
33061,3,3061,[318 427  98 191 182],655,5,12363,4.037557152188112,40.0,0.0
33062,3,3062,[318 427  98 191 182],450,5,12368,4.037871367939928,40.0,0.0
33063,3,3063,[318 427  98 191 182],72,5,12373,4.038185378590079,40.0,0.0
33064,3,3064,[588 655 423  96 121],716,4,12377,4.038172920065253,0.0,0.0
33065,3,3065,[187 294 333 508 197],655,1,12378,4.0371819960861055,0.0,0.0
33066,3,3066,[235 546 121   4 127],716,2,12380,4.03651776980763,0.0,20.0
33067,3,3067,[318 427  98 191 182],796,5,12385,4.036831812255541,40.0,0.0
33068,3,3068,[202 204  15 121   4],796,5,12390,4.037145650048876,0.0,0.0
33069,3,3069,[318 427  98 191 182],72,5,12395,4.037459283387622,40.0,0.0
33070,3,3070,[186 215 183  50 182],655,3,12398,4.037121458808206,0.0,20.0
33071,3,3071,[222 289 211   7 237],296,4,12402,4.037109375,0.0,0.0
33072,3,3072,[318 427  98 191 182],450,5,12407,4.037422713960299,40.0,0.0
33073,3,3073,[318 427  98 191 182],655,5,12412,4.037735849056604,40.0,0.0
33074,3,3074,[318 427  98 191 182],72,5,12417,4.038048780487805,40.0,0.0
33075,3,3075,[ 82 216 318 176  69],269,1,12418,4.037061118335501,20.0,0.0
33076,3,3076,[742 210  69 568 655],280,2,12420,4.0363990900227495,0.0,0.0
33077,3,3077,[385 118 245 228  15],796,4,12424,4.03638726445744,0.0,0.0
33078,3,3078,[318 427  98 191 182],72,5,12429,4.036700227346541,40.0,0.0
33079,3,3079,[288 168 197  97 151],457,5,12434,4.037012987012987,0.0,0.0
33080,3,3080,[678 181  70 195 174],280,1,12435,4.036027263875365,0.0,0.0
33081,3,3081,[515 181  82 111 185],716,5,12440,4.036340038935756,0.0,0.0
33082,3,3082,[228 301 204  89 174],450,5,12445,4.036652611093091,0.0,0.0
33083,3,3083,[258 125 186 195 117],655,0,12445,4.035343709468223,0.0,0.0
33084,3,3084,[318 427  98 191 182],796,5,12450,4.035656401944895,40.0,0.0
33085,3,3085,[318 427  98 191 182],269,5,12455,4.03596889176928,40.0,0.0
33086,3,3086,[318 427  98 191 182],450,5,12460,4.036281179138322,40.0,0.0
33087,3,3087,[125 183 302 172  96],450,5,12465,4.036593264248705,0.0,0.0
33088,3,3088,[318 427  98 191 182],655,5,12470,4.03690514729686,40.0,0.0
33089,3,3089,[153 202 197 195 127],716,4,12474,4.036893203883495,0.0,20.0
33090,3,3090,[603  25 301 195 121],450,3,12477,4.0365577483015205,20.0,0.0
33091,3,3091,[186 125 210 215 318],18,3,12480,4.0362225097024576,20.0,0.0
33092,3,3092,[318 427  98 191 182],796,5,12485,4.0365341092790175,40.0,0.0
33093,3,3093,[182  28 546 118 185],450,4,12489,4.0365223012281835,0.0,0.0
33094,3,3094,[195 161  56 275 202],23,3,12492,4.036187399030695,0.0,20.0
33095,3,3095,[294 180 100 483   1],457,4,12496,4.036175710594315,0.0,20.0
33096,3,3096,[748  22 216 222 197],280,2,12498,4.035518243461414,0.0,0.0
33097,3,3097,[302 435 265 117   1],655,1,12499,4.034538411878631,0.0,0.0
33098,3,3098,[153 210 132 143  12],655,1,12500,4.033559212649242,0.0,0.0
33099,3,3099,[318 427  98 191 182],72,5,12505,4.033870967741936,40.0,0.0
33100,3,3100,[318 427  98 191 182],18,5,12510,4.034182521767172,40.0,0.0
33101,3,3101,[318 427  98 191 182],655,5,12515,4.034493874919407,40.0,0.0
33102,3,3102,[111 196  64 288 294],629,4,12519,4.0344827586206895,20.0,0.0
33103,3,3103,[318 427  98 191 182],18,5,12524,4.03479381443299,40.0,0.0
33104,3,3104,[318 427  98 191 182],655,5,12529,4.035104669887279,40.0,0.0
33105,3,3105,[238  96 191 405 172],655,2,12531,4.034449452672248,0.0,0.0
33106,3,3106,[187 288  96 245 179],504,3,12534,4.034116511103959,0.0,0.0
33107,3,3107,[318 427  98 191 182],72,5,12539,4.034427284427284,40.0,0.0
33108,3,3108,[181 423  71  95 172],885,3,12542,4.034094564168543,0.0,0.0
33109,3,3109,[ 88 202 318 301 204],796,4,12546,4.034083601286174,20.0,0.0
33110,3,3110,[318 427  98 191 182],18,5,12551,4.034394085503053,40.0,0.0
33111,3,3111,[179 210  71  79   8],535,4,12555,4.034383033419023,0.0,0.0
33112,3,3112,[318 427  98 191 182],18,5,12560,4.034693221972374,40.0,0.0
33113,3,3113,[318 427  98 191 182],450,5,12565,4.035003211303789,40.0,0.0
33114,3,3114,[318 427  98 191 182],450,5,12570,4.035313001605137,40.0,0.0
33115,3,3115,[257 153 197 237  82],796,3,12573,4.034980744544288,0.0,0.0
33116,3,3116,[275 143 286 175 186],655,2,12575,4.03432787937119,0.0,40.0
33117,3,3117,[176   7 215 496 238],450,5,12580,4.034637588197563,20.0,0.0
33118,3,3118,[257  95 273  79 151],796,4,12584,4.034626482847067,0.0,0.0
33119,3,3119,[313 215 132 357 197],796,4,12588,4.0346153846153845,0.0,0.0
33120,3,3120,[496 313  70 186  25],450,3,12591,4.034283883370715,20.0,0.0
33121,3,3121,[318 427  98 191 182],655,5,12596,4.034593209481102,40.0,0.0
33122,3,3122,[318 427  98 191 182],72,5,12601,4.034902337495997,40.0,0.0
33123,3,3123,[318 427  98 191 182],796,5,12606,4.035211267605634,40.0,0.0
33124,3,3124,[603   9 179 238   1],18,4,12610,4.0352,20.0,0.0
33125,3,3125,[111 200 180   9 323],796,2,12612,4.0345489443378115,0.0,0.0
33126,3,3126,[196 302 173 215 269],535,4,12616,4.034537895746722,0.0,0.0
33127,3,3127,[318 427  98 191 182],655,5,12621,4.034846547314578,40.0,0.0
33128,3,3128,[318 427  98 191 182],269,5,12626,4.035155001597954,40.0,0.0
33129,3,3129,[ 69 168 276 322 121],401,1,12627,4.034185303514377,0.0,0.0
33130,3,3130,[318 427  98 191 182],796,5,12632,4.034493771957841,40.0,0.0
33131,3,3131,[318 427  98 191 182],269,5,12637,4.034802043422733,40.0,0.0
33132,3,3132,[ 64 265 151  12 186],457,5,12642,4.03511011809767,20.0,0.0
33133,3,3133,[318 427  98 191 182],655,5,12647,4.035417996171027,40.0,0.0
33134,3,3134,[496 185 173 302 318],704,5,12652,4.035725677830941,40.0,0.0
33135,3,3135,[322  70 742 210 588],450,4,12656,4.035714285714286,0.0,0.0
33136,3,3136,[ 56 258 135 748 357],151,4,12660,4.035702900860695,0.0,0.0
33137,3,3137,[318 427  98 191 182],72,5,12665,4.036010197578075,40.0,0.0
33138,3,3138,[194 151 294 234 153],504,1,12666,4.035043007327174,0.0,0.0
33139,3,3139,[210  88 173 483   9],269,2,12668,4.0343949044585985,0.0,0.0
33140,3,3140,[318 427  98 191 182],18,5,12673,4.034702324100605,40.0,0.0
33141,3,3141,[  4 302  11 175   7],344,4,12677,4.034691279439847,0.0,0.0
33142,3,3142,[195 153 125 222  50],151,3,12680,4.0343620744511615,0.0,20.0
33143,3,3143,[ 98 471 143 215 294],655,2,12682,4.033715012722646,0.0,0.0
33144,3,3144,[117 121 301 597 143],450,4,12686,4.033704292527822,0.0,0.0
33145,3,3145,[ 15 322 655 204 191],450,4,12690,4.0336935791481245,0.0,0.0
33146,3,3146,[ 50 194 127 196  79],457,5,12695,4.0340006355258975,0.0,40.0
33147,3,3147,[300 197  50 191  15],151,4,12699,4.033989834815756,0.0,20.0
33148,3,3148,[301 483 100 151 471],450,4,12703,4.033979040965386,0.0,20.0
33149,3,3149,[258 125 546 210 508],344,2,12705,4.033333333333333,0.0,0.0
33150,3,3150,[318 427  98 182 191],269,5,12710,4.033640114249445,40.0,0.0
33151,3,3151,[127  71  70 132 121],786,4,12714,4.033629441624366,0.0,20.0
33152,3,3152,[318 427  98 182 191],796,5,12719,4.033935934031081,40.0,0.0
33153,3,3153,[ 15 405 100 427 187],72,4,12723,4.0339251743817375,20.0,20.0
33154,3,3154,[318 427  98 182 191],269,5,12728,4.034231378763867,40.0,0.0
33155,3,3155,[161 176 301   1  50],655,1,12729,4.033269961977187,0.0,20.0
33156,3,3156,[423 210 237  22 211],269,2,12731,4.032625910674692,0.0,0.0
33157,3,3157,[318 427  98 182 191],72,5,12736,4.032932235592147,40.0,0.0
33158,3,3158,[318 427  98 182 191],72,5,12741,4.0332383665717,40.0,0.0
33159,3,3159,[318 427  98 182 191],18,5,12746,4.033544303797468,40.0,0.0
33160,3,3160,[222 423   1  95 282],280,3,12749,4.033217336285985,0.0,0.0
33161,3,3161,[ 28 121  25 435 275],716,5,12754,4.033523086654016,0.0,20.0
33162,3,3162,[318 427  98 182 191],655,5,12759,4.033828643692697,40.0,0.0
33163,3,3163,[403 174 483 603 127],796,5,12764,4.034134007585335,20.0,20.0
33164,3,3164,[313 286 508   4 195],344,3,12767,4.033807266982622,0.0,20.0
33165,3,3165,[318 427  98 182 191],450,5,12772,4.0341124447252055,40.0,0.0
33166,3,3166,[318 427  98 182 191],450,5,12777,4.034417429744237,40.0,0.0
33167,3,3167,[588 117 183  70  11],450,5,12782,4.034722222222222,0.0,0.0
33168,3,3168,[ 96  98  88 151  64],457,5,12787,4.0350268223414325,20.0,0.0
33169,3,3169,[318 427  98 182 191],450,5,12792,4.035331230283911,40.0,0.0
33170,3,3170,[237 211 180 153 385],716,3,12795,4.035004730368969,0.0,0.0
33171,3,3171,[318 427  98 182 191],72,5,12800,4.03530895334174,40.0,0.0
33172,3,3172,[318 427  98 182 191],796,5,12805,4.0356129845572015,40.0,0.0
33173,3,3173,[111  88  97 172  15],707,3,12808,4.03528670447385,0.0,0.0
33174,3,3174,[180 588  88 143 273],796,3,12811,4.03496062992126,0.0,0.0
33175,3,3175,[ 82 173 181 228 176],756,2,12813,4.034319899244332,0.0,0.0
33176,3,3176,[318 427  98 182 191],18,5,12818,4.034623858986465,40.0,0.0
33177,3,3177,[318 427  98 182 191],655,5,12823,4.03492762743864,40.0,0.0
33178,3,3178,[ 69 405 215 268 191],655,1,12824,4.033972947467757,0.0,0.0
33179,3,3179,[318 427  98 182 191],796,5,12829,4.034276729559749,40.0,0.0
33180,3,3180,[187  15 135 275 211],18,4,12833,4.034265954102484,0.0,20.0
33181,3,3181,[182 196 211 288 300],655,1,12834,4.0333123821495915,0.0,0.0
33182,3,3182,[186 197  82 427  28],151,4,12838,4.03330191643104,20.0,0.0
33183,3,3183,[318 427  98 182 191],18,5,12843,4.033605527638191,40.0,0.0
33184,3,3184,[257 161 273 211 483],655,2,12845,4.032967032967033,0.0,0.0
33185,3,3185,[427 182 228 258 328],655,2,12847,4.0323289391086,20.0,0.0
33186,3,3186,[318 427  98 182 191],72,5,12852,4.032632569814873,40.0,0.0
33187,3,3187,[186  28 197 151   4],457,5,12857,4.032936010037641,0.0,0.0
33188,3,3188,[234 181 222 265  79],807,4,12861,4.032925682031985,0.0,0.0
33189,3,3189,[100 357 216 546 496],796,4,12865,4.032915360501567,20.0,20.0
33190,3,3190,[204 179 185 182 216],655,4,12869,4.032905045440301,0.0,0.0
33191,3,3191,[318 427  98 182 191],655,5,12874,4.033208020050125,40.0,0.0
33192,3,3192,[127 435 153  25 427],655,2,12876,4.032571249608519,20.0,20.0
33193,3,3193,[143 275  70 222 135],450,3,12879,4.0322479649342515,0.0,20.0
33194,3,3194,[318 427  98 182 191],655,5,12884,4.032550860719875,40.0,0.0
33195,3,3195,[ 22 127  79 121 195],716,4,12888,4.032540675844806,0.0,20.0
33196,3,3196,[179 191 588 181 183],577,4,12892,4.0325304973412575,0.0,0.0
33197,3,3197,[318 427  98 182 191],796,5,12897,4.032833020637899,40.0,0.0
33198,3,3198,[318 427  98 182 191],18,5,12902,4.033135354798374,40.0,0.0
33199,3,3199,[318 427  98 182 191],18,5,12907,4.0334375,40.0,0.0
33200,3,3200,[318 427  98 182 191],655,5,12912,4.033739456419869,40.0,0.0
33201,3,3201,[185 258 405 273 403],655,2,12914,4.033104309806371,0.0,0.0
33202,3,3202,[294 328 286 597   7],450,5,12919,4.033406181704652,0.0,20.0
33203,3,3203,[245 183 180 135 185],450,4,12923,4.033395755305867,0.0,0.0
33204,3,3204,[318 427  98 182 191],269,5,12928,4.0336973478939155,40.0,0.0
33205,3,3205,[ 64 202 603  28 173],389,4,12932,4.033686837180287,40.0,0.0
33206,3,3206,[655 161 135 276 405],269,3,12935,4.033364515123168,0.0,0.0
33207,3,3207,[172 143 185 222 200],796,5,12940,4.033665835411472,0.0,0.0
33208,3,3208,[ 71  64 186 187   4],535,3,12943,4.033343720785291,20.0,0.0
33209,3,3209,[313 182  50 172 144],593,4,12947,4.033333333333333,0.0,20.0
33210,3,3210,[546 111 228 196 322],344,3,12950,4.033011522890066,0.0,0.0
33211,3,3211,[318 427  98 191 182],450,5,12955,4.033312577833126,40.0,0.0
33212,3,3212,[318 427  98 191 182],72,5,12960,4.033613445378151,40.0,0.0
33213,3,3213,[132 195 179 273 172],450,4,12964,4.033602986932172,0.0,0.0
33214,3,3214,[318 427  98 191 182],18,5,12969,4.033903576982893,40.0,0.0
33215,3,3215,[318 427  98 191 182],450,5,12974,4.034203980099503,40.0,0.0
33216,3,3216,[318 427  98 191 182],18,5,12979,4.034504196456326,40.0,0.0
33217,3,3217,[176 323  96  88  95],23,2,12981,4.033871970167806,0.0,0.0
33218,3,3218,[318 427  98 191 182],269,5,12986,4.03417210313762,40.0,0.0
33219,3,3219,[318 427  98 191 182],72,5,12991,4.034472049689441,40.0,0.0
33220,3,3220,[318 427  98 191 182],796,5,12996,4.034771809996895,40.0,0.0
33221,3,3221,[318 427  98 191 182],269,5,13001,4.035071384233396,40.0,0.0
33222,3,3222,[471 118   1   4  11],716,2,13003,4.034439962767608,0.0,0.0
33223,3,3223,[318 427  98 191 182],18,5,13008,4.034739454094293,40.0,0.0
33224,3,3224,[568 238 185 186  64],716,4,13012,4.034728682170543,20.0,0.0
33225,3,3225,[125 181 185  25 202],151,5,13017,4.0350278983261,0.0,0.0
33226,3,3226,[742 117 153 185 118],796,4,13021,4.035017043693833,0.0,0.0
33227,3,3227,[318 427  98 191 182],18,5,13026,4.0353159851301115,40.0,0.0
33228,3,3228,[318 427  98 191 182],18,5,13031,4.035614741406008,40.0,0.0
33229,3,3229,[496 210 269 135 228],450,3,13034,4.035294117647059,20.0,0.0
33230,3,3230,[222 282  95  97 257],796,4,13038,4.035283194057567,0.0,0.0
33231,3,3231,[318 427  98 191 182],269,5,13043,4.035581683168317,40.0,0.0
33232,3,3232,[318 427  98 191 182],450,5,13048,4.035879987627591,40.0,0.0
33233,3,3233,[216 258 286  25 427],450,4,13052,4.035868893011751,20.0,20.0
33234,3,3234,[ 25 118 182 257  89],655,2,13054,4.0352395672333845,0.0,0.0
33235,3,3235,[318 427  98 191 182],269,5,13059,4.035537700865266,40.0,0.0
33236,3,3236,[202 173 191 186 286],796,3,13062,4.0352177942539385,0.0,20.0
33237,3,3237,[318 427  98 191 182],655,5,13067,4.035515750463249,40.0,0.0
33238,3,3238,[127 237 234 211 204],450,4,13071,4.035504785427601,0.0,20.0
33239,3,3239,[318 427  98 191 182],796,5,13076,4.0358024691358025,40.0,0.0
33240,3,3240,[153 597 269 238 228],796,3,13079,4.035482875655662,0.0,0.0
33241,3,3241,[318 427  98 191 182],655,5,13084,4.035780382479951,40.0,0.0
33242,3,3242,[318 427  98 191 182],18,5,13089,4.036077705827937,40.0,0.0
33243,3,3243,[275 174 168 181 228],798,4,13093,4.036066584463625,0.0,20.0
33244,3,3244,[318 427  98 191 182],269,5,13098,4.036363636363636,40.0,0.0
33245,3,3245,[597  96 568 588 403],450,5,13103,4.036660505237215,0.0,0.0
33246,3,3246,[258 423 215  97 173],11,4,13107,4.036649214659686,0.0,0.0
33247,3,3247,[318 427  98 191 182],269,5,13112,4.036945812807882,40.0,0.0
33248,3,3248,[176 234 289 403 265],655,0,13112,4.0357032933210215,0.0,0.0
33249,3,3249,[318 427  98 191 182],796,5,13117,4.036,40.0,0.0
33250,3,3250,[318 427  98 191 182],72,5,13122,4.036296524146416,40.0,0.0
33251,3,3251,[168 238 161  79 655],796,3,13125,4.035977859778598,0.0,0.0
33252,3,3252,[318 427  98 191 182],796,5,13130,4.036274208422994,40.0,0.0
33253,3,3253,[318 427  98 191 182],269,5,13135,4.036570374923172,40.0,0.0
33254,3,3254,[111 179 288 100 117],450,4,13139,4.036559139784946,0.0,20.0
33255,3,3255,[318 427  98 191 182],72,5,13144,4.036855036855036,40.0,0.0
33256,3,3256,[ 97 182 228   7  64],72,3,13147,4.036536690205711,20.0,0.0
33257,3,3257,[ 11 282 202 257   1],655,0,13147,4.035297728667895,0.0,0.0
33258,3,3258,[318 427  98 191 182],450,5,13152,4.035593740411169,40.0,0.0
33259,3,3259,[286  12 187 191  15],450,4,13156,4.03558282208589,0.0,20.0
33260,3,3260,[597 257 144 151  15],796,5,13161,4.035878564857406,0.0,0.0
33261,3,3261,[318 427  98 191 182],796,5,13166,4.036174126302882,40.0,0.0
33262,3,3262,[318 427  98 191 182],72,5,13171,4.036469506589029,40.0,0.0
33263,3,3263,[121 603 222  71 144],450,2,13173,4.035845588235294,20.0,0.0
33264,3,3264,[ 12 210 183 300 135],655,2,13175,4.035222052067382,0.0,0.0
33265,3,3265,[318 427  98 191 182],18,5,13180,4.035517452541335,40.0,0.0
33266,3,3266,[318 427  98 191 182],450,5,13185,4.035812672176308,40.0,0.0
33267,3,3267,[191 333   1 508 175],655,1,13186,4.034883720930233,0.0,0.0
33268,3,3268,[275 294 127 174 143],401,3,13189,4.034567145916182,0.0,40.0
33269,3,3269,[318 427  98 191 182],18,5,13194,4.034862385321101,40.0,0.0
33270,3,3270,[318 427  98 191 182],796,5,13199,4.035157444206664,40.0,0.0
33271,3,3271,[318 427  98 191 182],18,5,13204,4.0354523227383865,40.0,0.0
33272,3,3272,[179 185 655 210 222],450,3,13207,4.0351359608921475,0.0,0.0
33273,3,3273,[318 427  98 191 182],269,5,13212,4.035430665852169,40.0,0.0
33274,3,3274,[265 144 597 100 496],796,4,13216,4.035419847328244,20.0,20.0
33275,3,3275,[318 427  98 191 182],72,5,13221,4.035714285714286,40.0,0.0
33276,3,3276,[318 427  98 191 182],72,5,13226,4.036008544400366,40.0,0.0
33277,3,3277,[597  82 568 234  15],457,4,13230,4.035997559487492,0.0,0.0
33278,3,3278,[ 64 216 286 215 204],330,5,13235,4.036291552302531,20.0,20.0
33279,3,3279,[318  64 168  12  97],457,5,13240,4.036585365853658,40.0,0.0
33280,3,3280,[216  88  98  11 121],269,1,13241,4.035659859798842,0.0,0.0
33281,3,3281,[318 427  98 191 182],18,5,13246,4.035953686776356,40.0,0.0
33282,3,3282,[427 195  56 132 313],655,2,13248,4.0353335363996345,20.0,0.0
33283,3,3283,[237 180 403 568  79],796,4,13252,4.035322777101096,0.0,0.0
33284,3,3284,[318 427  98 191 182],72,5,13257,4.035616438356165,40.0,0.0
33285,3,3285,[546  98 168 300 222],716,4,13261,4.035605599513086,0.0,0.0
33286,3,3286,[318 427  98 191 182],450,5,13266,4.0358989960450256,40.0,0.0
33287,3,3287,[318 427  98 191 182],18,5,13271,4.036192214111922,40.0,0.0
33288,3,3288,[546  97 435 197  15],151,4,13275,4.036181210094254,0.0,0.0
33289,3,3289,[135 742 197  71 328],450,3,13278,4.035866261398176,0.0,0.0
33290,3,3290,[318 427  98 191 182],655,5,13283,4.0361592221209355,40.0,0.0
33291,3,3291,[318 427  98 191 182],72,5,13288,4.0364520048602675,40.0,0.0
33292,3,3292,[265 748 238 111  11],436,2,13290,4.035833586395384,0.0,0.0
33293,3,3293,[318 427  98 191 182],655,5,13295,4.036126290224651,40.0,0.0
33294,3,3294,[318 427  98 191 182],796,5,13300,4.036418816388467,40.0,0.0
33295,3,3295,[282 748   9 288 216],280,3,13303,4.036104368932039,0.0,0.0
33296,3,3296,[318 427  98 191 182],18,5,13308,4.036396724294813,40.0,0.0
33297,3,3297,[179  79   8  12 194],457,5,13313,4.03668890236507,0.0,0.0
33298,3,3298,[245 200 127 294  22],796,3,13316,4.036374658987572,0.0,20.0
33299,3,3299,[322  97  70 161 117],401,2,13318,4.035757575757576,0.0,0.0
33300,3,3300,[181  56 100  95  69],885,2,13320,4.03514086640412,0.0,20.0
33301,3,3301,[385   7   9  97 174],655,0,13320,4.033918837068444,0.0,0.0
33302,3,3302,[318 427  98 191 182],796,5,13325,4.034211323039661,40.0,0.0
33303,3,3303,[496 286   7 181 118],151,4,13329,4.0342009685230025,20.0,20.0
33304,3,3304,[195 132 187   1 181],655,1,13330,4.033282904689864,0.0,0.0
33305,3,3305,[318 427  98 191 182],450,5,13335,4.033575317604356,40.0,0.0
33306,3,3306,[237 202 496 276 322],280,3,13338,4.033262775929845,20.0,0.0
33307,3,3307,[132 546  88 186 153],716,3,13341,4.032950423216445,0.0,0.0
33308,3,3308,[318 427  98 191 182],655,5,13346,4.033242671501965,40.0,0.0
33309,3,3309,[180  12 275 427 496],18,5,13351,4.033534743202417,40.0,20.0
33310,3,3310,[318 427  98 191 182],72,5,13356,4.033826638477802,40.0,0.0
33311,3,3311,[318 427  98 191 182],796,5,13361,4.034118357487923,40.0,0.0
33312,3,3312,[132 265 117 111 191],796,5,13366,4.034409900392394,0.0,0.0
33313,3,3313,[318 427  98 191 182],796,5,13371,4.034701267350633,40.0,0.0
33314,3,3314,[318 427  98 191 182],269,5,13376,4.03499245852187,40.0,0.0
33315,3,3315,[318 427  98 191 182],269,5,13381,4.035283474065139,40.0,0.0
33316,3,3316,[318 427  98 191 182],269,5,13386,4.035574314139282,40.0,0.0
33317,3,3317,[318 427  98 191 182],450,5,13391,4.0358649789029535,40.0,0.0
33318,3,3318,[318 427  98 191 182],18,5,13396,4.036155468514613,40.0,0.0
33319,3,3319,[ 88  15 202 405  25],577,2,13398,4.035542168674699,0.0,0.0
33320,3,3320,[318 427  98 191 182],269,5,13403,4.0358325805480275,40.0,0.0
33321,3,3321,[288 174 427 403 294],655,1,13404,4.034918723660446,20.0,0.0
33322,3,3322,[194 265 385 135 294],457,4,13408,4.034908215467951,0.0,0.0
33323,3,3323,[318 427  98 191 182],796,5,13413,4.035198555956678,40.0,0.0
33324,3,3324,[318 427  98 191 182],18,5,13418,4.035488721804511,40.0,0.0
33325,3,3325,[318 427  98 191 182],18,5,13423,4.0357787131689715,40.0,0.0
33326,3,3326,[  9 132 483  25  89],151,5,13428,4.036068530207394,0.0,0.0
33327,3,3327,[265 182  12 258 216],450,5,13433,4.036358173076923,0.0,0.0
33328,3,3328,[318 655 269  15 568],796,3,13436,4.036046860919195,20.0,0.0
33329,3,3329,[182 748 185 187 228],256,3,13439,4.035735735735735,0.0,0.0
33330,3,3330,[318 427  98 191 182],18,5,13444,4.036025217652357,40.0,0.0
33331,3,3331,[318 427  98 191 182],269,5,13449,4.036314525810324,40.0,0.0
33332,3,3332,[183 174 181 125   8],655,1,13450,4.035403540354036,0.0,0.0
33333,3,3333,[318 427  98 191 182],18,5,13455,4.035692861427714,40.0,0.0
33334,3,3334,[286 172 597 182 100],796,3,13458,4.035382308845577,0.0,40.0
33335,3,3335,[318 427  98 191 182],796,5,13463,4.035671462829736,40.0,0.0
33336,3,3336,[100 204 588 237   4],786,5,13468,4.035960443512137,0.0,20.0
33337,3,3337,[318 427  98 191 182],72,5,13473,4.036249251048532,40.0,0.0
33338,3,3338,[127 275  96 200 276],457,5,13478,4.036537885594489,0.0,40.0
33339,3,3339,[318 427  98 191 182],450,5,13483,4.036826347305389,40.0,0.0
33340,3,3340,[318 427  98 191 182],72,5,13488,4.037114636336426,40.0,0.0
33341,3,3341,[271   1 144  69  96],655,0,13488,4.0359066427289045,0.0,0.0
33342,3,3342,[318 427  98 191 182],18,5,13493,4.036195034400239,40.0,0.0
33343,3,3343,[265 175 185 153 257],716,4,13497,4.036184210526316,0.0,0.0
33344,3,3344,[286 282 182 187 168],450,5,13502,4.036472346786248,0.0,20.0
33345,3,3345,[ 64 180 603   4 172],535,3,13505,4.0361625821876865,40.0,0.0
33346,3,3346,[318 427  98 191 182],655,5,13510,4.0364505527337915,40.0,0.0
33347,3,3347,[655 228 185 435 187],450,5,13515,4.03673835125448,0.0,0.0
33348,3,3348,[318 427  98 191 182],450,5,13520,4.037025977903852,40.0,0.0
33349,3,3349,[ 69 216  25  28 117],330,5,13525,4.037313432835821,0.0,0.0
33350,3,3350,[318 427  98 191 182],18,5,13530,4.0376007162041185,40.0,0.0
33351,3,3351,[318 427  98 191 182],18,5,13535,4.037887828162291,40.0,0.0
33352,3,3352,[237 197 282 301  22],450,5,13540,4.038174768863704,0.0,0.0
33353,3,3353,[318 427  98 191 182],18,5,13545,4.038461538461538,40.0,0.0
33354,3,3354,[ 88 111  82 143 427],796,4,13549,4.038450074515648,20.0,0.0
33355,3,3355,[234 161  98 216 194],796,4,13553,4.038438617401669,0.0,0.0
33356,3,3356,[318 427  98 191 182],18,5,13558,4.038725052129878,40.0,0.0
33357,3,3357,[318 427  98 191 182],18,5,13563,4.039011316259678,40.0,0.0
33358,3,3358,[318 427  98 191 182],18,5,13568,4.039297409943435,40.0,0.0
33359,3,3359,[318 427  98 191 182],796,5,13573,4.039583333333334,40.0,0.0
33360,3,3360,[ 12 403 210 276 144],280,2,13575,4.038976495090747,0.0,0.0
33361,3,3361,[318 427  98 191 182],18,5,13580,4.0392623438429505,40.0,0.0
33362,3,3362,[238 100 197 289 333],655,0,13580,4.038061254831995,0.0,20.0
33363,3,3363,[318 427  98 191 182],72,5,13585,4.038347205707491,40.0,0.0
33364,3,3364,[318 427  98 191 182],450,5,13590,4.038632986627043,40.0,0.0
33365,3,3365,[318 427  98 191 182],655,5,13595,4.038918597742128,40.0,0.0
33366,3,3366,[228  22 111 144 235],450,4,13599,4.0389070389070385,0.0,0.0
33367,3,3367,[318 427  98 191 182],18,5,13604,4.039192399049881,40.0,0.0
33368,3,3368,[180 172 185 588 191],457,5,13609,4.0394775897892545,0.0,0.0
33369,3,3369,[318 427  98 191 182],72,5,13614,4.039762611275965,40.0,0.0
33370,3,3370,[318 427  98 191 182],450,5,13619,4.040047463660635,40.0,0.0
33371,3,3371,[161 181 186 143 405],796,4,13623,4.040035587188612,0.0,0.0
33372,3,3372,[294 271 322 597  97],796,2,13625,4.039430773791877,0.0,0.0
33373,3,3373,[118 200 333 174 273],655,2,13627,4.038826318909306,0.0,0.0
33374,3,3374,[318 427  98 191 182],72,5,13632,4.0391111111111115,40.0,0.0
33375,3,3375,[318 427  98 191 182],450,5,13637,4.039395734597156,40.0,0.0
33376,3,3376,[179 265 144 276 125],436,3,13640,4.039087947882736,0.0,0.0
33377,3,3377,[318 427  98 191 182],450,5,13645,4.0393724097098875,40.0,0.0
33378,3,3378,[508 288 127 200 237],280,3,13648,4.039064812074578,0.0,20.0
33379,3,3379,[172 742 282 135 191],655,3,13651,4.0387573964497046,0.0,0.0
33380,3,3380,[ 28 183 172 483 302],655,4,13655,4.038745933155871,0.0,0.0
33381,3,3381,[318 427  98 191 182],269,5,13660,4.039030159668835,40.0,0.0
33382,3,3382,[318 427  98 191 182],18,5,13665,4.039314218149571,40.0,0.0
33383,3,3383,[318 427  98 191 182],450,5,13670,4.039598108747045,40.0,0.0
33384,3,3384,[318 427  98 191 182],796,5,13675,4.039881831610044,40.0,0.0
33385,3,3385,[318 427  98 191 182],655,5,13680,4.040165386887183,40.0,0.0
33386,3,3386,[318 427  98 191 182],796,5,13685,4.040448774726897,40.0,0.0
33387,3,3387,[318 427  98 191 182],655,5,13690,4.04073199527745,40.0,0.0
33388,3,3388,[318 427  98 191 182],796,5,13695,4.041015048686928,40.0,0.0
33389,3,3389,[318 427  98 191 182],450,5,13700,4.041297935103245,40.0,0.0
33390,3,3390,[322 294 496 300 655],450,5,13705,4.041580654674138,20.0,0.0
33391,3,3391,[318 427  98 191 182],655,5,13710,4.04186320754717,40.0,0.0
33392,3,3392,[202  79  96 181 405],23,4,13714,4.041850869437076,0.0,0.0
33393,3,3393,[211  70 135 496 175],151,5,13719,4.042133176193282,20.0,0.0
33394,3,3394,[204 228  12 265 111],655,0,13719,4.040942562592047,0.0,0.0
33395,3,3395,[318 427  98 191 182],450,5,13724,4.041224970553593,40.0,0.0
33396,3,3396,[318 427  98 191 182],450,5,13729,4.041507212246099,40.0,0.0
33397,3,3397,[ 97   8  82 588 237],577,5,13734,4.041789287816362,0.0,0.0
33398,3,3398,[318 427  98 191 182],18,5,13739,4.042071197411003,40.0,0.0
33399,3,3399,[181 196 276 678 195],504,3,13742,4.041764705882353,0.0,0.0
33400,3,3400,[195 269 273  12  56],450,4,13746,4.041752425757131,0.0,0.0
33401,3,3401,[ 22 118 588 275 655],716,4,13750,4.041740152851264,0.0,20.0
33402,3,3402,[318 427  98 191 182],269,5,13755,4.04202174551866,40.0,0.0
33403,3,3403,[318 427  98 191 182],18,5,13760,4.042303172737955,40.0,0.0
33404,3,3404,[183 301 286 269 288],344,4,13764,4.042290748898679,0.0,20.0
33405,3,3405,[318 427  98 191 182],655,5,13769,4.042571931884909,40.0,0.0
33406,3,3406,[318 427  98 191 182],655,5,13774,4.042852949809216,40.0,0.0
33407,3,3407,[318 427  98 191 182],450,5,13779,4.043133802816901,40.0,0.0
33408,3,3408,[222  98  88  96 161],655,1,13780,4.042241126430038,0.0,0.0
33409,3,3409,[125 235 597 118 742],457,3,13783,4.041935483870968,0.0,0.0
33410,3,3410,[318 427  98 191 182],450,5,13788,4.04221635883905,40.0,0.0
33411,3,3411,[508 135 515  89 111],269,3,13791,4.041910902696365,0.0,0.0
33412,3,3412,[318 427  98 191 182],72,5,13796,4.042191620275418,40.0,0.0
33413,3,3413,[172 180 215 194 471],450,5,13801,4.042472173403632,0.0,0.0
33414,3,3414,[172 151 181 173  28],885,3,13804,4.042166910688141,0.0,0.0
33415,3,3415,[187 176 222 265 322],450,4,13808,4.04215456674473,0.0,0.0
33416,3,3416,[216 275 111  97 179],786,5,13813,4.042434884401522,0.0,20.0
33417,3,3417,[ 22 185 187 216 125],796,5,13818,4.042715038033938,0.0,0.0
33418,3,3418,[ 98 588 423 121 176],457,5,13823,4.042995027785902,0.0,0.0
33419,3,3419,[  4   8   9  79 271],655,1,13824,4.042105263157895,0.0,0.0
33420,3,3420,[191  71 117 275 210],450,3,13827,4.041800643086817,0.0,20.0
33421,3,3421,[318 427  98 191 182],72,5,13832,4.04208065458796,40.0,0.0
33422,3,3422,[318 427  98 191 182],72,5,13837,4.042360502483202,40.0,0.0
33423,3,3423,[318 427  98 191 182],269,5,13842,4.042640186915888,40.0,0.0
33424,3,3424,[318 427  98 191 182],450,5,13847,4.042919708029197,40.0,0.0
33425,3,3425,[161 742  79 210 179],577,3,13850,4.0426152948044365,0.0,0.0
33426,3,3426,[318 427  98 191 182],18,5,13855,4.042894660052524,40.0,0.0
33427,3,3427,[215  22 172 322 275],796,4,13859,4.042882147024504,0.0,20.0
33428,3,3428,[288 144 322 181 180],450,4,13863,4.042869641294838,0.0,0.0
33429,3,3429,[153 318 655 125 161],593,4,13867,4.042857142857143,20.0,0.0
33430,3,3430,[318 427  98 191 182],18,5,13872,4.043136111920723,40.0,0.0
33431,3,3431,[318 427  98 191 182],796,5,13877,4.043414918414919,40.0,0.0
33432,3,3432,[121 282 568   9 357],457,5,13882,4.043693562481795,0.0,0.0
33433,3,3433,[318 427  98 191 182],450,5,13887,4.04397204426325,40.0,0.0
33434,3,3434,[318 427  98 191 182],655,5,13892,4.0442503639010186,40.0,0.0
33435,3,3435,[318 427  98 191 182],655,5,13897,4.04452852153667,40.0,0.0
33436,3,3436,[125 210 496 118  56],593,4,13901,4.044515565900495,20.0,0.0
33437,3,3437,[318 427  98 191 182],655,5,13906,4.04479348458406,40.0,0.0
33438,3,3438,[ 15   9  97 301 508],655,0,13906,4.043617330619366,0.0,0.0
33439,3,3439,[318 427  98 191 182],796,5,13911,4.043895348837209,40.0,0.0
33440,3,3440,[318 427  98 191 182],269,5,13916,4.044173205463528,40.0,0.0
33441,3,3441,[318 427  98 191 182],72,5,13921,4.044450900639164,40.0,0.0
33442,3,3442,[318 427  98 191 182],269,5,13926,4.044728434504792,40.0,0.0
33443,3,3443,[318 427  98 191 182],72,5,13931,4.045005807200929,40.0,0.0
33444,3,3444,[161 222 357 100  22],655,1,13932,4.044121915820029,0.0,20.0
33445,3,3445,[318 427  98 191 182],269,5,13937,4.044399303540336,40.0,0.0
33446,3,3446,[742 282 143 405 313],655,2,13939,4.04380620829707,0.0,0.0
33447,3,3447,[318 427  98 191 182],450,5,13944,4.044083526682135,40.0,0.0
33448,3,3448,[318 427  98 191 182],450,5,13949,4.044360684256306,40.0,0.0
33449,3,3449,[318 427  98 191 182],269,5,13954,4.04463768115942,40.0,0.0
33450,3,3450,[200 195 143 357 269],796,4,13958,4.044624746450304,0.0,0.0
33451,3,3451,[318 427  98 191 182],655,5,13963,4.044901506373117,40.0,0.0
33452,3,3452,[ 98 322 275 143 588],786,4,13967,4.044888502751231,0.0,20.0
33453,3,3453,[318 427  98 191 182],796,5,13972,4.045165026056746,40.0,0.0
33454,3,3454,[183  15  98 269 216],796,4,13976,4.045151953690304,0.0,0.0
33455,3,3455,[ 28 144  56 403  69],655,0,13976,4.043981481481482,0.0,0.0
33456,3,3456,[748 333 180 121 286],796,3,13979,4.043679490888053,0.0,20.0
33457,3,3457,[318 427  98 191 182],450,5,13984,4.043956043956044,40.0,0.0
33458,3,3458,[202 172 125 153 211],401,2,13986,4.043365134431917,0.0,0.0
33459,3,3459,[ 25 471 161 204 302],450,4,13990,4.043352601156069,0.0,0.0
33460,3,3460,[289 257 258 181  22],807,4,13994,4.043340075122797,0.0,0.0
33461,3,3461,[318 427  98 191 182],72,5,13999,4.043616406701329,40.0,0.0
33462,3,3462,[318 427  98 191 182],72,5,14004,4.043892578688998,40.0,0.0
33463,3,3463,[435   1 258 222 195],655,0,14004,4.042725173210162,0.0,0.0
33464,3,3464,[496  98 202 269  25],344,5,14009,4.043001443001443,20.0,0.0
33465,3,3465,[318 427  98 191 182],450,5,14014,4.043277553375649,40.0,0.0
33466,3,3466,[318 427  98 191 182],796,5,14019,4.043553504470724,40.0,0.0
33467,3,3467,[318 427  98 191 182],72,5,14024,4.043829296424452,40.0,0.0
33468,3,3468,[ 64 144 245 121 195],450,4,14028,4.043816661862208,20.0,0.0
33469,3,3469,[  7  22 111 121 210],344,3,14031,4.043515850144092,0.0,0.0
33470,3,3470,[318 427  98 191 182],796,5,14036,4.043791414577932,40.0,0.0
33471,3,3471,[ 70  25 121 258 385],151,4,14040,4.043778801843318,0.0,0.0
33472,3,3472,[318 427  98 191 182],72,5,14045,4.04405413187446,40.0,0.0
33473,3,3473,[318 427  98 191 182],269,5,14050,4.044329303396661,40.0,0.0
33474,3,3474,[121  82 144 301 196],796,3,14053,4.044028776978418,0.0,0.0
33475,3,3475,[111 151 245  50  71],885,3,14056,4.043728423475259,0.0,20.0
33476,3,3476,[318 427  98 191 182],269,5,14061,4.044003451251078,40.0,0.0
33477,3,3477,[318 427  98 191 182],269,5,14066,4.044278320874065,40.0,0.0
33478,3,3478,[  4 568 161  88 174],796,5,14071,4.044553032480598,0.0,0.0
33479,3,3479,[318 427  98 191 182],796,5,14076,4.044827586206897,40.0,0.0
33480,3,3480,[568 588 423  22 202],450,5,14081,4.045101982189026,0.0,0.0
33481,3,3481,[318 427  98 191 182],796,5,14086,4.045376220562895,40.0,0.0
33482,3,3482,[318 427  98 191 182],450,5,14091,4.045650301464255,40.0,0.0
33483,3,3483,[318 427  98 191 182],655,5,14096,4.045924225028703,40.0,0.0
33484,3,3484,[275 118  95  25  69],450,2,14098,4.045337159253945,0.0,20.0
33485,3,3485,[117 282 144 268 238],296,4,14102,4.045324153757889,0.0,0.0
33486,3,3486,[179 603 153 234 216],269,2,14104,4.04473759678807,20.0,0.0
33487,3,3487,[318 427  98 191 182],655,5,14109,4.045011467889908,40.0,0.0
33488,3,3488,[435   9 127 328 210],401,3,14112,4.044711951848667,0.0,20.0
33489,3,3489,[153 118 405 286 273],796,3,14115,4.044412607449857,0.0,20.0
33490,3,3490,[185 202 118 483  70],450,3,14118,4.0441134345459755,0.0,0.0
33491,3,3491,[318 427  98 191 182],269,5,14123,4.04438717067583,40.0,0.0
33492,3,3492,[318 427  98 191 182],450,5,14128,4.044660750071571,40.0,0.0
33493,3,3493,[172 196  82  50 211],450,4,14132,4.044647967945049,0.0,20.0
33494,3,3494,[172  69 195 153 121],655,1,14133,4.043776824034334,0.0,0.0
33495,3,3495,[318 427  98 191 182],18,5,14138,4.044050343249428,40.0,0.0
33496,3,3496,[357 196 286 200 300],629,5,14143,4.044323706033743,0.0,20.0
33497,3,3497,[318 427  98 191 182],18,5,14148,4.044596912521441,40.0,0.0
33498,3,3498,[286 183 117 127  97],236,3,14151,4.044298370963133,0.0,40.0
33499,3,3499,[318 427  98 191 182],450,5,14156,4.0445714285714285,40.0,0.0
33500,3,3500,[318 427  98 191 182],18,5,14161,4.044844330191374,40.0,0.0
33501,3,3501,[ 22  79 235 328 322],450,4,14165,4.044831524842947,0.0,0.0
33502,3,3502,[197 174 302 301  12],450,5,14170,4.045104196403083,0.0,0.0
33503,3,3503,[318 427  98 191 182],18,5,14175,4.045376712328767,40.0,0.0
33504,3,3504,[318 427  98 191 182],655,5,14180,4.04564907275321,40.0,0.0
33505,3,3505,[265 211  64 125 357],655,2,14182,4.045065601825442,20.0,0.0
33506,3,3506,[318 427  98 191 182],269,5,14187,4.045337895637297,40.0,0.0
33507,3,3507,[ 69 204 588 173  97],796,4,14191,4.045324971493729,0.0,0.0
33508,3,3508,[200 268 435 515 235],269,3,14194,4.04502707324024,0.0,0.0
33509,3,3509,[161 275 135 185 191],655,4,14198,4.0450142450142454,0.0,20.0
33510,3,3510,[318 427  98 191 182],269,5,14203,4.045286243235545,40.0,0.0
33511,3,3511,[ 79   1 483 318   7],655,3,14206,4.04498861047836,20.0,0.0
33512,3,3512,[328  82   9 161  56],796,3,14209,4.044691147167663,0.0,0.0
33513,3,3513,[276 161   8 294  15],457,4,14213,4.04467842914058,0.0,0.0
33514,3,3514,[318 427  98 191 182],655,5,14218,4.044950213371266,40.0,0.0
33515,3,3515,[318 427  98 191 182],72,5,14223,4.045221843003413,40.0,0.0
33516,3,3516,[318 427  98 191 182],796,5,14228,4.045493318168894,40.0,0.0
33517,3,3517,[186 318  70 172  95],885,4,14232,4.045480386583286,20.0,0.0
33518,3,3518,[245 323 181 100 282],256,4,14236,4.045467462347258,0.0,20.0
33519,3,3519,[  4 121 216 313  96],450,3,14239,4.045170454545454,0.0,0.0
33520,3,3520,[318 427  98 191 182],450,5,14244,4.045441635898892,40.0,0.0
33521,3,3521,[318 427  98 191 182],72,5,14249,4.045712663259511,40.0,0.0
33522,3,3522,[318 427  98 191 182],72,5,14254,4.0459835367584445,40.0,0.0
33523,3,3523,[318 427  98 191 182],796,5,14259,4.046254256526674,40.0,0.0
33524,3,3524,[318 427  98 191 182],796,5,14264,4.046524822695035,40.0,0.0
33525,3,3525,[318 427  98 191 182],796,5,14269,4.046795235394215,40.0,0.0
33526,3,3526,[318 427  98 191 182],796,5,14274,4.047065494754749,40.0,0.0
33527,3,3527,[318 427  98 191 182],269,5,14279,4.047335600907029,40.0,0.0
33528,3,3528,[318 427  98 191 182],269,5,14284,4.047605553981298,40.0,0.0
33529,3,3529,[318 427  98 191 182],655,5,14289,4.047875354107648,40.0,0.0
33530,3,3530,[318 427  98 191 182],450,5,14294,4.04814500141603,40.0,0.0
33531,3,3531,[276 405 742  82 300],655,1,14295,4.047281993204983,0.0,0.0
33532,3,3532,[318 427  98 191 182],796,5,14300,4.047551655816586,40.0,0.0
33533,3,3533,[ 22 175 286 301 597],11,3,14303,4.047255234861347,0.0,20.0
33534,3,3534,[318 427  98 191 182],796,5,14308,4.047524752475248,40.0,0.0
33535,3,3535,[318 427  98 191 182],72,5,14313,4.047794117647059,40.0,0.0
33536,3,3536,[318 427  98 191 182],450,5,14318,4.0480633305060785,40.0,0.0
33537,3,3537,[318 427  98 191 182],269,5,14323,4.048332391181458,40.0,0.0
33538,3,3538,[318 427  98 191 182],655,5,14328,4.048601299802204,40.0,0.0
33539,3,3539,[318 427  98 191 182],72,5,14333,4.048870056497175,40.0,0.0
33540,3,3540,[294 300  50  11 210],716,5,14338,4.049138661395086,0.0,20.0
33541,3,3541,[ 96 237  88 168 111],716,4,14342,4.049124788255223,0.0,0.0
33542,3,3542,[318 427  98 191 182],18,5,14347,4.049393169630257,40.0,0.0
33543,3,3543,[286 282 196   9 143],401,2,14349,4.048814898419865,0.0,20.0
33544,3,3544,[318 427  98 191 182],269,5,14354,4.049083215796897,40.0,0.0
33545,3,3545,[144 161  12 294 282],280,2,14356,4.048505358150028,0.0,0.0
33546,3,3546,[234 216 181 275  98],796,4,14360,4.0484916831124895,0.0,20.0
33547,3,3547,[318 427  98 191 182],269,5,14365,4.0487598647125145,40.0,0.0
33548,3,3548,[318 427  98 191 182],655,5,14370,4.049027895181742,40.0,0.0
33549,3,3549,[318 427  98 191 182],796,5,14375,4.049295774647887,40.0,0.0
33550,3,3550,[318 427  98 191 182],269,5,14380,4.049563503238525,40.0,0.0
33551,3,3551,[180 294 125 100 275],457,4,14384,4.04954954954955,0.0,40.0
33552,3,3552,[318 427  98 191 182],655,5,14389,4.049817056009006,40.0,0.0
33553,3,3553,[  1 168 143 118 258],796,4,14393,4.049803038829488,0.0,0.0
33554,3,3554,[257  25  64 181 471],655,1,14394,4.048945147679325,20.0,0.0
33555,3,3555,[357 210 508  69 237],344,3,14397,4.0486501687289085,0.0,0.0
33556,3,3556,[176  50  79  95 300],796,5,14402,4.048917627213944,0.0,20.0
33557,3,3557,[204 191 282 194  50],457,5,14407,4.0491849353569425,0.0,20.0
33558,3,3558,[318 427  98 191 182],269,5,14412,4.04945209328463,40.0,0.0
33559,3,3559,[318 427  98 191 182],18,5,14417,4.049719101123595,40.0,0.0
33560,3,3560,[318 427  98 191 182],72,5,14422,4.0499859590002805,40.0,0.0
33561,3,3561,[318 427  98 191 182],655,5,14427,4.050252667040988,40.0,0.0
33562,3,3562,[118 196 125  71 302],450,3,14430,4.0499579006455235,0.0,0.0
33563,3,3563,[288 294  25 427  82],655,1,14431,4.049102132435466,20.0,0.0
33564,3,3564,[174 475 655 435  11],655,0,14431,4.04796633941094,0.0,0.0
33565,3,3565,[318 427  98 191 182],450,5,14436,4.04823331463825,40.0,0.0
33566,3,3566,[215 176 271 282   9],796,4,14440,4.048219792542753,0.0,0.0
33567,3,3567,[153  12 202 183 271],655,1,14441,4.047365470852018,0.0,0.0
33568,3,3568,[ 50 117   8 258   9],655,1,14442,4.046511627906977,0.0,20.0
33569,3,3569,[318 427  98 191 182],796,5,14447,4.046778711484594,40.0,0.0
33570,3,3570,[318 427  98 191 182],655,5,14452,4.047045645477457,40.0,0.0
33571,3,3571,[318 427  98 191 182],796,5,14457,4.047312430011198,40.0,0.0
33572,3,3572,[ 25 302 385 294 144],450,4,14461,4.0472991883571225,0.0,0.0
33573,3,3573,[318 427  98 191 182],72,5,14466,4.047565752658087,40.0,0.0
33574,3,3574,[475 508  96 200 185],269,4,14470,4.047552447552447,0.0,0.0
33575,3,3575,[215  28 153 118 211],151,2,14472,4.046979865771812,0.0,0.0
33576,3,3576,[288  98 237 286   9],280,4,14476,4.046966731898239,0.0,20.0
33577,3,3577,[ 11   9 153  64  22],655,1,14477,4.046115148127446,20.0,0.0
33578,3,3578,[117 118 175 173  50],344,3,14480,4.045822855546242,0.0,20.0
33579,3,3579,[357  70 405 210  71],450,3,14483,4.045530726256983,0.0,0.0
33580,3,3580,[196 265 328 172   4],629,3,14486,4.045238760122871,0.0,0.0
33581,3,3581,[313 655  11 111 143],577,3,14489,4.044946957007259,0.0,0.0
33582,3,3582,[318 427  98 191 182],796,5,14494,4.045213508233324,40.0,0.0
33583,3,3583,[318 427  98 191 182],796,5,14499,4.045479910714286,40.0,0.0
33584,3,3584,[265 172 210  11  69],450,4,14503,4.045467224546722,0.0,0.0
33585,3,3585,[318 427  98 191 182],72,5,14508,4.045733407696598,40.0,0.0
33586,3,3586,[318 427  98 191 182],655,5,14513,4.045999442431,40.0,0.0
33587,3,3587,[588 173 202 235 210],401,2,14515,4.045429208472687,0.0,0.0
33588,3,3588,[181 603   1  56 215],535,3,14518,4.045137921426581,20.0,0.0
33589,3,3589,[318 427  98 191 182],796,5,14523,4.045403899721449,40.0,0.0
33590,3,3590,[318 427  98 191 182],18,5,14528,4.045669729880256,40.0,0.0
33591,3,3591,[318 427  98 191 182],18,5,14533,4.045935412026726,40.0,0.0
33592,3,3592,[318 427  98 191 182],269,5,14538,4.046200946284442,40.0,0.0
33593,3,3593,[318 403 187 118  50],504,1,14539,4.045353366722315,20.0,20.0
33594,3,3594,[318 427  98 191 182],269,5,14544,4.045618915159944,40.0,0.0
33595,3,3595,[318 427  98 191 182],269,5,14549,4.045884315906563,40.0,0.0
33596,3,3596,[423  22  82 117   8],655,0,14549,4.044759521823742,0.0,0.0
33597,3,3597,[318 427  98 191 182],796,5,14554,4.045025013896609,40.0,0.0
33598,3,3598,[318 427  98 191 182],72,5,14559,4.045290358432898,40.0,0.0
33599,3,3599,[318 427  98 191 182],269,5,14564,4.045555555555556,40.0,0.0
33600,3,3600,[ 70 678  97  96 655],504,4,14568,4.045542904748681,0.0,0.0
33601,3,3601,[423 265 323  88 568],280,2,14570,4.044975013881177,0.0,0.0
33602,3,3602,[318 427  98 191 182],18,5,14575,4.045240077713017,40.0,0.0
33603,3,3603,[318 427  98 191 182],450,5,14580,4.04550499445061,40.0,0.0
33604,3,3604,[202 118  50 183 237],504,0,14580,4.044382801664355,0.0,20.0
33605,3,3605,[204 471 185 286  64],450,5,14585,4.044647809206878,20.0,20.0
33606,3,3606,[245 405  89  64 282],256,4,14589,4.044635431106182,20.0,0.0
33607,3,3607,[318 427  98 191 182],450,5,14594,4.04490022172949,40.0,0.0
33608,3,3608,[318 427  98 191 182],18,5,14599,4.045164865613743,40.0,0.0
33609,3,3609,[186 202 204  82 183],450,3,14602,4.044875346260388,0.0,0.0
33610,3,3610,[175 210 121  97 202],655,0,14602,4.043755192467461,0.0,0.0
33611,3,3611,[318 427  98 191 182],18,5,14607,4.044019933554817,40.0,0.0
33612,3,3612,[318 427  98 191 182],796,5,14612,4.044284528092997,40.0,0.0
33613,3,3613,[318 427  98 191 182],796,5,14617,4.044548976203653,40.0,0.0
33614,3,3614,[318 427  98 191 182],269,5,14622,4.044813278008299,40.0,0.0
33615,3,3615,[318 427  98 191 182],796,5,14627,4.045077433628318,40.0,0.0
33616,3,3616,[238 135  28 222 271],655,1,14628,4.04423555432679,0.0,0.0
33617,3,3617,[318 427  98 191 182],450,5,14633,4.0444997236042015,40.0,0.0
33618,3,3618,[318 427  98 191 182],450,5,14638,4.044763746891406,40.0,0.0
33619,3,3619,[385 245  69 271 222],796,4,14642,4.04475138121547,0.0,0.0
33620,3,3620,[546  69 100 655  71],593,3,14645,4.0444628555647615,0.0,20.0
33621,3,3621,[181 125 237 132 301],450,5,14650,4.044726670347874,0.0,0.0
33622,3,3622,[318 427  98 191 182],796,5,14655,4.044990339497654,40.0,0.0
33623,3,3623,[ 28  95 423 333 655],796,3,14658,4.0447019867549665,0.0,0.0
33624,3,3624,[515 195  95 174 200],716,4,14662,4.044689655172414,0.0,0.0
33625,3,3625,[282  12  22  70 215],457,5,14667,4.044953116381688,0.0,0.0
33626,3,3626,[322  95 282 357  97],796,3,14670,4.044665012406948,0.0,0.0
33627,3,3627,[118 143 117 234  71],593,4,14674,4.044652701212789,0.0,0.0
33628,3,3628,[318 427  98 191 182],72,5,14679,4.044915954808487,40.0,0.0
33629,3,3629,[273  69 288  96 111],344,4,14683,4.044903581267218,0.0,0.0
33630,3,3630,[ 97 471 357 300  88],450,5,14688,4.045166620765629,0.0,0.0
33631,3,3631,[210 179 182 173 471],535,4,14692,4.045154185022026,0.0,0.0
33632,3,3632,[194 568  98  71 257],798,3,14695,4.0448665015139005,0.0,0.0
33633,3,3633,[ 97 185 135 403  28],330,4,14699,4.0448541552008805,0.0,0.0
33634,3,3634,[597 275  15 176 245],796,4,14703,4.04484181568088,0.0,20.0
33635,3,3635,[ 82 210  25 294 151],256,4,14707,4.044829482948295,0.0,0.0
33636,3,3636,[318 427  98 191 182],269,5,14712,4.0450921088809455,40.0,0.0
33637,3,3637,[655 132 183 191 301],796,3,14715,4.04480483782298,0.0,0.0
33638,3,3638,[568 258 322 245 748],450,5,14720,4.045067326188513,0.0,0.0
33639,3,3639,[318 427  98 191 182],269,5,14725,4.045329670329671,40.0,0.0
33640,3,3640,[202 234 483 180 276],280,3,14728,4.045042570722329,0.0,0.0
33641,3,3641,[318  88  15 385 228],577,2,14730,4.0444810543657335,20.0,0.0
33642,3,3642,[ 79 275  71 196 301],535,4,14734,4.044468844359045,0.0,20.0
33643,3,3643,[318 427  98 191 182],796,5,14739,4.044731064763996,40.0,0.0
33644,3,3644,[318 427  98 191 182],269,5,14744,4.044993141289438,40.0,0.0
33645,3,3645,[318 427  98 191 182],655,5,14749,4.045255074053758,40.0,0.0
33646,3,3646,[179 286 405  50 257],655,2,14751,4.044694269262408,0.0,40.0
33647,3,3647,[318 427  98 191 182],655,5,14756,4.044956140350878,40.0,0.0
33648,3,3648,[216 302  15   4  70],151,4,14760,4.044943820224719,0.0,0.0
33649,3,3649,[357 471 273 127  96],344,4,14764,4.0449315068493155,0.0,20.0
33650,3,3650,[143 202 200 423 655],457,5,14769,4.045193097781429,0.0,0.0
33651,3,3651,[318 427  98 191 182],655,5,14774,4.045454545454546,40.0,0.0
33652,3,3652,[603  15 194 191 294],450,4,14778,4.045442102381604,20.0,0.0
33653,3,3653,[318 427  98 191 182],796,5,14783,4.045703338806787,40.0,0.0
33654,3,3654,[238 204 275 237   8],330,5,14788,4.045964432284542,0.0,20.0
33655,3,3655,[265 257 151  97  25],716,5,14793,4.046225382932167,0.0,0.0
33656,3,3656,[ 56 234 117 300 121],693,2,14795,4.045665846322122,0.0,0.0
33657,3,3657,[300 118 237   7  25],938,3,14798,4.045379989065063,0.0,0.0
33658,3,3658,[318 427  98 191 182],796,5,14803,4.045640885487838,40.0,0.0
33659,3,3659,[318 427  98 191 182],655,5,14808,4.045901639344263,40.0,0.0
33660,3,3660,[568 588  82 385 210],457,5,14813,4.046162250751161,0.0,0.0
33661,3,3661,[318 427  98 191 182],18,5,14818,4.046422719825232,40.0,0.0
33662,3,3662,[135  96  88  12 127],457,5,14823,4.046683046683047,0.0,20.0
33663,3,3663,[117 515 204 181  97],72,4,14827,4.046670305676856,0.0,0.0
33664,3,3664,[313 328 161 471  98],450,5,14832,4.046930422919509,0.0,0.0
33665,3,3665,[118  89  69 333  96],655,1,14833,4.046099290780142,0.0,0.0
33666,3,3666,[153 181 237 245 215],450,5,14838,4.046359421870739,0.0,0.0
33667,3,3667,[202 125 111  88 228],280,1,14839,4.045528898582334,0.0,0.0
33668,3,3668,[322 222   1  95 195],280,3,14842,4.045243935677297,0.0,0.0
33669,3,3669,[318 427  98 191 182],269,5,14847,4.045504087193461,40.0,0.0
33670,3,3670,[318 427  98 191 182],655,5,14852,4.045764096976301,40.0,0.0
33671,3,3671,[191 234   7 117 172],693,2,14854,4.04520697167756,0.0,0.0
33672,3,3672,[  4 121  56 265 301],655,0,14854,4.04410563572012,0.0,0.0
33673,3,3673,[318 427  98 191 182],18,5,14859,4.044365813826892,40.0,0.0
33674,3,3674,[151 127  97   1 275],401,2,14861,4.043809523809524,0.0,40.0
33675,3,3675,[ 89 121 357 322 200],151,3,14864,4.043525571273123,0.0,0.0
33676,3,3676,[ 25  56 215  50 313],655,2,14866,4.042969812347022,0.0,20.0
33677,3,3677,[318 427  98 191 182],72,5,14871,4.043230016313213,40.0,0.0
33678,3,3678,[318 427  98 191 182],655,5,14876,4.0434900788257675,40.0,0.0
33679,3,3679,[174 435  22  69 238],655,0,14876,4.042391304347826,0.0,0.0
33680,3,3680,[313 187 357 655 174],450,5,14881,4.0426514534094,0.0,0.0
33681,3,3681,[318 427  98 191 182],72,5,14886,4.0429114611624115,40.0,0.0
33682,3,3682,[318 427  98 191 182],72,5,14891,4.043171327721966,40.0,0.0
33683,3,3683,[117 176 318  97 174],236,2,14893,4.0426167209554835,20.0,0.0
33684,3,3684,[318 427  98 191 182],655,5,14898,4.042876526458616,40.0,0.0
33685,3,3685,[318 427  98 191 182],450,5,14903,4.043136190992946,40.0,0.0
33686,3,3686,[318 427  98 191 182],450,5,14908,4.043395714673176,40.0,0.0
33687,3,3687,[288  97 121 235  98],450,2,14910,4.042841648590022,0.0,0.0
33688,3,3688,[  4 173 202 215  28],457,5,14915,4.043101111412307,0.0,0.0
33689,3,3689,[318 427  98 191 182],655,5,14920,4.043360433604336,40.0,0.0
33690,3,3690,[ 88 118 125  56   4],504,2,14922,4.042806827418044,0.0,0.0
33691,3,3691,[318 427  98 191 182],450,5,14927,4.043066088840737,40.0,0.0
33692,3,3692,[318 427  98 191 182],796,5,14932,4.043325209856485,40.0,0.0
33693,3,3693,[ 12 210  11  70 471],450,4,14936,4.043313481321062,0.0,0.0
33694,3,3694,[181 655 210 173  88],885,3,14939,4.043031123139378,0.0,0.0
33695,3,3695,[333 238 234 435   7],629,4,14943,4.04301948051948,0.0,0.0
33696,3,3696,[318 427  98 191 182],450,5,14948,4.04327833378415,40.0,0.0
33697,3,3697,[318 427  98 191 182],269,5,14953,4.043537047052461,40.0,0.0
33698,3,3698,[496 111 187 483 238],716,4,14957,4.043525277101919,20.0,0.0
33699,3,3699,[273 318 597 282 100],796,3,14960,4.043243243243243,20.0,20.0
33700,3,3700,[ 95   4 546 427 153],450,3,14963,4.042961361794109,20.0,0.0
33701,3,3701,[318 427  98 191 182],72,5,14968,4.043219881145327,40.0,0.0
33702,3,3702,[181  88 603 235  96],450,4,14972,4.0432082095598165,20.0,0.0
33703,3,3703,[318 427  98 191 182],450,5,14977,4.043466522678186,40.0,0.0
33704,3,3704,[318 427  98 191 182],796,5,14982,4.043724696356275,40.0,0.0
33705,3,3705,[143 161  98   4  69],593,5,14987,4.043982730706961,0.0,0.0
33706,3,3706,[195  69 245 258 568],344,2,14989,4.043431346101969,0.0,0.0
33707,3,3707,[318 427  98 191 182],269,5,14994,4.043689320388349,40.0,0.0
33708,3,3708,[318 427  98 191 182],269,5,14999,4.043947155567539,40.0,0.0
33709,3,3709,[318 427  98 191 182],72,5,15004,4.0442048517520215,40.0,0.0
33710,3,3710,[ 98 357 174 176 385],716,3,15007,4.043923470762597,0.0,0.0
33711,3,3711,[318 427  98 191 182],450,5,15012,4.044181034482759,40.0,0.0
33712,3,3712,[132 258 161 173 195],796,5,15017,4.044438459466739,0.0,0.0
33713,3,3713,[318 427  98 191 182],655,5,15022,4.044695745826602,40.0,0.0
33714,3,3714,[318 427  98 191 182],796,5,15027,4.044952893674293,40.0,0.0
33715,3,3715,[318 427  98 191 182],72,5,15032,4.045209903121636,40.0,0.0
33716,3,3716,[318 427  98 191 182],269,5,15037,4.045466774280333,40.0,0.0
33717,3,3717,[185  56 742 111 508],11,4,15041,4.045454545454546,0.0,0.0
33718,3,3718,[318 427  98 191 182],269,5,15046,4.045711212691584,40.0,0.0
33719,3,3719,[196  97 385 173 568],577,4,15050,4.045698924731183,0.0,0.0
33720,3,3720,[216 313   9 508   1],655,2,15052,4.045149153453373,0.0,0.0
33721,3,3721,[ 71 210 318 357 288],450,2,15054,4.044599677592692,20.0,0.0
33722,3,3722,[118   9 132 215 127],457,5,15059,4.044856298683857,0.0,20.0
33723,3,3723,[318 427  98 191 182],655,5,15064,4.045112781954887,40.0,0.0
33724,3,3724,[323 300 301 161   9],796,2,15066,4.044563758389262,0.0,0.0
33725,3,3725,[318 427  98 191 182],655,5,15071,4.044820182501342,40.0,0.0
33726,3,3726,[318 427  98 191 182],72,5,15076,4.045076469009928,40.0,0.0
33727,3,3727,[195  11  82 135 117],655,1,15077,4.04425965665236,0.0,0.0
33728,3,3728,[318 427  98 191 182],655,5,15082,4.044515956020381,40.0,0.0
33729,3,3729,[200  71 245 568  15],796,4,15086,4.044504021447721,0.0,0.0
33730,3,3730,[318 427  98 191 182],450,5,15091,4.044760117930849,40.0,0.0
33731,3,3731,[ 56 111 568 403 405],457,4,15095,4.044748124330118,0.0,0.0
33732,3,3732,[318 427  98 191 182],450,5,15100,4.045004018215912,40.0,0.0
33733,3,3733,[183 111 202 143  79],655,3,15103,4.044724156400643,0.0,0.0
33734,3,3734,[ 25 117 276 282 181],277,4,15107,4.04471218206158,0.0,0.0
33735,3,3735,[318 427  98 191 182],655,5,15112,4.044967880085653,40.0,0.0
33736,3,3736,[153 175  56 200 313],655,2,15114,4.044420658282045,0.0,0.0
33737,3,3737,[318 427  98 191 182],269,5,15119,4.044676297485286,40.0,0.0
33738,3,3738,[318 427  98 191 182],72,5,15124,4.04493179994651,40.0,0.0
33739,3,3739,[318 427  98 191 182],796,5,15129,4.045187165775401,40.0,0.0
33740,3,3740,[276 195  98 333  70],655,2,15131,4.0446404704624435,0.0,0.0
33741,3,3741,[318 427  98 191 182],450,5,15136,4.044895777659006,40.0,0.0
33742,3,3742,[289  97   7 202 121],786,4,15140,4.0448837830617155,0.0,0.0
33743,3,3743,[313 271 215 483 186],796,4,15144,4.044871794871795,0.0,0.0
33744,3,3744,[318 427  98 191 182],269,5,15149,4.0451268357810415,40.0,0.0
33745,3,3745,[318 427  98 191 182],269,5,15154,4.045381740523225,40.0,0.0
33746,3,3746,[234 174  12 471   4],256,5,15159,4.045636509207366,0.0,0.0
33747,3,3747,[ 89 215 100   4  64],796,4,15163,4.045624332977588,20.0,20.0
33748,3,3748,[ 22 294 216 471 300],450,5,15168,4.045878901040277,0.0,0.0
33749,3,3749,[318 427  98 191 182],796,5,15173,4.046133333333334,40.0,0.0
33750,3,3750,[237 111 228  97 132],796,4,15177,4.046121034390829,0.0,0.0
33751,3,3751,[318 427  98 191 182],72,5,15182,4.04637526652452,40.0,0.0
33752,3,3752,[318 427  98 191 182],450,5,15187,4.046629363176126,40.0,0.0
33753,3,3753,[318 427  98 191 182],796,5,15192,4.0468833244539155,40.0,0.0
33754,3,3754,[318 427  98 191 182],655,5,15197,4.047137150466045,40.0,0.0
33755,3,3755,[ 79 471  98 588  25],457,5,15202,4.047390841320554,0.0,0.0
33756,3,3756,[  4 151 385 173 496],151,4,15206,4.047378227309023,20.0,0.0
33757,3,3757,[318 427  98 191 182],18,5,15211,4.047631718999468,40.0,0.0
33758,3,3758,[  4 216 121   7 546],256,5,15216,4.047885075818037,0.0,0.0
33759,3,3759,[496 200 216 655  79],716,5,15221,4.048138297872341,20.0,0.0
33760,3,3760,[301 111 179 385 132],450,5,15226,4.048391385269875,0.0,0.0
33761,3,3761,[318 427  98 191 182],796,5,15231,4.048644338118022,40.0,0.0
33762,3,3762,[318 427  98 191 182],450,5,15236,4.04889715652405,40.0,0.0
33763,3,3763,[318 427  98 191 182],72,5,15241,4.049149840595112,40.0,0.0
33764,3,3764,[318 427  98 191 182],655,5,15246,4.049402390438247,40.0,0.0
33765,3,3765,[318 427  98 191 182],796,5,15251,4.049654806160382,40.0,0.0
33766,3,3766,[ 96 132  11  79 197],457,5,15256,4.0499070878683305,0.0,0.0
33767,3,3767,[235 423 151  79 435],5,3,15259,4.049628450106157,0.0,0.0
33768,3,3768,[318 427  98 191 182],796,5,15264,4.049880604934996,40.0,0.0
33769,3,3769,[318 427  98 191 182],269,5,15269,4.050132625994695,40.0,0.0
33770,3,3770,[301  56 742 423 125],450,5,15274,4.050384513391673,0.0,0.0
33771,3,3771,[143 144 385  71 655],450,4,15278,4.050371155885472,0.0,0.0
33772,3,3772,[300  56 176 265 245],450,5,15283,4.050622846541214,0.0,0.0
33773,3,3773,[403 271 204 100 483],796,4,15287,4.050609432962374,0.0,20.0
33774,3,3774,[210 568  97  11 181],655,0,15287,4.04953642384106,0.0,0.0
33775,3,3775,[286 186  15 117 168],796,3,15290,4.049258474576271,0.0,20.0
33776,3,3776,[318 427  98 191 182],18,5,15295,4.049510193275086,40.0,0.0
33777,3,3777,[222 161 300 204   7],450,4,15299,4.049497088406564,0.0,0.0
33778,3,3778,[318 427  98 191 182],18,5,15304,4.049748610743583,40.0,0.0
33779,3,3779,[318 427  98 191 182],269,5,15309,4.05,40.0,0.0
33780,3,3780,[318 427  98 191 182],655,5,15314,4.050251256281407,40.0,0.0
33781,3,3781,[318 427  98 191 182],72,5,15319,4.050502379693284,40.0,0.0
33782,3,3782,[257  56 269 174 211],655,0,15319,4.049431667988369,0.0,0.0
33783,3,3783,[546   4 210 275 204],716,3,15322,4.049154334038055,0.0,20.0
33784,3,3784,[318 427  98 191 182],18,5,15327,4.049405548216645,40.0,0.0
33785,3,3785,[318 427  98 191 182],269,5,15332,4.049656629688325,40.0,0.0
33786,3,3786,[318 427  98 191 182],796,5,15337,4.0499075785582255,40.0,0.0
33787,3,3787,[318 427  98 191 182],269,5,15342,4.050158394931362,40.0,0.0
33788,3,3788,[318 427  98 191 182],796,5,15347,4.050409078912642,40.0,0.0
33789,3,3789,[318 427  98 191 182],18,5,15352,4.0506596306068605,40.0,0.0
33790,3,3790,[318 427  98 191 182],18,5,15357,4.050910050118702,40.0,0.0
33791,3,3791,[405  82 427 197 173],450,4,15361,4.050896624472574,20.0,0.0
33792,3,3792,[318 427  98 191 182],18,5,15366,4.05114684945953,40.0,0.0
33793,3,3793,[ 64  28  69 176  95],450,4,15370,4.051133368476542,20.0,0.0
33794,3,3794,[318 427  98 191 182],269,5,15375,4.051383399209486,40.0,0.0
33795,3,3795,[318 427  98 191 182],269,5,15380,4.051633298208641,40.0,0.0
33796,3,3796,[121 423 175  82 275],457,5,15385,4.051883065578088,0.0,20.0
33797,3,3797,[176 234 273 301  69],796,2,15387,4.051342812006319,0.0,0.0
33798,3,3798,[318 427  98 191 182],72,5,15392,4.0515925243485125,40.0,0.0
33799,3,3799,[603 144 222 173 403],796,5,15397,4.051842105263158,20.0,0.0
33800,3,3800,[161 276 132 191 196],786,4,15401,4.051828466193107,0.0,0.0
33801,3,3801,[318 427  98 191 182],655,5,15406,4.052077853761178,40.0,0.0
33802,3,3802,[210 742 234 237 204],577,3,15409,4.051801209571391,0.0,0.0
33803,3,3803,[318 427  98 191 182],655,5,15414,4.05205047318612,40.0,0.0
33804,3,3804,[211  98 132 176 228],796,4,15418,4.05203679369251,0.0,0.0
33805,3,3805,[ 12 265   7 211  70],450,5,15423,4.052285864424593,0.0,0.0
33806,3,3806,[118 323 144 127 273],796,3,15426,4.052009456264775,0.0,20.0
33807,3,3807,[318 427  98 191 182],655,5,15431,4.0522584033613445,40.0,0.0
33808,3,3808,[121 405 200 125 117],655,1,15432,4.0514570753478605,0.0,0.0
33809,3,3809,[282 121  97 216  22],256,4,15436,4.051443569553806,0.0,0.0
33810,3,3810,[318 427  98 191 182],269,5,15441,4.051692469168198,40.0,0.0
33811,3,3811,[318 427  98 191 182],796,5,15446,4.051941238195173,40.0,0.0
33812,3,3812,[385 742  98 228 268],655,1,15447,4.051140833988985,0.0,0.0
33813,3,3813,[196  69 403 294 568],457,4,15451,4.051127425275301,0.0,0.0
33814,3,3814,[  1 121  96 125  11],655,0,15451,4.0500655307994755,0.0,0.0
33815,3,3815,[333 143 183  71 258],796,5,15456,4.050314465408805,0.0,0.0
33816,3,3816,[216 179 121 200 286],655,3,15459,4.050039297877914,0.0,20.0
33817,3,3817,[603 187  89   7  70],72,3,15462,4.049764274489261,20.0,0.0
33818,3,3818,[318 427  98 191 182],655,5,15467,4.050013092432574,40.0,0.0
33819,3,3819,[215  22 183 496 235],280,3,15470,4.049738219895288,20.0,0.0
33820,3,3820,[228 313  70 197 187],655,2,15472,4.049201779638838,0.0,0.0
33821,3,3821,[318 427  98 191 182],269,5,15477,4.049450549450549,40.0,0.0
33822,3,3822,[313 238  89 385  11],450,5,15482,4.049699189118494,0.0,0.0
33823,3,3823,[100 742   7 172  82],577,4,15486,4.049686192468619,0.0,20.0
33824,3,3824,[182  82 258 300 546],450,4,15490,4.049673202614379,0.0,0.0
33825,3,3825,[ 82 282 222  98  12],280,2,15492,4.049137480397282,0.0,0.0
33826,3,3826,[318 427  98 191 182],18,5,15497,4.049385941991115,40.0,0.0
33827,3,3827,[318 427  98 191 182],18,5,15502,4.049634273772205,40.0,0.0
33828,3,3828,[385 186 204  98 185],716,3,15505,4.049360146252285,0.0,0.0
33829,3,3829,[  9  96 118 282 211],693,2,15507,4.048825065274151,0.0,0.0
33830,3,3830,[318 427  98 191 182],796,5,15512,4.049073348995041,40.0,0.0
33831,3,3831,[318 427  98 191 182],18,5,15517,4.049321503131524,40.0,0.0
33832,3,3832,[318 427  98 191 182],796,5,15522,4.0495695277850245,40.0,0.0
33833,3,3833,[318 427  98 191 182],450,5,15527,4.04981742305686,40.0,0.0
33834,3,3834,[187 216 471 202 173],716,3,15530,4.049543676662321,0.0,0.0
33835,3,3835,[318 427  98 191 182],18,5,15535,4.049791449426486,40.0,0.0
33836,3,3836,[151 215 204  50  56],151,4,15539,4.0497784727651815,0.0,20.0
33837,3,3837,[318 427  98 191 182],18,5,15544,4.050026055237103,40.0,0.0
33838,3,3838,[318 427  98 191 182],450,5,15549,4.050273508726231,40.0,0.0
33839,3,3839,[318 427  98 191 182],18,5,15554,4.050520833333334,40.0,0.0
33840,3,3840,[318 427  98 191 182],269,5,15559,4.050768029159073,40.0,0.0
33841,3,3841,[318 427  98 191 182],269,5,15564,4.051015096304008,40.0,0.0
33842,3,3842,[318 427  98 191 182],450,5,15569,4.051262034868592,40.0,0.0
33843,3,3843,[318 427  98 191 182],269,5,15574,4.051508844953174,40.0,0.0
33844,3,3844,[423 211 282 322  88],504,4,15578,4.05149544863459,0.0,0.0
33845,3,3845,[385 568 322 546 216],593,3,15581,4.0512220488819555,0.0,0.0
33846,3,3846,[181 161 288 117 210],655,0,15581,4.050168962828177,0.0,0.0
33847,3,3847,[318 427  98 191 182],655,5,15586,4.0504158004158,40.0,0.0
33848,3,3848,[318 427  98 191 182],450,5,15591,4.05066250974279,40.0,0.0
33849,3,3849,[385   7 121 127 161],256,5,15596,4.050909090909091,0.0,20.0
33850,3,3850,[186 276 127  88  82],457,5,15601,4.0511555440145415,0.0,20.0
33851,3,3851,[318 427  98 191 182],18,5,15606,4.0514018691588785,40.0,0.0
33852,3,3852,[ 25 237 286 100 276],401,3,15609,4.0511289903970935,0.0,40.0
33853,3,3853,[  8 483  70 588 318],457,5,15614,4.051375194603009,20.0,0.0
33854,3,3854,[204  89 238 144 222],23,3,15617,4.051102464332036,0.0,0.0
33855,3,3855,[318 427  98 191 182],655,5,15622,4.051348547717843,40.0,0.0
33856,3,3856,[265 322 235 228 655],280,3,15625,4.05107596577651,0.0,0.0
33857,3,3857,[ 69 185 237 748 357],796,5,15630,4.051321928460342,0.0,0.0
33858,3,3858,[144 181 121  11 275],296,5,15635,4.051567763669344,0.0,20.0
33859,3,3859,[172 301 508  15 222],655,1,15636,4.050777202072539,0.0,0.0
33860,3,3860,[275 276 403 175 144],655,2,15638,4.0502460502460504,0.0,20.0
33861,3,3861,[318 427  98 191 182],18,5,15643,4.050491973070947,40.0,0.0
33862,3,3862,[175 678  64 121  88],344,2,15645,4.049961170075071,20.0,0.0
33863,3,3863,[ 12 186 176 172  71],796,4,15649,4.049948240165631,0.0,0.0
33864,3,3864,[180 175   9 276 475],269,4,15653,4.04993531694696,0.0,0.0
33865,3,3865,[245 603 151 111 742],756,3,15656,4.049663735126746,20.0,0.0
33866,3,3866,[318 427  98 191 182],72,5,15661,4.049909490561158,40.0,0.0
33867,3,3867,[135 215 179 151 195],535,4,15665,4.049896587383661,0.0,0.0
33868,3,3868,[318 427  98 191 182],72,5,15670,4.050142155595761,40.0,0.0
33869,3,3869,[318 427  98 191 182],269,5,15675,4.050387596899225,40.0,0.0
33870,3,3870,[210   7  69  95 423],577,3,15678,4.050116249031258,0.0,0.0
33871,3,3871,[318 427  98 191 182],269,5,15683,4.050361570247934,40.0,0.0
33872,3,3872,[318 427  98 191 182],450,5,15688,4.050606764781823,40.0,0.0
33873,3,3873,[318 427  98 191 182],450,5,15693,4.050851832731027,40.0,0.0
33874,3,3874,[318 427  98 191 182],72,5,15698,4.051096774193549,40.0,0.0
33875,3,3875,[318 427  98 191 182],72,5,15703,4.0513415892672855,40.0,0.0
33876,3,3876,[318 427  98 191 182],796,5,15708,4.0515862780500385,40.0,0.0
33877,3,3877,[678  82 143 174 257],807,4,15712,4.051572975760702,0.0,0.0
33878,3,3878,[100 179 117  12 200],655,2,15714,4.0510440835266825,0.0,20.0
33879,3,3879,[151 187 475 143 132],389,4,15718,4.051030927835051,0.0,0.0
33880,3,3880,[211  88 238 143 173],593,5,15723,4.051275444473074,0.0,0.0
33881,3,3881,[ 56 435   8 237 427],11,5,15728,4.051519835136528,20.0,0.0
33882,3,3882,[318 427  98 191 182],450,5,15733,4.05176409992274,40.0,0.0
33883,3,3883,[318 427  98 191 182],18,5,15738,4.05200823892894,40.0,0.0
33884,3,3884,[318 427  98 191 182],655,5,15743,4.052252252252252,40.0,0.0
33885,3,3885,[318 427  98 191 182],655,5,15748,4.052496139989707,40.0,0.0
33886,3,3886,[357 180 237   8 385],796,4,15752,4.052482634422434,0.0,0.0
33887,3,3887,[318 427  98 191 182],655,5,15757,4.05272633744856,40.0,0.0
33888,3,3888,[318 427  98 191 182],269,5,15762,4.052969915145281,40.0,0.0
33889,3,3889,[318 427  98 191 182],18,5,15767,4.0532133676092545,40.0,0.0
33890,3,3890,[318 427  98 191 182],269,5,15772,4.053456694937034,40.0,0.0
33891,3,3891,[318 427  98 191 182],18,5,15777,4.053699897225077,40.0,0.0
33892,3,3892,[300 471 294 204 235],716,3,15780,4.053429231954791,0.0,0.0
33893,3,3893,[300 144 258 357  79],655,2,15782,4.052901900359528,0.0,0.0
33894,3,3894,[237 423 118 273 748],796,4,15786,4.052888318356867,0.0,0.0
33895,3,3895,[318 427  98 191 182],655,5,15791,4.0531314168377826,40.0,0.0
33896,3,3896,[237 182 423 322 191],450,5,15796,4.053374390556838,0.0,0.0
33897,3,3897,[588 204 132  69 655],450,5,15801,4.053617239610056,0.0,0.0
33898,3,3898,[286 300 423 238 268],535,2,15803,4.053090536034881,0.0,20.0
33899,3,3899,[318 427  98 191 182],72,5,15808,4.053333333333334,40.0,0.0
33900,3,3900,[318 427  98 191 182],18,5,15813,4.0535760061522685,40.0,0.0
33901,3,3901,[318 427  98 191 182],269,5,15818,4.053818554587391,40.0,0.0
33902,3,3902,[318 427  98 191 182],796,5,15823,4.054060978734307,40.0,0.0
33903,3,3903,[318 427  98 191 182],72,5,15828,4.054303278688525,40.0,0.0
33904,3,3904,[318 427  98 191 182],450,5,15833,4.054545454545455,40.0,0.0
33905,3,3905,[318 427  98 191 182],269,5,15838,4.05478750640041,40.0,0.0
33906,3,3906,[496 174 176 118  88],280,1,15839,4.054005630918864,20.0,0.0
33907,3,3907,[318 427  98 191 182],72,5,15844,4.054247697031729,40.0,0.0
33908,3,3908,[322 405 200   1  50],593,2,15846,4.053722179585572,0.0,20.0
33909,3,3909,[318 427  98 191 182],18,5,15851,4.0539641943734015,40.0,0.0
33910,3,3910,[318 427  98 191 182],72,5,15856,4.054206085400153,40.0,0.0
33911,3,3911,[222  64 403  69 100],72,3,15859,4.053936605316974,20.0,20.0
33912,3,3912,[143  97  98 300 144],655,2,15861,4.053411704574495,0.0,0.0
33913,3,3913,[ 12 357 471 111 678],344,3,15864,4.053142565150741,0.0,0.0
33914,3,3914,[257 276 282  69 176],457,4,15868,4.053128991060025,0.0,0.0
33915,3,3915,[180 181 269 275 427],296,5,15873,4.053370786516854,20.0,20.0
33916,3,3916,[318 427  98 191 182],796,5,15878,4.053612458514169,40.0,0.0
33917,3,3917,[318 427  98 191 182],72,5,15883,4.053854007146503,40.0,0.0
33918,3,3918,[318 427  98 191 182],655,5,15888,4.0540954325082925,40.0,0.0
33919,3,3919,[318 427  98 191 182],450,5,15893,4.0543367346938775,40.0,0.0
33920,3,3920,[210 181 197 127 161],504,4,15897,4.054322876817139,0.0,20.0
33921,3,3921,[318 427  98 191 182],450,5,15902,4.054563997960225,40.0,0.0
33922,3,3922,[ 50 403 742 234   4],450,3,15905,4.054295182258476,0.0,20.0
33923,3,3923,[318 427  98 191 182],450,5,15910,4.054536187563711,40.0,0.0
33924,3,3924,[222 546 215  79 235],450,3,15913,4.054267515923567,0.0,0.0
33925,3,3925,[117 151 181 742  79],756,4,15917,4.054253693326541,0.0,0.0
33926,3,3926,[318 427  98 191 182],450,5,15922,4.05449452508276,40.0,0.0
33927,3,3927,[183 174 238  56 185],457,5,15927,4.054735234215886,0.0,0.0
33928,3,3928,[318 427  98 191 182],655,5,15932,4.054975820819547,40.0,0.0
33929,3,3929,[318 427  98 191 182],796,5,15937,4.055216284987277,40.0,0.0
33930,3,3930,[385  70  95 183 508],344,3,15940,4.05494785041974,0.0,0.0
33931,3,3931,[423 294 182 322 471],280,2,15942,4.05442522889115,0.0,0.0
33932,3,3932,[318 427  98 191 182],269,5,15947,4.054665649631325,40.0,0.0
33933,3,3933,[294 182 286 313   1],796,2,15949,4.0541433655312655,0.0,20.0
33934,3,3934,[173  64  25  15  82],450,2,15951,4.053621346886913,20.0,0.0
33935,3,3935,[ 11 546  88 655 181],457,4,15955,4.053607723577236,0.0,0.0
33936,3,3936,[318 427  98 191 182],269,5,15960,4.053848107696215,40.0,0.0
33937,3,3937,[194 269 210 234  79],18,3,15963,4.0535804977145755,0.0,0.0
33938,3,3938,[176   9 423 403 143],269,2,15965,4.053059152069053,0.0,0.0
33939,3,3939,[318 427  98 191 182],655,5,15970,4.053299492385787,40.0,0.0
33940,3,3940,[ 97  56 496 125 508],731,2,15972,4.052778482618625,20.0,0.0
33941,3,3941,[  8 200 318 288   7],655,2,15974,4.052257737189244,20.0,0.0
33942,3,3942,[180 423   7 210 100],280,3,15977,4.051990869896018,0.0,20.0
33943,3,3943,[216 215 423 237 196],450,5,15982,4.052231237322515,0.0,0.0
33944,3,3944,[318 427  98 191 182],796,5,15987,4.052471482889734,40.0,0.0
33945,3,3945,[318 427  98 191 182],450,5,15992,4.05271160669032,40.0,0.0
33946,3,3946,[216  12 197 603 100],503,3,15995,4.052444894856853,20.0,20.0
33947,3,3947,[318 427  98 191 182],18,5,16000,4.052684903748734,40.0,0.0
33948,3,3948,[187 210 318 127 202],504,3,16003,4.052418333755381,20.0,20.0
33949,3,3949,[318 427  98 191 182],655,5,16008,4.052658227848101,40.0,0.0
33950,3,3950,[318 427  98 191 182],450,5,16013,4.052898000506201,40.0,0.0
33951,3,3951,[ 71  69 118 237 302],450,3,16016,4.052631578947368,0.0,0.0
33952,3,3952,[568 273 153 185 742],655,2,16018,4.052112319757146,0.0,0.0
33953,3,3953,[318 427  98 191 182],450,5,16023,4.052352048558422,40.0,0.0
33954,3,3954,[318 427  98 191 182],269,5,16028,4.052591656131479,40.0,0.0
33955,3,3955,[318 427  98 191 182],450,5,16033,4.052831142568251,40.0,0.0
33956,3,3956,[318 427  98 191 182],655,5,16038,4.053070507960576,40.0,0.0
33957,3,3957,[318 427  98 191 182],655,5,16043,4.053309752400202,40.0,0.0
33958,3,3958,[318 427  98 191 182],655,5,16048,4.053548875978782,40.0,0.0
33959,3,3959,[318 427  98 191 182],18,5,16053,4.053787878787879,40.0,0.0
33960,3,3960,[318 427  98 191 182],72,5,16058,4.05402676091896,40.0,0.0
33961,3,3961,[210 196 318  11 234],577,2,16060,4.053508329126704,20.0,0.0
33962,3,3962,[228 174 742  95 273],344,4,16064,4.053494827151148,0.0,0.0
33963,3,3963,[403 216  98 182 423],796,5,16069,4.053733602421796,0.0,0.0
33964,3,3964,[318 427  98 191 182],269,5,16074,4.053972257250946,40.0,0.0
33965,3,3965,[ 79 265 423 742 546],280,5,16079,4.054210791729703,0.0,0.0
33966,3,3966,[202 546  82 385  12],796,4,16083,4.054197126291908,0.0,0.0
33967,3,3967,[294  70  69 173 202],457,4,16087,4.054183467741935,0.0,0.0
33968,3,3968,[318 427  98 191 182],796,5,16092,4.054421768707483,40.0,0.0
33969,3,3969,[111 403 187 181  88],655,1,16093,4.053652392947103,0.0,0.0
33970,3,3970,[ 70 204  25 288 179],264,5,16098,4.05389070763032,0.0,0.0
33971,3,3971,[318 427  98 191 182],18,5,16103,4.054128902316213,40.0,0.0
33972,3,3972,[318 427  98 191 182],655,5,16108,4.054366977095394,40.0,0.0
33973,3,3973,[210 127 211 435 174],655,1,16109,4.053598389531958,0.0,20.0
33974,3,3974,[318 427  98 191 182],450,5,16114,4.053836477987422,40.0,0.0
33975,3,3975,[318 427  98 191 182],655,5,16119,4.05407444668008,40.0,0.0
33976,3,3976,[215 276 185 204  97],18,2,16121,4.0535579582599945,0.0,0.0
33977,3,3977,[  7 187 216 301  88],89,5,16126,4.053795877325289,0.0,0.0
33978,3,3978,[318 427  98 191 182],450,5,16131,4.054033676803217,40.0,0.0
33979,3,3979,[318 427  98 191 182],269,5,16136,4.05427135678392,40.0,0.0
33980,3,3980,[318 427  98 191 182],269,5,16141,4.054508917357448,40.0,0.0
33981,3,3981,[318 427  98 191 182],72,5,16146,4.0547463586137615,40.0,0.0
33982,3,3982,[318 427  98 191 182],72,5,16151,4.0549836806427315,40.0,0.0
33983,3,3983,[183 385 132 153  50],796,5,16156,4.055220883534137,0.0,20.0
33984,3,3984,[318 427  98 191 182],269,5,16161,4.0554579673776665,40.0,0.0
33985,3,3985,[318 427  98 191 182],450,5,16166,4.05569493226292,40.0,0.0
33986,3,3986,[286 181 210 151   1],330,5,16171,4.055931778279408,0.0,20.0
33987,3,3987,[318 427  98 191 182],450,5,16176,4.05616850551655,40.0,0.0
33988,3,3988,[100 318  98 265 179],878,3,16179,4.055903735271998,20.0,20.0
33989,3,3989,[318 427  98 191 182],450,5,16184,4.056140350877193,40.0,0.0
33990,3,3990,[117 423 483 172  56],796,5,16189,4.056376847907792,0.0,0.0
33991,3,3991,[318 427  98 191 182],18,5,16194,4.056613226452906,40.0,0.0
33992,3,3992,[318 427  98 191 182],269,5,16199,4.0568494866015525,40.0,0.0
33993,3,3993,[318 427  98 191 182],72,5,16204,4.057085628442664,40.0,0.0
33994,3,3994,[318 427  98 191 182],18,5,16209,4.057321652065081,40.0,0.0
33995,3,3995,[132 191  12  79  70],457,5,16214,4.0575575575575575,0.0,0.0
33996,3,3996,[603 168 655 318 179],535,5,16219,4.057793345008757,40.0,0.0
33997,3,3997,[318 427  98 191 182],72,5,16224,4.0580290145072535,40.0,0.0
33998,3,3998,[118 423   9  25 143],151,4,16228,4.058014503625906,0.0,0.0
33999,3,3999,[ 97 228 180 172 471],786,5,16233,4.05825,0.0,0.0
34000,3,4000,[508 117  50 483 289],655,2,16235,4.057735566108473,0.0,20.0
34001,3,4001,[300 215 257  89 194],796,5,16240,4.057971014492754,0.0,0.0
34002,3,4002,[245 258 655 237 181],504,3,16243,4.05770671996003,0.0,0.0
34003,3,4003,[  4  97 172 318 168],535,3,16246,4.057442557442558,20.0,0.0
34004,3,4004,[135 405  22  12 172],655,2,16248,4.056928838951311,0.0,0.0
34005,3,4005,[318 427  98 191 182],269,5,16253,4.057164253619571,40.0,0.0
34006,3,4006,[318 427  98 191 182],18,5,16258,4.0573995507861245,40.0,0.0
34007,3,4007,[237  98  11 333 427],655,2,16260,4.0568862275449105,20.0,0.0
34008,3,4008,[318 427  98 191 182],72,5,16265,4.057121476677476,40.0,0.0
34009,3,4009,[ 28 322 269 282 185],796,2,16267,4.056608478802993,0.0,0.0
34010,3,4010,[318 427  98 191 182],450,5,16272,4.056843679880329,40.0,0.0
34011,3,4011,[182 546 181  50 183],503,4,16276,4.056829511465603,0.0,20.0
34012,3,4012,[318 427  98 191 182],72,5,16281,4.057064540244206,40.0,0.0
34013,3,4013,[237 197 168 268  64],535,4,16285,4.057050323866467,20.0,0.0
34014,3,4014,[318 427  98 191 182],450,5,16290,4.057285180572852,40.0,0.0
34015,3,4015,[318 427  98 191 182],450,5,16295,4.057519920318725,40.0,0.0
34016,3,4016,[318 427  98 191 182],450,5,16300,4.057754543191437,40.0,0.0
34017,3,4017,[318 427  98 191 182],796,5,16305,4.057989049278248,40.0,0.0
34018,3,4018,[385 333 301 258 175],655,0,16305,4.056979348096541,0.0,0.0
34019,3,4019,[132 173   9  50   4],796,4,16309,4.0569651741293535,0.0,20.0
34020,3,4020,[318 427  98 191 182],655,5,16314,4.057199701566774,40.0,0.0
34021,3,4021,[117 132  64 197 174],629,5,16319,4.0574341123819,20.0,0.0
34022,3,4022,[318 427  98 191 182],72,5,16324,4.057668406661695,40.0,0.0
34023,3,4023,[269 117 172 275 257],655,2,16326,4.057157057654075,0.0,20.0
34024,3,4024,[318 427  98 191 182],18,5,16331,4.057391304347826,40.0,0.0
34025,3,4025,[435  82 655 196 210],450,3,16334,4.057128663686041,0.0,0.0
34026,3,4026,[318 427  98 191 182],72,5,16339,4.057362801092625,40.0,0.0
34027,3,4027,[318 427  98 191 182],655,5,16344,4.05759682224429,40.0,0.0
34028,3,4028,[318 427  98 191 182],796,5,16349,4.0578307272276,40.0,0.0
34029,3,4029,[172  64 195 435 132],535,4,16353,4.057816377171216,20.0,0.0
34030,3,4030,[318 427  98 191 182],269,5,16358,4.05805011163483,40.0,0.0
34031,3,4031,[318 427  98 191 182],796,5,16363,4.05828373015873,40.0,0.0
34032,3,4032,[ 64  96  70 427 568],72,5,16368,4.05851723282916,40.0,0.0
34033,3,4033,[ 79 405  64 111 215],716,5,16373,4.058750619732276,20.0,0.0
34034,3,4034,[318 427  98 191 182],655,5,16378,4.058983890954151,40.0,0.0
34035,3,4035,[318 427  98 191 182],796,5,16383,4.059217046580773,40.0,0.0
34036,3,4036,[143 496 210 185 183],796,4,16387,4.059202378003468,20.0,0.0
34037,3,4037,[153 403 211 172 121],796,4,16391,4.059187716691431,0.0,0.0
34038,3,4038,[318 427  98 191 182],18,5,16396,4.059420648675415,40.0,0.0
34039,3,4039,[  8  50 195  96  28],457,5,16401,4.059653465346535,0.0,20.0
34040,3,4040,[318 427  98 191 182],18,5,16406,4.059886166790398,40.0,0.0
34041,3,4041,[118 289 216 228 405],655,1,16407,4.059129143988125,0.0,0.0
34042,3,4042,[302 174 496 385 228],450,5,16412,4.059361860004947,20.0,0.0
34043,3,4043,[318 427  98 191 182],269,5,16417,4.059594460929772,40.0,0.0
34044,3,4044,[268  89  50 202 603],269,2,16419,4.059085290482076,20.0,20.0
34045,3,4045,[385 180  12 403 257],796,4,16423,4.059070687098369,0.0,0.0
34046,3,4046,[318 427  98 191 182],269,5,16428,4.05930318754633,40.0,0.0
34047,3,4047,[161 427 187 403 194],450,5,16433,4.059535573122529,20.0,0.0
34048,3,4048,[144 118  88 161 245],593,4,16437,4.0595208693504565,0.0,0.0
34049,3,4049,[235 427 117 257 300],716,4,16441,4.059506172839506,20.0,0.0
34050,3,4050,[515 196  95 471  25],716,4,16445,4.0594914835843,0.0,0.0
34051,3,4051,[603  70 405 191 175],11,3,16448,4.059230009871668,20.0,0.0
34052,3,4052,[318 427  98 191 182],269,5,16453,4.05946212681964,40.0,0.0
34053,3,4053,[ 69 117 121 222 258],655,0,16453,4.05846077947706,0.0,0.0
34054,3,4054,[318 427  98 191 182],796,5,16458,4.0586929716399505,40.0,0.0
34055,3,4055,[318 427  98 191 182],796,5,16463,4.058925049309665,40.0,0.0
34056,3,4056,[175  22   7   4 180],457,5,16468,4.059157012570865,0.0,0.0
34057,3,4057,[318 427  98 191 182],655,5,16473,4.059388861508132,40.0,0.0
34058,3,4058,[301   7   4 423  25],535,4,16477,4.059374230105937,0.0,0.0
34059,3,4059,[318 427  98 191 182],655,5,16482,4.059605911330049,40.0,0.0
34060,3,4060,[ 64 655  88 216 195],457,5,16487,4.0598374784535824,20.0,0.0
34061,3,4061,[ 71   1 181 117   7],786,5,16492,4.060068931560807,0.0,0.0
34062,3,4062,[318 427  98 191 182],655,5,16497,4.060300270735909,40.0,0.0
34063,3,4063,[ 64 237 182 125  71],18,3,16500,4.06003937007874,20.0,0.0
34064,3,4064,[245 117   8  69 385],280,4,16504,4.0600246002460025,0.0,0.0
34065,3,4065,[144 257 176 127 300],796,5,16509,4.060255779636006,0.0,20.0
34066,3,4066,[294 258 222  69   4],655,0,16509,4.059257437914925,0.0,0.0
34067,3,4067,[318 427  98 191 182],18,5,16514,4.059488692232055,40.0,0.0
34068,3,4068,[151 143 655 235  79],716,4,16518,4.059474072253625,0.0,0.0
34069,3,4069,[435 172   1 748 121],401,1,16519,4.058722358722359,0.0,0.0
34070,3,4070,[216 181 183  88 135],280,2,16521,4.0582166543846725,0.0,0.0
34071,3,4071,[318 427  98 191 182],18,5,16526,4.05844793713163,40.0,0.0
34072,3,4072,[318 427  98 191 182],796,5,16531,4.058679106309845,40.0,0.0
34073,3,4073,[ 50 318 234 211 597],796,3,16534,4.058419243986254,20.0,20.0
34074,3,4074,[318 427  98 191 182],796,5,16539,4.058650306748466,40.0,0.0
34075,3,4075,[183 385 151 282  22],796,5,16544,4.058881256133464,0.0,0.0
34076,3,4076,[318 427  98 191 182],72,5,16549,4.059112092224675,40.0,0.0
34077,3,4077,[ 95 176 172 125 222],450,3,16552,4.058852378616969,0.0,0.0
34078,3,4078,[172 174 238 204 228],23,4,16556,4.0588379504780585,0.0,0.0
34079,3,4079,[ 71  70 195 235 118],330,4,16560,4.0588235294117645,0.0,0.0
34080,3,4080,[318 427  98 191 182],655,5,16565,4.059054153393776,40.0,0.0
34081,3,4081,[318 427  98 191 182],796,5,16570,4.059284664380206,40.0,0.0
34082,3,4082,[286 111 191 195 302],151,2,16572,4.05878030859662,0.0,20.0
34083,3,4083,[ 50 483 435  97 269],450,4,16576,4.058765915768854,0.0,20.0
34084,3,4084,[318 427  98 191 182],72,5,16581,4.058996328029376,40.0,0.0
34085,3,4085,[151 173  56 135 182],450,4,16585,4.058981889378365,0.0,0.0
34086,3,4086,[ 82 318 234 210 143],655,2,16587,4.058478101296795,20.0,0.0
34087,3,4087,[318 427  98 191 182],450,5,16592,4.0587084148727985,40.0,0.0
34088,3,4088,[318 427  98 191 182],450,5,16597,4.058938615798484,40.0,0.0
34089,3,4089,[318 427  98 191 182],655,5,16602,4.0591687041564795,40.0,0.0
34090,3,4090,[216  28 273  22 546],450,4,16606,4.059154241016866,0.0,0.0
34091,3,4091,[216 265  82 196 748],450,4,16610,4.059139784946237,0.0,0.0
34092,3,4092,[  4 100 181 200 174],457,5,16615,4.059369655509406,0.0,20.0
34093,3,4093,[546  12  98  79 117],280,5,16620,4.059599413776258,0.0,0.0
34094,3,4094,[172 245  95 427 118],796,4,16624,4.059584859584859,20.0,0.0
34095,3,4095,[  4 546   8 173 276],344,4,16628,4.0595703125,0.0,0.0
34096,3,4096,[318 427  98 191 182],655,5,16633,4.059799853551379,40.0,0.0
34097,3,4097,[172 423 127 288 238],436,3,16636,4.0595412396290875,0.0,20.0
34098,3,4098,[294 135 483 385 597],457,3,16639,4.059282751890705,0.0,0.0
34099,3,4099,[318 427  98 191 182],18,5,16644,4.059512195121951,40.0,0.0
34100,3,4100,[318 427  98 191 182],269,5,16649,4.059741526456961,40.0,0.0
34101,3,4101,[318 427  98 191 182],72,5,16654,4.059970745977572,40.0,0.0
34102,3,4102,[318 427  98 191 182],655,5,16659,4.060199853765537,40.0,0.0
34103,3,4103,[318 427  98 191 182],18,5,16664,4.060428849902534,40.0,0.0
34104,3,4104,[153 118 235  22 195],330,4,16668,4.060414129110841,0.0,0.0
34105,3,4105,[471 357 435 322 111],450,5,16673,4.0606429615197275,0.0,0.0
34106,3,4106,[ 25 176 186 265 302],655,1,16674,4.059897735573411,0.0,0.0
34107,3,4107,[318 427  98 191 182],269,5,16679,4.060126582278481,40.0,0.0
34108,3,4108,[318 427  98 191 182],72,5,16684,4.060355317595522,40.0,0.0
34109,3,4109,[318 427  98 191 182],450,5,16689,4.06058394160584,40.0,0.0
34110,3,4110,[318 427  98 191 182],18,5,16694,4.06081245439066,40.0,0.0
34111,3,4111,[144   8 289 435 100],655,0,16694,4.059824902723736,0.0,20.0
34112,3,4112,[ 22 282 215  71   4],535,2,16696,4.059324094335035,0.0,0.0
34113,3,4113,[427  82 121 508 273],655,2,16698,4.0588235294117645,20.0,0.0
34114,3,4114,[197  50 210 423 172],716,5,16703,4.059052247873633,0.0,20.0
34115,3,4115,[318 427  98 191 182],796,5,16708,4.059280855199223,40.0,0.0
34116,3,4116,[275  97  70 216  79],151,5,16713,4.059509351469517,0.0,20.0
34117,3,4117,[282  15 143 603 301],450,4,16717,4.059494900437105,20.0,0.0
34118,3,4118,[318 427  98 191 182],269,5,16722,4.05972323379461,40.0,0.0
34119,3,4119,[176 200 405 187 117],716,3,16725,4.059466019417476,0.0,0.0
34120,3,4120,[318 427  98 191 182],450,5,16730,4.059694248968697,40.0,0.0
34121,3,4121,[ 11 471 603 568 546],716,3,16733,4.059437166424066,20.0,0.0
34122,3,4122,[318 427  98 191 182],450,5,16738,4.059665292262915,40.0,0.0
34123,3,4123,[318 427  98 191 182],72,5,16743,4.059893307468477,40.0,0.0
34124,3,4124,[318 427  98 191 182],72,5,16748,4.060121212121212,40.0,0.0
34125,3,4125,[318 427  98 191 182],796,5,16753,4.060349006301503,40.0,0.0
34126,3,4126,[318 427  98 191 182],72,5,16758,4.060576690089653,40.0,0.0
34127,3,4127,[183 186 483 125 603],655,3,16761,4.06031976744186,20.0,0.0
34128,3,4128,[318 427  98 191 182],796,5,16766,4.060547348026156,40.0,0.0
34129,3,4129,[318 427  98 191 182],655,5,16771,4.060774818401937,40.0,0.0
34130,3,4130,[318 427  98 191 182],796,5,16776,4.061002178649238,40.0,0.0
34131,3,4131,[318 427  98 191 182],796,5,16781,4.061229428848016,40.0,0.0
34132,3,4132,[318 427  98 191 182],18,5,16786,4.0614565690781514,40.0,0.0
34133,3,4133,[127 194 211   4 423],389,5,16791,4.061683599419449,0.0,20.0
34134,3,4134,[289  15 174 268 186],655,0,16791,4.060701330108827,0.0,0.0
34135,3,4135,[ 50  82 196 135 385],716,3,16794,4.060444874274662,0.0,20.0
34136,3,4136,[ 11 333 117 475  12],655,0,16794,4.059463379260333,0.0,0.0
34137,3,4137,[318 427  98 191 182],796,5,16799,4.059690671822136,40.0,0.0
34138,3,4138,[322  70  15  89 191],450,4,16803,4.059676250302005,0.0,0.0
34139,3,4139,[195 483 132 187 176],450,4,16807,4.059661835748792,0.0,0.0
34140,3,4140,[111 179 471  64 546],450,5,16812,4.05988891572084,20.0,0.0
34141,3,4141,[237 180  82 588 245],450,4,16816,4.059874456784162,0.0,0.0
34142,3,4142,[  4  25 111 313 132],577,5,16821,4.060101375814627,0.0,0.0
34143,3,4143,[318 427  98 191 182],450,5,16826,4.060328185328185,40.0,0.0
34144,3,4144,[318 427  98 191 182],450,5,16831,4.060554885404101,40.0,0.0
34145,3,4145,[276 111 143 121  15],269,1,16832,4.0598166907863,0.0,0.0
34146,3,4146,[318 427  98 191 182],796,5,16837,4.060043404870991,40.0,0.0
34147,3,4147,[ 22 423 313 597 195],796,5,16842,4.060270009643202,0.0,0.0
34148,3,4148,[318 427  98 191 182],72,5,16847,4.0604965051819715,40.0,0.0
34149,3,4149,[318 427  98 191 182],450,5,16852,4.060722891566265,40.0,0.0
34150,3,4150,[318 427  98 191 182],18,5,16857,4.06094916887497,40.0,0.0
34151,3,4151,[318 427  98 191 182],269,5,16862,4.0611753371868975,40.0,0.0
34152,3,4152,[286 125 742  98 210],174,5,16867,4.061401396580785,0.0,20.0
34153,3,4153,[202  25 294 357 186],450,3,16870,4.061145883485797,0.0,0.0
34154,3,4154,[318 427  98 191 182],72,5,16875,4.061371841155235,40.0,0.0
34155,3,4155,[ 88 748  97   1  98],796,3,16878,4.06111645813282,0.0,0.0
34156,3,4156,[318 427  98 191 182],72,5,16883,4.061342314168872,40.0,0.0
34157,3,4157,[318 427  98 191 182],450,5,16888,4.061568061568061,40.0,0.0
34158,3,4158,[182 187 153 655 168],535,3,16891,4.061312815580669,0.0,0.0
34159,3,4159,[ 89 238 265  12 179],457,5,16896,4.061538461538461,0.0,0.0
34160,3,4160,[ 50  56 237 471 173],577,3,16899,4.0612833453496755,0.0,20.0
34161,3,4161,[100 288 180 228 483],457,5,16904,4.061508889956752,0.0,20.0
34162,3,4162,[183 196 301  25  88],151,4,16908,4.061494114821042,0.0,0.0
34163,3,4163,[318 427  98 191 182],796,5,16913,4.061719500480307,40.0,0.0
34164,3,4164,[318 427  98 191 182],796,5,16918,4.061944777911164,40.0,0.0
34165,3,4165,[318 427  98 191 182],450,5,16923,4.062169947191551,40.0,0.0
34166,3,4166,[318 427  98 191 182],269,5,16928,4.062395008399328,40.0,0.0
34167,3,4167,[ 15  98 496 301 471],450,4,16932,4.062380038387716,20.0,0.0
34168,3,4168,[318 427  98 191 182],655,5,16937,4.06260494123291,40.0,0.0
34169,3,4169,[318 427  98 191 182],450,5,16942,4.0628297362110315,40.0,0.0
34170,3,4170,[118 289 568 483 195],693,2,16944,4.062335171421721,0.0,0.0
34171,3,4171,[ 82   4 435 216 238],450,3,16947,4.0620805369127515,0.0,0.0
34172,3,4172,[328 483 174 117 194],401,4,16951,4.0620656601965015,0.0,0.0
34173,3,4173,[ 15   9 322 172 245],593,2,16953,4.061571633924293,0.0,0.0
34174,3,4174,[153  25 172 435  15],18,3,16956,4.061317365269461,0.0,0.0
34175,3,4175,[318 427  98 191 182],72,5,16961,4.06154214559387,40.0,0.0
34176,3,4176,[318 427  98 191 182],18,5,16966,4.061766818290639,40.0,0.0
34177,3,4177,[ 98 191 210  97 257],796,3,16969,4.061512685495452,0.0,0.0
34178,3,4178,[318 427  98 191 182],450,5,16974,4.061737257717157,40.0,0.0
34179,3,4179,[318 427  98 191 182],655,5,16979,4.061961722488038,40.0,0.0
34180,3,4180,[ 50  95  96 176 742],756,3,16982,4.061707725424539,0.0,20.0
34181,3,4181,[318 427  98 191 182],450,5,16987,4.061932089909134,40.0,0.0
34182,3,4182,[546 195 144  96 483],280,3,16990,4.061678221372221,0.0,0.0
34183,3,4183,[127 228 186 200 273],796,3,16993,4.061424474187381,0.0,20.0
34184,3,4184,[318 427  98 191 182],796,5,16998,4.061648745519713,40.0,0.0
34185,3,4185,[172 313 318 289 200],236,3,17001,4.061395126612518,20.0,0.0
34186,3,4186,[202 423 191 588 196],796,5,17006,4.061619297826606,0.0,0.0
34187,3,4187,[ 25  69 258 235 183],457,4,17010,4.06160458452722,0.0,0.0
34188,3,4188,[318 427  98 191 182],796,5,17015,4.0618285987109095,40.0,0.0
34189,3,4189,[191 423 322 210 385],450,4,17019,4.0618138424821,0.0,0.0
34190,3,4190,[302 118 202 568 423],389,3,17022,4.061560486757337,0.0,0.0
34191,3,4191,[318 427  98 191 182],18,5,17027,4.061784351145038,40.0,0.0
34192,3,4192,[318 427  98 191 182],269,5,17032,4.062008108752683,40.0,0.0
34193,3,4193,[ 88   1  15 258 237],457,5,17037,4.062231759656652,0.0,0.0
34194,3,4194,[172 211 196 286 273],796,2,17039,4.061740166865316,0.0,20.0
34195,3,4195,[318 427  98 191 182],450,5,17044,4.061963775023832,40.0,0.0
34196,3,4196,[318 427  98 191 182],450,5,17049,4.062187276626162,40.0,0.0
34197,3,4197,[318 427  98 191 182],655,5,17054,4.062410671748451,40.0,0.0
34198,3,4198,[546 323 216 423  71],280,4,17058,4.06239580852584,0.0,0.0
34199,3,4199,[318 427  98 191 182],72,5,17063,4.062619047619048,40.0,0.0
34200,3,4200,[ 12 144  11 194 143],457,5,17068,4.06284218043323,0.0,0.0
34201,3,4201,[181 273 191 153 210],655,2,17070,4.062351261304141,0.0,0.0
34202,3,4202,[238 151  22 215 127],796,4,17074,4.062336426362123,0.0,20.0
34203,3,4203,[318 427  98 191 182],655,5,17079,4.06255946717412,40.0,0.0
34204,3,4204,[200 588 186 204 318],457,5,17084,4.062782401902497,20.0,0.0
34205,3,4205,[318 427  98 191 182],18,5,17089,4.063005230622919,40.0,0.0
34206,3,4206,[318 427  98 191 182],18,5,17094,4.063227953410982,40.0,0.0
34207,3,4207,[117 546 144  64 182],457,4,17098,4.063212927756654,20.0,0.0
34208,3,4208,[318 427  98 191 182],796,5,17103,4.06343549536707,40.0,0.0
34209,3,4209,[568  15 318 222   1],655,1,17104,4.06270783847981,20.0,0.0
34210,3,4210,[318 427  98 191 182],269,5,17109,4.062930420327713,40.0,0.0
34211,3,4211,[318 427  98 191 182],655,5,17114,4.06315289648623,40.0,0.0
34212,3,4212,[ 70 175 275 257 196],716,4,17118,4.063137906479943,0.0,20.0
34213,3,4213,[194  70  97 286 302],535,3,17121,4.062885619364025,0.0,20.0
34214,3,4214,[ 28 172 191  25 194],450,4,17125,4.062870699881376,0.0,0.0
34215,3,4215,[ 50  15 588  64  82],450,3,17128,4.062618595825427,20.0,20.0
34216,3,4216,[318 191 655 238 216],269,4,17132,4.062603746739388,20.0,0.0
34217,3,4217,[318 427  98 191 182],269,5,17137,4.062825983878615,40.0,0.0
34218,3,4218,[318 427  98 191 182],72,5,17142,4.06304811566722,40.0,0.0
34219,3,4219,[318 427  98 191 182],269,5,17147,4.0632701421800945,40.0,0.0
34220,3,4220,[318 427  98 191 182],450,5,17152,4.063492063492063,40.0,0.0
34221,3,4221,[318 427  98 191 182],655,5,17157,4.063713879677878,40.0,0.0
34222,3,4222,[ 11 237 496 168 300],535,4,17161,4.063698792327729,20.0,0.0
34223,3,4223,[ 22 742 385 655 125],450,5,17166,4.063920454545454,0.0,0.0
34224,3,4224,[  1 211 301 546 322],796,1,17167,4.0631952662721895,0.0,0.0
34225,3,4225,[318 427  98 191 182],450,5,17172,4.063416942735447,40.0,0.0
34226,3,4226,[318 427  98 191 182],450,5,17177,4.063638514312752,40.0,0.0
34227,3,4227,[748 161  71 222 127],450,3,17180,4.063386944181646,0.0,20.0
34228,3,4228,[318 427  98 191 182],796,5,17185,4.063608418065736,40.0,0.0
34229,3,4229,[318 427  98 191 182],72,5,17190,4.0638297872340425,40.0,0.0
34230,3,4230,[483 328 151  64 135],450,3,17193,4.063578350271803,20.0,0.0
34231,3,4231,[318 427  98 191 182],18,5,17198,4.063799621928166,40.0,0.0
34232,3,4232,[318 427  98 191 182],655,5,17203,4.064020789038507,40.0,0.0
34233,3,4233,[471 568 228 496  69],577,2,17205,4.06353330184223,20.0,0.0
34234,3,4234,[161  98 135   9 234],655,2,17207,4.063046044864227,0.0,0.0
34235,3,4235,[318 427  98 191 182],18,5,17212,4.063267233238904,40.0,0.0
34236,3,4236,[318 427  98 191 182],72,5,17217,4.06348831720557,40.0,0.0
34237,3,4237,[313  97 275 153 471],593,3,17220,4.063237376120812,0.0,20.0
34238,3,4238,[121 191 276 282  11],296,5,17225,4.06345836282142,0.0,0.0
34239,3,4239,[471  97 200 204 100],457,5,17230,4.063679245283019,0.0,20.0
34240,3,4240,[318 427  98 191 182],796,5,17235,4.063900023579344,40.0,0.0
34241,3,4241,[318 427  98 191 182],450,5,17240,4.064120697784064,40.0,0.0
34242,3,4242,[173 234   7 496  22],269,1,17241,4.063398538769738,20.0,0.0
34243,3,4243,[151 405 135  89 181],457,5,17246,4.063619227144204,0.0,0.0
34244,3,4244,[318 427  98 191 182],269,5,17251,4.063839811542992,40.0,0.0
34245,3,4245,[  4 173 118 196 202],450,3,17254,4.063589260480452,0.0,0.0
34246,3,4246,[318 427  98 191 182],18,5,17259,4.063809748057452,40.0,0.0
34247,3,4247,[202 257 118 194 168],716,4,17263,4.06379472693032,0.0,0.0
34248,3,4248,[ 50 186 179 204 153],296,4,17267,4.063779712873617,0.0,20.0
34249,3,4249,[176  96 245  89 222],796,4,17271,4.0637647058823525,0.0,0.0
34250,3,4250,[318 427  98 191 182],796,5,17276,4.063984944718889,40.0,0.0
34251,3,4251,[294 132 234 655  15],457,4,17280,4.063969896519285,0.0,0.0
34252,3,4252,[ 22 301 196 127 200],450,4,17284,4.063954855396191,0.0,20.0
34253,3,4253,[238 742 678 245  71],504,4,17288,4.063939821344617,0.0,0.0
34254,3,4254,[318 427  98 191 182],796,5,17293,4.064159811985899,40.0,0.0
34255,3,4255,[318 427  98 191 182],72,5,17298,4.0643796992481205,40.0,0.0
34256,3,4256,[435  97 121  79 271],655,1,17299,4.063659854357529,0.0,0.0
34257,3,4257,[588 496 185 183  70],450,5,17304,4.0638797557538755,20.0,0.0
34258,3,4258,[318 427  98 191 182],450,5,17309,4.064099553885889,40.0,0.0
34259,3,4259,[300 423 238 111 144],629,5,17314,4.064319248826291,0.0,0.0
34260,3,4260,[318 427  98 191 182],18,5,17319,4.064538840647735,40.0,0.0
34261,3,4261,[318 427  98 191 182],655,5,17324,4.064758329422806,40.0,0.0
34262,3,4262,[357 143 173  96 603],23,3,17327,4.064508562045508,20.0,0.0
34263,3,4263,[318 427  98 191 182],269,5,17332,4.064727954971858,40.0,0.0
34264,3,4264,[318 427  98 191 182],450,5,17337,4.064947245017585,40.0,0.0
34265,3,4265,[144 197 471 496 322],450,5,17342,4.06516643225504,20.0,0.0
34266,3,4266,[318 427  98 191 182],796,5,17347,4.065385516756503,40.0,0.0
34267,3,4267,[318 427  98 191 182],269,5,17352,4.0656044985941895,40.0,0.0
34268,3,4268,[318 427  98 191 182],796,5,17357,4.0658233778402435,40.0,0.0
34269,3,4269,[179 176   1 180 143],457,5,17362,4.066042154566745,0.0,0.0
34270,3,4270,[168 125 568 196  69],457,5,17367,4.066260828845704,0.0,0.0
34271,3,4271,[216  28   4 118   1],457,5,17372,4.0664794007490634,0.0,0.0
34272,3,4272,[237  50 313 183   1],344,2,17374,4.065995787502925,0.0,20.0
34273,3,4273,[318 427  98 191 182],450,5,17379,4.06621431913898,40.0,0.0
34274,3,4274,[  8   7 742 273 183],344,4,17383,4.066198830409356,0.0,0.0
34275,3,4275,[483   9 186 742 286],655,1,17384,4.065481758652947,0.0,20.0
34276,3,4276,[318 427  98 191 182],18,5,17389,4.065700257189619,40.0,0.0
34277,3,4277,[215 568 132  12 357],796,5,17394,4.065918653576437,0.0,0.0
34278,3,4278,[289  96  71 118  95],756,2,17396,4.065435849497546,0.0,0.0
34279,3,4279,[318 427  98 191 182],269,5,17401,4.065654205607476,40.0,0.0
34280,3,4280,[318 427  98 191 182],18,5,17406,4.065872459705676,40.0,0.0
34281,3,4281,[405  69 185 173 294],716,5,17411,4.066090611863615,0.0,0.0
34282,3,4282,[191 237 257  50   9],655,2,17413,4.065608218538408,0.0,20.0
34283,3,4283,[322 588 235 403  70],450,4,17417,4.065592903828198,0.0,0.0
34284,3,4284,[318 427  98 191 182],450,5,17422,4.065810968494749,40.0,0.0
34285,3,4285,[483 182 471 275 496],535,4,17426,4.065795613625759,20.0,20.0
34286,3,4286,[318 427  98 191 182],18,5,17431,4.066013529274551,40.0,0.0
34287,3,4287,[318 427  98 191 182],655,5,17436,4.066231343283582,40.0,0.0
34288,3,4288,[318 427  98 191 182],796,5,17441,4.066449055723945,40.0,0.0
34289,3,4289,[318 427  98 191 182],72,5,17446,4.066666666666666,40.0,0.0
34290,3,4290,[318 427  98 191 182],18,5,17451,4.066884176182708,40.0,0.0
34291,3,4291,[318 427  98 191 182],655,5,17456,4.067101584342963,40.0,0.0
34292,3,4292,[275 496 603 168 132],151,5,17461,4.067318891218262,40.0,20.0
34293,3,4293,[568 151 471 237  22],256,5,17466,4.067536096879366,0.0,0.0
34294,3,4294,[318 427  98 191 182],655,5,17471,4.0677532013969735,40.0,0.0
34295,3,4295,[318 427  98 191 182],269,5,17476,4.067970204841713,40.0,0.0
34296,3,4296,[117  97 143  69 286],401,2,17478,4.067488945776123,0.0,20.0
34297,3,4297,[318 427  98 191 182],796,5,17483,4.067705909725453,40.0,0.0
34298,3,4298,[318 427  98 191 182],450,5,17488,4.067922772737846,40.0,0.0
34299,3,4299,[318 427  98 191 182],72,5,17493,4.068139534883721,40.0,0.0
34300,3,4300,[318 427  98 191 182],269,5,17498,4.0683561962334345,40.0,0.0
34301,3,4301,[405 257 515 282  25],120,4,17502,4.06834030683403,0.0,0.0
34302,3,4302,[318 427  98 191 182],269,5,17507,4.068556820822682,40.0,0.0
34303,3,4303,[318 427  98 191 182],269,5,17512,4.068773234200743,40.0,0.0
34304,3,4304,[655 194 271 187 273],796,3,17515,4.0685249709639955,0.0,0.0
34305,3,4305,[318 427  98 191 182],72,5,17520,4.068741291221551,40.0,0.0
34306,3,4306,[194   7 385 153  70],450,5,17525,4.068957511028558,0.0,0.0
34307,3,4307,[318 427  98 191 182],269,5,17530,4.0691736304549675,40.0,0.0
34308,3,4308,[ 50 200 286 118 423],151,3,17533,4.068925504757484,0.0,40.0
34309,3,4309,[ 70 200 179 111  95],450,3,17536,4.068677494199536,0.0,0.0
34310,3,4310,[318 427  98 191 182],72,5,17541,4.068893528183716,40.0,0.0
34311,3,4311,[318 427  98 191 182],72,5,17546,4.069109461966605,40.0,0.0
34312,3,4312,[318 427  98 191 182],269,5,17551,4.069325295617899,40.0,0.0
34313,3,4313,[318 427  98 191 182],18,5,17556,4.069541029207232,40.0,0.0
34314,3,4314,[318 427  98 191 182],269,5,17561,4.0697566628041715,40.0,0.0
34315,3,4315,[151 546  70 172 471],457,4,17565,4.069740500463392,0.0,0.0
34316,3,4316,[471 276 111 176  88],344,3,17568,4.069492703266157,0.0,0.0
34317,3,4317,[318 427  98 191 182],450,5,17573,4.069708198239926,40.0,0.0
34318,3,4318,[196  11 568 273 678],344,3,17576,4.069460523269275,0.0,0.0
34319,3,4319,[174 151 125 191 175],344,4,17580,4.069444444444445,0.0,0.0
34320,3,4320,[385  22 257 597 186],457,3,17583,4.069196945151585,0.0,0.0
34321,3,4321,[333 273 328  28   7],655,1,17584,4.068486811661268,0.0,0.0
34322,3,4322,[ 69  15 210  88   8],457,5,17589,4.068702290076335,0.0,0.0
34323,3,4323,[318 427  98 191 182],450,5,17594,4.068917668825162,40.0,0.0
34324,3,4324,[ 50 195 143 357 318],655,4,17598,4.068901734104046,20.0,20.0
34325,3,4325,[318 427  98 191 182],796,5,17603,4.069116967175219,40.0,0.0
34326,3,4326,[200  98  15 204  64],629,5,17608,4.0693321007626535,20.0,0.0
34327,3,4327,[235 282   9 118 265],457,4,17612,4.069316081330869,0.0,0.0
34328,3,4328,[318 427  98 191 182],450,5,17617,4.069531069531069,40.0,0.0
34329,3,4329,[237 322 181 588  64],401,0,17617,4.068591224018475,20.0,0.0
34330,3,4330,[275 196 215 515  82],716,5,17622,4.06880628030478,0.0,20.0
34331,3,4331,[318 427  98 191 182],655,5,17627,4.069021237303786,40.0,0.0
34332,3,4332,[269 515 300   8 197],655,1,17628,4.0683129471497805,0.0,0.0
34333,3,4333,[322 269 294 258 300],629,2,17630,4.067835717581911,0.0,0.0
34334,3,4334,[318 427  98 191 182],18,5,17635,4.06805074971165,40.0,0.0
34335,3,4335,[222 588  96 118 237],716,3,17638,4.067804428044281,0.0,0.0
34336,3,4336,[318 427  98 191 182],18,5,17643,4.068019368226885,40.0,0.0
34337,3,4337,[195  96 318 200 515],908,4,17647,4.068003688335638,20.0,0.0
34338,3,4338,[161 204 268  56  82],655,0,17647,4.067066144272874,0.0,0.0
34339,3,4339,[318 427  98 191 182],655,5,17652,4.067281105990784,40.0,0.0
34340,3,4340,[318 427  98 191 182],450,5,17657,4.067495968670813,40.0,0.0
34341,3,4341,[603 153  98 427  95],18,4,17661,4.067480423767849,40.0,0.0
34342,3,4342,[ 98 301 200 144  22],655,2,17663,4.06700437485609,0.0,0.0
34343,3,4343,[318 427  98 191 182],72,5,17668,4.067219152854512,40.0,0.0
34344,3,4344,[318 427  98 191 182],269,5,17673,4.067433831990794,40.0,0.0
34345,3,4345,[318 427  98 191 182],72,5,17678,4.06764841233318,40.0,0.0
34346,3,4346,[ 25 181  64 100 322],450,4,17682,4.067632850241546,20.0,20.0
34347,3,4347,[318 427  98 191 182],450,5,17687,4.067847286108556,40.0,0.0
34348,3,4348,[318 427  98 191 182],269,5,17692,4.068061623361692,40.0,0.0
34349,3,4349,[ 56 301 265 176 174],450,5,17697,4.068275862068965,0.0,0.0
34350,3,4350,[318 427  98 191 182],450,5,17702,4.068490002298322,40.0,0.0
34351,3,4351,[258 125  96  70 118],655,0,17702,4.067555147058823,0.0,0.0
34352,3,4352,[603 471 191 174 405],716,4,17706,4.067539627842867,20.0,0.0
34353,3,4353,[318 427  98 191 182],269,5,17711,4.067753789618742,40.0,0.0
34354,3,4354,[318 427  98 191 182],18,5,17716,4.06796785304248,40.0,0.0
34355,3,4355,[318 427  98 191 182],269,5,17721,4.068181818181818,40.0,0.0
34356,3,4356,[125  89 151 568 168],450,5,17726,4.06839568510443,0.0,0.0
34357,3,4357,[215 127  12 748 275],450,5,17731,4.068609453877926,0.0,40.0
34358,3,4358,[318 427  98 191 182],18,5,17736,4.068823124569856,40.0,0.0
34359,3,4359,[ 88  11 405 276 385],593,3,17739,4.0685779816513765,0.0,0.0
34360,3,4360,[318 427  98 191 182],18,5,17744,4.068791561568448,40.0,0.0
34361,3,4361,[318 427  98 191 182],796,5,17749,4.0690050435580005,40.0,0.0
34362,3,4362,[200 568 135 195 125],450,3,17752,4.068760027504011,0.0,0.0
34363,3,4363,[318 427  98 191 182],655,5,17757,4.06897341888176,40.0,0.0
34364,3,4364,[ 25  79 597 742 423],11,2,17759,4.068499427262314,0.0,0.0
34365,3,4365,[318 427  98 191 182],18,5,17764,4.068712780577187,40.0,0.0
34366,3,4366,[318 427  98 191 182],655,5,17769,4.068926036180445,40.0,0.0
34367,3,4367,[318 427  98 191 182],796,5,17774,4.069139194139194,40.0,0.0
34368,3,4368,[187 194 118  69 197],716,3,17777,4.068894483863584,0.0,0.0
34369,3,4369,[471 597 121  97 194],457,4,17781,4.068878718535469,0.0,0.0
34370,3,4370,[318 427  98 191 182],796,5,17786,4.069091741020362,40.0,0.0
34371,3,4371,[ 56 508 302 655 210],535,3,17789,4.068847209515096,0.0,0.0
34372,3,4372,[318 427  98 191 182],269,5,17794,4.069060141779099,40.0,0.0
34373,3,4373,[127 180   1  64  56],292,5,17799,4.069272976680384,20.0,20.0
34374,3,4374,[151 286 234 173 121],152,5,17804,4.069485714285714,0.0,20.0
34375,3,4375,[318 427  98 191 182],655,5,17809,4.069698354661791,40.0,0.0
34376,3,4376,[186 210 435 135 483],807,4,17813,4.0696824308887365,0.0,0.0
34377,3,4377,[318 427  98 191 182],450,5,17818,4.0698949291914115,40.0,0.0
34378,3,4378,[655 313 200 403 195],796,4,17822,4.069878967800868,0.0,0.0
34379,3,4379,[318 427  98 191 182],72,5,17827,4.070091324200913,40.0,0.0
34380,3,4380,[237 603 135  88 172],655,3,17830,4.069847066879708,20.0,0.0
34381,3,4381,[318 427  98 191 182],72,5,17835,4.070059333637609,40.0,0.0
34382,3,4382,[318 427  98 191 182],18,5,17840,4.07027150353639,40.0,0.0
34383,3,4383,[405 179 204  15 143],593,4,17844,4.070255474452555,0.0,0.0
34384,3,4384,[161 275 195 196 100],450,5,17849,4.070467502850627,0.0,40.0
34385,3,4385,[127   1 144 234 215],280,2,17851,4.06999544003648,0.0,20.0
34386,3,4386,[318 427  98 191 182],796,5,17856,4.070207431046273,40.0,0.0
34387,3,4387,[318 427  98 191 182],269,5,17861,4.070419325432999,40.0,0.0
34388,3,4388,[204 195   1 174 173],344,4,17865,4.070403280929597,0.0,0.0
34389,3,4389,[318 427  98 191 182],72,5,17870,4.070615034168565,40.0,0.0
34390,3,4390,[318 427  98 191 182],655,5,17875,4.070826690958779,40.0,0.0
34391,3,4391,[181   8 144  11 385],655,0,17875,4.069899817850637,0.0,0.0
34392,3,4392,[318 427  98 191 182],18,5,17880,4.070111541088095,40.0,0.0
34393,3,4393,[ 82 179 121 117 125],504,4,17884,4.0700955848884846,0.0,0.0
34394,3,4394,[318 427  98 191 182],18,5,17889,4.0703071672354945,40.0,0.0
34395,3,4395,[496  82 588 118  22],807,5,17894,4.070518653321201,20.0,0.0
34396,3,4396,[176 275   4  50 194],450,4,17898,4.0705026154196045,0.0,40.0
34397,3,4397,[318 427  98 191 182],655,5,17903,4.0707139608913145,40.0,0.0
34398,3,4398,[ 56  28  64   4 265],577,4,17907,4.070697885883155,20.0,0.0
34399,3,4399,[385 357 427  56 176],796,5,17912,4.070909090909091,20.0,0.0
34400,3,4400,[385 423 168 186 234],796,3,17915,4.070665757782322,0.0,0.0
34401,3,4401,[483 275   1 202 271],655,2,17917,4.070195365742844,0.0,20.0
34402,3,4402,[318 427  98 191 182],269,5,17922,4.070406540994776,40.0,0.0
34403,3,4403,[318 427  98 191 182],655,5,17927,4.070617620345141,40.0,0.0
34404,3,4404,[318 427  98 191 182],72,5,17932,4.070828603859251,40.0,0.0
34405,3,4405,[174 269 185 302  12],450,5,17937,4.0710394916023604,0.0,0.0
34406,3,4406,[ 25 117 302 173 202],401,2,17939,4.070569548445655,0.0,0.0
34407,3,4407,[  1 181  15 222 194],796,4,17943,4.070553539019964,0.0,0.0
34408,3,4408,[318 427  98 191 182],655,5,17948,4.070764345656611,40.0,0.0
34409,3,4409,[257 515  79  50 174],655,3,17951,4.0705215419501135,0.0,20.0
34410,3,4410,[222 235 180 483  50],716,3,17954,4.070278848333711,0.0,20.0
34411,3,4411,[143 427 742 181 300],655,2,17956,4.069809610154125,20.0,0.0
34412,3,4412,[275 183 742 118 294],796,3,17959,4.069567187854068,0.0,20.0
34413,3,4413,[215 127  15  98 235],457,4,17963,4.0695514272768465,0.0,20.0
34414,3,4414,[318 427  98 191 182],450,5,17968,4.069762174405436,40.0,0.0
34415,3,4415,[318 427  98 191 182],72,5,17973,4.069972826086956,40.0,0.0
34416,3,4416,[318 427  98 191 182],450,5,17978,4.070183382386235,40.0,0.0
34417,3,4417,[191 144  82  25 176],457,5,17983,4.0703938433680396,0.0,0.0
34418,3,4418,[423 125  97 568  98],450,5,17988,4.07060420909708,0.0,0.0
34419,3,4419,[300 286 403 111 185],655,1,17989,4.069909502262443,0.0,20.0
34420,3,4420,[135  15 168 172 603],151,5,17994,4.070119882379553,20.0,0.0
34421,3,4421,[318 427  98 191 182],72,5,17999,4.070330167345093,40.0,0.0
34422,3,4422,[ 97 143 195 168 187],504,4,18003,4.070314266335067,0.0,0.0
34423,3,4423,[318 427  98 191 182],655,5,18008,4.070524412296564,40.0,0.0
34424,3,4424,[655 471 144 322 197],280,1,18009,4.069830508474576,0.0,0.0
34425,3,4425,[318 427  98 191 182],796,5,18014,4.070040668775418,40.0,0.0
34426,3,4426,[175 269 179 313 265],655,2,18016,4.069573074316693,0.0,0.0
34427,3,4427,[318 427  98 191 182],269,5,18021,4.0697831978319785,40.0,0.0
34428,3,4428,[228 328 215 508 117],655,0,18021,4.068864303454505,0.0,0.0
34429,3,4429,[318 427  98 191 182],450,5,18026,4.069074492099323,40.0,0.0
34430,3,4430,[ 79  50  64 172 435],450,5,18031,4.069284585872263,20.0,20.0
34431,3,4431,[318 427  98 191 182],72,5,18036,4.069494584837545,40.0,0.0
34432,3,4432,[318 427  98 191 182],269,5,18041,4.069704489059328,40.0,0.0
34433,3,4433,[318 427  98 191 182],269,5,18046,4.069914298601714,40.0,0.0
34434,3,4434,[318 427  98 191 182],655,5,18051,4.070124013528749,40.0,0.0
34435,3,4435,[483 333 197 180 273],796,2,18053,4.069657348963029,0.0,0.0
34436,3,4436,[318 427  98 191 182],655,5,18058,4.0698670272706785,40.0,0.0
34437,3,4437,[318 427  98 191 182],450,5,18063,4.070076611086074,40.0,0.0
34438,3,4438,[318 427  98 191 182],72,5,18068,4.07028610047308,40.0,0.0
34439,3,4439,[318 427  98 191 182],450,5,18073,4.0704954954954955,40.0,0.0
34440,3,4440,[ 71  97 172 100 222],344,3,18076,4.070254447196577,0.0,20.0
34441,3,4441,[318 427  98 191 182],450,5,18081,4.070463755065286,40.0,0.0
34442,3,4442,[471 200 235  88 294],457,3,18084,4.070222822417286,0.0,0.0
34443,3,4443,[ 56  97 215 568   4],796,4,18088,4.07020702070207,0.0,0.0
34444,3,4444,[127  25 191 197 742],457,5,18093,4.070416197975253,0.0,20.0
34445,3,4445,[181 176  82 200 172],716,4,18097,4.070400359874044,0.0,0.0
34446,3,4446,[318 427  98 191 182],796,5,18102,4.070609399595233,40.0,0.0
34447,3,4447,[ 12  89 151 175 121],151,5,18107,4.070818345323741,0.0,0.0
34448,3,4448,[  1 403 257 300 187],655,1,18108,4.070128118678355,0.0,0.0
34449,3,4449,[318 427  98 191 182],796,5,18113,4.0703370786516855,40.0,0.0
34450,3,4450,[318 427  98 191 182],655,5,18118,4.070545944731521,40.0,0.0
34451,3,4451,[258  50 568 471 678],344,2,18120,4.070080862533692,0.0,20.0
34452,3,4452,[318 186  98  71  11],450,3,18123,4.069840556927914,20.0,0.0
34453,3,4453,[ 56  88 588 180 183],716,3,18126,4.06960035922766,0.0,0.0
34454,3,4454,[318 427  98 191 182],72,5,18131,4.069809203142537,40.0,0.0
34455,3,4455,[603  88 588 143 405],716,5,18136,4.070017953321364,20.0,0.0
34456,3,4456,[318 427  98 191 182],450,5,18141,4.070226609827238,40.0,0.0
34457,3,4457,[186 127 276 202 546],504,2,18143,4.0697622252131,0.0,20.0
34458,3,4458,[318 427  98 191 182],72,5,18148,4.069970845481049,40.0,0.0
34459,3,4459,[ 15   4 125 275 183],796,5,18153,4.07017937219731,0.0,20.0
34460,3,4460,[234 385 175 655  22],716,3,18156,4.069939475453934,0.0,0.0
34461,3,4461,[318 427  98 191 182],18,5,18161,4.070147915732855,40.0,0.0
34462,3,4462,[318 427  98 191 182],796,5,18166,4.07035626260363,40.0,0.0
34463,3,4463,[318 427  98 191 182],796,5,18171,4.070564516129032,40.0,0.0
34464,3,4464,[318 427  98 191 182],18,5,18176,4.070772676371781,40.0,0.0
34465,3,4465,[318 427  98 191 182],450,5,18181,4.070980743394537,40.0,0.0
34466,3,4466,[ 88 211 183 135 328],236,1,18182,4.0702932616968885,0.0,0.0
34467,3,4467,[318 427  98 191 182],269,5,18187,4.0705013428827215,40.0,0.0
34468,3,4468,[ 50 483  82 132 215],151,3,18190,4.070261803535467,0.0,20.0
34469,3,4469,[318 427  98 191 182],18,5,18195,4.070469798657718,40.0,0.0
34470,3,4470,[196 483 275  89 143],457,5,18200,4.07067770073809,0.0,20.0
34471,3,4471,[ 96  15 237 271 180],796,4,18204,4.0706618962432914,0.0,0.0
34472,3,4472,[318 427  98 191 182],450,5,18209,4.070869662418958,40.0,0.0
34473,3,4473,[435 196 117  15  50],450,4,18213,4.070853822083147,0.0,20.0
34474,3,4474,[318 427  98 191 182],450,5,18218,4.071061452513966,40.0,0.0
34475,3,4475,[568  98 222   8 742],280,3,18221,4.070822162645219,0.0,0.0
34476,3,4476,[151 204 175 100 173],151,4,18225,4.070806343533616,0.0,20.0
34477,3,4477,[ 22 471 143 125 313],655,2,18227,4.070343903528361,0.0,0.0
34478,3,4478,[423 300  50 215 100],151,3,18230,4.070104934137084,0.0,40.0
34479,3,4479,[318 427  98 191 182],269,5,18235,4.0703125,40.0,0.0
34480,3,4480,[258 174 385 238 210],450,4,18239,4.070296808748047,0.0,0.0
34481,3,4481,[273 588 216 271  96],796,4,18243,4.070281124497992,0.0,0.0
34482,3,4482,[135 144 196 286 322],629,4,18247,4.0702654472451485,0.0,20.0
34483,3,4483,[318 427  98 191 182],269,5,18252,4.070472792149866,40.0,0.0
34484,3,4484,[  1 183  82 100 328],450,4,18256,4.070457079152732,0.0,20.0
34485,3,4485,[357  64 143 211 117],693,3,18259,4.070218457423094,20.0,0.0
34486,3,4486,[153  98 180 210  79],796,3,18262,4.069979942054825,0.0,0.0
34487,3,4487,[318 427  98 191 182],450,5,18267,4.070187165775401,40.0,0.0
34488,3,4488,[318 427  98 191 182],655,5,18272,4.070394297170862,40.0,0.0
34489,3,4489,[318 427  98 191 182],269,5,18277,4.070601336302896,40.0,0.0
34490,3,4490,[ 28  89 121 144 161],457,5,18282,4.070808283233133,0.0,0.0
34491,3,4491,[435 275 135 191 179],18,4,18286,4.070792520035619,0.0,20.0
34492,3,4492,[603 176 121  89 288],655,2,18288,4.070331626975295,20.0,0.0
34493,3,4493,[318 427  98 191 182],72,5,18293,4.070538495772141,40.0,0.0
34494,3,4494,[ 25  22 265 179 302],450,4,18297,4.070522803114572,0.0,0.0
34495,3,4495,[318 427  98 191 182],655,5,18302,4.070729537366548,40.0,0.0
34496,3,4496,[318 427  98 191 182],655,5,18307,4.070936179675339,40.0,0.0
34497,3,4497,[318 427  98 191 182],72,5,18312,4.071142730102268,40.0,0.0
34498,3,4498,[161 228  28   4 475],655,0,18312,4.070237830629028,0.0,0.0
34499,3,4499,[179 118   1 191 175],655,2,18314,4.0697777777777775,0.0,0.0
34500,3,4500,[318 427  98 191 182],450,5,18319,4.069984447900467,40.0,0.0
34501,3,4501,[161 118  96   1 300],807,4,18323,4.069968902709907,0.0,0.0
34502,3,4502,[318 427  98 191 182],72,5,18328,4.0701754385964914,40.0,0.0
34503,3,4503,[196 117 385  79 125],344,2,18330,4.069715808170515,0.0,0.0
34504,3,4504,[483 183 228 423 153],151,3,18333,4.069478357380688,0.0,0.0
34505,3,4505,[215  28 191 301 483],796,3,18336,4.069241011984022,0.0,0.0
34506,3,4506,[ 11 333 117 180 185],693,3,18339,4.069003771910362,0.0,0.0
34507,3,4507,[318 427  98 191 182],655,5,18344,4.069210292812778,40.0,0.0
34508,3,4508,[ 56 185 132  70 196],716,5,18349,4.069416722111333,0.0,0.0
34509,3,4509,[258 135 202 245 132],450,4,18353,4.06940133037694,0.0,0.0
34510,3,4510,[318 427  98 191 182],72,5,18358,4.069607625803592,40.0,0.0
34511,3,4511,[318 427  98 191 182],269,5,18363,4.069813829787234,40.0,0.0
34512,3,4512,[ 28 333 117 286 202],655,0,18363,4.068912031907822,0.0,20.0
34513,3,4513,[100 187 175 655   7],655,1,18364,4.068232166592822,0.0,20.0
34514,3,4514,[202  12 191  88 288],457,5,18369,4.06843853820598,0.0,0.0
34515,3,4515,[ 97 273 483 588 168],796,3,18372,4.068201948627103,0.0,0.0
34516,3,4516,[318 427  98 191 182],72,5,18377,4.068408235554571,40.0,0.0
34517,3,4517,[508   1 183  88  71],344,2,18379,4.067950420540062,0.0,0.0
34518,3,4518,[127 111 135 194  25],716,4,18383,4.067935383934499,0.0,20.0
34519,3,4519,[483 175 202  64 118],655,2,18385,4.067477876106195,20.0,0.0
34520,3,4520,[210 268 313 204 127],655,2,18387,4.067020570670206,0.0,20.0
34521,3,4521,[318 427  98 191 182],655,5,18392,4.067226890756302,40.0,0.0
34522,3,4522,[318 427  98 191 182],450,5,18397,4.067433119610878,40.0,0.0
34523,3,4523,[748 216 603  79 215],450,5,18402,4.06763925729443,20.0,0.0
34524,3,4524,[234 300  71 121 237],450,2,18404,4.067182320441989,0.0,0.0
34525,3,4525,[318 427  98 191 182],18,5,18409,4.067388422448078,40.0,0.0
34526,3,4526,[357  56 483 100 423],151,4,18413,4.067373536558427,0.0,20.0
34527,3,4527,[318 427  98 191 182],655,5,18418,4.067579505300353,40.0,0.0
34528,3,4528,[288 197 385 200 216],280,4,18422,4.067564583793332,0.0,0.0
34529,3,4529,[318 427  98 191 182],655,5,18427,4.067770419426049,40.0,0.0
34530,3,4530,[172   4 322 210 216],280,2,18429,4.067314058706687,0.0,0.0
34531,3,4531,[200  96 515 276 185],269,4,18433,4.0672992056487205,0.0,0.0
34532,3,4532,[210  11  22  69 237],577,3,18436,4.067063754687845,0.0,0.0
34533,3,4533,[318 427  98 191 182],18,5,18441,4.067269519188355,40.0,0.0
34534,3,4534,[195 245 161 300 403],504,4,18445,4.0672546857772875,0.0,0.0
34535,3,4535,[318 427  98 191 182],796,5,18450,4.067460317460317,40.0,0.0
34536,3,4536,[318 427  98 191 182],18,5,18455,4.067665858496804,40.0,0.0
34537,3,4537,[318 427  98 191 182],18,5,18460,4.067871308946673,40.0,0.0
34538,3,4538,[318 427  98 191 182],18,5,18465,4.068076668869795,40.0,0.0
34539,3,4539,[318 427  98 191 182],655,5,18470,4.068281938325991,40.0,0.0
34540,3,4540,[216 117 153 121 288],593,5,18475,4.068487117375027,0.0,0.0
34541,3,4541,[318 427  98 191 182],796,5,18480,4.068692206076618,40.0,0.0
34542,3,4542,[318 427  98 191 182],269,5,18485,4.068897204490425,40.0,0.0
34543,3,4543,[405  69 186 202 318],269,1,18486,4.068221830985915,20.0,0.0
34544,3,4544,[216 202   9  98 423],457,5,18491,4.068426842684269,0.0,0.0
34545,3,4545,[318 427  98 191 182],269,5,18496,4.068631764188297,40.0,0.0
34546,3,4546,[301 168  56 245 405],450,5,18501,4.06883659555751,0.0,0.0
34547,3,4547,[318 427  98 191 182],72,5,18506,4.069041336851363,40.0,0.0
34548,3,4548,[318 427  98 191 182],18,5,18511,4.069245988129259,40.0,0.0
34549,3,4549,[143 515 100  15 200],269,3,18514,4.069010989010989,0.0,20.0
34550,3,4550,[318 427  98 191 182],18,5,18519,4.069215557020435,40.0,0.0
34551,3,4551,[515 132 318 175 603],716,4,18523,4.069200351493849,40.0,0.0
34552,3,4552,[318 427  98 191 182],18,5,18528,4.069404788051834,40.0,0.0
34553,3,4553,[435 222 238  79  97],450,4,18532,4.069389547650418,0.0,0.0
34554,3,4554,[318 427  98 191 182],450,5,18537,4.069593852908891,40.0,0.0
34555,3,4555,[318 427  98 191 182],269,5,18542,4.0697980684811235,40.0,0.0
34556,3,4556,[  1 197 180  82 125],280,2,18544,4.0693438665788895,0.0,0.0
34557,3,4557,[318 427  98 191 182],796,5,18549,4.069548047389206,40.0,0.0
34558,3,4558,[318 427  98 191 182],450,5,18554,4.069752138626892,40.0,0.0
34559,3,4559,[318 427  98 191 182],655,5,18559,4.069956140350877,40.0,0.0
34560,3,4560,[202   1 271 228 151],796,4,18563,4.069940802455601,0.0,0.0
34561,3,4561,[318 427  98 191 182],450,5,18568,4.070144673388865,40.0,0.0
34562,3,4562,[546 185  95 183 228],23,3,18571,4.069910146833224,0.0,0.0
34563,3,4563,[385  70  28 515 191],655,2,18573,4.069456617002629,0.0,0.0
34564,3,4564,[ 95 678  22 183 302],344,3,18576,4.0692223439211395,0.0,0.0
34565,3,4565,[318 427  98 191 182],269,5,18581,4.069426193604905,40.0,0.0
34566,3,4566,[ 70 275 181 228 121],151,5,18586,4.069629954017955,0.0,20.0
34567,3,4567,[318 427  98 191 182],72,5,18591,4.069833625218914,40.0,0.0
34568,3,4568,[318 427  98 191 182],18,5,18596,4.070037207266361,40.0,0.0
34569,3,4569,[286  22 546 135 655],450,4,18600,4.070021881838074,0.0,20.0
34570,3,4570,[318 427  98 191 182],450,5,18605,4.070225333625027,40.0,0.0
34571,3,4571,[174 300 288  82 210],504,5,18610,4.070428696412948,0.0,0.0
34572,3,4572,[222 282 127 238  97],450,4,18614,4.070413295429696,0.0,20.0
34573,3,4573,[318 427  98 191 182],796,5,18619,4.070616528202886,40.0,0.0
34574,3,4574,[181 111  82  97 282],796,3,18622,4.070382513661202,0.0,0.0
34575,3,4575,[318 427  98 191 182],796,5,18627,4.070585664335664,40.0,0.0
34576,3,4576,[588 318 121   4 111],716,4,18631,4.070570242516933,20.0,0.0
34577,3,4577,[301 182 269  64 127],796,3,18634,4.0703363914373085,20.0,20.0
34578,3,4578,[597 238 302  97  89],450,5,18639,4.070539419087137,0.0,0.0
34579,3,4579,[318 427  98 191 182],18,5,18644,4.070742358078602,40.0,0.0
34580,3,4580,[ 12 194 135 286 153],18,3,18647,4.070508622571491,0.0,20.0
34581,3,4581,[ 82  12 183 237 121],450,3,18650,4.070274989087735,0.0,0.0
34582,3,4582,[405   1 176 471 235],450,4,18654,4.070259655247654,0.0,0.0
34583,3,4583,[276  97 318  11 237],224,2,18656,4.069808027923211,20.0,0.0
34584,3,4584,[318 427  98 191 182],450,5,18661,4.070010905125409,40.0,0.0
34585,3,4585,[318 427  98 191 182],796,5,18666,4.07021369385085,40.0,0.0
34586,3,4586,[ 97 144 180 174 215],796,3,18669,4.069980379332898,0.0,0.0
34587,3,4587,[196 228 322 143   1],151,4,18673,4.069965126416739,0.0,0.0
34588,3,4588,[318 427  98 191 182],655,5,18678,4.070167792547396,40.0,0.0
34589,3,4589,[318 427  98 191 182],18,5,18683,4.07037037037037,40.0,0.0
34590,3,4590,[ 70 294 286 273 603],655,2,18685,4.069919407536484,20.0,20.0
34591,3,4591,[318 427  98 191 182],796,5,18690,4.070121951219512,40.0,0.0
34592,3,4592,[318 427  98 191 182],655,5,18695,4.070324406705857,40.0,0.0
34593,3,4593,[ 25  28 273 257 294],655,1,18696,4.0696560731388765,0.0,0.0
34594,3,4594,[151  25  69 597 322],450,4,18700,4.069640914036997,0.0,0.0
34595,3,4595,[318 427  98 191 182],655,5,18705,4.069843342036553,40.0,0.0
34596,3,4596,[318 427  98 191 182],269,5,18710,4.0700456819665,40.0,0.0
34597,3,4597,[318 427  98 191 182],450,5,18715,4.070247933884297,40.0,0.0
34598,3,4598,[318 427  98 191 182],72,5,18720,4.070450097847358,40.0,0.0
34599,3,4599,[265 118 181 275 191],450,4,18724,4.070434782608696,0.0,20.0
34600,3,4600,[655 175 144 323 174],23,2,18726,4.069984785916105,0.0,0.0
34601,3,4601,[318 427  98 191 182],18,5,18731,4.070186875271621,40.0,0.0
34602,3,4602,[234  64 257 195  71],796,4,18735,4.070171627199652,20.0,0.0
34603,3,4603,[357 143 302 483 748],151,3,18738,4.069939183318853,0.0,0.0
34604,3,4604,[238 210   8 195 174],269,1,18739,4.069272529858849,0.0,0.0
34605,3,4605,[318 427  98 191 182],72,5,18744,4.069474598349978,40.0,0.0
34606,3,4606,[318 427  98 191 182],796,5,18749,4.069676579118732,40.0,0.0
34607,3,4607,[318 427  98 191 182],72,5,18754,4.069878472222222,40.0,0.0
34608,3,4608,[318 427  98 191 182],796,5,18759,4.070080277717509,40.0,0.0
34609,3,4609,[357  79  56 288  22],457,5,18764,4.070281995661605,0.0,0.0
34610,3,4610,[121 204 117 471 222],655,0,18764,4.069399262632834,0.0,0.0
34611,3,4611,[318 427  98 191 182],796,5,18769,4.069601040763226,40.0,0.0
34612,3,4612,[318 427  98 191 182],655,5,18774,4.0698027314112295,40.0,0.0
34613,3,4613,[144  82 588 655 471],280,1,18775,4.069137407889033,0.0,0.0
34614,3,4614,[118 483 228 265 174],655,1,18776,4.068472372697725,0.0,0.0
34615,3,4615,[172 655 603 187 181],716,4,18780,4.0684575389948,20.0,0.0
34616,3,4616,[172  96  89  15 121],655,2,18782,4.068009529997834,0.0,0.0
34617,3,4617,[318 427  98 191 182],18,5,18787,4.068211346903421,40.0,0.0
34618,3,4618,[318 427  98 191 182],796,5,18792,4.068413076423468,40.0,0.0
34619,3,4619,[294  96 289 258 125],655,0,18792,4.067532467532468,0.0,0.0
34620,3,4620,[318 427  98 191 182],655,5,18797,4.067734256654404,40.0,0.0
34621,3,4621,[318 427  98 191 182],72,5,18802,4.067935958459541,40.0,0.0
34622,3,4622,[318 427  98 191 182],796,5,18807,4.068137573004543,40.0,0.0
34623,3,4623,[286 483   9 216 508],280,4,18811,4.068122837370242,0.0,20.0
34624,3,4624,[ 50 216 151 286 268],344,3,18814,4.067891891891892,0.0,40.0
34625,3,4625,[257  88 195 176 238],655,0,18814,4.067012537829658,0.0,0.0
34626,3,4626,[318 427  98 191 182],18,5,18819,4.0672141776529065,40.0,0.0
34627,3,4627,[318 427  98 191 182],655,5,18824,4.067415730337078,40.0,0.0
34628,3,4628,[ 96 471 200 191  88],716,3,18827,4.067185137178656,0.0,0.0
34629,3,4629,[318 427  98 191 182],450,5,18832,4.067386609071274,40.0,0.0
34630,3,4630,[318 427  98 191 182],18,5,18837,4.06758799395379,40.0,0.0
34631,3,4631,[318 427  98 191 182],450,5,18842,4.067789291882556,40.0,0.0
34632,3,4632,[318 427  98 191 182],655,5,18847,4.0679905029138785,40.0,0.0
34633,3,4633,[597 195 294 210   8],796,3,18850,4.0677600345274065,0.0,0.0
34634,3,4634,[471 174 215 568  97],344,2,18852,4.067313915857605,0.0,0.0
34635,3,4635,[322  50 183 496  56],450,5,18857,4.067515099223469,20.0,20.0
34636,3,4636,[318 427  98 191 182],450,5,18862,4.067716195816261,40.0,0.0
34637,3,4637,[ 64  79 195 234 117],450,4,18866,4.067701595515309,20.0,0.0
34638,3,4638,[275 222 228 423 385],786,5,18871,4.067902565208019,0.0,20.0
34639,3,4639,[588 483  15 117 237],450,3,18874,4.067672413793104,0.0,0.0
34640,3,4640,[318 427  98 191 182],72,5,18879,4.067873303167421,40.0,0.0
34641,3,4641,[318 427  98 191 182],796,5,18884,4.068074105988798,40.0,0.0
34642,3,4642,[222 318 265 143 258],796,5,18889,4.0682748223131595,20.0,0.0
34643,3,4643,[496 215 196 742 100],344,3,18892,4.068044788975022,20.0,20.0
34644,3,4644,[ 98 127  79  50 300],908,4,18896,4.068030139935415,0.0,40.0
34645,3,4645,[172 216 282 271 111],796,5,18901,4.06823073611709,0.0,0.0
34646,3,4646,[483 100 258  11 228],457,5,18906,4.068431245965138,0.0,20.0
34647,3,4647,[318 427  98 191 182],269,5,18911,4.068631669535284,40.0,0.0
34648,3,4648,[186 403 121   9 222],693,0,18911,4.067756506775651,0.0,0.0
34649,3,4649,[318 427  98 191 182],796,5,18916,4.067956989247312,40.0,0.0
34650,3,4650,[132 200 181 275 222],655,2,18918,4.067512362932702,0.0,20.0
34651,3,4651,[318 427  98 191 182],18,5,18923,4.067712811693895,40.0,0.0
34652,3,4652,[318 427  98 191 182],72,5,18928,4.067913174296153,40.0,0.0
34653,3,4653,[318 427  98 191 182],18,5,18933,4.068113450795015,40.0,0.0
34654,3,4654,[318 427  98 191 182],450,5,18938,4.068313641245972,40.0,0.0
34655,3,4655,[318 427  98 191 182],269,5,18943,4.068513745704467,40.0,0.0
34656,3,4656,[172 183 276  79 318],457,5,18948,4.068713764225897,20.0,0.0
34657,3,4657,[318 427  98 191 182],655,5,18953,4.068913696865607,40.0,0.0
34658,3,4658,[318 427  98 191 182],18,5,18958,4.069113543678901,40.0,0.0
34659,3,4659,[257 301 215   4  88],655,0,18958,4.0682403433476395,0.0,0.0
34660,3,4660,[234 181  25 144  22],450,3,18961,4.068011156404205,0.0,0.0
34661,3,4661,[597 357 172 237 161],269,1,18962,4.067353067353068,0.0,0.0
34662,3,4662,[196  82   1 357 174],786,5,18967,4.067553077417971,0.0,0.0
34663,3,4663,[318 427  98 191 182],655,5,18972,4.067753001715266,40.0,0.0
34664,3,4664,[191 275 235 181 276],344,3,18975,4.067524115755627,0.0,20.0
34665,3,4665,[318 427  98 191 182],655,5,18980,4.067723960565795,40.0,0.0
34666,3,4666,[222 288   4 294 121],457,4,18984,4.067709449325048,0.0,0.0
34667,3,4667,[237 483 245 568 172],450,4,18988,4.067694944301628,0.0,0.0
34668,3,4668,[318 427  98 191 182],269,5,18993,4.067894624116513,40.0,0.0
34669,3,4669,[210 313 265 508  70],655,1,18994,4.067237687366167,0.0,0.0
34670,3,4670,[318 427  98 191 182],450,5,18999,4.067437379576108,40.0,0.0
34671,3,4671,[318 427  98 191 182],269,5,19004,4.06763698630137,40.0,0.0
34672,3,4672,[318 427  98 191 182],450,5,19009,4.067836507596833,40.0,0.0
34673,3,4673,[ 95 125 385 403   1],577,5,19014,4.06803594351733,0.0,0.0
34674,3,4674,[318 427  98 191 182],269,5,19019,4.068235294117647,40.0,0.0
34675,3,4675,[423 269  69 180 257],796,3,19022,4.0680068434559455,0.0,0.0
34676,3,4676,[318 427  98 191 182],655,5,19027,4.0682061150310025,40.0,0.0
34677,3,4677,[318 427  98 191 182],450,5,19032,4.068405301410859,40.0,0.0
34678,3,4678,[318 427  98 191 182],72,5,19037,4.068604402650139,40.0,0.0
34679,3,4679,[ 71 496 200 655 275],796,4,19041,4.068589743589744,20.0,20.0
34680,3,4680,[318 427  98 191 182],18,5,19046,4.0687887203588975,40.0,0.0
34681,3,4681,[ 56  69 127  64  97],796,4,19050,4.06877402819308,20.0,20.0
34682,3,4682,[ 82 135 234 174  69],18,1,19051,4.068118727311552,0.0,0.0
34683,3,4683,[  7 100 237 257 403],457,4,19055,4.068104184457728,0.0,20.0
34684,3,4684,[228 237 174 144  98],450,5,19060,4.068303094983992,0.0,0.0
34685,3,4685,[288  11 172 265  22],629,4,19064,4.068288518992745,0.0,0.0
34686,3,4686,[100 234 181 196 257],23,2,19066,4.067847237038618,0.0,20.0
34687,3,4687,[357 385 302 100  71],401,2,19068,4.0674061433447095,0.0,20.0
34688,3,4688,[ 96   9 215 118  70],72,4,19072,4.0673917679675835,0.0,0.0
34689,3,4689,[318 427  98 191 182],72,5,19077,4.067590618336887,40.0,0.0
34690,3,4690,[318 427  98 191 182],796,5,19082,4.067789383926668,40.0,0.0
34691,3,4691,[135 222 181  79 100],450,3,19085,4.067561807331629,0.0,20.0
34692,3,4692,[117 333 427  79 282],796,5,19090,4.067760494353292,20.0,0.0
34693,3,4693,[318 427  98 191 182],72,5,19095,4.067959096719216,40.0,0.0
34694,3,4694,[195 423 143 257 483],807,4,19099,4.067944621938232,0.0,0.0
34695,3,4695,[603   4 117 318 257],716,4,19103,4.067930153321976,40.0,0.0
34696,3,4696,[328  97  98  64 197],450,5,19108,4.0681285927187565,20.0,0.0
34697,3,4697,[318 427  98 191 182],796,5,19113,4.068326947637292,40.0,0.0
34698,3,4698,[197 200 286 182 385],280,3,19116,4.0680995956586505,0.0,20.0
34699,3,4699,[318 427  98 191 182],72,5,19121,4.068297872340426,40.0,0.0
34700,3,4700,[318 427  98 191 182],18,5,19126,4.068496064667092,40.0,0.0
34701,3,4701,[143 197 568 748   1],450,5,19131,4.068694172692472,0.0,0.0
34702,3,4702,[318 427  98 191 182],18,5,19136,4.068892196470338,40.0,0.0
34703,3,4703,[173 210 172   1 515],535,2,19138,4.068452380952381,0.0,0.0
34704,3,4704,[301 276  11 257 273],655,2,19140,4.068012752391073,0.0,0.0
34705,3,4705,[588 228 286 211 245],796,2,19142,4.067573310667234,0.0,20.0
34706,3,4706,[ 64 181 127 191 100],389,5,19147,4.067771404291481,20.0,40.0
34707,3,4707,[318 427  98 191 182],655,5,19152,4.067969413763806,40.0,0.0
34708,3,4708,[ 96 204 135 144 237],450,4,19156,4.067954979825865,0.0,0.0
34709,3,4709,[423 515 168 181 216],716,5,19161,4.0681528662420385,0.0,0.0
34710,3,4710,[294  12 318 173 216],450,5,19166,4.068350668647845,20.0,0.0
34711,3,4711,[179 181 117 194 202],577,4,19170,4.068336162988116,0.0,0.0
34712,3,4712,[118  28 197   1  96],655,0,19170,4.067472947167409,0.0,0.0
34713,3,4713,[143 111 234   8  28],796,3,19173,4.067246499787866,0.0,0.0
34714,3,4714,[318 427  98 191 182],796,5,19178,4.06744432661718,40.0,0.0
34715,3,4715,[204  79  98 427 496],535,3,19181,4.067217981340119,40.0,0.0
34716,3,4716,[318 427  98 191 182],269,5,19186,4.067415730337078,40.0,0.0
34717,3,4717,[ 95 143 172 132 200],786,5,19191,4.06761339550657,0.0,0.0
34718,3,4718,[194 405  11 132 191],450,5,19196,4.067810976901886,0.0,0.0
34719,3,4719,[161 202 117  96 153],504,3,19199,4.067584745762712,0.0,0.0
34720,3,4720,[318 427  98 191 182],796,5,19204,4.067782249523406,40.0,0.0
34721,3,4721,[318 427  98 191 182],72,5,19209,4.067979669631512,40.0,0.0
34722,3,4722,[515  97 181 313 238],655,2,19211,4.067541816641965,0.0,0.0
34723,3,4723,[318 427  98 191 182],796,5,19216,4.0677392040643525,40.0,0.0
34724,3,4724,[318 427  98 191 182],269,5,19221,4.0679365079365075,40.0,0.0
34725,3,4725,[196  12 161   1   9],796,3,19224,4.067710537452391,0.0,0.0
34726,3,4726,[318 427  98 191 182],18,5,19229,4.0679077639094565,40.0,0.0
34727,3,4727,[135 132 496 180 210],535,4,19233,4.067893401015229,20.0,0.0
34728,3,4728,[318 427  98 191 182],72,5,19238,4.06809050539226,40.0,0.0
34729,3,4729,[273 313 286  71 176],236,2,19240,4.067653276955602,0.0,20.0
34730,3,4730,[496 678 546  71  22],280,4,19244,4.067638976960473,20.0,0.0
34731,3,4731,[181  79 275 200 161],450,4,19248,4.067624683009298,0.0,20.0
34732,3,4732,[100 172 204 289   9],236,2,19250,4.067187830128883,0.0,20.0
34733,3,4733,[318 427  98 191 182],796,5,19255,4.067384875369666,40.0,0.0
34734,3,4734,[180 132 211   8 597],269,2,19257,4.066948257655755,0.0,0.0
34735,3,4735,[318 427  98 191 182],269,5,19262,4.06714527027027,40.0,0.0
34736,3,4736,[318 427  98 191 182],269,5,19267,4.067342199704454,40.0,0.0
34737,3,4737,[318 427  98 191 182],450,5,19272,4.0675390460109755,40.0,0.0
34738,3,4738,[269 196 135  82 588],450,3,19275,4.0673137792783285,0.0,0.0
34739,3,4739,[265  95 597 423  97],796,4,19279,4.067299578059072,0.0,0.0
34740,3,4740,[111 161  11  98 143],436,4,19283,4.067285382830627,0.0,0.0
34741,3,4741,[ 96   1  69  11 257],457,4,19287,4.067271193589203,0.0,0.0
34742,3,4742,[318 427  98 191 182],269,5,19292,4.067467847353996,40.0,0.0
34743,3,4743,[117 132 211 202 179],786,5,19297,4.067664418212479,0.0,0.0
34744,3,4744,[  9 294  22 597 588],457,3,19300,4.067439409905163,0.0,0.0
34745,3,4745,[318 427  98 191 182],269,5,19305,4.06763590391909,40.0,0.0
34746,3,4746,[318 427  98 191 182],655,5,19310,4.067832315146409,40.0,0.0
34747,3,4747,[318 427  98 191 182],655,5,19315,4.068028643639427,40.0,0.0
34748,3,4748,[100 300   8 216 258],11,3,19318,4.067803748157507,0.0,20.0
34749,3,4749,[318 196  50 161  25],577,5,19323,4.068,20.0,20.0
34750,3,4750,[318 427  98 191 182],450,5,19328,4.068196169227531,40.0,0.0
34751,3,4751,[403 180 435 197 196],450,5,19333,4.068392255892256,0.0,0.0
34752,3,4752,[318 427  98 191 182],18,5,19338,4.068588260046287,40.0,0.0
34753,3,4753,[ 97 176 228 161  88],655,0,19338,4.0677324358435,0.0,0.0
34754,3,4754,[135 118 286 357   7],450,3,19341,4.067507886435331,0.0,20.0
34755,3,4755,[318 427  98 191 182],655,5,19346,4.067703952901598,40.0,0.0
34756,3,4756,[ 97  98 655 546   8],796,3,19349,4.067479503889006,0.0,0.0
34757,3,4757,[318 427  98 191 182],450,5,19354,4.067675493905002,40.0,0.0
34758,3,4758,[318 427  98 191 182],18,5,19359,4.067871401554949,40.0,0.0
34759,3,4759,[318 427  98 191 182],18,5,19364,4.068067226890756,40.0,0.0
34760,3,4760,[318 427  98 191 182],269,5,19369,4.068262969964294,40.0,0.0
34761,3,4761,[318 427  98 191 182],18,5,19374,4.068458630827384,40.0,0.0
34762,3,4762,[318 427  98 191 182],655,5,19379,4.0686542095318075,40.0,0.0
34763,3,4763,[174 179 186  12 173],457,5,19384,4.068849706129303,0.0,0.0
34764,3,4764,[318 427  98 191 182],450,5,19389,4.069045120671563,40.0,0.0
34765,3,4765,[318 427  98 191 182],796,5,19394,4.069240453210239,40.0,0.0
34766,3,4766,[176  98 235 405 174],23,3,19397,4.069016152716594,0.0,0.0
34767,3,4767,[181 265   8 173   9],796,4,19401,4.069001677852349,0.0,0.0
34768,3,4768,[318 427  98 191 182],796,5,19406,4.06919689662403,40.0,0.0
34769,3,4769,[  9 117  56 300 197],796,3,19409,4.068972746331237,0.0,0.0
34770,3,4770,[204 588 195 237  11],344,3,19412,4.068748690002096,0.0,0.0
34771,3,4771,[161 275  95 282 245],796,4,19416,4.068734283319363,0.0,20.0
34772,3,4772,[318 427  98 191 182],72,5,19421,4.06892939451079,40.0,0.0
34773,3,4773,[275 237 191 117 173],152,5,19426,4.0691244239631335,0.0,20.0
34774,3,4774,[318 427  98 191 182],269,5,19431,4.069319371727748,40.0,0.0
34775,3,4775,[357 151 748 143 182],796,5,19436,4.069514237855946,0.0,0.0
34776,3,4776,[318 427  98 191 182],269,5,19441,4.069709022398995,40.0,0.0
34777,3,4777,[ 71  25 143 385 173],450,3,19444,4.069485140226036,0.0,0.0
34778,3,4778,[318 427  98 191 182],450,5,19449,4.069679849340866,40.0,0.0
34779,3,4779,[318 427  98 191 182],269,5,19454,4.069874476987447,40.0,0.0
34780,3,4780,[496 179  11 182 117],593,4,19458,4.069859861953566,20.0,0.0
34781,3,4781,[  4 174 118 168 173],151,4,19462,4.069845253032204,0.0,0.0
34782,3,4782,[318 427  98 191 182],72,5,19467,4.07003972402258,40.0,0.0
34783,3,4783,[603 423 100 197 151],796,3,19470,4.069816053511706,20.0,20.0
34784,3,4784,[ 98  28 118  50 135],389,3,19473,4.069592476489028,0.0,20.0
34785,3,4785,[318 427  98 191 182],450,5,19478,4.06978687839532,40.0,0.0
34786,3,4786,[318 427  98 191 182],18,5,19483,4.069981199080844,40.0,0.0
34787,3,4787,[265 185 211  82 175],716,4,19487,4.069966583124478,0.0,0.0
34788,3,4788,[403 265  79 282 496],450,5,19492,4.070160785132596,20.0,0.0
34789,3,4789,[ 11 125 181 117 237],450,5,19497,4.07035490605428,0.0,0.0
34790,3,4790,[117  56 143 423 215],457,5,19502,4.070548945940304,0.0,0.0
34791,3,4791,[405 161 271 172  69],807,4,19506,4.070534223706177,0.0,0.0
34792,3,4792,[194 195  56 143   1],716,4,19510,4.0705195076152725,0.0,0.0
34793,3,4793,[318 427  98 191 182],269,5,19515,4.070713391739675,40.0,0.0
34794,3,4794,[318 427  98 191 182],269,5,19520,4.070907194994787,40.0,0.0
34795,3,4795,[318 427  98 191 182],655,5,19525,4.071100917431193,40.0,0.0
34796,3,4796,[132 222  97 185 385],450,4,19529,4.071086095476339,0.0,0.0
34797,3,4797,[318 427  98 191 182],18,5,19534,4.071279699874948,40.0,0.0
34798,3,4798,[ 22 357 168  11 151],716,5,19539,4.071473223588248,0.0,0.0
34799,3,4799,[318 427  98 191 182],655,5,19544,4.071666666666666,40.0,0.0
34800,3,4800,[318 427  98 191 182],18,5,19549,4.071860029160591,40.0,0.0
34801,3,4801,[  9 588 127 202  28],457,5,19554,4.072053311120366,0.0,20.0
34802,3,4802,[318 427  98 191 182],796,5,19559,4.072246512596294,40.0,0.0
34803,3,4803,[318 427  98 191 182],655,5,19564,4.072439633638634,40.0,0.0
34804,3,4804,[ 12  79 117 121 588],450,4,19568,4.072424557752341,0.0,0.0
34805,3,4805,[318 427  98 191 182],655,5,19573,4.072617561381606,40.0,0.0
34806,3,4806,[318 427  98 191 182],18,5,19578,4.072810484709798,40.0,0.0
34807,3,4807,[318 427  98 191 182],796,5,19583,4.0730033277870215,40.0,0.0
34808,3,4808,[318 427  98 191 182],796,5,19588,4.073196090663339,40.0,0.0
34809,3,4809,[318 427  98 191 182],796,5,19593,4.073388773388773,40.0,0.0
34810,3,4810,[318 427  98 191 182],450,5,19598,4.073581376013303,40.0,0.0
34811,3,4811,[318 427  98 191 182],655,5,19603,4.073773898586866,40.0,0.0
34812,3,4812,[588 238  50 197 742],450,5,19608,4.07396634115936,0.0,20.0
34813,3,4813,[191  97  15  22 111],450,4,19612,4.073950976319069,0.0,0.0
34814,3,4814,[318 427  98 191 182],796,5,19617,4.074143302180685,40.0,0.0
34815,3,4815,[318 427  98 191 182],796,5,19622,4.0743355481727574,40.0,0.0
34816,3,4816,[318 427  98 191 182],655,5,19627,4.074527714345028,40.0,0.0
34817,3,4817,[318 427  98 191 182],655,5,19632,4.074719800747198,40.0,0.0
34818,3,4818,[117 588 748 185 153],450,5,19637,4.0749118074289274,0.0,0.0
34819,3,4819,[318 427  98 191 182],269,5,19642,4.075103734439834,40.0,0.0
34820,3,4820,[318 427  98 191 182],72,5,19647,4.075295581829496,40.0,0.0
34821,3,4821,[ 95 748 215 181 328],796,5,19652,4.0754873496474495,0.0,0.0
34822,3,4822,[423 202 183  25 286],655,1,19653,4.074849678623264,0.0,20.0
34823,3,4823,[318 427  98 191 182],796,5,19658,4.075041459369817,40.0,0.0
34824,3,4824,[ 95 202 182 471 204],389,4,19662,4.0750259067357515,0.0,0.0
34825,3,4825,[546  70  11 435 185],450,5,19667,4.075217571487775,0.0,0.0
34826,3,4826,[228  56 265 211 121],716,5,19672,4.075409156826186,0.0,0.0
34827,3,4827,[204 125 143 211  97],450,5,19677,4.075600662800332,0.0,0.0
34828,3,4828,[318 427  98 191 182],72,5,19682,4.075792089459515,40.0,0.0
34829,3,4829,[318 427  98 191 182],655,5,19687,4.075983436853002,40.0,0.0
34830,3,4830,[ 11 143 282 180 234],716,3,19690,4.075760712067895,0.0,0.0
34831,3,4831,[ 89 313 471   8 302],344,3,19693,4.075538079470198,0.0,0.0
34832,3,4832,[318 427  98 191 182],18,5,19698,4.075729360645561,40.0,0.0
34833,3,4833,[ 97 496 588 202 186],796,3,19701,4.075506826644601,20.0,0.0
34834,3,4834,[318 427  98 191 182],18,5,19706,4.07569803516029,40.0,0.0
34835,3,4835,[322  69 200 183  88],450,4,19710,4.075682382133995,0.0,0.0
34836,3,4836,[ 82 385 228 678 313],807,4,19714,4.0756667355799046,0.0,0.0
34837,3,4837,[228  12 508  64 222],693,1,19715,4.075031004547333,20.0,0.0
34838,3,4838,[ 82 204  56  15 471],577,2,19717,4.074602190535234,0.0,0.0
34839,3,4839,[318 427  98 191 182],18,5,19722,4.074793388429752,40.0,0.0
34840,3,4840,[318 427  98 191 182],450,5,19727,4.074984507333196,40.0,0.0
34841,3,4841,[318 427  98 191 182],655,5,19732,4.075175547294506,40.0,0.0
34842,3,4842,[176 508 183 228 282],280,0,19732,4.07433409043981,0.0,0.0
34843,3,4843,[318 427  98 191 182],450,5,19737,4.074525185796862,40.0,0.0
34844,3,4844,[186 143 181 515  88],716,4,19741,4.074509803921568,0.0,0.0
34845,3,4845,[301 111 742 121   1],655,0,19741,4.073669005365249,0.0,0.0
34846,3,4846,[238 318 275 483 234],18,4,19745,4.073653806478234,20.0,20.0
34847,3,4847,[318 427  98 191 182],450,5,19750,4.073844884488449,40.0,0.0
34848,3,4848,[ 79  89 161   9  12],72,4,19754,4.073829655599092,0.0,0.0
34849,3,4849,[132 161  70 245 238],450,5,19759,4.074020618556701,0.0,0.0
34850,3,4850,[508 568 357  70 289],655,1,19760,4.073386930529788,0.0,0.0
34851,3,4851,[  1 180  79  82  95],450,3,19763,4.073165704863974,0.0,0.0
34852,3,4852,[237  88  82 117 568],716,5,19768,4.073356686585617,0.0,0.0
34853,3,4853,[318 427  98 191 182],796,5,19773,4.073547589616811,40.0,0.0
34854,3,4854,[127 181  95 144 132],450,4,19777,4.0735324407826985,0.0,20.0
34855,3,4855,[318 427  98 191 182],269,5,19782,4.073723228995058,40.0,0.0
34856,3,4856,[132  95 245 318 483],450,3,19785,4.073502161828289,20.0,0.0
34857,3,4857,[ 50 210  97  95 118],450,2,19787,4.0730753396459445,0.0,20.0
34858,3,4858,[204 435 515 185 151],535,4,19791,4.073060300473348,0.0,0.0
34859,3,4859,[ 69 546  88 111  12],450,5,19796,4.073251028806585,0.0,0.0
34860,3,4860,[318 427  98 191 182],796,5,19801,4.073441678666941,40.0,0.0
34861,3,4861,[742 135 200  88  96],457,5,19806,4.073632250102838,0.0,0.0
34862,3,4862,[318 427  98 191 182],796,5,19811,4.073822743162657,40.0,0.0
34863,3,4863,[197 135 118 508 172],280,1,19812,4.073190789473684,0.0,0.0
34864,3,4864,[318 427  98 191 182],18,5,19817,4.073381294964029,40.0,0.0
34865,3,4865,[318 427  98 191 182],72,5,19822,4.073571722153719,40.0,0.0
34866,3,4866,[  9  97  89 483 546],151,4,19826,4.0735566057119375,0.0,0.0
34867,3,4867,[318 427  98 191 182],269,5,19831,4.073746918652424,40.0,0.0
34868,3,4868,[435  28 302 173 496],389,4,19835,4.073731772437872,20.0,0.0
34869,3,4869,[655 313  11 269 423],450,5,19840,4.073921971252567,0.0,0.0
34870,3,4870,[186  89 546 222   9],151,4,19844,4.073906795319236,0.0,0.0
34871,3,4871,[  9 151 210 216   4],256,5,19849,4.074096880131363,0.0,0.0
34872,3,4872,[318 427  98 191 182],655,5,19854,4.07428688692797,40.0,0.0
34873,3,4873,[318 427  98 191 182],18,5,19859,4.0744768157570785,40.0,0.0
34874,3,4874,[194 182   7 655 151],535,4,19863,4.074461538461539,0.0,0.0
34875,3,4875,[318 427  98 191 182],269,5,19868,4.074651353568499,40.0,0.0
34876,3,4876,[294 269 275 210 546],796,2,19870,4.074225958581095,0.0,20.0
34877,3,4877,[ 96  25 273 302 195],450,3,19873,4.074005740057401,0.0,0.0
34878,3,4878,[318 427  98 191 182],72,5,19878,4.074195531871285,40.0,0.0
34879,3,4879,[318 427  98 191 182],796,5,19883,4.074385245901639,40.0,0.0
34880,3,4880,[318 427  98 191 182],269,5,19888,4.074574882196271,40.0,0.0
34881,3,4881,[ 79 144 143 132 265],450,5,19893,4.07476444080295,0.0,0.0
34882,3,4882,[ 25 215  12 200  11],655,1,19894,4.074134753225477,0.0,0.0
34883,3,4883,[318 427  98 191 182],72,5,19899,4.074324324324325,40.0,0.0
34884,3,4884,[276 100 202  97  56],504,2,19901,4.073899692937564,0.0,20.0
34885,3,4885,[318 427  98 191 182],450,5,19906,4.074089234547687,40.0,0.0
34886,3,4886,[318 427  98 191 182],18,5,19911,4.074278698588091,40.0,0.0
34887,3,4887,[318 427  98 191 182],18,5,19916,4.074468085106383,40.0,0.0
34888,3,4888,[318 427  98 191 182],269,5,19921,4.074657394150133,40.0,0.0
34889,3,4889,[ 95 318  25  56 118],577,3,19924,4.074437627811861,20.0,0.0
34890,3,4890,[357 238 191 405 655],796,3,19927,4.074217951339194,0.0,0.0
34891,3,4891,[357 195 211  56 176],23,3,19930,4.073998364677024,0.0,0.0
34892,3,4892,[  1 328 176 385 168],450,5,19935,4.074187614960147,0.0,0.0
34893,3,4893,[318 427  98 191 182],72,5,19940,4.074376787903556,40.0,0.0
34894,3,4894,[603 275  71 357  95],330,5,19945,4.074565883554648,20.0,20.0
34895,3,4895,[135 216 515 174   7],321,4,19949,4.0745506535947715,0.0,0.0
34896,3,4896,[216 496   9  50 118],344,4,19953,4.074535429855013,20.0,20.0
34897,3,4897,[182 546 125 423 228],280,2,19955,4.07411188240098,0.0,0.0
34898,3,4898,[318 427  98 191 182],18,5,19960,4.074300877730149,40.0,0.0
34899,3,4899,[ 96  12  95   7 195],280,4,19964,4.074285714285714,0.0,0.0
34900,3,4900,[318 427  98 191 182],796,5,19969,4.074474597021016,40.0,0.0
34901,3,4901,[191 173 175 286 215],11,3,19972,4.074255405956753,0.0,20.0
34902,3,4902,[318 427  98 191 182],450,5,19977,4.074444217825821,40.0,0.0
34903,3,4903,[318 427  98 191 182],269,5,19982,4.0746329526916805,40.0,0.0
34904,3,4904,[ 89 173   1  82 258],807,3,19985,4.074413863404689,0.0,0.0
34905,3,4905,[286 245 180 265 176],450,5,19990,4.074602527517325,0.0,20.0
34906,3,4906,[318 427  98 191 182],18,5,19995,4.074791114734054,40.0,0.0
34907,3,4907,[318 427  98 191 182],450,5,20000,4.074979625101874,40.0,0.0
34908,3,4908,[318 427  98 191 182],655,5,20005,4.075168058667753,40.0,0.0
34909,3,4909,[318 427  98 191 182],450,5,20010,4.075356415478615,40.0,0.0
34910,3,4910,[318 427  98 191 182],450,5,20015,4.075544695581348,40.0,0.0
34911,3,4911,[275  82   7 423 194],23,3,20018,4.075325732899023,0.0,20.0
34912,3,4912,[100 403   1 427 181],5,3,20021,4.075106859352737,20.0,20.0
34913,3,4913,[318 427  98 191 182],269,5,20026,4.075295075295076,40.0,0.0
34914,3,4914,[268  50  12 197 275],655,2,20028,4.074872838250254,0.0,40.0
34915,3,4915,[181 180 173 176 117],292,5,20033,4.075061025223759,0.0,0.0
34916,3,4916,[318 427  98 191 182],269,5,20038,4.07524913565182,40.0,0.0
34917,3,4917,[318 427  98 191 182],796,5,20043,4.0754371695811304,40.0,0.0
34918,3,4918,[318 427  98 191 182],269,5,20048,4.075625127058345,40.0,0.0
34919,3,4919,[318 427  98 191 182],655,5,20053,4.075813008130082,40.0,0.0
34920,3,4920,[318 427  98 191 182],269,5,20058,4.076000812842918,40.0,0.0
34921,3,4921,[318 427  98 191 182],18,5,20063,4.076188541243397,40.0,0.0
34922,3,4922,[194 471 427 100 603],450,5,20068,4.076376193378022,40.0,20.0
34923,3,4923,[318 427  98 191 182],72,5,20073,4.076563769293258,40.0,0.0
34924,3,4924,[ 71 144 269  64 173],450,4,20077,4.076548223350254,20.0,0.0
34925,3,4925,[ 12  79 132 180  50],18,5,20082,4.07673568818514,0.0,20.0
34926,3,4926,[322 742 179 196  95],450,4,20086,4.0767201136594275,0.0,0.0
34927,3,4927,[357 471  97 435 269],450,5,20091,4.076907467532467,0.0,0.0
34928,3,4928,[318 427  98 191 182],450,5,20096,4.07709474538446,40.0,0.0
34929,3,4929,[172  97 405 125 186],577,4,20100,4.077079107505071,0.0,0.0
34930,3,4930,[121 153 195 423 168],796,5,20105,4.077266274589332,0.0,0.0
34931,3,4931,[276 135 568 202 475],655,2,20107,4.076845093268451,0.0,0.0
34932,3,4932,[318 427  98 191 182],18,5,20112,4.077032231907562,40.0,0.0
34933,3,4933,[258 211 275 245 286],450,5,20117,4.077219294689907,0.0,40.0
34934,3,4934,[318 427  98 191 182],18,5,20122,4.077406281661601,40.0,0.0
34935,3,4935,[125  88 237 100 258],504,3,20125,4.077188006482982,0.0,20.0
34936,3,4936,[318 427  98 191 182],269,5,20130,4.077374924042941,40.0,0.0
34937,3,4937,[180 257 181 357 328],796,4,20134,4.077359254759012,0.0,0.0
34938,3,4938,[196  28 273 318  15],236,3,20137,4.0771411216845515,20.0,0.0
34939,3,4939,[318 427  98 191 182],269,5,20142,4.077327935222672,40.0,0.0
34940,3,4940,[ 69 385 179 286  98],786,5,20147,4.077514673143089,0.0,20.0
34941,3,4941,[318 427  98 191 182],655,5,20152,4.077701335491704,40.0,0.0
34942,3,4942,[318 427  98 191 182],450,5,20157,4.077887922314384,40.0,0.0
34943,3,4943,[318 427  98 191 182],655,5,20162,4.078074433656958,40.0,0.0
34944,3,4944,[318 427  98 191 182],450,5,20167,4.078260869565217,40.0,0.0
34945,3,4945,[318 427  98 191 182],655,5,20172,4.078447230084917,40.0,0.0
34946,3,4946,[ 28 143 185  56 127],796,4,20176,4.078431372549019,0.0,20.0
34947,3,4947,[300 175 125   7 302],655,1,20177,4.077809215844786,0.0,0.0
34948,3,4948,[ 98 187  12 132 111],450,5,20182,4.077995554657506,0.0,0.0
34949,3,4949,[144 748  95  69 265],796,5,20187,4.078181818181818,0.0,0.0
34950,3,4950,[179 187  64 125  50],655,4,20191,4.078166027065239,20.0,20.0
34951,3,4951,[237 483  64 268 435],269,3,20194,4.0779483037156705,20.0,0.0
34952,3,4952,[318 427  98 191 182],796,5,20199,4.078134463961236,40.0,0.0
34953,3,4953,[191 216 100 210 357],344,5,20204,4.078320549051272,0.0,20.0
34954,3,4954,[405 144 197 496  50],450,5,20209,4.078506559031282,20.0,20.0
34955,3,4955,[204 313  89 515 238],296,5,20214,4.078692493946731,0.0,0.0
34956,3,4956,[  9   8 269 183 258],655,1,20215,4.0780714141617915,0.0,0.0
34957,3,4957,[195 302 403 151 235],269,1,20216,4.077450584913271,0.0,0.0
34958,3,4958,[318 427  98 191 182],450,5,20221,4.077636620286348,40.0,0.0
34959,3,4959,[318 427  98 191 182],796,5,20226,4.077822580645162,40.0,0.0
34960,3,4960,[235 100 135 423 568],330,4,20230,4.077806893771417,0.0,20.0
34961,3,4961,[180 172 215 286 300],796,3,20233,4.077589681580008,0.0,20.0
34962,3,4962,[125  69 118 403 200],577,3,20236,4.077372556921217,0.0,0.0
34963,3,4963,[ 11 333  28 435 111],655,0,20236,4.07655116841257,0.0,0.0
34964,3,4964,[ 70  96 269 200  25],655,1,20237,4.075931520644511,0.0,0.0
34965,3,4965,[  1 603 151 174   8],23,4,20241,4.075916230366492,20.0,0.0
34966,3,4966,[318 427  98 191 182],18,5,20246,4.076102275015099,40.0,0.0
34967,3,4967,[318 427  98 191 182],269,5,20251,4.076288244766506,40.0,0.0
34968,3,4968,[318 427  98 191 182],655,5,20256,4.076474139665929,40.0,0.0
34969,3,4969,[318 403  89  88 275],18,2,20258,4.076056338028169,20.0,20.0
34970,3,4970,[202 153 323 195 172],280,1,20259,4.075437537718769,0.0,0.0
34971,3,4971,[318 427  98 191 182],269,5,20264,4.075623491552695,40.0,0.0
34972,3,4972,[322   4 176  98   8],344,4,20268,4.075608284737583,0.0,0.0
34973,3,4973,[318 427  98 191 182],450,5,20273,4.075794129473261,40.0,0.0
34974,3,4974,[318 427  98 191 182],18,5,20278,4.075979899497487,40.0,0.0
34975,3,4975,[318 427  98 191 182],655,5,20283,4.076165594855305,40.0,0.0
34976,3,4976,[318 427  98 191 182],450,5,20288,4.076351215591722,40.0,0.0
34977,3,4977,[318 427  98 191 182],450,5,20293,4.076536761751708,40.0,0.0
34978,3,4978,[405 132 127 597 385],450,5,20298,4.076722233380197,0.0,20.0
34979,3,4979,[318 427  98 191 182],655,5,20303,4.076907630522088,40.0,0.0
34980,3,4980,[200 271 183  88 423],796,5,20308,4.077092953222245,0.0,0.0
34981,3,4981,[318 427  98 191 182],450,5,20313,4.077278201525492,40.0,0.0
34982,3,4982,[111 258   9 195 216],344,4,20317,4.077262693156733,0.0,0.0
34983,3,4983,[318 427  98 191 182],796,5,20322,4.07744783306581,40.0,0.0
34984,3,4984,[294 216 588 125 655],450,5,20327,4.077632898696089,0.0,0.0
34985,3,4985,[318 427  98 191 182],655,5,20332,4.077817890092258,40.0,0.0
34986,3,4986,[302 127 181 496  79],344,4,20336,4.077802285943453,20.0,20.0
34987,3,4987,[318 427  98 191 182],269,5,20341,4.077987169206095,40.0,0.0
34988,3,4988,[222 211 179 127  12],450,4,20345,4.077971537382241,0.0,20.0
34989,3,4989,[275 313  11 546 288],344,2,20347,4.077555110220441,0.0,20.0
34990,3,4990,[318 427  98 191 182],796,5,20352,4.077739931877379,40.0,0.0
34991,3,4991,[185  71 427 168 301],389,5,20357,4.07792467948718,20.0,0.0
34992,3,4992,[ 15 176 161 187 204],269,1,20358,4.077308231524134,0.0,0.0
34993,3,4993,[496 194 210 176 153],503,4,20362,4.077292751301562,20.0,0.0
34994,3,4994,[318 427  98 191 182],269,5,20367,4.077477477477477,40.0,0.0
34995,3,4995,[237 194 182 211 153],18,3,20370,4.077261809447558,0.0,0.0
34996,3,4996,[173 121 179 471  97],450,4,20374,4.077246347808686,0.0,0.0
34997,3,4997,[  9 273 300 176 172],655,2,20376,4.076830732292917,0.0,0.0
34998,3,4998,[187 210 121 196 357],504,4,20380,4.0768153630726145,0.0,0.0
34999,3,4999,[318 427  98 191 182],18,5,20385,4.077,40.0,0.0
35000,3,5000,[168 111 588 172 286],389,3,20388,4.076784643071385,0.0,20.0
35001,3,5001,[318 427  98 191 182],269,5,20393,4.076969212315074,40.0,0.0
35002,3,5002,[318 427  98 191 182],72,5,20398,4.077153707775334,40.0,0.0
35003,3,5003,[318 427  98 191 182],18,5,20403,4.077338129496403,40.0,0.0
35004,3,5004,[318 427  98 191 182],18,5,20408,4.077522477522478,40.0,0.0
35005,3,5005,[143 168 568 222  50],796,5,20413,4.077706751897723,0.0,20.0
35006,3,5006,[ 89 195  28 197 196],72,4,20417,4.077691232274815,0.0,0.0
35007,3,5007,[318 427  98 191 182],796,5,20422,4.077875399361022,40.0,0.0
35008,3,5008,[ 98 405 228   9 655],796,3,20425,4.077660211619086,0.0,0.0
35009,3,5009,[234 301   1 204  50],655,1,20426,4.077045908183632,0.0,20.0
35010,3,5010,[318 427  98 191 182],72,5,20431,4.077230093793654,40.0,0.0
35011,3,5011,[318 427  98 191 182],72,5,20436,4.077414205905826,40.0,0.0
35012,3,5012,[318 427  98 191 182],796,5,20441,4.0775982445641334,40.0,0.0
35013,3,5013,[318 427  98 191 182],269,5,20446,4.077782209812525,40.0,0.0
35014,3,5014,[ 50 210  56 143  98],389,3,20449,4.0775672981056825,0.0,20.0
35015,3,5015,[318 427  98 191 182],269,5,20454,4.077751196172249,40.0,0.0
35016,3,5016,[357  97  82 222   1],450,3,20457,4.07753637632051,0.0,0.0
35017,3,5017,[318 427  98 191 182],269,5,20462,4.077720207253886,40.0,0.0
35018,3,5018,[318 427  98 191 182],72,5,20467,4.077903964933253,40.0,0.0
35019,3,5019,[318 427  98 191 182],72,5,20472,4.0780876494023905,40.0,0.0
35020,3,5020,[318 427  98 191 182],655,5,20477,4.078271260705039,40.0,0.0
35021,3,5021,[318 427  98 191 182],450,5,20482,4.0784547988849065,40.0,0.0
35022,3,5022,[318 427  98 191 182],72,5,20487,4.078638263985666,40.0,0.0
35023,3,5023,[183 748 286 655  56],450,5,20492,4.078821656050955,0.0,20.0
35024,3,5024,[318 427  98 191 182],18,5,20497,4.079004975124378,40.0,0.0
35025,3,5025,[597 228  98 100 258],23,4,20501,4.0789892558694785,0.0,20.0
35026,3,5026,[318 427  98 191 182],796,5,20506,4.079172468669187,40.0,0.0
35027,3,5027,[216 125 204 153 183],280,2,20508,4.078758949880668,0.0,0.0
35028,3,5028,[216 405 282  98 181],457,5,20513,4.078942135613442,0.0,0.0
35029,3,5029,[117 135 121 655 196],693,2,20515,4.078528827037774,0.0,0.0
35030,3,5030,[181 748 238 228 200],450,4,20519,4.078513218048101,0.0,0.0
35031,3,5031,[318 427  98 191 182],655,5,20524,4.078696343402226,40.0,0.0
35032,3,5032,[196 111 210 161 181],798,2,20526,4.078283330021856,0.0,0.0
35033,3,5033,[318 427  98 191 182],72,5,20531,4.078466428287644,40.0,0.0
35034,3,5034,[176 202 132 210  12],344,5,20536,4.078649453823237,0.0,0.0
35035,3,5035,[318 427  98 191 182],269,5,20541,4.078832406671962,40.0,0.0
35036,3,5036,[318 427  98 191 182],72,5,20546,4.07901528687711,40.0,0.0
35037,3,5037,[318 427  98 191 182],655,5,20551,4.079198094481938,40.0,0.0
35038,3,5038,[318 427  98 191 182],18,5,20556,4.0793808295296685,40.0,0.0
35039,3,5039,[318 427  98 191 182],72,5,20561,4.0795634920634924,40.0,0.0
35040,3,5040,[318 427  98 191 182],18,5,20566,4.0797460821265625,40.0,0.0
35041,3,5041,[318 427  98 191 182],269,5,20571,4.079928599761999,40.0,0.0
35042,3,5042,[318 427  98 191 182],796,5,20576,4.080111045012889,40.0,0.0
35043,3,5043,[318 427  98 191 182],655,5,20581,4.080293417922284,40.0,0.0
35044,3,5044,[597 202 282 204 151],450,5,20586,4.080475718533201,0.0,0.0
35045,3,5045,[318 427  98 191 182],450,5,20591,4.080657946888625,40.0,0.0
35046,3,5046,[294  70  89 300  50],655,2,20593,4.080245690509213,0.0,20.0
35047,3,5047,[216   7 181 172 655],786,5,20598,4.080427892234549,0.0,0.0
35048,3,5048,[318 427  98 191 182],72,5,20603,4.080610021786493,40.0,0.0
35049,3,5049,[318 427  98 191 182],450,5,20608,4.080792079207921,40.0,0.0
35050,3,5050,[318 427  98 191 182],269,5,20613,4.0809740645416746,40.0,0.0
35051,3,5051,[318 427  98 191 182],655,5,20618,4.081155977830562,40.0,0.0
35052,3,5052,[ 25  97 143 568   4],450,3,20621,4.080942014644766,0.0,0.0
35053,3,5053,[100 179 183  70 238],264,5,20626,4.081123862287297,0.0,20.0
35054,3,5054,[318 427  98 191 182],655,5,20631,4.0813056379821955,40.0,0.0
35055,3,5055,[  4 405 286 301 173],344,3,20634,4.081091772151899,0.0,20.0
35056,3,5056,[318 427  98 191 182],72,5,20639,4.08127348230176,40.0,0.0
35057,3,5057,[245 194 117 197 496],450,5,20644,4.081455120601028,20.0,0.0
35058,3,5058,[475 238 125 182   8],655,1,20645,4.080846016999407,0.0,0.0
35059,3,5059,[318 427  98 191 182],72,5,20650,4.0810276679841895,40.0,0.0
35060,3,5060,[318 427  98 191 182],655,5,20655,4.081209247184351,40.0,0.0
35061,3,5061,[318 427  98 191 182],72,5,20660,4.081390754642434,40.0,0.0
35062,3,5062,[118  98 161 187 357],504,3,20663,4.081177167687142,0.0,0.0
35063,3,5063,[318 427  98 191 182],18,5,20668,4.081358609794629,40.0,0.0
35064,3,5064,[318 427  98 191 182],18,5,20673,4.081539980256664,40.0,0.0
35065,3,5065,[333 197 508 200 483],655,2,20675,4.081129095933676,0.0,0.0
35066,3,5066,[  7  69  28 405 196],72,3,20678,4.08091572922834,0.0,0.0
35067,3,5067,[173  25 588 235 322],344,3,20681,4.080702446724546,0.0,0.0
35068,3,5068,[100  70  79 289 268],655,1,20682,4.080094693233379,0.0,20.0
35069,3,5069,[318 427  98 191 182],269,5,20687,4.080276134122288,40.0,0.0
35070,3,5070,[258 187 200 151 127],796,5,20692,4.080457503450996,0.0,20.0
35071,3,5071,[318 427  98 191 182],796,5,20697,4.08063880126183,40.0,0.0
35072,3,5072,[216 143 179  15 186],577,2,20699,4.080228661541494,0.0,0.0
35073,3,5073,[496 748   8 185 174],796,5,20704,4.0804099329917225,20.0,0.0
35074,3,5074,[546 132 100 172 191],796,4,20708,4.080394088669951,0.0,20.0
35075,3,5075,[318 427  98 191 182],655,5,20713,4.080575256107171,40.0,0.0
35076,3,5076,[ 88  56 125 655  69],593,4,20717,4.080559385463856,0.0,0.0
35077,3,5077,[483 196 588 235 144],23,2,20719,4.080149665222528,0.0,0.0
35078,3,5078,[603 168 121 210 568],796,4,20723,4.080133884622957,20.0,0.0
35079,3,5079,[318 427  98 191 182],796,5,20728,4.080314960629921,40.0,0.0
35080,3,5080,[121 200 275 174  97],457,5,20733,4.080495965361149,0.0,20.0
35081,3,5081,[ 79 215 265  69 143],796,5,20738,4.080676898858717,0.0,0.0
35082,3,5082,[483 655 172 153 215],655,2,20740,4.080267558528428,0.0,0.0
35083,3,5083,[318 427  98 191 182],450,5,20745,4.08044846577498,40.0,0.0
35084,3,5084,[282 172   9 183 318],236,3,20748,4.08023598820059,20.0,0.0
35085,3,5085,[318 427  98 191 182],269,5,20753,4.08041683051514,40.0,0.0
35086,3,5086,[111   8 181 289 117],756,5,20758,4.0805976017299,0.0,0.0
35087,3,5087,[187 294 222 211 176],716,3,20761,4.080385220125786,0.0,0.0
35088,3,5088,[222 182 143  70 186],655,2,20763,4.079976419728827,0.0,0.0
35089,3,5089,[318 427  98 191 182],18,5,20768,4.080157170923379,40.0,0.0
35090,3,5090,[318 427  98 191 182],72,5,20773,4.080337851109801,40.0,0.0
35091,3,5091,[180 603 168 194 216],269,3,20776,4.0801256873527105,20.0,0.0
35092,3,5092,[  7 268  12 435 196],629,4,20780,4.080109954839976,0.0,0.0
35093,3,5093,[318 427  98 191 182],269,5,20785,4.080290537887711,40.0,0.0
35094,3,5094,[185  88 175 475 121],269,3,20788,4.080078508341511,0.0,0.0
35095,3,5095,[655 175 546  69 275],151,4,20792,4.080062794348509,0.0,20.0
35096,3,5096,[143 423  22 174 132],807,5,20797,4.080243280360997,0.0,0.0
35097,3,5097,[237 151 194 211 153],535,5,20802,4.080423695566889,0.0,0.0
35098,3,5098,[238 186 423  70  64],151,5,20807,4.080604040007844,20.0,0.0
35099,3,5099,[294  70 117 185   7],655,1,20808,4.08,0.0,0.0
35100,3,5100,[318 427  98 191 182],72,5,20813,4.080180356792786,40.0,0.0
35101,3,5101,[318 427  98 191 182],450,5,20818,4.080360642885143,40.0,0.0
35102,3,5102,[211  69 322 318 173],401,2,20820,4.079952968841858,20.0,0.0
35103,3,5103,[ 56 496 118 153 196],593,5,20825,4.0801332288401255,20.0,0.0
35104,3,5104,[318 427  98 191 182],269,5,20830,4.080313418217434,40.0,0.0
35105,3,5105,[100 748 117   4 265],256,5,20835,4.080493537015276,0.0,20.0
35106,3,5106,[385 357  50 403 269],655,2,20837,4.080086156256119,0.0,20.0
35107,3,5107,[318 427  98 191 182],796,5,20842,4.080266249021143,40.0,0.0
35108,3,5108,[ 28 328 546 271 286],796,3,20845,4.080054805245645,0.0,20.0
35109,3,5109,[176 588 181 742 265],280,3,20848,4.079843444227006,0.0,0.0
35110,3,5110,[483 216 294 182   9],796,3,20851,4.07963216591665,0.0,0.0
35111,3,5111,[318 427  98 191 182],18,5,20856,4.07981220657277,40.0,0.0
35112,3,5112,[117 742 276 153 151],504,3,20859,4.079601017015451,0.0,0.0
35113,3,5113,[318 427  98 191 182],796,5,20864,4.079780993351584,40.0,0.0
35114,3,5114,[318 427  98 191 182],72,5,20869,4.079960899315738,40.0,0.0
35115,3,5115,[568 234  15 180  96],72,5,20874,4.080140734949179,0.0,0.0
35116,3,5116,[228 181 471 197  64],716,4,20878,4.080125073285128,20.0,0.0
35117,3,5117,[357 143 405 234 286],450,4,20882,4.080109417741305,0.0,20.0
35118,3,5118,[318 427  98 191 182],655,5,20887,4.080289118968548,40.0,0.0
35119,3,5119,[318 427  98 191 182],450,5,20892,4.08046875,40.0,0.0
35120,3,5120,[168 427  50  82 185],796,4,20896,4.080453036516305,20.0,20.0
35121,3,5121,[318 427  98 191 182],269,5,20901,4.080632565404139,40.0,0.0
35122,3,5122,[318 427  98 191 182],450,5,20906,4.080812024204568,40.0,0.0
35123,3,5123,[318 427  98 191 182],655,5,20911,4.080991412958626,40.0,0.0
35124,3,5124,[282 300 405  22 603],450,5,20916,4.081170731707317,20.0,0.0
35125,3,5125,[318 427  98 191 182],450,5,20921,4.081349980491612,40.0,0.0
35126,3,5126,[172 100 568  22  70],330,5,20926,4.081529159352447,0.0,20.0
35127,3,5127,[318  82 597 197 546],457,3,20929,4.081318252730109,20.0,0.0
35128,3,5128,[318 427  98 191 182],18,5,20934,4.081497367907974,40.0,0.0
35129,3,5129,[179  97 111 237  88],457,4,20938,4.0814814814814815,0.0,0.0
35130,3,5130,[271 301 288  15 187],655,1,20939,4.0808809198986555,0.0,0.0
35131,3,5131,[ 96 195 172 127 546],344,4,20943,4.080865159781761,0.0,20.0
35132,3,5132,[475 238 186 180 211],269,3,20946,4.080654587960257,0.0,0.0
35133,3,5133,[174 471  70 508  12],655,0,20946,4.079859758472925,0.0,0.0
35134,3,5134,[ 69  12 603 228 127],450,5,20951,4.080038948393379,20.0,20.0
35135,3,5135,[186 172 135  28 173],450,3,20954,4.079828660436137,0.0,0.0
35136,3,5136,[318 427  98 191 182],18,5,20959,4.080007786645902,40.0,0.0
35137,3,5137,[183 328 318 257  15],796,5,20964,4.080186843129622,20.0,0.0
35138,3,5138,[318 427  98 191 182],269,5,20969,4.0803658299280015,40.0,0.0
35139,3,5139,[318 427  98 191 182],450,5,20974,4.080544747081712,40.0,0.0
35140,3,5140,[318 427  98 191 182],72,5,20979,4.080723594631395,40.0,0.0
35141,3,5141,[127 132 282  70 180],280,4,20983,4.080707895760405,0.0,20.0
35142,3,5142,[318 427  98 191 182],655,5,20988,4.080886642037721,40.0,0.0
35143,3,5143,[301  25 194 222 210],151,5,20993,4.08106531881804,0.0,0.0
35144,3,5144,[318 427  98 191 182],796,5,20998,4.081243926141886,40.0,0.0
35145,3,5145,[318 427  98 191 182],18,5,21003,4.081422464049747,40.0,0.0
35146,3,5146,[  4 197 211  56 117],796,3,21006,4.081212356712648,0.0,0.0
35147,3,5147,[200 197 118 194 111],151,3,21009,4.081002331002331,0.0,0.0
35148,3,5148,[ 97 300 135  12 153],655,1,21010,4.080403961934357,0.0,0.0
35149,3,5149,[ 64  50 187 286 435],389,4,21014,4.080388349514563,20.0,40.0
35150,3,5150,[318 427  98 191 182],655,5,21019,4.080566880217433,40.0,0.0
35151,3,5151,[318 427  98 191 182],796,5,21024,4.080745341614906,40.0,0.0
35152,3,5152,[288  96 132 144 322],450,4,21028,4.080729672035707,0.0,0.0
35153,3,5153,[135 603 568 191 117],72,5,21033,4.080908032596042,20.0,0.0
35154,3,5154,[318 427  98 191 182],72,5,21038,4.081086323957323,40.0,0.0
35155,3,5155,[318 427  98 191 182],18,5,21043,4.081264546159813,40.0,0.0
35156,3,5156,[318 427  98 191 182],18,5,21048,4.0814426992437465,40.0,0.0
35157,3,5157,[ 12 597 678  22   4],344,2,21050,4.081039162466072,0.0,0.0
35158,3,5158,[318 427  98 191 182],269,5,21055,4.081217290172514,40.0,0.0
35159,3,5159,[318 427  98 191 182],269,5,21060,4.0813953488372094,40.0,0.0
35160,3,5160,[ 64 187   9 174 238],796,3,21063,4.08118581670219,20.0,0.0
35161,3,5161,[483 132 194 191 176],269,4,21067,4.081170089112747,0.0,0.0
35162,3,5162,[127 357   9 161 135],269,4,21071,4.081154367615727,0.0,20.0
35163,3,5163,[318 427  98 191 182],655,5,21076,4.081332300542216,40.0,0.0
35164,3,5164,[118 405 173 135  64],716,3,21079,4.081122942884802,20.0,0.0
35165,3,5165,[318 427  98 191 182],450,5,21084,4.08130081300813,40.0,0.0
35166,3,5166,[ 82 313 197 234 182],280,0,21084,4.080510934778402,0.0,0.0
35167,3,5167,[ 89 210 328 435 286],655,1,21085,4.079914860681114,0.0,20.0
35168,3,5168,[318 427  98 191 182],796,5,21090,4.08009286128845,40.0,0.0
35169,3,5169,[318 427  98 191 182],269,5,21095,4.0802707930367506,40.0,0.0
35170,3,5170,[318 427  98 191 182],655,5,21100,4.080448655965964,40.0,0.0
35171,3,5171,[210  79 423 211 176],236,2,21102,4.080046403712297,0.0,0.0
35172,3,5172,[603 181 127 210  56],18,3,21105,4.079837618403247,20.0,20.0
35173,3,5173,[211 168 179  88 195],504,3,21108,4.079628913799768,0.0,0.0
35174,3,5174,[318 427  98 191 182],655,5,21113,4.079806763285024,40.0,0.0
35175,3,5175,[289 357 125 234  22],655,1,21114,4.079211746522411,0.0,0.0
35176,3,5176,[185  11 508 197 161],401,2,21116,4.0788101216921,0.0,0.0
35177,3,5177,[318 427  98 191 182],18,5,21121,4.078988026264967,40.0,0.0
35178,3,5178,[161 405 210  97 588],786,5,21126,4.0791658621355475,0.0,0.0
35179,3,5179,[168 121 282 234  89],457,5,21131,4.079343629343629,0.0,0.0
35180,3,5180,[132 143  71 328  69],450,4,21135,4.079328314997105,0.0,0.0
35181,3,5181,[318 427  98 191 182],450,5,21140,4.079505982246237,40.0,0.0
35182,3,5182,[318 427  98 191 182],269,5,21145,4.079683580937681,40.0,0.0
35183,3,5183,[228 403   7 125 546],457,4,21149,4.0796682098765435,0.0,0.0
35184,3,5184,[289 183 179 161  50],655,3,21152,4.0794599807135965,0.0,20.0
35185,3,5185,[187 100   4 118 181],796,4,21156,4.079444658696491,0.0,20.0
35186,3,5186,[318 427  98 191 182],269,5,21161,4.079622132253712,40.0,0.0
35187,3,5187,[603 135 222  97 127],716,4,21165,4.079606784888203,20.0,20.0
35188,3,5188,[318 427  98 191 182],796,5,21170,4.079784158797456,40.0,0.0
35189,3,5189,[318 427  98 191 182],796,5,21175,4.079961464354528,40.0,0.0
35190,3,5190,[197 318  28 328 174],151,4,21179,4.079946060489308,20.0,0.0
35191,3,5191,[ 70 197 187 117 194],504,2,21181,4.079545454545454,0.0,0.0
35192,3,5192,[186 423 546 215  56],693,2,21183,4.079145002888504,0.0,0.0
35193,3,5193,[318 427  98 191 182],796,5,21188,4.079322294955718,40.0,0.0
35194,3,5194,[318 427  98 191 182],72,5,21193,4.0794995187680465,40.0,0.0
35195,3,5195,[318 427  98 191 182],655,5,21198,4.0796766743648964,40.0,0.0
35196,3,5196,[318 427  98 191 182],796,5,21203,4.079853761785645,40.0,0.0
35197,3,5197,[318 427  98 191 182],796,5,21208,4.080030781069643,40.0,0.0
35198,3,5198,[318 427  98 191 182],269,5,21213,4.080207732256203,40.0,0.0
35199,3,5199,[294 403  22 121 258],450,4,21217,4.0801923076923075,0.0,0.0
35200,3,5200,[318 427  98 191 182],269,5,21222,4.080369159776966,40.0,0.0
35201,3,5201,[357 195  69 196  98],504,5,21227,4.080545943867743,0.0,0.0
35202,3,5202,[  9  56 194 132 333],629,5,21232,4.080722660003844,0.0,0.0
35203,3,5203,[200 125 286 265 161],796,4,21236,4.080707148347425,0.0,20.0
35204,3,5204,[318 427  98 191 182],18,5,21241,4.0808837656099906,40.0,0.0
35205,3,5205,[318 427  98 191 182],18,5,21246,4.081060315021129,40.0,0.0
35206,3,5206,[385 121   4 216 111],655,1,21247,4.08046859996159,0.0,0.0
35207,3,5207,[318 427  98 191 182],72,5,21252,4.080645161290323,40.0,0.0
35208,3,5208,[143 302 161  11  71],401,1,21253,4.080053753119601,0.0,0.0
35209,3,5209,[318 427  98 191 182],269,5,21258,4.0802303262955855,40.0,0.0
35210,3,5210,[318 427  98 191 182],18,5,21263,4.0804068317021684,40.0,0.0
35211,3,5211,[318 427  98 191 182],450,5,21268,4.080583269378358,40.0,0.0
35212,3,5212,[318 196 132 286 405],786,5,21273,4.080759639363131,20.0,20.0
35213,3,5213,[194 265 132  56   8],457,5,21278,4.080935941695436,0.0,0.0
35214,3,5214,[302 187 127 202  79],655,4,21282,4.080920421860019,0.0,20.0
35215,3,5215,[ 79 153 210 403   8],655,1,21283,4.080329754601227,0.0,0.0
35216,3,5216,[318 427  98 191 182],269,5,21288,4.080506037952847,40.0,0.0
35217,3,5217,[245 678 546 275 742],344,1,21289,4.079915676504408,0.0,20.0
35218,3,5218,[144 180 200  89 282],796,4,21293,4.079900364054416,0.0,0.0
35219,3,5219,[318 427  98 191 182],269,5,21298,4.08007662835249,40.0,0.0
35220,3,5220,[194  15 180 121 323],796,3,21301,4.07986975675158,0.0,0.0
35221,3,5221,[318 427  98 191 182],269,5,21306,4.080045959402527,40.0,0.0
35222,3,5222,[655   9 276 211 268],535,3,21309,4.0798391728891445,0.0,0.0
35223,3,5223,[318 427  98 191 182],450,5,21314,4.080015313935681,40.0,0.0
35224,3,5224,[183 405 294 568 161],796,4,21318,4.08,0.0,0.0
35225,3,5225,[475 603 168 302  70],269,3,21321,4.079793340987371,20.0,0.0
35226,3,5226,[318 427  98 191 182],18,5,21326,4.079969389707289,40.0,0.0
35227,3,5227,[318 427  98 191 182],450,5,21331,4.080145371078807,40.0,0.0
35228,3,5228,[318 427  98 191 182],72,5,21336,4.080321285140562,40.0,0.0
35229,3,5229,[318 427  98 191 182],72,5,21341,4.080497131931167,40.0,0.0
35230,3,5230,[228 294 200 153  82],280,2,21343,4.080099407379087,0.0,0.0
35231,3,5231,[ 25 257 195 265 127],655,1,21344,4.079510703363915,0.0,20.0
35232,3,5232,[318 427  98 191 182],450,5,21349,4.079686604242308,40.0,0.0
35233,3,5233,[318 427  98 191 182],18,5,21354,4.079862437905999,40.0,0.0
35234,3,5234,[301  11 268 179 257],655,1,21355,4.0792741165234006,0.0,0.0
35235,3,5235,[318 427  98 191 182],655,5,21360,4.0794499618029025,40.0,0.0
35236,3,5236,[318 427  98 191 182],796,5,21365,4.079625739927439,40.0,0.0
35237,3,5237,[357   4 210 118 300],716,3,21368,4.079419625811378,0.0,0.0
35238,3,5238,[282   9   1 471  15],593,2,21370,4.079022714258446,0.0,0.0
35239,3,5239,[318 427  98 191 182],269,5,21375,4.0791984732824424,40.0,0.0
35240,3,5240,[318 427  98 191 182],72,5,21380,4.079374165235642,40.0,0.0
35241,3,5241,[  7 423 546 118 181],151,3,21383,4.07916825639069,0.0,0.0
35242,3,5242,[318 427  98 191 182],450,5,21388,4.079343887087545,40.0,0.0
35243,3,5243,[318 427  98 191 182],796,5,21393,4.079519450800915,40.0,0.0
35244,3,5244,[515 427 168  28 222],807,5,21398,4.079694947569114,20.0,0.0
35245,3,5245,[196 294 202 121 211],450,4,21402,4.079679756004575,0.0,0.0
35246,3,5246,[318 427  98 191 182],450,5,21407,4.079855155326854,40.0,0.0
35247,3,5247,[ 89 125 118 179 187],655,3,21410,4.079649390243903,0.0,0.0
35248,3,5248,[318 427  98 191 182],18,5,21415,4.079824728519718,40.0,0.0
35249,3,5249,[318 427  98 191 182],18,5,21420,4.08,40.0,0.0
35250,3,5250,[ 88  71 237 125  25],593,4,21424,4.079984764806704,0.0,0.0
35251,3,5251,[216 276 655 185 678],504,4,21428,4.07996953541508,0.0,0.0
35252,3,5252,[318 427  98 191 182],655,5,21433,4.080144679230916,40.0,0.0
35253,3,5253,[515 288  96 118 153],292,3,21436,4.079939094023601,0.0,0.0
35254,3,5254,[328 117 269  22 748],450,5,21441,4.08011417697431,0.0,0.0
35255,3,5255,[318 427  98 191 182],18,5,21446,4.0802891933028915,40.0,0.0
35256,3,5256,[318 427  98 191 182],72,5,21451,4.080464143047365,40.0,0.0
35257,3,5257,[151  95 210 235 172],344,4,21455,4.080448839863066,0.0,0.0
35258,3,5258,[318 427  98 191 182],450,5,21460,4.080623692717246,40.0,0.0
35259,3,5259,[204 318 197 125 180],504,4,21464,4.080608365019011,20.0,0.0
35260,3,5260,[ 12 313 238 357 182],450,5,21469,4.080783121079643,0.0,0.0
35261,3,5261,[175 182 234 194  12],352,3,21472,4.080577727099962,0.0,0.0
35262,3,5262,[403  79  64  82  22],577,5,21477,4.080752422572677,20.0,0.0
35263,3,5263,[191 179 211 475 135],269,5,21482,4.080927051671733,0.0,0.0
35264,3,5264,[318 427  98 191 182],18,5,21487,4.081101614434948,40.0,0.0
35265,3,5265,[318 427  98 191 182],269,5,21492,4.081276110900114,40.0,0.0
35266,3,5266,[  9 117 301 300 180],796,2,21494,4.080880956901462,0.0,0.0
35267,3,5267,[318 427  98 191 182],796,5,21499,4.081055429005315,40.0,0.0
35268,3,5268,[318 427  98 191 182],450,5,21504,4.081229834883279,40.0,0.0
35269,3,5269,[302 515 483 196 144],655,3,21507,4.081024667931689,0.0,0.0
35270,3,5270,[318 427  98 191 182],450,5,21512,4.08119901346993,40.0,0.0
35271,3,5271,[318 427  98 191 182],18,5,21517,4.081373292867982,40.0,0.0
35272,3,5272,[186  12 215 125 238],655,0,21517,4.08059927934762,0.0,0.0
35273,3,5273,[318 427  98 191 182],450,5,21522,4.080773606370876,40.0,0.0
35274,3,5274,[405  97 174 181 427],330,5,21527,4.080947867298578,20.0,0.0
35275,3,5275,[318 427  98 191 182],655,5,21532,4.081122062168309,40.0,0.0
35276,3,5276,[318 427  98 191 182],796,5,21537,4.081296191017624,40.0,0.0
35277,3,5277,[318 427  98 191 182],655,5,21542,4.081470253884047,40.0,0.0
35278,3,5278,[318 427  98 191 182],796,5,21547,4.081644250805077,40.0,0.0
35279,3,5279,[318 427  98 191 182],655,5,21552,4.081818181818182,40.0,0.0
35280,3,5280,[196  64 258 471  25],344,3,21555,4.081613330808559,20.0,0.0
35281,3,5281,[318 427  98 191 182],18,5,21560,4.081787201817494,40.0,0.0
35282,3,5282,[318 427  98 191 182],796,5,21565,4.0819610070035965,40.0,0.0
35283,3,5283,[655 194  50 121  69],72,3,21568,4.0817562452687355,0.0,20.0
35284,3,5284,[ 22  56 427 300 118],450,4,21572,4.081740775780511,20.0,0.0
35285,3,5285,[318 427  98 191 182],18,5,21577,4.081914491108589,40.0,0.0
35286,3,5286,[318 427  98 191 182],18,5,21582,4.082088140722527,40.0,0.0
35287,3,5287,[185 117 288 471 210],693,2,21584,4.081694402420575,0.0,0.0
35288,3,5288,[318 427  98 191 182],18,5,21589,4.081868027982606,40.0,0.0
35289,3,5289,[603 515 153 211 174],18,4,21593,4.081852551984877,20.0,0.0
35290,3,5290,[318 427  98 191 182],18,5,21598,4.082026082026082,40.0,0.0
35291,3,5291,[237 300 294  88  98],504,2,21600,4.081632653061225,0.0,0.0
35292,3,5292,[318 427  98 191 182],796,5,21605,4.0818061590780275,40.0,0.0
35293,3,5293,[  1 161 258 191 222],23,3,21608,4.081601813373631,0.0,0.0
35294,3,5294,[318 427  98 191 182],72,5,21613,4.081775259678943,40.0,0.0
35295,3,5295,[ 88  50 300  69 200],655,2,21615,4.081382175226586,0.0,20.0
35296,3,5296,[234 182  96 168 127],269,3,21618,4.081178025297338,0.0,20.0
35297,3,5297,[318 427  98 191 182],655,5,21623,4.081351453378633,40.0,0.0
35298,3,5298,[318 427  98 191 182],72,5,21628,4.08152481600302,40.0,0.0
35299,3,5299,[318 427  98 191 182],72,5,21633,4.081698113207548,40.0,0.0
35300,3,5300,[ 96 269 176 132  88],796,4,21637,4.081682701377098,0.0,0.0
35301,3,5301,[  7   8  12 588 234],577,3,21640,4.081478687287816,0.0,0.0
35302,3,5302,[153  82 228  25 151],450,3,21643,4.0812747501414295,0.0,0.0
35303,3,5303,[118 210 238 245 121],593,3,21646,4.081070889894419,0.0,0.0
35304,3,5304,[318 427  98 191 182],269,5,21651,4.08124410933082,40.0,0.0
35305,3,5305,[588  88 117  69 187],716,4,21655,4.081228797587636,0.0,0.0
35306,3,5306,[318 427  98 191 182],796,5,21660,4.0814019219898245,40.0,0.0
35307,3,5307,[ 12 301 286 265 117],655,0,21660,4.080633006782215,0.0,20.0
35308,3,5308,[  1 269 176 191  56],450,5,21665,4.0808061781879825,0.0,0.0
35309,3,5309,[318 427  98 191 182],796,5,21670,4.080979284369115,40.0,0.0
35310,3,5310,[ 88 237 210  11  96],457,5,21675,4.0811523253624555,0.0,0.0
35311,3,5311,[180 176 183 257 194],796,4,21679,4.081137048192771,0.0,0.0
35312,3,5312,[ 28  79 237 238 196],18,2,21681,4.080745341614906,0.0,0.0
35313,3,5313,[318 427  98 191 182],655,5,21686,4.080918328942416,40.0,0.0
35314,3,5314,[117  69 100 234 195],72,5,21691,4.081091251175917,0.0,20.0
35315,3,5315,[603 216  56  97   1],450,5,21696,4.081264108352144,20.0,0.0
35316,3,5316,[318 427  98 191 182],655,5,21701,4.081436900507805,40.0,0.0
35317,3,5317,[228  69 748 483 172],807,5,21706,4.081609627679579,0.0,0.0
35318,3,5318,[318 427  98 191 182],450,5,21711,4.081782289904117,40.0,0.0
35319,3,5319,[ 88 235 191 588 546],23,1,21712,4.081203007518797,0.0,0.0
35320,3,5320,[318 427  98 191 182],18,5,21717,4.08137568126292,40.0,0.0
35321,3,5321,[ 97 385 210 234 275],796,2,21719,4.08098459225855,0.0,20.0
35322,3,5322,[  4 127 111 405 568],796,5,21724,4.081157242156679,0.0,20.0
35323,3,5323,[318 427  98 191 182],18,5,21729,4.081329827197596,40.0,0.0
35324,3,5324,[313  82 322 597 265],796,3,21732,4.0811267605633805,0.0,0.0
35325,3,5325,[151 471 186 235 385],457,4,21736,4.081111528351483,0.0,0.0
35326,3,5326,[175 603 151 161 496],716,3,21739,4.080908578937488,40.0,0.0
35327,3,5327,[318 427  98 191 182],655,5,21744,4.081081081081081,40.0,0.0
35328,3,5328,[294 496 118 151 194],577,4,21748,4.0810658660161385,20.0,0.0
35329,3,5329,[125 195   8 286 132],655,0,21748,4.080300187617261,0.0,20.0
35330,3,5330,[318 427  98 191 182],655,5,21753,4.080472706809229,40.0,0.0
35331,3,5331,[194 403 313 172 318],796,5,21758,4.080645161290323,20.0,0.0
35332,3,5332,[211 200 153  12 265],450,4,21762,4.0806300393774615,0.0,0.0
35333,3,5333,[318 427  98 191 182],796,5,21767,4.080802399700038,40.0,0.0
35334,3,5334,[210  15 496   1 435],450,3,21770,4.080599812558575,20.0,0.0
35335,3,5335,[197 568 215  64 269],450,5,21775,4.080772113943029,20.0,0.0
35336,3,5336,[  1 183 118 186 257],655,1,21776,4.080194866029605,0.0,0.0
35337,3,5337,[318 427  98 191 182],796,5,21781,4.080367178718621,40.0,0.0
35338,3,5338,[ 56 187 300 427 174],693,3,21784,4.080164824873572,20.0,0.0
35339,3,5339,[ 50 175 302 111 515],269,2,21786,4.079775280898876,0.0,20.0
35340,3,5340,[151  15 143 302 204],450,4,21790,4.079760344504774,0.0,0.0
35341,3,5341,[196 111 475 265 333],655,0,21790,4.078996630475477,0.0,0.0
35342,3,5342,[496   4  28  88 294],450,4,21794,4.078981845405203,20.0,0.0
35343,3,5343,[318 427  98 191 182],18,5,21799,4.079154191616767,40.0,0.0
35344,3,5344,[172 423 288 568 282],655,1,21800,4.078578110383536,0.0,0.0
35345,3,5345,[286 172 508 257  88],401,1,21801,4.0780022446689115,0.0,20.0
35346,3,5346,[318 427  98 191 182],796,5,21806,4.07817467738919,40.0,0.0
35347,3,5347,[  7 151 269 328 258],450,5,21811,4.0783470456245325,0.0,0.0
35348,3,5348,[ 79  88 313 289 196],236,3,21814,4.078145447747242,0.0,0.0
35349,3,5349,[300   4 222 588 187],450,3,21817,4.077943925233645,0.0,0.0
35350,3,5350,[132 385 196 127  69],504,5,21822,4.078116239955149,0.0,20.0
35351,3,5351,[100 269   4 187  28],450,4,21826,4.078101644245142,0.0,20.0
35352,3,5352,[216 603  88 238 275],23,4,21830,4.078087053988417,20.0,20.0
35353,3,5353,[471 161 282 176 153],450,5,21835,4.078259245423982,0.0,0.0
35354,3,5354,[318 427  98 191 182],655,5,21840,4.078431372549019,40.0,0.0
35355,3,5355,[135 288 245 187 161],450,3,21843,4.07823002240478,0.0,0.0
35356,3,5356,[318 427  98 191 182],72,5,21848,4.078402090722419,40.0,0.0
35357,3,5357,[655 191 202 568  96],450,5,21853,4.078574094811497,0.0,0.0
35358,3,5358,[318 427  98 191 182],72,5,21858,4.078746034707968,40.0,0.0
35359,3,5359,[318 427  98 191 182],18,5,21863,4.078917910447761,40.0,0.0
35360,3,5360,[186 403 222 195 405],796,4,21867,4.078903189703413,0.0,0.0
35361,3,5361,[318 427  98 191 182],72,5,21872,4.079074972025364,40.0,0.0
35362,3,5362,[ 70  89 100 655  28],457,5,21877,4.079246690285288,0.0,20.0
35363,3,5363,[268 100 111 132 179],655,1,21878,4.078672632363907,0.0,20.0
35364,3,5364,[318 427  98 191 182],72,5,21883,4.078844361602982,40.0,0.0
35365,3,5365,[179 202 301 405 196],655,1,21884,4.078270592620202,0.0,0.0
35366,3,5366,[318 427  98 191 182],269,5,21889,4.078442332774362,40.0,0.0
35367,3,5367,[153  25 318  64 186],450,3,21892,4.078241430700447,40.0,0.0
35368,3,5368,[200 597 211 195 222],796,4,21896,4.078226857887874,0.0,0.0
35369,3,5369,[318 427  98 191 182],72,5,21901,4.078398510242086,40.0,0.0
35370,3,5370,[301 144  11 471 546],593,3,21904,4.078197728542171,0.0,0.0
35371,3,5371,[268 210 222 475  22],655,0,21904,4.077438570364855,0.0,0.0
35372,3,5372,[111 180 405 275  11],457,4,21908,4.077424157826168,0.0,20.0
35373,3,5373,[318 427  98 191 182],796,5,21913,4.0775958317826575,40.0,0.0
35374,3,5374,[  1 300 200 121 204],796,4,21917,4.077581395348838,0.0,0.0
35375,3,5375,[318 427  98 191 182],450,5,21922,4.077752976190476,40.0,0.0
35376,3,5376,[318 427  98 191 182],72,5,21927,4.077924493211828,40.0,0.0
35377,3,5377,[234 173 135  25 194],450,2,21929,4.077538118259576,0.0,0.0
35378,3,5378,[258  69 125 144 172],457,5,21934,4.077709611451943,0.0,0.0
35379,3,5379,[318 427  98 191 182],655,5,21939,4.077881040892193,40.0,0.0
35380,3,5380,[185 132 322 286 748],796,3,21942,4.0776807284891285,0.0,20.0
35381,3,5381,[300  89 168 100 403],450,5,21947,4.07785209959123,0.0,20.0
35382,3,5382,[318 427  98 191 182],655,5,21952,4.078023407022107,40.0,0.0
35383,3,5383,[ 96 496 195  56 322],908,4,21956,4.078008915304606,20.0,0.0
35384,3,5384,[196 215 427 276 143],18,3,21959,4.077808727948003,20.0,0.0
35385,3,5385,[269 187 132 333 186],796,3,21962,4.07760861492759,0.0,0.0
35386,3,5386,[132 125 204 286  96],280,3,21965,4.077408576201968,0.0,20.0
35387,3,5387,[144 191   1 183 328],450,5,21970,4.077579806978471,0.0,0.0
35388,3,5388,[496   7 132  12 678],344,4,21974,4.077565411022453,20.0,0.0
35389,3,5389,[215  22 423  79 186],457,5,21979,4.07773654916512,0.0,0.0
35390,3,5390,[318 427  98 191 182],796,5,21984,4.077907623817474,40.0,0.0
35391,3,5391,[176 183 153 300 265],450,5,21989,4.078078635014837,0.0,0.0
35392,3,5392,[186 288 301 117 200],655,1,21990,4.077507880585944,0.0,0.0
35393,3,5393,[318 427  98 191 182],269,5,21995,4.077678902484242,40.0,0.0
35394,3,5394,[282  50 111 357 204],296,4,21999,4.077664504170528,0.0,20.0
35395,3,5395,[204 174 179 423  79],236,2,22001,4.077279466271312,0.0,0.0
35396,3,5396,[265  97 174 357 427],450,5,22006,4.077450435427089,20.0,0.0
35397,3,5397,[318 427  98 191 182],18,5,22011,4.077621341237496,40.0,0.0
35398,3,5398,[172 288 282 597 100],593,4,22015,4.07760696425264,0.0,20.0
35399,3,5399,[318 427  98 191 182],72,5,22020,4.0777777777777775,40.0,0.0
35400,3,5400,[245 202 483 234 191],796,3,22023,4.077578226254397,0.0,0.0
35401,3,5401,[176 185 151 127 211],716,4,22027,4.077563865235098,0.0,20.0
35402,3,5402,[655  79 238 111 168],457,4,22031,4.077549509531742,0.0,0.0
35403,3,5403,[405   4 144 181 276],655,1,22032,4.076980014803849,0.0,0.0
35404,3,5404,[318 427  98 191 182],72,5,22037,4.077150786308973,40.0,0.0
35405,3,5405,[318 427  98 191 182],450,5,22042,4.07732149463559,40.0,0.0
35406,3,5406,[318 427  98 191 182],18,5,22047,4.077492139818753,40.0,0.0
35407,3,5407,[211 117  28 135  71],450,3,22050,4.077292899408284,0.0,0.0
35408,3,5408,[318 427  98 191 182],655,5,22055,4.077463486781291,40.0,0.0
35409,3,5409,[318 427  98 191 182],796,5,22060,4.077634011090573,40.0,0.0
35410,3,5410,[ 22 195   9 182 276],269,3,22063,4.077434854925152,0.0,0.0
35411,3,5411,[318 427  98 191 182],796,5,22068,4.07760532150776,40.0,0.0
35412,3,5412,[318 427  98 191 182],796,5,22073,4.077775725106226,40.0,0.0
35413,3,5413,[318 427  98 191 182],72,5,22078,4.077946065755449,40.0,0.0
35414,3,5414,[318 427  98 191 182],655,5,22083,4.078116343490304,40.0,0.0
35415,3,5415,[318 427  98 191 182],796,5,22088,4.078286558345643,40.0,0.0
35416,3,5416,[588  82 143 181   1],798,5,22093,4.078456710356286,0.0,0.0
35417,3,5417,[ 88 318 172 237 100],796,4,22097,4.07844222960502,20.0,20.0
35418,3,5418,[172 475 276 153 111],655,2,22099,4.0780586824137295,0.0,0.0
35419,3,5419,[318 427  98 191 182],269,5,22104,4.078228782287823,40.0,0.0
35420,3,5420,[ 69 216 161   7 100],577,4,22108,4.078214351595647,0.0,20.0
35421,3,5421,[318 427  98 191 182],450,5,22113,4.078384360014755,40.0,0.0
35422,3,5422,[289 515 216 204 427],655,3,22116,4.078185506177393,20.0,0.0
35423,3,5423,[318 427  98 191 182],269,5,22121,4.078355457227139,40.0,0.0
35424,3,5424,[ 56 265  96 121 742],457,5,22126,4.07852534562212,0.0,0.0
35425,3,5425,[597  89 194 588 135],450,4,22130,4.078510873571692,0.0,0.0
35426,3,5426,[  8 271  50   7 237],655,1,22131,4.077943615257048,0.0,20.0
35427,3,5427,[180 151 132 385 216],504,5,22136,4.078113485630066,0.0,0.0
35428,3,5428,[286 423 187 194 276],535,2,22138,4.07773070547062,0.0,20.0
35429,3,5429,[196 182 181 180  22],18,3,22141,4.077532228360957,0.0,0.0
35430,3,5430,[318 427  98 191 182],655,5,22146,4.077702080648131,40.0,0.0
35431,3,5431,[318 427  98 191 182],655,5,22151,4.077871870397644,40.0,0.0
35432,3,5432,[318 427  98 191 182],72,5,22156,4.078041597644027,40.0,0.0
35433,3,5433,[121 282 496 181 180],716,3,22159,4.077843209422157,20.0,0.0
35434,3,5434,[216  88 111 258 301],796,4,22163,4.077828886844526,0.0,0.0
35435,3,5435,[318 427  98 191 182],269,5,22168,4.077998528329654,40.0,0.0
35436,3,5436,[318 427  98 191 182],450,5,22173,4.078168107412176,40.0,0.0
35437,3,5437,[588 174 191 172 202],389,5,22178,4.078337624126517,0.0,0.0
35438,3,5438,[318 427  98 191 182],796,5,22183,4.078507078507078,40.0,0.0
35439,3,5439,[318 427  98 191 182],450,5,22188,4.078676470588236,40.0,0.0
35440,3,5440,[153  15 269 172 588],796,4,22192,4.078662010659805,0.0,0.0
35441,3,5441,[318 427  98 191 182],450,5,22197,4.07883131201764,40.0,0.0
35442,3,5442,[237 176 132 125  88],280,1,22198,4.078265662318574,0.0,0.0
35443,3,5443,[318 427  98 191 182],450,5,22203,4.078434974283615,40.0,0.0
35444,3,5444,[ 96 180 127 118 174],457,5,22208,4.078604224058769,0.0,20.0
35445,3,5445,[185 174 118 111 357],450,4,22212,4.078589790672053,0.0,0.0
35446,3,5446,[318 427  98 191 182],72,5,22217,4.078758949880668,40.0,0.0
35447,3,5447,[234 161 117  79 153],655,1,22218,4.078193832599119,0.0,0.0
35448,3,5448,[318 427  98 191 182],18,5,22223,4.078363002385759,40.0,0.0
35449,3,5449,[194 405 173 183  11],716,4,22227,4.078348623853211,0.0,0.0
35450,3,5450,[238  12 603 294 235],264,4,22231,4.078334250596221,20.0,0.0
35451,3,5451,[318 427  98 191 182],72,5,22236,4.078503301540719,40.0,0.0
35452,3,5452,[ 96 597 288 186  15],457,4,22240,4.078488905189804,0.0,0.0
35453,3,5453,[318 427  98 191 182],450,5,22245,4.078657865786579,40.0,0.0
35454,3,5454,[318 427  98 191 182],269,5,22250,4.078826764436297,40.0,0.0
35455,3,5455,[318 427  98 191 182],72,5,22255,4.078995601173021,40.0,0.0
35456,3,5456,[318 427  98 191 182],72,5,22260,4.0791643760307865,40.0,0.0
35457,3,5457,[168 153  12 322 748],450,5,22265,4.0793330890436055,0.0,0.0
35458,3,5458,[144  88 275 200 176],796,5,22270,4.079501740245466,0.0,20.0
35459,3,5459,[172  12 385 234 588],796,4,22274,4.079487179487179,0.0,0.0
35460,3,5460,[318 427  98 191 182],450,5,22279,4.07965574070683,40.0,0.0
35461,3,5461,[195   4 301  97 234],796,2,22281,4.079274990845844,0.0,0.0
35462,3,5462,[333  11 234   4  15],629,3,22284,4.079077429983526,0.0,0.0
35463,3,5463,[318 427  98 191 182],18,5,22289,4.079245973645681,40.0,0.0
35464,3,5464,[144  71  56 210 748],796,4,22293,4.079231473010064,0.0,0.0
35465,3,5465,[ 70 603  88 546 135],151,4,22297,4.079216977680205,20.0,0.0
35466,3,5466,[ 50 276 202 173 175],457,5,22302,4.0793854033290655,0.0,20.0
35467,3,5467,[196 127 273  64  11],629,3,22305,4.079188002926116,20.0,20.0
35468,3,5468,[ 64 515 216  50 161],716,4,22309,4.079173523496069,20.0,20.0
35469,3,5469,[318 427  98 191 182],18,5,22314,4.079341864716636,40.0,0.0
35470,3,5470,[211 210 300   4 143],389,2,22316,4.0789617985743005,0.0,0.0
35471,3,5471,[318 427  98 191 182],18,5,22321,4.079130116959064,40.0,0.0
35472,3,5472,[318 427  98 191 182],18,5,22326,4.079298373835191,40.0,0.0
35473,3,5473,[318 427  98 191 182],269,5,22331,4.0794665692363905,40.0,0.0
35474,3,5474,[318 427  98 191 182],655,5,22336,4.079634703196347,40.0,0.0
35475,3,5475,[385 153 257 144 282],655,0,22336,4.078889700511322,0.0,0.0
35476,3,5476,[211 385 357 282 228],450,5,22341,4.079057878400584,0.0,0.0
35477,3,5477,[318 483 185  97 191],18,4,22345,4.079043446513326,20.0,0.0
35478,3,5478,[ 89 111 318  97 216],18,3,22348,4.078846504836649,20.0,0.0
35479,3,5479,[  9 173  50 117 228],756,2,22350,4.078467153284672,0.0,20.0
35480,3,5480,[185 273 186 286 182],450,3,22353,4.078270388615216,0.0,20.0
35481,3,5481,[318 427  98 191 182],269,5,22358,4.07843852608537,40.0,0.0
35482,3,5482,[ 56 216 301 603  64],450,5,22363,4.078606602225059,40.0,0.0
35483,3,5483,[258 294 273 313  71],450,3,22366,4.078409919766593,0.0,0.0
35484,3,5484,[318 427  98 191 182],18,5,22371,4.078577939835916,40.0,0.0
35485,3,5485,[318 427  98 191 182],269,5,22376,4.078745898651112,40.0,0.0
35486,3,5486,[318 427  98 191 182],655,5,22381,4.078913796245671,40.0,0.0
35487,3,5487,[435  95  50 181 161],807,4,22385,4.078899416909621,0.0,20.0
35488,3,5488,[318 427  98 191 182],450,5,22390,4.07906722535981,40.0,0.0
35489,3,5489,[318 427  98 191 182],655,5,22395,4.079234972677596,40.0,0.0
35490,3,5490,[318 427  98 191 182],655,5,22400,4.079402658896376,40.0,0.0
35491,3,5491,[173   1 423 211 318],807,4,22404,4.079388201019665,20.0,0.0
35492,3,5492,[318 427  98 191 182],18,5,22409,4.079555798288731,40.0,0.0
35493,3,5493,[135   7 301 191 161],655,2,22411,4.079177284310156,0.0,0.0
35494,3,5494,[318 427  98 191 182],655,5,22416,4.079344858962694,40.0,0.0
35495,3,5495,[568 265 245 181 144],450,5,22421,4.079512372634643,0.0,0.0
35496,3,5496,[403 182 118 245 183],796,4,22425,4.079497907949791,0.0,0.0
35497,3,5497,[318 427  98 191 182],269,5,22430,4.079665332848308,40.0,0.0
35498,3,5498,[118 182 111 237 172],457,4,22434,4.079650845608293,0.0,0.0
35499,3,5499,[318 427  98 191 182],18,5,22439,4.079818181818182,40.0,0.0
35500,3,5500,[318 427  98 191 182],655,5,22444,4.0799854571896015,40.0,0.0
35501,3,5501,[195   4 168   9 179],18,2,22446,4.079607415485278,0.0,0.0
35502,3,5502,[318 427  98 191 182],269,5,22451,4.079774668362711,40.0,0.0
35503,3,5503,[216 603 100 144 183],796,4,22455,4.079760174418604,20.0,20.0
35504,3,5504,[318 427  98 191 182],72,5,22460,4.079927338782925,40.0,0.0
35505,3,5505,[191   8 202 185 568],269,2,22462,4.079549582273883,0.0,0.0
35506,3,5506,[  9 483 183 313 153],796,4,22466,4.0795351370982385,0.0,0.0
35507,3,5507,[318 427  98 191 182],72,5,22471,4.079702251270879,40.0,0.0
35508,3,5508,[318 427  98 191 182],796,5,22476,4.0798693047740064,40.0,0.0
35509,3,5509,[318 427  98 191 182],18,5,22481,4.080036297640653,40.0,0.0
35510,3,5510,[318 427  98 191 182],655,5,22486,4.080203229903828,40.0,0.0
35511,3,5511,[318 427  98 191 182],72,5,22491,4.080370101596516,40.0,0.0
35512,3,5512,[318 427  98 191 182],269,5,22496,4.080536912751678,40.0,0.0
35513,3,5513,[ 64 173 176 194 435],269,2,22498,4.080159593761334,20.0,0.0
35514,3,5514,[318 427  98 191 182],269,5,22503,4.080326382592928,40.0,0.0
35515,3,5515,[ 98 181 228 215 204],280,1,22504,4.079767947788253,0.0,0.0
35516,3,5516,[144   8 176 286  15],796,4,22508,4.079753489215153,0.0,20.0
35517,3,5517,[318 427  98 191 182],269,5,22513,4.079920260964117,40.0,0.0
35518,3,5518,[385   4 235 111 183],457,3,22516,4.079724587787643,0.0,0.0
35519,3,5519,[100 216  56 288 742],450,4,22520,4.079710144927536,0.0,20.0
35520,3,5520,[318 427  98 191 182],72,5,22525,4.079876833906901,40.0,0.0
35521,3,5521,[318 427  98 191 182],655,5,22530,4.080043462513582,40.0,0.0
35522,3,5522,[276 483  50 187 125],18,4,22534,4.08002896976281,0.0,20.0
35523,3,5523,[318 427  98 191 182],450,5,22539,4.080195510499638,40.0,0.0
35524,3,5524,[655 294 151 125 118],504,3,22542,4.08,0.0,0.0
35525,3,5525,[318 427  98 191 182],18,5,22547,4.080166485703945,40.0,0.0
35526,3,5526,[435 483 161 471  95],716,3,22550,4.079971051203184,0.0,0.0
35527,3,5527,[318 427  98 191 182],18,5,22555,4.080137481910275,40.0,0.0
35528,3,5528,[143 175   7 286  64],151,5,22560,4.080303852414541,20.0,20.0
35529,3,5529,[ 97 132 191  28 173],151,4,22564,4.080289330922242,0.0,0.0
35530,3,5530,[294 273 258 269 300],655,1,22565,4.079732417284397,0.0,0.0
35531,3,5531,[117 111 276  69 174],457,4,22569,4.079718004338395,0.0,0.0
35532,3,5532,[318 427  98 191 182],796,5,22574,4.079884330381348,40.0,0.0
35533,3,5533,[318 427  98 191 182],796,5,22579,4.080050596313697,40.0,0.0
35534,3,5534,[318 427  98 191 182],655,5,22584,4.080216802168022,40.0,0.0
35535,3,5535,[168 185 294 216 655],796,3,22587,4.080021676300578,0.0,0.0
35536,3,5536,[195 210 423 151  79],450,4,22591,4.08000722412859,0.0,0.0
35537,3,5537,[318 427  98 191 182],269,5,22596,4.080173347778982,40.0,0.0
35538,3,5538,[ 98 216  69 132  70],269,2,22598,4.079797797436361,0.0,0.0
35539,3,5539,[357 181  64 655  79],796,4,22602,4.079783393501805,20.0,0.0
35540,3,5540,[318 427  98 191 182],18,5,22607,4.079949467605125,40.0,0.0
35541,3,5541,[300 175  12 228 333],655,0,22607,4.079213280404186,0.0,0.0
35542,3,5542,[286  56 235 153 194],264,4,22611,4.07919898971676,0.0,20.0
35543,3,5543,[333  22 515 100 161],655,1,22612,4.078643578643579,0.0,20.0
35544,3,5544,[210   7 161 204 200],577,2,22614,4.078268710550045,0.0,0.0
35545,3,5545,[182 153 234 333 301],629,4,22618,4.078254597908402,0.0,0.0
35546,3,5546,[ 28  98 328 300   1],655,1,22619,4.0776996574725075,0.0,0.0
35547,3,5547,[471 302  79 237 568],450,5,22624,4.0778658976207645,0.0,0.0
35548,3,5548,[180 204 403 173 194],269,1,22625,4.077311227248153,0.0,0.0
35549,3,5549,[300  71 483 191 403],796,5,22630,4.077477477477477,0.0,0.0
35550,3,5550,[144  79 385  50 185],716,3,22633,4.07728337236534,0.0,20.0
35551,3,5551,[318 427  98 191 182],18,5,22638,4.077449567723343,40.0,0.0
35552,3,5552,[655  22  79 216  64],450,5,22643,4.077615703223483,20.0,0.0
35553,3,5553,[318 427  98 191 182],72,5,22648,4.077781778898092,40.0,0.0
35554,3,5554,[318 427  98 191 182],655,5,22653,4.077947794779478,40.0,0.0
35555,3,5555,[118 200  82  88 196],796,4,22657,4.077933765298776,0.0,0.0
35556,3,5556,[318 427  98 191 182],269,5,22662,4.0780996940795395,40.0,0.0
35557,3,5557,[318 427  98 191 182],796,5,22667,4.078265563152213,40.0,0.0
35558,3,5558,[385 215 515 258 200],655,2,22669,4.077891707141572,0.0,0.0
35559,3,5559,[265 471 143 118 183],655,2,22671,4.077517985611511,0.0,0.0
35560,3,5560,[143 132  56 195  28],796,4,22675,4.0775040460348855,0.0,0.0
35561,3,5561,[318 427  98 191 182],72,5,22680,4.077669902912621,40.0,0.0
35562,3,5562,[318 427  98 191 182],655,5,22685,4.077835700161783,40.0,0.0
35563,3,5563,[ 15 748 245 655  97],224,3,22688,4.07764198418404,0.0,0.0
35564,3,5564,[318 427  98 191 182],796,5,22693,4.0778077268643305,40.0,0.0
35565,3,5565,[ 64 144 211 187 568],450,5,22698,4.07797340998922,20.0,0.0
35566,3,5566,[318 427  98 191 182],796,5,22703,4.078139033590803,40.0,0.0
35567,3,5567,[238 127 258 275 403],457,5,22708,4.078304597701149,0.0,40.0
35568,3,5568,[210  70  25  96 204],72,5,22713,4.078470102352307,0.0,0.0
35569,3,5569,[318 427  98 191 182],18,5,22718,4.078635547576302,40.0,0.0
35570,3,5570,[603 100  71 111   9],756,3,22721,4.078441931430623,20.0,20.0
35571,3,5571,[318 427  98 191 182],655,5,22726,4.078607322325915,40.0,0.0
35572,3,5572,[318 427  98 191 182],450,5,22731,4.078772653866858,40.0,0.0
35573,3,5573,[173 234 135  82 405],807,3,22734,4.078579117330463,0.0,0.0
35574,3,5574,[132 301 333 121  56],796,4,22738,4.078565022421524,0.0,0.0
35575,3,5575,[187 435   1 125  12],503,2,22740,4.07819225251076,0.0,0.0
35576,3,5576,[216 405  15  28 174],655,1,22741,4.077640308409539,0.0,0.0
35577,3,5577,[318 427  98 191 182],655,5,22746,4.077805665112944,40.0,0.0
35578,3,5578,[318 427  98 191 182],18,5,22751,4.077970962538089,40.0,0.0
35579,3,5579,[173 427 215 100  97],11,4,22755,4.077956989247312,20.0,20.0
35580,3,5580,[318 427  98 191 182],450,5,22760,4.078122200322523,40.0,0.0
35581,3,5581,[  1 143 257 172 427],23,3,22763,4.0779290576854175,20.0,0.0
35582,3,5582,[423 111  88 196 132],457,4,22767,4.07791509940892,0.0,0.0
35583,3,5583,[475 182  12  56 117],655,1,22768,4.077363896848137,0.0,0.0
35584,3,5584,[ 28  70 194 151  98],716,5,22773,4.0775290957923005,0.0,0.0
35585,3,5585,[318 427  98 191 182],18,5,22778,4.0776942355889725,40.0,0.0
35586,3,5586,[318 427  98 191 182],796,5,22783,4.077859316269913,40.0,0.0
35587,3,5587,[275  96  98 403 204],796,5,22788,4.078024337866857,0.0,20.0
35588,3,5588,[ 50 265  96 228 121],716,4,22792,4.078010377527286,0.0,20.0
35589,3,5589,[318 427  98 191 182],18,5,22797,4.078175313059034,40.0,0.0
35590,3,5590,[318 427  98 191 182],655,5,22802,4.0783401895904134,40.0,0.0
35591,3,5591,[318 427  98 191 182],18,5,22807,4.078505007153076,40.0,0.0
35592,3,5592,[318 427  98 191 182],18,5,22812,4.078669765778652,40.0,0.0
35593,3,5593,[568 200 202 238 151],716,5,22817,4.0788344654987485,0.0,0.0
35594,3,5594,[318 427  98 191 182],18,5,22822,4.078999106344951,40.0,0.0
35595,3,5595,[318 427  98 191 182],450,5,22827,4.079163688348821,40.0,0.0
35596,3,5596,[405 237 125 191 183],450,5,22832,4.079328211541897,0.0,0.0
35597,3,5597,[475 135 185 182 196],655,3,22835,4.079135405501965,0.0,0.0
35598,3,5598,[  4  56 385 678  71],504,4,22839,4.079121271655652,0.0,0.0
35599,3,5599,[151  79 273 300  88],450,4,22843,4.079107142857143,0.0,0.0
35600,3,5600,[173 143 191 483 322],401,3,22846,4.078914479557222,0.0,0.0
35601,3,5601,[318 427  98 191 182],796,5,22851,4.079078900392717,40.0,0.0
35602,3,5602,[318 427  98 191 182],450,5,22856,4.0792432625379265,40.0,0.0
35603,3,5603,[234 265 318 323  28],796,2,22858,4.078872234118487,20.0,0.0
35604,3,5604,[318 427  98 191 182],450,5,22863,4.079036574487065,40.0,0.0
35605,3,5605,[197 210  56 258 483],151,5,22868,4.079200856225473,0.0,0.0
35606,3,5606,[111  79 174  97   4],18,3,22871,4.079008382379169,0.0,0.0
35607,3,5607,[  7 202  88 132 197],457,5,22876,4.079172610556348,0.0,0.0
35608,3,5608,[ 25 118   1  89 153],450,3,22879,4.078980210376181,0.0,0.0
35609,3,5609,[318 427  98 191 182],72,5,22884,4.079144385026738,40.0,0.0
35610,3,5610,[197 235 222 655  11],716,4,22888,4.079130279807521,0.0,0.0
35611,3,5611,[161 423 111 172 132],436,3,22891,4.078937990021383,0.0,0.0
35612,3,5612,[318 427  98 191 182],72,5,22896,4.07910208444682,40.0,0.0
35613,3,5613,[228  15   8 187  64],655,2,22898,4.078731742073388,20.0,0.0
35614,3,5614,[195  15 403 483 273],796,4,22902,4.078717720391808,0.0,0.0
35615,3,5615,[318 427  98 191 182],796,5,22907,4.078881766381766,40.0,0.0
35616,3,5616,[318 427  98 191 182],655,5,22912,4.079045753961189,40.0,0.0
35617,3,5617,[151 655 235 257 195],23,1,22913,4.078497686009256,0.0,0.0
35618,3,5618,[318 427  98 191 182],18,5,22918,4.07866168357359,40.0,0.0
35619,3,5619,[179 191  97 258 300],655,2,22920,4.07829181494662,0.0,0.0
35620,3,5620,[318 427  98 191 182],72,5,22925,4.078455790784558,40.0,0.0
35621,3,5621,[ 25 197 228 275 289],655,1,22926,4.077908217716115,0.0,20.0
35622,3,5622,[ 64 176 191 234 318],655,3,22929,4.077716521429842,40.0,0.0
35623,3,5623,[179 176 210   7 471],655,1,22930,4.077169274537695,0.0,0.0
35624,3,5624,[318 427  98 191 182],269,5,22935,4.077333333333334,40.0,0.0
35625,3,5625,[318 427  98 191 182],269,5,22940,4.077497333807323,40.0,0.0
35626,3,5626,[161  25  15 125   7],577,3,22943,4.077305846810023,0.0,0.0
35627,3,5627,[ 88  64 179 100 194],236,1,22944,4.076759061833688,20.0,20.0
35628,3,5628,[318 427  98 191 182],269,5,22949,4.076923076923077,40.0,0.0
35629,3,5629,[ 79   9 268 405 196],344,3,22952,4.076731793960923,0.0,0.0
35630,3,5630,[318 427  98 191 182],269,5,22957,4.07689575563843,40.0,0.0
35631,3,5631,[318 427  98 191 182],796,5,22962,4.077059659090909,40.0,0.0
35632,3,5632,[318 427  98 191 182],450,5,22967,4.077223504349369,40.0,0.0
35633,3,5633,[483 186 118 405 286],151,3,22970,4.077032303869364,0.0,20.0
35634,3,5634,[318 427  98 191 182],655,5,22975,4.0771960958296365,40.0,0.0
35635,3,5635,[215   8 276 202 216],18,3,22978,4.077004968062456,0.0,0.0
35636,3,5636,[318 427  98 191 182],655,5,22983,4.077168706758914,40.0,0.0
35637,3,5637,[144 655 257  97 294],716,4,22987,4.077155019510465,0.0,0.0
35638,3,5638,[678 151 195  70 191],344,3,22990,4.076964000709346,0.0,0.0
35639,3,5639,[318 427  98 191 182],18,5,22995,4.077127659574468,40.0,0.0
35640,3,5640,[318 427  98 191 182],450,5,23000,4.07729126041482,40.0,0.0
35641,3,5641,[318 427  98 191 182],655,5,23005,4.077454803261255,40.0,0.0
35642,3,5642,[318 427  98 191 182],18,5,23010,4.077618288144604,40.0,0.0
35643,3,5643,[318 427  98 191 182],796,5,23015,4.077781715095677,40.0,0.0
35644,3,5644,[318 427  98 191 182],269,5,23020,4.077945084145261,40.0,0.0
35645,3,5645,[ 97 132 179  50   8],655,2,23022,4.077577045696068,0.0,20.0
35646,3,5646,[318 427  98 191 182],72,5,23027,4.077740393129095,40.0,0.0
35647,3,5647,[ 79 222 174 121   4],796,5,23032,4.077903682719547,0.0,0.0
35648,3,5648,[288 300 196 197 202],450,4,23036,4.0778898920162865,0.0,0.0
35649,3,5649,[318 427  98 191 182],450,5,23041,4.0780530973451325,40.0,0.0
35650,3,5650,[318 427  98 191 182],18,5,23046,4.078216244912405,40.0,0.0
35651,3,5651,[318 427  98 191 182],72,5,23051,4.078379334748761,40.0,0.0
35652,3,5652,[385 405 568 423 289],655,0,23051,4.077657880771272,0.0,0.0
35653,3,5653,[265 405 258 186 294],796,3,23054,4.07746727980191,0.0,0.0
35654,3,5654,[302 216  25  28  79],655,3,23057,4.077276746242264,0.0,0.0
35655,3,5655,[318 427  98 191 182],18,5,23062,4.077439886845827,40.0,0.0
35656,3,5656,[546 275  12 471 195],450,5,23067,4.077602969771964,0.0,20.0
35657,3,5657,[655 257 603 385 508],401,1,23068,4.07705903145988,20.0,0.0
35658,3,5658,[568 168 215 405 496],716,5,23073,4.077222124050185,20.0,0.0
35659,3,5659,[318 427  98 191 182],269,5,23078,4.077385159010601,40.0,0.0
35660,3,5660,[568 265  50 172 121],655,2,23080,4.0770181946652535,0.0,20.0
35661,3,5661,[238 197 222 117 546],716,4,23084,4.077004592016955,0.0,0.0
35662,3,5662,[  1  11 204 197 257],330,5,23089,4.07716757902172,0.0,0.0
35663,3,5663,[318 427  98 191 182],72,5,23094,4.077330508474576,40.0,0.0
35664,3,5664,[318 427  98 191 182],655,5,23099,4.077493380406001,40.0,0.0
35665,3,5665,[237 215 179  79   1],535,3,23102,4.077303212142605,0.0,0.0
35666,3,5666,[357  70 179 175 234],269,3,23105,4.077113110993471,0.0,0.0
35667,3,5667,[318 427  98 191 182],796,5,23110,4.0772759350741,40.0,0.0
35668,3,5668,[318 427  98 191 182],18,5,23115,4.07743870171106,40.0,0.0
35669,3,5669,[318 427  98 191 182],655,5,23120,4.0776014109347445,40.0,0.0
35670,3,5670,[135 197  97 568  69],72,5,23125,4.0777640627755245,0.0,0.0
35671,3,5671,[318 427  98 191 182],72,5,23130,4.077926657263752,40.0,0.0
35672,3,5672,[318 427  98 191 182],72,5,23135,4.078089194429755,40.0,0.0
35673,3,5673,[318 427  98 191 182],450,5,23140,4.078251674303842,40.0,0.0
35674,3,5674,[318 427  98 191 182],796,5,23145,4.078414096916299,40.0,0.0
35675,3,5675,[318 427  98 191 182],796,5,23150,4.078576462297392,40.0,0.0
35676,3,5676,[215 423 161   7  89],457,5,23155,4.078738770477365,0.0,0.0
35677,3,5677,[318 427  98 191 182],18,5,23160,4.0789010214864385,40.0,0.0
35678,3,5678,[318 427  98 191 182],18,5,23165,4.079063215354816,40.0,0.0
35679,3,5679,[245 228  79 357 172],344,4,23169,4.079049295774648,0.0,0.0
35680,3,5680,[ 15  64 121 238   1],494,4,23173,4.079035381094878,20.0,0.0
35681,3,5681,[179 322 211 183 228],786,4,23177,4.079021471312918,0.0,0.0
35682,3,5682,[318 427  98 191 182],796,5,23182,4.079183529825796,40.0,0.0
35683,3,5683,[318 427  98 191 182],72,5,23187,4.079345531315974,40.0,0.0
35684,3,5684,[318 427  98 191 182],72,5,23192,4.079507475813545,40.0,0.0
35685,3,5685,[318 427  98 191 182],72,5,23197,4.079669363348575,40.0,0.0
35686,3,5686,[ 15  98  96 183 200],577,3,23200,4.0794795146826095,0.0,0.0
35687,3,5687,[318 427  98 191 182],655,5,23205,4.07964135021097,40.0,0.0
35688,3,5688,[318 427  98 191 182],18,5,23210,4.07980312884514,40.0,0.0
35689,3,5689,[748   8  98 174 151],796,5,23215,4.079964850615114,0.0,0.0
35690,3,5690,[135 237 269 318 121],535,4,23219,4.079950799507995,20.0,0.0
35691,3,5691,[318  70 568 125  82],280,2,23221,4.079585382993676,20.0,0.0
35692,3,5692,[286 173 258  70 135],535,3,23224,4.079395749165642,0.0,20.0
35693,3,5693,[202 427 301 210 357],450,4,23228,4.079381805409203,20.0,0.0
35694,3,5694,[168  70  15 185 597],269,2,23230,4.079016681299385,0.0,0.0
35695,3,5695,[237 301 127 238 211],296,5,23235,4.079178370786517,0.0,20.0
35696,3,5696,[318 427  98 191 182],18,5,23240,4.0793400035106195,40.0,0.0
35697,3,5697,[318 427  98 191 182],269,5,23245,4.07950157950158,40.0,0.0
35698,3,5698,[318 427  98 191 182],450,5,23250,4.079663098789261,40.0,0.0
35699,3,5699,[318 427  98 191 182],450,5,23255,4.079824561403509,40.0,0.0
35700,3,5700,[245 222 471 508 127],344,3,23258,4.079635151727767,0.0,20.0
35701,3,5701,[385 234 603 202  96],450,4,23262,4.07962118554893,20.0,0.0
35702,3,5702,[318 427  98 191 182],796,5,23267,4.0797825705768895,40.0,0.0
35703,3,5703,[318 427  98 191 182],796,5,23272,4.079943899018232,40.0,0.0
35704,3,5704,[  8 322 151 191 265],796,4,23276,4.079929886064855,0.0,0.0
35705,3,5705,[258 181 151 172  50],807,4,23280,4.079915878023134,0.0,20.0
35706,3,5706,[318 427  98 191 182],18,5,23285,4.0800770983003325,40.0,0.0
35707,3,5707,[174 269 282 182 302],450,5,23290,4.080238262088297,0.0,0.0
35708,3,5708,[318 427  98 191 182],269,5,23295,4.08039936941671,40.0,0.0
35709,3,5709,[211 118 286 185   8],389,3,23298,4.080210157618214,0.0,20.0
35710,3,5710,[318 427  98 191 182],450,5,23303,4.080371213447733,40.0,0.0
35711,3,5711,[318 427  98 191 182],269,5,23308,4.080532212885154,40.0,0.0
35712,3,5712,[318 427  98 191 182],796,5,23313,4.080693155960091,40.0,0.0
35713,3,5713,[318 427  98 191 182],450,5,23318,4.080854042702135,40.0,0.0
35714,3,5714,[318 427  98 191 182],72,5,23323,4.081014873140857,40.0,0.0
35715,3,5715,[318 427  98 191 182],72,5,23328,4.081175647305808,40.0,0.0
35716,3,5716,[121 423 275 151 202],151,5,23333,4.081336365226518,0.0,20.0
35717,3,5717,[318 427  98 191 182],72,5,23338,4.081497026932494,40.0,0.0
35718,3,5718,[182 179 174 237  69],593,4,23342,4.0814827767092146,0.0,0.0
35719,3,5719,[471 197 301  98  96],655,1,23343,4.080944055944056,0.0,0.0
35720,3,5720,[238 174   8  82 597],457,4,23347,4.080929907358853,0.0,0.0
35721,3,5721,[318 427  98 191 182],269,5,23352,4.081090527787487,40.0,0.0
35722,3,5722,[328 515 117 176 118],655,1,23353,4.080552157959112,0.0,0.0
35723,3,5723,[322   4 238 215 194],504,3,23356,4.080363382250175,0.0,0.0
35724,3,5724,[318 427  98 191 182],450,5,23361,4.080524017467249,40.0,0.0
35725,3,5725,[ 25 111  56 282 196],655,0,23361,4.079811386657353,0.0,0.0
35726,3,5726,[143  95 132  96 546],796,5,23366,4.079972062161691,0.0,0.0
35727,3,5727,[318 427  98 191 182],72,5,23371,4.080132681564246,40.0,0.0
35728,3,5728,[ 28 185 282 269 153],796,3,23374,4.079944143829639,0.0,0.0
35729,3,5729,[318 427  98 191 182],796,5,23379,4.0801047120418845,40.0,0.0
35730,3,5730,[318 427  98 191 182],655,5,23384,4.080265224219159,40.0,0.0
35731,3,5731,[186 151 187 125 276],504,2,23386,4.0799023028611305,0.0,0.0
35732,3,5732,[186 483 204 215  96],450,3,23389,4.079713936856794,0.0,0.0
35733,3,5733,[118 357 568   4 302],344,4,23393,4.079700034879665,0.0,0.0
35734,3,5734,[318 427  98 191 182],796,5,23398,4.079860505666957,40.0,0.0
35735,3,5735,[234 475 180 176 403],269,1,23399,4.079323570432357,0.0,0.0
35736,3,5736,[273 153 515 179  64],655,4,23403,4.07930974376852,20.0,0.0
35737,3,5737,[318 427  98 191 182],796,5,23408,4.079470198675497,40.0,0.0
35738,3,5738,[ 69 100 121  88 483],457,5,23413,4.079630597665099,0.0,20.0
35739,3,5739,[  9 197 194 403 216],796,3,23416,4.079442508710802,0.0,0.0
35740,3,5740,[328 294  82 151 286],796,2,23418,4.079080299599373,0.0,20.0
35741,3,5741,[318 427  98 191 182],18,5,23423,4.079240682688958,40.0,0.0
35742,3,5742,[318 427  98 191 182],72,5,23428,4.079401009925126,40.0,0.0
35743,3,5743,[  8 258 276  56 328],655,1,23429,4.078864902506964,0.0,0.0
35744,3,5744,[195 174 121  95 127],716,4,23433,4.078851174934726,0.0,20.0
35745,3,5745,[318 427  98 191 182],655,5,23438,4.079011486251305,40.0,0.0
35746,3,5746,[ 69 172 144 228  97],457,5,23443,4.079171741778319,0.0,0.0
35747,3,5747,[318 427  98 191 182],269,5,23448,4.079331941544885,40.0,0.0
35748,3,5748,[318 427  98 191 182],796,5,23453,4.0794920855801005,40.0,0.0
35749,3,5749,[318 427  98 191 182],450,5,23458,4.079652173913043,40.0,0.0
35750,3,5750,[318 427  98 191 182],18,5,23463,4.07981220657277,40.0,0.0
35751,3,5751,[515 234  98 427 265],655,3,23466,4.079624478442281,20.0,0.0
35752,3,5752,[257 161  89 475 483],655,2,23468,4.079262993220929,0.0,0.0
35753,3,5753,[496  98  11 275 228],716,5,23473,4.079423010079944,20.0,20.0
35754,3,5754,[318 427  98 191 182],655,5,23478,4.079582971329279,40.0,0.0
35755,3,5755,[125 100   9 265 186],655,0,23478,4.078874218207088,0.0,20.0
35756,3,5756,[318 427  98 191 182],655,5,23483,4.079034219211395,40.0,0.0
35757,3,5757,[117 144 276 173 125],401,2,23485,4.078673150399444,0.0,0.0
35758,3,5758,[ 22  56 238 294 318],450,5,23490,4.078833130751867,20.0,0.0
35759,3,5759,[  4 210 318 127  98],450,3,23493,4.078645833333334,20.0,20.0
35760,3,5760,[135 179  70 508  98],269,4,23497,4.078632181912862,0.0,0.0
35761,3,5761,[318 427  98 191 182],450,5,23502,4.078792086081222,40.0,0.0
35762,3,5762,[655 196 496 183  25],577,5,23507,4.078951934756203,20.0,0.0
35763,3,5763,[181 194 427 143  88],18,2,23509,4.078591256072172,20.0,0.0
35764,3,5764,[318 427  98 191 182],72,5,23514,4.078751084128361,40.0,0.0
35765,3,5765,[176 117 302  88 655],450,5,23519,4.078910856746445,0.0,0.0
35766,3,5766,[318 427  98 191 182],796,5,23524,4.079070573955263,40.0,0.0
35767,3,5767,[318 427  98 191 182],269,5,23529,4.079230235783633,40.0,0.0
35768,3,5768,[318 427  98 191 182],450,5,23534,4.079389842260357,40.0,0.0
35769,3,5769,[302 100 179  64 603],269,4,23538,4.079376083188908,40.0,20.0
35770,3,5770,[181 222 204 234 117],655,0,23538,4.078669208109513,0.0,0.0
35771,3,5771,[318 427  98 191 182],269,5,23543,4.078828828828829,40.0,0.0
35772,3,5772,[318 427  98 191 182],18,5,23548,4.078988394249091,40.0,0.0
35773,3,5773,[127 174  50 100 211],401,3,23551,4.078801524073433,0.0,60.0
35774,3,5774,[318 427  98 191 182],269,5,23556,4.078961038961039,40.0,0.0
35775,3,5775,[318 427  98 191 182],18,5,23561,4.079120498614959,40.0,0.0
35776,3,5776,[318 427  98 191 182],450,5,23566,4.079279903063874,40.0,0.0
35777,3,5777,[180  11 210 257 508],296,4,23570,4.0792661820699205,0.0,0.0
35778,3,5778,[318 427  98 191 182],655,5,23575,4.079425506142932,40.0,0.0
35779,3,5779,[318 427  98 191 182],72,5,23580,4.079584775086505,40.0,0.0
35780,3,5780,[318 427  98 191 182],72,5,23585,4.079743988929251,40.0,0.0
35781,3,5781,[318 427  98 191 182],655,5,23590,4.079903147699758,40.0,0.0
35782,3,5782,[318 427  98 191 182],796,5,23595,4.080062251426595,40.0,0.0
35783,3,5783,[318 427  98 191 182],72,5,23600,4.080221300138312,40.0,0.0
35784,3,5784,[ 95 194  69 185 143],389,3,23603,4.080034572169404,0.0,0.0
35785,3,5785,[153 234 288  79 282],655,1,23604,4.079502246802627,0.0,0.0
35786,3,5786,[100 403 237 328 118],796,4,23608,4.079488508726456,0.0,20.0
35787,3,5787,[318 427  98 191 182],450,5,23613,4.079647546648237,40.0,0.0
35788,3,5788,[318 427  98 191 182],655,5,23618,4.079806529625151,40.0,0.0
35789,3,5789,[318 427  98 191 182],18,5,23623,4.079965457685665,40.0,0.0
35790,3,5790,[318 427  98 191 182],450,5,23628,4.0801243308582285,40.0,0.0
35791,3,5791,[318 427  98 191 182],72,5,23633,4.0802831491712706,40.0,0.0
35792,3,5792,[318 427  98 191 182],655,5,23638,4.080441912653202,40.0,0.0
35793,3,5793,[318 427  98 191 182],450,5,23643,4.080600621332413,40.0,0.0
35794,3,5794,[318 427  98 191 182],72,5,23648,4.080759275237273,40.0,0.0
35795,3,5795,[318 427  98 191 182],450,5,23653,4.080917874396135,40.0,0.0
35796,3,5796,[215 135 175 603 195],716,2,23655,4.080558909780921,20.0,0.0
35797,3,5797,[318 427  98 191 182],18,5,23660,4.0807174887892375,40.0,0.0
35798,3,5798,[318 427  98 191 182],269,5,23665,4.080876013105708,40.0,0.0
35799,3,5799,[318 427  98 191 182],269,5,23670,4.0810344827586205,40.0,0.0
35800,3,5800,[318 427  98 191 182],269,5,23675,4.081192897776245,40.0,0.0
35801,3,5801,[318 427  98 191 182],796,5,23680,4.0813512581868325,40.0,0.0
35802,3,5802,[318 427  98 191 182],450,5,23685,4.081509564018611,40.0,0.0
35803,3,5803,[318 427  98 191 182],72,5,23690,4.081667815299793,40.0,0.0
35804,3,5804,[318 427  98 191 182],655,5,23695,4.0818260120585705,40.0,0.0
35805,3,5805,[318 427  98 191 182],18,5,23700,4.081984154323114,40.0,0.0
35806,3,5806,[546 288 180 127 179],504,4,23704,4.081970036163251,0.0,20.0
35807,3,5807,[269 180  71 423 588],450,4,23708,4.0819559228650135,0.0,0.0
35808,3,5808,[318 427  98 191 182],72,5,23713,4.082113961094853,40.0,0.0
35809,3,5809,[ 50  79  98 471 568],655,3,23716,4.081927710843374,0.0,20.0
35810,3,5810,[318 427  98 191 182],72,5,23721,4.082085699535364,40.0,0.0
35811,3,5811,[318 427  98 191 182],655,5,23726,4.082243633860977,40.0,0.0
35812,3,5812,[318 427  98 191 182],269,5,23731,4.082401513848271,40.0,0.0
35813,3,5813,[100  25 211 175 202],264,5,23736,4.082559339525284,0.0,20.0
35814,3,5814,[ 12 210 182 191   4],450,3,23739,4.082373172828891,0.0,0.0
35815,3,5815,[ 12 183  69  22 257],796,5,23744,4.082530949105915,0.0,0.0
35816,3,5816,[215 357 111 271 269],796,4,23748,4.082516761217122,0.0,0.0
35817,3,5817,[318 427  98 191 182],72,5,23753,4.082674458576831,40.0,0.0
35818,3,5818,[655 132 300 294  82],655,0,23753,4.081972847568311,0.0,0.0
35819,3,5819,[597 216  64 204 603],796,5,23758,4.08213058419244,40.0,0.0
35820,3,5820,[318 427  98 191 182],450,5,23763,4.082288266620855,40.0,0.0
35821,3,5821,[546 655 100 568 748],450,5,23768,4.082445894881484,0.0,20.0
35822,3,5822,[318 427  98 191 182],269,5,23773,4.082603469002232,40.0,0.0
35823,3,5823,[318 427  98 191 182],18,5,23778,4.082760989010989,40.0,0.0
35824,3,5824,[318 427  98 191 182],269,5,23783,4.082918454935622,40.0,0.0
35825,3,5825,[144 423 181 135 228],457,5,23788,4.083075866803982,0.0,0.0
35826,3,5826,[318 427  98 191 182],269,5,23793,4.083233224643899,40.0,0.0
35827,3,5827,[318 427  98 191 182],269,5,23798,4.083390528483185,40.0,0.0
35828,3,5828,[318 427  98 191 182],655,5,23803,4.083547778349631,40.0,0.0
35829,3,5829,[202 423 121 200 168],504,4,23807,4.083533447684391,0.0,0.0
35830,3,5830,[318 427  98 191 182],655,5,23812,4.083690619104785,40.0,0.0
35831,3,5831,[403 186 194 181 385],796,4,23816,4.083676268861454,0.0,0.0
35832,3,5832,[318 427  98 191 182],450,5,23821,4.083833361906395,40.0,0.0
35833,3,5833,[318 427  98 191 182],450,5,23826,4.083990401097018,40.0,0.0
35834,3,5834,[318 427  98 191 182],796,5,23831,4.084147386461011,40.0,0.0
35835,3,5835,[318 427  98 191 182],18,5,23836,4.084304318026045,40.0,0.0
35836,3,5836,[ 82 300 678 185 194],504,4,23840,4.084289874935755,0.0,0.0
35837,3,5837,[318 427  98 191 182],450,5,23845,4.084446728331621,40.0,0.0
35838,3,5838,[655 210 273 405  96],796,2,23847,4.084089741394075,0.0,0.0
35839,3,5839,[318 427  98 191 182],18,5,23852,4.0842465753424655,40.0,0.0
35840,3,5840,[318 427  98 191 182],796,5,23857,4.084403355589796,40.0,0.0
35841,3,5841,[318 427  98 191 182],18,5,23862,4.084560082163643,40.0,0.0
35842,3,5842,[194 111 197  15  25],65,5,23867,4.084716755091563,0.0,0.0
35843,3,5843,[176 568 197 423 180],716,3,23870,4.084531143052704,0.0,0.0
35844,3,5844,[228 144 216  82 100],450,4,23874,4.084516680923866,0.0,20.0
35845,3,5845,[318 427  98 191 182],450,5,23879,4.084673280875813,40.0,0.0
35846,3,5846,[318 427  98 191 182],796,5,23884,4.084829827261844,40.0,0.0
35847,3,5847,[318 427  98 191 182],450,5,23889,4.084986320109439,40.0,0.0
35848,3,5848,[405 423 175 742 174],655,0,23889,4.084287912463669,0.0,0.0
35849,3,5849,[318 427  98 191 182],796,5,23894,4.084444444444444,40.0,0.0
35850,3,5850,[121  70  97 174  69],401,3,23897,4.084259101008374,0.0,0.0
35851,3,5851,[483 546   9 313 180],796,3,23900,4.084073820915926,0.0,0.0
35852,3,5852,[ 15 204 180 100  71],18,4,23904,4.084059456688878,0.0,20.0
35853,3,5853,[318 427  98 191 182],72,5,23909,4.084215920737957,40.0,0.0
35854,3,5854,[318 427  98 191 182],655,5,23914,4.0843723313407345,40.0,0.0
35855,3,5855,[318 427  98 191 182],269,5,23919,4.08452868852459,40.0,0.0
35856,3,5856,[ 97 194  70 427 197],535,5,23924,4.084684992316886,20.0,0.0
35857,3,5857,[318 427  98 191 182],269,5,23929,4.0848412427449645,40.0,0.0
35858,3,5858,[ 70 215 187 288 194],450,4,23933,4.084826762246117,0.0,0.0
35859,3,5859,[546  22  88 185  70],457,4,23937,4.08481228668942,0.0,0.0
35860,3,5860,[318 427  98 191 182],72,5,23942,4.084968435420577,40.0,0.0
35861,3,5861,[318 427  98 191 182],655,5,23947,4.085124530876834,40.0,0.0
35862,3,5862,[200 179 237  28  89],18,1,23948,4.084598328500768,0.0,0.0
35863,3,5863,[ 69 237 173   1 603],796,4,23952,4.0845839017735335,20.0,0.0
35864,3,5864,[318 427  98 191 182],796,5,23957,4.084739982949702,40.0,0.0
35865,3,5865,[318 427  98 191 182],18,5,23962,4.084896010910331,40.0,0.0
35866,3,5866,[318 427  98 191 182],655,5,23967,4.0850519856826315,40.0,0.0
35867,3,5867,[508 168 237 173 185],535,5,23972,4.085207907293797,0.0,0.0
35868,3,5868,[194 118 197  95  22],796,4,23976,4.085193388993014,0.0,0.0
35869,3,5869,[175  22 265 423 546],716,3,23979,4.085008517887564,0.0,0.0
35870,3,5870,[318 427  98 191 182],269,5,23984,4.085164367228751,40.0,0.0
35871,3,5871,[318 427  98 191 182],796,5,23989,4.085320163487738,40.0,0.0
35872,3,5872,[ 88 118 191 748 405],450,4,23993,4.085305635961178,0.0,0.0
35873,3,5873,[313 322  98  70 568],450,5,23998,4.085461355124276,0.0,0.0
35874,3,5874,[132  82 588 258 144],23,3,24001,4.085276595744681,0.0,0.0
35875,3,5875,[318 427  98 191 182],655,5,24006,4.085432266848196,40.0,0.0
35876,3,5876,[318 427  98 191 182],796,5,24011,4.085587884975328,40.0,0.0
35877,3,5877,[ 98 210   7  79  56],151,5,24016,4.085743450153113,0.0,0.0
35878,3,5878,[318 427  98 191 182],450,5,24021,4.085898962408573,40.0,0.0
35879,3,5879,[275 172  97  50  56],151,5,24026,4.086054421768708,0.0,40.0
35880,3,5880,[318 427  98 191 182],796,5,24031,4.0862098282604995,40.0,0.0
35881,3,5881,[318 427  98 191 182],72,5,24036,4.086365181910915,40.0,0.0
35882,3,5882,[318 427  98 191 182],72,5,24041,4.086520482746898,40.0,0.0
35883,3,5883,[318 427  98 191 182],450,5,24046,4.086675730795378,40.0,0.0
35884,3,5884,[318 427  98 191 182],72,5,24051,4.0868309260832625,40.0,0.0
35885,3,5885,[318 427  98 191 182],72,5,24056,4.086986068637445,40.0,0.0
35886,3,5886,[  1 200 211 182 423],593,3,24059,4.08680142687277,0.0,0.0
35887,3,5887,[ 69 276 403 302 742],655,2,24061,4.086447010869565,0.0,0.0
35888,3,5888,[318 427  98 191 182],269,5,24066,4.086602139582272,40.0,0.0
35889,3,5889,[318 427  98 191 182],796,5,24071,4.086757215619694,40.0,0.0
35890,3,5890,[318 427  98 191 182],655,5,24076,4.086912239008657,40.0,0.0
35891,3,5891,[318 427  98 191 182],269,5,24081,4.0870672097759675,40.0,0.0
35892,3,5892,[135 111 328 748  95],450,3,24084,4.0868827422365515,0.0,0.0
35893,3,5893,[168 313   1 151  95],807,5,24089,4.087037665422463,0.0,0.0
35894,3,5894,[318 427  98 191 182],796,5,24094,4.087192536047498,40.0,0.0
35895,3,5895,[ 89 748 228  15 183],796,5,24099,4.087347354138399,0.0,0.0
35896,3,5896,[183 174 222 471 271],655,1,24100,4.0868238087162965,0.0,0.0
35897,3,5897,[318 427  98 191 182],450,5,24105,4.086978636826043,40.0,0.0
35898,3,5898,[318 427  98 191 182],269,5,24110,4.087133412442787,40.0,0.0
35899,3,5899,[357 238 742 121 748],450,4,24114,4.087118644067797,0.0,0.0
35900,3,5900,[215 182 742 603   9],796,3,24117,4.086934417895272,20.0,0.0
35901,3,5901,[235 435 237  15 302],450,3,24120,4.086750254151135,0.0,0.0
35902,3,5902,[318 427  98 191 182],18,5,24125,4.086904963577842,40.0,0.0
35903,3,5903,[318 427  98 191 182],450,5,24130,4.0870596205962055,40.0,0.0
35904,3,5904,[318 427  98 191 182],18,5,24135,4.087214225232853,40.0,0.0
35905,3,5905,[ 15   1 172 427 191],655,3,24138,4.087030138841856,20.0,0.0
35906,3,5906,[211  15 174 588 195],786,4,24142,4.08701540545116,0.0,0.0
35907,3,5907,[ 95 215 143 588 174],450,4,24146,4.087000677048071,0.0,0.0
35908,3,5908,[318 427  98 191 182],18,5,24151,4.087155187002877,40.0,0.0
35909,3,5909,[318 427  98 191 182],72,5,24156,4.087309644670051,40.0,0.0
35910,3,5910,[318 427  98 191 182],72,5,24161,4.08746405007613,40.0,0.0
35911,3,5911,[318 427  98 191 182],18,5,24166,4.087618403247632,40.0,0.0
35912,3,5912,[318 427  98 191 182],450,5,24171,4.08777270421106,40.0,0.0
35913,3,5913,[427 172 496 215 100],577,5,24176,4.087926952992898,40.0,20.0
35914,3,5914,[435 318  96 228 195],655,1,24177,4.087404902789518,20.0,0.0
35915,3,5915,[202 496 197 300 423],151,5,24182,4.087559161595673,20.0,0.0
35916,3,5916,[ 97 483 151  22 237],152,5,24187,4.0877133682609434,0.0,0.0
35917,3,5917,[238  69  89 204 173],457,5,24192,4.087867522811761,0.0,0.0
35918,3,5918,[200  56 100  89 475],655,2,24194,4.087514782902518,0.0,20.0
35919,3,5919,[ 28 265 427 655 197],716,5,24199,4.087668918918919,20.0,0.0
35920,3,5920,[318 427  98 191 182],450,5,24204,4.087823002871136,40.0,0.0
35921,3,5921,[318 427  98 191 182],18,5,24209,4.0879770347855455,40.0,0.0
35922,3,5922,[286  11 357 568  15],593,5,24214,4.088131014688503,0.0,20.0
35923,3,5923,[204 121 423  64   1],577,5,24219,4.0882849426063474,20.0,0.0
35924,3,5924,[265  97 196 333 275],236,1,24220,4.087763713080169,0.0,20.0
35925,3,5925,[ 98 179 423 318 742],655,3,24223,4.08758015524806,20.0,0.0
35926,3,5926,[ 50  82 427 216 181],716,5,24228,4.087734098194702,20.0,20.0
35927,3,5927,[318 427  98 191 182],18,5,24233,4.087887989203779,40.0,0.0
35928,3,5928,[ 95 202  71 216 161],577,5,24238,4.088041828301568,0.0,0.0
35929,3,5929,[318 427  98 191 182],18,5,24243,4.0881956155143335,40.0,0.0
35930,3,5930,[318 427  98 191 182],655,5,24248,4.088349350868319,40.0,0.0
35931,3,5931,[ 25 427  28 546 173],716,4,24252,4.088334457181389,20.0,0.0
35932,3,5932,[318 427  98 191 182],269,5,24257,4.088488117309962,40.0,0.0
35933,3,5933,[423 179  79 174 182],450,5,24262,4.088641725648803,0.0,0.0
35934,3,5934,[385 275 245  89 215],450,5,24267,4.088795282224094,0.0,20.0
35935,3,5935,[328 194 197 423  70],65,4,24271,4.088780323450135,0.0,0.0
35936,3,5936,[234  28 186 168 176],716,3,24274,4.0885969344786925,0.0,0.0
35937,3,5937,[  1  11  50 216 195],344,3,24277,4.088413607275177,0.0,20.0
35938,3,5938,[ 82 200 288 153 125],504,4,24281,4.088398720323287,0.0,0.0
35939,3,5939,[ 69 271  98 202 194],629,5,24286,4.088552188552189,0.0,0.0
35940,3,5940,[ 82 186 172 197  69],786,4,24290,4.088537283285643,0.0,0.0
35941,3,5941,[318 427  98 191 182],72,5,24295,4.088690676539885,40.0,0.0
35942,3,5942,[318 427  98 191 182],72,5,24300,4.08884401817264,40.0,0.0
35943,3,5943,[318 427  98 191 182],796,5,24305,4.08899730820996,40.0,0.0
35944,3,5944,[  4 216  79  22 183],457,5,24310,4.089150546677881,0.0,0.0
35945,3,5945,[318 427  98 191 182],72,5,24315,4.089303733602422,40.0,0.0
35946,3,5946,[546  95 423 185  89],23,3,24318,4.089120564990751,0.0,0.0
35947,3,5947,[ 82 153  69  64 289],655,1,24319,4.088601210490921,20.0,0.0
35948,3,5948,[172  12 196 423 403],796,5,24324,4.088754412506304,0.0,0.0
35949,3,5949,[318 427  98 191 182],72,5,24329,4.08890756302521,40.0,0.0
35950,3,5950,[210 435 125 211 269],18,4,24333,4.088892623088556,0.0,0.0
35951,3,5951,[211 179 132 222  71],786,5,24338,4.089045698924731,0.0,0.0
35952,3,5952,[435  89 176 655  98],655,2,24340,4.088694775743322,0.0,0.0
35953,3,5953,[187 328 181 483 333],796,5,24345,4.088847833389318,0.0,0.0
35954,3,5954,[318 427  98 191 182],72,5,24350,4.089000839630563,40.0,0.0
35955,3,5955,[318 427  98 191 182],18,5,24355,4.089153794492948,40.0,0.0
35956,3,5956,[318 427  98 191 182],18,5,24360,4.08930669800235,40.0,0.0
35957,3,5957,[318 427  98 191 182],450,5,24365,4.089459550184626,40.0,0.0
35958,3,5958,[318 427  98 191 182],18,5,24370,4.089612351065615,40.0,0.0
35959,3,5959,[423 215 202 603 195],655,1,24371,4.089093959731543,20.0,0.0
35960,3,5960,[318 427  98 191 182],269,5,24376,4.089246770676061,40.0,0.0
35961,3,5961,[ 98 286 172 222 200],786,5,24381,4.08939953035894,0.0,20.0
35962,3,5962,[181 228 546 125  89],796,5,24386,4.08955223880597,0.0,0.0
35963,3,5963,[318 427  98 191 182],450,5,24391,4.0897048960429245,40.0,0.0
35964,3,5964,[318 427  98 191 182],18,5,24396,4.089857502095557,40.0,0.0
35965,3,5965,[238  88  97 269 211],707,3,24399,4.089674824002682,0.0,0.0
35966,3,5966,[318 427  98 191 182],655,5,24404,4.089827383945031,40.0,0.0
35967,3,5967,[144 197 179 748 403],450,5,24409,4.089979892761394,0.0,0.0
35968,3,5968,[318 427  98 191 182],655,5,24414,4.090132350477467,40.0,0.0
35969,3,5969,[197 678 161 125 216],401,2,24416,4.089782244556114,0.0,0.0
35970,3,5970,[  9 186 471 423 237],535,5,24421,4.089934684307486,0.0,0.0
35971,3,5971,[322 742 197  28 172],450,5,24426,4.090087073007368,0.0,0.0
35972,3,5972,[318 427  98 191 182],655,5,24431,4.0902394106813995,40.0,0.0
35973,3,5973,[318 427  98 191 182],72,5,24436,4.090391697355206,40.0,0.0
35974,3,5974,[318 427  98 191 182],450,5,24441,4.090543933054393,40.0,0.0
35975,3,5975,[ 96 174 200  11 597],269,1,24442,4.090026773761713,0.0,0.0
35976,3,5976,[185 204   7  22 197],535,4,24446,4.090011711560984,0.0,0.0
35977,3,5977,[318 427  98 191 182],450,5,24451,4.090163934426229,40.0,0.0
35978,3,5978,[144 176 286 168 588],450,5,24456,4.0903161063723035,0.0,20.0
35979,3,5979,[318 427  98 191 182],655,5,24461,4.090468227424749,40.0,0.0
35980,3,5980,[ 64  70 257  88 546],457,3,24464,4.090285905366995,20.0,0.0
35981,3,5981,[588  88 211 179   4],786,5,24469,4.090437980608492,0.0,0.0
35982,3,5982,[204 176 318 121 357],450,4,24473,4.090422864783553,20.0,0.0
35983,3,5983,[318 427  98 191 182],269,5,24478,4.090574866310161,40.0,0.0
35984,3,5984,[318 427  98 191 182],18,5,24483,4.090726817042606,40.0,0.0
35985,3,5985,[318 427  98 191 182],450,5,24488,4.0908787170063485,40.0,0.0
35986,3,5986,[318 427  98 191 182],655,5,24493,4.0910305662268245,40.0,0.0
35987,3,5987,[318 427  98 191 182],269,5,24498,4.091182364729459,40.0,0.0
35988,3,5988,[318 427  98 191 182],450,5,24503,4.091334112539656,40.0,0.0
35989,3,5989,[318 427  98 191 182],450,5,24508,4.091485809682805,40.0,0.0
35990,3,5990,[215 195 333 357 282],693,4,24512,4.091470539142047,0.0,0.0
35991,3,5991,[318 427  98 191 182],269,5,24517,4.091622162883845,40.0,0.0
35992,3,5992,[318 427  98 191 182],655,5,24522,4.091773736025363,40.0,0.0
35993,3,5993,[318 427  98 191 182],450,5,24527,4.0919252585919255,40.0,0.0
35994,3,5994,[318 427  98 191 182],18,5,24532,4.092076730608841,40.0,0.0
35995,3,5995,[318 427  98 191 182],72,5,24537,4.092228152101401,40.0,0.0
35996,3,5996,[282 121  69 403 265],655,0,24537,4.091545772886443,0.0,0.0
35997,3,5997,[318 427  98 191 182],450,5,24542,4.091697232410803,40.0,0.0
35998,3,5998,[318 427  98 191 182],796,5,24547,4.09184864144024,40.0,0.0
35999,3,5999,[196 216 143 237 215],174,5,24552,4.092,0.0,0.0
36000,3,6000,[300 282 215 195  95],450,4,24556,4.091984669221796,0.0,0.0
36001,3,6001,[  4 175 151 210  11],344,4,24560,4.091969343552149,0.0,0.0
36002,3,6002,[271 423 333 173 435],629,5,24565,4.092120606363485,0.0,0.0
36003,3,6003,[265 182 597   9 238],457,4,24569,4.092105263157895,0.0,0.0
36004,3,6004,[294 172  79  82 111],450,4,24573,4.092089925062448,0.0,0.0
36005,3,6005,[435 603   4 269 100],450,4,24577,4.092074592074592,20.0,20.0
36006,3,6006,[111 196 216 282 204],593,5,24582,4.092225736640586,0.0,0.0
36007,3,6007,[ 82 405 180 174 228],716,4,24586,4.092210386151797,0.0,0.0
36008,3,6008,[111  96  82 269 302],450,4,24590,4.092195040772175,0.0,0.0
36009,3,6009,[200 265 125  88 216],280,3,24593,4.0920133111480865,0.0,0.0
36010,3,6010,[318 427  98 191 182],18,5,24598,4.092164365330228,40.0,0.0
36011,3,6011,[318 427  98 191 182],450,5,24603,4.092315369261477,40.0,0.0
36012,3,6012,[181 275  50 257 300],902,3,24606,4.0921337102943625,0.0,40.0
36013,3,6013,[ 89  69 222 275 194],796,5,24611,4.092284669105421,0.0,20.0
36014,3,6014,[127 742 323 161 195],504,5,24616,4.092435577722361,0.0,20.0
36015,3,6015,[125 405 176  69  12],457,5,24621,4.092586436170213,0.0,0.0
36016,3,6016,[179  56 427  22 187],450,5,24626,4.09273724447399,20.0,0.0
36017,3,6017,[318 427  98 191 182],72,5,24631,4.0928880026586905,40.0,0.0
36018,3,6018,[318 427  98 191 182],796,5,24636,4.093038710749294,40.0,0.0
36019,3,6019,[318 427  98 191 182],18,5,24641,4.093189368770764,40.0,0.0
36020,3,6020,[318 427  98 191 182],655,5,24646,4.093339976748048,40.0,0.0
36021,3,6021,[318 427  98 191 182],72,5,24651,4.093490534706078,40.0,0.0
36022,3,6022,[318 427  98 191 182],450,5,24656,4.093641042669766,40.0,0.0
36023,3,6023,[235 200 403 483 183],269,2,24658,4.093293492695883,0.0,0.0
36024,3,6024,[268  22 153 174 515],535,2,24660,4.092946058091286,0.0,0.0
36025,3,6025,[318 427  98 191 182],450,5,24665,4.0930965814802525,40.0,0.0
36026,3,6026,[322 204 185 318 100],401,4,24669,4.093081134892982,20.0,20.0
36027,3,6027,[204 238 237 143 175],457,5,24674,4.093231585932316,0.0,0.0
36028,3,6028,[318 427  98 191 182],72,5,24679,4.093381987062531,40.0,0.0
36029,3,6029,[222 197 211   7  95],786,4,24683,4.0933665008291875,0.0,0.0
36030,3,6030,[174  25 132 186   1],655,0,24683,4.092687779804344,0.0,0.0
36031,3,6031,[318 427  98 191 182],18,5,24688,4.092838196286472,40.0,0.0
36032,3,6032,[185  28  82 237 197],457,5,24693,4.0929885629040275,0.0,0.0
36033,3,6033,[318 427  98 191 182],655,5,24698,4.093138879681803,40.0,0.0
36034,3,6034,[318 427  98 191 182],72,5,24703,4.093289146644573,40.0,0.0
36035,3,6035,[318 427  98 191 182],72,5,24708,4.093439363817097,40.0,0.0
36036,3,6036,[318 427  98 191 182],796,5,24713,4.093589531224118,40.0,0.0
36037,3,6037,[318 427  98 191 182],655,5,24718,4.093739648890361,40.0,0.0
36038,3,6038,[568 328  22 182 173],450,5,24723,4.093889716840536,0.0,0.0
36039,3,6039,[318 427  98 191 182],655,5,24728,4.094039735099337,40.0,0.0
36040,3,6040,[318 427  98 191 182],450,5,24733,4.094189703691442,40.0,0.0
36041,3,6041,[328 168  89 405  98],450,5,24738,4.09433962264151,0.0,0.0
36042,3,6042,[318 427  98 191 182],655,5,24743,4.094489491974185,40.0,0.0
36043,3,6043,[191 100 357 187  64],316,4,24747,4.09447385837194,20.0,20.0
36044,3,6044,[318 427  98 191 182],796,5,24752,4.094623655913979,40.0,0.0
36045,3,6045,[423 100  97 300 194],151,4,24756,4.094608005292756,0.0,20.0
36046,3,6046,[ 28 222 597  88 195],796,4,24760,4.094592359847859,0.0,0.0
36047,3,6047,[ 95  82 211 597 286],450,3,24763,4.094411375661376,0.0,20.0
36048,3,6048,[318 427  98 191 182],269,5,24768,4.094561084476773,40.0,0.0
36049,3,6049,[318 427  98 191 182],655,5,24773,4.094710743801653,40.0,0.0
36050,3,6050,[161 194 216  64 185],450,5,24778,4.094860353660552,20.0,0.0
36051,3,6051,[183 257 222  69   7],457,4,24782,4.094844679444812,0.0,0.0
36052,3,6052,[301 182 216  70   8],655,2,24784,4.094498595737651,0.0,0.0
36053,3,6053,[286 222 333 318 174],236,3,24787,4.094317806408986,20.0,20.0
36054,3,6054,[423 161 597 143 318],457,4,24791,4.094302229562345,20.0,0.0
36055,3,6055,[216 168 194 215 202],878,4,24795,4.094286657859974,0.0,0.0
36056,3,6056,[318 427  98 191 182],655,5,24800,4.094436189532772,40.0,0.0
36057,3,6057,[546 100   1 294 111],280,3,24803,4.094255529877848,0.0,20.0
36058,3,6058,[318 427  98 191 182],450,5,24808,4.094405017329592,40.0,0.0
36059,3,6059,[172 121  97 117 191],786,4,24812,4.094389438943894,0.0,0.0
36060,3,6060,[318 427  98 191 182],450,5,24817,4.094538854974426,40.0,0.0
36061,3,6061,[318 427  98 191 182],450,5,24822,4.094688221709007,40.0,0.0
36062,3,6062,[318 427  98 191 182],269,5,24827,4.094837539172027,40.0,0.0
36063,3,6063,[125 222 265 127 161],457,5,24832,4.094986807387863,0.0,20.0
36064,3,6064,[161 175 202 200  25],716,3,24835,4.094806265457543,0.0,0.0
36065,3,6065,[318 427  98 191 182],18,5,24840,4.094955489614243,40.0,0.0
36066,3,6066,[318 427  98 191 182],796,5,24845,4.095104664578869,40.0,0.0
36067,3,6067,[179 276 265 100   4],655,2,24847,4.094759393539881,0.0,20.0
36068,3,6068,[568 191 100  97 322],796,2,24849,4.0944142362827485,0.0,20.0
36069,3,6069,[318 427  98 191 182],450,5,24854,4.094563426688633,40.0,0.0
36070,3,6070,[196  97  50 168 194],535,5,24859,4.094712567945972,0.0,20.0
36071,3,6071,[318 427  98 191 182],450,5,24864,4.094861660079052,40.0,0.0
36072,3,6072,[318 427  98 191 182],269,5,24869,4.095010703112136,40.0,0.0
36073,3,6073,[200  79 496 215 237],280,3,24872,4.094830424761278,20.0,0.0
36074,3,6074,[235 202 117 471   7],344,2,24874,4.094485596707819,0.0,0.0
36075,3,6075,[172 483   4 211  56],389,5,24879,4.0946346280447665,0.0,0.0
36076,3,6076,[318 427  98 191 182],796,5,24884,4.094783610334046,40.0,0.0
36077,3,6077,[144  28 151 183 588],23,1,24885,4.094274432379072,0.0,0.0
36078,3,6078,[318 405   1 258   7],450,5,24890,4.094423424905412,20.0,0.0
36079,3,6079,[245 258 200  15 196],796,4,24894,4.094407894736842,0.0,0.0
36080,3,6080,[318 427  98 191 182],450,5,24899,4.094556816313107,40.0,0.0
36081,3,6081,[ 25  98 234 475 211],655,1,24900,4.0940480105228545,0.0,0.0
36082,3,6082,[318 427  98 191 182],450,5,24905,4.0941969422982085,40.0,0.0
36083,3,6083,[471 204 197  82  96],72,4,24909,4.094181459566075,0.0,0.0
36084,3,6084,[318 427  98 191 182],655,5,24914,4.0943303204601476,40.0,0.0
36085,3,6085,[118 185  69 197 195],151,3,24917,4.0941505093657575,0.0,0.0
36086,3,6086,[483  22 245 172   9],796,3,24920,4.093970757351733,0.0,0.0
36087,3,6087,[238 211 275 286 182],18,5,24925,4.094119579500657,0.0,40.0
36088,3,6088,[318 427  98 191 182],655,5,24930,4.094268352767285,40.0,0.0
36089,3,6089,[ 70 742   8  12 151],457,5,24935,4.094417077175698,0.0,0.0
36090,3,6090,[471 276 210 174 172],256,3,24938,4.094237399441799,0.0,0.0
36091,3,6091,[423  69  56 483 200],269,4,24942,4.094221930400526,0.0,0.0
36092,3,6092,[318 427  98 191 182],450,5,24947,4.0943705892007225,40.0,0.0
36093,3,6093,[318 427  98 191 182],796,5,24952,4.09451919921234,40.0,0.0
36094,3,6094,[318 427  98 191 182],18,5,24957,4.094667760459393,40.0,0.0
36095,3,6095,[318 427  98 191 182],655,5,24962,4.094816272965879,40.0,0.0
36096,3,6096,[318 427  98 191 182],655,5,24967,4.094964736755782,40.0,0.0
36097,3,6097,[318 427  98 191 182],655,5,24972,4.095113151853067,40.0,0.0
36098,3,6098,[318 427  98 191 182],450,5,24977,4.095261518281686,40.0,0.0
36099,3,6099,[423 195   4 132 185],716,3,24980,4.0950819672131145,0.0,0.0
36100,3,6100,[318 427  98 191 182],18,5,24985,4.095230290116374,40.0,0.0
36101,3,6101,[245 588 235 265 237],280,3,24988,4.095050803015405,0.0,0.0
36102,3,6102,[318 427  98 191 182],655,5,24993,4.095199082418483,40.0,0.0
36103,3,6103,[197  69 748 678 318],280,2,24995,4.094855832241153,20.0,0.0
36104,3,6104,[181 117  25 282  28],504,4,24999,4.094840294840295,0.0,0.0
36105,3,6105,[475 179 187 286 273],655,3,25002,4.0946609891909596,0.0,20.0
36106,3,6106,[655   9 237  96  89],269,2,25004,4.094317995742591,0.0,0.0
36107,3,6107,[245 172 302 269  88],344,3,25007,4.094138834315651,0.0,0.0
36108,3,6108,[597 211 125 179 153],593,4,25011,4.094123424455721,0.0,0.0
36109,3,6109,[318 427  98 191 182],269,5,25016,4.094271685761047,40.0,0.0
36110,3,6110,[215  97 318 265  98],450,5,25021,4.0944198985436095,20.0,0.0
36111,3,6111,[318 427  98 191 182],269,5,25026,4.094568062827225,40.0,0.0
36112,3,6112,[318 427  98 191 182],796,5,25031,4.094716178635695,40.0,0.0
36113,3,6113,[318 427  98 191 182],450,5,25036,4.094864245992803,40.0,0.0
36114,3,6114,[180 275 276 153   4],535,3,25039,4.094685200327064,0.0,20.0
36115,3,6115,[238 195 678 655 357],504,4,25043,4.094669718770438,0.0,0.0
36116,3,6116,[125 168 172 161  22],796,5,25048,4.094817721105117,0.0,0.0
36117,3,6117,[318 427  98 191 182],18,5,25053,4.0949656750572085,40.0,0.0
36118,3,6118,[423 286 186  88 222],786,5,25058,4.095113580650433,0.0,20.0
36119,3,6119,[ 28  12 282   9 187],796,3,25061,4.094934640522876,0.0,0.0
36120,3,6120,[318 427  98 191 182],269,5,25066,4.09508250285901,40.0,0.0
36121,3,6121,[ 11 153 173   7 127],629,3,25069,4.094903626265926,0.0,20.0
36122,3,6122,[318 427  98 191 182],655,5,25074,4.095051445369917,40.0,0.0
36123,3,6123,[318 427  98 191 182],18,5,25079,4.095199216198563,40.0,0.0
36124,3,6124,[300 742 288 748  25],938,2,25081,4.094857142857143,0.0,0.0
36125,3,6125,[135 211 403  89  69],450,4,25085,4.094841658504734,0.0,0.0
36126,3,6126,[ 15 183 111 258 588],450,4,25089,4.094826179206789,0.0,0.0
36127,3,6127,[125 182  95 211 181],450,4,25093,4.094810704960835,0.0,0.0
36128,3,6128,[318 427  98 191 182],18,5,25098,4.094958394517866,40.0,0.0
36129,3,6129,[318 427  98 191 182],18,5,25103,4.09510603588907,40.0,0.0
36130,3,6130,[318 427  98 191 182],796,5,25108,4.095253629098027,40.0,0.0
36131,3,6131,[318 427  98 191 182],269,5,25113,4.095401174168297,40.0,0.0
36132,3,6132,[ 96 742 179 237 423],655,1,25114,4.094896461764226,0.0,0.0
36133,3,6133,[318 427  98 191 182],18,5,25119,4.095044016954679,40.0,0.0
36134,3,6134,[132 191 748 222 211],796,4,25123,4.0950285248573755,0.0,0.0
36135,3,6135,[318 427  98 191 182],796,5,25128,4.095176010430248,40.0,0.0
36136,3,6136,[  7 508   9 403 180],269,2,25130,4.094834609744175,0.0,0.0
36137,3,6137,[318 427  98 191 182],72,5,25135,4.094982078853047,40.0,0.0
36138,3,6138,[318 427  98 191 182],450,5,25140,4.095129499918554,40.0,0.0
36139,3,6139,[  4  25 153 210 202],264,5,25145,4.0952768729641695,0.0,0.0
36140,3,6140,[318 427  98 191 182],269,5,25150,4.095424198013353,40.0,0.0
36141,3,6141,[588 234 245 265 183],280,2,25152,4.095083034842071,0.0,0.0
36142,3,6142,[318 427  98 191 182],18,5,25157,4.0952303434803845,40.0,0.0
36143,3,6143,[318 427  98 191 182],655,5,25162,4.095377604166667,40.0,0.0
36144,3,6144,[318 427  98 191 182],18,5,25167,4.095524816924328,40.0,0.0
36145,3,6145,[318 427  98 191 182],450,5,25172,4.095671981776765,40.0,0.0
36146,3,6146,[318 427  98 191 182],655,5,25177,4.095819098747357,40.0,0.0
36147,3,6147,[318 427  98 191 182],796,5,25182,4.0959661678594665,40.0,0.0
36148,3,6148,[182 202 268   7 288],655,1,25183,4.095462676858026,0.0,0.0
36149,3,6149,[ 22 271 125 191 228],655,1,25184,4.094959349593496,0.0,0.0
36150,3,6150,[318 427  98 191 182],269,5,25189,4.095106486750122,40.0,0.0
36151,3,6151,[318 427  98 191 182],450,5,25194,4.095253576072822,40.0,0.0
36152,3,6152,[  1 151 111 286 234],796,2,25196,4.0949130505444495,0.0,20.0
36153,3,6153,[318 427  98 191 182],796,5,25201,4.095060123496912,40.0,0.0
36154,3,6154,[175 186 100 195  98],269,3,25204,4.094882209585703,0.0,20.0
36155,3,6155,[288 286 118 471 181],450,3,25207,4.094704353476283,0.0,20.0
36156,3,6156,[318 427  98 191 182],450,5,25212,4.09485138866331,40.0,0.0
36157,3,6157,[318 427  98 191 182],72,5,25217,4.094998376096135,40.0,0.0
36158,3,6158,[ 96 180  89   7  64],72,3,25220,4.094820587757753,20.0,0.0
36159,3,6159,[318 427  98 191 182],655,5,25225,4.094967532467533,40.0,0.0
36160,3,6160,[318 427  98 191 182],72,5,25230,4.095114429475735,40.0,0.0
36161,3,6161,[210 238 211  96 237],296,4,25234,4.095098993833171,0.0,0.0
36162,3,6162,[294 117 143 173 216],796,4,25238,4.09508356319974,0.0,0.0
36163,3,6163,[318 427  98 191 182],655,5,25243,4.095230369889682,40.0,0.0
36164,3,6164,[318 427  98 191 182],269,5,25248,4.095377128953771,40.0,0.0
36165,3,6165,[318 427  98 191 182],655,5,25253,4.09552384041518,40.0,0.0
36166,3,6166,[318 427  98 191 182],18,5,25258,4.095670504297065,40.0,0.0
36167,3,6167,[318 427  98 191 182],450,5,25263,4.095817120622568,40.0,0.0
36168,3,6168,[204 135 111  96  79],450,4,25267,4.095801588588102,0.0,0.0
36169,3,6169,[269 568 742 168 597],796,3,25270,4.095623987034036,0.0,0.0
36170,3,6170,[435 135 121 265 405],450,3,25273,4.095446443040026,0.0,0.0
36171,3,6171,[318 427  98 191 182],72,5,25278,4.095593000648088,40.0,0.0
36172,3,6172,[318 427  98 191 182],655,5,25283,4.09573951077272,40.0,0.0
36173,3,6173,[289 258 471 222 132],807,4,25287,4.095724003887269,0.0,0.0
36174,3,6174,[405 237 216 173 748],11,2,25289,4.095384615384615,0.0,0.0
36175,3,6175,[161  97 185 211 195],796,3,25292,4.09520725388601,0.0,0.0
36176,3,6176,[318 427  98 191 182],655,5,25297,4.095353731584912,40.0,0.0
36177,3,6177,[318 427  98 191 182],18,5,25302,4.095500161864681,40.0,0.0
36178,3,6178,[318 427  98 191 182],72,5,25307,4.095646544748341,40.0,0.0
36179,3,6179,[100 127 282  96 405],292,4,25311,4.095631067961165,0.0,40.0
36180,3,6180,[144 172 275   8 245],796,4,25315,4.0956155961818475,0.0,20.0
36181,3,6181,[318 427  98 191 182],269,5,25320,4.095761889356195,40.0,0.0
36182,3,6182,[318 427  98 191 182],18,5,25325,4.095908135209445,40.0,0.0
36183,3,6183,[318 427  98 191 182],450,5,25330,4.096054333764553,40.0,0.0
36184,3,6184,[318 427  98 191 182],18,5,25335,4.096200485044462,40.0,0.0
36185,3,6185,[318 427  98 191 182],450,5,25340,4.096346589072098,40.0,0.0
36186,3,6186,[161 294 222 204 655],796,3,25343,4.096169387425246,0.0,0.0
36187,3,6187,[318 427  98 191 182],450,5,25348,4.096315449256625,40.0,0.0
36188,3,6188,[318 427  98 191 182],450,5,25353,4.096461463887542,40.0,0.0
36189,3,6189,[318 427  98 191 182],450,5,25358,4.096607431340872,40.0,0.0
36190,3,6190,[318 427  98 191 182],269,5,25363,4.096753351639476,40.0,0.0
36191,3,6191,[132 111  82   8 483],457,4,25367,4.096737726098191,0.0,0.0
36192,3,6192,[228 176 200  50 211],5,3,25370,4.096560632972711,0.0,20.0
36193,3,6193,[318 427  98 191 182],796,5,25375,4.096706490151759,40.0,0.0
36194,3,6194,[318 427  98 191 182],450,5,25380,4.096852300242131,40.0,0.0
36195,3,6195,[196 195 151 200 181],151,3,25383,4.096675274370561,0.0,0.0
36196,3,6196,[318 427  98 191 182],72,5,25388,4.09682104243989,40.0,0.0
36197,3,6197,[318 427  98 191 182],72,5,25393,4.096966763472087,40.0,0.0
36198,3,6198,[318 427  98 191 182],450,5,25398,4.097112437489918,40.0,0.0
36199,3,6199,[118  79  95   4 132],577,4,25402,4.097096774193548,0.0,0.0
36200,3,6200,[237 197 118 496  22],716,4,25406,4.097081115949041,20.0,0.0
36201,3,6201,[318 427  98 191 182],72,5,25411,4.097226701064173,40.0,0.0
36202,3,6202,[318 427  98 191 182],269,5,25416,4.0973722392390775,40.0,0.0
36203,3,6203,[318 427  98 191 182],450,5,25421,4.097517730496454,40.0,0.0
36204,3,6204,[258  25   7 185 183],457,5,25426,4.097663174858985,0.0,0.0
36205,3,6205,[318 427  98 191 182],18,5,25431,4.097808572349339,40.0,0.0
36206,3,6206,[173 238 180 357 135],450,4,25435,4.097792814564202,0.0,0.0
36207,3,6207,[603 289 496 173 435],704,4,25439,4.09777706185567,40.0,0.0
36208,3,6208,[318 427  98 191 182],450,5,25444,4.097922370752134,40.0,0.0
36209,3,6209,[318 427  98 191 182],796,5,25449,4.098067632850242,40.0,0.0
36210,3,6210,[318 427  98 191 182],796,5,25454,4.098212848172597,40.0,0.0
36211,3,6211,[655  79 273 127  88],655,3,25457,4.09803605924018,0.0,20.0
36212,3,6212,[  4 172 216 286  25],593,4,25461,4.098020280057943,0.0,20.0
36213,3,6213,[181  56 111  96 508],296,4,25465,4.098004505954297,0.0,0.0
36214,3,6214,[216 423 357 174 172],593,5,25470,4.0981496379726465,0.0,0.0
36215,3,6215,[118 125 121 168 234],577,3,25473,4.097972972972973,0.0,0.0
36216,3,6216,[318 427  98 191 182],796,5,25478,4.098118063374618,40.0,0.0
36217,3,6217,[318 427  98 191 182],796,5,25483,4.098263107108395,40.0,0.0
36218,3,6218,[ 97  70 204 286 427],503,3,25486,4.098086509085062,20.0,20.0
36219,3,6219,[302 588  70  71 151],344,3,25489,4.097909967845659,0.0,0.0
36220,3,6220,[194 403 603 257  64],796,5,25494,4.098054975084391,40.0,0.0
36221,3,6221,[318 427  98 191 182],796,5,25499,4.09819993571199,40.0,0.0
36222,3,6222,[318 427  98 191 182],796,5,25504,4.098344849750924,40.0,0.0
36223,3,6223,[ 98  25 118 172 181],330,5,25509,4.09848971722365,0.0,0.0
36224,3,6224,[183 234 143 195  64],655,3,25512,4.098313253012048,20.0,0.0
36225,3,6225,[318 427  98 191 182],796,5,25517,4.09845807902345,40.0,0.0
36226,3,6226,[168   7 173 228 427],450,5,25522,4.098602858519351,20.0,0.0
36227,3,6227,[ 79 496 471 286 195],450,5,25527,4.098747591522158,20.0,20.0
36228,3,6228,[508 403  56 210 125],655,0,25527,4.098089580992133,0.0,0.0
36229,3,6229,[132 294   1  70 172],716,5,25532,4.098234349919744,0.0,0.0
36230,3,6230,[318 427  98 191 182],655,5,25537,4.098379072380036,40.0,0.0
36231,3,6231,[318 427  98 191 182],655,5,25542,4.098523748395379,40.0,0.0
36232,3,6232,[385 121 161 294 328],655,0,25542,4.097866196053265,0.0,0.0
36233,3,6233,[403 176 508 181 183],655,1,25543,4.097369265319217,0.0,0.0
36234,3,6234,[403 234  96   1 294],450,4,25547,4.097353648757017,0.0,0.0
36235,3,6235,[ 97 234  50 211  88],450,4,25551,4.097338037203335,0.0,20.0
36236,3,6236,[318 427  98 191 182],269,5,25556,4.097482764149431,40.0,0.0
36237,3,6237,[318 427  98 191 182],18,5,25561,4.097627444693812,40.0,0.0
36238,3,6238,[ 50 276  70 216 515],655,4,25565,4.097611796762302,0.0,20.0
36239,3,6239,[318 427  98 191 182],72,5,25570,4.097756410256411,40.0,0.0
36240,3,6240,[151  79 318 403 288],457,5,25575,4.097900977407467,20.0,0.0
36241,3,6241,[318 427  98 191 182],796,5,25580,4.098045498237744,40.0,0.0
36242,3,6242,[144  89 173 385 179],457,5,25585,4.098189972769502,0.0,0.0
36243,3,6243,[318 427  98 191 182],269,5,25590,4.098334401024984,40.0,0.0
36244,3,6244,[151 515 143 237 196],401,3,25593,4.098158526821457,0.0,0.0
36245,3,6245,[318 427  98 191 182],655,5,25598,4.098302913864874,40.0,0.0
36246,3,6246,[318 427  98 191 182],655,5,25603,4.098447254682248,40.0,0.0
36247,3,6247,[318 427  98 191 182],72,5,25608,4.098591549295775,40.0,0.0
36248,3,6248,[216 568 483 183 300],716,4,25612,4.09857577212354,0.0,0.0
36249,3,6249,[318 427  98 191 182],796,5,25617,4.09872,40.0,0.0
36250,3,6250,[196 204 318  50 151],716,5,25622,4.0988641817309235,20.0,20.0
36251,3,6251,[  7  96  64  98 179],457,5,25627,4.099008317338452,20.0,0.0
36252,3,6252,[235  97 181 385 234],450,3,25630,4.098832560371022,0.0,0.0
36253,3,6253,[237 257  96  98 143],796,5,25635,4.098976654940838,0.0,0.0
36254,3,6254,[ 64  12  25 318 515],655,3,25638,4.098800959232614,40.0,0.0
36255,3,6255,[318 427  98 191 182],18,5,25643,4.098945012787723,40.0,0.0
36256,3,6256,[515 151 258  82 748],807,4,25647,4.098929199296788,0.0,0.0
36257,3,6257,[200 195 742 127 301],655,2,25649,4.098593799936082,0.0,20.0
36258,3,6258,[318 427  98 191 182],72,5,25654,4.098737817542738,40.0,0.0
36259,3,6259,[748 603 238 258  79],450,5,25659,4.09888178913738,20.0,0.0
36260,3,6260,[403 183  96 186 215],655,1,25660,4.098386839163073,0.0,0.0
36261,3,6261,[ 89 496 471 515 168],807,5,25665,4.098530820824018,20.0,0.0
36262,3,6262,[318 427  98 191 182],269,5,25670,4.098674756506466,40.0,0.0
36263,3,6263,[318 427  98 191 182],72,5,25675,4.09881864623244,40.0,0.0
36264,3,6264,[318 427  98 191 182],18,5,25680,4.0989624900239425,40.0,0.0
36265,3,6265,[ 79  98   8 483 515],655,4,25684,4.0989466964570695,0.0,0.0
36266,3,6266,[318 427  98 191 182],655,5,25689,4.099090473910962,40.0,0.0
36267,3,6267,[318 427  98 191 182],450,5,25694,4.099234205488194,40.0,0.0
36268,3,6268,[318 427  98 191 182],796,5,25699,4.099377891210719,40.0,0.0
36269,3,6269,[313 100   4 238 182],655,2,25701,4.099043062200957,0.0,20.0
36270,3,6270,[318 427  98 191 182],450,5,25706,4.099186732578536,40.0,0.0
36271,3,6271,[ 28 191 222 288 153],655,1,25707,4.098692602040816,0.0,0.0
36272,3,6272,[318 427  98 191 182],18,5,25712,4.098836282480472,40.0,0.0
36273,3,6273,[318 427  98 191 182],450,5,25717,4.098979917118266,40.0,0.0
36274,3,6274,[121  69 204 423 182],655,1,25718,4.098486055776893,0.0,0.0
36275,3,6275,[302   9  70 186  22],655,1,25719,4.097992351816443,0.0,0.0
36276,3,6276,[323 313 195 258 603],796,4,25723,4.097976740481122,20.0,0.0
36277,3,6277,[318 427  98 191 182],450,5,25728,4.0981204205160875,40.0,0.0
36278,3,6278,[318 427  98 191 182],72,5,25733,4.098264054785794,40.0,0.0
36279,3,6279,[318 427  98 191 182],655,5,25738,4.098407643312102,40.0,0.0
36280,3,6280,[471 216 235  98 111],450,4,25742,4.098391975800032,0.0,0.0
36281,3,6281,[318 427  98 191 182],18,5,25747,4.098535498248966,40.0,0.0
36282,3,6282,[294 313 268   7 144],296,4,25751,4.098519815374821,0.0,0.0
36283,3,6283,[144  79 603  22 181],450,5,25756,4.0986632718014,20.0,0.0
36284,3,6284,[121 143  25 483  56],693,3,25759,4.09848846459825,0.0,0.0
36285,3,6285,[ 97 271 273 742  25],655,1,25760,4.097995545657016,0.0,0.0
36286,3,6286,[471 286 121 181  11],450,4,25764,4.097979958644823,0.0,20.0
36287,3,6287,[318 427  98 191 182],796,5,25769,4.098123409669212,40.0,0.0
36288,3,6288,[403 172  82 194 196],269,1,25770,4.097630783908412,0.0,0.0
36289,3,6289,[322 161 216 273 427],796,3,25773,4.097456279809221,20.0,0.0
36290,3,6290,[318 427  98 191 182],796,5,25778,4.097599745668415,40.0,0.0
36291,3,6291,[196 132  89 357 191],151,4,25782,4.09758423394787,0.0,0.0
36292,3,6292,[ 64 196 172  15 100],655,2,25784,4.09725091371365,20.0,20.0
36293,3,6293,[ 25  82  97 135  56],18,2,25786,4.096917699396251,0.0,0.0
36294,3,6294,[318 427  98 191 182],796,5,25791,4.097061159650516,40.0,0.0
36295,3,6295,[471 194  79 173 302],535,3,25794,4.096886912325286,0.0,0.0
36296,3,6296,[ 95 196 161 423 588],389,2,25796,4.09655391456249,0.0,0.0
36297,3,6297,[318 427  98 191 182],450,5,25801,4.096697364242616,40.0,0.0
36298,3,6298,[318 427  98 191 182],796,5,25806,4.096840768375933,40.0,0.0
36299,3,6299,[237 302 202 204 496],344,4,25810,4.0968253968253965,20.0,0.0
36300,3,6300,[194 175 121  56  97],11,3,25813,4.096651325186478,0.0,0.0
36301,3,6301,[318 427  98 191 182],269,5,25818,4.096794668359251,40.0,0.0
36302,3,6302,[100 228 118   8  79],577,3,25821,4.096620656830081,0.0,20.0
36303,3,6303,[318 427  98 191 182],18,5,25826,4.096763959390863,40.0,0.0
36304,3,6304,[289 186 117 127 185],693,3,25829,4.096590007930214,0.0,20.0
36305,3,6305,[748 237 655 496 265],796,4,25833,4.096574690770694,20.0,0.0
36306,3,6306,[181 655 121 195 423],151,4,25837,4.096559378468369,0.0,0.0
36307,3,6307,[318 427  98 191 182],269,5,25842,4.0967025998731765,40.0,0.0
36308,3,6308,[288 742 235  97 568],450,3,25845,4.096528768426058,0.0,0.0
36309,3,6309,[655   1 121  96 273],450,3,25848,4.09635499207607,0.0,0.0
36310,3,6310,[318 427  98 191 182],655,5,25853,4.09649817778482,40.0,0.0
36311,3,6311,[318 427  98 191 182],796,5,25858,4.096641318124208,40.0,0.0
36312,3,6312,[318 427  98 191 182],269,5,25863,4.096784413115793,40.0,0.0
36313,3,6313,[ 28  71 588 385 234],786,4,25867,4.096769084573963,0.0,0.0
36314,3,6314,[ 82 546 200 196 318],786,5,25872,4.096912114014252,20.0,0.0
36315,3,6315,[403 181  82  70  28],504,2,25874,4.0965801139962,0.0,0.0
36316,3,6316,[318 427  98 191 182],655,5,25879,4.09672312806712,40.0,0.0
36317,3,6317,[318 427  98 191 182],18,5,25884,4.096866096866097,40.0,0.0
36318,3,6318,[318 427  98 191 182],655,5,25889,4.097009020414623,40.0,0.0
36319,3,6319,[318 427  98 191 182],72,5,25894,4.097151898734177,40.0,0.0
36320,3,6320,[318 427  98 191 182],655,5,25899,4.097294731846227,40.0,0.0
36321,3,6321,[318 427  98 191 182],450,5,25904,4.097437519772224,40.0,0.0
36322,3,6322,[318 427  98 191 182],655,5,25909,4.097580262533607,40.0,0.0
36323,3,6323,[143  56 301 118  82],389,3,25912,4.097406704617331,0.0,0.0
36324,3,6324,[  9  64 175   4 191],18,4,25916,4.097391304347826,20.0,0.0
36325,3,6325,[194 423  88 234 121],151,5,25921,4.097533986721467,0.0,0.0
36326,3,6326,[318 427  98 191 182],72,5,25926,4.097676623992413,40.0,0.0
36327,3,6327,[318 427  98 191 182],269,5,25931,4.097819216182048,40.0,0.0
36328,3,6328,[318 427  98 191 182],18,5,25936,4.09796176331174,40.0,0.0
36329,3,6329,[185  25 135 175 302],151,4,25940,4.097946287519747,0.0,0.0
36330,3,6330,[185 289 268  15 195],655,1,25941,4.097456957826568,0.0,0.0
36331,3,6331,[ 15 181 471 603 127],655,2,25943,4.097125710675932,20.0,20.0
36332,3,6332,[318 427  98 191 182],269,5,25948,4.097268277277752,40.0,0.0
36333,3,6333,[ 50 258 302 182  56],535,2,25950,4.096937164508999,0.0,20.0
36334,3,6334,[318 427  98 191 182],72,5,25955,4.097079715864246,40.0,0.0
36335,3,6335,[300 181 222 183 210],716,4,25959,4.097064393939394,0.0,0.0
36336,3,6336,[318 427  98 191 182],269,5,25964,4.097206880227237,40.0,0.0
36337,3,6337,[357 258 238 385 483],23,4,25968,4.097191543073524,0.0,0.0
36338,3,6338,[328 191 234  56 100],450,4,25972,4.097176210758795,0.0,20.0
36339,3,6339,[318 427  98 191 182],655,5,25977,4.097318611987382,40.0,0.0
36340,3,6340,[179 568  50 143 237],577,2,25979,4.096987856804921,0.0,20.0
36341,3,6341,[318 427  98 191 182],269,5,25984,4.097130242825607,40.0,0.0
36342,3,6342,[318 427  98 191 182],796,5,25989,4.0972725839508115,40.0,0.0
36343,3,6343,[187 655 174 357 153],716,4,25993,4.097257250945775,0.0,0.0
36344,3,6344,[135 588 288 322 301],450,3,25996,4.097084318360914,0.0,0.0
36345,3,6345,[275 357 435  69 153],716,5,26001,4.097226599432713,0.0,20.0
36346,3,6346,[318 427  98 191 182],655,5,26006,4.0973688356703954,40.0,0.0
36347,3,6347,[328 174 427 111  71],450,4,26010,4.097353497164462,20.0,0.0
36348,3,6348,[  9 174 135 238  70],18,4,26014,4.097338163490313,0.0,0.0
36349,3,6349,[405 237 181 191  79],72,2,26016,4.097007874015748,0.0,0.0
36350,3,6350,[ 64  79 588 121 258],457,5,26021,4.097150055109432,20.0,0.0
36351,3,6351,[318 427  98 191 182],796,5,26026,4.097292191435768,40.0,0.0
36352,3,6352,[318 427  98 191 182],450,5,26031,4.097434283015898,40.0,0.0
36353,3,6353,[318 427  98 191 182],72,5,26036,4.0975763298709476,40.0,0.0
36354,3,6354,[222 132  11   9  79],457,5,26041,4.09771833202203,0.0,0.0
36355,3,6355,[318 427  98 191 182],18,5,26046,4.097860289490246,40.0,0.0
36356,3,6356,[318 427  98 191 182],450,5,26051,4.098002202296681,40.0,0.0
36357,3,6357,[132 313 161 135 597],450,4,26055,4.097986788298207,0.0,0.0
36358,3,6358,[483 191 185 423 216],23,3,26058,4.097814121717251,0.0,0.0
36359,3,6359,[318 427  98 191 182],450,5,26063,4.097955974842767,40.0,0.0
36360,3,6360,[318 427  98 191 182],18,5,26068,4.098097783367395,40.0,0.0
36361,3,6361,[237 471 568   1  50],450,5,26073,4.098239547312166,0.0,20.0
36362,3,6362,[318 427  98 191 182],796,5,26078,4.098381266698098,40.0,0.0
36363,3,6363,[318 427  98 191 182],72,5,26083,4.0985229415461975,40.0,0.0
36364,3,6364,[318 427  98 191 182],18,5,26088,4.098664571877455,40.0,0.0
36365,3,6365,[508 276 183   7 678],280,2,26090,4.098334904178448,0.0,0.0
36366,3,6366,[318 427  98 191 182],72,5,26095,4.09847651955395,40.0,0.0
36367,3,6367,[318 427  98 191 182],72,5,26100,4.098618090452261,40.0,0.0
36368,3,6368,[118 204 172 405  28],450,4,26104,4.0986026063746275,0.0,0.0
36369,3,6369,[318 427  98 191 182],269,5,26109,4.098744113029827,40.0,0.0
36370,3,6370,[483 265 181 195 191],151,3,26112,4.098571652801758,0.0,0.0
36371,3,6371,[181 191 117 405 172],72,2,26114,4.098242310106717,0.0,0.0
36372,3,6372,[ 69 496 182   9 174],18,4,26118,4.098226894712067,20.0,0.0
36373,3,6373,[318 427  98 191 182],72,5,26123,4.098368371509256,40.0,0.0
36374,3,6374,[183 135 282 196 210],655,2,26125,4.098039215686274,0.0,0.0
36375,3,6375,[ 88  12 323 228  95],280,2,26127,4.097710163111668,0.0,0.0
36376,3,6376,[318 427  98 191 182],72,5,26132,4.097851654382938,40.0,0.0
36377,3,6377,[318 427  98 191 182],18,5,26137,4.097993101285669,40.0,0.0
36378,3,6378,[318 427  98 191 182],450,5,26142,4.098134503840727,40.0,0.0
36379,3,6379,[568 117 196 273 211],450,4,26146,4.098119122257053,0.0,0.0
36380,3,6380,[318 427  98 191 182],450,5,26151,4.09826046074283,40.0,0.0
36381,3,6381,[318 427  98 191 182],796,5,26156,4.0984017549357565,40.0,0.0
36382,3,6382,[318 427  98 191 182],18,5,26161,4.0985430048566505,40.0,0.0
36383,3,6383,[ 98  56 215 333   7],693,4,26165,4.0985275689223055,0.0,0.0
36384,3,6384,[318 742 187 200 191],796,4,26169,4.098512137823023,20.0,0.0
36385,3,6385,[318 427  98 191 182],796,5,26174,4.098653304102725,40.0,0.0
36386,3,6386,[405 185   9 180 196],457,5,26179,4.098794426178174,0.0,0.0
36387,3,6387,[318 427  98 191 182],450,5,26184,4.098935504070131,40.0,0.0
36388,3,6388,[ 28 168 273 257  71],796,3,26187,4.098763499765221,0.0,0.0
36389,3,6389,[318 427  98 191 182],655,5,26192,4.098904538341158,40.0,0.0
36390,3,6390,[228  25 172 117  56],457,5,26197,4.0990455327804725,0.0,0.0
36391,3,6391,[318 427  98 191 182],450,5,26202,4.09918648310388,40.0,0.0
36392,3,6392,[318 427  98 191 182],450,5,26207,4.099327389332082,40.0,0.0
36393,3,6393,[318 427  98 191 182],269,5,26212,4.099468251485768,40.0,0.0
36394,3,6394,[318 427  98 191 182],269,5,26217,4.099609069585614,40.0,0.0
36395,3,6395,[  1 328  64 127 235],450,4,26221,4.099593495934959,20.0,20.0
36396,3,6396,[318 427  98 191 182],269,5,26226,4.099734250429889,40.0,0.0
36397,3,6397,[318 427  98 191 182],450,5,26231,4.099874960925289,40.0,0.0
36398,3,6398,[427 111 204  97  28],236,4,26235,4.09985935302391,20.0,0.0
36399,3,6399,[318 427  98 191 182],655,5,26240,4.1,40.0,0.0
36400,3,6400,[318 427  98 191 182],450,5,26245,4.100140603030776,40.0,0.0
36401,3,6401,[235  56 300 603 216],716,4,26249,4.100124960949703,20.0,0.0
36402,3,6402,[194 185 153 181  69],796,5,26254,4.100265500546619,0.0,0.0
36403,3,6403,[318 427  98 191 182],796,5,26259,4.100405996252342,40.0,0.0
36404,3,6404,[435  95 300 216 235],450,3,26262,4.100234192037471,0.0,0.0
36405,3,6405,[ 64 385 173 180 597],450,5,26267,4.100374648766781,20.0,0.0
36406,3,6406,[237 215  69 403 210],655,0,26267,4.099734665209927,0.0,0.0
36407,3,6407,[318 427  98 191 182],18,5,26272,4.099875156054932,40.0,0.0
36408,3,6408,[588 111  15  28  25],577,4,26276,4.0998595724762055,0.0,0.0
36409,3,6409,[318 427  98 191 182],72,5,26281,4.1,40.0,0.0
36410,3,6410,[318 427  98 191 182],796,5,26286,4.100140383715489,40.0,0.0
36411,3,6411,[258  82 125 286  22],796,3,26289,4.099968808484093,0.0,20.0
36412,3,6412,[318 427  98 191 182],796,5,26294,4.1001091532823954,40.0,0.0
36413,3,6413,[234 111 235 135 121],269,1,26295,4.099625818521983,0.0,0.0
36414,3,6414,[258 111 173   8  96],796,5,26300,4.099766173031957,0.0,0.0
36415,3,6415,[215  70 125 191 176],344,2,26302,4.099438902743142,0.0,0.0
36416,3,6416,[318 427  98 191 182],655,5,26307,4.099579242636747,40.0,0.0
36417,3,6417,[318 427  98 191 182],269,5,26312,4.0997195387971335,40.0,0.0
36418,3,6418,[318 427  98 191 182],796,5,26317,4.099859791244742,40.0,0.0
36419,3,6419,[318 427  98 191 182],72,5,26322,4.1,40.0,0.0
36420,3,6420,[288 403 357 202 234],504,2,26324,4.099672948138919,0.0,0.0
36421,3,6421,[318 427  98 191 182],450,5,26329,4.0998131423232635,40.0,0.0
36422,3,6422,[  7 276 403 318 151],269,3,26332,4.099641911879184,20.0,0.0
36423,3,6423,[318 427  98 191 182],269,5,26337,4.099782067247821,40.0,0.0
36424,3,6424,[318 427  98 191 182],796,5,26342,4.099922178988327,40.0,0.0
36425,3,6425,[318 427  98 191 182],796,5,26347,4.100062247121071,40.0,0.0
36426,3,6426,[318 427  98 191 182],269,5,26352,4.100202271666407,40.0,0.0
36427,3,6427,[  1  95 588 195  96],807,3,26355,4.100031113876789,0.0,0.0
36428,3,6428,[183   4 546 313 174],450,4,26359,4.1000155545185875,0.0,0.0
36429,3,6429,[196 173 423  15 135],269,2,26361,4.099688958009331,0.0,0.0
36430,3,6430,[435   4 100 258  50],535,4,26365,4.099673456694138,0.0,40.0
36431,3,6431,[546  15 318 427 111],577,3,26368,4.099502487562189,40.0,0.0
36432,3,6432,[111  98 197 173 117],786,4,26372,4.099487020052853,0.0,0.0
36433,3,6433,[ 71 546 125 118 423],796,5,26377,4.099626981659932,0.0,0.0
36434,3,6434,[318 427  98 191 182],796,5,26382,4.0997668997669,40.0,0.0
36435,3,6435,[435 603 265 135 268],535,2,26384,4.099440646364202,20.0,0.0
36436,3,6436,[318 427  98 191 182],796,5,26389,4.099580549945627,40.0,0.0
36437,3,6437,[318 427  98 191 182],450,5,26394,4.099720410065237,40.0,0.0
36438,3,6438,[132 435 161   7  88],450,5,26399,4.099860226743283,0.0,0.0
36439,3,6439,[  7 471 403 174 197],280,1,26400,4.099378881987578,0.0,0.0
36440,3,6440,[ 89 245 403  64  97],796,3,26403,4.099208197484862,20.0,0.0
36441,3,6441,[302 111 174 568 483],450,4,26407,4.099192797267929,0.0,0.0
36442,3,6442,[ 64 275 216 153 197],321,4,26411,4.099177401831445,20.0,20.0
36443,3,6443,[ 28  98 265  71 200],236,2,26413,4.09885164494103,0.0,0.0
36444,3,6444,[318 427  98 191 182],450,5,26418,4.098991466252909,40.0,0.0
36445,3,6445,[318 427  98 191 182],450,5,26423,4.099131244182439,40.0,0.0
36446,3,6446,[318 427  98 191 182],796,5,26428,4.099270978749806,40.0,0.0
36447,3,6447,[313 423  70 204   1],593,4,26432,4.099255583126551,0.0,0.0
36448,3,6448,[121  25  12 182  70],72,4,26436,4.099240192277873,0.0,0.0
36449,3,6449,[ 12 322 238 204  22],796,3,26439,4.09906976744186,0.0,0.0
36450,3,6450,[ 98 568 435 403   4],450,4,26443,4.099054410168966,0.0,0.0
36451,3,6451,[175  70 183 435 546],716,2,26445,4.098729076255425,0.0,0.0
36452,3,6452,[568 302 235 265 238],450,4,26449,4.098713776538045,0.0,0.0
36453,3,6453,[318 427  98 191 182],796,5,26454,4.098853424233034,40.0,0.0
36454,3,6454,[228 100 196 275  56],796,4,26458,4.098838109992254,0.0,40.0
36455,3,6455,[ 97  56 194 161  69],504,3,26461,4.09866790582404,0.0,0.0
36456,3,6456,[125 196 151 180 187],796,4,26465,4.098652625058077,0.0,0.0
36457,3,6457,[318 427  98 191 182],18,5,26470,4.098792195726231,40.0,0.0
36458,3,6458,[318 427  98 191 182],796,5,26475,4.098931723176962,40.0,0.0
36459,3,6459,[318 427  98 191 182],269,5,26480,4.099071207430341,40.0,0.0
36460,3,6460,[ 15 423 121 302 237],655,1,26481,4.098591549295775,0.0,0.0
36461,3,6461,[318 427  98 191 182],269,5,26486,4.098731043020736,40.0,0.0
36462,3,6462,[210 174 568 216 117],655,1,26487,4.098251585950797,0.0,0.0
36463,3,6463,[238 176 204 318 132],151,4,26491,4.0982363861386135,20.0,0.0
36464,3,6464,[318 427  98 191 182],72,5,26496,4.098375870069606,40.0,0.0
36465,3,6465,[151 194 180   1  25],450,4,26500,4.098360655737705,0.0,0.0
36466,3,6466,[ 89 423 180 125 234],457,5,26505,4.098500077315602,0.0,0.0
36467,3,6467,[  4 276 197  64 427],535,3,26508,4.098330241187384,40.0,0.0
36468,3,6468,[318 427  98 191 182],655,5,26513,4.098469624362344,40.0,0.0
36469,3,6469,[ 64  28  89  56 300],655,2,26515,4.098145285935085,20.0,0.0
36470,3,6470,[483  15 275 238  97],655,2,26517,4.0978210477515065,0.0,20.0
36471,3,6471,[191 405 182 180 187],269,3,26520,4.097651421508035,0.0,0.0
36472,3,6472,[  1  82  12 496  50],151,4,26524,4.0976363355476595,20.0,20.0
36473,3,6473,[318 427  98 191 182],72,5,26529,4.097775718257646,40.0,0.0
36474,3,6474,[257 333  50 265 100],655,1,26530,4.097297297297297,0.0,40.0
36475,3,6475,[318 427  98 191 182],796,5,26535,4.097436689314391,40.0,0.0
36476,3,6476,[197 117 151 183 135],756,3,26538,4.097267253358036,0.0,0.0
36477,3,6477,[265  12 161 301 427],450,5,26543,4.097406606977462,20.0,0.0
36478,3,6478,[318 427  98 191 182],72,5,26548,4.097545917579874,40.0,0.0
36479,3,6479,[144 194   9 215  22],535,3,26551,4.097376543209877,0.0,0.0
36480,3,6480,[318 427  98 191 182],450,5,26556,4.097515815460577,40.0,0.0
36481,3,6481,[ 89 302 100 144 127],655,3,26559,4.0973464979944465,0.0,40.0
36482,3,6482,[318 234 180  12 143],457,5,26564,4.0974857319142375,20.0,0.0
36483,3,6483,[181 655  15 742 568],577,3,26567,4.097316471314004,0.0,0.0
36484,3,6484,[ 64 168 173  50 194],796,5,26572,4.09745566692367,20.0,20.0
36485,3,6485,[748  11 257 196 405],401,1,26573,4.096978106691335,0.0,0.0
36486,3,6486,[318 427  98 191 182],18,5,26578,4.097117311546169,40.0,0.0
36487,3,6487,[127  11 175 172 238],716,4,26582,4.097102342786683,0.0,20.0
36488,3,6488,[195 405   4 143 172],786,5,26587,4.097241485591,0.0,0.0
36489,3,6489,[ 88   4 405 173  96],577,3,26590,4.0970724191063175,0.0,0.0
36490,3,6490,[318 427  98 191 182],796,5,26595,4.097211523648128,40.0,0.0
36491,3,6491,[195 282  98 294 197],655,1,26596,4.096734442390635,0.0,0.0
36492,3,6492,[318 427  98 191 182],655,5,26601,4.096873556137378,40.0,0.0
36493,3,6493,[318 427  98 191 182],796,5,26606,4.097012627040345,40.0,0.0
36494,3,6494,[318 427  98 191 182],18,5,26611,4.0971516551193226,40.0,0.0
36495,3,6495,[216 237  97 357 385],796,4,26615,4.097136699507389,0.0,0.0
36496,3,6496,[173  89 289  79 222],756,3,26618,4.096967831306757,0.0,0.0
36497,3,6497,[318 427  98 191 182],796,5,26623,4.097106802092951,40.0,0.0
36498,3,6498,[181  95 132 200 180],716,4,26627,4.097091860286198,0.0,0.0
36499,3,6499,[742 174 222  96  56],796,4,26631,4.097076923076923,0.0,0.0
36500,3,6500,[385 423 202 273 153],655,1,26632,4.096600522996462,0.0,0.0
36501,3,6501,[275 655 144 132 508],535,4,26636,4.096585665948939,0.0,20.0
36502,3,6502,[ 88 603 117 194 210],450,4,26640,4.096570813470706,20.0,0.0
36503,3,6503,[318 427  98 191 182],72,5,26645,4.096709717097171,40.0,0.0
36504,3,6504,[318 427  98 191 182],18,5,26650,4.09684857801691,40.0,0.0
36505,3,6505,[175 603 127 111  70],716,4,26654,4.096833691976637,20.0,20.0
36506,3,6506,[318 427  98 191 182],18,5,26659,4.0969724911633625,40.0,0.0
36507,3,6507,[318 427  98 191 182],269,5,26664,4.097111247695144,40.0,0.0
36508,3,6508,[125  96 748 222   1],292,2,26666,4.096789061299739,0.0,0.0
36509,3,6509,[ 98 235 515 435 151],716,4,26670,4.096774193548387,0.0,0.0
36510,3,6510,[318 427  98 191 182],269,5,26675,4.0969129166026725,40.0,0.0
36511,3,6511,[175 471 191 117 385],344,2,26677,4.096590909090909,0.0,0.0
36512,3,6512,[318 427  98 191 182],796,5,26682,4.096729617687702,40.0,0.0
36513,3,6513,[191 282 275 173 496],796,5,26687,4.0968682836966535,20.0,20.0
36514,3,6514,[161 271 496  15 405],796,5,26692,4.097006907137375,20.0,0.0
36515,3,6515,[603 271 143  89 269],796,4,26696,4.096992019643953,20.0,0.0
36516,3,6516,[318 427  98 191 182],796,5,26701,4.0971305815559305,40.0,0.0
36517,3,6517,[202  89 195 186 357],18,2,26703,4.096808837066585,0.0,0.0
36518,3,6518,[211 405 216 186   8],269,1,26704,4.096333793526615,0.0,0.0
36519,3,6519,[318 427  98 191 182],72,5,26709,4.096472392638037,40.0,0.0
36520,3,6520,[318 427  98 191 182],450,5,26714,4.096610949240914,40.0,0.0
36521,3,6521,[210 176   4 179  97],655,1,26715,4.096136154553818,0.0,0.0
36522,3,6522,[318 427  98 191 182],269,5,26720,4.096274720220757,40.0,0.0
36523,3,6523,[ 98 483 191 300 496],450,4,26724,4.096259963212753,20.0,0.0
36524,3,6524,[187 313 204  95 265],796,5,26729,4.09639846743295,0.0,0.0
36525,3,6525,[318 427  98 191 182],72,5,26734,4.096536929206252,40.0,0.0
36526,3,6526,[132 427 286 385   1],655,1,26735,4.096062509575609,20.0,20.0
36527,3,6527,[318 427  98 191 182],796,5,26740,4.096200980392157,40.0,0.0
36528,3,6528,[318 427  98 191 182],796,5,26745,4.096339408791545,40.0,0.0
36529,3,6529,[603 286  98 471 475],655,2,26747,4.096018376722817,20.0,20.0
36530,3,6530,[318 427  98 191 182],72,5,26752,4.096156790690553,40.0,0.0
36531,3,6531,[216 125 121 111 286],593,5,26757,4.0962951622780155,0.0,20.0
36532,3,6532,[318 427  98 191 182],796,5,26762,4.096433491504668,40.0,0.0
36533,3,6533,[318 427  98 191 182],796,5,26767,4.0965717783899604,40.0,0.0
36534,3,6534,[196 179 228 197  98],655,2,26769,4.096250956388676,0.0,0.0
36535,3,6535,[228 168   8  69 427],796,5,26774,4.096389228886169,20.0,0.0
36536,3,6536,[318 427  98 191 182],450,5,26779,4.0965274590790886,40.0,0.0
36537,3,6537,[318 427  98 191 182],796,5,26784,4.096665646986846,40.0,0.0
36538,3,6538,[318 427  98 191 182],269,5,26789,4.096803792628842,40.0,0.0
36539,3,6539,[318 427  98 191 182],450,5,26794,4.096941896024465,40.0,0.0
36540,3,6540,[318 427  98 191 182],796,5,26799,4.09707995719309,40.0,0.0
36541,3,6541,[180 483  11 127 427],693,3,26802,4.096912259247937,20.0,20.0
36542,3,6542,[318 427  98 191 182],72,5,26807,4.0970502827449184,40.0,0.0
36543,3,6543,[318 427  98 191 182],18,5,26812,4.09718826405868,40.0,0.0
36544,3,6544,[403  22 385  97 282],655,0,26812,4.096562261268144,0.0,0.0
36545,3,6545,[ 22   7 508  71   4],280,3,26815,4.096394744882371,0.0,0.0
36546,3,6546,[318 427  98 191 182],72,5,26820,4.096532763097602,40.0,0.0
36547,3,6547,[318 427  98 191 182],18,5,26825,4.096670739156995,40.0,0.0
36548,3,6548,[  7 302 127  12 257],655,2,26827,4.096350587876012,0.0,20.0
36549,3,6549,[175 191 200  82  95],716,4,26831,4.096335877862596,0.0,0.0
36550,3,6550,[187 286 655  89 186],796,2,26833,4.096015875438864,0.0,20.0
36551,3,6551,[200 742 496 202  79],796,4,26837,4.096001221001221,20.0,0.0
36552,3,6552,[318 427  98 191 182],269,5,26842,4.096139172897909,40.0,0.0
36553,3,6553,[357 546 175 588 185],23,3,26845,4.095971925541654,0.0,0.0
36554,3,6554,[235 435  96 385  95],716,2,26847,4.095652173913043,0.0,0.0
36555,3,6555,[228 302  88 301 210],344,4,26851,4.095637583892618,0.0,0.0
36556,3,6556,[318 427  98 191 182],269,5,26856,4.095775507091658,40.0,0.0
36557,3,6557,[222 197 322 294  98],450,4,26860,4.095760902714242,0.0,0.0
36558,3,6558,[318 427  98 191 182],796,5,26865,4.095898765055649,40.0,0.0
36559,3,6559,[318 427  98 191 182],655,5,26870,4.096036585365853,40.0,0.0
36560,3,6560,[318 427  98 191 182],18,5,26875,4.096174363664075,40.0,0.0
36561,3,6561,[318 427  98 191 182],269,5,26880,4.096312099969522,40.0,0.0
36562,3,6562,[135 127 175 237  56],269,4,26884,4.096297424958099,0.0,20.0
36563,3,6563,[118 210  25 282  50],450,2,26886,4.095978062157221,0.0,20.0
36564,3,6564,[100  12  82 200 143],577,3,26889,4.095811119573495,0.0,20.0
36565,3,6565,[318 427  98 191 182],269,5,26894,4.095948827292111,40.0,0.0
36566,3,6566,[ 98 265  11 269 427],655,2,26896,4.095629663468859,20.0,0.0
36567,3,6567,[234 597   4 496 655],450,3,26899,4.095462850182704,20.0,0.0
36568,3,6568,[318 427  98 191 182],18,5,26904,4.095600548028619,40.0,0.0
36569,3,6569,[196 132 127 216 191],835,5,26909,4.095738203957382,0.0,20.0
36570,3,6570,[100 176 181 168  56],389,5,26914,4.09587581798813,0.0,20.0
36571,3,6571,[183  69  79 300 118],693,1,26915,4.095404747413268,0.0,0.0
36572,3,6572,[237 168  64  71  98],450,4,26919,4.095390232770424,20.0,0.0
36573,3,6573,[153 546 202 597  79],796,5,26924,4.095527836933374,0.0,0.0
36574,3,6574,[ 88 313 276 237  50],344,2,26926,4.095209125475285,0.0,20.0
36575,3,6575,[318 427  98 191 182],18,5,26931,4.095346715328467,40.0,0.0
36576,3,6576,[318 427  98 191 182],18,5,26936,4.095484263341949,40.0,0.0
36577,3,6577,[237 194   9  82 118],796,3,26939,4.095317725752508,0.0,0.0
36578,3,6578,[ 71 286 195 117 588],344,2,26941,4.0949992400060795,0.0,20.0
36579,3,6579,[282  25 288 175 179],457,5,26946,4.095136778115502,0.0,0.0
36580,3,6580,[ 97   9 300 294 183],796,2,26948,4.094818416654004,0.0,0.0
36581,3,6581,[318 427  98 191 182],72,5,26953,4.094955940443634,40.0,0.0
36582,3,6582,[268 135   8 117 185],655,2,26955,4.094637703174844,0.0,0.0
36583,3,6583,[318 427  98 191 182],796,5,26960,4.094775212636695,40.0,0.0
36584,3,6584,[181  79 268 568 118],655,1,26961,4.094305239179954,0.0,0.0
36585,3,6585,[318 427  98 191 182],796,5,26966,4.094442757364106,40.0,0.0
36586,3,6586,[194 111 200 176 216],457,4,26970,4.094428419614392,0.0,0.0
36587,3,6587,[318 427  98 191 182],269,5,26975,4.094565877352762,40.0,0.0
36588,3,6588,[318 427  98 191 182],796,5,26980,4.0947032933677345,40.0,0.0
36589,3,6589,[318 427  98 191 182],796,5,26985,4.094840667678301,40.0,0.0
36590,3,6590,[318 427  98 191 182],72,5,26990,4.094978000303444,40.0,0.0
36591,3,6591,[515 179 483 597 403],269,3,26993,4.094811893203883,0.0,0.0
36592,3,6592,[301 215 258  22   4],535,3,26996,4.0946458364932505,0.0,0.0
36593,3,6593,[  1 597 286 258  82],450,4,27000,4.094631483166515,0.0,20.0
36594,3,6594,[302 515 313 228 357],655,4,27004,4.09461713419257,0.0,0.0
36595,3,6595,[234 210 288 546 197],280,2,27006,4.094299575500303,0.0,0.0
36596,3,6596,[318 427  98 191 182],450,5,27011,4.094436865241777,40.0,0.0
36597,3,6597,[318 427  98 191 182],269,5,27016,4.094574113367687,40.0,0.0
36598,3,6598,[ 88 176  15  97  69],11,2,27018,4.094256705561449,0.0,0.0
36599,3,6599,[234   1 176 483  79],796,3,27021,4.094090909090909,0.0,0.0
36600,3,6600,[121 302  97 200  95],450,2,27023,4.0937736706559615,0.0,0.0
36601,3,6601,[ 97 182 323   9 204],796,2,27025,4.09345652832475,0.0,0.0
36602,3,6602,[  1   8  82 257 286],389,3,27028,4.093290928365894,0.0,20.0
36603,3,6603,[ 96 135 176  56 294],716,2,27030,4.09297395517868,0.0,0.0
36604,3,6604,[318 427  98 191 182],269,5,27035,4.093111279333838,40.0,0.0
36605,3,6605,[318 427  98 191 182],796,5,27040,4.093248561913412,40.0,0.0
36606,3,6606,[ 88   1 328 215 211],65,4,27044,4.093234448312396,0.0,0.0
36607,3,6607,[222 333   9 237 318],236,4,27048,4.093220338983051,20.0,0.0
36608,3,6608,[318 427  98 191 182],269,5,27053,4.093357542744742,40.0,0.0
36609,3,6609,[132 186  56  79  97],457,5,27058,4.093494704992436,0.0,0.0
36610,3,6610,[318 427  98 191 182],655,5,27063,4.09363182574497,40.0,0.0
36611,3,6611,[748 268 301  25  97],11,3,27066,4.093466424682395,0.0,0.0
36612,3,6612,[318 427  98 191 182],796,5,27071,4.093603508241343,40.0,0.0
36613,3,6613,[318 427  98 191 182],269,5,27076,4.093740550347747,40.0,0.0
36614,3,6614,[496 265 210  69 161],807,5,27081,4.093877551020408,20.0,0.0
36615,3,6615,[318 427  98 191 182],72,5,27086,4.094014510278114,40.0,0.0
36616,3,6616,[302 179 403 117 175],655,2,27088,4.093698050476046,0.0,0.0
36617,3,6617,[318 427  98 191 182],269,5,27093,4.093834995466908,40.0,0.0
36618,3,6618,[435 174 125 423 185],655,1,27094,4.093367578184016,0.0,0.0
36619,3,6619,[318 427  98 191 182],269,5,27099,4.093504531722054,40.0,0.0
36620,3,6620,[153 234 210 200 174],18,3,27102,4.09333937471681,0.0,0.0
36621,3,6621,[568 125 405 181 222],450,4,27106,4.093325279371791,0.0,0.0
36622,3,6622,[318 427  98 191 182],655,5,27111,4.09346217726106,40.0,0.0
36623,3,6623,[ 96 211 228  89 294],296,4,27115,4.09344806763285,0.0,0.0
36624,3,6624,[333 302 515 121 268],655,2,27117,4.093132075471698,0.0,0.0
36625,3,6625,[318 427  98 191 182],655,5,27122,4.0932689405372775,40.0,0.0
36626,3,6626,[118 186 273  25 117],693,2,27124,4.092953070771088,0.0,0.0
36627,3,6627,[318 427  98 191 182],18,5,27129,4.093089921544961,40.0,0.0
36628,3,6628,[405 423 237 655 144],655,0,27129,4.092472469452406,0.0,0.0
36629,3,6629,[ 69 210  82 228 222],151,4,27133,4.092458521870286,0.0,0.0
36630,3,6630,[179   4 197 483 568],450,3,27136,4.09229377167848,0.0,0.0
36631,3,6631,[655 302 161  22 121],655,1,27137,4.091827503015682,0.0,0.0
36632,3,6632,[318 427  98 191 182],450,5,27142,4.091964420322629,40.0,0.0
36633,3,6633,[174  69  79  82 196],655,1,27143,4.091498341875188,0.0,0.0
36634,3,6634,[276 215 187 423 269],655,2,27145,4.091183119819141,0.0,0.0
36635,3,6635,[318 427  98 191 182],796,5,27150,4.0913200723327305,40.0,0.0
36636,3,6636,[313 187  71   9 181],236,3,27153,4.091155642609613,0.0,0.0
36637,3,6637,[423  28 195  69 197],457,5,27158,4.091292557999397,0.0,0.0
36638,3,6638,[318 427  98 191 182],269,5,27163,4.0914294321433955,40.0,0.0
36639,3,6639,[318 427  98 191 182],18,5,27168,4.091566265060241,40.0,0.0
36640,3,6640,[135 202 234 265 245],629,4,27172,4.091552477036591,0.0,0.0
36641,3,6641,[ 28 183 161 405  22],577,4,27176,4.0915386931647095,0.0,0.0
36642,3,6642,[132 216 294 187 245],796,3,27179,4.091374379045612,0.0,0.0
36643,3,6643,[273  96 234 435 185],655,2,27181,4.091059602649007,0.0,0.0
36644,3,6644,[234 161  95 228 181],716,4,27185,4.09104589917231,0.0,0.0
36645,3,6645,[318 427  98 191 182],72,5,27190,4.091182666265423,40.0,0.0
36646,3,6646,[318 427  98 191 182],18,5,27195,4.09131939220701,40.0,0.0
36647,3,6647,[318 427  98 191 182],269,5,27200,4.091456077015644,40.0,0.0
36648,3,6648,[191 111 568 204 176],457,4,27204,4.091442322153707,0.0,0.0
36649,3,6649,[151 294  88 202 211],23,1,27205,4.090977443609023,0.0,0.0
36650,3,6650,[276 176 161  97 186],504,2,27207,4.090663058186739,0.0,0.0
36651,3,6651,[ 12 313 121 204 132],344,3,27210,4.090499098015634,0.0,0.0
36652,3,6652,[216   4 204 265 161],577,5,27215,4.090635803396964,0.0,0.0
36653,3,6653,[196  95 127 475 300],389,2,27217,4.090321611061016,0.0,20.0
36654,3,6654,[318 427  98 191 182],269,5,27222,4.09045830202855,40.0,0.0
36655,3,6655,[196 322 385 211  89],796,3,27225,4.090294471153846,0.0,0.0
36656,3,6656,[318 427  98 191 182],72,5,27230,4.090431125131441,40.0,0.0
36657,3,6657,[117 183 151 423 143],504,4,27234,4.090417542805647,0.0,0.0
36658,3,6658,[318 427  98 191 182],72,5,27239,4.090554137257847,40.0,0.0
36659,3,6659,[  7 300 313 215 172],693,3,27242,4.09039039039039,0.0,0.0
36660,3,6660,[318 427  98 191 182],655,5,27247,4.09052694790572,40.0,0.0
36661,3,6661,[357 172 403 185 125],457,5,27252,4.090663464425098,0.0,0.0
36662,3,6662,[385 322  96 276 121],256,4,27256,4.090649857421582,0.0,0.0
36663,3,6663,[318 427  98 191 182],450,5,27261,4.09078631452581,40.0,0.0
36664,3,6664,[318 427  98 191 182],796,5,27266,4.090922730682671,40.0,0.0
36665,3,6665,[195 435 153 655 405],450,5,27271,4.091059105910591,0.0,0.0
36666,3,6666,[196   4  25 195  88],18,0,27271,4.090445477726114,0.0,0.0
36667,3,6667,[216 282 748  56 237],796,5,27276,4.090581883623275,0.0,0.0
36668,3,6668,[286  82 265   9 191],786,5,27281,4.090718248612985,0.0,20.0
36669,3,6669,[ 97 258 245 100 234],450,4,27285,4.090704647676162,0.0,20.0
36670,3,6670,[318 427  98 191 182],269,5,27290,4.090840953380303,40.0,0.0
36671,3,6671,[318 427  98 191 182],18,5,27295,4.09097721822542,40.0,0.0
36672,3,6672,[100  50 475 496  82],269,3,27298,4.0908137269593885,20.0,40.0
36673,3,6673,[318 427  98 191 182],18,5,27303,4.090949955049446,40.0,0.0
36674,3,6674,[471 121 655 258 435],655,0,27303,4.090337078651685,0.0,0.0
36675,3,6675,[318 427  98 191 182],72,5,27308,4.090473337327741,40.0,0.0
36676,3,6676,[318 427  98 191 182],450,5,27313,4.090609555189456,40.0,0.0
36677,3,6677,[318 427  98 191 182],655,5,27318,4.090745732255166,40.0,0.0
36678,3,6678,[180 276  28 153 173],292,5,27323,4.090881868543195,0.0,0.0
36679,3,6679,[496 181 180 435 300],450,5,27328,4.091017964071856,20.0,0.0
36680,3,6680,[ 69 183 135 273 568],693,2,27330,4.09070498428379,0.0,0.0
36681,3,6681,[318 427  98 191 182],796,5,27335,4.090841065549236,40.0,0.0
36682,3,6682,[318 427  98 191 182],72,5,27340,4.0909771060900795,40.0,0.0
36683,3,6683,[318 427  98 191 182],796,5,27345,4.091113105924596,40.0,0.0
36684,3,6684,[  1 483 197  82 117],457,5,27350,4.091249065071055,0.0,0.0
36685,3,6685,[318 427  98 191 182],18,5,27355,4.091384983547711,40.0,0.0
36686,3,6686,[588 597  96 135 153],450,4,27359,4.091371317481681,0.0,0.0
36687,3,6687,[318 427  98 191 182],450,5,27364,4.091507177033493,40.0,0.0
36688,3,6688,[161 568 322 173 200],593,4,27368,4.091493496785768,0.0,0.0
36689,3,6689,[ 82 235  89  88  70],450,3,27371,4.091330343796711,0.0,0.0
36690,3,6690,[302 237 200  79   1],655,3,27374,4.091167239575549,0.0,0.0
36691,3,6691,[318 427  98 191 182],72,5,27379,4.0913030484160195,40.0,0.0
36692,3,6692,[  1 143 496 216 435],389,3,27382,4.091139997011803,20.0,0.0
36693,3,6693,[318 427  98 191 182],655,5,27387,4.091275769345683,40.0,0.0
36694,3,6694,[ 70 282 204 471 125],457,5,27392,4.0914115011202385,0.0,0.0
36695,3,6695,[153 286 118 603 143],450,4,27396,4.091397849462366,20.0,20.0
36696,3,6696,[318 427  98 191 182],655,5,27401,4.091533522472749,40.0,0.0
36697,3,6697,[318 427  98 191 182],796,5,27406,4.091669154971633,40.0,0.0
36698,3,6698,[100  69 215   1 197],174,4,27410,4.091655470965816,0.0,20.0
36699,3,6699,[216 175  98 121 117],716,4,27414,4.091641791044776,0.0,0.0
36700,3,6700,[196 125   4 313  12],796,5,27419,4.091777346664677,0.0,0.0
36701,3,6701,[181   4  79 182 173],535,2,27421,4.09146523425843,0.0,0.0
36702,3,6702,[403 423 286 204 216],450,5,27426,4.091600775772043,0.0,20.0
36703,3,6703,[ 88 173 204 135  50],457,5,27431,4.091736276849642,0.0,20.0
36704,3,6704,[186 194 174 588 185],450,4,27435,4.091722595078299,0.0,0.0
36705,3,6705,[318 427  98 191 182],72,5,27440,4.091858037578288,40.0,0.0
36706,3,6706,[179  15  22   7 161],450,4,27444,4.091844341732518,0.0,0.0
36707,3,6707,[318 427  98 191 182],655,5,27449,4.091979725700656,40.0,0.0
36708,3,6708,[100 195 294 282 181],236,2,27451,4.091667908779252,0.0,20.0
36709,3,6709,[182 403   4 175 191],457,5,27456,4.091803278688524,0.0,0.0
36710,3,6710,[318 427  98 191 182],18,5,27461,4.091938608255104,40.0,0.0
36711,3,6711,[318 427  98 191 182],796,5,27466,4.09207389749702,40.0,0.0
36712,3,6712,[318 427  98 191 182],655,5,27471,4.092209146432295,40.0,0.0
36713,3,6713,[ 70 172 655 215  95],23,2,27473,4.091897527554364,0.0,0.0
36714,3,6714,[194 318 111 168 405],151,4,27477,4.091883842144453,20.0,0.0
36715,3,6715,[318 427  98 191 182],796,5,27482,4.092019058963669,40.0,0.0
36716,3,6716,[195  28 153 100 135],151,2,27484,4.0917076075629,0.0,20.0
36717,3,6717,[318 427  98 191 182],655,5,27489,4.091842810360227,40.0,0.0
36718,3,6718,[318 427  98 191 182],655,5,27494,4.091977972912636,40.0,0.0
36719,3,6719,[403 118  56 237 318],504,1,27495,4.091517857142857,20.0,0.0
36720,3,6720,[  9 228 323 300 301],796,2,27497,4.0912066656747506,0.0,0.0
36721,3,6721,[471 132  28 183 197],450,5,27502,4.091341862540911,0.0,0.0
36722,3,6722,[  4 385 313 318 216],450,4,27506,4.091328276067232,20.0,0.0
36723,3,6723,[318 427  98 191 182],269,5,27511,4.091463414634147,40.0,0.0
36724,3,6724,[195 588 173  28  70],23,3,27514,4.091301115241635,0.0,0.0
36725,3,6725,[197  50 282 237 211],655,1,27515,4.090841510556051,0.0,20.0
36726,3,6726,[318 427  98 191 182],72,5,27520,4.090976661215995,40.0,0.0
36727,3,6727,[  1 127  50 357 176],450,5,27525,4.091111771700357,0.0,40.0
36728,3,6728,[357 100 182 318 197],450,5,27530,4.091246842027047,20.0,20.0
36729,3,6729,[742 435  64 181 151],450,5,27535,4.091381872213967,20.0,0.0
36730,3,6730,[176  95 403 185   4],796,5,27540,4.091516862279008,0.0,0.0
36731,3,6731,[318 427  98 191 182],450,5,27545,4.091651812240047,40.0,0.0
36732,3,6732,[318 427  98 191 182],796,5,27550,4.091786722114956,40.0,0.0
36733,3,6733,[427 301 187 211 181],296,5,27555,4.091921591921592,20.0,0.0
36734,3,6734,[318 427  98 191 182],269,5,27560,4.092056421677802,40.0,0.0
36735,3,6735,[318 427  98 191 182],72,5,27565,4.092191211401425,40.0,0.0
36736,3,6736,[191 215 228 568  97],796,4,27569,4.092177527089209,0.0,0.0
36737,3,6737,[508 118 111 216  88],280,2,27571,4.091867022855447,0.0,0.0
36738,3,6738,[  1 475 187  50 237],655,2,27573,4.091556610773112,0.0,20.0
36739,3,6739,[318 427  98 191 182],18,5,27578,4.091691394658754,40.0,0.0
36740,3,6740,[318 427  98 191 182],269,5,27583,4.091826138555111,40.0,0.0
36741,3,6741,[318 427  98 191 182],269,5,27588,4.091960842479977,40.0,0.0
36742,3,6742,[318 427  98 191 182],796,5,27593,4.092095506451135,40.0,0.0
36743,3,6743,[273 127 238 117 222],450,3,27596,4.091933570581258,0.0,20.0
36744,3,6744,[237   1 257 435 183],655,1,27597,4.091475166790215,0.0,0.0
36745,3,6745,[318 427  98 191 182],18,5,27602,4.091609842869849,40.0,0.0
36746,3,6746,[125 183 403 185 100],504,3,27605,4.0914480509856235,0.0,20.0
36747,3,6747,[318 427  98 191 182],72,5,27610,4.091582691167753,40.0,0.0
36748,3,6748,[318 427  98 191 182],18,5,27615,4.0917172914505855,40.0,0.0
36749,3,6749,[318 427  98 191 182],655,5,27620,4.091851851851852,40.0,0.0
36750,3,6750,[286  69 603 471  82],389,4,27624,4.09183824618575,20.0,20.0
36751,3,6751,[333 176  64 111 187],796,5,27629,4.091972748815166,20.0,0.0
36752,3,6752,[318 427  98 191 182],269,5,27634,4.092107211609655,40.0,0.0
36753,3,6753,[111  70 100 385 191],457,4,27638,4.092093574178265,0.0,20.0
36754,3,6754,[ 15 496 172 185 118],330,5,27643,4.092227979274611,20.0,0.0
36755,3,6755,[ 50 237 168 405 121],716,5,27648,4.092362344582593,0.0,20.0
36756,3,6756,[318 427  98 191 182],18,5,27653,4.092496670119876,40.0,0.0
36757,3,6757,[318 427  98 191 182],655,5,27658,4.092630955904114,40.0,0.0
36758,3,6758,[ 88 191 197 234 318],878,4,27662,4.092617251072644,20.0,0.0
36759,3,6759,[111 216 276 323  82],280,3,27665,4.0924556213017755,0.0,0.0
36760,3,6760,[153 405 151 265  64],151,3,27668,4.092294039343292,20.0,0.0
36761,3,6761,[318 427  98 191 182],655,5,27673,4.092428275658089,40.0,0.0
36762,3,6762,[210 234 183   4 186],450,1,27674,4.091971018778649,0.0,0.0
36763,3,6763,[568 174  98 603 127],450,5,27679,4.092105263157895,20.0,20.0
36764,3,6764,[204 313 318  22 588],450,5,27684,4.0922394678492235,20.0,0.0
36765,3,6765,[318 427  98 191 182],72,5,27689,4.092373632870234,40.0,0.0
36766,3,6766,[318  64   1 237 603],330,5,27694,4.0925077582385105,60.0,0.0
36767,3,6767,[318 427  98 191 182],269,5,27699,4.092641843971631,40.0,0.0
36768,3,6768,[318 427  98 191 182],269,5,27704,4.092775890087162,40.0,0.0
36769,3,6769,[546 172 118  50 742],796,4,27708,4.092762186115214,0.0,20.0
36770,3,6770,[176  70 427 174 234],655,1,27709,4.092305420174273,20.0,0.0
36771,3,6771,[111 238 132 151  96],450,5,27714,4.092439456585942,0.0,0.0
36772,3,6772,[318 427  98 191 182],18,5,27719,4.092573453417983,40.0,0.0
36773,3,6773,[318 427  98 191 182],450,5,27724,4.092707410687924,40.0,0.0
36774,3,6774,[245 318 322 323 237],224,1,27725,4.092250922509225,20.0,0.0
36775,3,6775,[210 405   9  50  82],280,1,27726,4.0917945690672965,0.0,20.0
36776,3,6776,[318 427  98 191 182],450,5,27731,4.091928581968423,40.0,0.0
36777,3,6777,[ 89  15 222  12  69],655,1,27732,4.091472410740631,0.0,0.0
36778,3,6778,[161 196 176  97 655],786,5,27737,4.091606431627084,0.0,0.0
36779,3,6779,[172 288  50 204 508],655,2,27739,4.091297935103245,0.0,20.0
36780,3,6780,[143 186 125  79 655],577,4,27743,4.091284471316915,0.0,0.0
36781,3,6781,[ 64 202   4 238 357],591,4,27747,4.091271011501032,20.0,0.0
36782,3,6782,[357 196  79  50 117],450,5,27752,4.09140498304585,0.0,20.0
36783,3,6783,[195 603 181  88   1],23,4,27756,4.091391509433962,20.0,0.0
36784,3,6784,[ 56 153  69  88   4],655,0,27756,4.090788504053058,0.0,0.0
36785,3,6785,[483 196  28 222 194],716,5,27761,4.090922487474212,0.0,0.0
36786,3,6786,[318 427  98 191 182],796,5,27766,4.091056431412995,40.0,0.0
36787,3,6787,[318 427  98 191 182],72,5,27771,4.091190335886859,40.0,0.0
36788,3,6788,[179 181 257 427 403],655,2,27773,4.0908823096185,20.0,0.0
36789,3,6789,[265 294   4 211 301],450,4,27777,4.090868924889543,0.0,0.0
36790,3,6790,[471 302 174 216 385],450,5,27782,4.091002797820645,0.0,0.0
36791,3,6791,[318 427  98 191 182],796,5,27787,4.091136631330977,40.0,0.0
36792,3,6792,[318 427  98 191 182],72,5,27792,4.091270425437951,40.0,0.0
36793,3,6793,[318 427  98 191 182],18,5,27797,4.091404180158964,40.0,0.0
36794,3,6794,[508 216  28 294 475],655,1,27798,4.090949227373068,0.0,0.0
36795,3,6795,[216 172  22 323 403],796,4,27802,4.090935844614479,0.0,0.0
36796,3,6796,[603  97 211 258 275],450,5,27807,4.09106958952479,20.0,20.0
36797,3,6797,[318 427  98 191 182],269,5,27812,4.09120329508679,40.0,0.0
36798,3,6798,[ 11 173 180   7 216],450,5,27817,4.0913369613178405,0.0,0.0
36799,3,6799,[187   9 483  88 144],655,2,27819,4.091029411764706,0.0,0.0
36800,3,6800,[318 427  98 191 182],796,5,27824,4.091163064255257,40.0,0.0
36801,3,6801,[318 427  98 191 182],18,5,27829,4.09129667744781,40.0,0.0
36802,3,6802,[ 89  50 496   7 100],786,5,27834,4.091430251359694,20.0,40.0
36803,3,6803,[678 132  88 238 282],504,3,27837,4.091269841269841,0.0,0.0
36804,3,6804,[318 427  98 191 182],18,5,27842,4.091403379867744,40.0,0.0
36805,3,6805,[471 191 215  22 301],450,5,27847,4.091536879224214,0.0,0.0
36806,3,6806,[318 427  98 191 182],18,5,27852,4.091670339356544,40.0,0.0
36807,3,6807,[132 111 748 151 196],151,4,27856,4.09165687426557,0.0,0.0
36808,3,6808,[318 427  98 191 182],655,5,27861,4.091790277573799,40.0,0.0
36809,3,6809,[318 427  98 191 182],18,5,27866,4.091923641703377,40.0,0.0
36810,3,6810,[ 97 423 153 172 100],593,5,27871,4.092056966671561,0.0,20.0
36811,3,6811,[161 276 194 257 546],457,3,27874,4.091896652965355,0.0,0.0
36812,3,6812,[318 427  98 191 182],269,5,27879,4.092029942756495,40.0,0.0
36813,3,6813,[ 97  25  96 200 185],504,5,27884,4.092163193425301,0.0,0.0
36814,3,6814,[258 135  89 275   4],655,3,27887,4.092002934702862,0.0,20.0
36815,3,6815,[318 427  98 191 182],655,5,27892,4.092136150234742,40.0,0.0
36816,3,6816,[202  50  11 655 191],450,5,27897,4.092269326683292,0.0,20.0
36817,3,6817,[187  11 238 204 197],629,4,27901,4.092255793487826,0.0,0.0
36818,3,6818,[195 194 483 748 202],151,3,27904,4.092095615192844,0.0,0.0
36819,3,6819,[318 427  98 191 182],72,5,27909,4.092228739002932,40.0,0.0
36820,3,6820,[100  82  98 288 185],457,5,27914,4.0923618237795045,0.0,20.0
36821,3,6821,[318 427  98 191 182],655,5,27919,4.092494869539724,40.0,0.0
36822,3,6822,[ 50 172 568 174 423],436,3,27922,4.092334750109923,0.0,20.0
36823,3,6823,[318 427  98 191 182],450,5,27927,4.092467760844079,40.0,0.0
36824,3,6824,[318 427  98 191 182],18,5,27932,4.092600732600733,40.0,0.0
36825,3,6825,[282  88 182 235   4],280,1,27933,4.092147670670964,0.0,0.0
36826,3,6826,[318 427  98 191 182],450,5,27938,4.09228065035887,40.0,0.0
36827,3,6827,[ 95 183  64 268 195],344,4,27942,4.092267135325132,20.0,0.0
36828,3,6828,[318 427  98 191 182],655,5,27947,4.0924000585737295,40.0,0.0
36829,3,6829,[ 98  79  88  64 100],389,4,27951,4.092386530014641,20.0,20.0
36830,3,6830,[318 427  98 191 182],269,5,27956,4.092519396867223,40.0,0.0
36831,3,6831,[318 427  98 191 182],72,5,27961,4.092652224824356,40.0,0.0
36832,3,6832,[427 210 187 125 286],655,2,27963,4.092345968096005,20.0,20.0
36833,3,6833,[318 427  98 191 182],450,5,27968,4.092478782557799,40.0,0.0
36834,3,6834,[176 276 125 245   4],280,1,27969,4.092026335040234,0.0,0.0
36835,3,6835,[318 427  98 191 182],18,5,27974,4.09215915740199,40.0,0.0
36836,3,6836,[318 427  98 191 182],450,5,27979,4.092291940909756,40.0,0.0
36837,3,6837,[215 176 121 196 423],11,2,27981,4.0919859608072535,0.0,0.0
36838,3,6838,[597 238 215 483 385],796,4,27985,4.091972510600965,0.0,0.0
36839,3,6839,[202 196 216 273 211],450,4,27989,4.091959064327486,0.0,0.0
36840,3,6840,[318 427  98 191 182],269,5,27994,4.092091799444526,40.0,0.0
36841,3,6841,[318 427  98 191 182],18,5,27999,4.0922244957614735,40.0,0.0
36842,3,6842,[ 50 301 282 234 245],450,4,28003,4.092211018559111,0.0,20.0
36843,3,6843,[ 12  82   9 403  28],796,2,28005,4.091905318527177,0.0,0.0
36844,3,6844,[546 405 748  79 180],796,4,28009,4.091891891891892,0.0,0.0
36845,3,6845,[318 427  98 191 182],655,5,28014,4.0920245398773005,40.0,0.0
36846,3,6846,[471 237 210 588 546],280,2,28016,4.091719001022345,0.0,0.0
36847,3,6847,[318 427  98 191 182],655,5,28021,4.091851635514018,40.0,0.0
36848,3,6848,[318 427  98 191 182],72,5,28026,4.091984231274639,40.0,0.0
36849,3,6849,[318 427  98 191 182],18,5,28031,4.092116788321168,40.0,0.0
36850,3,6850,[318 427  98 191 182],655,5,28036,4.092249306670559,40.0,0.0
36851,3,6851,[318 427  98 191 182],18,5,28041,4.092381786339755,40.0,0.0
36852,3,6852,[135  71 211 496 187],535,3,28044,4.092222384357216,20.0,0.0
36853,3,6853,[318 427  98 191 182],450,5,28049,4.092354829296761,40.0,0.0
36854,3,6854,[318 427  98 191 182],450,5,28054,4.092487235594457,40.0,0.0
36855,3,6855,[228  69 496 181  15],796,5,28059,4.092619603267211,20.0,0.0
36856,3,6856,[269 135 143 403  88],18,2,28061,4.09231442321715,0.0,0.0
36857,3,6857,[276 237 111  50  25],277,4,28065,4.092300962379703,0.0,20.0
36858,3,6858,[125 237 180 111  22],18,2,28067,4.0919959177722705,0.0,0.0
36859,3,6859,[318 427  98 191 182],269,5,28072,4.092128279883382,40.0,0.0
36860,3,6860,[318 427  98 191 182],450,5,28077,4.0922606034105815,40.0,0.0
36861,3,6861,[161 204  98  22  96],716,3,28080,4.092101428155057,0.0,0.0
36862,3,6862,[568 288  98 268 302],344,4,28084,4.092088008159697,0.0,0.0
36863,3,6863,[318 427  98 191 182],796,5,28089,4.09222027972028,40.0,0.0
36864,3,6864,[125 302 151 135 286],151,4,28093,4.092206846321923,0.0,20.0
36865,3,6865,[202 385 603 435 196],401,4,28097,4.092193416836586,20.0,0.0
36866,3,6866,[215 196 168 202 322],796,4,28101,4.09217999126256,0.0,0.0
36867,3,6867,[121  97 127 111 403],796,4,28105,4.092166569598136,0.0,20.0
36868,3,6868,[318 427  98 191 182],72,5,28110,4.092298733440093,40.0,0.0
36869,3,6869,[173 546 100 143 183],786,5,28115,4.092430858806405,0.0,20.0
36870,3,6870,[210 125 118 197 143],174,4,28119,4.092417406491049,0.0,0.0
36871,3,6871,[132 288  12 204 100],450,4,28123,4.092403958090803,0.0,20.0
36872,3,6872,[318 427  98 191 182],450,5,28128,4.092536010475775,40.0,0.0
36873,3,6873,[180 655 216 197 195],457,5,28133,4.092668024439918,0.0,0.0
36874,3,6874,[318 427  98 191 182],269,5,28138,4.0928,40.0,0.0
36875,3,6875,[318 427  98 191 182],655,5,28143,4.092931937172775,40.0,0.0
36876,3,6876,[318 427  98 191 182],655,5,28148,4.093063835974989,40.0,0.0
36877,3,6877,[318 427  98 191 182],18,5,28153,4.093195696423379,40.0,0.0
36878,3,6878,[318 427  98 191 182],655,5,28158,4.093327518534671,40.0,0.0
36879,3,6879,[237   7 588 597 258],344,2,28160,4.093023255813954,0.0,0.0
36880,3,6880,[318 427  98 191 182],655,5,28165,4.093155064670833,40.0,0.0
36881,3,6881,[385 483   9  96 144],796,4,28169,4.0931415286254,0.0,0.0
36882,3,6882,[318 427  98 191 182],655,5,28174,4.093273281999128,40.0,0.0
36883,3,6883,[210 228 748 195  79],256,4,28178,4.0932597327135385,0.0,0.0
36884,3,6884,[318 427  98 191 182],18,5,28183,4.093391430646332,40.0,0.0
36885,3,6885,[318 427  98 191 182],796,5,28188,4.093523090328202,40.0,0.0
36886,3,6886,[ 11 300 182 125 121],450,4,28192,4.093509510672281,0.0,0.0
36887,3,6887,[135  95 216 100 197],280,3,28195,4.093350754936121,0.0,20.0
36888,3,6888,[132 427 181 186 204],450,4,28199,4.093337204238641,20.0,0.0
36889,3,6889,[  7  56 294  25 275],450,4,28203,4.093323657474601,0.0,20.0
36890,3,6890,[210 191 180 185 288],457,5,28208,4.093455231461326,0.0,0.0
36891,3,6891,[568  71 603 173  22],756,1,28209,4.093006384213581,20.0,0.0
36892,3,6892,[318 427  98 191 182],655,5,28214,4.093137966052517,40.0,0.0
36893,3,6893,[282 276 257 318   1],457,4,28218,4.093124456048738,20.0,0.0
36894,3,6894,[161 273 385 182   1],796,3,28221,4.0929659173314,0.0,0.0
36895,3,6895,[655 118 742  71  12],280,3,28224,4.092807424593968,0.0,0.0
36896,3,6896,[318 427  98 191 182],18,5,28229,4.092938958967667,40.0,0.0
36897,3,6897,[322 216   9 294 403],256,4,28233,4.0929254856480135,0.0,0.0
36898,3,6898,[742 318 172 204 655],577,5,28238,4.093056964777504,20.0,0.0
36899,3,6899,[ 79 427 222 111 238],450,4,28242,4.09304347826087,20.0,0.0
36900,3,6900,[125 210 234 423 161],786,4,28246,4.093029995652804,0.0,0.0
36901,3,6901,[100 294  70 197 181],280,1,28247,4.092581860330339,0.0,20.0
36902,3,6902,[318 427  98 191 182],796,5,28252,4.092713313052296,40.0,0.0
36903,3,6903,[258  95  82 195 237],796,4,28256,4.092699884125145,0.0,0.0
36904,3,6904,[318 427  98 191 182],269,5,28261,4.092831281679942,40.0,0.0
36905,3,6905,[742 195 144 176 100],796,3,28264,4.092673037938025,0.0,20.0
36906,3,6906,[235 748 121 568 204],450,3,28267,4.092514840017373,0.0,0.0
36907,3,6907,[282 597 117 187 257],796,5,28272,4.092646207295889,0.0,0.0
36908,3,6908,[ 12 204 276 275 435],18,4,28276,4.092632797799971,0.0,20.0
36909,3,6909,[216 269  69 211 181],655,1,28277,4.092185238784371,0.0,0.0
36910,3,6910,[318 427  98 191 182],72,5,28282,4.092316596729851,40.0,0.0
36911,3,6911,[603 179 301 427 197],389,5,28287,4.092447916666667,40.0,0.0
36912,3,6912,[318 427  98 191 182],655,5,28292,4.092579198611312,40.0,0.0
36913,3,6913,[318 427  98 191 182],18,5,28297,4.092710442580272,40.0,0.0
36914,3,6914,[318 427  98 191 182],655,5,28302,4.092841648590022,40.0,0.0
36915,3,6915,[222 185  98 211 318],151,5,28307,4.092972816657027,20.0,0.0
36916,3,6916,[143 318 153   9  64],18,5,28312,4.093103946797744,40.0,0.0
36917,3,6917,[318 427  98 191 182],796,5,28317,4.093235039028621,40.0,0.0
36918,3,6918,[603 357 151 183 173],716,4,28321,4.0932215638097995,20.0,0.0
36919,3,6919,[318 427  98 191 182],796,5,28326,4.093352601156069,40.0,0.0
36920,3,6920,[222 237  79 515 655],72,3,28329,4.093194625054183,0.0,0.0
36921,3,6921,[186  70   7  82 117],655,0,28329,4.092603293845709,0.0,0.0
36922,3,6922,[174 176 471 118  89],655,1,28330,4.0921565795175505,0.0,0.0
36923,3,6923,[ 96 427 135 238 187],655,3,28333,4.091998844598498,20.0,0.0
36924,3,6924,[318 427  98 191 182],655,5,28338,4.092129963898917,40.0,0.0
36925,3,6925,[ 96 258 161 185  82],796,4,28342,4.092116661853884,0.0,0.0
36926,3,6926,[318 427  98 191 182],450,5,28347,4.092247726288437,40.0,0.0
36927,3,6927,[143   1 286   7   9],151,5,28352,4.092378752886836,0.0,20.0
36928,3,6928,[117 176 161  98   8],280,4,28356,4.092365420695627,0.0,0.0
36929,3,6929,[186 182 161 132 194],389,3,28359,4.092207792207792,0.0,0.0
36930,3,6930,[196 186   7 385  97],457,5,28364,4.092338767854566,0.0,0.0
36931,3,6931,[318 427  98 191 182],450,5,28369,4.092469705712637,40.0,0.0
36932,3,6932,[318 427  98 191 182],655,5,28374,4.0926006057983555,40.0,0.0
36933,3,6933,[483 121 100 546   9],796,3,28377,4.092443034323622,0.0,20.0
36934,3,6934,[ 12 174 228   1 183],655,1,28378,4.091997116077866,0.0,0.0
36935,3,6935,[318 427  98 191 182],18,5,28383,4.092128027681661,40.0,0.0
36936,3,6936,[318 427  98 191 182],655,5,28388,4.092258901542453,40.0,0.0
36937,3,6937,[318 427  98 191 182],72,5,28393,4.092389737676564,40.0,0.0
36938,3,6938,[318 427  98 191 182],450,5,28398,4.092520536100302,40.0,0.0
36939,3,6939,[318 427  98 191 182],655,5,28403,4.092651296829971,40.0,0.0
36940,3,6940,[318 427  98 191 182],269,5,28408,4.092782019881861,40.0,0.0
36941,3,6941,[318 427  98 191 182],655,5,28413,4.092912705272256,40.0,0.0
36942,3,6942,[176 568 328 238 403],450,5,28418,4.0930433530174275,0.0,0.0
36943,3,6943,[318 427  98 191 182],450,5,28423,4.093173963133641,40.0,0.0
36944,3,6944,[318 427  98 191 182],450,5,28428,4.093304535637149,40.0,0.0
36945,3,6945,[318 427  98 191 182],72,5,28433,4.093435070544198,40.0,0.0
36946,3,6946,[318 427  98 191 182],72,5,28438,4.093565567871024,40.0,0.0
36947,3,6947,[385  96  70 173 269],344,3,28441,4.0934081750143925,0.0,0.0
36948,3,6948,[318 427  98 191 182],796,5,28446,4.093538638653044,40.0,0.0
36949,3,6949,[  4 588 174  71 294],450,3,28449,4.093381294964029,0.0,0.0
36950,3,6950,[ 64 483 423 273  56],450,3,28452,4.093223996547259,20.0,0.0
36951,3,6951,[318 427  98 191 182],655,5,28457,4.093354430379747,40.0,0.0
36952,3,6952,[318 427  98 191 182],655,5,28462,4.093484826693514,40.0,0.0
36953,3,6953,[405 182 132  71 423],280,3,28465,4.093327581248203,0.0,0.0
36954,3,6954,[ 97 275  70  69 288],344,2,28467,4.093026599568655,0.0,20.0
36955,3,6955,[153 385 568 196 271],796,5,28472,4.093156986774008,0.0,0.0
36956,3,6956,[318 427  98 191 182],796,5,28477,4.0932873364956155,40.0,0.0
36957,3,6957,[318 427  98 191 182],796,5,28482,4.09341764874964,40.0,0.0
36958,3,6958,[258 237 185 125 655],796,4,28486,4.093404224744934,0.0,0.0
36959,3,6959,[603  69  12 568 187],72,5,28491,4.093534482758621,20.0,0.0
36960,3,6960,[257 265   9  97 191],655,1,28492,4.093090073265335,0.0,0.0
36961,3,6961,[318 427  98 191 182],18,5,28497,4.093220338983051,40.0,0.0
36962,3,6962,[748 238 282 269  69],796,3,28500,4.093063334769496,0.0,0.0
36963,3,6963,[318 427  98 191 182],18,5,28505,4.0931935669155655,40.0,0.0
36964,3,6964,[187 742  12  71   8],796,4,28509,4.0931801866475235,0.0,0.0
36965,3,6965,[111 195 175 237   7],655,0,28509,4.092592592592593,0.0,0.0
36966,3,6966,[194  96 204  82 151],577,5,28514,4.0927228362279315,0.0,0.0
36967,3,6967,[294 185 200 151   1],716,5,28519,4.092853042479908,0.0,0.0
36968,3,6968,[323 301 211 118 234],796,1,28520,4.092409240924092,0.0,0.0
36969,3,6969,[318 427  98 191 182],72,5,28525,4.092539454806313,40.0,0.0
36970,3,6970,[318 427  98 191 182],655,5,28530,4.0926696313297946,40.0,0.0
36971,3,6971,[318 427  98 191 182],72,5,28535,4.092799770510614,40.0,0.0
36972,3,6972,[318  69 234 403  25],577,4,28539,4.092786462067976,20.0,0.0
36973,3,6973,[143 216 294 180  88],796,3,28542,4.092629767708632,0.0,0.0
36974,3,6974,[282 191 202 234  12],655,1,28543,4.092186379928315,0.0,0.0
36975,3,6975,[318 427  98 191 182],72,5,28548,4.092316513761468,40.0,0.0
36976,3,6976,[318 427  98 191 182],655,5,28553,4.092446610290956,40.0,0.0
36977,3,6977,[318 427  98 191 182],796,5,28558,4.092576669532818,40.0,0.0
36978,3,6978,[318 427  98 191 182],269,5,28563,4.09270669150308,40.0,0.0
36979,3,6979,[318 427  98 191 182],72,5,28568,4.0928366762177655,40.0,0.0
36980,3,6980,[238 174 161   1  70],786,5,28573,4.092966623692881,0.0,0.0
36981,3,6981,[318 427  98 191 182],450,5,28578,4.093096533944428,40.0,0.0
36982,3,6982,[ 82 121  70 471  69],457,5,28583,4.093226406988401,0.0,0.0
36983,3,6983,[235 168 111  79 210],450,3,28586,4.093069873997709,0.0,0.0
36984,3,6984,[405  28 204 403 143],796,4,28590,4.0930565497494635,0.0,0.0
36985,3,6985,[318 427  98 191 182],796,5,28595,4.093186372745491,40.0,0.0
36986,3,6986,[588 403 210 483 238],450,3,28598,4.093029912695005,0.0,0.0
36987,3,6987,[322  25 211 328  70],151,3,28601,4.092873497424156,0.0,0.0
36988,3,6988,[318 427  98 191 182],18,5,28606,4.093003290885678,40.0,0.0
36989,3,6989,[318 427  98 191 182],18,5,28611,4.0931330472103005,40.0,0.0
36990,3,6990,[ 79 132 202 222  82],798,3,28614,4.092976684308397,0.0,0.0
36991,3,6991,[603 210  28 185 187],655,3,28617,4.092820366132723,20.0,0.0
36992,3,6992,[196 234 302 288 301],450,3,28620,4.0926640926640925,0.0,0.0
36993,3,6993,[318 427  98 191 182],796,5,28625,4.092793823277095,40.0,0.0
36994,3,6994,[174 132  98 118 135],280,3,28628,4.092637598284489,0.0,0.0
36995,3,6995,[191 405 183 194   1],577,4,28632,4.0926243567753,0.0,0.0
36996,3,6996,[471  79 196  11 100],535,4,28636,4.092611119051022,0.0,20.0
36997,3,6997,[181 323 151  82 204],23,1,28637,4.092169191197485,0.0,0.0
36998,3,6998,[318 427  98 191 182],72,5,28642,4.0922988998428345,40.0,0.0
36999,3,6999,[ 69  82 143 200  98],655,3,28645,4.092142857142857,0.0,0.0
37000,3,7000,[195  12  89 357  98],151,4,28649,4.092129695757749,0.0,0.0
37001,3,7001,[238  98  82 385  88],450,4,28653,4.092116538131962,0.0,0.0
37002,3,7002,[176 117 121 318 423],716,4,28657,4.092103384263887,20.0,0.0
37003,3,7003,[318 427  98 191 182],18,5,28662,4.092233009708738,40.0,0.0
37004,3,7004,[318 427  98 191 182],269,5,28667,4.092362598144183,40.0,0.0
37005,3,7005,[318 427  98 191 182],655,5,28672,4.092492149586069,40.0,0.0
37006,3,7006,[ 28  97 237 125   4],577,5,28677,4.0926216640502355,0.0,0.0
37007,3,7007,[318 427  98 191 182],18,5,28682,4.092751141552512,40.0,0.0
37008,3,7008,[313 258 294 153 215],796,4,28686,4.092737908403481,0.0,0.0
37009,3,7009,[405 655 357  70 301],655,1,28687,4.092296718972896,0.0,0.0
37010,3,7010,[127 603 546 200 183],450,4,28691,4.092283554414491,20.0,20.0
37011,3,7011,[153 172  12 588 173],796,5,28696,4.092413006274957,0.0,0.0
37012,3,7012,[ 95 237  82 471 603],716,4,28700,4.092399828889206,20.0,0.0
37013,3,7013,[195 294 427 117 191],655,2,28702,4.092101511263188,20.0,0.0
37014,3,7014,[318 427  98 191 182],450,5,28707,4.092230933713471,40.0,0.0
37015,3,7015,[318 427  98 191 182],269,5,28712,4.09236031927024,40.0,0.0
37016,3,7016,[318 427  98 191 182],269,5,28717,4.092489667949266,40.0,0.0
37017,3,7017,[318 427  98 191 182],796,5,28722,4.092618979766315,40.0,0.0
37018,3,7018,[318 427  98 191 182],450,5,28727,4.092748254737142,40.0,0.0
37019,3,7019,[121 180  50 117  69],457,5,28732,4.092877492877493,0.0,20.0
37020,3,7020,[100 175  70 144 228],655,0,28732,4.092294544936618,0.0,20.0
37021,3,7021,[318 427  98 191 182],655,5,28737,4.092423810880091,40.0,0.0
37022,3,7022,[655   7  89 118 100],450,4,28741,4.092410650719066,0.0,20.0
37023,3,7023,[318 427  98 191 182],796,5,28746,4.09253986332574,40.0,0.0
37024,3,7024,[318 427  98 191 182],72,5,28751,4.092669039145908,40.0,0.0
37025,3,7025,[318 427  98 191 182],655,5,28756,4.092798178195275,40.0,0.0
37026,3,7026,[318 427  98 191 182],450,5,28761,4.0929272804895405,40.0,0.0
37027,3,7027,[318 427  98 191 182],269,5,28766,4.093056346044394,40.0,0.0
37028,3,7028,[ 12  95 180  97  28],796,2,28768,4.092758571631811,0.0,0.0
37029,3,7029,[318 427  98 191 182],655,5,28773,4.092887624466572,40.0,0.0
37030,3,7030,[161  98 588 269 403],450,5,28778,4.0930166405916655,0.0,0.0
37031,3,7031,[318 427  98 191 182],655,5,28783,4.093145620022753,40.0,0.0
37032,3,7032,[117 168   1 603 471],401,2,28785,4.092848002274989,20.0,0.0
37033,3,7033,[318 427  98 191 182],450,5,28790,4.092976969007677,40.0,0.0
37034,3,7034,[318 427  98 191 182],655,5,28795,4.093105899076049,40.0,0.0
37035,3,7035,[318 427  98 191 182],18,5,28800,4.093234792495736,40.0,0.0
37036,3,7036,[318 427  98 191 182],450,5,28805,4.093363649282365,40.0,0.0
37037,3,7037,[ 95 111 172 200 748],280,3,28808,4.093208297811878,0.0,0.0
37038,3,7038,[318 427  98 191 182],796,5,28813,4.093337121750249,40.0,0.0
37039,3,7039,[423   4 257 271 127],655,1,28814,4.092897727272727,0.0,20.0
37040,3,7040,[318 427  98 191 182],269,5,28819,4.093026558727454,40.0,0.0
37041,3,7041,[546 405 655 245  11],280,2,28821,4.092729338256177,0.0,0.0
37042,3,7042,[195  22 288 216  25],457,5,28826,4.092858157035354,0.0,0.0
37043,3,7043,[174 427 196 258 215],450,5,28831,4.0929869392390685,20.0,0.0
37044,3,7044,[318 427  98 191 182],796,5,28836,4.093115684882895,40.0,0.0
37045,3,7045,[475 143 471 216 144],655,2,28838,4.092818620493897,0.0,0.0
37046,3,7046,[603  98 427 172 186],655,4,28842,4.0928054491272885,40.0,0.0
37047,3,7047,[245 195 300 204 238],629,4,28846,4.092792281498298,0.0,0.0
37048,3,7048,[195 215 483  97   7],151,3,28849,4.092637253511136,0.0,0.0
37049,3,7049,[318 427  98 191 182],72,5,28854,4.092765957446809,40.0,0.0
37050,3,7050,[282  79 135 318 546],450,4,28858,4.092752801021132,20.0,0.0
37051,3,7051,[318 427  98 191 182],450,5,28863,4.092881452070334,40.0,0.0
37052,3,7052,[588  82 245  98 385],796,3,28866,4.092726499361974,0.0,0.0
37053,3,7053,[588 132 127  95 288],450,3,28869,4.092571590586901,0.0,20.0
37054,3,7054,[748 173  11 273 423],450,4,28873,4.092558469170801,0.0,0.0
37055,3,7055,[228 237 195  64 144],716,3,28876,4.092403628117914,20.0,0.0
37056,3,7056,[318 427  98 191 182],72,5,28881,4.092532237494686,40.0,0.0
37057,3,7057,[318 427  98 191 182],18,5,28886,4.092660810427883,40.0,0.0
37058,3,7058,[234  50  69  89 222],72,2,28888,4.092364357557727,0.0,20.0
37059,3,7059,[318 427  98 191 182],655,5,28893,4.092492917847025,40.0,0.0
37060,3,7060,[  4   1 385 237 318],457,5,28898,4.092621441722136,20.0,0.0
37061,3,7061,[318 427  98 191 182],655,5,28903,4.092749929198527,40.0,0.0
37062,3,7062,[318 427  98 191 182],18,5,28908,4.092878380291661,40.0,0.0
37063,3,7063,[318 427  98 191 182],655,5,28913,4.093006795016987,40.0,0.0
37064,3,7064,[ 12 196 588   7 181],344,4,28917,4.092993630573249,0.0,0.0
37065,3,7065,[180 135 181 185  70],457,5,28922,4.093121992640815,0.0,0.0
37066,3,7066,[318 427  98 191 182],269,5,28927,4.093250318381209,40.0,0.0
37067,3,7067,[748   7  96 357 125],450,5,28932,4.093378607809847,0.0,0.0
37068,3,7068,[318 427  98 191 182],269,5,28937,4.093506860942142,40.0,0.0
37069,3,7069,[318 427  98 191 182],655,5,28942,4.093635077793493,40.0,0.0
37070,3,7070,[118  98 179 202 117],655,2,28944,4.093338990241833,0.0,0.0
37071,3,7071,[318 427  98 191 182],796,5,28949,4.0934671945701355,40.0,0.0
37072,3,7072,[318 427  98 191 182],18,5,28954,4.093595362646685,40.0,0.0
37073,3,7073,[483 183 151 174 143],796,5,28959,4.093723494486853,0.0,0.0
37074,3,7074,[222 245 588  82  98],450,3,28962,4.093568904593639,0.0,0.0
37075,3,7075,[234 742 405 568 117],593,3,28965,4.093414358394573,0.0,0.0
37076,3,7076,[318 427  98 191 182],796,5,28970,4.093542461494984,40.0,0.0
37077,3,7077,[318 427  98 191 182],796,5,28975,4.093670528397852,40.0,0.0
37078,3,7078,[597 222  88 215  82],23,1,28976,4.0932335075575645,0.0,0.0
37079,3,7079,[318 427  98 191 182],18,5,28981,4.093361581920904,40.0,0.0
37080,3,7080,[318 427  98 191 182],450,5,28986,4.093489620110154,40.0,0.0
37081,3,7081,[234 111 294  82 568],716,5,28991,4.093617622140639,0.0,0.0
37082,3,7082,[318 427  98 191 182],655,5,28996,4.093745588027672,40.0,0.0
37083,3,7083,[427 144 294 385 125],796,4,29000,4.0937323546019195,20.0,0.0
37084,3,7084,[318 427  98 191 182],655,5,29005,4.093860268172195,40.0,0.0
37085,3,7085,[508 748 678 210 204],280,0,29005,4.093282528930285,0.0,0.0
37086,3,7086,[318 427  98 191 182],72,5,29010,4.093410469874418,40.0,0.0
37087,3,7087,[318 427  98 191 182],269,5,29015,4.093538374717833,40.0,0.0
37088,3,7088,[273 118 194 195 275],796,4,29019,4.093525179856115,0.0,20.0
37089,3,7089,[318 427  98 191 182],269,5,29024,4.093653032440057,40.0,0.0
37090,3,7090,[323 568 282  50 322],256,4,29028,4.093639825130447,0.0,20.0
37091,3,7091,[318 427  98 191 182],655,5,29033,4.093767625493514,40.0,0.0
37092,3,7092,[ 22  50 187  95 294],796,4,29037,4.09375440575215,0.0,20.0
37093,3,7093,[176 117 194 181  70],716,4,29041,4.093741189737806,0.0,0.0
37094,3,7094,[  8 100 294 204 471],457,4,29045,4.093727977448908,0.0,20.0
37095,3,7095,[180 111 322 132 333],796,3,29048,4.093573844419391,0.0,0.0
37096,3,7096,[313 117 294 144 200],655,2,29050,4.093278850218402,0.0,0.0
37097,3,7097,[318 427  98 191 182],72,5,29055,4.093406593406593,40.0,0.0
37098,3,7098,[ 97  25  15 175 234],457,5,29060,4.093534300605719,0.0,0.0
37099,3,7099,[111   1  98 385 100],655,1,29061,4.093098591549296,0.0,20.0
37100,3,7100,[318 427  98 191 182],450,5,29066,4.093226306154063,40.0,0.0
37101,3,7101,[318 427  98 191 182],72,5,29071,4.0933539847930165,40.0,0.0
37102,3,7102,[269 655 286 245  11],450,5,29076,4.093481627481346,0.0,20.0
37103,3,7103,[318 427  98 191 182],796,5,29081,4.0936092342342345,40.0,0.0
37104,3,7104,[318 427  98 191 182],796,5,29086,4.093736805066854,40.0,0.0
37105,3,7105,[318 427  98 191 182],18,5,29091,4.093864339994371,40.0,0.0
37106,3,7106,[237 202 185 275 282],716,4,29095,4.093851132686084,0.0,20.0
37107,3,7107,[197 174 118  69  82],655,0,29095,4.093275182892516,0.0,0.0
37108,3,7108,[318 427  98 191 182],796,5,29100,4.0934027289351524,40.0,0.0
37109,3,7109,[475 289 273   8 121],655,1,29101,4.092967651195499,0.0,0.0
37110,3,7110,[435   4 100 289 471],655,0,29101,4.092392068626072,0.0,20.0
37111,3,7111,[ 98 435 385  70 228],716,4,29105,4.092379077615298,0.0,0.0
37112,3,7112,[323 204 143 210 144],796,3,29108,4.092225502600872,0.0,0.0
37113,3,7113,[318 427  98 191 182],655,5,29113,4.092353106550464,40.0,0.0
37114,3,7114,[127 175 357 294  25],655,2,29115,4.0920590302178494,0.0,20.0
37115,3,7115,[ 96 204 568 172  79],280,2,29117,4.091765036537381,0.0,0.0
37116,3,7116,[385 191 215 179 194],577,4,29121,4.091752142756779,0.0,0.0
37117,3,7117,[ 95 323 385  56 183],280,3,29124,4.091598763697668,0.0,0.0
37118,3,7118,[318 427  98 191 182],72,5,29129,4.091726366062649,40.0,0.0
37119,3,7119,[ 88  50 181 180  12],18,3,29132,4.091573033707865,0.0,20.0
37120,3,7120,[117 196 172 294 748],401,1,29133,4.091138884988063,0.0,0.0
37121,3,7121,[135 318 265 215   1],450,4,29137,4.091126088177478,20.0,0.0
37122,3,7122,[176 121 194  28 168],577,5,29142,4.091253685244981,0.0,0.0
37123,3,7123,[269 151 385   1   8],344,3,29145,4.091100505334082,0.0,0.0
37124,3,7124,[ 70 161   8 111 742],280,5,29150,4.091228070175439,0.0,0.0
37125,3,7125,[ 70 301 282 427 179],450,5,29155,4.091355599214145,20.0,0.0
37126,3,7126,[182 328 234 117 121],655,1,29156,4.090921846499228,0.0,0.0
37127,3,7127,[318 427  98 191 182],796,5,29161,4.091049382716049,40.0,0.0
37128,3,7128,[318 427  98 191 182],655,5,29166,4.0911768831533175,40.0,0.0
37129,3,7129,[318 427  98 191 182],655,5,29171,4.091304347826087,40.0,0.0
37130,3,7130,[ 11 435  71 127 655],450,4,29175,4.091291543962979,0.0,20.0
37131,3,7131,[176 258 121 546   9],151,3,29178,4.091138530566461,0.0,0.0
37132,3,7132,[196 357  79 118 200],457,5,29183,4.091265947006869,0.0,0.0
37133,3,7133,[204 742  12 176 322],344,3,29186,4.0911129800953185,0.0,0.0
37134,3,7134,[318 427  98 191 182],18,5,29191,4.091240364400841,40.0,0.0
37135,3,7135,[597 196 121 328 301],450,4,29195,4.091227578475336,0.0,0.0
37136,3,7136,[121 568 172 275  96],450,4,29199,4.091214796132829,0.0,20.0
37137,3,7137,[180 276   9 289 197],786,3,29202,4.091061922107032,0.0,0.0
37138,3,7138,[318 427  98 191 182],796,5,29207,4.091189242190783,40.0,0.0
37139,3,7139,[196 197 181 423   1],786,4,29211,4.091176470588235,0.0,0.0
37140,3,7140,[318 427  98 191 182],796,5,29216,4.091303738972133,40.0,0.0
37141,3,7141,[ 25  96 191 257 405],655,1,29217,4.090870904508541,0.0,0.0
37142,3,7142,[318 427  98 191 182],450,5,29222,4.090998180036399,40.0,0.0
37143,3,7143,[318 427  98 191 182],655,5,29227,4.091125419932811,40.0,0.0
37144,3,7144,[144  79 265 183 588],796,5,29232,4.0912526242127365,0.0,0.0
37145,3,7145,[ 56 496  50 194 135],389,4,29236,4.091239854464036,20.0,20.0
37146,3,7146,[318 427  98 191 182],450,5,29241,4.091367007135861,40.0,0.0
37147,3,7147,[258  22 427 194 568],450,5,29246,4.091494124230554,20.0,0.0
37148,3,7148,[318 427  98 191 182],269,5,29251,4.091621205763044,40.0,0.0
37149,3,7149,[161 222 176 174 175],23,3,29254,4.091468531468531,0.0,0.0
37150,3,7150,[  8 238 275 508 294],655,1,29255,4.09103621871067,0.0,20.0
37151,3,7151,[175 127  56 275 286],655,2,29257,4.0907438478747205,0.0,60.0
37152,3,7152,[318 427  98 191 182],450,5,29262,4.09087096323221,40.0,0.0
37153,3,7153,[ 79 508 144 275  96],296,5,29267,4.090998043052838,0.0,20.0
37154,3,7154,[318 427  98 191 182],18,5,29272,4.091125087351503,40.0,0.0
37155,3,7155,[  8   4 275 200 403],457,5,29277,4.091252096143097,0.0,20.0
37156,3,7156,[ 95  82 322 288 118],280,3,29280,4.091099622746961,0.0,0.0
37157,3,7157,[200 288 143 269  95],450,2,29282,4.090807488125175,0.0,0.0
37158,3,7158,[ 11 282 196 195 127],716,3,29285,4.090655119430088,0.0,20.0
37159,3,7159,[216 144 238 200 186],450,3,29288,4.090502793296089,0.0,0.0
37160,3,7160,[276  71 294 153 282],280,3,29291,4.090350509705348,0.0,0.0
37161,3,7161,[318 427  98 191 182],18,5,29296,4.0904775202457415,40.0,0.0
37162,3,7162,[ 64 496 181 210 322],796,3,29299,4.0903252827027785,40.0,0.0
37163,3,7163,[597  15 508  22  98],269,2,29301,4.090033500837521,0.0,0.0
37164,3,7164,[318 427  98 191 182],269,5,29306,4.090160502442428,40.0,0.0
37165,3,7165,[318 427  98 191 182],655,5,29311,4.090287468601731,40.0,0.0
37166,3,7166,[318 427  98 191 182],655,5,29316,4.090414399330264,40.0,0.0
37167,3,7167,[  1 423 322 176 210],280,3,29319,4.090262276785714,0.0,0.0
37168,3,7168,[318 427  98 191 182],18,5,29324,4.090389175617241,40.0,0.0
37169,3,7169,[173 125 210 322 187],450,4,29328,4.090376569037657,0.0,0.0
37170,3,7170,[318 427  98 191 182],269,5,29333,4.090503416538837,40.0,0.0
37171,3,7171,[318 427  98 191 182],72,5,29338,4.090630228667038,40.0,0.0
37172,3,7172,[202  97 143 168  25],330,4,29342,4.090617593754357,0.0,0.0
37173,3,7173,[257  97 185 197   9],796,2,29344,4.090326177864511,0.0,0.0
37174,3,7174,[216 144 121 135 168],716,3,29347,4.090174216027875,0.0,0.0
37175,3,7175,[318 427  98 191 182],18,5,29352,4.090301003344481,40.0,0.0
37176,3,7176,[234  56 423 328 172],629,4,29356,4.090288421345966,0.0,0.0
37177,3,7177,[216 234   7 237 210],256,5,29361,4.090415157425467,0.0,0.0
37178,3,7178,[318 427  98 191 182],269,5,29366,4.09054185819752,40.0,0.0
37179,3,7179,[318 427  98 191 182],269,5,29371,4.0906685236768805,40.0,0.0
37180,3,7180,[318 427  98 191 182],796,5,29376,4.09079515387829,40.0,0.0
37181,3,7181,[318 427  98 191 182],18,5,29381,4.090921748816486,40.0,0.0
37182,3,7182,[318 427  98 191 182],269,5,29386,4.0910483085061955,40.0,0.0
37183,3,7183,[ 88 118 153 294  98],716,4,29390,4.091035634743875,0.0,0.0
37184,3,7184,[318 427  98 191 182],72,5,29395,4.09116214335421,40.0,0.0
37185,3,7185,[100  95 117  71  98],786,5,29400,4.091288616754801,0.0,20.0
37186,3,7186,[357 597  50 748 111],796,5,29405,4.091415054960345,0.0,20.0
37187,3,7187,[ 70 238 202 265 132],786,5,29410,4.091541457985532,0.0,0.0
37188,3,7188,[318 427  98 191 182],796,5,29415,4.091667825845041,40.0,0.0
37189,3,7189,[275 313 328 179 435],450,5,29420,4.0917941585535464,0.0,20.0
37190,3,7190,[143 185 161   1 144],457,5,29425,4.091920456125712,0.0,0.0
37191,3,7191,[238 175 546  79 228],457,4,29429,4.091907675194661,0.0,0.0
37192,3,7192,[318 427  98 191 182],72,5,29434,4.092033921868484,40.0,0.0
37193,3,7193,[271 483   1 161 195],655,1,29435,4.091604114539894,0.0,0.0
37194,3,7194,[118 194 403 655 173],457,5,29440,4.091730368311327,0.0,0.0
37195,3,7195,[318 427  98 191 182],655,5,29445,4.091856586992773,40.0,0.0
37196,3,7196,[318 427  98 191 182],72,5,29450,4.091982770598861,40.0,0.0
37197,3,7197,[568 194 333 210 257],796,4,29454,4.091969991664351,0.0,0.0
37198,3,7198,[181 216 357  79  50],344,4,29458,4.091957216280039,0.0,20.0
37199,3,7199,[318 427  98 191 182],18,5,29463,4.092083333333333,40.0,0.0
37200,3,7200,[ 89  50 125 405 748],796,5,29468,4.092209415358978,0.0,20.0
37201,3,7201,[568  69 385 471 182],280,2,29470,4.091918911413496,0.0,0.0
37202,3,7202,[172 385 215 211 597],23,3,29473,4.091767319172567,0.0,0.0
37203,3,7203,[144 143 191  64 216],693,3,29476,4.091615769017213,20.0,0.0
37204,3,7204,[301 176  82 151 197],389,5,29481,4.091741845940319,0.0,0.0
37205,3,7205,[318 427  98 191 182],655,5,29486,4.091867887871218,40.0,0.0
37206,3,7206,[318 427  98 191 182],655,5,29491,4.091993894824476,40.0,0.0
37207,3,7207,[181 182 568 588 301],796,4,29495,4.091981132075472,0.0,0.0
37208,3,7208,[318 427  98 191 182],450,5,29500,4.09210708836177,40.0,0.0
37209,3,7209,[222 118 196 197 257],457,4,29504,4.092094313453536,0.0,0.0
37210,3,7210,[318 427  98 191 182],18,5,29509,4.092220219109693,40.0,0.0
37211,3,7211,[318 427  98 191 182],655,5,29514,4.09234608985025,40.0,0.0
37212,3,7212,[237 182 216 568 228],796,5,29519,4.092471925689727,0.0,0.0
37213,3,7213,[318 427  98 191 182],18,5,29524,4.092597726642639,40.0,0.0
37214,3,7214,[655 222 153 385 245],450,4,29528,4.092584892584893,0.0,0.0
37215,3,7215,[496 282  70 597   9],593,3,29531,4.092433481152994,20.0,0.0
37216,3,7216,[588  22 127 174 235],280,4,29535,4.092420673410004,0.0,20.0
37217,3,7217,[655 234 271 546  56],796,3,29538,4.092269326683292,0.0,0.0
37218,3,7218,[318 427  98 191 182],796,5,29543,4.092395068569054,40.0,0.0
37219,3,7219,[318 427  98 191 182],72,5,29548,4.092520775623269,40.0,0.0
37220,3,7220,[318 427  98 191 182],72,5,29553,4.092646447860407,40.0,0.0
37221,3,7221,[127  50  96 273 174],655,3,29556,4.092495153697037,0.0,40.0
37222,3,7222,[318 427  98 191 182],450,5,29561,4.09262079468365,40.0,0.0
37223,3,7223,[318 427  98 191 182],796,5,29566,4.092746400885936,40.0,0.0
37224,3,7224,[318 427  98 191 182],269,5,29571,4.092871972318339,40.0,0.0
37225,3,7225,[318 427  98 191 182],450,5,29576,4.092997508995294,40.0,0.0
37226,3,7226,[ 82 182   7 216 176],352,3,29579,4.0928462709284625,0.0,0.0
37227,3,7227,[143 471  98 191 118],450,4,29583,4.092833425567239,0.0,0.0
37228,3,7228,[318 427  98 191 182],72,5,29588,4.092958915479319,40.0,0.0
37229,3,7229,[318 427  98 191 182],269,5,29593,4.093084370677731,40.0,0.0
37230,3,7230,[200 245 132  25 179],450,3,29596,4.092933204259438,0.0,0.0
37231,3,7231,[ 50 125 222 121   8],655,1,29597,4.092505530973451,0.0,20.0
37232,3,7232,[211 405 385 100 196],655,0,29597,4.091939720724457,0.0,20.0
37233,3,7233,[357 257  96  28 117],716,4,29601,4.091927011335361,0.0,0.0
37234,3,7234,[ 50 403 515 508 276],269,3,29604,4.0917760884588805,0.0,20.0
37235,3,7235,[318 427  98 191 182],450,5,29609,4.091901603095633,40.0,0.0
37236,3,7236,[289 294 211 183 286],655,1,29610,4.0914743678319745,0.0,20.0
37237,3,7237,[275 118 127 176 204],716,3,29613,4.091323570046974,0.0,40.0
37238,3,7238,[194 257 276 200  22],457,4,29617,4.091310954551734,0.0,0.0
37239,3,7239,[318 427  98 191 182],450,5,29622,4.091436464088398,40.0,0.0
37240,3,7240,[318 427  98 191 182],18,5,29627,4.091561938958708,40.0,0.0
37241,3,7241,[ 56  70 186 125 238],450,4,29631,4.091549295774648,0.0,0.0
37242,3,7242,[318 427  98 191 182],450,5,29636,4.091674720419715,40.0,0.0
37243,3,7243,[313 742 194 191  70],450,5,29641,4.091800110436223,0.0,0.0
37244,3,7244,[318 427  98 191 182],18,5,29646,4.091925465838509,40.0,0.0
37245,3,7245,[245 202 265 546  12],256,4,29650,4.091912779464532,0.0,0.0
37246,3,7246,[204 496 117  98 282],280,3,29653,4.091762108458672,20.0,0.0
37247,3,7247,[318 427  98 191 182],796,5,29658,4.091887417218543,40.0,0.0
37248,3,7248,[179  89 187 258 483],296,5,29663,4.092012691405711,0.0,0.0
37249,3,7249,[318 427  98 191 182],655,5,29668,4.0921379310344825,40.0,0.0
37250,3,7250,[318 427  98 191 182],796,5,29673,4.092263136119156,40.0,0.0
37251,3,7251,[318 427  98 191 182],72,5,29678,4.092388306674021,40.0,0.0
37252,3,7252,[318 427  98 191 182],655,5,29683,4.09251344271336,40.0,0.0
37253,3,7253,[ 97 302 313 200 286],707,3,29686,4.092362834298318,0.0,20.0
37254,3,7254,[318 427  98 191 182],450,5,29691,4.0924879393521705,40.0,0.0
37255,3,7255,[ 15 176  96 197  11],655,0,29691,4.091923925027563,0.0,0.0
37256,3,7256,[318 427  98 191 182],655,5,29696,4.0920490560837814,40.0,0.0
37257,3,7257,[318 427  98 191 182],72,5,29701,4.092174152659135,40.0,0.0
37258,3,7258,[318 427  98 191 182],655,5,29706,4.092299214767874,40.0,0.0
37259,3,7259,[588 234  56 546 568],450,4,29710,4.09228650137741,0.0,0.0
37260,3,7260,[318 427  98 191 182],269,5,29715,4.092411513565625,40.0,0.0
37261,3,7261,[318 427  98 191 182],655,5,29720,4.0925364913247035,40.0,0.0
37262,3,7262,[318 427  98 191 182],72,5,29725,4.0926614346688694,40.0,0.0
37263,3,7263,[318 427  98 191 182],796,5,29730,4.092786343612334,40.0,0.0
37264,3,7264,[318 427  98 191 182],18,5,29735,4.092911218169305,40.0,0.0
37265,3,7265,[ 50 385  28 180 111],796,3,29738,4.092760803743463,0.0,20.0
37266,3,7266,[475  98 202 195 117],655,1,29739,4.09233521398101,0.0,0.0
37267,3,7267,[318 427  98 191 182],796,5,29744,4.092460099064392,40.0,0.0
37268,3,7268,[496 200 181 151 603],908,2,29746,4.092172238272115,40.0,0.0
37269,3,7269,[161 403 265 216 204],450,5,29751,4.092297111416781,0.0,0.0
37270,3,7270,[318 427  98 191 182],269,5,29756,4.092421950213176,40.0,0.0
37271,3,7271,[318 427  98 191 182],18,5,29761,4.0925467546754675,40.0,0.0
37272,3,7272,[  4 228 508 176 318],280,1,29762,4.092121545442046,20.0,0.0
37273,3,7273,[118  96 588 357 127],716,3,29765,4.0919714050041245,0.0,20.0
37274,3,7274,[151 132 197 234 300],504,4,29769,4.091958762886598,0.0,0.0
37275,3,7275,[333 742 265  97  12],796,3,29772,4.091808686091259,0.0,0.0
37276,3,7276,[655 568 174 597 313],796,4,29776,4.0917960698089875,0.0,0.0
37277,3,7277,[318 427  98 191 182],655,5,29781,4.0919208573784,40.0,0.0
37278,3,7278,[318 427  98 191 182],269,5,29786,4.092045610660805,40.0,0.0
37279,3,7279,[238 200  95 153 265],716,5,29791,4.09217032967033,0.0,0.0
37280,3,7280,[ 82 179 210  69 204],450,3,29794,4.092020326878176,0.0,0.0
37281,3,7281,[483 318 742 222 202],450,3,29797,4.0918703652842625,20.0,0.0
37282,3,7282,[318 427  98 191 182],269,5,29802,4.091995056982013,40.0,0.0
37283,3,7283,[318 427  98 191 182],269,5,29807,4.092119714442614,40.0,0.0
37284,3,7284,[423 357 742 194 237],457,5,29812,4.092244337680165,0.0,0.0
37285,3,7285,[318 427  98 191 182],655,5,29817,4.092368926708756,40.0,0.0
37286,3,7286,[318 427  98 191 182],72,5,29822,4.092493481542473,40.0,0.0
37287,3,7287,[ 25 185 196 301 258],655,1,29823,4.092069154774973,0.0,0.0
37288,3,7288,[185  28 427  11 403],330,5,29828,4.092193716559199,20.0,0.0
37289,3,7289,[318 427  98 191 182],269,5,29833,4.092318244170096,40.0,0.0
37290,3,7290,[318 427  98 191 182],796,5,29838,4.092442737621726,40.0,0.0
37291,3,7291,[318 427  98 191 182],18,5,29843,4.09256719692814,40.0,0.0
37292,3,7292,[196 191  28 174 423],72,5,29848,4.092691622103387,0.0,0.0
37293,3,7293,[427 216 187 294  50],835,4,29852,4.092678914176035,20.0,20.0
37294,3,7294,[228 269 172  98 275],23,5,29857,4.092803289924606,0.0,20.0
37295,3,7295,[ 79 117 194 496 357],796,5,29862,4.092927631578948,20.0,0.0
37296,3,7296,[282 210 215 100   4],535,3,29865,4.092777853912567,0.0,20.0
37297,3,7297,[318 427  98 191 182],796,5,29870,4.092902164976706,40.0,0.0
37298,3,7298,[185 173  89 286 204],562,3,29873,4.092752431839978,0.0,20.0
37299,3,7299,[318 427  98 191 182],18,5,29878,4.092876712328767,40.0,0.0
37300,3,7300,[ 50  12 313 385 742],655,2,29880,4.092590056156691,0.0,20.0
37301,3,7301,[318 427  98 191 182],655,5,29885,4.092714324842509,40.0,0.0
37302,3,7302,[318 427  98 191 182],269,5,29890,4.092838559496098,40.0,0.0
37303,3,7303,[172  12 300 125 385],796,5,29895,4.092962760131435,0.0,0.0
37304,3,7304,[172  79 196 111 143],593,5,29900,4.093086926762491,0.0,0.0
37305,3,7305,[318 427  98 191 182],450,5,29905,4.09321105940323,40.0,0.0
37306,3,7306,[195 143 200 100 173],786,5,29910,4.093335158067607,0.0,20.0
37307,3,7307,[143 655 427 273 191],236,3,29913,4.093185550082102,20.0,0.0
37308,3,7308,[132 385 405 265 197],786,4,29917,4.093172800656725,0.0,0.0
37309,3,7309,[318 427  98 191 182],450,5,29922,4.093296853625171,40.0,0.0
37310,3,7310,[597 385  12  82 222],450,3,29925,4.093147312269183,0.0,0.0
37311,3,7311,[318 427  98 191 182],655,5,29930,4.093271334792123,40.0,0.0
37312,3,7312,[318 427  98 191 182],72,5,29935,4.093395323396691,40.0,0.0
37313,3,7313,[318 427  98 191 182],72,5,29940,4.0935192780968,40.0,0.0
37314,3,7314,[196 301   4 268 333],629,3,29943,4.09336978810663,0.0,0.0
37315,3,7315,[234 265  11  79 215],450,4,29947,4.093357025697102,0.0,0.0
37316,3,7316,[ 97 153 282  50 742],796,3,29950,4.093207598742654,0.0,20.0
37317,3,7317,[318 427  98 191 182],655,5,29955,4.093331511341897,40.0,0.0
37318,3,7318,[282 173 144 435 471],450,5,29960,4.093455390080612,0.0,0.0
37319,3,7319,[318 427  98 191 182],269,5,29965,4.093579234972678,40.0,0.0
37320,3,7320,[318  11 568  89 173],450,5,29970,4.093703046031963,20.0,0.0
37321,3,7321,[603 135  15 187 258],655,3,29973,4.093553673859601,20.0,0.0
37322,3,7322,[182 286 153 234  88],593,3,29976,4.093404342482589,0.0,20.0
37323,3,7323,[318 427  98 191 182],796,5,29981,4.093528126706718,40.0,0.0
37324,3,7324,[ 88 515  15   8  28],18,3,29984,4.093378839590444,0.0,0.0
37325,3,7325,[ 25 111 117  64 118],655,1,29985,4.092956592956593,20.0,0.0
37326,3,7326,[318 427  98 191 182],18,5,29990,4.093080387607479,40.0,0.0
37327,3,7327,[423 174   8  69 172],457,5,29995,4.0932041484716155,0.0,0.0
37328,3,7328,[286 121 234 197 515],655,1,29996,4.092782098512758,0.0,20.0
37329,3,7329,[204 182 187  97 245],796,3,29999,4.092633015006821,0.0,0.0
37330,3,7330,[405 300 183 245 118],450,4,30003,4.092620379211567,0.0,0.0
37331,3,7331,[275 135  22 265 742],655,2,30005,4.092334969994544,0.0,20.0
37332,3,7332,[318 427  98 191 182],796,5,30010,4.092458748124915,40.0,0.0
37333,3,7333,[318 427  98 191 182],655,5,30015,4.092582492500682,40.0,0.0
37334,3,7334,[127 100 111 235 475],839,4,30019,4.092569870483981,0.0,40.0
37335,3,7335,[318 427  98 191 182],18,5,30024,4.092693565976009,40.0,0.0
37336,3,7336,[318 427  98 191 182],796,5,30029,4.092817227749761,40.0,0.0
37337,3,7337,[568  11 515 318 172],269,2,30031,4.092532025074952,20.0,0.0
37338,3,7338,[318 427  98 191 182],18,5,30036,4.0926556751601035,40.0,0.0
37339,3,7339,[318 427  98 191 182],72,5,30041,4.092779291553134,40.0,0.0
37340,3,7340,[318 427  98 191 182],72,5,30046,4.092902874267811,40.0,0.0
37341,3,7341,[496 117 228 135   1],716,4,30050,4.092890220648325,20.0,0.0
37342,3,7342,[318 427  98 191 182],18,5,30055,4.093013754596214,40.0,0.0
37343,3,7343,[318 427  98 191 182],655,5,30060,4.0931372549019605,40.0,0.0
37344,3,7344,[132 202 186  28 135],716,3,30063,4.092988427501702,0.0,0.0
37345,3,7345,[483  22  56 175 144],655,1,30064,4.092567383610128,0.0,0.0
37346,3,7346,[403 168 258  12 185],796,5,30069,4.092690894242548,0.0,0.0
37347,3,7347,[228 179  28  69 181],457,5,30074,4.092814371257485,0.0,0.0
37348,3,7348,[435 100 403  95 173],756,1,30075,4.0923935229282895,0.0,20.0
37349,3,7349,[153 200 187 588 118],450,3,30078,4.0922448979591834,0.0,0.0
37350,3,7350,[ 50 168  56 183 186],269,2,30080,4.091960277513263,0.0,20.0
37351,3,7351,[265 357 427 245 742],796,3,30083,4.091811751904244,20.0,0.0
37352,3,7352,[318 427  98 191 182],72,5,30088,4.0919352645178835,40.0,0.0
37353,3,7353,[318 427  98 191 182],450,5,30093,4.09205874354093,40.0,0.0
37354,3,7354,[173 194 265 172 111],450,5,30098,4.092182188987084,0.0,0.0
37355,3,7355,[318 427  98 191 182],450,5,30103,4.092305600870038,40.0,0.0
37356,3,7356,[318 427  98 191 182],655,5,30108,4.09242897920348,40.0,0.0
37357,3,7357,[174   1 202 265  11],716,5,30113,4.092552324001087,0.0,0.0
37358,3,7358,[ 69 153 748  15  12],796,5,30118,4.0926756352765326,0.0,0.0
37359,3,7359,[328 185  96 294 288],655,1,30119,4.092255434782609,0.0,0.0
37360,3,7360,[100  64  88 118 427],655,2,30121,4.091971199565276,40.0,20.0
37361,3,7361,[318 427  98 191 182],655,5,30126,4.092094539527302,40.0,0.0
37362,3,7362,[318 427  98 191 182],269,5,30131,4.09221784598669,40.0,0.0
37363,3,7363,[496 215  25 127 180],450,4,30135,4.092205323193916,20.0,20.0
37364,3,7364,[234 597 187 127 153],269,2,30137,4.091921249151392,0.0,20.0
37365,3,7365,[173 483 143 237 294],450,4,30141,4.091908770024436,0.0,0.0
37366,3,7366,[318 427  98 191 182],655,5,30146,4.0920320347495585,40.0,0.0
37367,3,7367,[135 195  50  12   7],457,5,30151,4.092155266015201,0.0,20.0
37368,3,7368,[318 427  98 191 182],72,5,30156,4.092278463834984,40.0,0.0
37369,3,7369,[215 471 195  50 603],450,5,30161,4.0924016282225235,20.0,20.0
37370,3,7370,[655 265   4 286 257],796,3,30164,4.092253425586759,0.0,20.0
37371,3,7371,[318 427  98 191 182],796,5,30169,4.092376559956593,40.0,0.0
37372,3,7372,[318 427  98 191 182],655,5,30174,4.092499660924997,40.0,0.0
37373,3,7373,[282   1 496 300  71],796,4,30178,4.092487116897207,20.0,0.0
37374,3,7374,[318 427  98 191 182],796,5,30183,4.092610169491525,40.0,0.0
37375,3,7375,[318 427  98 191 182],18,5,30188,4.092733188720174,40.0,0.0
37376,3,7376,[318 427  98 191 182],72,5,30193,4.09285617459672,40.0,0.0
37377,3,7377,[ 50  15 183 496 271],796,5,30198,4.092979127134725,20.0,20.0
37378,3,7378,[318 427  98 191 182],269,5,30203,4.093102046347743,40.0,0.0
37379,3,7379,[318 427  98 191 182],450,5,30208,4.093224932249322,40.0,0.0
37380,3,7380,[286  22  89 187 174],18,4,30212,4.093212301856117,0.0,20.0
37381,3,7381,[132 168 234  97 228],457,5,30217,4.093335139528583,0.0,0.0
37382,3,7382,[423 245 153 211 174],450,5,30222,4.093457943925234,0.0,0.0
37383,3,7383,[318 427  98 191 182],655,5,30227,4.093580715059589,40.0,0.0
37384,3,7384,[276  22 235   7 742],457,4,30231,4.093568043331077,0.0,0.0
37385,3,7385,[318 427  98 191 182],655,5,30236,4.09369076631465,40.0,0.0
37386,3,7386,[318 427  98 191 182],450,5,30241,4.0938134560714765,40.0,0.0
37387,3,7387,[183 357 294 100 182],796,3,30244,4.093665403356795,0.0,20.0
37388,3,7388,[318 427  98 191 182],18,5,30249,4.093788063337393,40.0,0.0
37389,3,7389,[318 427  98 191 182],796,5,30254,4.0939106901217865,40.0,0.0
37390,3,7390,[318 427  98 191 182],796,5,30259,4.094033283723447,40.0,0.0
37391,3,7391,[318 427  98 191 182],450,5,30264,4.0941558441558445,40.0,0.0
37392,3,7392,[194  12 216 210 603],503,3,30267,4.0940078452590285,20.0,0.0
37393,3,7393,[294 597 427  98 100],796,3,30270,4.093859886394374,20.0,20.0
37394,3,7394,[318 427  98 191 182],72,5,30275,4.093982420554429,40.0,0.0
37395,3,7395,[318 427  98 191 182],18,5,30280,4.094104921579232,40.0,0.0
37396,3,7396,[ 50 121  88 216 127],655,3,30283,4.093957009598486,0.0,40.0
37397,3,7397,[318 427  98 191 182],72,5,30288,4.0940794809407945,40.0,0.0
37398,3,7398,[ 50 196 211  98 588],716,5,30293,4.094201919178268,0.0,20.0
37399,3,7399,[ 89 603  22 237 269],796,4,30297,4.094189189189189,20.0,0.0
37400,3,7400,[ 82 176 423 323 318],796,3,30300,4.094041345764086,20.0,0.0
37401,3,7401,[318 427  98 191 182],450,5,30305,4.094163739529857,40.0,0.0
37402,3,7402,[196 215 132 172 276],535,3,30308,4.094015939483993,0.0,0.0
37403,3,7403,[237 300   1 483 228],716,5,30313,4.0941383036196655,0.0,0.0
37404,3,7404,[238 222 435 204 245],450,4,30317,4.094125590817016,0.0,0.0
37405,3,7405,[318 427  98 191 182],269,5,30322,4.09424790710235,40.0,0.0
37406,3,7406,[ 50 405  79 215 100],655,2,30324,4.093965168084245,0.0,40.0
37407,3,7407,[118  95 197 215 181],450,3,30327,4.093817494600432,0.0,0.0
37408,3,7408,[125 405 333 185 300],796,5,30332,4.0939398029423675,0.0,0.0
37409,3,7409,[318 427  98 191 182],72,5,30337,4.0940620782726045,40.0,0.0
37410,3,7410,[161 197 234 117 176],504,3,30340,4.093914451491027,0.0,0.0
37411,3,7411,[318 427  98 191 182],450,5,30345,4.094036697247707,40.0,0.0
37412,3,7412,[318 427  98 191 182],796,5,30350,4.094158910022933,40.0,0.0
37413,3,7413,[168 196 496   4 568],450,4,30354,4.094146209873212,20.0,0.0
37414,3,7414,[318 427  98 191 182],655,5,30359,4.094268374915711,40.0,0.0
37415,3,7415,[151 173 405  15 211],151,4,30363,4.09425566343042,0.0,0.0
37416,3,7416,[318 427  98 191 182],269,5,30368,4.094377780773898,40.0,0.0
37417,3,7417,[111 125 180 257 258],296,4,30372,4.094365057967107,0.0,0.0
37418,3,7418,[ 25 143 357   1 286],330,5,30377,4.094487127645235,0.0,20.0
37419,3,7419,[100 588  88 204 182],796,4,30381,4.094474393530997,0.0,20.0
37420,3,7420,[318 427  98 191 182],796,5,30386,4.094596415577415,40.0,0.0
37421,3,7421,[318 427  98 191 182],796,5,30391,4.094718404742657,40.0,0.0
37422,3,7422,[318 427  98 191 182],450,5,30396,4.094840361040011,40.0,0.0
37423,3,7423,[  1 151 187 265  15],450,4,30400,4.094827586206897,0.0,0.0
37424,3,7424,[318 427  98 191 182],655,5,30405,4.094949494949495,40.0,0.0
37425,3,7425,[ 69 273  82  50 179],655,3,30408,4.094802046862376,0.0,20.0
37426,3,7426,[ 96 282 328 423 289],655,0,30408,4.094250706880302,0.0,0.0
37427,3,7427,[318 427  98 191 182],796,5,30413,4.0943726440495425,40.0,0.0
37428,3,7428,[655  69 515   9  64],72,5,30418,4.094494548391439,20.0,0.0
37429,3,7429,[318 427  98 191 182],450,5,30423,4.094616419919246,40.0,0.0
37430,3,7430,[195 313 181 127 742],693,3,30426,4.094469115865967,0.0,20.0
37431,3,7431,[176  88 742 318 216],280,3,30429,4.094321851453175,20.0,0.0
37432,3,7432,[318 427  98 191 182],450,5,30434,4.094443697026772,40.0,0.0
37433,3,7433,[318 427  98 191 182],72,5,30439,4.0945655098197475,40.0,0.0
37434,3,7434,[318 427  98 191 182],18,5,30444,4.094687289845326,40.0,0.0
37435,3,7435,[318 427  98 191 182],18,5,30449,4.09480903711673,40.0,0.0
37436,3,7436,[182 302 172  64 515],655,5,30454,4.094930751647169,20.0,0.0
37437,3,7437,[318 427  98 191 182],450,5,30459,4.095052433449852,40.0,0.0
37438,3,7438,[318 427  98 191 182],655,5,30464,4.095174082537976,40.0,0.0
37439,3,7439,[318 427  98 191 182],655,5,30469,4.0952956989247316,40.0,0.0
37440,3,7440,[127 172 515 151   8],269,3,30472,4.095148501545491,0.0,20.0
37441,3,7441,[318 427  98 191 182],450,5,30477,4.0952700886858375,40.0,0.0
37442,3,7442,[318 427  98 191 182],655,5,30482,4.095391643154642,40.0,0.0
37443,3,7443,[403 191 180 100 200],450,4,30486,4.095378828586782,0.0,20.0
37444,3,7444,[257  88  71 301 197],389,3,30489,4.095231699126931,0.0,0.0
37445,3,7445,[318 427  98 191 182],18,5,30494,4.095353209777062,40.0,0.0
37446,3,7446,[318 427  98 191 182],269,5,30499,4.095474687793742,40.0,0.0
37447,3,7447,[318 427  98 191 182],72,5,30504,4.095596133190118,40.0,0.0
37448,3,7448,[318 427  98 191 182],269,5,30509,4.095717545979326,40.0,0.0
37449,3,7449,[176 275 475 182 423],503,3,30512,4.095570469798658,0.0,20.0
37450,3,7450,[176 175 215  22 742],655,0,30512,4.095020802576835,0.0,0.0
37451,3,7451,[210 568 546 423 185],796,4,30516,4.095008051529791,0.0,0.0
37452,3,7452,[318 427  98 191 182],450,5,30521,4.095129478062526,40.0,0.0
37453,3,7453,[ 96 286 100 215 172],280,2,30523,4.0948484035417225,0.0,40.0
37454,3,7454,[197 100 318 328 161],450,5,30528,4.094969818913481,20.0,20.0
37455,3,7455,[318 427  98 191 182],18,5,30533,4.0950912017167385,40.0,0.0
37456,3,7456,[318 427  98 191 182],655,5,30538,4.095212551964597,40.0,0.0
37457,3,7457,[194 202 265  98 183],457,5,30543,4.095333869670153,0.0,0.0
37458,3,7458,[182  64 176  70 427],450,5,30548,4.095455154846494,40.0,0.0
37459,3,7459,[318 427  98 191 182],655,5,30553,4.0955764075067025,40.0,0.0
37460,3,7460,[257 597 182 405 322],796,4,30557,4.0955635973730065,0.0,0.0
37461,3,7461,[ 96 195 257  88 215],655,0,30557,4.095014741356205,0.0,0.0
37462,3,7462,[318 427  98 191 182],72,5,30562,4.09513600428782,40.0,0.0
37463,3,7463,[318 427  98 191 182],655,5,30567,4.095257234726688,40.0,0.0
37464,3,7464,[318 427  98 191 182],18,5,30572,4.095378432685868,40.0,0.0
37465,3,7465,[144  25 161 403 318],450,4,30576,4.095365657648005,20.0,0.0
37466,3,7466,[318 427  98 191 182],72,5,30581,4.095486808624615,40.0,0.0
37467,3,7467,[121 271 211  97 174],655,0,30581,4.094938403856454,0.0,0.0
37468,3,7468,[273 302  69 216 322],450,4,30585,4.094925692863837,0.0,0.0
37469,3,7469,[318 427  98 191 182],269,5,30590,4.095046854082999,40.0,0.0
37470,3,7470,[ 88 174 286 357 603],401,4,30594,4.095034131976978,20.0,20.0
37471,3,7471,[161 357  95 235  98],330,5,30599,4.095155246252677,0.0,0.0
37472,3,7472,[318 427  98 191 182],72,5,30604,4.0952763281145454,40.0,0.0
37473,3,7473,[318 427  98 191 182],18,5,30609,4.095397377575595,40.0,0.0
37474,3,7474,[357  96 568   8 273],655,2,30611,4.095117056856187,0.0,0.0
37475,3,7475,[176  82  69 237   9],457,5,30616,4.095238095238095,0.0,0.0
37476,3,7476,[175 405 286 385  89],151,3,30619,4.095091614283803,0.0,20.0
37477,3,7477,[318 427  98 191 182],450,5,30624,4.095212623696176,40.0,0.0
37478,3,7478,[318 427  98 191 182],18,5,30629,4.095333600748763,40.0,0.0
37479,3,7479,[ 25 385 118   7 471],655,0,30629,4.094786096256684,0.0,0.0
37480,3,7480,[318 427  98 191 182],796,5,30634,4.094907097981554,40.0,0.0
37481,3,7481,[210 385 200 211 168],504,5,30639,4.095028067361668,0.0,0.0
37482,3,7482,[ 50 118  82 127 211],796,3,30642,4.094881731925698,0.0,40.0
37483,3,7483,[  4 118 179  95 144],450,2,30644,4.094601817210048,0.0,0.0
37484,3,7484,[318 427  98 191 182],72,5,30649,4.094722778891115,40.0,0.0
37485,3,7485,[318 427  98 191 182],796,5,30654,4.09484370825541,40.0,0.0
37486,3,7486,[318 427  98 191 182],655,5,30659,4.094964605315881,40.0,0.0
37487,3,7487,[318 427  98 191 182],18,5,30664,4.09508547008547,40.0,0.0
37488,3,7488,[143   8 237 118 257],457,4,30668,4.095072773400988,0.0,0.0
37489,3,7489,[318 427  98 191 182],18,5,30673,4.095193591455273,40.0,0.0
37490,3,7490,[302 173 125  64 328],450,5,30678,4.095314377252703,20.0,0.0
37491,3,7491,[357 174 180 268 483],269,3,30681,4.095168179391351,0.0,0.0
37492,3,7492,[  1 357 234 173 546],457,4,30685,4.09515547844655,0.0,0.0
37493,3,7493,[318 427  98 191 182],269,5,30690,4.095276220976781,40.0,0.0
37494,3,7494,[132 176 151   1 603],389,5,30695,4.095396931287525,20.0,0.0
37495,3,7495,[  4 275 318   8 265],535,3,30698,4.095250800426895,20.0,20.0
37496,3,7496,[318 427  98 191 182],18,5,30703,4.095371481926104,40.0,0.0
37497,3,7497,[318 427  98 191 182],269,5,30708,4.095492131234996,40.0,0.0
37498,3,7498,[318 427  98 191 182],72,5,30713,4.095612748366449,40.0,0.0
37499,3,7499,[ 12 161 323 546 333],796,4,30717,4.0956,0.0,0.0
37500,3,7500,[318 427  98 191 182],72,5,30722,4.095720570590588,40.0,0.0
37501,3,7501,[135 568  25 603 172],389,2,30724,4.0954412156758195,20.0,0.0
37502,3,7502,[318 427  98 191 182],72,5,30729,4.095561775289884,40.0,0.0
37503,3,7503,[ 88 210 301 318 118],450,3,30732,4.095415778251599,20.0,0.0
37504,3,7504,[357 318 568 508 222],693,3,30735,4.0952698201199205,20.0,0.0
37505,3,7505,[323 194  28 197  79],796,2,30737,4.094990674127365,0.0,0.0
37506,3,7506,[  7 597 194 118  79],450,4,30741,4.094978020514187,0.0,0.0
37507,3,7507,[ 22  97 111 300 185],655,1,30742,4.09456579648375,0.0,0.0
37508,3,7508,[318 427  98 191 182],72,5,30747,4.094686376348382,40.0,0.0
37509,3,7509,[  8 471 234 286   9],593,1,30748,4.09427430093209,0.0,20.0
37510,3,7510,[318 427  98 191 182],72,5,30753,4.094394887498336,40.0,0.0
37511,3,7511,[318 427  98 191 182],796,5,30758,4.0945154419595315,40.0,0.0
37512,3,7512,[655   9 286 222 435],236,4,30762,4.094502861706376,0.0,20.0
37513,3,7513,[318 427  98 191 182],72,5,30767,4.094623369709875,40.0,0.0
37514,3,7514,[318 427  98 191 182],18,5,30772,4.094743845642049,40.0,0.0
37515,3,7515,[318 427  98 191 182],655,5,30777,4.0948642895157,40.0,0.0
37516,3,7516,[318 427  98 191 182],450,5,30782,4.094984701343621,40.0,0.0
37517,3,7517,[318 427  98 191 182],18,5,30787,4.095105081138601,40.0,0.0
37518,3,7518,[265 118 186 258 385],151,3,30790,4.094959436095225,0.0,0.0
37519,3,7519,[151 216  64 568   1],796,4,30794,4.094946808510638,20.0,0.0
37520,3,7520,[235 475 176 234 151],292,4,30798,4.094934184284004,0.0,0.0
37521,3,7521,[111 210 216 196 174],18,3,30801,4.09478862004786,0.0,0.0
37522,3,7522,[318 427  98 191 182],655,5,30806,4.094908945899243,40.0,0.0
37523,3,7523,[318 427  98 191 182],655,5,30811,4.095029239766082,40.0,0.0
37524,3,7524,[237 125 235   7 181],938,2,30813,4.094750830564784,0.0,0.0
37525,3,7525,[318 427  98 191 182],450,5,30818,4.0948711134732925,40.0,0.0
37526,3,7526,[318 427  98 191 182],450,5,30823,4.094991364421416,40.0,0.0
37527,3,7527,[318 427  98 191 182],450,5,30828,4.095111583421891,40.0,0.0
37528,3,7528,[318 427  98 191 182],72,5,30833,4.095231770487448,40.0,0.0
37529,3,7529,[318 427  98 191 182],796,5,30838,4.09535192563081,40.0,0.0
37530,3,7530,[483 132 172 742 655],450,4,30842,4.095339264373921,0.0,0.0
37531,3,7531,[294 196 182 174 328],655,1,30843,4.0949283058948485,0.0,0.0
37532,3,7532,[318 427  98 191 182],269,5,30848,4.095048453471392,40.0,0.0
37533,3,7533,[265 603 211 121 216],796,4,30852,4.095035837536501,20.0,0.0
37534,3,7534,[318 427  98 191 182],72,5,30857,4.095155938951559,40.0,0.0
37535,3,7535,[ 28 176 301 143 187],655,2,30859,4.094877919320594,0.0,0.0
37536,3,7536,[318 427  98 191 182],655,5,30864,4.09499800981823,40.0,0.0
37537,3,7537,[143 174 132 568 202],716,5,30869,4.0951180684531705,0.0,0.0
37538,3,7538,[318 427  98 191 182],72,5,30874,4.095238095238095,40.0,0.0
37539,3,7539,[318 427  98 191 182],269,5,30879,4.095358090185677,40.0,0.0
37540,3,7540,[318 427  98 191 182],655,5,30884,4.09547805330858,40.0,0.0
37541,3,7541,[318 427  98 191 182],450,5,30889,4.095597984619464,40.0,0.0
37542,3,7542,[  9 179 151 210 546],504,4,30893,4.095585310884264,0.0,0.0
37543,3,7543,[194 179  88 211 200],504,2,30895,4.095307529162248,0.0,0.0
37544,3,7544,[318 427  98 191 182],18,5,30900,4.095427435387674,40.0,0.0
37545,3,7545,[318 427  98 191 182],450,5,30905,4.095547309833024,40.0,0.0
37546,3,7546,[318 427  98 191 182],72,5,30910,4.095667152510932,40.0,0.0
37547,3,7547,[265 191 275 294 322],450,5,30915,4.095786963434022,0.0,20.0
37548,3,7548,[173 202 151 118 194],798,3,30918,4.095641806861836,0.0,0.0
37549,3,7549,[318 427  98 191 182],655,5,30923,4.095761589403973,40.0,0.0
37550,3,7550,[204 603 197 172 174],401,4,30927,4.0957489074294795,20.0,0.0
37551,3,7551,[301  69 127   7 174],629,3,30930,4.095603813559322,0.0,20.0
37552,3,7552,[318 427  98 191 182],269,5,30935,4.095723553554879,40.0,0.0
37553,3,7553,[117  89 195 196 144],655,1,30936,4.095313741064337,0.0,0.0
37554,3,7554,[318 427  98 191 182],796,5,30941,4.095433487756453,40.0,0.0
37555,3,7555,[318 427  98 191 182],796,5,30946,4.09555320275278,40.0,0.0
37556,3,7556,[215 294 153 515 435],716,5,30951,4.095672886065899,0.0,0.0
37557,3,7557,[318 427  98 191 182],269,5,30956,4.095792537708388,40.0,0.0
37558,3,7558,[269 234 200 191 186],18,3,30959,4.095647572430216,0.0,0.0
37559,3,7559,[318 427  98 191 182],655,5,30964,4.095767195767196,40.0,0.0
37560,3,7560,[185 423 405 269 210],655,1,30965,4.095357756910461,0.0,0.0
37561,3,7561,[318 427  98 191 182],450,5,30970,4.0954773869346734,40.0,0.0
37562,3,7562,[318 427  98 191 182],796,5,30975,4.095596985323285,40.0,0.0
37563,3,7563,[318 427  98 191 182],796,5,30980,4.095716552088842,40.0,0.0
37564,3,7564,[427 174 210   1  89],5,3,30983,4.0955717118308,20.0,0.0
37565,3,7565,[318 427  98 191 182],450,5,30988,4.095691250330425,40.0,0.0
37566,3,7566,[318 427  98 191 182],655,5,30993,4.095810757235364,40.0,0.0
37567,3,7567,[ 15 403  88 238 168],450,4,30997,4.095798097251586,0.0,0.0
37568,3,7568,[182 286 144  22 234],655,1,30998,4.095389087065662,0.0,20.0
37569,3,7569,[318 427  98 191 182],72,5,31003,4.095508586525759,40.0,0.0
37570,3,7570,[318 427  98 191 182],18,5,31008,4.0956280544181745,40.0,0.0
37571,3,7571,[228 742 588 313 175],344,3,31011,4.095483359746434,0.0,0.0
37572,3,7572,[318 427  98 191 182],18,5,31016,4.095602799418988,40.0,0.0
37573,3,7573,[318 427  98 191 182],269,5,31021,4.095722207552152,40.0,0.0
37574,3,7574,[202  22  79  28  50],796,4,31025,4.095709570957096,0.0,20.0
37575,3,7575,[183 222  69 403 508],280,1,31026,4.095300950369588,0.0,0.0
37576,3,7576,[603 151 265  11 508],535,4,31030,4.095288372706876,20.0,0.0
37577,3,7577,[318 427  98 191 182],450,5,31035,4.095407759303246,40.0,0.0
37578,3,7578,[216   7  70 135 405],450,4,31039,4.095395170866869,0.0,0.0
37579,3,7579,[301 275 288 269 172],655,2,31041,4.095118733509235,0.0,20.0
37580,3,7580,[318 427  98 191 182],796,5,31046,4.095238095238095,40.0,0.0
37581,3,7581,[318 427  98 191 182],796,5,31051,4.095357425481403,40.0,0.0
37582,3,7582,[294 176  11 127 483],655,2,31053,4.095081102466042,0.0,20.0
37583,3,7583,[222 197  79 265 496],151,5,31058,4.095200421940929,20.0,0.0
37584,3,7584,[318 427  98 191 182],72,5,31063,4.0953197099538565,40.0,0.0
37585,3,7585,[288 435 385 153 275],450,4,31067,4.095307144740311,0.0,20.0
37586,3,7586,[318 427  98 191 182],269,5,31072,4.095426387241334,40.0,0.0
37587,3,7587,[483 508 172 435 132],535,4,31076,4.09541381128097,0.0,0.0
37588,3,7588,[318 427  98 191 182],655,5,31081,4.095533008301489,40.0,0.0
37589,3,7589,[318 427  98 191 182],796,5,31086,4.095652173913043,40.0,0.0
37590,3,7590,[318 427  98 191 182],72,5,31091,4.095771308128047,40.0,0.0
37591,3,7591,[318 427  98 191 182],18,5,31096,4.095890410958904,40.0,0.0
37592,3,7592,[318 427  98 191 182],796,5,31101,4.096009482418016,40.0,0.0
37593,3,7593,[ 25   7  50 282 300],655,1,31102,4.095601790887542,0.0,20.0
37594,3,7594,[161 257 117  50  96],504,4,31106,4.095589203423305,0.0,20.0
37595,3,7595,[322 153 357 172  98],629,4,31110,4.095576619273301,0.0,0.0
37596,3,7596,[  8 172 151   4 132],389,5,31115,4.095695669343161,0.0,0.0
37597,3,7597,[234  98 301 173 174],450,4,31119,4.095683074493287,0.0,0.0
37598,3,7598,[282 185 191 357  97],450,5,31124,4.09580207922095,0.0,0.0
37599,3,7599,[215 275 483 286  11],535,4,31128,4.095789473684211,0.0,40.0
37600,3,7600,[655 144 204 245 269],450,5,31133,4.095908433100908,0.0,0.0
37601,3,7601,[318 427  98 191 182],269,5,31138,4.096027361220731,40.0,0.0
37602,3,7602,[318 427  98 191 182],18,5,31143,4.096146258056031,40.0,0.0
37603,3,7603,[  4 322 215 273 181],450,3,31146,4.0960021041557075,0.0,0.0
37604,3,7604,[185 121  11 172 135],330,4,31150,4.095989480604866,0.0,0.0
37605,3,7605,[318 427  98 191 182],796,5,31155,4.096108335524586,40.0,0.0
37606,3,7606,[100 403 483 196 200],655,2,31157,4.095832785592218,0.0,20.0
37607,3,7607,[245 294  12  79 403],256,4,31161,4.095820189274448,0.0,0.0
37608,3,7608,[282  69 200 471 405],280,2,31163,4.095544749638586,0.0,0.0
37609,3,7609,[318 427  98 191 182],18,5,31168,4.095663600525624,40.0,0.0
37610,3,7610,[318 427  98 191 182],450,5,31173,4.095782420181316,40.0,0.0
37611,3,7611,[318 427  98 191 182],18,5,31178,4.095901208617971,40.0,0.0
37612,3,7612,[185 175   8 151 143],269,3,31181,4.095757257323,0.0,0.0
37613,3,7613,[546 318   1 172  56],593,3,31184,4.095613343840294,20.0,0.0
37614,3,7614,[318 427  98 191 182],72,5,31189,4.095732107682206,40.0,0.0
37615,3,7615,[ 95  28 179 196 187],786,5,31194,4.0958508403361344,0.0,0.0
37616,3,7616,[568   4 235   1 282],457,4,31198,4.095838256531443,0.0,0.0
37617,3,7617,[275   1 187 300 405],450,5,31203,4.095956944079811,0.0,20.0
37618,3,7618,[318 427  98 191 182],450,5,31208,4.096075600472503,40.0,0.0
37619,3,7619,[318 427  98 191 182],796,5,31213,4.096194225721785,40.0,0.0
37620,3,7620,[318 427  98 191 182],655,5,31218,4.096312819839916,40.0,0.0
37621,3,7621,[ 28  95 282  22 172],450,4,31222,4.096300183678824,0.0,0.0
37622,3,7622,[ 98 143   1 183  64],796,4,31226,4.096287550833005,20.0,0.0
37623,3,7623,[318 427  98 191 182],269,5,31231,4.096406086044071,40.0,0.0
37624,3,7624,[318 427  98 191 182],796,5,31236,4.096524590163934,40.0,0.0
37625,3,7625,[318 427  98 191 182],72,5,31241,4.096643063204826,40.0,0.0
37626,3,7626,[ 56 121 655 151 196],450,4,31245,4.09663039202832,0.0,0.0
37627,3,7627,[186 180 235 265  97],457,4,31249,4.096617724174095,0.0,0.0
37628,3,7628,[ 50 182  56 286 742],280,3,31252,4.096473980862498,0.0,40.0
37629,3,7629,[174  25 300 161  28],389,2,31254,4.096199213630406,0.0,0.0
37630,3,7630,[125 234 597  50   4],796,4,31258,4.096186607259861,0.0,20.0
37631,3,7631,[318 427  98 191 182],450,5,31263,4.096305031446541,40.0,0.0
37632,3,7632,[211  95 496 143 323],796,3,31266,4.096161404428141,20.0,0.0
37633,3,7633,[318 427  98 191 182],655,5,31271,4.096279800890752,40.0,0.0
37634,3,7634,[318 427  98 191 182],269,5,31276,4.0963981663392275,40.0,0.0
37635,3,7635,[318 427  98 191 182],450,5,31281,4.096516500785752,40.0,0.0
37636,3,7636,[318 427  98 191 182],796,5,31286,4.096634804242504,40.0,0.0
37637,3,7637,[197 258 194   8 121],535,5,31291,4.0967530767216545,0.0,0.0
37638,3,7638,[ 22 258 174 318  56],535,3,31294,4.096609503861762,20.0,0.0
37639,3,7639,[318 427  98 191 182],269,5,31299,4.0967277486911,40.0,0.0
37640,3,7640,[ 12 181 182 318 111],457,4,31303,4.096715089647952,20.0,0.0
37641,3,7641,[318 427  98 191 182],796,5,31308,4.096833289714734,40.0,0.0
37642,3,7642,[210 403   8 300 258],807,4,31312,4.096820620175324,0.0,0.0
37643,3,7643,[318 427  98 191 182],450,5,31317,4.096938775510204,40.0,0.0
37644,3,7644,[265 211 318 161 405],450,5,31322,4.097056899934598,20.0,0.0
37645,3,7645,[ 56 179 423 603 175],18,4,31326,4.097044206120848,20.0,0.0
37646,3,7646,[ 79 175 288 275 318],655,3,31329,4.096900745390349,20.0,20.0
37647,3,7647,[174   1 282 121 286],796,3,31332,4.0967573221757325,0.0,20.0
37648,3,7648,[318 427  98 191 182],655,5,31337,4.0968754085501375,40.0,0.0
37649,3,7649,[318 427  98 191 182],18,5,31342,4.096993464052288,40.0,0.0
37650,3,7650,[318 427  98 191 182],796,5,31347,4.0971114886942885,40.0,0.0
37651,3,7651,[282 427 385 202 496],796,5,31352,4.097229482488238,40.0,0.0
37652,3,7652,[ 98 496 200  82 127],450,3,31355,4.097086110022214,20.0,20.0
37653,3,7653,[ 97 125 210 301 197],796,1,31356,4.096681473739221,0.0,0.0
37654,3,7654,[ 56 197 174 471  79],716,4,31360,4.09666884389288,0.0,0.0
37655,3,7655,[ 22 176 237 210 204],457,5,31365,4.096786833855799,0.0,0.0
37656,3,7656,[318 427  98 191 182],450,5,31370,4.09690479299987,40.0,0.0
37657,3,7657,[427 202 161 127 588],716,4,31374,4.096892138939671,20.0,20.0
37658,3,7658,[245 118  96 127 174],450,4,31378,4.096879488183836,0.0,20.0
37659,3,7659,[153 180  11   7  22],280,5,31383,4.096997389033943,0.0,0.0
37660,3,7660,[318 427  98 191 182],72,5,31388,4.097115259104555,40.0,0.0
37661,3,7661,[ 25  15  12 313 603],450,3,31391,4.096972069955625,20.0,0.0
37662,3,7662,[176 125 403 483 121],457,5,31396,4.097089912566879,0.0,0.0
37663,3,7663,[318 427  98 191 182],655,5,31401,4.097207724425887,40.0,0.0
37664,3,7664,[403  50 286 185 181],18,2,31403,4.096934116112198,0.0,40.0
37665,3,7665,[237 222  25  82 228],256,4,31407,4.096921471432299,0.0,0.0
37666,3,7666,[318 427  98 191 182],655,5,31412,4.097039259162645,40.0,0.0
37667,3,7667,[318 427  98 191 182],655,5,31417,4.097157016171101,40.0,0.0
37668,3,7668,[318 427  98 191 182],269,5,31422,4.097274742469683,40.0,0.0
37669,3,7669,[318 427  98 191 182],269,5,31427,4.097392438070404,40.0,0.0
37670,3,7670,[318 427  98 191 182],18,5,31432,4.097510102985269,40.0,0.0
37671,3,7671,[318 427  98 191 182],269,5,31437,4.0976277372262775,40.0,0.0
37672,3,7672,[117  79 202 318 186],450,4,31441,4.097615013684348,20.0,0.0
37673,3,7673,[318 427  98 191 182],796,5,31446,4.09773260359656,40.0,0.0
37674,3,7674,[471 161  88 403  96],693,1,31447,4.0973289902280134,0.0,0.0
37675,3,7675,[294 318 181 483   9],655,2,31449,4.0970557582074,20.0,0.0
37676,3,7676,[197 172 132 195 183],280,1,31450,4.096652338152924,0.0,0.0
37677,3,7677,[318 427  98 191 182],269,5,31455,4.096769992185465,40.0,0.0
37678,3,7678,[100 216  22  69 237],330,5,31460,4.0968876155749445,0.0,20.0
37679,3,7679,[ 25 265  89  69 238],457,5,31465,4.097005208333333,0.0,0.0
37680,3,7680,[191 125  12 197  89],151,4,31469,4.096992579091264,0.0,0.0
37681,3,7681,[318 427  98 191 182],655,5,31474,4.097110127570945,40.0,0.0
37682,3,7682,[210 111 515 588 294],401,3,31477,4.096967330469869,0.0,0.0
37683,3,7683,[273 655 235 403 588],450,3,31480,4.096824570536179,0.0,0.0
37684,3,7684,[  4  88 181 182  79],389,4,31484,4.096811971372804,0.0,0.0
37685,3,7685,[318 427  98 191 182],269,5,31489,4.096929482175383,40.0,0.0
37686,3,7686,[318 427  98 191 182],72,5,31494,4.097046962404058,40.0,0.0
37687,3,7687,[318 427  98 191 182],655,5,31499,4.09716441207076,40.0,0.0
37688,3,7688,[318 427  98 191 182],72,5,31504,4.09728183118741,40.0,0.0
37689,3,7689,[318 427  98 191 182],269,5,31509,4.09739921976593,40.0,0.0
37690,3,7690,[ 22 588 385 403 191],457,5,31514,4.097516577818229,0.0,0.0
37691,3,7691,[196 301 288 237  69],655,0,31514,4.096983879355174,0.0,0.0
37692,3,7692,[427  56 333 111 271],655,1,31515,4.0965813076823085,20.0,0.0
37693,3,7693,[318 427  98 191 182],796,5,31520,4.096698726280218,40.0,0.0
37694,3,7694,[318 427  98 191 182],450,5,31525,4.096816114359974,40.0,0.0
37695,3,7695,[318 427  98 191 182],796,5,31530,4.096933471933472,40.0,0.0
37696,3,7696,[121 257  22 483 143],655,2,31532,4.096661036767572,0.0,0.0
37697,3,7697,[318 427  98 191 182],450,5,31537,4.096778383995843,40.0,0.0
37698,3,7698,[318 427  98 191 182],655,5,31542,4.0968957007403555,40.0,0.0
37699,3,7699,[318 427  98 191 182],72,5,31547,4.097012987012987,40.0,0.0
37700,3,7700,[318 427  98 191 182],18,5,31552,4.097130242825607,40.0,0.0
37701,3,7701,[  9 322 385 546  88],796,3,31555,4.0969877953778235,0.0,0.0
37702,3,7702,[318 427  98 191 182],269,5,31560,4.097105024016617,40.0,0.0
37703,3,7703,[318 427  98 191 182],269,5,31565,4.097222222222222,40.0,0.0
37704,3,7704,[318 427  98 191 182],796,5,31570,4.097339390006489,40.0,0.0
37705,3,7705,[194 405 210 403 191],798,5,31575,4.0974565273812615,0.0,0.0
37706,3,7706,[318 427  98 191 182],655,5,31580,4.097573634358375,40.0,0.0
37707,3,7707,[318 427  98 191 182],18,5,31585,4.097690710949663,40.0,0.0
37708,3,7708,[172 275 655  97 257],716,5,31590,4.097807757166947,0.0,20.0
37709,3,7709,[183 333 143  28 271],655,2,31592,4.097535667963683,0.0,0.0
37710,3,7710,[318 427  98 191 182],796,5,31597,4.097652703929452,40.0,0.0
37711,3,7711,[215 202 655  70 200],151,3,31600,4.097510373443983,0.0,0.0
37712,3,7712,[117 427 288   1 742],655,1,31601,4.097108777388824,20.0,0.0
37713,3,7713,[318 427  98 191 182],18,5,31606,4.097225823178636,40.0,0.0
37714,3,7714,[318 427  98 191 182],18,5,31611,4.097342838626053,40.0,0.0
37715,3,7715,[ 88 182 235 318 181],269,2,31613,4.097071021254536,20.0,0.0
37716,3,7716,[135 300 603 172 117],655,3,31616,4.09692885836465,20.0,0.0
37717,3,7717,[318 427  98 191 182],450,5,31621,4.097045866804872,40.0,0.0
37718,3,7718,[318 427  98 191 182],450,5,31626,4.0971628449281,40.0,0.0
37719,3,7719,[194 121 202 257 357],716,5,31631,4.097279792746114,0.0,0.0
37720,3,7720,[ 97 471 403   8  95],577,4,31635,4.097267193368735,0.0,0.0
37721,3,7721,[143 194 176 385 546],151,2,31637,4.096995596995597,0.0,0.0
37722,3,7722,[ 22 191 271 172 268],655,2,31639,4.096724070956882,0.0,0.0
37723,3,7723,[ 69 186 655  56 588],716,4,31643,4.096711548420507,0.0,0.0
37724,3,7724,[318 427  98 191 182],655,5,31648,4.096828478964401,40.0,0.0
37725,3,7725,[ 56  28 275 318  22],457,5,31653,4.096945379238933,20.0,20.0
37726,3,7726,[  9 197  64  82 313],655,2,31655,4.096674000258833,20.0,0.0
37727,3,7727,[245 568  69  71  98],450,4,31659,4.09666149068323,0.0,0.0
37728,3,7728,[318 427  98 191 182],18,5,31664,4.096778367188511,40.0,0.0
37729,3,7729,[318 427  98 191 182],269,5,31669,4.096895213454075,40.0,0.0
37730,3,7730,[318 427  98 191 182],655,5,31674,4.0970120294916565,40.0,0.0
37731,3,7731,[271  50  89  79  69],807,4,31678,4.096999482669426,0.0,20.0
37732,3,7732,[ 12 118 195 222  22],655,0,31678,4.096469675417044,0.0,0.0
37733,3,7733,[194 328 176 211 234],796,3,31681,4.096327902767003,0.0,0.0
37734,3,7734,[318 427  98 191 182],72,5,31686,4.096444731738849,40.0,0.0
37735,3,7735,[181  79 237 118  69],344,1,31687,4.096044467425026,0.0,0.0
37736,3,7736,[568 196 328 301  15],450,4,31691,4.09603205376761,0.0,0.0
37737,3,7737,[318 427  98 191 182],18,5,31696,4.09614887567847,40.0,0.0
37738,3,7738,[318 427  98 191 182],450,5,31701,4.096265667398889,40.0,0.0
37739,3,7739,[318 427  98 191 182],796,5,31706,4.096382428940569,40.0,0.0
37740,3,7740,[318 427  98 191 182],72,5,31711,4.096499160315204,40.0,0.0
37741,3,7741,[318 427  98 191 182],18,5,31716,4.096615861534487,40.0,0.0
37742,3,7742,[318 427  98 191 182],655,5,31721,4.096732532610099,40.0,0.0
37743,3,7743,[  1 204 195 210 271],655,0,31721,4.096203512396694,0.0,0.0
37744,3,7744,[318 427  98 191 182],72,5,31726,4.096320206584894,40.0,0.0
37745,3,7745,[235 143 181 132 496],330,5,31731,4.096436870642912,20.0,0.0
37746,3,7746,[318 427  98 191 182],18,5,31736,4.096553504582419,40.0,0.0
37747,3,7747,[318 427  98 191 182],18,5,31741,4.096670108415075,40.0,0.0
37748,3,7748,[568 357 210  71 176],450,3,31744,4.096528584333463,0.0,0.0
37749,3,7749,[282  50 210 168 471],535,4,31748,4.096516129032258,0.0,20.0
37750,3,7750,[318 427  98 191 182],18,5,31753,4.096632692555799,40.0,0.0
37751,3,7751,[204 237 151  96 176],577,5,31758,4.0967492260061915,0.0,0.0
37752,3,7752,[318 427  98 191 182],655,5,31763,4.0968657293950725,40.0,0.0
37753,3,7753,[ 25 273 210 228 546],344,4,31767,4.096853237038948,0.0,0.0
37754,3,7754,[196 210 174   1 117],796,3,31770,4.096711798839459,0.0,0.0
37755,3,7755,[117 200   4 111  28],450,3,31773,4.096570397111913,0.0,0.0
37756,3,7756,[143 318 222 385   9],457,5,31778,4.096686863478149,20.0,0.0
37757,3,7757,[318 427  98 191 182],269,5,31783,4.096803299819541,40.0,0.0
37758,3,7758,[655 202 196 143 181],401,3,31786,4.096661940971774,0.0,0.0
37759,3,7759,[318 427  98 191 182],18,5,31791,4.096778350515464,40.0,0.0
37760,3,7760,[173 200 161   4  69],577,4,31795,4.096765880685479,0.0,0.0
37761,3,7761,[175 405 191 237 121],457,5,31800,4.096882246843597,0.0,0.0
37762,3,7762,[222 151 748 271 234],796,4,31804,4.096869766842715,0.0,0.0
37763,3,7763,[508 385 173  95 176],344,4,31808,4.096857290056672,0.0,0.0
37764,3,7764,[ 79 275 211   1 496],18,5,31813,4.096973599484868,20.0,20.0
37765,3,7765,[318 427  98 191 182],655,5,31818,4.097089878959568,40.0,0.0
37766,3,7766,[276 185 143 121   4],655,3,31821,4.096948628814214,0.0,0.0
37767,3,7767,[328  71 265 211 100],236,1,31822,4.096549948506694,0.0,20.0
37768,3,7768,[405 215 435 268 318],655,1,31823,4.096151370832797,20.0,0.0
37769,3,7769,[333 222  22 100  89],655,1,31824,4.095752895752896,0.0,20.0
37770,3,7770,[200 385 175 568 191],716,3,31827,4.095611890361601,0.0,0.0
37771,3,7771,[276 288  64 471 195],457,5,31832,4.095728255275348,20.0,0.0
37772,3,7772,[318 427  98 191 182],269,5,31837,4.095844590248295,40.0,0.0
37773,3,7773,[  1 204 748 313 588],807,5,31842,4.095960895291999,0.0,0.0
37774,3,7774,[318 427  98 191 182],450,5,31847,4.096077170418006,40.0,0.0
37775,3,7775,[318 427  98 191 182],18,5,31852,4.09619341563786,40.0,0.0
37776,3,7776,[318 427  98 191 182],796,5,31857,4.096309630963097,40.0,0.0
37777,3,7777,[318 427  98 191 182],450,5,31862,4.096425816405246,40.0,0.0
37778,3,7778,[174 143 655 153 195],450,5,31867,4.0965419719758325,0.0,0.0
37779,3,7779,[ 28  50 210 186 238],450,3,31870,4.096401028277635,0.0,20.0
37780,3,7780,[275  22 121  89 235],457,4,31874,4.096388638992417,0.0,20.0
37781,3,7781,[182 194 151   8 268],269,4,31878,4.096376252891288,0.0,0.0
37782,3,7782,[161  79 655 423 275],796,4,31882,4.096363869973018,0.0,20.0
37783,3,7783,[318 427  98 191 182],18,5,31887,4.096479958890031,40.0,0.0
37784,3,7784,[143  97  96 282  15],450,4,31891,4.096467565831728,0.0,0.0
37785,3,7785,[318 427  98 191 182],796,5,31896,4.096583611610583,40.0,0.0
37786,3,7786,[ 25 183 161 385 121],655,1,31897,4.096185950943881,0.0,0.0
37787,3,7787,[176 174 237 471 181],457,5,31902,4.096302003081664,0.0,0.0
37788,3,7788,[318 427  98 191 182],18,5,31907,4.096418025420465,40.0,0.0
37789,3,7789,[318 427  98 191 182],72,5,31912,4.096534017971758,40.0,0.0
37790,3,7790,[318 427  98 191 182],655,5,31917,4.096649980747015,40.0,0.0
37791,3,7791,[403 237  69 423 194],18,1,31918,4.096252566735113,0.0,0.0
37792,3,7792,[318 427  98 191 182],450,5,31923,4.09636853586552,40.0,0.0
37793,3,7793,[  4 183  79 153 127],655,3,31926,4.096227867590454,0.0,20.0
37794,3,7794,[318 427  98 191 182],72,5,31931,4.096343810134702,40.0,0.0
37795,3,7795,[318 427  98 191 182],655,5,31936,4.0964597229348385,40.0,0.0
37796,3,7796,[318 427  98 191 182],655,5,31941,4.096575606002308,40.0,0.0
37797,3,7797,[318 427  98 191 182],18,5,31946,4.096691459348551,40.0,0.0
37798,3,7798,[318 427  98 191 182],450,5,31951,4.096807282984998,40.0,0.0
37799,3,7799,[195 603 265 483 228],292,5,31956,4.096923076923077,20.0,0.0
37800,3,7800,[496 111  15 127 357],450,4,31960,4.096910652480451,20.0,20.0
37801,3,7801,[328 135 153 333 269],655,1,31961,4.096513714432197,0.0,0.0
37802,3,7802,[318 427  98 191 182],269,5,31966,4.096629501473792,40.0,0.0
37803,3,7803,[508 294 405 235 125],280,1,31967,4.096232701178883,0.0,0.0
37804,3,7804,[237 427 121 302  88],655,2,31969,4.095964125560538,20.0,0.0
37805,3,7805,[318 427  98 191 182],269,5,31974,4.096079938508839,40.0,0.0
37806,3,7806,[318 427  98 191 182],655,5,31979,4.096195721788139,40.0,0.0
37807,3,7807,[318 427  98 191 182],72,5,31984,4.096311475409836,40.0,0.0
37808,3,7808,[ 98 423  79 173 202],23,3,31987,4.096171084645921,0.0,0.0
37809,3,7809,[318 427  98 191 182],796,5,31992,4.09628681177977,40.0,0.0
37810,3,7810,[471 318 282 216 182],450,5,31997,4.096402509281782,20.0,0.0
37811,3,7811,[742 182 568 655  64],796,3,32000,4.09626216077829,20.0,0.0
37812,3,7812,[318 427  98 191 182],18,5,32005,4.096377831818764,40.0,0.0
37813,3,7813,[318 427  98 191 182],18,5,32010,4.096493473253135,40.0,0.0
37814,3,7814,[ 82 483  69 222 187],716,4,32014,4.096481126039667,0.0,0.0
37815,3,7815,[135 100  82 197  22],280,2,32016,4.096212896622313,0.0,20.0
37816,3,7816,[118  69 172 271 385],655,1,32017,4.095816809517718,0.0,0.0
37817,3,7817,[318 427  98 191 182],796,5,32022,4.0959324635456635,40.0,0.0
37818,3,7818,[318 427  98 191 182],450,5,32027,4.096048087990791,40.0,0.0
37819,3,7819,[ 70 211 185  98 238],151,5,32032,4.09616368286445,0.0,0.0
37820,3,7820,[318 427  98 191 182],655,5,32037,4.096279248177982,40.0,0.0
37821,3,7821,[153 568 210  96 257],655,0,32037,4.095755561237535,0.0,0.0
37822,3,7822,[318 427  98 191 182],18,5,32042,4.095871149175508,40.0,0.0
37823,3,7823,[318 427  98 191 182],269,5,32047,4.095986707566462,40.0,0.0
37824,3,7824,[143 328  71   1 195],796,4,32051,4.095974440894569,0.0,0.0
37825,3,7825,[318 427  98 191 182],269,5,32056,4.096089956555073,40.0,0.0
37826,3,7826,[318 427  98 191 182],72,5,32061,4.096205442698352,40.0,0.0
37827,3,7827,[  1 294 742  11  56],280,4,32065,4.096193152784875,0.0,0.0
37828,3,7828,[318 427  98 191 182],18,5,32070,4.096308596244731,40.0,0.0
37829,3,7829,[655 144 202   7  28],457,5,32075,4.096424010217114,0.0,0.0
37830,3,7830,[318 427  98 191 182],796,5,32080,4.096539394713319,40.0,0.0
37831,3,7831,[194 301 496 172 282],450,5,32085,4.096654749744637,20.0,0.0
37832,3,7832,[161 228 182   8 318],280,3,32088,4.096514745308311,20.0,0.0
37833,3,7833,[318 427  98 191 182],18,5,32093,4.096630074036252,40.0,0.0
37834,3,7834,[318 427  98 191 182],796,5,32098,4.096745373324825,40.0,0.0
37835,3,7835,[238  15 117 245 153],593,4,32102,4.096733027054619,0.0,0.0
37836,3,7836,[238 568   8 182 273],655,2,32104,4.096465484241419,0.0,0.0
37837,3,7837,[181  50 100  12 172],352,5,32109,4.09658076039806,0.0,40.0
37838,3,7838,[196 475 168 182 132],269,4,32113,4.096568439852022,0.0,0.0
37839,3,7839,[ 69 328  11 179   4],450,4,32117,4.0965561224489795,0.0,0.0
37840,3,7840,[427 222 132 597  96],23,4,32121,4.0965438081877315,20.0,0.0
37841,3,7841,[ 64  95  69 210  15],389,2,32123,4.096276460086712,20.0,0.0
37842,3,7842,[318 427  98 191 182],655,5,32128,4.09639168685452,40.0,0.0
37843,3,7843,[ 69 275 181 300  88],716,5,32133,4.096506884242733,0.0,20.0
37844,3,7844,[186 181 196  97 153],655,0,32133,4.095984703632888,0.0,0.0
37845,3,7845,[748 286 318 405 568],450,5,32138,4.0960999235279125,20.0,20.0
37846,3,7846,[318 427  98 191 182],269,5,32143,4.096215114056327,40.0,0.0
37847,3,7847,[176 385  50 197  28],655,1,32144,4.095820591233435,0.0,20.0
37848,3,7848,[603  25 435 238 301],151,5,32149,4.095935787998471,20.0,0.0
37849,3,7849,[318 427  98 191 182],450,5,32154,4.096050955414013,40.0,0.0
37850,3,7850,[318 427  98 191 182],72,5,32159,4.096166093491275,40.0,0.0
37851,3,7851,[318 427  98 191 182],450,5,32164,4.096281202241467,40.0,0.0
37852,3,7852,[ 56  64 357 286 742],796,3,32167,4.096141601935566,20.0,20.0
37853,3,7853,[318 427  98 191 182],72,5,32172,4.096256684491979,40.0,0.0
37854,3,7854,[318 427  98 191 182],655,5,32177,4.096371737746658,40.0,0.0
37855,3,7855,[318 427  98 191 182],796,5,32182,4.0964867617107945,40.0,0.0
37856,3,7856,[179  97  15 313 568],577,2,32184,4.096219931271477,0.0,0.0
37857,3,7857,[204  12 222  88 475],655,0,32184,4.0956986510562485,0.0,0.0
37858,3,7858,[357 100 323 258 204],796,3,32187,4.095559231454383,0.0,20.0
37859,3,7859,[655  56 173 273 196],796,3,32190,4.095419847328245,0.0,0.0
37860,3,7860,[318 427  98 191 182],796,5,32195,4.095534919221473,40.0,0.0
37861,3,7861,[318 427  98 191 182],72,5,32200,4.0956499618417705,40.0,0.0
37862,3,7862,[318 427  98 191 182],450,5,32205,4.095764975200305,40.0,0.0
37863,3,7863,[318 427  98 191 182],450,5,32210,4.09587995930824,40.0,0.0
37864,3,7864,[ 15  95 496 200 748],450,2,32212,4.095613477431659,20.0,0.0
37865,3,7865,[176 423  71 185 172],389,5,32217,4.095728451563692,0.0,0.0
37866,3,7866,[318 427  98 191 182],450,5,32222,4.095843396466251,40.0,0.0
37867,3,7867,[318 427  98 191 182],269,5,32227,4.095958312150483,40.0,0.0
37868,3,7868,[216 185 258 588 118],450,4,32231,4.09594611767696,0.0,0.0
37869,3,7869,[318 427  98 191 182],18,5,32236,4.096060991105464,40.0,0.0
37870,3,7870,[318 427  98 191 182],269,5,32241,4.096175835344937,40.0,0.0
37871,3,7871,[318 427  98 191 182],796,5,32246,4.096290650406504,40.0,0.0
37872,3,7872,[289 153 143  56  98],236,4,32250,4.096278419916169,0.0,0.0
37873,3,7873,[ 25 100 182 282 300],655,1,32251,4.095885191770384,0.0,20.0
37874,3,7874,[318 427  98 191 182],796,5,32256,4.096,40.0,0.0
37875,3,7875,[318 427  98 191 182],450,5,32261,4.096114779075673,40.0,0.0
37876,3,7876,[318 427  98 191 182],72,5,32266,4.096229529008506,40.0,0.0
37877,3,7877,[300   4 186 258 172],796,4,32270,4.096217314039096,0.0,0.0
37878,3,7878,[180  88 328 210 216],796,3,32273,4.096078182510471,0.0,0.0
37879,3,7879,[318 427  98 191 182],655,5,32278,4.096192893401016,40.0,0.0
37880,3,7880,[144 568 597 183 121],593,4,32282,4.096180687729984,0.0,0.0
37881,3,7881,[318 427  98 191 182],18,5,32287,4.0962953565085005,40.0,0.0
37882,3,7882,[275 546  25 127 268],503,5,32292,4.0964099961943425,0.0,40.0
37883,3,7883,[161 423 301 655  22],796,3,32295,4.096270928462709,0.0,0.0
37884,3,7884,[568 144 216 161 288],436,5,32300,4.096385542168675,0.0,0.0
37885,3,7885,[271   7 435 186 515],655,1,32301,4.0959928988080145,0.0,0.0
37886,3,7886,[176 234 655 174 216],786,4,32305,4.0959807277798905,0.0,0.0
37887,3,7887,[318 427  98 191 182],18,5,32310,4.096095334685598,40.0,0.0
37888,3,7888,[318 427  98 191 182],450,5,32315,4.096209912536443,40.0,0.0
37889,3,7889,[318 427  98 191 182],72,5,32320,4.096324461343473,40.0,0.0
37890,3,7890,[ 97 118 269 111 182],655,1,32321,4.095932074515271,0.0,0.0
37891,3,7891,[196 435 597 313  97],450,5,32326,4.096046629498226,0.0,0.0
37892,3,7892,[302 385  96 258 125],344,2,32328,4.095781071835804,0.0,0.0
37893,3,7893,[318 427  98 191 182],655,5,32333,4.095895616924246,40.0,0.0
37894,3,7894,[ 79 172   4 742 202],256,3,32336,4.095756808106397,0.0,0.0
37895,3,7895,[318 427  98 191 182],655,5,32341,4.095871327254306,40.0,0.0
37896,3,7896,[211 117  98 111 318],655,2,32343,4.095605926301127,20.0,0.0
37897,3,7897,[153 191 135 275 187],655,4,32347,4.095593821220562,0.0,20.0
37898,3,7898,[318 427  98 191 182],796,5,32352,4.095708317508546,40.0,0.0
37899,3,7899,[121 282 258  98 508],535,3,32355,4.095569620253165,0.0,0.0
37900,3,7900,[318 427  98 191 182],655,5,32360,4.0956840906214405,40.0,0.0
37901,3,7901,[121 245 185 168 216],796,4,32364,4.095671981776765,0.0,0.0
37902,3,7902,[318 427  98 191 182],796,5,32369,4.095786410223965,40.0,0.0
37903,3,7903,[  7 301 603  70 186],655,1,32370,4.095394736842105,20.0,0.0
37904,3,7904,[318 427  98 191 182],796,5,32375,4.0955091714105,40.0,0.0
37905,3,7905,[194 603 185 179 180],18,2,32377,4.095244118391095,20.0,0.0
37906,3,7906,[172  79 275 385 174],655,3,32380,4.09510560263058,0.0,20.0
37907,3,7907,[ 11 238 194 121 215],450,4,32384,4.095093576125443,0.0,0.0
37908,3,7908,[318 427  98 191 182],18,5,32389,4.095207990896447,40.0,0.0
37909,3,7909,[194 515 215 204  56],18,2,32391,4.094943109987358,0.0,0.0
37910,3,7910,[151 508 195 202   1],344,4,32395,4.094931108582986,0.0,0.0
37911,3,7911,[318 427  98 191 182],796,5,32400,4.095045500505561,40.0,0.0
37912,3,7912,[172   1  11  79  50],296,5,32405,4.095159863515733,0.0,20.0
37913,3,7913,[194  98 121 546 180],796,4,32409,4.095147839272176,0.0,0.0
37914,3,7914,[294 742 216 143 132],450,5,32414,4.0952621604548325,0.0,0.0
37915,3,7915,[318 427  98 191 182],450,5,32419,4.095376452753916,40.0,0.0
37916,3,7916,[318 427  98 191 182],796,5,32424,4.095490716180372,40.0,0.0
37917,3,7917,[194 151 286 405  64],450,5,32429,4.0956049507451375,20.0,20.0
37918,3,7918,[ 22 168 174 153  79],716,5,32434,4.095719156459149,0.0,0.0
37919,3,7919,[318 427  98 191 182],269,5,32439,4.095833333333333,40.0,0.0
37920,3,7920,[172 405 179  15 117],450,4,32443,4.09582123469259,0.0,0.0
37921,3,7921,[210 200 100  12 144],450,3,32446,4.095682908356475,0.0,20.0
37922,3,7922,[318 427  98 191 182],269,5,32451,4.095797046573268,40.0,0.0
37923,3,7923,[318 427  98 191 182],72,5,32456,4.0959111559818275,40.0,0.0
37924,3,7924,[125  12 216 748 127],450,5,32461,4.09602523659306,0.0,20.0
37925,3,7925,[ 50  15 210 153 195],151,3,32464,4.09588695432753,0.0,20.0
37926,3,7926,[318 427  98 191 182],18,5,32469,4.096001009209032,40.0,0.0
37927,3,7927,[187 435 258 748 275],450,5,32474,4.096115035317861,0.0,20.0
37928,3,7928,[143 197 174 172 200],716,5,32479,4.096229032664901,0.0,0.0
37929,3,7929,[204  69  88 483  82],655,1,32480,4.095838587641866,0.0,0.0
37930,3,7930,[132 515 174 216 265],655,2,32482,4.095574328584037,0.0,0.0
37931,3,7931,[125  50 153 294 245],450,5,32487,4.095688350983359,0.0,20.0
37932,3,7932,[475 603 125 179 300],655,2,32489,4.095424177486449,20.0,0.0
37933,3,7933,[276 204  15  50 179],655,3,32492,4.09528611041089,0.0,20.0
37934,3,7934,[111 313 282 483 269],296,4,32496,4.0952741020793955,0.0,0.0
37935,3,7935,[318 427  98 191 182],269,5,32501,4.09538810483871,40.0,0.0
37936,3,7936,[318 427  98 191 182],450,5,32506,4.09550207887111,40.0,0.0
37937,3,7937,[  1 173 234  88 597],450,4,32510,4.095490047871,0.0,0.0
37938,3,7938,[318 427  98 191 182],450,5,32515,4.0956039803501705,40.0,0.0
37939,3,7939,[286  88 282  98 276],280,3,32518,4.0954659949622165,0.0,20.0
37940,3,7940,[318 427  98 191 182],655,5,32523,4.095579901775595,40.0,0.0
37941,3,7941,[185 742  50  97 191],655,3,32526,4.095441954167716,0.0,20.0
37942,3,7942,[423 385 318 276 181],655,2,32528,4.09517814427798,20.0,0.0
37943,3,7943,[318 427  98 191 182],450,5,32533,4.095292044310171,40.0,0.0
37944,3,7944,[ 11 300 168 276 483],535,3,32536,4.095154185022026,0.0,0.0
37945,3,7945,[318 427  98 191 182],18,5,32541,4.095268059400956,40.0,0.0
37946,3,7946,[179  56  22 483  98],18,5,32546,4.095381905121429,0.0,0.0
37947,3,7947,[144 276 127 111 125],436,5,32551,4.095495722194262,0.0,20.0
37948,3,7948,[172 508 194 265 471],535,3,32554,4.095357906654925,0.0,0.0
37949,3,7949,[275   9 588 286 323],796,2,32556,4.095094339622642,0.0,40.0
37950,3,7950,[268  11  12  98 191],344,3,32559,4.094956609231543,0.0,0.0
37951,3,7951,[168 222 185  11 176],450,4,32563,4.094944668008048,0.0,0.0
37952,3,7952,[286  15 333 483 215],655,1,32564,4.094555513642651,0.0,20.0
37953,3,7953,[258  79  70 655 100],457,5,32569,4.094669348755343,0.0,20.0
37954,3,7954,[211  22 228 483 268],296,5,32574,4.094783155248272,0.0,0.0
37955,3,7955,[318 427  98 191 182],269,5,32579,4.094896933132227,40.0,0.0
37956,3,7956,[ 15 423   8 186 195],269,1,32580,4.094507980394621,0.0,0.0
37957,3,7957,[318 427  98 191 182],450,5,32585,4.094621764262378,40.0,0.0
37958,3,7958,[318 427  98 191 182],450,5,32590,4.094735519537631,40.0,0.0
37959,3,7959,[ 56  22 357 121 271],796,5,32595,4.094849246231155,0.0,0.0
37960,3,7960,[215 300  12 288 273],693,2,32597,4.0945861072729555,0.0,0.0
37961,3,7961,[172  69 151  56 427],716,5,32602,4.094699824164783,20.0,0.0
37962,3,7962,[318 427  98 191 182],796,5,32607,4.094813512495291,40.0,0.0
37963,3,7963,[318 427  98 191 182],796,5,32612,4.094927172275239,40.0,0.0
37964,3,7964,[195   4 515 423 294],716,3,32615,4.094789704959196,0.0,0.0
37965,3,7965,[318 427  98 191 182],269,5,32620,4.094903339191564,40.0,0.0
37966,3,7966,[143 153 195 100 200],18,3,32623,4.094765909376177,0.0,20.0
37967,3,7967,[ 79   9  25 195  98],693,4,32627,4.094754016064257,0.0,0.0
37968,3,7968,[172  15 161 144  89],655,2,32629,4.094491153218723,0.0,0.0
37969,3,7969,[294 742 301  70 228],655,0,32629,4.0939774153074024,0.0,0.0
37970,3,7970,[318 427  98 191 182],18,5,32634,4.0940910801656,40.0,0.0
37971,3,7971,[216  50   8 176 471],280,2,32636,4.093828399397893,0.0,20.0
37972,3,7972,[318 427  98 191 182],450,5,32641,4.093942054433714,40.0,0.0
37973,3,7973,[318 427  98 191 182],655,5,32646,4.09405568096313,40.0,0.0
37974,3,7974,[215   8 174   9 357],796,4,32650,4.094043887147335,0.0,0.0
37975,3,7975,[265 257 603  56 289],655,1,32651,4.093655967903711,20.0,0.0
37976,3,7976,[546  12 194 197   1],450,5,32656,4.093769587564247,0.0,0.0
37977,3,7977,[318 427  98 191 182],450,5,32661,4.093883178741539,40.0,0.0
37978,3,7978,[318 427  98 191 182],269,5,32666,4.093996741446296,40.0,0.0
37979,3,7979,[435 176 483 135 111],450,3,32669,4.093859649122807,0.0,0.0
37980,3,7980,[322 211 238 258 121],504,4,32673,4.0938478887357475,0.0,0.0
37981,3,7981,[  1 333 144 172 313],796,4,32677,4.093836131295415,0.0,0.0
37982,3,7982,[ 97 210 515 269 568],655,1,32678,4.093448578228736,0.0,0.0
37983,3,7983,[276 111 172  88 385],344,3,32681,4.093311623246493,0.0,0.0
37984,3,7984,[318 427  98 191 182],269,5,32686,4.093425172197871,40.0,0.0
37985,3,7985,[318 427  98 191 182],18,5,32691,4.093538692712246,40.0,0.0
37986,3,7986,[300 483 265 185 294],655,2,32693,4.093276574433454,0.0,0.0
37987,3,7987,[194  28   1  50 191],457,5,32698,4.093390085127692,0.0,20.0
37988,3,7988,[  4 161 222 143  96],796,5,32703,4.0935035674051825,0.0,0.0
37989,3,7989,[318 427  98 191 182],72,5,32708,4.093617021276596,40.0,0.0
37990,3,7990,[318 427  98 191 182],72,5,32713,4.093730446752597,40.0,0.0
37991,3,7991,[161 181 546 200 265],577,3,32716,4.093593593593593,0.0,0.0
37992,3,7992,[301 125 655 151 191],450,5,32721,4.093706993619417,0.0,0.0
37993,3,7993,[318 427  98 191 182],18,5,32726,4.093820365273955,40.0,0.0
37994,3,7994,[546  69  98 183 273],344,3,32729,4.093683552220138,0.0,0.0
37995,3,7995,[318 427  98 191 182],655,5,32734,4.093796898449225,40.0,0.0
37996,3,7996,[318 427  98 191 182],18,5,32739,4.093910216331124,40.0,0.0
37997,3,7997,[234 132 135 117  28],716,4,32743,4.093898474618655,0.0,0.0
37998,3,7998,[153 144 313 161 471],593,4,32747,4.093886735841981,0.0,0.0
37999,3,7999,[318 427  98 191 182],655,5,32752,4.094,40.0,0.0
38000,3,8000,[ 70  82 204 174 483],23,2,32754,4.093738282714661,0.0,0.0
38001,3,8001,[318 427  98 191 182],269,5,32759,4.093851537115721,40.0,0.0
38002,3,8002,[ 70  69 238 180 318],716,4,32763,4.093839810071223,20.0,0.0
38003,3,8003,[183 216 475  82 300],655,2,32765,4.093578210894552,0.0,0.0
38004,3,8004,[265 175 200   8  25],655,1,32766,4.093191755153029,0.0,0.0
38005,3,8005,[  8 121 313 175 483],655,2,32768,4.092930302273295,0.0,0.0
38006,3,8006,[216 273 118  71 182],796,4,32772,4.0929186961408766,0.0,0.0
38007,3,8007,[ 96  88   8 222 742],756,2,32774,4.0926573426573425,0.0,0.0
38008,3,8008,[174 125 222 117 186],655,0,32774,4.092146335372706,0.0,0.0
38009,3,8009,[318 427  98 191 182],655,5,32779,4.092259675405743,40.0,0.0
38010,3,8010,[318 427  98 191 182],269,5,32784,4.092372987142679,40.0,0.0
38011,3,8011,[318 427  98 191 182],269,5,32789,4.092486270594109,40.0,0.0
38012,3,8012,[265 187 118  82 496],716,3,32792,4.092349931361538,20.0,0.0
38013,3,8013,[111 153 186  56 405],269,1,32793,4.091964062889943,0.0,0.0
38014,3,8014,[273 546 301 151 323],796,2,32795,4.091703056768559,0.0,0.0
38015,3,8015,[ 56 187  69 238  88],18,3,32798,4.091566866267465,0.0,0.0
38016,3,8016,[318 427  98 191 182],655,5,32803,4.091680179618311,40.0,0.0
38017,3,8017,[ 95 403 197 117 234],796,3,32806,4.091544025941631,0.0,0.0
38018,3,8018,[187 427 257 216  71],796,5,32811,4.091657313879536,20.0,0.0
38019,3,8019,[215  70 385 403 282],457,5,32816,4.091770573566085,0.0,0.0
38020,3,8020,[546 135 483 282 288],457,4,32820,4.091759132277771,0.0,0.0
38021,3,8021,[678  11 210 172 174],280,1,32821,4.091373722263775,0.0,0.0
38022,3,8022,[318 427  98 191 182],269,5,32826,4.091486974947028,40.0,0.0
38023,3,8023,[182 313 318 405 211],593,3,32829,4.091350947158524,20.0,0.0
38024,3,8024,[234  79  82  88 100],457,5,32834,4.091464174454829,0.0,20.0
38025,3,8025,[318 427  98 191 182],269,5,32839,4.091577373536008,40.0,0.0
38026,3,8026,[318 427  98 191 182],72,5,32844,4.091690544412607,40.0,0.0
38027,3,8027,[182 195 276 175 496],269,4,32848,4.091679123069258,20.0,0.0
38028,3,8028,[568  98 546  25 144],593,3,32851,4.091543156059285,0.0,0.0
38029,3,8029,[318 427  98 191 182],450,5,32856,4.091656288916563,40.0,0.0
38030,3,8030,[318 427  98 191 182],796,5,32861,4.091769393599801,40.0,0.0
38031,3,8031,[ 79  96 173 161 276],457,5,32866,4.091882470119522,0.0,0.0
38032,3,8032,[318 427  98 191 182],655,5,32871,4.091995518486244,40.0,0.0
38033,3,8033,[211 194 135 427  79],11,4,32875,4.0919840677122234,20.0,0.0
38034,3,8034,[286 127 202  89 151],450,5,32880,4.092097075295582,0.0,40.0
38035,3,8035,[318 427  98 191 182],18,5,32885,4.092210054753608,40.0,0.0
38036,3,8036,[318 427  98 191 182],450,5,32890,4.0923230060968026,40.0,0.0
38037,3,8037,[222  69 333 132 204],236,3,32893,4.092187111221697,0.0,0.0
38038,3,8038,[ 56 427 357 546 216],693,4,32897,4.092175643736783,20.0,0.0
38039,3,8039,[300 186 237 655 100],655,0,32897,4.091666666666667,0.0,20.0
38040,3,8040,[328 127  98 202 172],450,5,32902,4.091779629399328,0.0,20.0
38041,3,8041,[ 50   1 183 210 118],344,3,32905,4.091643869684158,0.0,20.0
38042,3,8042,[318 427  98 191 182],655,5,32910,4.091756807161507,40.0,0.0
38043,3,8043,[483 258 286 475 121],296,5,32915,4.091869716558926,0.0,20.0
38044,3,8044,[318 427  98 191 182],450,5,32920,4.0919825978868865,40.0,0.0
38045,3,8045,[222 238  56   1 228],796,3,32923,4.091846880437484,0.0,0.0
38046,3,8046,[655 216 318 435 173],65,4,32927,4.091835466633528,20.0,0.0
38047,3,8047,[172   7 173  98  28],786,5,32932,4.091948310139165,0.0,0.0
38048,3,8048,[318 427  98 191 182],269,5,32937,4.092061125605666,40.0,0.0
38049,3,8049,[318 427  98 191 182],796,5,32942,4.092173913043478,40.0,0.0
38050,3,8050,[294 197 271  69 286],796,2,32944,4.091914047944354,0.0,20.0
38051,3,8051,[194  11  95 235 186],450,2,32946,4.091654247391952,0.0,0.0
38052,3,8052,[318 427  98 191 182],450,5,32951,4.091767043337886,40.0,0.0
38053,3,8053,[318 427  98 191 182],450,5,32956,4.091879811273901,40.0,0.0
38054,3,8054,[318 427  98 191 182],450,5,32961,4.091992551210429,40.0,0.0
38055,3,8055,[275 197   9 237 273],796,2,32963,4.091732869910626,0.0,20.0
38056,3,8056,[179  89 161 127 289],786,5,32968,4.091845600099292,0.0,20.0
38057,3,8057,[318 427  98 191 182],450,5,32973,4.0919583023082655,40.0,0.0
38058,3,8058,[318 427  98 191 182],450,5,32978,4.092070976547959,40.0,0.0
38059,3,8059,[ 56 161  97 117 191],450,5,32983,4.0921836228287845,0.0,0.0
38060,3,8060,[318 427  98 191 182],18,5,32988,4.092296241161146,40.0,0.0
38061,3,8061,[318 427  98 191 182],72,5,32993,4.092408831555446,40.0,0.0
38062,3,8062,[301 187 191  98 269],296,5,32998,4.092521394022076,0.0,0.0
38063,3,8063,[318 427  98 191 182],269,5,33003,4.092633928571429,40.0,0.0
38064,3,8064,[195 235 153 143 185],450,4,33007,4.0926224426534406,0.0,0.0
38065,3,8065,[275   4  97  56 655],796,3,33010,4.092486982395239,0.0,20.0
38066,3,8066,[268 100 196 288 237],655,0,33010,4.091979670261559,0.0,20.0
38067,3,8067,[318 427  98 191 182],18,5,33015,4.092092216162618,40.0,0.0
38068,3,8068,[318 427  98 191 182],269,5,33020,4.092204734167803,40.0,0.0
38069,3,8069,[318 427  98 191 182],72,5,33025,4.092317224287484,40.0,0.0
38070,3,8070,[180 144 318 210 211],796,2,33027,4.092057985379754,20.0,0.0
38071,3,8071,[216  79 195  89 179],450,5,33032,4.0921704658077305,0.0,0.0
38072,3,8072,[ 70 568 286   4  25],344,3,33035,4.092035178991701,0.0,20.0
38073,3,8073,[318 427  98 191 182],269,5,33040,4.092147634381967,40.0,0.0
38074,3,8074,[318 427  98 191 182],269,5,33045,4.092260061919505,40.0,0.0
38075,3,8075,[173  64 603 153 187],716,4,33049,4.092248637939574,40.0,0.0
38076,3,8076,[318 427  98 191 182],450,5,33054,4.092361025133094,40.0,0.0
38077,3,8077,[318 427  98 191 182],796,5,33059,4.0924733845011145,40.0,0.0
38078,3,8078,[ 96 135  89 125 288],655,2,33061,4.092214382968189,0.0,0.0
38079,3,8079,[318 427  98 191 182],269,5,33066,4.092326732673268,40.0,0.0
38080,3,8080,[318 427  98 191 182],18,5,33071,4.092439054572454,40.0,0.0
38081,3,8081,[318 427  98 191 182],796,5,33076,4.0925513486760705,40.0,0.0
38082,3,8082,[318 427  98 191 182],450,5,33081,4.092663614994433,40.0,0.0
38083,3,8083,[748 271 215 294  50],796,4,33085,4.092652152399802,0.0,20.0
38084,3,8084,[318 427  98 191 182],269,5,33090,4.092764378478664,40.0,0.0
38085,3,8085,[318 125 100  50 210],18,4,33094,4.092752906257729,20.0,40.0
38086,3,8086,[318 427  98 191 182],796,5,33099,4.09286509212316,40.0,0.0
38087,3,8087,[318 427  98 191 182],796,5,33104,4.09297725024728,40.0,0.0
38088,3,8088,[318 427  98 191 182],72,5,33109,4.093089380640376,40.0,0.0
38089,3,8089,[318 427  98 191 182],269,5,33114,4.093201483312732,40.0,0.0
38090,3,8090,[318 427  98 191 182],655,5,33119,4.093313558274626,40.0,0.0
38091,3,8091,[318 427  98 191 182],18,5,33124,4.093425605536332,40.0,0.0
38092,3,8092,[318 427  98 191 182],72,5,33129,4.093537625108118,40.0,0.0
38093,3,8093,[210 269 187 179  56],296,4,33133,4.093526068692859,0.0,0.0
38094,3,8094,[ 12 132  96   7 181],457,5,33138,4.093638048177888,0.0,0.0
38095,3,8095,[282 234 211 423 258],693,2,33140,4.093379446640316,0.0,0.0
38096,3,8096,[318 427  98 191 182],796,5,33145,4.0934914165740395,40.0,0.0
38097,3,8097,[210 127  70 275 186],786,5,33150,4.093603358854038,0.0,40.0
38098,3,8098,[118 471 276 655  71],593,2,33152,4.093344857389801,0.0,0.0
38099,3,8099,[275  15  50 603   8],18,4,33156,4.093333333333334,20.0,40.0
38100,3,8100,[385 185  95  98 238],796,4,33160,4.09332181212196,0.0,0.0
38101,3,8101,[427 318 194 202  28],716,5,33165,4.093433720069119,40.0,0.0
38102,3,8102,[235 258  50 222 300],756,2,33167,4.09317536714797,0.0,20.0
38103,3,8103,[318 427  98 191 182],655,5,33172,4.093287265547878,40.0,0.0
38104,3,8104,[318 427  98 191 182],72,5,33177,4.093399136335595,40.0,0.0
38105,3,8105,[258  25  56 568 333],655,0,33177,4.092894152479644,0.0,0.0
38106,3,8106,[471 282 204 234 185],716,3,33180,4.092759343776983,0.0,0.0
38107,3,8107,[117 215 111 118  22],280,3,33183,4.092624568327578,0.0,0.0
38108,3,8108,[318 427  98 191 182],450,5,33188,4.092736465655444,40.0,0.0
38109,3,8109,[265 176 183 471  69],280,2,33190,4.092478421701603,0.0,0.0
38110,3,8110,[318 427  98 191 182],655,5,33195,4.092590309456294,40.0,0.0
38111,3,8111,[  1 132  88 202 237],796,4,33199,4.092578895463511,0.0,0.0
38112,3,8112,[318 427  98 191 182],72,5,33204,4.092690743251572,40.0,0.0
38113,3,8113,[  1  15  12 196  70],72,5,33209,4.092802563470545,0.0,0.0
38114,3,8114,[318 427  98 191 182],18,5,33214,4.092914356130622,40.0,0.0
38115,3,8115,[318 427  98 191 182],796,5,33219,4.093026121241991,40.0,0.0
38116,3,8116,[ 28 176 185 187 210],504,3,33222,4.0928914623629415,0.0,0.0
38117,3,8117,[318 427  98 191 182],655,5,33227,4.0930032027593,40.0,0.0
38118,3,8118,[318 427  98 191 182],450,5,33232,4.093114915630004,40.0,0.0
38119,3,8119,[294 301 215 185 196],655,1,33233,4.092733990147783,0.0,0.0
38120,3,8120,[318 427  98 191 182],18,5,33238,4.0928457086565695,40.0,0.0
38121,3,8121,[318 427  98 191 182],18,5,33243,4.0929573996552575,40.0,0.0
38122,3,8122,[318 427  98 191 182],450,5,33248,4.093069063154007,40.0,0.0
38123,3,8123,[ 70 183 275 405 678],344,2,33250,4.092811422944362,0.0,20.0
38124,3,8124,[318 427  98 191 182],18,5,33255,4.092923076923077,40.0,0.0
38125,3,8125,[318 427  98 191 182],18,5,33260,4.093034703421117,40.0,0.0
38126,3,8126,[318 427  98 191 182],655,5,33265,4.093146302448628,40.0,0.0
38127,3,8127,[318 427  98 191 182],269,5,33270,4.093257874015748,40.0,0.0
38128,3,8128,[187 269 228 257 118],796,4,33274,4.093246401771435,0.0,0.0
38129,3,8129,[228 300  64 318 546],716,4,33278,4.093234932349324,40.0,0.0
38130,3,8130,[318 427  98 191 182],269,5,33283,4.093346451850941,40.0,0.0
38131,3,8131,[318 427  98 191 182],72,5,33288,4.093457943925234,40.0,0.0
38132,3,8132,[289 258  11 275  64],655,2,33290,4.093200541005779,20.0,20.0
38133,3,8133,[318 427  98 191 182],450,5,33295,4.093312023604622,40.0,0.0
38134,3,8134,[318 427  98 191 182],450,5,33300,4.093423478795329,40.0,0.0
38135,3,8135,[546  70  11 132 168],716,4,33304,4.093411996066863,0.0,0.0
38136,3,8136,[211  15  88  50  98],796,4,33308,4.093400516160747,0.0,20.0
38137,3,8137,[318 427  98 191 182],796,5,33313,4.093511919390513,40.0,0.0
38138,3,8138,[318 427  98 191 182],796,5,33318,4.093623295245116,40.0,0.0
38139,3,8139,[318 427  98 191 182],796,5,33323,4.093734643734644,40.0,0.0
38140,3,8140,[318 427  98 191 182],655,5,33328,4.093845964869181,40.0,0.0
38141,3,8141,[222 216 286 289 210],236,4,33332,4.093834438712847,0.0,20.0
38142,3,8142,[204 194 483 183 161],716,3,33335,4.093700110524376,0.0,0.0
38143,3,8143,[318 427  98 191 182],72,5,33340,4.093811394891945,40.0,0.0
38144,3,8144,[318 427  98 191 182],450,5,33345,4.093922651933702,40.0,0.0
38145,3,8145,[318 427  98 191 182],450,5,33350,4.09403388165971,40.0,0.0
38146,3,8146,[ 96 322 127  98 182],280,4,33354,4.0940223395114765,0.0,20.0
38147,3,8147,[151  64 186 655 546],796,3,33357,4.093888070692194,20.0,0.0
38148,3,8148,[597  70  56 655 216],174,4,33361,4.093876549269849,0.0,0.0
38149,3,8149,[168  69  88 135 269],450,4,33365,4.093865030674847,0.0,0.0
38150,3,8150,[237 294 196 313  11],450,5,33370,4.093976199239357,0.0,0.0
38151,3,8151,[318 427  98 191 182],655,5,33375,4.094087340529931,40.0,0.0
38152,3,8152,[318 427  98 191 182],796,5,33380,4.094198454556605,40.0,0.0
38153,3,8153,[318 427  98 191 182],18,5,33385,4.094309541329409,40.0,0.0
38154,3,8154,[318 427  98 191 182],18,5,33390,4.094420600858369,40.0,0.0
38155,3,8155,[318 427  98 191 182],72,5,33395,4.094531633153506,40.0,0.0
38156,3,8156,[318 427  98 191 182],18,5,33400,4.094642638224838,40.0,0.0
38157,3,8157,[318 427  98 191 182],18,5,33405,4.094753616082373,40.0,0.0
38158,3,8158,[318 546 245 111 313],450,5,33410,4.09486456673612,20.0,0.0
38159,3,8159,[318 427  98 191 182],450,5,33415,4.094975490196078,40.0,0.0
38160,3,8160,[180 275 176 265 100],796,3,33418,4.094841318465874,0.0,40.0
38161,3,8161,[318 427  98 191 182],269,5,33423,4.094952217593727,40.0,0.0
38162,3,8162,[483   7 210   9 117],457,5,33428,4.09506308955041,0.0,0.0
38163,3,8163,[322 483 655 222  79],450,3,33431,4.094928956393924,0.0,0.0
38164,3,8164,[ 98 357 323 191 405],23,2,33433,4.0946723821188,0.0,0.0
38165,3,8165,[186 235 183 202 180],269,0,33433,4.094170952730835,0.0,0.0
38166,3,8166,[318 427  98 191 182],450,5,33438,4.094281866046284,40.0,0.0
38167,3,8167,[ 28 132 405 273 508],655,1,33439,4.093903036238982,0.0,0.0
38168,3,8168,[515  98  28 179 257],655,3,33442,4.093769127188151,0.0,0.0
38169,3,8169,[ 50 318  70  79 176],151,4,33446,4.093757649938801,20.0,20.0
38170,3,8170,[168 125 118  50 216],796,5,33451,4.093868559539836,0.0,20.0
38171,3,8171,[ 95   8  89 196 195],344,5,33456,4.093979441997063,0.0,0.0
38172,3,8172,[318 427  98 191 182],269,5,33461,4.094090297320445,40.0,0.0
38173,3,8173,[ 56 216   4 111 286],18,3,33464,4.093956447271838,0.0,20.0
38174,3,8174,[318 427  98 191 182],796,5,33469,4.094067278287461,40.0,0.0
38175,3,8175,[318 427  98 191 182],450,5,33474,4.094178082191781,40.0,0.0
38176,3,8176,[318 427  98 191 182],796,5,33479,4.094288858994742,40.0,0.0
38177,3,8177,[318 427  98 191 182],796,5,33484,4.0943996087062855,40.0,0.0
38178,3,8178,[204 435   7 597 161],450,5,33489,4.094510331336349,0.0,0.0
38179,3,8179,[318 427  98 191 182],450,5,33494,4.094621026894866,40.0,0.0
38180,3,8180,[ 50 234 197 183 185],796,3,33497,4.094487226500428,0.0,20.0
38181,3,8181,[125 172 194 237 187],450,5,33502,4.094597897824492,0.0,0.0
38182,3,8182,[318 427  98 191 182],269,5,33507,4.094708542099474,40.0,0.0
38183,3,8183,[318 427  98 191 182],450,5,33512,4.094819159335288,40.0,0.0
38184,3,8184,[210  12 182 173   1],280,2,33514,4.094563225412339,0.0,0.0
38185,3,8185,[ 89  64 222 228 237],72,1,33515,4.094185194234059,20.0,0.0
38186,3,8186,[197   8 151  11  98],535,4,33519,4.094173689996335,0.0,0.0
38187,3,8187,[318 427  98 191 182],18,5,33524,4.0942843185149,40.0,0.0
38188,3,8188,[318 427  98 191 182],72,5,33529,4.094394920014654,40.0,0.0
38189,3,8189,[195 508 197 286 168],535,4,33533,4.094383394383394,0.0,20.0
38190,3,8190,[318 427  98 191 182],450,5,33538,4.094493956781834,40.0,0.0
38191,3,8191,[ 15 191 100  25 268],655,1,33539,4.0941162109375,0.0,20.0
38192,3,8192,[318 427  98 191 182],72,5,33544,4.094226778957647,40.0,0.0
38193,3,8193,[202 318 385 313  56],450,5,33549,4.094337319990236,20.0,0.0
38194,3,8194,[ 97 238 195 100 175],151,3,33552,4.094203782794387,0.0,20.0
38195,3,8195,[318 427  98 191 182],269,5,33557,4.09431429965837,40.0,0.0
38196,3,8196,[ 22 228 191  64 143],655,3,33560,4.094180797852873,20.0,0.0
38197,3,8197,[318 427  98 191 182],72,5,33565,4.094291290558673,40.0,0.0
38198,3,8198,[318 427  98 191 182],72,5,33570,4.094401756311745,40.0,0.0
38199,3,8199,[318 427  98 191 182],18,5,33575,4.094512195121951,40.0,0.0
38200,3,8200,[318 427  98 191 182],72,5,33580,4.094622606999146,40.0,0.0
38201,3,8201,[ 50   8  69 144   9],796,4,33584,4.094611070470617,0.0,20.0
38202,3,8202,[318 427  98 191 182],655,5,33589,4.094721443374375,40.0,0.0
38203,3,8203,[318 427  98 191 182],269,5,33594,4.094831789371039,40.0,0.0
38204,3,8204,[211 235 172 195 132],269,2,33596,4.094576477757465,0.0,0.0
38205,3,8205,[135 483  79 265 515],655,4,33600,4.0945649524737995,0.0,0.0
38206,3,8206,[318 427  98 191 182],18,5,33605,4.094675277202388,40.0,0.0
38207,3,8207,[318 427  98 191 182],796,5,33610,4.094785575048733,40.0,0.0
38208,3,8208,[318 427  98 191 182],18,5,33615,4.094895846022658,40.0,0.0
38209,3,8209,[ 12 197 118  97 135],693,3,33618,4.094762484774665,0.0,0.0
38210,3,8210,[127 111 228  96 151],296,3,33621,4.09462915601023,0.0,20.0
38211,3,8211,[196 211 194   8  25],18,2,33623,4.094374086702387,0.0,0.0
38212,3,8212,[318 427  98 191 182],796,5,33628,4.0944843540728115,40.0,0.0
38213,3,8213,[318 427  98 191 182],72,5,33633,4.094594594594595,40.0,0.0
38214,3,8214,[568 118 222 597 132],796,5,33638,4.094704808277541,0.0,0.0
38215,3,8215,[318 427  98 191 182],796,5,33643,4.0948149951314505,40.0,0.0
38216,3,8216,[187 186  22  12 333],655,1,33644,4.0944383594986,0.0,0.0
38217,3,8217,[ 89 195 301 245 403],450,5,33649,4.0945485519591145,0.0,0.0
38218,3,8218,[318 427  98 191 182],269,5,33654,4.094658717605548,40.0,0.0
38219,3,8219,[318 427  98 191 182],269,5,33659,4.094768856447689,40.0,0.0
38220,3,8220,[588 183 405  71 173],786,5,33664,4.094878968495317,0.0,0.0
38221,3,8221,[318 427  98 191 182],18,5,33669,4.094989053758209,40.0,0.0
38222,3,8222,[151 125  88 222  70],344,2,33671,4.094734281892253,0.0,0.0
38223,3,8223,[318 427  98 191 182],655,5,33676,4.094844357976654,40.0,0.0
38224,3,8224,[318 427  98 191 182],655,5,33681,4.094954407294833,40.0,0.0
38225,3,8225,[318 427  98 191 182],450,5,33686,4.095064429856553,40.0,0.0
38226,3,8226,[194 322   8 121 153],796,4,33690,4.0950528746809285,0.0,0.0
38227,3,8227,[222 183 302 181 174],655,2,33692,4.094798249878464,0.0,0.0
38228,3,8228,[318 427  98 191 182],72,5,33697,4.0949082513063555,40.0,0.0
38229,3,8229,[318 427  98 191 182],796,5,33702,4.09501822600243,40.0,0.0
38230,3,8230,[ 96 144 210 168 483],450,3,33705,4.094885190134856,0.0,0.0
38231,3,8231,[471 742 257 423 153],655,0,33705,4.094387755102041,0.0,0.0
38232,3,8232,[172 183  64   9 228],457,5,33710,4.094497752945464,20.0,0.0
38233,3,8233,[ 22  64 161 238  69],269,2,33712,4.0942433811027446,20.0,0.0
38234,3,8234,[318 427  98 191 182],796,5,33717,4.094353369763206,40.0,0.0
38235,3,8235,[318 427  98 191 182],269,5,33722,4.094463331714424,40.0,0.0
38236,3,8236,[183   7  12 185 127],693,4,33726,4.0944518635425515,0.0,20.0
38237,3,8237,[144   8  98 282 127],655,2,33728,4.094197620781743,0.0,20.0
38238,3,8238,[286 238 172 275   8],18,4,33732,4.094186187644132,0.0,40.0
38239,3,8239,[318 427  98 191 182],72,5,33737,4.094296116504855,40.0,0.0
38240,3,8240,[318 427  98 191 182],655,5,33742,4.094406018687052,40.0,0.0
38241,3,8241,[269  22 111 161 288],450,4,33746,4.094394564426111,0.0,0.0
38242,3,8242,[318 427  98 191 182],796,5,33751,4.094504427999515,40.0,0.0
38243,3,8243,[318 427  98 191 182],269,5,33756,4.094614264919942,40.0,0.0
38244,3,8244,[ 69 153  28 118 172],655,1,33757,4.094238932686476,0.0,0.0
38245,3,8245,[  7 286 195 234 328],629,3,33760,4.094106233325249,0.0,20.0
38246,3,8246,[175 174 117   1 405],457,5,33765,4.094216078574027,0.0,0.0
38247,3,8247,[318 427  98 191 182],655,5,33770,4.094325897187197,40.0,0.0
38248,3,8248,[318 427  98 191 182],269,5,33775,4.094435689174445,40.0,0.0
38249,3,8249,[127 282 121 748 258],796,5,33780,4.094545454545455,0.0,20.0
38250,3,8250,[294 222 144 237 151],457,4,33784,4.094533995879288,0.0,0.0
38251,3,8251,[568 161  28  11 180],693,2,33786,4.094280174503151,0.0,0.0
38252,3,8252,[318 427  98 191 182],796,5,33791,4.0943899188173996,40.0,0.0
38253,3,8253,[318 427  98 191 182],655,5,33796,4.09449963653986,40.0,0.0
38254,3,8254,[318 427  98 191 182],18,5,33801,4.094609327680194,40.0,0.0
38255,3,8255,[  9 328 185  64 597],796,4,33805,4.094597868217054,20.0,0.0
38256,3,8256,[195 196 125 245  28],450,5,33810,4.094707520891365,0.0,0.0
38257,3,8257,[275 216 282 174 333],655,2,33812,4.094453862920804,0.0,20.0
38258,3,8258,[403 273 194  88  22],796,4,33816,4.094442426443879,0.0,0.0
38259,3,8259,[ 15   7 215 300 111],450,4,33820,4.094430992736077,0.0,0.0
38260,3,8260,[318 117 186  82 172],577,5,33825,4.094540612516645,20.0,0.0
38261,3,8261,[211  50 603 135  12],151,5,33830,4.094650205761317,20.0,20.0
38262,3,8262,[318 427  98 191 182],796,5,33835,4.094759772479729,40.0,0.0
38263,3,8263,[318 427  98 191 182],72,5,33840,4.09486931268151,40.0,0.0
38264,3,8264,[318 427  98 191 182],450,5,33845,4.094978826376286,40.0,0.0
38265,3,8265,[245 176 257  25 403],504,3,33848,4.094846358577304,0.0,0.0
38266,3,8266,[ 97  22  56 191 228],457,5,33853,4.094955848554494,0.0,0.0
38267,3,8267,[318 427  98 191 182],796,5,33858,4.095065312046444,40.0,0.0
38268,3,8268,[318 427  98 191 182],655,5,33863,4.095174749062765,40.0,0.0
38269,3,8269,[655 568 238 286 195],655,0,33863,4.094679564691656,0.0,20.0
38270,3,8270,[111 302  88 173 228],344,4,33867,4.094668117519042,0.0,0.0
38271,3,8271,[125   1  22  15  82],577,4,33871,4.09465667311412,0.0,0.0
38272,3,8272,[ 64 427 471  25 186],577,4,33875,4.094645231475885,40.0,0.0
38273,3,8273,[151 172 228 204 257],807,5,33880,4.094754653130288,0.0,0.0
38274,3,8274,[ 12 546 357  69 173],457,4,33884,4.094743202416918,0.0,0.0
38275,3,8275,[318 427  98 191 182],72,5,33889,4.094852585790237,40.0,0.0
38276,3,8276,[318 427  98 191 182],655,5,33894,4.0949619427328745,40.0,0.0
38277,3,8277,[318 427  98 191 182],18,5,33899,4.095071273254409,40.0,0.0
38278,3,8278,[276 288 135 228 385],457,5,33904,4.095180577364416,0.0,0.0
38279,3,8279,[483 302 328 258 181],902,1,33905,4.094806763285024,0.0,0.0
38280,3,8280,[318 427  98 191 182],18,5,33910,4.094916072938051,40.0,0.0
38281,3,8281,[132 215 161 357 127],716,4,33914,4.094904612412461,0.0,20.0
38282,3,8282,[318 427  98 191 182],18,5,33919,4.095013883858505,40.0,0.0
38283,3,8283,[318 427  98 191 182],450,5,33924,4.095123128923225,40.0,0.0
38284,3,8284,[318 427  98 191 182],72,5,33929,4.095232347616173,40.0,0.0
38285,3,8285,[318 427  98 191 182],72,5,33934,4.095341539946898,40.0,0.0
38286,3,8286,[318 427  98 191 182],796,5,33939,4.095450705924943,40.0,0.0
38287,3,8287,[132  88 471   1 385],577,3,33942,4.095318532818533,0.0,0.0
38288,3,8288,[ 12 216 117   8  69],796,5,33947,4.095427675232235,0.0,0.0
38289,3,8289,[435 475 202 197 183],655,1,33948,4.0950542822677924,0.0,0.0
38290,3,8290,[ 82 234 228 196  50],716,5,33953,4.095163430225546,0.0,20.0
38291,3,8291,[288 117 333 357  98],629,5,33958,4.095272551857212,0.0,0.0
38292,3,8292,[318 427  98 191 182],450,5,33963,4.095381647172314,40.0,0.0
38293,3,8293,[ 25 174 202 176 185],450,4,33967,4.095370147094285,0.0,0.0
38294,3,8294,[318 427  98 191 182],450,5,33972,4.095479204339964,40.0,0.0
38295,3,8295,[742  82 168 176 200],450,3,33975,4.095347155255545,0.0,0.0
38296,3,8296,[288 197 144  12 182],629,5,33980,4.09545618898397,0.0,0.0
38297,3,8297,[ 15 135  28 588 222],457,5,33985,4.095565196432875,0.0,0.0
38298,3,8298,[318 427  98 191 182],796,5,33990,4.095674177611761,40.0,0.0
38299,3,8299,[121 180 174 228 216],457,5,33995,4.09578313253012,0.0,0.0
38300,3,8300,[153  25 403  98 121],655,1,33996,4.095410191543188,0.0,0.0
38301,3,8301,[276 153 196  15 211],593,4,34000,4.095398699108649,0.0,0.0
38302,3,8302,[144 196   1 185 194],23,3,34003,4.095266771046609,0.0,0.0
38303,3,8303,[153 202 234 483 508],269,2,34005,4.095014450867052,0.0,0.0
38304,3,8304,[ 25 597 183 118 179],457,4,34009,4.095003010234798,0.0,0.0
38305,3,8305,[318 427  98 191 182],450,5,34014,4.095111967252588,40.0,0.0
38306,3,8306,[318 427  98 191 182],796,5,34019,4.095220898037799,40.0,0.0
38307,3,8307,[318 427  98 191 182],450,5,34024,4.095329802599903,40.0,0.0
38308,3,8308,[197 228 655 215  69],151,4,34028,4.095318329522205,0.0,0.0
38309,3,8309,[302  69 151 185   9],401,1,34029,4.094945848375451,0.0,0.0
38310,3,8310,[191 496 161 222 318],716,4,34033,4.0949344242570085,40.0,0.0
38311,3,8311,[318 427  98 191 182],450,5,34038,4.095043310875842,40.0,0.0
38312,3,8312,[318 427  98 191 182],18,5,34043,4.095152171297967,40.0,0.0
38313,3,8313,[ 64 603 318 508 182],655,4,34047,4.095140726485446,60.0,0.0
38314,3,8314,[403 385 588  96 182],796,5,34052,4.095249549007817,0.0,0.0
38315,3,8315,[ 28  70 127 180 276],786,4,34056,4.095238095238095,0.0,20.0
38316,3,8316,[ 70 161 182 151 100],450,5,34061,4.095346879884573,0.0,20.0
38317,3,8317,[180 269   4 588 118],450,3,34064,4.095215195960567,0.0,0.0
38318,3,8318,[385   8 427 132 237],655,1,34065,4.094843130183916,20.0,0.0
38319,3,8319,[ 97 175 191  69 186],716,3,34068,4.094711538461539,0.0,0.0
38320,3,8320,[318 427  98 191 182],655,5,34073,4.09482033409446,40.0,0.0
38321,3,8321,[318 427  98 191 182],18,5,34078,4.09492910358087,40.0,0.0
38322,3,8322,[496 328 385 153 117],450,5,34083,4.095037846930193,20.0,0.0
38323,3,8323,[ 88  50 405 181 742],593,4,34087,4.095026429601154,0.0,20.0
38324,3,8324,[211 403 172 471 174],655,1,34088,4.094654654654654,0.0,0.0
38325,3,8325,[318 427  98 191 182],450,5,34093,4.09476339178477,40.0,0.0
38326,3,8326,[111 603 127  88 125],401,3,34096,4.094631920259397,20.0,20.0
38327,3,8327,[318 427  98 191 182],655,5,34101,4.094740634005763,40.0,0.0
38328,3,8328,[118 121 202 483  50],151,4,34105,4.094729259214792,0.0,20.0
38329,3,8329,[318 427  98 191 182],72,5,34110,4.09483793517407,40.0,0.0
38330,3,8330,[318 427  98 191 182],655,5,34115,4.094946585043813,40.0,0.0
38331,3,8331,[125 318 143 161  79],450,5,34120,4.095055208833413,20.0,0.0
38332,3,8332,[318 427  98 191 182],269,5,34125,4.095163806552262,40.0,0.0
38333,3,8333,[318 427  98 191 182],796,5,34130,4.095272378209743,40.0,0.0
38334,3,8334,[318 427  98 191 182],796,5,34135,4.095380923815237,40.0,0.0
38335,3,8335,[100  89  82 172 216],457,5,34140,4.095489443378119,0.0,20.0
38336,3,8336,[318 427  98 191 182],796,5,34145,4.095597936907761,40.0,0.0
38337,3,8337,[318 427  98 191 182],18,5,34150,4.095706404413528,40.0,0.0
38338,3,8338,[318  98 127 357  56],562,2,34152,4.095455090538434,20.0,20.0
38339,3,8339,[318 427  98 191 182],450,5,34157,4.095563549160672,40.0,0.0
38340,3,8340,[318 427  98 191 182],796,5,34162,4.095671981776765,40.0,0.0
38341,3,8341,[222 235 515 282  11],292,3,34165,4.095540637736754,0.0,0.0
38342,3,8342,[318 427  98 191 182],72,5,34170,4.095649047105358,40.0,0.0
38343,3,8343,[318 427  98 191 182],72,5,34175,4.095757430488974,40.0,0.0
38344,3,8344,[258 181 282 183 202],457,5,34180,4.095865787896944,0.0,0.0
38345,3,8345,[302 427 197 655 318],151,4,34184,4.095854301461778,40.0,0.0
38346,3,8346,[238 183 185 172 588],716,4,34188,4.095842817778843,0.0,0.0
38347,3,8347,[318 427  98 191 182],450,5,34193,4.095951126018208,40.0,0.0
38348,3,8348,[318 427  98 191 182],796,5,34198,4.096059408312373,40.0,0.0
38349,3,8349,[318 427  98 191 182],72,5,34203,4.096167664670658,40.0,0.0
38350,3,8350,[318 427  98 191 182],655,5,34208,4.096275895102383,40.0,0.0
38351,3,8351,[655  56 194   8  98],457,5,34213,4.096384099616858,0.0,0.0
38352,3,8352,[318 427  98 191 182],796,5,34218,4.096492278223393,40.0,0.0
38353,3,8353,[318 427  98 191 182],18,5,34223,4.09660043093129,40.0,0.0
38354,3,8354,[168  69  82 269 318],796,3,34226,4.096469180131658,20.0,0.0
38355,3,8355,[294 435  98 268 186],296,3,34229,4.0963379607467685,0.0,0.0
38356,3,8356,[318 427  98 191 182],450,5,34234,4.096446093095609,40.0,0.0
38357,3,8357,[222 471 144  88 153],716,3,34237,4.096314907872697,0.0,0.0
38358,3,8358,[318 427  98 191 182],72,5,34242,4.096423017107309,40.0,0.0
38359,3,8359,[194 322 323 286 496],796,2,34244,4.0961722488038275,20.0,20.0
38360,3,8360,[294 176  25 234 182],450,3,34247,4.096041143403899,0.0,0.0
38361,3,8361,[318 427  98 191 182],18,5,34252,4.096149246591724,40.0,0.0
38362,3,8362,[318 427  98 191 182],18,5,34257,4.096257323926821,40.0,0.0
38363,3,8363,[483 183 172 357 588],457,5,34262,4.09636537541846,0.0,0.0
38364,3,8364,[318 427  98 191 182],269,5,34267,4.096473401075912,40.0,0.0
38365,3,8365,[357  22 144 427 508],655,2,34269,4.096222806598135,20.0,0.0
38366,3,8366,[ 50 117 546  71  88],796,5,34274,4.096330823473169,0.0,20.0
38367,3,8367,[318 427  98 191 182],269,5,34279,4.096438814531549,40.0,0.0
38368,3,8368,[318 427  98 191 182],269,5,34284,4.096546779782531,40.0,0.0
38369,3,8369,[318 427  98 191 182],72,5,34289,4.096654719235365,40.0,0.0
38370,3,8370,[234 294  79 194 111],450,4,34293,4.096643172858679,0.0,0.0
38371,3,8371,[318 427  98 191 182],450,5,34298,4.0967510750119445,40.0,0.0
38372,3,8372,[318 427  98 191 182],450,5,34303,4.096858951391377,40.0,0.0
38373,3,8373,[276 182 403   1 423],280,3,34306,4.096727967518509,0.0,0.0
38374,3,8374,[568  96 742 202  50],796,4,34310,4.096716417910447,0.0,20.0
38375,3,8375,[318 427  98 191 182],269,5,34315,4.096824259789876,40.0,0.0
38376,3,8376,[318 427  98 191 182],796,5,34320,4.096932075922168,40.0,0.0
38377,3,8377,[318 427  98 191 182],655,5,34325,4.0970398663165435,40.0,0.0
38378,3,8378,[318 427  98 191 182],72,5,34330,4.097147630982217,40.0,0.0
38379,3,8379,[318 427  98 191 182],796,5,34335,4.097255369928401,40.0,0.0
38380,3,8380,[318 427  98 191 182],269,5,34340,4.0973630831643,40.0,0.0
38381,3,8381,[237 286 275 258   7],938,3,34343,4.097232164161298,0.0,40.0
38382,3,8382,[286 183 215 222 257],796,4,34347,4.097220565430037,0.0,20.0
38383,3,8383,[196 191 228 202 603],655,2,34349,4.096970419847328,20.0,0.0
38384,3,8384,[302  50  11  96 216],450,5,34354,4.097078115682767,0.0,20.0
38385,3,8385,[  9 515 508 176 182],269,4,34358,4.097066539470546,0.0,0.0
38386,3,8386,[318 427  98 191 182],18,5,34363,4.097174198163825,40.0,0.0
38387,3,8387,[318 427  98 191 182],450,5,34368,4.09728183118741,40.0,0.0
38388,3,8388,[ 97 195  12  64 508],693,3,34371,4.097151031112171,20.0,0.0
38389,3,8389,[318 427  98 191 182],655,5,34376,4.097258641239571,40.0,0.0
38390,3,8390,[318 427  98 191 182],18,5,34381,4.097366225718031,40.0,0.0
38391,3,8391,[318 427  98 191 182],796,5,34386,4.097473784556721,40.0,0.0
38392,3,8392,[318 427  98 191 182],269,5,34391,4.097581317764804,40.0,0.0
38393,3,8393,[318 427  98 191 182],269,5,34396,4.097688825351441,40.0,0.0
38394,3,8394,[318 427  98 191 182],72,5,34401,4.0977963073257895,40.0,0.0
38395,3,8395,[427 182 568  56 121],72,4,34405,4.097784659361601,20.0,0.0
38396,3,8396,[318 427  98 191 182],450,5,34410,4.097892104322972,40.0,0.0
38397,3,8397,[318 427  98 191 182],450,5,34415,4.097999523696118,40.0,0.0
38398,3,8398,[318 427  98 191 182],72,5,34420,4.098106917490178,40.0,0.0
38399,3,8399,[282 405 318 300 568],655,1,34421,4.097738095238095,20.0,0.0
38400,3,8400,[318 427  98 191 182],269,5,34426,4.097845494583978,40.0,0.0
38401,3,8401,[172 257   1 185 202],330,5,34431,4.097952868364675,0.0,0.0
38402,3,8402,[238 357 183 211 588],786,5,34436,4.098060216589313,0.0,0.0
38403,3,8403,[286  97 257 197 176],835,3,34439,4.097929557353641,0.0,20.0
38404,3,8404,[ 56 515 176 405 302],655,2,34441,4.097679952409281,0.0,0.0
38405,3,8405,[318 427  98 191 182],72,5,34446,4.097787294789436,40.0,0.0
38406,3,8406,[318 427  98 191 182],450,5,34451,4.097894611633163,40.0,0.0
38407,3,8407,[318 427  98 191 182],450,5,34456,4.098001902949572,40.0,0.0
38408,3,8408,[318 427  98 191 182],655,5,34461,4.09810916874777,40.0,0.0
38409,3,8409,[ 96 234 483  98 423],23,3,34464,4.097978596908442,0.0,0.0
38410,3,8410,[111 172 187 161 173],269,1,34465,4.097610272262513,0.0,0.0
38411,3,8411,[318 427  98 191 182],18,5,34470,4.09771754636234,40.0,0.0
38412,3,8412,[197   7 132 196 423],535,5,34475,4.0978247949601805,0.0,0.0
38413,3,8413,[546 237 127  25 282],15,0,34475,4.097337770382696,0.0,20.0
38414,3,8414,[318 427  98 191 182],18,5,34480,4.097445038621509,40.0,0.0
38415,3,8415,[318 427  98 191 182],72,5,34485,4.097552281368821,40.0,0.0
38416,3,8416,[  7 318 174   9 655],786,5,34490,4.097659498633718,20.0,0.0
38417,3,8417,[483 202 215   7 191],655,2,34492,4.097410311237824,0.0,0.0
38418,3,8418,[318 427  98 191 182],796,5,34497,4.097517519895474,40.0,0.0
38419,3,8419,[172 153 200 435 282],450,4,34501,4.09750593824228,0.0,0.0
38420,3,8420,[210 100 333  88 286],236,1,34502,4.097138107113169,0.0,40.0
38421,3,8421,[318 195 135 435 183],655,3,34505,4.09700783661838,20.0,0.0
38422,3,8422,[318 427  98 191 182],796,5,34510,4.097115042146504,40.0,0.0
38423,3,8423,[318 427  98 191 182],655,5,34515,4.097222222222222,40.0,0.0
38424,3,8424,[275 204 194 302 286],389,4,34519,4.097210682492582,0.0,40.0
38425,3,8425,[318 427  98 191 182],18,5,34524,4.097317825777356,40.0,0.0
38426,3,8426,[318 427  98 191 182],655,5,34529,4.097424943633559,40.0,0.0
38427,3,8427,[318 427  98 191 182],18,5,34534,4.097532036070242,40.0,0.0
38428,3,8428,[265 194 300 515 258],807,4,34538,4.097520465061098,0.0,0.0
38429,3,8429,[435 237  89  25 210],655,1,34539,4.097153024911032,0.0,0.0
38430,3,8430,[318 427  98 191 182],18,5,34544,4.0972601114932985,40.0,0.0
38431,3,8431,[210 655  88 471 183],786,5,34549,4.097367172675522,0.0,0.0
38432,3,8432,[318 427  98 191 182],655,5,34554,4.097474208466738,40.0,0.0
38433,3,8433,[269 318 197  64 301],535,5,34559,4.097581218875979,40.0,0.0
38434,3,8434,[271 237 568  11   1],655,0,34559,4.097095435684647,0.0,0.0
38435,3,8435,[195  89 121 265 118],796,5,34564,4.097202465623519,0.0,0.0
38436,3,8436,[ 64 100 318 195 328],796,4,34568,4.097190944648572,40.0,20.0
38437,3,8437,[191 237 204 427 423],236,4,34572,4.097179426404361,20.0,0.0
38438,3,8438,[  8 100 181 568  89],457,5,34577,4.097286408342221,0.0,20.0
38439,3,8439,[318 427  98 191 182],796,5,34582,4.09739336492891,40.0,0.0
38440,3,8440,[117  96 180 151  28],450,5,34587,4.097500296173439,0.0,0.0
38441,3,8441,[318 427  98 191 182],796,5,34592,4.097607202084814,40.0,0.0
38442,3,8442,[161  79 423 435 200],716,4,34596,4.097595641359706,0.0,0.0
38443,3,8443,[318 427  98 191 182],655,5,34601,4.097702510658456,40.0,0.0
38444,3,8444,[121 187  88   1  11],450,4,34605,4.097690941385435,0.0,0.0
38445,3,8445,[318 427  98 191 182],655,5,34610,4.0977977740942455,40.0,0.0
38446,3,8446,[318 427  98 191 182],269,5,34615,4.097904581508228,40.0,0.0
38447,3,8447,[385 125 132 186 301],655,0,34615,4.097419507575758,0.0,0.0
38448,3,8448,[655 194 182 294 546],457,3,34618,4.097289620073381,0.0,0.0
38449,3,8449,[655 168 197 268   4],535,3,34621,4.097159763313609,0.0,0.0
38450,3,8450,[427  12 423 151 228],577,4,34625,4.0971482664773395,20.0,0.0
38451,3,8451,[588 195 238 181 185],796,4,34629,4.097136772361571,0.0,0.0
38452,3,8452,[194 121 294 300 215],716,5,34634,4.09724358216018,0.0,0.0
38453,3,8453,[ 79 151  95 357 153],18,4,34638,4.097232079488999,0.0,0.0
38454,3,8454,[318 427  98 191 182],655,5,34643,4.097338852749852,40.0,0.0
38455,3,8455,[180 161 257  97 172],716,3,34646,4.09720908230842,0.0,0.0
38456,3,8456,[318 427  98 191 182],72,5,34651,4.097315833037721,40.0,0.0
38457,3,8457,[423  79  71 216  70],18,5,34656,4.097422558524474,0.0,0.0
38458,3,8458,[318 427  98 191 182],18,5,34661,4.097529258777633,40.0,0.0
38459,3,8459,[318 427  98 191 182],269,5,34666,4.0976359338061465,40.0,0.0
38460,3,8460,[318 427  98 191 182],269,5,34671,4.097742583618958,40.0,0.0
38461,3,8461,[318 427  98 191 182],655,5,34676,4.097849208225006,40.0,0.0
38462,3,8462,[318 427  98 191 182],450,5,34681,4.097955807633227,40.0,0.0
38463,3,8463,[318 427  98 191 182],655,5,34686,4.098062381852552,40.0,0.0
38464,3,8464,[318 427  98 191 182],269,5,34691,4.098168930891908,40.0,0.0
38465,3,8465,[282 210 202 153 273],450,3,34694,4.098039215686274,0.0,0.0
38466,3,8466,[111 302 196 132 211],389,3,34697,4.0979095311208225,0.0,0.0
38467,3,8467,[111 245 357 143 204],450,5,34702,4.098016060462919,0.0,0.0
38468,3,8468,[195 111 245 182 197],629,4,34706,4.098004486952415,0.0,0.0
38469,3,8469,[318 427  98 191 182],72,5,34711,4.098110979929162,40.0,0.0
38470,3,8470,[318 427  98 191 182],450,5,34716,4.098217447762956,40.0,0.0
38471,3,8471,[ 97 288 273   4 748],450,2,34718,4.097969782813975,0.0,0.0
38472,3,8472,[748 161  12 508 153],280,3,34721,4.097840198276879,0.0,0.0
38473,3,8473,[318 427  98 191 182],72,5,34726,4.097946660372905,40.0,0.0
38474,3,8474,[318 427  98 191 182],72,5,34731,4.098053097345133,40.0,0.0
38475,3,8475,[318 427  98 191 182],450,5,34736,4.098159509202454,40.0,0.0
38476,3,8476,[318 427  98 191 182],655,5,34741,4.098265895953757,40.0,0.0
38477,3,8477,[258   7 204 237 301],344,3,34744,4.098136352913423,0.0,0.0
38478,3,8478,[ 15 483 357 423 202],655,2,34746,4.0978889019931595,0.0,0.0
38479,3,8479,[318 427  98 191 182],18,5,34751,4.097995283018868,40.0,0.0
38480,3,8480,[125   9 742 173  25],593,3,34754,4.097865817710176,0.0,0.0
38481,3,8481,[318 427  98 191 182],72,5,34759,4.097972176373497,40.0,0.0
38482,3,8482,[318 427  98 191 182],72,5,34764,4.098078509961098,40.0,0.0
38483,3,8483,[125  50 273 197 202],655,2,34766,4.097831211692598,0.0,20.0
38484,3,8484,[245   9 222 322 117],796,2,34768,4.097583971714791,0.0,0.0
38485,3,8485,[318 427  98 191 182],450,5,34773,4.097690313457459,40.0,0.0
38486,3,8486,[318 427  98 191 182],655,5,34778,4.0977966301402144,40.0,0.0
38487,3,8487,[483 423 357  56 427],450,4,34782,4.097785108388313,20.0,0.0
38488,3,8488,[204 186 153 313  79],796,4,34786,4.097773589350925,0.0,0.0
38489,3,8489,[318 427  98 191 182],796,5,34791,4.097879858657244,40.0,0.0
38490,3,8490,[143  15 179  28 181],655,2,34793,4.09763278765752,0.0,0.0
38491,3,8491,[191 294 265  69 234],457,4,34797,4.097621290626472,0.0,0.0
38492,3,8492,[ 96  64   4 258 403],796,5,34802,4.0977275403273286,20.0,0.0
38493,3,8493,[318 427  98 191 182],796,5,34807,4.097833765010596,40.0,0.0
38494,3,8494,[288  79   9 176 678],280,3,34810,4.097704532077692,0.0,0.0
38495,3,8495,[ 70  89 161 185 286],655,2,34812,4.0974576271186445,0.0,20.0
38496,3,8496,[318 427  98 191 182],72,5,34817,4.097563846063316,40.0,0.0
38497,3,8497,[318 427  98 191 182],72,5,34822,4.097670040009414,40.0,0.0
38498,3,8498,[318 427  98 191 182],18,5,34827,4.097776208965761,40.0,0.0
38499,3,8499,[318 427  98 191 182],18,5,34832,4.097882352941176,40.0,0.0
38500,3,8500,[228  70  25 286 100],344,3,34835,4.097753205505235,0.0,40.0
38501,3,8501,[318 427  98 191 182],796,5,34840,4.097859327217125,40.0,0.0
38502,3,8502,[318 427  98 191 182],269,5,34845,4.097965423968011,40.0,0.0
38503,3,8503,[237   4  12 318 258],796,5,34850,4.098071495766698,20.0,0.0
38504,3,8504,[300 301 185 748 210],450,4,34854,4.098059964726631,0.0,0.0
38505,3,8505,[318 427  98 191 182],655,5,34859,4.098166000470257,40.0,0.0
38506,3,8506,[151  69 125 211 496],450,5,34864,4.098272011284824,20.0,0.0
38507,3,8507,[ 50 179 215 268   4],655,2,34866,4.09802538787024,0.0,20.0
38508,3,8508,[318 427  98 191 182],72,5,34871,4.0981313902926315,40.0,0.0
38509,3,8509,[183 182 742 588 294],796,3,34874,4.098002350176263,0.0,0.0
38510,3,8510,[ 64 423  56 216   1],18,5,34879,4.0981083303959585,20.0,0.0
38511,3,8511,[ 64 748 435 216  25],450,4,34883,4.098096804511278,20.0,0.0
38512,3,8512,[238 191  56 161 742],655,1,34884,4.097732879126043,0.0,0.0
38513,3,8513,[127 435  56 135 483],18,4,34888,4.097721400046981,0.0,20.0
38514,3,8514,[748 546 742 228 194],450,5,34893,4.097827363476219,0.0,0.0
38515,3,8515,[  8 515 181 172 216],18,3,34896,4.097698449976515,0.0,0.0
38516,3,8516,[318 427  98 191 182],18,5,34901,4.097804391217565,40.0,0.0
38517,3,8517,[318 427  98 191 182],450,5,34906,4.09791030758394,40.0,0.0
38518,3,8518,[318 427  98 191 182],796,5,34911,4.0980161990844,40.0,0.0
38519,3,8519,[276 603 196 568 742],655,2,34913,4.097769953051643,20.0,0.0
38520,3,8520,[234 204 179 182 135],18,2,34915,4.097523764816336,0.0,0.0
38521,3,8521,[318 427  98 191 182],72,5,34920,4.097629664398029,40.0,0.0
38522,3,8522,[ 69 127  15 173 186],796,4,34924,4.097618209550627,0.0,20.0
38523,3,8523,[318 427  98 191 182],18,5,34929,4.097724073205068,40.0,0.0
38524,3,8524,[ 25 183 273 181 471],450,3,34932,4.097595307917889,0.0,0.0
38525,3,8525,[161 323 294 204 269],796,2,34934,4.097349284541402,0.0,0.0
38526,3,8526,[318 427  98 191 182],72,5,34939,4.097455142488566,40.0,0.0
38527,3,8527,[ 98 328 286 187 111],450,5,34944,4.097560975609756,0.0,20.0
38528,3,8528,[318 427  98 191 182],655,5,34949,4.097666783913706,40.0,0.0
38529,3,8529,[403 237  12 118   1],577,4,34953,4.097655334114888,0.0,0.0
38530,3,8530,[471 111 175 185  56],655,1,34954,4.0972922283436874,0.0,0.0
38531,3,8531,[318 427  98 191 182],72,5,34959,4.097398030942335,40.0,0.0
38532,3,8532,[275 322 151  71  12],344,3,34962,4.097269424586898,0.0,20.0
38533,3,8533,[318 427  98 191 182],269,5,34967,4.097375205062105,40.0,0.0
38534,3,8534,[318 427  98 191 182],18,5,34972,4.097480960749854,40.0,0.0
38535,3,8535,[ 79 228 215 475 282],655,1,34973,4.09711808809747,0.0,0.0
38536,3,8536,[318 427  98 191 182],18,5,34978,4.097223849127328,40.0,0.0
38537,3,8537,[318 427  98 191 182],655,5,34983,4.097329585382994,40.0,0.0
38538,3,8538,[318 427  98 191 182],796,5,34988,4.09743529687317,40.0,0.0
38539,3,8539,[318 427  98 191 182],796,5,34993,4.0975409836065575,40.0,0.0
38540,3,8540,[318 427  98 191 182],796,5,34998,4.097646645591851,40.0,0.0
38541,3,8541,[318 427  98 191 182],269,5,35003,4.097752282837743,40.0,0.0
38542,3,8542,[ 56 186 194  79 435],535,3,35006,4.097623785555426,0.0,0.0
38543,3,8543,[318 427  98 191 182],72,5,35011,4.0977294007490634,40.0,0.0
38544,3,8544,[318 427  98 191 182],269,5,35016,4.097834991222937,40.0,0.0
38545,3,8545,[318 427  98 191 182],18,5,35021,4.097940556985725,40.0,0.0
38546,3,8546,[318 427  98 191 182],269,5,35026,4.098046098046098,40.0,0.0
38547,3,8547,[ 11   4 210 471 196],577,2,35028,4.097800655124006,0.0,0.0
38548,3,8548,[268  97   8  11  69],655,0,35028,4.097321324131477,0.0,0.0
38549,3,8549,[235 215  82 118 180],457,4,35032,4.097309941520468,0.0,0.0
38550,3,8550,[185 300 301 423 269],450,5,35037,4.09741550695825,0.0,0.0
38551,3,8551,[318 427  98 191 182],269,5,35042,4.097521047708138,40.0,0.0
38552,3,8552,[318 427  98 191 182],269,5,35047,4.097626563778791,40.0,0.0
38553,3,8553,[318 427  98 191 182],796,5,35052,4.097732055178864,40.0,0.0
38554,3,8554,[318 427  98 191 182],450,5,35057,4.097837521917008,40.0,0.0
38555,3,8555,[ 97  12  69 132 211],450,5,35062,4.09794296400187,0.0,0.0
38556,3,8556,[318 427  98 191 182],72,5,35067,4.098048381442094,40.0,0.0
38557,3,8557,[318 427  98 191 182],450,5,35072,4.098153774246319,40.0,0.0
38558,3,8558,[196  22  69 269 276],655,1,35073,4.097791798107256,0.0,0.0
38559,3,8559,[588 258 483 135  79],807,4,35077,4.0977803738317755,0.0,0.0
38560,3,8560,[318 427  98 191 182],72,5,35082,4.097885761009228,40.0,0.0
38561,3,8561,[318 427  98 191 182],72,5,35087,4.097991123569259,40.0,0.0
38562,3,8562,[333 195  15  64 294],629,4,35091,4.097979680018685,20.0,0.0
38563,3,8563,[471 294 216 125 385],577,4,35095,4.097968239140589,0.0,0.0
38564,3,8564,[318 427  98 191 182],72,5,35100,4.0980735551663745,40.0,0.0
38565,3,8565,[357 655  12 161 237],796,4,35104,4.098062106000467,0.0,0.0
38566,3,8566,[  1  50  95 238  25],18,4,35108,4.098050659507412,0.0,20.0
38567,3,8567,[427 423 603 238 174],911,3,35111,4.097922502334267,40.0,0.0
38568,3,8568,[257 195 185 172 234],716,4,35115,4.097911074804528,0.0,0.0
38569,3,8569,[357 289 273   4 228],655,2,35117,4.097666277712952,0.0,0.0
38570,3,8570,[318 427  98 191 182],450,5,35122,4.097771555244429,40.0,0.0
38571,3,8571,[197 258 357 125 216],151,5,35127,4.097876808212786,0.0,0.0
38572,3,8572,[318 427  98 191 182],18,5,35132,4.097982036626618,40.0,0.0
38573,3,8573,[318 427  98 191 182],72,5,35137,4.098087240494518,40.0,0.0
38574,3,8574,[318 427  98 191 182],655,5,35142,4.0981924198250725,40.0,0.0
38575,3,8575,[318 427  98 191 182],655,5,35147,4.098297574626866,40.0,0.0
38576,3,8576,[318 427  98 191 182],72,5,35152,4.098402704908477,40.0,0.0
38577,3,8577,[318 427  98 191 182],18,5,35157,4.09850781067848,40.0,0.0
38578,3,8578,[179  12  25 118  22],577,3,35160,4.098379764541322,0.0,0.0
38579,3,8579,[161   7 151 195 117],885,4,35164,4.098368298368299,0.0,0.0
38580,3,8580,[318 427  98 191 182],72,5,35169,4.098473371401934,40.0,0.0
38581,3,8581,[ 71 275  25   1 200],330,5,35174,4.09857841994873,0.0,20.0
38582,3,8582,[318 427  98 191 182],18,5,35179,4.098683444017244,40.0,0.0
38583,3,8583,[318 427  98 191 182],269,5,35184,4.09878844361603,40.0,0.0
38584,3,8584,[117 153 423 385 216],796,5,35189,4.09889341875364,0.0,0.0
38585,3,8585,[318 427  98 191 182],450,5,35194,4.098998369438621,40.0,0.0
38586,3,8586,[258 546 173 196  88],796,5,35199,4.099103295679516,0.0,0.0
38587,3,8587,[423 173 286 125 238],450,5,35204,4.099208197484862,0.0,20.0
38588,3,8588,[318 427  98 191 182],796,5,35209,4.099313074863197,40.0,0.0
38589,3,8589,[318 427  98 191 182],18,5,35214,4.09941792782305,40.0,0.0
38590,3,8590,[318 427  98 191 182],72,5,35219,4.099522756372949,40.0,0.0
38591,3,8591,[ 98 275 186  22 211],535,3,35222,4.099394785847299,0.0,20.0
38592,3,8592,[288 144 132 269 176],655,0,35222,4.098917723728617,0.0,0.0
38593,3,8593,[ 96 210 135 423 302],450,3,35225,4.098789853386084,0.0,0.0
38594,3,8594,[  9 423 603 301  97],535,5,35230,4.0988947062245495,20.0,0.0
38595,3,8595,[742  56 216 258 127],450,5,35235,4.098999534667287,0.0,20.0
38596,3,8596,[  4 153  89 132  95],450,3,35238,4.098871699430034,0.0,0.0
38597,3,8597,[318 427  98 191 182],18,5,35243,4.098976506164224,40.0,0.0
38598,3,8598,[ 56  11 200 403  50],269,2,35245,4.098732410745436,0.0,20.0
38599,3,8599,[427 597 111 655 588],450,5,35250,4.098837209302325,20.0,0.0
38600,3,8600,[200 238 568 111  71],593,5,35255,4.098941983490292,0.0,0.0
38601,3,8601,[318 427  98 191 182],72,5,35260,4.099046733317833,40.0,0.0
38602,3,8602,[427 273  96 300 202],450,4,35264,4.099035220271998,20.0,0.0
38603,3,8603,[191 405  15 275 161],655,2,35266,4.098791259879126,0.0,20.0
38604,3,8604,[318 427  98 191 182],269,5,35271,4.098895990703079,40.0,0.0
38605,3,8605,[318 427  98 191 182],72,5,35276,4.099000697188008,40.0,0.0
38606,3,8606,[ 97   4 258  69 144],457,5,35281,4.0991053793423955,0.0,0.0
38607,3,8607,[204 135 181 197 423],18,2,35283,4.098861524163569,0.0,0.0
38608,3,8608,[216  95   1 597 182],450,4,35287,4.098850040655129,0.0,0.0
38609,3,8609,[186 183  56 318 174],504,2,35289,4.098606271777004,20.0,0.0
38610,3,8610,[318 427  98 191 182],655,5,35294,4.098710951109046,40.0,0.0
38611,3,8611,[318 427  98 191 182],72,5,35299,4.09881560613098,40.0,0.0
38612,3,8612,[318 427  98 191 182],450,5,35304,4.098920236851272,40.0,0.0
38613,3,8613,[200 742 185 597 357],457,4,35308,4.098908753192477,0.0,0.0
38614,3,8614,[ 97 182 333 144 269],796,3,35311,4.098781195589089,0.0,0.0
38615,3,8615,[ 79 132 568  56 286],280,4,35315,4.098769730733519,0.0,20.0
38616,3,8616,[210 117  98 323 204],174,4,35319,4.098758268538934,0.0,0.0
38617,3,8617,[144 191 161 655  98],457,5,35324,4.098862845207705,0.0,0.0
38618,3,8618,[318 427  98 191 182],450,5,35329,4.098967397609932,40.0,0.0
38619,3,8619,[318 427  98 191 182],450,5,35334,4.09907192575406,40.0,0.0
38620,3,8620,[322 313  98 294 132],796,3,35337,4.098944438000232,0.0,0.0
38621,3,8621,[318 427  98 191 182],450,5,35342,4.099048944560427,40.0,0.0
38622,3,8622,[ 50 179 196  56 237],65,3,35345,4.098921489040937,0.0,20.0
38623,3,8623,[191 117 174  12  28],450,5,35350,4.099025974025974,0.0,0.0
38624,3,8624,[271   4 210 183  22],796,4,35354,4.099014492753623,0.0,0.0
38625,3,8625,[318 427  98 191 182],450,5,35359,4.099118942731278,40.0,0.0
38626,3,8626,[318 427  98 191 182],450,5,35364,4.099223368494262,40.0,0.0
38627,3,8627,[403 333 187 172  12],693,1,35365,4.098864163189615,0.0,0.0
38628,3,8628,[318 427  98 191 182],796,5,35370,4.098968594275119,40.0,0.0
38629,3,8629,[318 427  98 191 182],18,5,35375,4.099073001158748,40.0,0.0
38630,3,8630,[ 22 286 269  69 210],18,4,35379,4.099061522419187,0.0,20.0
38631,3,8631,[  1 132 471 385 183],280,3,35382,4.098934198331789,0.0,0.0
38632,3,8632,[300 322  15 265 748],151,3,35385,4.098806903741457,0.0,0.0
38633,3,8633,[318 427  98 191 182],655,5,35390,4.098911280982164,40.0,0.0
38634,3,8634,[597 200  97 197 403],450,4,35394,4.098899826288362,0.0,0.0
38635,3,8635,[143 588 655 286 265],450,5,35399,4.099004168596572,0.0,20.0
38636,3,8636,[423 678   9   4   7],280,3,35402,4.0988769248581685,0.0,0.0
38637,3,8637,[318 427  98 191 182],655,5,35407,4.098981245658718,40.0,0.0
38638,3,8638,[318 427  98 191 182],18,5,35412,4.099085542308138,40.0,0.0
38639,3,8639,[405  88 496 174 222],796,5,35417,4.099189814814815,20.0,0.0
38640,3,8640,[216   8 288  70 318],593,4,35421,4.099178335840759,20.0,0.0
38641,3,8641,[318 427  98 191 182],796,5,35426,4.099282573478361,40.0,0.0
38642,3,8642,[117 118 100  12   4],344,3,35429,4.0991553858613905,0.0,20.0
38643,3,8643,[742 143 196 186 153],655,1,35430,4.098796853308653,0.0,0.0
38644,3,8644,[318 427  98 191 182],796,5,35435,4.0989010989010985,40.0,0.0
38645,3,8645,[318 427  98 191 182],450,5,35440,4.099005320379367,40.0,0.0
38646,3,8646,[196  89 234  97 202],457,5,35445,4.099109517751821,0.0,0.0
38647,3,8647,[301  71 202 471 222],344,3,35448,4.098982423681776,0.0,0.0
38648,3,8648,[ 11 151 496 121  89],269,2,35450,4.098739738698115,20.0,0.0
38649,3,8649,[318 427  98 191 182],269,5,35455,4.098843930635838,40.0,0.0
38650,3,8650,[318 427  98 191 182],18,5,35460,4.0989480984857245,40.0,0.0
38651,3,8651,[286 216 322 423 655],796,2,35462,4.098705501618123,0.0,20.0
38652,3,8652,[515 210 423  79 265],807,5,35467,4.098809661389113,0.0,0.0
38653,3,8653,[318 427  98 191 182],796,5,35472,4.098913797088052,40.0,0.0
38654,3,8654,[318 427  98 191 182],18,5,35477,4.099017908723281,40.0,0.0
38655,3,8655,[318 427  98 191 182],450,5,35482,4.0991219963031424,40.0,0.0
38656,3,8656,[318 427  98 191 182],796,5,35487,4.099226059835971,40.0,0.0
38657,3,8657,[100 196 144 357  15],629,5,35492,4.099330099330099,0.0,20.0
38658,3,8658,[318 427  98 191 182],72,5,35497,4.099434114793856,40.0,0.0
38659,3,8659,[318 427  98 191 182],72,5,35502,4.099538106235566,40.0,0.0
38660,3,8660,[318 427  98 191 182],72,5,35507,4.099642073663549,40.0,0.0
38661,3,8661,[318 427  98 191 182],18,5,35512,4.099746017086123,40.0,0.0
38662,3,8662,[200 135 181 435 257],5,4,35516,4.099734503058986,0.0,0.0
38663,3,8663,[204 151 546 182 179],450,5,35521,4.099838411819022,0.0,0.0
38664,3,8664,[318 427  98 191 182],269,5,35526,4.099942296595499,40.0,0.0
38665,3,8665,[318 427  98 191 182],450,5,35531,4.100046157396723,40.0,0.0
38666,3,8666,[318 427  98 191 182],450,5,35536,4.100149994230991,40.0,0.0
38667,3,8667,[ 28 202 196 180 210],18,2,35538,4.099907706506691,0.0,0.0
38668,3,8668,[  9  82  12 483 216],796,3,35541,4.0997808282385515,0.0,0.0
38669,3,8669,[172   8  56   1 182],593,2,35543,4.099538638985006,0.0,0.0
38670,3,8670,[318 427  98 191 182],269,5,35548,4.099642486449083,40.0,0.0
38671,3,8671,[143 153 603 210 181],401,3,35551,4.099515682656826,20.0,0.0
38672,3,8672,[318 427  98 191 182],269,5,35556,4.099619508820477,40.0,0.0
38673,3,8673,[318 427  98 191 182],269,5,35561,4.0997233110445,40.0,0.0
38674,3,8674,[318 427  98 191 182],72,5,35566,4.099827089337176,40.0,0.0
38675,3,8675,[318 405 257 215 216],330,5,35571,4.099930843706777,20.0,0.0
38676,3,8676,[318 427  98 191 182],655,5,35576,4.100034574161577,40.0,0.0
38677,3,8677,[568  28 111 118 132],450,4,35580,4.100023046784973,0.0,0.0
38678,3,8678,[318 427  98 191 182],655,5,35585,4.100126742712294,40.0,0.0
38679,3,8679,[742 228   4 235  88],344,2,35587,4.099884792626728,0.0,0.0
38680,3,8680,[318 427  98 191 182],269,5,35592,4.0999884805897935,40.0,0.0
38681,3,8681,[318 427  98 191 182],796,5,35597,4.100092144667127,40.0,0.0
38682,3,8682,[187  96  64 143  22],450,5,35602,4.100195784866981,20.0,0.0
38683,3,8683,[405 175  82   9 228],151,3,35605,4.100069092584063,0.0,0.0
38684,3,8684,[153  89 100 174 300],655,1,35606,4.099712147380541,0.0,20.0
38685,3,8685,[318 427  98 191 182],655,5,35611,4.099815795533042,40.0,0.0
38686,3,8686,[318 427  98 191 182],18,5,35616,4.099919419822724,40.0,0.0
38687,3,8687,[318 427  98 191 182],72,5,35621,4.100023020257827,40.0,0.0
38688,3,8688,[318 427  98 191 182],796,5,35626,4.100126596846588,40.0,0.0
38689,3,8689,[568 546 127 151 216],450,5,35631,4.100230149597238,0.0,20.0
38690,3,8690,[318 427  98 191 182],72,5,35636,4.100333678518007,40.0,0.0
38691,3,8691,[318 427  98 191 182],796,5,35641,4.100437183617119,40.0,0.0
38692,3,8692,[191  50 200  96 483],269,3,35644,4.100310594731393,0.0,20.0
38693,3,8693,[194 168 427 222 182],796,5,35649,4.100414078674948,20.0,0.0
38694,3,8694,[318 427  98 191 182],450,5,35654,4.100517538815411,40.0,0.0
38695,3,8695,[151 276  11 655  82],457,5,35659,4.100620975160994,0.0,0.0
38696,3,8696,[  7 546 196  69 655],151,4,35663,4.100609405542141,0.0,0.0
38697,3,8697,[318 427  98 191 182],269,5,35668,4.100712807541964,40.0,0.0
38698,3,8698,[318 427  98 191 182],72,5,35673,4.100816185768479,40.0,0.0
38699,3,8699,[318 427  98 191 182],796,5,35678,4.100919540229885,40.0,0.0
38700,3,8700,[318 427  98 191 182],72,5,35683,4.101022870934376,40.0,0.0
38701,3,8701,[318 427  98 191 182],450,5,35688,4.10112617789014,40.0,0.0
38702,3,8702,[318 427  98 191 182],450,5,35693,4.101229461105366,40.0,0.0
38703,3,8703,[187 204 161 294 222],716,3,35696,4.101102941176471,0.0,0.0
38704,3,8704,[ 50   7  12 195   9],344,5,35701,4.101206203331419,0.0,20.0
38705,3,8705,[318 427  98 191 182],655,5,35706,4.1013094417643,40.0,0.0
38706,3,8706,[ 70 271  28 216 118],655,1,35707,4.100953256000919,0.0,0.0
38707,3,8707,[318 427  98 191 182],269,5,35712,4.101056499770326,40.0,0.0
38708,3,8708,[204  95   1  56  64],577,4,35716,4.1010448960845105,20.0,0.0
38709,3,8709,[318 427  98 191 182],655,5,35721,4.101148105625717,40.0,0.0
38710,3,8710,[168   7 176 194 269],450,5,35726,4.101251291470555,0.0,0.0
38711,3,8711,[318 427  98 191 182],796,5,35731,4.101354453627181,40.0,0.0
38712,3,8712,[ 69 132 174 322 182],629,4,35735,4.101342821071961,0.0,0.0
38713,3,8713,[318 427  98 191 182],796,5,35740,4.10144594904751,40.0,0.0
38714,3,8714,[185  22  50 216 143],269,1,35741,4.10109007458405,0.0,20.0
38715,3,8715,[273 174 294 603 161],401,2,35743,4.100849013308857,20.0,0.0
38716,3,8716,[265 258 300 144 294],796,4,35747,4.100837444074797,0.0,0.0
38717,3,8717,[318 427  98 191 182],72,5,35752,4.100940582702455,40.0,0.0
38718,3,8718,[318 427  98 191 182],72,5,35757,4.101043697671751,40.0,0.0
38719,3,8719,[423 328 195 118 300],151,2,35759,4.100802752293578,0.0,0.0
38720,3,8720,[  1 238 318 423 245],450,5,35764,4.100905859419791,20.0,0.0
38721,3,8721,[588  64 172 655 210],450,4,35768,4.10089429030039,20.0,0.0
38722,3,8722,[318 427  98 191 182],269,5,35773,4.1009973632924455,40.0,0.0
38723,3,8723,[ 25  70  96 257 435],716,4,35777,4.100985786336543,0.0,0.0
38724,3,8724,[318 427  98 191 182],796,5,35782,4.1010888252149,40.0,0.0
38725,3,8725,[318 427  98 191 182],450,5,35787,4.101191840476736,40.0,0.0
38726,3,8726,[204 127 172 403 161],269,1,35788,4.100836484473473,0.0,20.0
38727,3,8727,[210 496 215 121  11],450,3,35791,4.100710357470211,20.0,0.0
38728,3,8728,[318 427  98 191 182],72,5,35796,4.100813380685072,40.0,0.0
38729,3,8729,[191 546 405 186 273],796,3,35799,4.100687285223367,0.0,0.0
38730,3,8730,[318 427  98 191 182],72,5,35804,4.100790287481388,40.0,0.0
38731,3,8731,[483  22 168 265  89],807,5,35809,4.100893266147503,0.0,0.0
38732,3,8732,[  9 161  79 427 202],796,4,35813,4.100881713042482,20.0,0.0
38733,3,8733,[  4 313 132 202 427],577,5,35818,4.100984657659721,20.0,0.0
38734,3,8734,[318 427  98 191 182],450,5,35823,4.101087578706354,40.0,0.0
38735,3,8735,[318 427  98 191 182],269,5,35828,4.101190476190476,40.0,0.0
38736,3,8736,[181 385 210 403 132],655,0,35828,4.10072107130594,0.0,0.0
38737,3,8737,[318 427  98 191 182],269,5,35833,4.100823987182421,40.0,0.0
38738,3,8738,[318 427  98 191 182],269,5,35838,4.100926879505664,40.0,0.0
38739,3,8739,[318 427  98 191 182],18,5,35843,4.101029748283753,40.0,0.0
38740,3,8740,[318 427  98 191 182],269,5,35848,4.101132593524769,40.0,0.0
38741,3,8741,[191 588 678 323 275],316,2,35850,4.10089224433768,0.0,20.0
38742,3,8742,[318 427  98 191 182],655,5,35855,4.100995081779709,40.0,0.0
38743,3,8743,[318 427  98 191 182],796,5,35860,4.101097895699908,40.0,0.0
38744,3,8744,[180 216 185   8   4],796,4,35864,4.101086335048599,0.0,0.0
38745,3,8745,[300 216  15 237 121],796,5,35869,4.101189115024011,0.0,0.0
38746,3,8746,[258 125  98  50 269],655,2,35871,4.100948896764605,0.0,20.0
38747,3,8747,[322  56 471 153 173],593,3,35874,4.100823045267489,0.0,0.0
38748,3,8748,[318 427  98 191 182],72,5,35879,4.100925820093725,40.0,0.0
38749,3,8749,[ 88 275 271  69  28],796,4,35883,4.1009142857142855,0.0,20.0
38750,3,8750,[318 427  98 191 182],796,5,35888,4.101017026625528,40.0,0.0
38751,3,8751,[318 427  98 191 182],655,5,35893,4.101119744058501,40.0,0.0
38752,3,8752,[313 678 318 597  28],807,4,35897,4.101108191477207,20.0,0.0
38753,3,8753,[289  15 603  88 181],655,1,35898,4.100753941055517,20.0,0.0
38754,3,8754,[318 427  98 191 182],18,5,35903,4.100856653340948,40.0,0.0
38755,3,8755,[318 427  98 191 182],269,5,35908,4.100959342165372,40.0,0.0
38756,3,8756,[318 427  98 191 182],450,5,35913,4.101062007536828,40.0,0.0
38757,3,8757,[191  50 121 427 403],655,3,35916,4.100936286823476,20.0,20.0
38758,3,8758,[318 427  98 191 182],18,5,35921,4.101038931384862,40.0,0.0
38759,3,8759,[318 427  98 191 182],796,5,35926,4.101141552511415,40.0,0.0
38760,3,8760,[471 276 204 357 127],655,3,35929,4.101015865768748,0.0,20.0
38761,3,8761,[161 144 588  82 215],280,2,35931,4.1007760785208855,0.0,0.0
38762,3,8762,[318 427  98 191 182],796,5,35936,4.100878694511012,40.0,0.0
38763,3,8763,[318 427  98 191 182],655,5,35941,4.100981287083523,40.0,0.0
38764,3,8764,[318 427  98 191 182],18,5,35946,4.101083856246435,40.0,0.0
38765,3,8765,[318 427  98 191 182],655,5,35951,4.101186402007757,40.0,0.0
38766,3,8766,[210 168 588 204 202],457,5,35956,4.101288924375499,0.0,0.0
38767,3,8767,[318 427  98 191 182],72,5,35961,4.101391423357664,40.0,0.0
38768,3,8768,[318 427  98 191 182],18,5,35966,4.101493898962254,40.0,0.0
38769,3,8769,[318 427  98 191 182],72,5,35971,4.101596351197263,40.0,0.0
38770,3,8770,[318 427  98 191 182],18,5,35976,4.101698780070688,40.0,0.0
38771,3,8771,[ 97  56 302 132 405],151,3,35979,4.101573187414501,0.0,0.0
38772,3,8772,[273 237 276  71 118],344,2,35981,4.10133363729625,0.0,0.0
38773,3,8773,[187  71 286   1 300],389,3,35984,4.101208114884887,0.0,20.0
38774,3,8774,[318 427  98 191 182],72,5,35989,4.101310541310541,40.0,0.0
38775,3,8775,[318 427  98 191 182],655,5,35994,4.101412944393801,40.0,0.0
38776,3,8776,[100   8 151 210 185],330,5,35999,4.101515324142645,0.0,20.0
38777,3,8777,[ 95 245 265 568 173],280,2,36001,4.101275917065391,0.0,0.0
38778,3,8778,[179  11 222 196 234],450,3,36004,4.101150472718989,0.0,0.0
38779,3,8779,[423 176  50 238 471],655,1,36005,4.100797266514807,0.0,20.0
38780,3,8780,[318 427  98 191 182],18,5,36010,4.100899669741487,40.0,0.0
38781,3,8781,[318 427  98 191 182],18,5,36015,4.101002049647005,40.0,0.0
38782,3,8782,[118 216 655 100 237],450,4,36019,4.100990549925993,0.0,20.0
38783,3,8783,[318 427  98 191 182],450,5,36024,4.101092896174864,40.0,0.0
38784,3,8784,[ 97 222 121 191 286],786,4,36028,4.101081388730791,0.0,20.0
38785,3,8785,[180 182 328  64  95],450,4,36032,4.101069883906215,20.0,0.0
38786,3,8786,[318 427  98 191 182],18,5,36037,4.101172186184136,40.0,0.0
38787,3,8787,[318 427  98 191 182],655,5,36042,4.101274465179791,40.0,0.0
38788,3,8788,[ 88 144  15 202 423],655,0,36042,4.100807827966777,0.0,0.0
38789,3,8789,[546 183 176 216 151],577,4,36046,4.100796359499431,0.0,0.0
38790,3,8790,[161 603 118  56 168],716,3,36049,4.100671140939597,20.0,0.0
38791,3,8791,[568 100 678  50 176],280,0,36049,4.100204731574158,0.0,40.0
38792,3,8792,[318 427  98 191 182],796,5,36054,4.100307062436029,40.0,0.0
38793,3,8793,[603 197  79 135 286],450,4,36058,4.100295656129179,20.0,20.0
38794,3,8794,[318 427  98 191 182],269,5,36063,4.100397953382604,40.0,0.0
38795,3,8795,[ 69 181 151 211 186],450,4,36067,4.1003865393360615,0.0,0.0
38796,3,8796,[118  82 100  97 135],655,1,36068,4.100034102534955,0.0,20.0
38797,3,8797,[318 427  98 191 182],450,5,36073,4.100136394635144,40.0,0.0
38798,3,8798,[318 427  98 191 182],269,5,36078,4.100238663484487,40.0,0.0
38799,3,8799,[286  64 182 427  70],655,3,36081,4.100113636363637,40.0,20.0
38800,3,8800,[318 427  98 191 182],18,5,36086,4.1002158845585726,40.0,0.0
38801,3,8801,[318 427  98 191 182],72,5,36091,4.100318109520564,40.0,0.0
38802,3,8802,[181 222 180   4  98],280,2,36093,4.100079518346019,0.0,0.0
38803,3,8803,[318 427  98 191 182],450,5,36098,4.100181735574739,40.0,0.0
38804,3,8804,[288 268 357 135 222],655,2,36100,4.0999432140829075,0.0,0.0
38805,3,8805,[318 427  98 191 182],269,5,36105,4.100045423574835,40.0,0.0
38806,3,8806,[215   9 185 515 282],535,3,36108,4.099920517769956,0.0,0.0
38807,3,8807,[  9 111  98  70  69],457,4,36112,4.099909173478656,0.0,0.0
38808,3,8808,[405  11 322  98  69],280,4,36116,4.09989783176297,0.0,0.0
38809,3,8809,[318 427  98 191 182],18,5,36121,4.1,40.0,0.0
38810,3,8810,[318 427  98 191 182],450,5,36126,4.100102145045965,40.0,0.0
38811,3,8811,[175 216 427 180  70],269,2,36128,4.099863822060827,20.0,0.0
38812,3,8812,[ 98 237 265 235 483],280,4,36132,4.099852490638829,0.0,0.0
38813,3,8813,[318 427  98 191 182],450,5,36137,4.099954617653733,40.0,0.0
38814,3,8814,[195  28 117 435 175],655,0,36137,4.099489506522972,0.0,0.0
38815,3,8815,[ 69  79 275  88 322],796,4,36141,4.099478221415608,0.0,20.0
38816,3,8816,[471 328 318 294  88],655,1,36142,4.099126687081774,20.0,0.0
38817,3,8817,[235  64 127 179 357],450,4,36146,4.099115445679292,20.0,20.0
38818,3,8818,[318 427  98 191 182],450,5,36151,4.0992175983671615,40.0,0.0
38819,3,8819,[318 427  98 191 182],269,5,36156,4.099319727891157,40.0,0.0
38820,3,8820,[318 427  98 191 182],655,5,36161,4.099421834259155,40.0,0.0
38821,3,8821,[ 95 496 176 172 357],344,5,36166,4.09952391747903,20.0,0.0
38822,3,8822,[318 427  98 191 182],796,5,36171,4.099625977558653,40.0,0.0
38823,3,8823,[ 71 181  69 161 282],593,5,36176,4.099728014505893,0.0,0.0
38824,3,8824,[153 135  28 265 288],450,3,36179,4.099603399433428,0.0,0.0
38825,3,8825,[  4 276  15 179 228],786,3,36182,4.099478812599139,0.0,0.0
38826,3,8826,[655 143 176  50 197],504,3,36185,4.099354253993429,0.0,20.0
38827,3,8827,[318 427  98 191 182],655,5,36190,4.0994562754870865,40.0,0.0
38828,3,8828,[318 427  98 191 182],72,5,36195,4.0995582738702,40.0,0.0
38829,3,8829,[483 144  71 515 173],535,3,36198,4.099433748584372,0.0,0.0
38830,3,8830,[  9 568 234  71 127],280,3,36201,4.099309251500396,0.0,20.0
38831,3,8831,[318 427  98 191 182],18,5,36206,4.099411231884058,40.0,0.0
38832,3,8832,[318   9 234  25 127],457,5,36211,4.0995131891769505,20.0,20.0
38833,3,8833,[  9  69 186  82   1],457,5,36216,4.099615123386914,0.0,0.0
38834,3,8834,[318 427  98 191 182],269,5,36221,4.099717034521788,40.0,0.0
38835,3,8835,[318 427  98 191 182],796,5,36226,4.099818922589407,40.0,0.0
38836,3,8836,[301   1 286  95 127],796,2,36228,4.099581305873034,0.0,40.0
38837,3,8837,[318 427  98 191 182],796,5,36233,4.099683186241231,40.0,0.0
38838,3,8838,[318 427  98 191 182],72,5,36238,4.099785043556963,40.0,0.0
38839,3,8839,[172 196 215 143 202],457,5,36243,4.099886877828054,0.0,0.0
38840,3,8840,[  1 179 427 318 328],65,3,36246,4.0997624703087885,40.0,0.0
38841,3,8841,[ 71 385 322 181 111],593,4,36250,4.099751187514137,0.0,0.0
38842,3,8842,[546 176 288  97 143],450,4,36254,4.099739907271288,0.0,0.0
38843,3,8843,[15 12 89  7 95],450,3,36257,4.0996155585707825,0.0,0.0
38844,3,8844,[318 427  98 191 182],72,5,36262,4.099717354437535,40.0,0.0
38845,3,8845,[318 427  98 191 182],72,5,36267,4.09981912728917,40.0,0.0
38846,3,8846,[318 427  98 191 182],655,5,36272,4.099920877133491,40.0,0.0
38847,3,8847,[111 273 125  11 475],655,1,36273,4.099570524412297,0.0,0.0
38848,3,8848,[161 215  64 288 385],450,4,36277,4.099559272234151,20.0,0.0
38849,3,8849,[318 427  98 191 182],72,5,36282,4.0996610169491525,40.0,0.0
38850,3,8850,[742  79 603 568 200],450,4,36286,4.099649757089594,20.0,0.0
38851,3,8851,[318 427  98 191 182],796,5,36291,4.099751468594667,40.0,0.0
38852,3,8852,[ 88 196 742 144 172],593,5,36296,4.0998531571218795,0.0,0.0
38853,3,8853,[318 427  98 191 182],450,5,36301,4.099954822679015,40.0,0.0
38854,3,8854,[318 427  98 191 182],18,5,36306,4.100056465273856,40.0,0.0
38855,3,8855,[318 302 211 245 168],450,5,36311,4.100158084914183,20.0,0.0
38856,3,8856,[318 427  98 191 182],796,5,36316,4.100259681607768,40.0,0.0
38857,3,8857,[222 173 588  70  50],280,2,36318,4.100022578460149,0.0,20.0
38858,3,8858,[318 427  98 191 182],72,5,36323,4.100124167513263,40.0,0.0
38859,3,8859,[318 427  98 191 182],18,5,36328,4.1002257336343115,40.0,0.0
38860,3,8860,[318 427  98 191 182],72,5,36333,4.100327276831058,40.0,0.0
38861,3,8861,[ 88 197 234  69 742],796,2,36335,4.100090273076055,0.0,0.0
38862,3,8862,[318 427  98 191 182],269,5,36340,4.100191808642672,40.0,0.0
38863,3,8863,[161 179  70 588 143],457,5,36345,4.100293321299639,0.0,0.0
38864,3,8864,[318 427  98 191 182],796,5,36350,4.100394811054709,40.0,0.0
38865,3,8865,[318 427  98 191 182],796,5,36355,4.100496277915632,40.0,0.0
38866,3,8866,[313  12 196 238 100],796,3,36358,4.100372166459907,0.0,20.0
38867,3,8867,[318 427  98 191 182],269,5,36363,4.100473612990528,40.0,0.0
38868,3,8868,[318 427  98 191 182],269,5,36368,4.100575036644492,40.0,0.0
38869,3,8869,[318 427  98 191 182],269,5,36373,4.100676437429538,40.0,0.0
38870,3,8870,[202 357 191   4 117],786,5,36378,4.100777815353399,0.0,0.0
38871,3,8871,[ 15 173  25 742  98],11,2,36380,4.100541027953111,0.0,0.0
38872,3,8872,[318 427  98 191 182],18,5,36385,4.100642398286938,40.0,0.0
38873,3,8873,[318 427  98 191 182],269,5,36390,4.100743745774172,40.0,0.0
38874,3,8874,[318 427  98 191 182],796,5,36395,4.100845070422535,40.0,0.0
38875,3,8875,[288  70 603 179  96],655,2,36397,4.100608382154124,20.0,0.0
38876,3,8876,[318 427  98 191 182],18,5,36402,4.10070969922271,40.0,0.0
38877,3,8877,[483 161 202   8 194],389,4,36406,4.10069835548547,0.0,0.0
38878,3,8878,[318 427  98 191 182],72,5,36411,4.100799639599054,40.0,0.0
38879,3,8879,[ 56 357 603  50 276],269,4,36415,4.100788288288288,20.0,20.0
38880,3,8880,[318 427  98 191 182],18,5,36420,4.1008895394662765,40.0,0.0
38881,3,8881,[318 427  98 191 182],269,5,36425,4.10099076784508,40.0,0.0
38882,3,8882,[318 427  98 191 182],18,5,36430,4.101091973432399,40.0,0.0
38883,3,8883,[318 427  98 191 182],18,5,36435,4.101193156235929,40.0,0.0
38884,3,8884,[318 427  98 191 182],450,5,36440,4.101294316263365,40.0,0.0
38885,3,8885,[318 427  98 191 182],450,5,36445,4.101395453522395,40.0,0.0
38886,3,8886,[318 427  98 191 182],450,5,36450,4.101496568020704,40.0,0.0
38887,3,8887,[603  25 435 423 183],151,4,36454,4.101485148514851,20.0,0.0
38888,3,8888,[483 194 216 237 117],716,5,36459,4.101586230172122,0.0,0.0
38889,3,8889,[318 427  98 191 182],72,5,36464,4.101687289088864,40.0,0.0
38890,3,8890,[318 427  98 191 182],655,5,36469,4.101788325272747,40.0,0.0
38891,3,8891,[111 202 127 228 173],457,4,36473,4.101776878092668,0.0,20.0
38892,3,8892,[603 301 125 215 655],655,1,36474,4.101428089508603,20.0,0.0
38893,3,8893,[300 100 655  98 111],655,1,36475,4.10107937935687,0.0,20.0
38894,3,8894,[  7 135  98  96 288],450,3,36478,4.100955593029792,0.0,0.0
38895,3,8895,[318 427  98 191 182],269,5,36483,4.101056654676259,40.0,0.0
38896,3,8896,[265 172 143 183 125],796,5,36488,4.101157693604586,0.0,0.0
38897,3,8897,[318 427  98 191 182],655,5,36493,4.101258709822432,40.0,0.0
38898,3,8898,[318 427  98 191 182],450,5,36498,4.101359703337454,40.0,0.0
38899,3,8899,[318 427  98 191 182],72,5,36503,4.101460674157304,40.0,0.0
38900,3,8900,[318 427  98 191 182],655,5,36508,4.101561622289631,40.0,0.0
38901,3,8901,[603 181 237 318  64],450,5,36513,4.10166254774208,60.0,0.0
38902,3,8902,[318 427  98 191 182],796,5,36518,4.101763450522296,40.0,0.0
38903,3,8903,[210 196  22 195 132],450,4,36522,4.1017520215633425,0.0,0.0
38904,3,8904,[318 427  98 191 182],450,5,36527,4.101852891633913,40.0,0.0
38905,3,8905,[195 300 483 286  89],450,4,36531,4.101841455198742,0.0,20.0
38906,3,8906,[318 427  98 191 182],269,5,36536,4.101942292578871,40.0,0.0
38907,3,8907,[318 427  98 191 182],796,5,36541,4.102043107319264,40.0,0.0
38908,3,8908,[318 427  98 191 182],72,5,36546,4.102143899427545,40.0,0.0
38909,3,8909,[318 427  98 191 182],796,5,36551,4.102244668911336,40.0,0.0
38910,3,8910,[318 427  98 191 182],796,5,36556,4.1023454157782515,40.0,0.0
38911,3,8911,[215 195  11 135 111],457,4,36560,4.102333931777379,0.0,0.0
38912,3,8912,[318 427  98 191 182],450,5,36565,4.1024346460226635,40.0,0.0
38913,3,8913,[597  69 180 237  64],457,4,36569,4.102423154588288,20.0,0.0
38914,3,8914,[182  11 179 143 275],655,4,36573,4.102411665731912,0.0,20.0
38915,3,8915,[318 427  98 191 182],450,5,36578,4.102512337371018,40.0,0.0
38916,3,8916,[202  12 276 197   7],629,4,36582,4.102500841090053,0.0,0.0
38917,3,8917,[318 427  98 191 182],72,5,36587,4.102601480152501,40.0,0.0
38918,3,8918,[318 427  98 191 182],269,5,36592,4.102702096647606,40.0,0.0
38919,3,8919,[151 176 143   1 273],796,3,36595,4.102578475336323,0.0,0.0
38920,3,8920,[301 423 182  11 546],450,5,36600,4.102679071852931,0.0,0.0
38921,3,8921,[282  64 153  28 181],236,4,36604,4.102667563326609,20.0,0.0
38922,3,8922,[275  95 111   9 174],344,5,36609,4.1027681273114425,0.0,20.0
38923,3,8923,[318 427  98 191 182],796,5,36614,4.102868668758404,40.0,0.0
38924,3,8924,[300 423 125  82 174],655,0,36614,4.102408963585434,0.0,0.0
38925,3,8925,[318 427  98 191 182],450,5,36619,4.10250952274255,40.0,0.0
38926,3,8926,[ 97 289 508   9 179],523,3,36622,4.10238601993951,0.0,0.0
38927,3,8927,[318 427  98 191 182],450,5,36627,4.102486559139785,40.0,0.0
38928,3,8928,[322 151   9  64 300],796,3,36630,4.102363086571844,20.0,0.0
38929,3,8929,[288 546 275  15 234],457,4,36634,4.102351623740201,0.0,20.0
38930,3,8930,[234 194 183 200 294],577,3,36637,4.102228193931251,0.0,0.0
38931,3,8931,[ 11 655 678 127 215],280,2,36639,4.101992834751456,0.0,20.0
38932,3,8932,[318 427  98 191 182],269,5,36644,4.1020933616926,40.0,0.0
38933,3,8933,[318 427  98 191 182],72,5,36649,4.102193866129394,40.0,0.0
38934,3,8934,[318 427  98 191 182],796,5,36654,4.10229434806939,40.0,0.0
38935,3,8935,[318 427  98 191 182],269,5,36659,4.1023948075201435,40.0,0.0
38936,3,8936,[318 427  98 191 182],450,5,36664,4.102495244489202,40.0,0.0
38937,3,8937,[276 282 742  96 202],280,3,36667,4.102371895278586,0.0,0.0
38938,3,8938,[237 161 153 276 265],655,1,36668,4.102024834992728,0.0,0.0
38939,3,8939,[318 427  98 191 182],450,5,36673,4.102125279642058,40.0,0.0
38940,3,8940,[318 427  98 191 182],450,5,36678,4.102225701823063,40.0,0.0
38941,3,8941,[318 427  98 191 182],269,5,36683,4.102326101543279,40.0,0.0
38942,3,8942,[318 427  98 191 182],72,5,36688,4.1024264788102425,40.0,0.0
38943,3,8943,[186   4 234  95 286],786,4,36692,4.102415026833632,0.0,20.0
38944,3,8944,[318 427  98 191 182],72,5,36697,4.102515371716042,40.0,0.0
38945,3,8945,[195   1 168  89 322],450,5,36702,4.10261569416499,0.0,0.0
38946,3,8946,[318 427  98 191 182],18,5,36707,4.102715994187996,40.0,0.0
38947,3,8947,[318 427  98 191 182],72,5,36712,4.102816271792579,40.0,0.0
38948,3,8948,[143 655 258 301 161],655,1,36713,4.102469549670354,0.0,0.0
38949,3,8949,[655 294  89 405  69],655,1,36714,4.102122905027933,0.0,0.0
38950,3,8950,[318 427  98 191 182],655,5,36719,4.1022232152832085,40.0,0.0
38951,3,8951,[318 427  98 191 182],450,5,36724,4.102323503127793,40.0,0.0
38952,3,8952,[318 427  98 191 182],655,5,36729,4.102423768569195,40.0,0.0
38953,3,8953,[318 427  98 191 182],450,5,36734,4.10252401161492,40.0,0.0
38954,3,8954,[200 187 483 132 435],655,3,36737,4.102400893355667,0.0,0.0
38955,3,8955,[318 427  98 191 182],796,5,36742,4.102501116569897,40.0,0.0
38956,3,8956,[265 216 328 435 294],655,1,36743,4.102154739310037,0.0,0.0
38957,3,8957,[318 427  98 191 182],450,5,36748,4.102254967626703,40.0,0.0
38958,3,8958,[318 427  98 191 182],72,5,36753,4.102355173568479,40.0,0.0
38959,3,8959,[100 496 318 568  96],577,4,36757,4.10234375,40.0,20.0
38960,3,8960,[237   1 121 588 423],796,4,36761,4.102332328981141,0.0,0.0
38961,3,8961,[185 234 275  56 153],655,2,36763,4.10209774603883,0.0,20.0
38962,3,8962,[286 265 125   4 181],151,5,36768,4.102197924801963,0.0,20.0
38963,3,8963,[ 56 216 181 204 238],504,1,36769,4.101851851851852,0.0,0.0
38964,3,8964,[181 179  69   7 135],269,2,36771,4.101617401003904,0.0,0.0
38965,3,8965,[268 168 176 603 180],269,3,36774,4.1014945349096585,20.0,0.0
38966,3,8966,[508 301 313  50 121],655,2,36776,4.101260176201628,0.0,20.0
38967,3,8967,[318 427  98 191 182],72,5,36781,4.101360392506691,40.0,0.0
38968,3,8968,[318 427  98 191 182],450,5,36786,4.101460586464489,40.0,0.0
38969,3,8969,[210  28  56 202 174],457,5,36791,4.101560758082497,0.0,0.0
38970,3,8970,[318 427  98 191 182],796,5,36796,4.101660907368187,40.0,0.0
38971,3,8971,[318 427  98 191 182],269,5,36801,4.101761034329024,40.0,0.0
38972,3,8972,[427 182  50 496 125],503,3,36804,4.101638248077566,40.0,20.0
38973,3,8973,[318 427  98 191 182],450,5,36809,4.101738355248496,40.0,0.0
38974,3,8974,[318 427  98 191 182],269,5,36814,4.101838440111421,40.0,0.0
38975,3,8975,[318 427  98 191 182],450,5,36819,4.1019385026737964,40.0,0.0
38976,3,8976,[ 82 195 318 174  70],151,3,36822,4.101815751364598,20.0,0.0
38977,3,8977,[269 174 265 515 127],655,2,36824,4.1015816440187125,0.0,20.0
38978,3,8978,[  4 405 357   9 234],151,4,36828,4.101570330771801,0.0,0.0
38979,3,8979,[282 151 385  15  89],256,4,36832,4.101559020044544,0.0,0.0
38980,3,8980,[228 153 269   1  50],655,1,36833,4.101213673310322,0.0,20.0
38981,3,8981,[318 427  98 191 182],655,5,36838,4.101313738588288,40.0,0.0
38982,3,8982,[318 427  98 191 182],450,5,36843,4.101413781587443,40.0,0.0
38983,3,8983,[127 275 100  28 385],655,2,36845,4.101179875333927,0.0,60.0
38984,3,8984,[427 237 216 357 185],330,5,36850,4.101279910962716,20.0,0.0
38985,3,8985,[588 194 265 215  71],878,2,36852,4.101046071667038,0.0,0.0
38986,3,8986,[288  88  50 195 508],280,1,36853,4.100701012573718,0.0,20.0
38987,3,8987,[318 427  98 191 182],450,5,36858,4.100801068090788,40.0,0.0
38988,3,8988,[275 127 282 176 172],716,3,36861,4.100678607186562,0.0,40.0
38989,3,8989,[143  28 588 483 179],389,4,36865,4.100667408231368,0.0,0.0
38990,3,8990,[127 211  88 483 288],655,2,36867,4.100433767100434,0.0,20.0
38991,3,8991,[496 318 117 195 176],716,3,36870,4.100311387900356,40.0,0.0
38992,3,8992,[301  50 172   1 168],151,5,36875,4.100411431113088,0.0,20.0
38993,3,8993,[318 427  98 191 182],450,5,36880,4.1005114520791635,40.0,0.0
38994,3,8994,[423 286 269  50 186],503,4,36884,4.100500277932184,0.0,40.0
38995,3,8995,[318 427  98 191 182],450,5,36889,4.1006002667852375,40.0,0.0
38996,3,8996,[ 95 323 191 405 234],796,3,36892,4.100477937090141,0.0,0.0
38997,3,8997,[183 196 111 191 181],716,4,36896,4.100466770393421,0.0,0.0
38998,3,8998,[176   9 245  79 117],756,3,36899,4.100344482720303,0.0,0.0
38999,3,8999,[175 132 185 568 238],269,4,36903,4.100333333333333,0.0,0.0
39000,3,9000,[435 211 204 235  95],807,3,36906,4.100211087656927,0.0,0.0
39001,3,9001,[471 748 234 597 210],256,5,36911,4.100311041990668,0.0,0.0
39002,3,9002,[318 427  98 191 182],269,5,36916,4.100410974119738,40.0,0.0
39003,3,9003,[275 197 313 496 222],450,4,36920,4.100399822301199,20.0,20.0
39004,3,9004,[318 427  98 191 182],72,5,36925,4.100499722376457,40.0,0.0
39005,3,9005,[318 427  98 191 182],72,5,36930,4.100599600266489,40.0,0.0
39006,3,9006,[ 64 132 318 222 300],693,2,36932,4.10036638170312,40.0,0.0
39007,3,9007,[191 210 216 385 125],457,5,36937,4.100466252220249,0.0,0.0
39008,3,9008,[  4  88 143  97 357],18,3,36940,4.1003441003441,0.0,0.0
39009,3,9009,[ 82 655 328 185 282],796,3,36943,4.100221975582686,0.0,0.0
39010,3,9010,[318 427  98 191 182],796,5,36948,4.100321828875819,40.0,0.0
39011,3,9011,[318 427  98 191 182],450,5,36953,4.100421660008877,40.0,0.0
39012,3,9012,[597 655 257 357 132],23,1,36954,4.100077665594142,0.0,0.0
39013,3,9013,[318 427  98 191 182],655,5,36959,4.100177501664078,40.0,0.0
39014,3,9014,[318 427  98 191 182],450,5,36964,4.100277315585136,40.0,0.0
39015,3,9015,[153 276 197 328   7],292,3,36967,4.100155279503106,0.0,0.0
39016,3,9016,[118 195 271 471 174],72,3,36970,4.100033270489076,0.0,0.0
39017,3,9017,[182 186 211   1 301],655,1,36971,4.09968950986915,0.0,0.0
39018,3,9018,[318 427  98 191 182],796,5,36976,4.099789333629006,40.0,0.0
39019,3,9019,[176   9 175   7 385],151,3,36979,4.099667405764967,0.0,0.0
39020,3,9020,[318 427  98 191 182],655,5,36984,4.099767209843698,40.0,0.0
39021,3,9021,[318 427  98 191 182],655,5,36989,4.099866991797827,40.0,0.0
39022,3,9022,[318 427  98 191 182],796,5,36994,4.099966751634711,40.0,0.0
39023,3,9023,[318 427  98 191 182],72,5,36999,4.100066489361702,40.0,0.0
39024,3,9024,[318 427  98 191 182],18,5,37004,4.10016620498615,40.0,0.0
39025,3,9025,[318 427  98 191 182],655,5,37009,4.1002658985154,40.0,0.0
39026,3,9026,[318 427  98 191 182],18,5,37014,4.1003655699567965,40.0,0.0
39027,3,9027,[200 118  69 125 202],457,5,37019,4.1004652193176785,0.0,0.0
39028,3,9028,[275 301 385 186   8],655,1,37020,4.100121829659985,0.0,20.0
39029,3,9029,[318 427  98 191 182],72,5,37025,4.1002214839424145,40.0,0.0
39030,3,9030,[318 427  98 191 182],269,5,37030,4.100321116155465,40.0,0.0
39031,3,9031,[318 427  98 191 182],796,5,37035,4.100420726306466,40.0,0.0
39032,3,9032,[183  25 228 176 273],344,5,37040,4.100520314402745,0.0,0.0
39033,3,9033,[ 89 176 435  71 185],450,4,37044,4.100509187513836,0.0,0.0
39034,3,9034,[318 237 216  70 286],18,4,37048,4.100498063087991,20.0,20.0
39035,3,9035,[318 427  98 191 182],655,5,37053,4.100597609561753,40.0,0.0
39036,3,9036,[228 655  98 222 200],655,2,37055,4.100365165431006,0.0,0.0
39037,3,9037,[318 427  98 191 182],450,5,37060,4.100464704580659,40.0,0.0
39038,3,9038,[ 50 195 183 202 174],269,0,37060,4.1000110631707045,0.0,20.0
39039,3,9039,[423 182 258 168 174],535,4,37064,4.1,0.0,0.0
39040,3,9040,[318 427  98 191 182],72,5,37069,4.100099546510342,40.0,0.0
39041,3,9041,[357   9 423 568 475],655,1,37070,4.099756690997567,0.0,0.0
39042,3,9042,[ 96 228 204  56 202],716,4,37074,4.0997456596262305,0.0,0.0
39043,3,9043,[144 515 174 135  25],655,2,37076,4.099513489606369,0.0,0.0
39044,3,9044,[168 282 186 185 153],504,3,37079,4.0993919292426755,0.0,0.0
39045,3,9045,[318 427  98 191 182],269,5,37084,4.099491487950475,40.0,0.0
39046,3,9046,[318 427  98 191 182],655,5,37089,4.099591024649055,40.0,0.0
39047,3,9047,[237 187 191  79 144],716,3,37092,4.099469496021221,0.0,0.0
39048,3,9048,[318 427  98 191 182],18,5,37097,4.099569013150624,40.0,0.0
39049,3,9049,[515 185  79  69 385],716,4,37101,4.099558011049724,0.0,0.0
39050,3,9050,[318 427  98 191 182],269,5,37106,4.099657496409237,40.0,0.0
39051,3,9051,[322 117 597 423 222],796,4,37110,4.099646486964207,0.0,0.0
39052,3,9052,[318 427  98 191 182],655,5,37115,4.099745940572186,40.0,0.0
39053,3,9053,[318 427  98 191 182],269,5,37120,4.099845372211178,40.0,0.0
39054,3,9054,[588   8 237   1 234],577,4,37124,4.0998343456653785,0.0,0.0
39055,3,9055,[318 427  98 191 182],269,5,37129,4.099933745583039,40.0,0.0
39056,3,9056,[568  28 238 176 301],655,0,37129,4.0994810643701,0.0,0.0
39057,3,9057,[234  28 143  88  56],693,2,37131,4.099249282402297,0.0,0.0
39058,3,9058,[568 168 197 194 174],389,4,37135,4.099238326526106,0.0,0.0
39059,3,9059,[318 427  98 191 182],796,5,37140,4.099337748344371,40.0,0.0
39060,3,9060,[318 427  98 191 182],72,5,37145,4.099437148217636,40.0,0.0
39061,3,9061,[435 257 197 215 176],655,0,37145,4.098984771573604,0.0,0.0
39062,3,9062,[238  88  98   1 282],457,5,37150,4.099084188458567,0.0,0.0
39063,3,9063,[176 197 301 211 182],655,1,37151,4.098742277140335,0.0,0.0
39064,3,9064,[318 427  98 191 182],269,5,37156,4.0988416988416985,40.0,0.0
39065,3,9065,[318 427  98 191 182],18,5,37161,4.098941098610192,40.0,0.0
39066,3,9066,[269 135   4 245 235],450,2,37163,4.0987096062644754,0.0,0.0
39067,3,9067,[318 427  98 191 182],796,5,37168,4.098808998676665,40.0,0.0
39068,3,9068,[302   4 603 153 173],151,3,37171,4.09868783768883,20.0,0.0
39069,3,9069,[318 427  98 191 182],450,5,37176,4.098787210584344,40.0,0.0
39070,3,9070,[202  12 403 357 182],18,3,37179,4.09866607871238,0.0,0.0
39071,3,9071,[127   1 655   9 173],457,5,37184,4.098765432098766,0.0,20.0
39072,3,9072,[403 191 357  22 176],457,5,37189,4.0988647635842606,0.0,0.0
39073,3,9073,[117 183  79 655 194],716,4,37193,4.098853868194842,0.0,0.0
39074,3,9074,[210  15 238 186 173],786,4,37197,4.098842975206612,0.0,0.0
39075,3,9075,[318 427  98 191 182],450,5,37202,4.098942265315117,40.0,0.0
39076,3,9076,[318 427  98 191 182],18,5,37207,4.099041533546326,40.0,0.0
39077,3,9077,[318 427  98 191 182],796,5,37212,4.099140779907469,40.0,0.0
39078,3,9078,[301 300 496 118 194],389,3,37215,4.099019715827734,20.0,0.0
39079,3,9079,[318 427  98 191 182],655,5,37220,4.099118942731278,40.0,0.0
39080,3,9080,[318 427  98 191 182],72,5,37225,4.099218147781081,40.0,0.0
39081,3,9081,[153  11 435 423 318],655,1,37226,4.0988768993613744,20.0,0.0
39082,3,9082,[597  71 117  97   1],796,3,37229,4.098755917648354,0.0,0.0
39083,3,9083,[  8   1 179  82 127],655,2,37231,4.09852487890797,0.0,20.0
39084,3,9084,[318 427  98 191 182],72,5,37236,4.0986241056686845,40.0,0.0
39085,3,9085,[318 427  98 191 182],72,5,37241,4.098723310587717,40.0,0.0
39086,3,9086,[318 427  98 191 182],18,5,37246,4.098822493672279,40.0,0.0
39087,3,9087,[318 427  98 191 182],655,5,37251,4.098921654929577,40.0,0.0
39088,3,9088,[603 222 357 168   1],796,4,37255,4.098910771261965,20.0,0.0
39089,3,9089,[211 405  11 121  22],716,5,37260,4.099009900990099,0.0,0.0
39090,3,9090,[125 597 288  70 196],457,4,37264,4.0989990100099,0.0,0.0
39091,3,9091,[318 427  98 191 182],72,5,37269,4.099098108227013,40.0,0.0
39092,3,9092,[237 289 179 234   4],655,1,37270,4.09875728582426,0.0,0.0
39093,3,9093,[496 423   9  71 174],796,4,37274,4.098746426215087,20.0,0.0
39094,3,9094,[196 273 174 197 181],450,4,37278,4.098735568993953,0.0,0.0
39095,3,9095,[215 655 202 204 423],280,1,37279,4.0983948988566405,0.0,0.0
39096,3,9096,[176 183 269 179 127],450,5,37284,4.098494009013961,0.0,20.0
39097,3,9097,[318 427  98 191 182],269,5,37289,4.0985930973840405,40.0,0.0
39098,3,9098,[318 427  98 191 182],18,5,37294,4.098692163974063,40.0,0.0
39099,3,9099,[318 427  98 191 182],450,5,37299,4.098791208791209,40.0,0.0
39100,3,9100,[ 96 222 228  56 181],23,5,37304,4.098890231842654,0.0,0.0
39101,3,9101,[237 173  70 100 204],535,5,37309,4.098989233135574,0.0,20.0
39102,3,9102,[100 508 135 286  25],401,2,37311,4.098758650994178,0.0,40.0
39103,3,9103,[318 427  98 191 182],796,5,37316,4.098857644991213,40.0,0.0
39104,3,9104,[318 427  98 191 182],269,5,37321,4.098956617243273,40.0,0.0
39105,3,9105,[427 423  79 748 125],450,5,37326,4.099055567757523,20.0,0.0
39106,3,9106,[182 168 210 288 471],457,5,37331,4.099154496541122,0.0,0.0
39107,3,9107,[427 161  89 143 508],655,3,37334,4.099033816425121,20.0,0.0
39108,3,9108,[237 273 176 202 185],796,4,37338,4.099022944340762,0.0,0.0
39109,3,9109,[318 427  98 191 182],450,5,37343,4.099121844127333,40.0,0.0
39110,3,9110,[496 405   9 748  89],796,4,37347,4.099110964767863,20.0,0.0
39111,3,9111,[318 427  98 191 182],450,5,37352,4.099209833187006,40.0,0.0
39112,3,9112,[286 204  70 211 300],535,3,37355,4.0990892132118955,0.0,20.0
39113,3,9113,[483 603  79 257 237],655,3,37358,4.098968619705947,20.0,0.0
39114,3,9114,[143 118 269 300 385],450,4,37362,4.098957761930883,0.0,0.0
39115,3,9115,[496 132 125 185 182],796,5,37367,4.099056603773585,20.0,0.0
39116,3,9116,[318 427  98 191 182],72,5,37372,4.099155423933311,40.0,0.0
39117,3,9117,[318 427  98 191 182],450,5,37377,4.099254222417197,40.0,0.0
39118,3,9118,[603 222  88 100  50],450,4,37381,4.099243338085317,20.0,40.0
39119,3,9119,[143  96 161 333   9],655,1,37382,4.098903508771929,0.0,0.0
39120,3,9120,[ 50 234  25 215 405],835,4,37386,4.09889266527793,0.0,20.0
39121,3,9121,[588  69 405 174 742],796,4,37390,4.098881824161368,0.0,0.0
39122,3,9122,[318 427  98 191 182],796,5,37395,4.09898059848734,40.0,0.0
39123,3,9123,[318 427  98 191 182],18,5,37400,4.099079351161771,40.0,0.0
39124,3,9124,[275   1 265 318 276],457,5,37405,4.099178082191781,20.0,20.0
39125,3,9125,[  8  79 515 195 238],535,3,37408,4.099057637519176,0.0,0.0
39126,3,9126,[597 318  89 210 258],807,4,37412,4.099046784266462,20.0,0.0
39127,3,9127,[238  56 173 175 603],11,3,37415,4.098926380368098,20.0,0.0
39128,3,9128,[151 276  98 597 216],256,4,37419,4.09891554387118,0.0,0.0
39129,3,9129,[318 427  98 191 182],450,5,37424,4.099014238773275,40.0,0.0
39130,3,9130,[153 194  22 176 204],796,5,37429,4.099112912057825,0.0,0.0
39131,3,9131,[318 427  98 191 182],796,5,37434,4.099211563731932,40.0,0.0
39132,3,9132,[  1 132 215 234 210],151,4,37438,4.099200700755502,0.0,0.0
39133,3,9133,[228 423  69 234 238],786,4,37442,4.099189840157653,0.0,0.0
39134,3,9134,[318 427  98 191 182],18,5,37447,4.099288451012589,40.0,0.0
39135,3,9135,[176 180  28  12  56],457,5,37452,4.09938704028021,0.0,0.0
39136,3,9136,[318 427  98 191 182],796,5,37457,4.099485607967604,40.0,0.0
39137,3,9137,[318 427  98 191 182],269,5,37462,4.099584154081856,40.0,0.0
39138,3,9138,[357 655  28 568 174],716,5,37467,4.099682678630047,0.0,0.0
39139,3,9139,[318 427  98 191 182],18,5,37472,4.099781181619256,40.0,0.0
39140,3,9140,[143 215 210 121 385],655,1,37473,4.099442074171316,0.0,0.0
39141,3,9141,[318 427  98 191 182],269,5,37478,4.099540581929556,40.0,0.0
39142,3,9142,[318 427  98 191 182],269,5,37483,4.0996390681395605,40.0,0.0
39143,3,9143,[435  28 301  82 135],151,4,37487,4.099628171478566,0.0,0.0
39144,3,9144,[ 15 546 237 333 328],938,1,37488,4.099289229086933,0.0,0.0
39145,3,9145,[ 12 423 234 187 186],655,1,37489,4.09895036081347,0.0,0.0
39146,3,9146,[318 427  98 191 182],796,5,37494,4.09904886848147,40.0,0.0
39147,3,9147,[313 100 302 175 151],344,4,37498,4.09903804110188,0.0,20.0
39148,3,9148,[183 265 173   4 191],796,5,37503,4.0991365176522025,0.0,0.0
39149,3,9149,[271 195 435 268 294],655,0,37503,4.098688524590164,0.0,0.0
39150,3,9150,[179 568 111  22 276],269,2,37505,4.098459184788548,0.0,0.0
39151,3,9151,[143 496 183 216 174],151,4,37509,4.098448426573427,20.0,0.0
39152,3,9152,[237 210 357   9  64],796,3,37512,4.098328416912488,20.0,0.0
39153,3,9153,[318 427  98 191 182],269,5,37517,4.098426917194669,40.0,0.0
39154,3,9154,[282 300 127 180   7],693,3,37520,4.098306936100491,0.0,20.0
39155,3,9155,[318 427  98 191 182],796,5,37525,4.098405417212756,40.0,0.0
39156,3,9156,[318 427  98 191 182],18,5,37530,4.098503876815551,40.0,0.0
39157,3,9157,[265 183 403 471 125],280,1,37531,4.098165538327145,0.0,0.0
39158,3,9158,[318 427  98 191 182],18,5,37536,4.098264002620374,40.0,0.0
39159,3,9159,[ 98 144 655  28 195],655,1,37537,4.09792576419214,0.0,0.0
39160,3,9160,[318 427  98 191 182],72,5,37542,4.0980242331623185,40.0,0.0
39161,3,9161,[483  56  71 210 318],796,4,37546,4.098013534162846,20.0,0.0
39162,3,9162,[117  11 313 435 181],296,4,37550,4.098002837498636,0.0,0.0
39163,3,9163,[318 427  98 191 182],796,5,37555,4.098101265822785,40.0,0.0
39164,3,9164,[294 132 195 202 127],450,5,37560,4.098199672667758,0.0,20.0
39165,3,9165,[318 427  98 191 182],796,5,37565,4.098298058040585,40.0,0.0
39166,3,9166,[  1 742 173 183 117],280,3,37568,4.098178248063706,0.0,0.0
39167,3,9167,[187 153 111 100 742],655,1,37569,4.097840314136126,0.0,20.0
39168,3,9168,[ 12 655 173 174 200],450,4,37573,4.097829643363507,0.0,0.0
39169,3,9169,[318 427  98 191 182],796,5,37578,4.097928026172301,40.0,0.0
39170,3,9170,[423 117 132 176  69],716,4,37582,4.097917348162687,0.0,0.0
39171,3,9171,[151 194 161  50 196],457,5,37587,4.098015699956389,0.0,20.0
39172,3,9172,[121  69 161 568   7],450,4,37591,4.0980050147171045,0.0,0.0
39173,3,9173,[182 135 191 286  22],450,4,37595,4.097994331807281,0.0,20.0
39174,3,9174,[508 183 276  22 151],344,4,37599,4.097983651226158,0.0,0.0
39175,3,9175,[181 588 427 597 742],796,4,37603,4.097972972972973,20.0,0.0
39176,3,9176,[318 427  98 191 182],655,5,37608,4.09807126511932,40.0,0.0
39177,3,9177,[238 180  82 204 172],18,2,37610,4.097842667247766,0.0,0.0
39178,3,9178,[ 22 196  88 222   8],796,5,37615,4.097940952173439,0.0,0.0
39179,3,9179,[318 427  98 191 182],18,5,37620,4.098039215686274,40.0,0.0
39180,3,9180,[234   1 168 144 471],457,5,37625,4.0981374577932685,0.0,0.0
39181,3,9181,[181 118 121 196  88],151,4,37629,4.098126769766935,0.0,0.0
39182,3,9182,[318 427  98 191 182],72,5,37634,4.098224980943047,40.0,0.0
39183,3,9183,[132  50 127 121 597],807,4,37638,4.098214285714286,0.0,40.0
39184,3,9184,[318 427  98 191 182],18,5,37643,4.098312465977137,40.0,0.0
39185,3,9185,[655 288   8 172 182],457,5,37648,4.098410624863924,0.0,0.0
39186,3,9186,[318 427  98 191 182],18,5,37653,4.098508762381626,40.0,0.0
39187,3,9187,[318 427  98 191 182],655,5,37658,4.098606878537223,40.0,0.0
39188,3,9188,[318 427  98 191 182],796,5,37663,4.098704973337687,40.0,0.0
39189,3,9189,[588 132 318 144 322],280,4,37667,4.098694232861806,20.0,0.0
39190,3,9190,[318 427  98 191 182],796,5,37672,4.098792296812099,40.0,0.0
39191,3,9191,[318 427  98 191 182],450,5,37677,4.098890339425587,40.0,0.0
39192,3,9192,[ 56 238  15 318  79],593,5,37682,4.098988360709235,20.0,0.0
39193,3,9193,[318 427  98 191 182],269,5,37687,4.099086360670002,40.0,0.0
39194,3,9194,[318 427  98 191 182],72,5,37692,4.099184339314845,40.0,0.0
39195,3,9195,[318 427  98 191 182],796,5,37697,4.099282296650718,40.0,0.0
39196,3,9196,[276  56  15 385 118],655,1,37698,4.098945308252691,0.0,0.0
39197,3,9197,[282 172 181 125 161],593,5,37703,4.099043270276147,0.0,0.0
39198,3,9198,[318 427  98 191 182],655,5,37708,4.0991412110011956,40.0,0.0
39199,3,9199,[318 427  98 191 182],18,5,37713,4.099239130434783,40.0,0.0
39200,3,9200,[471 597 182 204 153],450,5,37718,4.099337028583849,0.0,0.0
39201,3,9201,[318 427  98 191 182],18,5,37723,4.099434905455336,40.0,0.0
39202,3,9202,[318 427  98 191 182],655,5,37728,4.099532761056177,40.0,0.0
39203,3,9203,[216  82   1 100 211],796,1,37729,4.099196001738375,0.0,20.0
39204,3,9204,[318 427  98 191 182],72,5,37734,4.099293862031504,40.0,0.0
39205,3,9205,[318 427  98 191 182],18,5,37739,4.0993917010645236,40.0,0.0
39206,3,9206,[318 427  98 191 182],72,5,37744,4.099489518844358,40.0,0.0
39207,3,9207,[318 427  98 191 182],450,5,37749,4.099587315377932,40.0,0.0
39208,3,9208,[318 427  98 191 182],72,5,37754,4.0996850906721685,40.0,0.0
39209,3,9209,[322 282 300 127 405],450,5,37759,4.099782844733985,0.0,20.0
39210,3,9210,[ 25  88  64 202 568],457,5,37764,4.099880577570296,20.0,0.0
39211,3,9211,[175 121 546 238 144],457,4,37768,4.0998697351280935,0.0,0.0
39212,3,9212,[ 11  98 237 323 182],256,5,37773,4.099967437316835,0.0,0.0
39213,3,9213,[318 427  98 191 182],72,5,37778,4.100065118298242,40.0,0.0
39214,3,9214,[515 186 175 187 655],655,2,37780,4.099837221920781,0.0,0.0
39215,3,9215,[ 12 294 322 748 318],796,3,37783,4.099717881944445,20.0,0.0
39216,3,9216,[318 427  98 191 182],269,5,37788,4.09981555820766,40.0,0.0
39217,3,9217,[318 427  98 191 182],796,5,37793,4.099913213278368,40.0,0.0
39218,3,9218,[176 588 127 275  15],457,5,37798,4.100010847163467,0.0,40.0
39219,3,9219,[318 427  98 191 182],450,5,37803,4.1001084598698485,40.0,0.0
39220,3,9220,[161 185 318 173 144],457,5,37808,4.100206051404403,20.0,0.0
39221,3,9221,[318 427  98 191 182],796,5,37813,4.100303621774018,40.0,0.0
39222,3,9222,[318 427  98 191 182],72,5,37818,4.100401170985579,40.0,0.0
39223,3,9223,[318 427  98 191 182],655,5,37823,4.100498699045967,40.0,0.0
39224,3,9224,[318 427  98 191 182],450,5,37828,4.100596205962059,40.0,0.0
39225,3,9225,[318 427  98 191 182],72,5,37833,4.100693691740733,40.0,0.0
39226,3,9226,[318 427  98 191 182],269,5,37838,4.100791156388858,40.0,0.0
39227,3,9227,[318 427  98 191 182],450,5,37843,4.100888599913307,40.0,0.0
39228,3,9228,[318 427  98 191 182],655,5,37848,4.100986022320945,40.0,0.0
39229,3,9229,[143  56 238 153   8],18,5,37853,4.101083423618635,0.0,0.0
39230,3,9230,[234 228 125 655  97],796,2,37855,4.100855811938035,0.0,0.0
39231,3,9231,[318 427  98 191 182],72,5,37860,4.1009532062391685,40.0,0.0
39232,3,9232,[318 427  98 191 182],72,5,37865,4.101050579443301,40.0,0.0
39233,3,9233,[275 176 127 288  56],450,4,37869,4.101039636127355,0.0,40.0
39234,3,9234,[318 427  98 191 182],72,5,37874,4.101136978884678,40.0,0.0
39235,3,9235,[181  89 191 135 176],269,2,37876,4.100909484625379,0.0,0.0
39236,3,9236,[176 132 275 179 210],236,1,37877,4.100573779365595,0.0,20.0
39237,3,9237,[ 64 222 269 276  11],344,4,37881,4.100562892400952,20.0,0.0
39238,3,9238,[318 427  98 191 182],450,5,37886,4.100660244615218,40.0,0.0
39239,3,9239,[318 427  98 191 182],450,5,37891,4.100757575757576,40.0,0.0
39240,3,9240,[215  12 357 435  79],72,5,37896,4.100854885834867,0.0,0.0
39241,3,9241,[235 153 405  97 186],716,3,37899,4.1007357714780355,0.0,0.0
39242,3,9242,[ 50 322 301 191 100],151,2,37901,4.100508492913556,0.0,40.0
39243,3,9243,[318 427  98 191 182],655,5,37906,4.10060579835569,40.0,0.0
39244,3,9244,[318 427  98 191 182],18,5,37911,4.100703082747431,40.0,0.0
39245,3,9245,[117 288 742 301 302],450,4,37915,4.100692191217824,0.0,0.0
39246,3,9246,[197 546 286 125 187],796,3,37918,4.100573158862334,0.0,20.0
39247,3,9247,[318 427  98 191 182],18,5,37923,4.100670415224913,40.0,0.0
39248,3,9248,[ 25 196 294  64 121],457,4,37927,4.100659530760082,20.0,0.0
39249,3,9249,[318 427  98 191 182],269,5,37932,4.100756756756756,40.0,0.0
39250,3,9250,[318 427  98 191 182],450,5,37937,4.100853961733867,40.0,0.0
39251,3,9251,[318 427  98 191 182],18,5,37942,4.100951145698227,40.0,0.0
39252,3,9252,[318 427  98 191 182],269,5,37947,4.101048308656652,40.0,0.0
39253,3,9253,[318 427  98 191 182],18,5,37952,4.10114545061595,40.0,0.0
39254,3,9254,[135 748 196 300 435],11,3,37955,4.101026472177201,0.0,0.0
39255,3,9255,[318 427  98 191 182],18,5,37960,4.101123595505618,40.0,0.0
39256,3,9256,[ 69 100 194 118 357],450,4,37964,4.101112671491844,0.0,20.0
39257,3,9257,[318 427  98 191 182],72,5,37969,4.101209764527976,40.0,0.0
39258,3,9258,[318 427  98 191 182],18,5,37974,4.101306836591425,40.0,0.0
39259,3,9259,[318 427  98 191 182],269,5,37979,4.101403887688985,40.0,0.0
39260,3,9260,[318 427  98 191 182],450,5,37984,4.101500917827448,40.0,0.0
39261,3,9261,[318 427  98 191 182],72,5,37989,4.101597927013604,40.0,0.0
39262,3,9262,[318 427  98 191 182],796,5,37994,4.101694915254237,40.0,0.0
39263,3,9263,[318 427  98 191 182],72,5,37999,4.101791882556132,40.0,0.0
39264,3,9264,[300 100 216 204 191],450,5,38004,4.101888828926066,0.0,20.0
39265,3,9265,[181  95  89 215 427],18,2,38006,4.101661990071229,20.0,0.0
39266,3,9266,[ 22 121 483 568 132],457,5,38011,4.101758929534909,0.0,0.0
39267,3,9267,[357 144 403  22 132],450,5,38016,4.101855848079413,0.0,0.0
39268,3,9268,[318 427  98 191 182],796,5,38021,4.101952745711512,40.0,0.0
39269,3,9269,[ 28  22   4 161 257],457,4,38025,4.101941747572815,0.0,0.0
39270,3,9270,[318 427  98 191 182],18,5,38030,4.102038615036134,40.0,0.0
39271,3,9271,[  4 271 597  88 238],796,4,38034,4.102027610008628,0.0,0.0
39272,3,9272,[ 64 405  71 237 168],330,4,38038,4.1020166073546855,20.0,0.0
39273,3,9273,[318 427  98 191 182],796,5,38043,4.102113435410826,40.0,0.0
39274,3,9274,[286 269 174  98 204],639,3,38046,4.101994609164421,0.0,20.0
39275,3,9275,[318 427  98 191 182],18,5,38051,4.102091418714964,40.0,0.0
39276,3,9276,[ 64 357 300  69  22],796,5,38056,4.102188207394632,20.0,0.0
39277,3,9277,[597  82 144 202  88],23,0,38056,4.101746065962492,0.0,0.0
39278,3,9278,[318 427  98 191 182],269,5,38061,4.10184287099903,40.0,0.0
39279,3,9279,[318 427  98 191 182],796,5,38066,4.101939655172414,40.0,0.0
39280,3,9280,[222 181 294 323 588],23,3,38069,4.1018209244693455,0.0,0.0
39281,3,9281,[655  82 183 234 186],655,1,38070,4.101486748545572,0.0,0.0
39282,3,9282,[318 427  98 191 182],72,5,38075,4.101583539803943,40.0,0.0
39283,3,9283,[318 427  98 191 182],655,5,38080,4.1016803102111155,40.0,0.0
39284,3,9284,[ 56 483   4  22 228],655,1,38081,4.1013462574044155,0.0,0.0
39285,3,9285,[568 257 195 238  88],796,4,38085,4.101335343527891,0.0,0.0
39286,3,9286,[174 275 385 173 257],796,5,38090,4.101432109400237,0.0,20.0
39287,3,9287,[318 427  98 191 182],450,5,38095,4.1015288544358315,40.0,0.0
39288,3,9288,[132 118 100   4  89],151,3,38098,4.101410270212079,0.0,20.0
39289,3,9289,[191 282 117 200 182],796,5,38103,4.101506996770722,0.0,0.0
39290,3,9290,[318 427  98 191 182],269,5,38108,4.101603702507803,40.0,0.0
39291,3,9291,[269 176 172 168 597],796,4,38112,4.101592767972449,0.0,0.0
39292,3,9292,[222 135 182 200 238],655,3,38115,4.101474227913483,0.0,0.0
39293,3,9293,[174 197  96  50 655],716,4,38119,4.101463309662147,0.0,20.0
39294,3,9294,[318 427  98 191 182],796,5,38124,4.101559978483055,40.0,0.0
39295,3,9295,[318 427  98 191 182],18,5,38129,4.101656626506024,40.0,0.0
39296,3,9296,[318 427  98 191 182],18,5,38134,4.101753253737765,40.0,0.0
39297,3,9297,[216 202 186 168 496],796,4,38138,4.101742310174231,20.0,0.0
39298,3,9298,[318 427  98 191 182],450,5,38143,4.101838907409399,40.0,0.0
39299,3,9299,[318 427  98 191 182],655,5,38148,4.101935483870967,40.0,0.0
39300,3,9300,[742  96 153 222 269],450,4,38152,4.101924524244705,0.0,0.0
39301,3,9301,[176 183 496 211 222],796,4,38156,4.1019135669748445,20.0,0.0
39302,3,9302,[318 427  98 191 182],269,5,38161,4.102010104267441,40.0,0.0
39303,3,9303,[318 427  98 191 182],72,5,38166,4.102106620808255,40.0,0.0
39304,3,9304,[318 427  98 191 182],18,5,38171,4.1022031166039765,40.0,0.0
39305,3,9305,[195 742 286 196  70],344,2,38173,4.1019772189984955,0.0,20.0
39306,3,9306,[318 427  98 191 182],450,5,38178,4.1020737079617495,40.0,0.0
39307,3,9307,[318 427  98 191 182],72,5,38183,4.102170176192523,40.0,0.0
39308,3,9308,[318 427  98 191 182],18,5,38188,4.102266623697497,40.0,0.0
39309,3,9309,[471 125 385  22 357],457,5,38193,4.102363050483351,0.0,0.0
39310,3,9310,[318 427  98 191 182],18,5,38198,4.102459456556761,40.0,0.0
39311,3,9311,[ 82  71 273 187   8],796,3,38201,4.102341065292096,0.0,0.0
39312,3,9312,[144 117 313 200 161],796,5,38206,4.102437453022657,0.0,0.0
39313,3,9313,[265 357 174 405 143],151,4,38210,4.102426454799227,0.0,0.0
39314,3,9314,[318 427  98 191 182],18,5,38215,4.10252281266774,40.0,0.0
39315,3,9315,[211 186 568  96 483],450,3,38218,4.102404465435809,0.0,0.0
39316,3,9316,[181   7 275 216 328],151,4,38222,4.102393474294301,0.0,20.0
39317,3,9317,[  1  97 269 302 427],450,5,38227,4.102489804679116,20.0,0.0
39318,3,9318,[222 195 127 276 288],256,4,38231,4.102478806738921,0.0,20.0
39319,3,9319,[318 427  98 191 182],18,5,38236,4.102575107296137,40.0,0.0
39320,3,9320,[318 427  98 191 182],796,5,38241,4.102671387190216,40.0,0.0
39321,3,9321,[ 79  95 125 357  70],344,3,38244,4.1025531001930915,0.0,0.0
39322,3,9322,[318 427  98 191 182],796,5,38249,4.102649361793414,40.0,0.0
39323,3,9323,[318 427  98 191 182],269,5,38254,4.102745602745602,40.0,0.0
39324,3,9324,[235 323 100  82 245],256,4,38258,4.102734584450402,0.0,20.0
39325,3,9325,[318 427  98 191 182],18,5,38263,4.102830795625134,40.0,0.0
39326,3,9326,[318 427  98 191 182],18,5,38268,4.102926986169186,40.0,0.0
39327,3,9327,[318 427  98 191 182],796,5,38273,4.103023156089193,40.0,0.0
39328,3,9328,[125 588  95 182   9],280,3,38276,4.102904920141494,0.0,0.0
39329,3,9329,[318 427  98 191 182],655,5,38281,4.103001071811361,40.0,0.0
39330,3,9330,[183 197 496  50  71],450,4,38285,4.102990033222591,20.0,20.0
39331,3,9331,[172 269 202 403 603],796,4,38289,4.102978996999571,20.0,0.0
39332,3,9332,[568 185 204  70 496],330,5,38294,4.103075109825351,20.0,0.0
39333,3,9333,[235 216 183 194  82],716,3,38297,4.102956931647739,0.0,0.0
39334,3,9334,[191 100 180 181 200],457,5,38302,4.1030530262453135,0.0,20.0
39335,3,9335,[318 427  98 191 182],655,5,38307,4.1031491002570695,40.0,0.0
39336,3,9336,[258 288  95  71 546],186,2,38309,4.102923851344115,0.0,0.0
39337,3,9337,[655 597 173  64  50],269,2,38311,4.102698650674663,20.0,20.0
39338,3,9338,[318 427  98 191 182],450,5,38316,4.102794731769997,40.0,0.0
39339,3,9339,[151 300 172  98 200],450,4,38320,4.102783725910064,0.0,0.0
39340,3,9340,[475 143 603 181 183],655,3,38323,4.102665667487421,20.0,0.0
39341,3,9341,[180  64  50 191   9],18,5,38328,4.102761721258831,20.0,20.0
39342,3,9342,[357 546 118 181  11],693,2,38330,4.10253665846088,0.0,0.0
39343,3,9343,[273 127 300 143 144],450,4,38334,4.102525684931507,0.0,20.0
39344,3,9344,[172 546 496 191 568],716,4,38338,4.102514713750669,20.0,0.0
39345,3,9345,[318 427  98 191 182],796,5,38343,4.102610742563663,40.0,0.0
39346,3,9346,[234  11 302 143 211],450,4,38347,4.102599764630362,0.0,0.0
39347,3,9347,[318 427  98 191 182],796,5,38352,4.102695763799743,40.0,0.0
39348,3,9348,[318 427  98 191 182],18,5,38357,4.102791742432346,40.0,0.0
39349,3,9349,[318 427  98 191 182],655,5,38362,4.102887700534759,40.0,0.0
39350,3,9350,[318 427  98 191 182],18,5,38367,4.102983638113571,40.0,0.0
39351,3,9351,[318 427  98 191 182],450,5,38372,4.103079555175364,40.0,0.0
39352,3,9352,[318 427  98 191 182],18,5,38377,4.1031754517267185,40.0,0.0
39353,3,9353,[318 427  98 191 182],655,5,38382,4.103271327774214,40.0,0.0
39354,3,9354,[216 181  82 195 176],457,5,38387,4.103367183324425,0.0,0.0
39355,3,9355,[597   7  97 546  28],450,5,38392,4.103463018383925,0.0,0.0
39356,3,9356,[318 427  98 191 182],796,5,38397,4.103558832959282,40.0,0.0
39357,3,9357,[318 427  98 191 182],796,5,38402,4.103654627057064,40.0,0.0
39358,3,9358,[318 427  98 191 182],796,5,38407,4.1037504006838335,40.0,0.0
39359,3,9359,[132 172  97 194 313],796,4,38411,4.1037393162393165,0.0,0.0
39360,3,9360,[174   7 111 322 313],450,5,38416,4.1038350603568,0.0,0.0
39361,3,9361,[289 132 118  11 288],693,2,38418,4.10361033967101,0.0,0.0
39362,3,9362,[211 172   1 245  89],450,5,38423,4.103706077112037,0.0,0.0
39363,3,9363,[  4 258 496 204  96],450,4,38427,4.103695002135839,20.0,0.0
39364,3,9364,[ 11 228 121 175 181],457,5,38432,4.103790710090763,0.0,0.0
39365,3,9365,[127 111 273 161 603],796,4,38436,4.103779628443306,20.0,20.0
39366,3,9366,[318 427  98 191 182],18,5,38441,4.103875306928579,40.0,0.0
39367,3,9367,[257 143 222 603   8],655,2,38443,4.10365072587532,20.0,0.0
39368,3,9368,[ 98 182 275 197 211],18,5,38448,4.1037463976945245,0.0,20.0
39369,3,9369,[318 427  98 191 182],18,5,38453,4.103842049092849,40.0,0.0
39370,3,9370,[318 427  98 191 182],450,5,38458,4.103937680076832,40.0,0.0
39371,3,9371,[ 88 234  95 182 300],450,3,38461,4.103819889031157,0.0,0.0
39372,3,9372,[  9 228 161 300 237],655,0,38461,4.103382054838366,0.0,0.0
39373,3,9373,[211 161 125  71 385],450,4,38465,4.103371026242799,0.0,0.0
39374,3,9374,[125 181 180 603 174],796,4,38469,4.10336,20.0,0.0
39375,3,9375,[118 234 186 471 228],716,2,38471,4.1031356655290105,0.0,0.0
39376,3,9376,[318 427  98 191 182],72,5,38476,4.103231310653727,40.0,0.0
39377,3,9377,[328 202 318 313 237],796,5,38481,4.103326935380678,20.0,0.0
39378,3,9378,[ 88  11  70 427 357],330,5,38486,4.103422539716387,20.0,0.0
39379,3,9379,[ 88 174 143 210 168],330,4,38490,4.1034115138592755,0.0,0.0
39380,3,9380,[471 121 597 496 546],807,5,38495,4.103507088796504,20.0,0.0
39381,3,9381,[318 427  98 191 182],655,5,38500,4.103602643359625,40.0,0.0
39382,3,9382,[181 427  79 423 568],389,4,38504,4.103591601833102,20.0,0.0
39383,3,9383,[318 427  98 191 182],269,5,38509,4.103687127024723,40.0,0.0
39384,3,9384,[318 427  98 191 182],18,5,38514,4.10378263185935,40.0,0.0
39385,3,9385,[318 427  98 191 182],450,5,38519,4.10387811634349,40.0,0.0
39386,3,9386,[318 427  98 191 182],18,5,38524,4.103973580483648,40.0,0.0
39387,3,9387,[ 56 151 181 234 357],504,2,38526,4.103749467405198,0.0,0.0
39388,3,9388,[194 180 111 181 144],296,4,38530,4.103738417296837,0.0,0.0
39389,3,9389,[318 427  98 191 182],72,5,38535,4.103833865814696,40.0,0.0
39390,3,9390,[234 125 210 197 597],457,4,38539,4.103822809072517,0.0,0.0
39391,3,9391,[180   8 357 238   1],535,3,38542,4.103705281090289,0.0,0.0
39392,3,9392,[318 427  98 191 182],450,5,38547,4.1038007026509105,40.0,0.0
39393,3,9393,[191 423 144  15 655],629,4,38551,4.103789652969981,0.0,0.0
39394,3,9394,[ 98  56  95 204 655],796,4,38555,4.103778605641298,0.0,0.0
39395,3,9395,[181 196 603 195 301],450,5,38560,4.10387398893146,20.0,0.0
39396,3,9396,[289 174 268 234 603],655,1,38561,4.103543684154517,20.0,0.0
39397,3,9397,[127  69 222 181 100],450,4,38565,4.103532666524792,0.0,40.0
39398,3,9398,[294 187 258 210 655],504,3,38568,4.1034152569422275,0.0,0.0
39399,3,9399,[318 427  98 191 182],655,5,38573,4.103510638297872,40.0,0.0
39400,3,9400,[318 427  98 191 182],72,5,38578,4.10360599936177,40.0,0.0
39401,3,9401,[318 427  98 191 182],18,5,38583,4.103701340140396,40.0,0.0
39402,3,9402,[153  69 301 222 597],450,4,38587,4.10369031160268,0.0,0.0
39403,3,9403,[496 210 597 173 271],796,4,38591,4.103679285410464,20.0,0.0
39404,3,9404,[318 427  98 191 182],72,5,38596,4.103774587985114,40.0,0.0
39405,3,9405,[318 427  98 191 182],18,5,38601,4.103869870295556,40.0,0.0
39406,3,9406,[318 427  98 191 182],72,5,38606,4.103965132348251,40.0,0.0
39407,3,9407,[ 97 135 181 300 313],693,3,38609,4.103847789115647,0.0,0.0
39408,3,9408,[357 121  64 568 301],796,4,38613,4.103836752045914,20.0,0.0
39409,3,9409,[318 427  98 191 182],450,5,38618,4.103931987247609,40.0,0.0
39410,3,9410,[318 427  98 191 182],655,5,38623,4.10402720221018,40.0,0.0
39411,3,9411,[151 294 204 127 597],450,5,38628,4.104122396940077,0.0,20.0
39412,3,9412,[318 427  98 191 182],450,5,38633,4.104217571443748,40.0,0.0
39413,3,9413,[471 173 238 265 228],457,5,38638,4.10431272572764,0.0,0.0
39414,3,9414,[153  82 176 100 202],504,2,38640,4.104089219330855,0.0,20.0
39415,3,9415,[289 111 282 403   7],655,0,38640,4.103653355989804,0.0,0.0
39416,3,9416,[318 427  98 191 182],796,5,38645,4.103748539874695,40.0,0.0
39417,3,9417,[318 427  98 191 182],18,5,38650,4.1038437035464,40.0,0.0
39418,3,9418,[318 427  98 191 182],655,5,38655,4.10393884701136,40.0,0.0
39419,3,9419,[435 180   4 127 237],18,3,38658,4.103821656050956,0.0,20.0
39420,3,9420,[318 427  98 191 182],269,5,38663,4.103916781657998,40.0,0.0
39421,3,9421,[318 427  98 191 182],269,5,38668,4.104011887072808,40.0,0.0
39422,3,9422,[318 427  98 191 182],655,5,38673,4.104106972301815,40.0,0.0
39423,3,9423,[318 427  98 191 182],796,5,38678,4.104202037351443,40.0,0.0
39424,3,9424,[132 288 294 211 357],655,1,38679,4.103872679045093,0.0,0.0
39425,3,9425,[318 427  98 191 182],450,5,38684,4.10396774877997,40.0,0.0
39426,3,9426,[202 276 195 210  96],280,2,38686,4.103744563487854,0.0,0.0
39427,3,9427,[318 427  98 191 182],450,5,38691,4.103839626644039,40.0,0.0
39428,3,9428,[318 427  98 191 182],72,5,38696,4.103934669636229,40.0,0.0
39429,3,9429,[313  88 111  69 423],577,4,38700,4.103923647932132,0.0,0.0
39430,3,9430,[313 153 121 742  98],796,4,38704,4.10391262856537,0.0,0.0
39431,3,9431,[275  64 211   1 385],716,4,38708,4.103901611535199,20.0,20.0
39432,3,9432,[318 427  98 191 182],18,5,38713,4.103996607653981,40.0,0.0
39433,3,9433,[ 56 603 153 186 385],450,4,38717,4.103985584057663,20.0,0.0
39434,3,9434,[ 79 234 333  12 117],655,1,38718,4.103656597774245,0.0,0.0
39435,3,9435,[182 427  64   8  82],655,3,38721,4.103539635438746,40.0,0.0
39436,3,9436,[318 427  98 191 182],72,5,38726,4.103634629649253,40.0,0.0
39437,3,9437,[423 172 333 195 300],693,1,38727,4.103305785123967,0.0,0.0
39438,3,9438,[ 97  56 175 125 546],457,4,38731,4.103294840555144,0.0,0.0
39439,3,9439,[153 161 183   4 265],655,1,38732,4.102966101694915,0.0,0.0
39440,3,9440,[ 15 655 181 313 100],236,3,38735,4.102849274441267,0.0,20.0
39441,3,9441,[318 427  98 191 182],72,5,38740,4.102944291463673,40.0,0.0
39442,3,9442,[173 186 183 204 210],264,5,38745,4.1030392883617495,0.0,0.0
39443,3,9443,[195  12  22 200 237],280,3,38748,4.10292249047014,0.0,0.0
39444,3,9444,[  9 216  95 427 515],18,5,38753,4.103017469560614,20.0,0.0
39445,3,9445,[179  97 144 403 111],457,4,38757,4.103006563624815,0.0,0.0
39446,3,9446,[318 427  98 191 182],655,5,38762,4.103101513708055,40.0,0.0
39447,3,9447,[234 282 257 172 174],796,4,38766,4.1030906011854364,0.0,0.0
39448,3,9448,[191 210 234 168 748],151,3,38769,4.1029738596676895,0.0,0.0
39449,3,9449,[174 187 301   1  96],655,1,38770,4.102645502645503,0.0,0.0
39450,3,9450,[318 427  98 191 182],796,5,38775,4.102740450745952,40.0,0.0
39451,3,9451,[257 172 471 181 265],457,4,38779,4.102729581041049,0.0,0.0
39452,3,9452,[318 427  98 191 182],655,5,38784,4.10282450015868,40.0,0.0
39453,3,9453,[187 228  98 196  56],693,2,38786,4.102602073196531,0.0,0.0
39454,3,9454,[318 427  98 191 182],655,5,38791,4.10269698572184,40.0,0.0
39455,3,9455,[318 427  98 191 182],796,5,38796,4.102791878172589,40.0,0.0
39456,3,9456,[655 435 215 121  22],535,4,38800,4.102781008776567,0.0,0.0
39457,3,9457,[179 204   8 125   9],655,1,38801,4.102452949883697,0.0,0.0
39458,3,9458,[318 427  98 191 182],450,5,38806,4.1025478380378475,40.0,0.0
39459,3,9459,[318 427  98 191 182],72,5,38811,4.102642706131078,40.0,0.0
39460,3,9460,[100 174  56 173 427],450,5,38816,4.1027375541697495,20.0,20.0
39461,3,9461,[318 427  98 191 182],18,5,38821,4.10283238216022,40.0,0.0
39462,3,9462,[132 301 655 423 222],151,5,38826,4.102927190108845,0.0,0.0
39463,3,9463,[318 427  98 191 182],796,5,38831,4.103021978021978,40.0,0.0
39464,3,9464,[318 427  98 191 182],796,5,38836,4.103116745905969,40.0,0.0
39465,3,9465,[405 322 471 257 282],401,1,38837,4.1027889287978025,0.0,0.0
39466,3,9466,[318 427  98 191 182],655,5,38842,4.102883701278124,40.0,0.0
39467,3,9467,[318 427  98 191 182],72,5,38847,4.10297845373891,40.0,0.0
39468,3,9468,[196  70 135  71 216],18,3,38850,4.102861970641039,0.0,0.0
39469,3,9469,[318 427  98 191 182],450,5,38855,4.102956705385427,40.0,0.0
39470,3,9470,[182 357  97 483  89],457,5,38860,4.103051420124591,0.0,0.0
39471,3,9471,[357 546 597  28  82],450,4,38864,4.10304054054054,0.0,0.0
39472,3,9472,[ 50 222 275 121 118],796,5,38869,4.10313522643302,0.0,40.0
39473,3,9473,[111 135   9 180  98],18,3,38872,4.103018788262614,0.0,0.0
39474,3,9474,[568   1  25 132  71],389,3,38875,4.102902374670185,0.0,0.0
39475,3,9475,[197 173   1 204 153],401,2,38877,4.102680455888561,0.0,0.0
39476,3,9476,[ 50  98 117 132 323],504,4,38881,4.10266962118814,0.0,20.0
39477,3,9477,[ 89  88 257  82 258],655,1,38882,4.102342266300908,0.0,0.0
39478,3,9478,[318 427  98 191 182],450,5,38887,4.102436965924675,40.0,0.0
39479,3,9479,[318 427  98 191 182],655,5,38892,4.10253164556962,40.0,0.0
39480,3,9480,[318 427  98 191 182],450,5,38897,4.1026263052420635,40.0,0.0
39481,3,9481,[276 127   4 196 100],629,4,38901,4.10261548196583,0.0,40.0
39482,3,9482,[186 181  82   1 568],389,3,38904,4.10249920911104,0.0,0.0
39483,3,9483,[318 427  98 191 182],655,5,38909,4.102593842260649,40.0,0.0
39484,3,9484,[234  88 238 180 265],796,2,38911,4.102372166578808,0.0,0.0
39485,3,9485,[318 427  98 191 182],72,5,38916,4.1024667931688805,40.0,0.0
39486,3,9486,[318 427  98 191 182],796,5,38921,4.102561399810266,40.0,0.0
39487,3,9487,[318 427  98 191 182],655,5,38926,4.102655986509275,40.0,0.0
39488,3,9488,[318 427  98 191 182],796,5,38931,4.10275055327221,40.0,0.0
39489,3,9489,[161 125 118  82 257],798,3,38934,4.102634351949421,0.0,0.0
39490,3,9490,[318 427  98 191 182],269,5,38939,4.102728901064166,40.0,0.0
39491,3,9491,[111 132 228   9 597],796,4,38943,4.102718078381796,0.0,0.0
39492,3,9492,[153  95 202 301 405],796,4,38947,4.102707257979564,0.0,0.0
39493,3,9493,[318 427  98 191 182],796,5,38952,4.102801769538656,40.0,0.0
39494,3,9494,[  4 237 300 282 245],504,4,38956,4.102790942601369,0.0,0.0
39495,3,9495,[385 282 132 143 118],796,5,38961,4.102885425442292,0.0,0.0
39496,3,9496,[195 237 282 471  25],457,5,38966,4.102979888385806,0.0,0.0
39497,3,9497,[318 427  98 191 182],655,5,38971,4.103074331438197,40.0,0.0
39498,3,9498,[318 427  98 191 182],269,5,38976,4.103168754605748,40.0,0.0
39499,3,9499,[318 427  98 191 182],269,5,38981,4.1032631578947365,40.0,0.0
39500,3,9500,[ 82 318 195 132 302],151,2,38983,4.103041785075256,20.0,0.0
39501,3,9501,[ 25  95 185 211 603],450,3,38986,4.102925699852663,20.0,0.0
39502,3,9502,[405 196 603   9 276],401,3,38989,4.102809639061349,20.0,0.0
39503,3,9503,[275 161  79 195 300],450,5,38994,4.102904040404041,0.0,20.0
39504,3,9504,[173 403 235 288 180],457,4,38998,4.102893214097843,0.0,0.0
39505,3,9505,[318 427  98 191 182],72,5,39003,4.102987586787292,40.0,0.0
39506,3,9506,[318 427  98 191 182],655,5,39008,4.1030819396234355,40.0,0.0
39507,3,9507,[100 118 257 187 215],504,3,39011,4.102965923432898,0.0,20.0
39508,3,9508,[318 427  98 191 182],796,5,39016,4.103060258702282,40.0,0.0
39509,3,9509,[318 427  98 191 182],655,5,39021,4.103154574132492,40.0,0.0
39510,3,9510,[237 161  22 276 423],655,1,39022,4.102828304068972,0.0,0.0
39511,3,9511,[318 427  98 191 182],796,5,39027,4.102922624053827,40.0,0.0
39512,3,9512,[318 427  98 191 182],655,5,39032,4.103016924208977,40.0,0.0
39513,3,9513,[318 427  98 191 182],269,5,39037,4.103111204540677,40.0,0.0
39514,3,9514,[191  71   1  50  96],796,4,39041,4.103100367840252,0.0,20.0
39515,3,9515,[245 125  88 471 187],256,4,39045,4.1030895334174025,0.0,0.0
39516,3,9516,[318 427  98 191 182],655,5,39050,4.103183776400126,40.0,0.0
39517,3,9517,[318 427  98 191 182],450,5,39055,4.103277999579744,40.0,0.0
39518,3,9518,[ 97 301   4  15 234],151,5,39060,4.103372202962496,0.0,0.0
39519,3,9519,[318 427  98 191 182],796,5,39065,4.103466386554622,40.0,0.0
39520,3,9520,[168 181 100 161 302],450,5,39070,4.1035605503623565,0.0,20.0
39521,3,9521,[318 427  98 191 182],269,5,39075,4.103654694391935,40.0,0.0
39522,3,9522,[118 111 300  95 173],716,4,39079,4.103643809723827,0.0,0.0
39523,3,9523,[  4 234  15 328 294],655,0,39079,4.103212935741285,0.0,0.0
39524,3,9524,[318 427  98 191 182],655,5,39084,4.103307086614174,40.0,0.0
39525,3,9525,[318 427  98 191 182],655,5,39089,4.103401217719925,40.0,0.0
39526,3,9526,[294 196  82 235 173],23,1,39090,4.103075469717645,0.0,0.0
39527,3,9527,[318 427  98 191 182],450,5,39095,4.103169605373636,40.0,0.0
39528,3,9528,[318 427  98 191 182],269,5,39100,4.103263721271907,40.0,0.0
39529,3,9529,[ 79  12  56   8 125],457,5,39105,4.1033578174186776,0.0,0.0
39530,3,9530,[318 427  98 191 182],796,5,39110,4.103451893820166,40.0,0.0
39531,3,9531,[742 210 186 118 179],655,1,39111,4.10312631137222,0.0,0.0
39532,3,9532,[318 427  98 191 182],18,5,39116,4.1032203923214094,40.0,0.0
39533,3,9533,[153 143 405 172  96],269,0,39116,4.102790014684288,0.0,0.0
39534,3,9534,[196 515 357   7  96],72,4,39120,4.102779234399581,0.0,0.0
39535,3,9535,[568 216 235  79 172],716,4,39124,4.102768456375839,0.0,0.0
39536,3,9536,[318 427  98 191 182],796,5,39129,4.102862535388487,40.0,0.0
39537,3,9537,[318 427  98 191 182],450,5,39134,4.102956594673936,40.0,0.0
39538,3,9538,[385 435 195 127 132],807,2,39136,4.102736135863298,0.0,20.0
39539,3,9539,[318 427  98 191 182],796,5,39141,4.1028301886792455,40.0,0.0
39540,3,9540,[318 427  98 191 182],655,5,39146,4.102924221779688,40.0,0.0
39541,3,9541,[ 69  71 288 100 185],504,5,39151,4.103018235170824,0.0,20.0
39542,3,9542,[318 427  98 191 182],450,5,39156,4.1031122288588495,40.0,0.0
39543,3,9543,[ 11 204 153 118   8],655,0,39156,4.102682313495389,0.0,0.0
39544,3,9544,[318 427  98 191 182],269,5,39161,4.102776322682033,40.0,0.0
39545,3,9545,[318 427  98 191 182],18,5,39166,4.102870312172637,40.0,0.0
39546,3,9546,[318 427  98 191 182],18,5,39171,4.102964281973395,40.0,0.0
39547,3,9547,[100 211 168 483 127],450,4,39175,4.102953498114789,0.0,40.0
39548,3,9548,[318 427  98 191 182],18,5,39180,4.103047439522463,40.0,0.0
39549,3,9549,[318 427  98 191 182],450,5,39185,4.103141361256545,40.0,0.0
39550,3,9550,[427 132 313 183 143],796,5,39190,4.103235263323212,20.0,0.0
39551,3,9551,[135 202   1 187  64],18,3,39193,4.103119765494137,20.0,0.0
39552,3,9552,[318 427  98 191 182],72,5,39198,4.103213650162252,40.0,0.0
39553,3,9553,[318 427  98 191 182],269,5,39203,4.10330751517689,40.0,0.0
39554,3,9554,[187  69 216  82 300],716,4,39207,4.103296703296703,0.0,0.0
39555,3,9555,[185 483  70 191 568],655,3,39210,4.1031812473838425,0.0,0.0
39556,3,9556,[216 273 496  96 173],450,4,39214,4.10317045097834,20.0,0.0
39557,3,9557,[318 427  98 191 182],269,5,39219,4.103264281230383,40.0,0.0
39558,3,9558,[228 132 194 210 237],796,4,39223,4.103253478397322,0.0,0.0
39559,3,9559,[318 427  98 191 182],796,5,39228,4.103347280334728,40.0,0.0
39560,3,9560,[ 79 195 282 127   7],693,5,39233,4.103441062650351,0.0,20.0
39561,3,9561,[318 427  98 191 182],72,5,39238,4.103534825350345,40.0,0.0
39562,3,9562,[200 275 144  69 269],655,2,39240,4.103314859353759,0.0,20.0
39563,3,9563,[318 427  98 191 182],655,5,39245,4.103408615641991,40.0,0.0
39564,3,9564,[318 427  98 191 182],269,5,39250,4.103502352326189,40.0,0.0
39565,3,9565,[318 427  98 191 182],18,5,39255,4.103596069412503,40.0,0.0
39566,3,9566,[318 427  98 191 182],72,5,39260,4.103689766907077,40.0,0.0
39567,3,9567,[318 427  98 191 182],72,5,39265,4.103783444816053,40.0,0.0
39568,3,9568,[238 301 121 174 245],593,4,39269,4.1037725990176614,0.0,0.0
39569,3,9569,[313 183   7 222 235],280,2,39271,4.103552769070011,0.0,0.0
39570,3,9570,[118 117 265  82  98],280,3,39274,4.103437467349284,0.0,0.0
39571,3,9571,[228 210 173 318  56],716,5,39279,4.103531132469703,20.0,0.0
39572,3,9572,[144 300 238  70 175],716,3,39282,4.1034158570980885,0.0,0.0
39573,3,9573,[143   1 385 197  64],151,4,39286,4.103405055358262,20.0,0.0
39574,3,9574,[318 427  98 191 182],72,5,39291,4.103498694516971,40.0,0.0
39575,3,9575,[318 427  98 191 182],796,5,39296,4.10359231411863,40.0,0.0
39576,3,9576,[318 427  98 191 182],269,5,39301,4.103685914169364,40.0,0.0
39577,3,9577,[121 328 132  71 111],796,5,39306,4.1037794946752975,0.0,0.0
39578,3,9578,[405 174 195  82 211],796,3,39309,4.103664265580958,0.0,0.0
39579,3,9579,[318 427  98 191 182],655,5,39314,4.1037578288100205,40.0,0.0
39580,3,9580,[357 172 204 121 161],593,5,39319,4.103851372508089,0.0,0.0
39581,3,9581,[318 427  98 191 182],655,5,39324,4.103944896681277,40.0,0.0
39582,3,9582,[318 427  98 191 182],655,5,39329,4.104038401335699,40.0,0.0
39583,3,9583,[ 15 435 286 118   4],450,2,39331,4.103818864774625,0.0,20.0
39584,3,9584,[ 89 588 210 275 423],18,4,39335,4.103808033385498,0.0,20.0
39585,3,9585,[318 427  98 191 182],18,5,39340,4.103901523054454,40.0,0.0
39586,3,9586,[174   7 276  98 403],269,2,39342,4.103682069469072,0.0,0.0
39587,3,9587,[318 427  98 191 182],269,5,39347,4.103775552774302,40.0,0.0
39588,3,9588,[318 427  98 191 182],796,5,39352,4.103869016581499,40.0,0.0
39589,3,9589,[318 427  98 191 182],72,5,39357,4.103962460896767,40.0,0.0
39590,3,9590,[318 427  98 191 182],796,5,39362,4.1040558857262015,40.0,0.0
39591,3,9591,[318 427  98 191 182],450,5,39367,4.104149291075896,40.0,0.0
39592,3,9592,[318 427  98 191 182],796,5,39372,4.1042426769519444,40.0,0.0
39593,3,9593,[ 12  22 258 265 222],796,5,39377,4.1043360433604335,0.0,0.0
39594,3,9594,[ 96 182 302 357 288],450,4,39381,4.104325169359041,0.0,0.0
39595,3,9595,[275 238 186   8  79],389,4,39385,4.10431429762401,0.0,20.0
39596,3,9596,[318 427  98 191 182],655,5,39390,4.104407627383558,40.0,0.0
39597,3,9597,[318 427  98 191 182],796,5,39395,4.104500937695353,40.0,0.0
39598,3,9598,[ 28 288 655 100  88],174,4,39399,4.104490051046984,0.0,20.0
39599,3,9599,[318 427  98 191 182],72,5,39404,4.104583333333333,40.0,0.0
39600,3,9600,[211 742 333 196 568],655,0,39404,4.104155817102385,0.0,0.0
39601,3,9601,[318 427  98 191 182],72,5,39409,4.1042491147677564,40.0,0.0
39602,3,9602,[ 64 210 423   9  56],629,5,39414,4.104342393002187,20.0,0.0
39603,3,9603,[ 12 100 215 588  79],450,5,39419,4.1044356518117455,0.0,20.0
39604,3,9604,[483  70 258  98  69],655,2,39421,4.104216553878189,0.0,0.0
39605,3,9605,[ 12 172 748 183  82],796,4,39425,4.104205704767853,0.0,0.0
39606,3,9606,[318 427  98 191 182],269,5,39430,4.104298948683252,40.0,0.0
39607,3,9607,[144 125 423 748 313],796,5,39435,4.104392173189009,0.0,0.0
39608,3,9608,[ 28 313 603 191 121],655,3,39438,4.104277240087418,20.0,0.0
39609,3,9609,[302 238 168  28 228],450,5,39443,4.104370447450572,0.0,0.0
39610,3,9610,[121  28  79   7 143],151,5,39448,4.10446363541775,0.0,0.0
39611,3,9611,[191 135 508 568  11],655,2,39450,4.104244694132334,0.0,0.0
39612,3,9612,[185 183  25 385 202],504,3,39453,4.1041298241964,0.0,0.0
39613,3,9613,[175 265  12 276   1],457,5,39458,4.104223008113168,0.0,0.0
39614,3,9614,[318 427  98 191 182],450,5,39463,4.1043161726469055,40.0,0.0
39615,3,9615,[318 427  98 191 182],450,5,39468,4.10440931780366,40.0,0.0
39616,3,9616,[318 427  98 191 182],72,5,39473,4.104502443589477,40.0,0.0
39617,3,9617,[318 427  98 191 182],18,5,39478,4.104595550010397,40.0,0.0
39618,3,9618,[318 568 153 185 118],796,5,39483,4.104688637072461,20.0,0.0
39619,3,9619,[318 427  98 191 182],450,5,39488,4.104781704781705,40.0,0.0
39620,3,9620,[318 427  98 191 182],450,5,39493,4.104874753144164,40.0,0.0
39621,3,9621,[215 275 222 588 151],23,3,39496,4.104759925171482,0.0,20.0
39622,3,9622,[318 427  98 191 182],18,5,39501,4.104852956458485,40.0,0.0
39623,3,9623,[318 427  98 191 182],72,5,39506,4.104945968412302,40.0,0.0
39624,3,9624,[ 25 300 202 222  56],716,5,39511,4.105038961038961,0.0,0.0
39625,3,9625,[318 427  98 191 182],450,5,39516,4.105131934344484,40.0,0.0
39626,3,9626,[210 185 245 405  89],256,5,39521,4.105224888334892,0.0,0.0
39627,3,9627,[ 15 185  28  69  56],457,5,39526,4.105317823016203,0.0,0.0
39628,3,9628,[ 15 211 276 238   9],18,5,39531,4.105410738394434,0.0,0.0
39629,3,9629,[ 11  56  69 200 568],269,2,39533,4.105192107995847,0.0,0.0
39630,3,9630,[655 204  70 269 175],264,5,39538,4.105285017132178,0.0,0.0
39631,3,9631,[172 210 202  28 197],389,4,39542,4.105274086378738,0.0,0.0
39632,3,9632,[187 144  12 117 237],450,5,39547,4.105366967715145,0.0,0.0
39633,3,9633,[186 235 215 546  64],457,3,39550,4.105252231679469,20.0,0.0
39634,3,9634,[318 427  98 191 182],72,5,39555,4.105345096004151,40.0,0.0
39635,3,9635,[183  50 172 151 195],269,1,39556,4.105022831050229,0.0,20.0
39636,3,9636,[603  28  96 132 435],716,4,39560,4.105011933174224,20.0,0.0
39637,3,9637,[318 427  98 191 182],655,5,39565,4.105104793525627,40.0,0.0
39638,3,9638,[172   8 597   1 143],593,2,39567,4.104886399004046,0.0,0.0
39639,3,9639,[403 151 121 475 515],269,3,39570,4.104771784232365,0.0,0.0
39640,3,9640,[318 427  98 191 182],655,5,39575,4.104864640597448,40.0,0.0
39641,3,9641,[313 471 288 121  82],655,1,39576,4.104542626011201,0.0,0.0
39642,3,9642,[222 215 275 265 111],716,5,39581,4.1046354868816755,0.0,20.0
39643,3,9643,[318 427  98 191 182],269,5,39586,4.1047283284944,40.0,0.0
39644,3,9644,[275 127  64 181  88],457,5,39591,4.104821150855366,20.0,40.0
39645,3,9645,[173 405 117   1 678],807,3,39594,4.104706614140577,0.0,0.0
39646,3,9646,[318 427  98 191 182],796,5,39599,4.104799419508655,40.0,0.0
39647,3,9647,[318 427  98 191 182],655,5,39604,4.104892205638475,40.0,0.0
39648,3,9648,[175 132 333 655 181],655,0,39604,4.104466784122707,0.0,0.0
39649,3,9649,[210 161 275 678 748],401,2,39606,4.104248704663212,0.0,20.0
39650,3,9650,[318 427  98 191 182],72,5,39611,4.104341519013574,40.0,0.0
39651,3,9651,[153  64 172 200 197],450,4,39615,4.104330708661418,20.0,0.0
39652,3,9652,[318 427  98 191 182],72,5,39620,4.104423495286439,40.0,0.0
39653,3,9653,[172   7 276 234 197],269,2,39622,4.104205510669153,0.0,0.0
39654,3,9654,[211  64 222  22 215],655,1,39623,4.103883997928534,20.0,0.0
39655,3,9655,[318 427  98 191 182],269,5,39628,4.103976801988401,40.0,0.0
39656,3,9656,[318 427  98 191 182],18,5,39633,4.104069586828207,40.0,0.0
39657,3,9657,[318 427  98 191 182],269,5,39638,4.104162352453924,40.0,0.0
39658,3,9658,[151  28  97  95 234],577,4,39642,4.10415156848535,0.0,0.0
39659,3,9659,[144  71 318 328  22],450,4,39646,4.104140786749483,20.0,0.0
39660,3,9660,[318 427  98 191 182],269,5,39651,4.104233516199152,40.0,0.0
39661,3,9661,[318 427  98 191 182],796,5,39656,4.10432622645415,40.0,0.0
39662,3,9662,[427 655 748 234  71],450,3,39659,4.104211942460934,20.0,0.0
39663,3,9663,[100  15 228 333  71],796,4,39663,4.1042011589403975,0.0,20.0
39664,3,9664,[ 97  95 286 202  69],450,4,39667,4.104190377651319,0.0,20.0
39665,3,9665,[515  69  79 210 742],655,2,39669,4.10397268777157,0.0,0.0
39666,3,9666,[ 12 546 357  64 135],457,4,39673,4.10396193234716,20.0,0.0
39667,3,9667,[471 748 301 318 282],450,5,39678,4.104054613156806,20.0,0.0
39668,3,9668,[235 144 182 294 357],457,3,39681,4.1039404281725105,0.0,0.0
39669,3,9669,[313 153 258  22 515],655,2,39683,4.103722854188211,0.0,0.0
39670,3,9670,[234 568 121 597 385],256,5,39688,4.103815530968876,0.0,0.0
39671,3,9671,[318 427  98 191 182],72,5,39693,4.103908188585608,40.0,0.0
39672,3,9672,[121 328 235   7  98],450,3,39696,4.103794065956787,0.0,0.0
39673,3,9673,[318 427  98 191 182],655,5,39701,4.103886706636345,40.0,0.0
39674,3,9674,[  8 180 300 588 748],796,4,39705,4.103875968992248,0.0,0.0
39675,3,9675,[318 427  98 191 182],450,5,39710,4.103968582058702,40.0,0.0
39676,3,9676,[186 100  70  25 655],885,3,39713,4.103854500361682,0.0,20.0
39677,3,9677,[238  95 216 215 515],18,4,39717,4.103843769373838,0.0,0.0
39678,3,9678,[318 427  98 191 182],18,5,39722,4.10393635706168,40.0,0.0
39679,3,9679,[515  88 301 216 210],655,2,39724,4.103719008264463,0.0,0.0
39680,3,9680,[161 655 237   8 168],457,5,39729,4.103811589711807,0.0,0.0
39681,3,9681,[318 427  98 191 182],655,5,39734,4.103904152034704,40.0,0.0
39682,3,9682,[288 197   7  22 258],629,4,39738,4.103893421460291,0.0,0.0
39683,3,9683,[ 97 144   7 471 423],450,5,39743,4.103985956216439,0.0,0.0
39684,3,9684,[318 427  98 191 182],18,5,39748,4.104078471863707,40.0,0.0
39685,3,9685,[257 204 357 222 215],23,1,39749,4.103758001238901,0.0,0.0
39686,3,9686,[ 88 215   1 271 111],655,0,39749,4.103334365644678,0.0,0.0
39687,3,9687,[678  71  97  22 235],344,0,39749,4.102910817506193,0.0,0.0
39688,3,9688,[  4 568 182 597 121],256,5,39754,4.103003405924244,0.0,0.0
39689,3,9689,[403 588 568  97  50],577,4,39758,4.102992776057792,0.0,20.0
39690,3,9690,[318 427  98 191 182],72,5,39763,4.103085336910535,40.0,0.0
39691,3,9691,[100 185 597  70 483],23,3,39766,4.102971522905489,0.0,20.0
39692,3,9692,[237 197 180 265 313],450,5,39771,4.103064066852368,0.0,0.0
39693,3,9693,[ 70  11 172   8 151],269,1,39772,4.102743965339386,0.0,0.0
39694,3,9694,[234 301 288 204 174],655,0,39772,4.1023207839092315,0.0,0.0
39695,3,9695,[176  69 403 515 118],72,2,39774,4.10210396039604,0.0,0.0
39696,3,9696,[318 427  98 191 182],269,5,39779,4.102196555635763,40.0,0.0
39697,3,9697,[271  97 143 182 127],796,4,39783,4.102186017735615,0.0,20.0
39698,3,9698,[603  25 269 179 180],450,4,39787,4.102175482008454,20.0,0.0
39699,3,9699,[318 427  98 191 182],450,5,39792,4.102268041237114,40.0,0.0
39700,3,9700,[318 427  98 191 182],655,5,39797,4.102360581383363,40.0,0.0
39701,3,9701,[318 427  98 191 182],72,5,39802,4.102453102453103,40.0,0.0
39702,3,9702,[210 143 161 427  70],450,4,39806,4.102442543543234,20.0,0.0
39703,3,9703,[318 427  98 191 182],269,5,39811,4.102535037098104,40.0,0.0
39704,3,9704,[318 427  98 191 182],18,5,39816,4.102627511591963,40.0,0.0
39705,3,9705,[318 427  98 191 182],655,5,39821,4.102719967030703,40.0,0.0
39706,3,9706,[318 427  98 191 182],269,5,39826,4.102812403420212,40.0,0.0
39707,3,9707,[427 423 496 603  64],796,5,39831,4.102904820766378,80.0,0.0
39708,3,9708,[117  71 385 202 176],796,5,39836,4.102997219075085,0.0,0.0
39709,3,9709,[322 427   8 100 173],796,3,39839,4.102883625128733,20.0,20.0
39710,3,9710,[546 385 180 195 257],504,5,39844,4.102976006590464,0.0,0.0
39711,3,9711,[318 427  98 191 182],72,5,39849,4.103068369028007,40.0,0.0
39712,3,9712,[ 88 183 143 294 161],504,2,39851,4.102851848038711,0.0,0.0
39713,3,9713,[181  50 172 289 568],693,1,39852,4.102532427424336,0.0,20.0
39714,3,9714,[186  22 475  98 180],269,2,39854,4.102316006176016,0.0,0.0
39715,3,9715,[222 234 475 235 238],264,5,39859,4.102408398517909,0.0,0.0
39716,3,9716,[269  97  71  22 191],450,4,39863,4.102397859421632,0.0,0.0
39717,3,9717,[318 427  98 191 182],269,5,39868,4.102490224325993,40.0,0.0
39718,3,9718,[ 98   1 328  79 200],151,3,39871,4.102376787735364,0.0,0.0
39719,3,9719,[318 427  98 191 182],796,5,39876,4.102469135802469,40.0,0.0
39720,3,9720,[127 423 194 588 183],457,5,39881,4.102561464869869,0.0,20.0
39721,3,9721,[222 185  25  50 186],693,2,39883,4.102345196461633,0.0,20.0
39722,3,9722,[215  79  64 153 301],655,2,39885,4.102128972539339,20.0,0.0
39723,3,9723,[265 161  22 117   1],807,5,39890,4.102221308103661,0.0,0.0
39724,3,9724,[328 603 185 748 118],450,4,39894,4.102210796915167,20.0,0.0
39725,3,9725,[318 427  98 191 182],655,5,39899,4.102303105079169,40.0,0.0
39726,3,9726,[117 173 216  64 588],796,5,39904,4.10239539426339,20.0,0.0
39727,3,9727,[121 222 100  28 182],655,1,39905,4.1020764802631575,0.0,20.0
39728,3,9728,[318 427  98 191 182],450,5,39910,4.102168773769144,40.0,0.0
39729,3,9729,[301 483 302  56 127],655,3,39913,4.102055498458376,0.0,20.0
39730,3,9730,[322 204 265 238  79],796,3,39916,4.101942246428939,0.0,0.0
39731,3,9731,[176 603 471 100 197],72,4,39920,4.101931771475544,20.0,20.0
39732,3,9732,[  1  71 132 143 161],786,5,39925,4.102024041919244,0.0,0.0
39733,3,9733,[318 427  98 191 182],796,5,39930,4.102116293404562,40.0,0.0
39734,3,9734,[258 176 403 300   7],655,0,39930,4.101694915254237,0.0,0.0
39735,3,9735,[318 427  98 191 182],72,5,39935,4.101787181594084,40.0,0.0
39736,3,9736,[318 427  98 191 182],269,5,39940,4.101879428982233,40.0,0.0
39737,3,9737,[300 210 144 301 215],796,3,39943,4.101766276442802,0.0,0.0
39738,3,9738,[111  79 100  25  11],655,1,39944,4.10144778724715,0.0,20.0
39739,3,9739,[  4 318  98 269 385],655,2,39946,4.10123203285421,20.0,0.0
39740,3,9740,[245 195 202  97 471],344,2,39948,4.10101632275947,0.0,0.0
39741,3,9741,[286 161   8 196 125],796,4,39952,4.101005953602956,0.0,20.0
39742,3,9742,[318 427  98 191 182],796,5,39957,4.101098224366211,40.0,0.0
39743,3,9743,[ 50 748  97 403 111],798,3,39960,4.100985221674877,0.0,20.0
39744,3,9744,[151 211 187 603 423],716,4,39964,4.100974858902001,20.0,0.0
39745,3,9745,[318 427  98 191 182],450,5,39969,4.101067104453109,40.0,0.0
39746,3,9746,[357 182   4 210 186],18,4,39973,4.101056735405766,0.0,0.0
39747,3,9747,[318 427  98 191 182],18,5,39978,4.101148953631514,40.0,0.0
39748,3,9748,[318 427  98 191 182],796,5,39983,4.101241152938763,40.0,0.0
39749,3,9749,[121 282 597  95 186],796,4,39987,4.101230769230769,0.0,0.0
39750,3,9750,[318 427  98 191 182],269,5,39992,4.101322941236797,40.0,0.0
39751,3,9751,[318 427  98 191 182],450,5,39997,4.101415094339623,40.0,0.0
39752,3,9752,[318 427  98 191 182],269,5,40002,4.101507228545063,40.0,0.0
39753,3,9753,[318 427  98 191 182],450,5,40007,4.10159934385893,40.0,0.0
39754,3,9754,[ 79  89 185 175   8],457,5,40012,4.101691440287032,0.0,0.0
39755,3,9755,[222  15 216 179 245],450,3,40015,4.101578515785158,0.0,0.0
39756,3,9756,[318 427  98 191 182],72,5,40020,4.101670595469919,40.0,0.0
39757,3,9757,[215 197 196 742  50],504,4,40024,4.101660176265629,0.0,20.0
39758,3,9758,[318 427  98 191 182],269,5,40029,4.101752228711958,40.0,0.0
39759,3,9759,[588 210 202 111 257],389,2,40031,4.101536885245902,0.0,0.0
39760,3,9760,[318 427  98 191 182],18,5,40036,4.10162893146194,40.0,0.0
39761,3,9761,[  9  79 179 172 357],457,5,40041,4.101720958819914,0.0,0.0
39762,3,9762,[  4 215   8 228 194],796,5,40046,4.101812967325617,0.0,0.0
39763,3,9763,[546 603 245 215 313],796,4,40050,4.101802539942646,20.0,0.0
39764,3,9764,[ 98  25 186 216  64],389,2,40052,4.101587301587301,20.0,0.0
39765,3,9765,[258 234 195 403 186],693,2,40054,4.10137210731108,0.0,0.0
39766,3,9766,[435 275 515 282 195],716,3,40057,4.10125934268455,0.0,20.0
39767,3,9767,[318 427  98 191 182],655,5,40062,4.101351351351352,40.0,0.0
39768,3,9768,[318 427  98 191 182],796,5,40067,4.101443341181287,40.0,0.0
39769,3,9769,[318 427  98 191 182],269,5,40072,4.101535312180143,40.0,0.0
39770,3,9770,[144 215 182 175 187],655,2,40074,4.101320233343568,0.0,0.0
39771,3,9771,[318 427  98 191 182],796,5,40079,4.101412198117069,40.0,0.0
39772,3,9772,[318 427  98 191 182],655,5,40084,4.101504144070398,40.0,0.0
39773,3,9773,[222  71 269 588  25],450,2,40086,4.101289134438305,0.0,0.0
39774,3,9774,[318 427  98 191 182],18,5,40091,4.101381074168798,40.0,0.0
39775,3,9775,[191 174 135 153 204],18,3,40094,4.101268412438626,0.0,0.0
39776,3,9776,[318 427  98 191 182],18,5,40099,4.101360335481232,40.0,0.0
39777,3,9777,[ 50 118 191  88  98],655,3,40102,4.101247698915934,0.0,20.0
39778,3,9778,[318 427  98 191 182],18,5,40107,4.101339605276613,40.0,0.0
39779,3,9779,[318 427  98 191 182],72,5,40112,4.1014314928425355,40.0,0.0
39780,3,9780,[318 427  98 191 182],796,5,40117,4.101523361619466,40.0,0.0
39781,3,9781,[196  69 300 183  22],796,5,40122,4.101615211613167,0.0,0.0
39782,3,9782,[132 135 385 300  25],151,4,40126,4.101604824695901,0.0,0.0
39783,3,9783,[318 427  98 191 182],18,5,40131,4.101696647587898,40.0,0.0
39784,3,9784,[151 286   9 294 127],296,3,40134,4.101584057230455,0.0,40.0
39785,3,9785,[216   4  96 191 125],344,4,40138,4.101573676680973,0.0,0.0
39786,3,9786,[318 427  98 191 182],796,5,40143,4.101665474609176,40.0,0.0
39787,3,9787,[318 427  98 191 182],72,5,40148,4.101757253780139,40.0,0.0
39788,3,9788,[175 275 258 196  28],457,5,40153,4.101849014199612,0.0,20.0
39789,3,9789,[318 427  98 191 182],269,5,40158,4.10194075587334,40.0,0.0
39790,3,9790,[385 276 187 185 508],655,3,40161,4.101828209580226,0.0,0.0
39791,3,9791,[  1  50 385 269 202],796,3,40164,4.10171568627451,0.0,20.0
39792,3,9792,[318 427  98 191 182],72,5,40169,4.101807413458593,40.0,0.0
39793,3,9793,[318 427  98 191 182],655,5,40174,4.101899121911375,40.0,0.0
39794,3,9794,[ 98  64 216 748 196],450,5,40179,4.101990811638591,20.0,0.0
39795,3,9795,[ 22 568 216 742  96],655,1,40180,4.101674152715394,0.0,0.0
39796,3,9796,[318 427  98 191 182],655,5,40185,4.101765846687761,40.0,0.0
39797,3,9797,[318 427  98 191 182],450,5,40190,4.101857521943254,40.0,0.0
39798,3,9798,[228 265  50  98 195],72,3,40193,4.101745076028166,0.0,20.0
39799,3,9799,[318 427  98 191 182],655,5,40198,4.101836734693878,40.0,0.0
39800,3,9800,[ 56 121 183 237 427],450,4,40202,4.101826344250586,20.0,0.0
39801,3,9801,[318 427  98 191 182],18,5,40207,4.101917975923281,40.0,0.0
39802,3,9802,[181 186  64 179 100],389,4,40211,4.1019075793124555,20.0,20.0
39803,3,9803,[318 427  98 191 182],450,5,40216,4.1019991840065275,40.0,0.0
39804,3,9804,[153 185   1 195   4],796,4,40220,4.1019887812340645,0.0,0.0
39805,3,9805,[318 427  98 191 182],796,5,40225,4.102080358963899,40.0,0.0
39806,3,9806,[  1  25 655  22 196],716,5,40230,4.102171918017742,0.0,0.0
39807,3,9807,[318 275 195  15 496],236,2,40232,4.101957585644372,40.0,20.0
39808,3,9808,[  7  95 678 210 322],280,3,40235,4.101845244163523,0.0,0.0
39809,3,9809,[100 300 117  15 196],655,0,40235,4.101427115188583,0.0,20.0
39810,3,9810,[318 427  98 191 182],796,5,40240,4.101518703496076,40.0,0.0
39811,3,9811,[385 546  64 234 216],450,4,40244,4.1015083571137385,20.0,0.0
39812,3,9812,[318 427  98 191 182],450,5,40249,4.101599918475491,40.0,0.0
39813,3,9813,[127 357 405 194 118],457,5,40254,4.101691461177909,0.0,20.0
39814,3,9814,[318 427  98 191 182],269,5,40259,4.101782985226694,40.0,0.0
39815,3,9815,[748 210  56 153 323],796,3,40262,4.101670741646291,0.0,0.0
39816,3,9816,[318 427  98 191 182],450,5,40267,4.101762249159621,40.0,0.0
39817,3,9817,[276 181 182 245 121],593,2,40269,4.101548176818089,0.0,0.0
39818,3,9818,[318 427  98 191 182],18,5,40274,4.101639678174967,40.0,0.0
39819,3,9819,[318 427  98 191 182],18,5,40279,4.10173116089613,40.0,0.0
39820,3,9820,[588   1 204 257 215],835,1,40280,4.101415334487323,0.0,0.0
39821,3,9821,[318 427  98 191 182],796,5,40285,4.1015068214212995,40.0,0.0
39822,3,9822,[318 427  98 191 182],269,5,40290,4.101598289728189,40.0,0.0
39823,3,9823,[318 427  98 191 182],796,5,40295,4.101689739413681,40.0,0.0
39824,3,9824,[271 483 294 588  82],796,3,40298,4.1015776081424935,0.0,0.0
39825,3,9825,[ 79  88 603 742 318],450,5,40303,4.101669041318949,40.0,0.0
39826,3,9826,[318 427  98 191 182],18,5,40308,4.101760455886843,40.0,0.0
39827,3,9827,[318 427  98 191 182],655,5,40313,4.101851851851852,40.0,0.0
39828,3,9828,[318 427  98 191 182],269,5,40318,4.101943229219656,40.0,0.0
39829,3,9829,[173 385  69 678  88],344,1,40319,4.101627670396745,0.0,0.0
39830,3,9830,[269   9 143  71 286],796,2,40321,4.1014138948225005,0.0,20.0
39831,3,9831,[471  88  11 403  22],457,5,40326,4.101505288852726,0.0,0.0
39832,3,9832,[294 176  28 475 435],655,0,40326,4.101088172480423,0.0,0.0
39833,3,9833,[318 427  98 191 182],796,5,40331,4.101179581045353,40.0,0.0
39834,3,9834,[197 173 172 328 174],629,4,40335,4.101169293340112,0.0,0.0
39835,3,9835,[268 508 357 204 111],269,3,40338,4.101057340382269,0.0,0.0
39836,3,9836,[322 204 186 234  82],796,1,40339,4.100742096167531,0.0,0.0
39837,3,9837,[318 427  98 191 182],269,5,40344,4.10083350274446,40.0,0.0
39838,3,9838,[318 427  98 191 182],72,5,40349,4.100924890740929,40.0,0.0
39839,3,9839,[318 427  98 191 182],450,5,40354,4.101016260162601,40.0,0.0
39840,3,9840,[132 268  70  22 204],535,3,40357,4.100904379636216,0.0,0.0
39841,3,9841,[ 56 275  50 127 132],629,5,40362,4.10099573257468,0.0,60.0
39842,3,9842,[318 427  98 191 182],72,5,40367,4.101087066951132,40.0,0.0
39843,3,9843,[294 174   9 276 301],655,1,40368,4.1007720438846,0.0,0.0
39844,3,9844,[302 200 427 118 196],151,2,40370,4.100558659217877,20.0,0.0
39845,3,9845,[318 427  98 191 182],655,5,40375,4.100650010156409,40.0,0.0
39846,3,9846,[ 64 300 403 197 222],450,4,40379,4.100639788768153,20.0,0.0
39847,3,9847,[ 50  96 211 427 181],796,4,40383,4.100629569455727,20.0,20.0
39848,3,9848,[318 427  98 191 182],796,5,40388,4.100720885369073,40.0,0.0
39849,3,9849,[318 427  98 191 182],72,5,40393,4.100812182741117,40.0,0.0
39850,3,9850,[318 427  98 191 182],655,5,40398,4.100903461577505,40.0,0.0
39851,3,9851,[318 427  98 191 182],269,5,40403,4.100994721883882,40.0,0.0
39852,3,9852,[318 427  98 191 182],18,5,40408,4.101085963665889,40.0,0.0
39853,3,9853,[318 427  98 191 182],796,5,40413,4.101177186929166,40.0,0.0
39854,3,9854,[237 132 568 151   8],344,4,40417,4.101166920345003,0.0,0.0
39855,3,9855,[276  28 135 275 435],18,3,40420,4.101055194805195,0.0,20.0
39856,3,9856,[289 117   4 181 237],786,5,40425,4.101146393425991,0.0,0.0
39857,3,9857,[181  12 176 186  69],655,0,40425,4.100730371272063,0.0,0.0
39858,3,9858,[655  64 301 300 483],796,3,40428,4.100618724008521,20.0,0.0
39859,3,9859,[318 427  98 191 182],655,5,40433,4.100709939148073,40.0,0.0
39860,3,9860,[427 385 405 186 179],655,2,40435,4.100496907007403,20.0,0.0
39861,3,9861,[318 427  98 191 182],269,5,40440,4.100588116000811,40.0,0.0
39862,3,9862,[318 427  98 191 182],72,5,40445,4.100679306499037,40.0,0.0
39863,3,9863,[273  64 471  50 173],450,4,40449,4.100669099756691,20.0,20.0
39864,3,9864,[323  50 183 197 143],504,3,40452,4.100557526609225,0.0,20.0
39865,3,9865,[318 427  98 191 182],796,5,40457,4.100648692479221,40.0,0.0
39866,3,9866,[318 427  98 191 182],18,5,40462,4.100739839870275,40.0,0.0
39867,3,9867,[427   1 194  82 423],18,3,40465,4.1006282934738545,20.0,0.0
39868,3,9868,[318 427  98 191 182],796,5,40470,4.100719424460432,40.0,0.0
39869,3,9869,[191 197 195 318 234],269,3,40473,4.100607902735562,20.0,0.0
39870,3,9870,[318 427  98 191 182],72,5,40478,4.100699017323473,40.0,0.0
39871,3,9871,[286 168 174  98 275],389,4,40482,4.100688816855754,0.0,40.0
39872,3,9872,[318 427  98 191 182],450,5,40487,4.100779904790843,40.0,0.0
39873,3,9873,[ 98 161 302 471 234],389,4,40491,4.100769698197285,0.0,0.0
39874,3,9874,[318 427  98 191 182],655,5,40496,4.100860759493671,40.0,0.0
39875,3,9875,[269 294 187 286  89],796,2,40498,4.10064803564196,0.0,20.0
39876,3,9876,[216 211 161 222 195],796,4,40502,4.100637845499645,0.0,0.0
39877,3,9877,[191 282   1 357 471],457,5,40507,4.100728892488358,0.0,0.0
39878,3,9878,[ 15   7   4  82 483],450,1,40508,4.100415021763336,0.0,0.0
39879,3,9879,[323 603 151 202 228],798,1,40509,4.100101214574899,20.0,0.0
39880,3,9880,[318 427  98 191 182],72,5,40514,4.100192288229937,40.0,0.0
39881,3,9881,[318 427  98 191 182],72,5,40519,4.100283343452742,40.0,0.0
39882,3,9882,[ 28 271 168 185 257],796,4,40523,4.100273196397855,0.0,0.0
39883,3,9883,[318 427  98 191 182],655,5,40528,4.100364225010117,40.0,0.0
39884,3,9884,[588 328 135 294 200],450,3,40531,4.100252908447142,0.0,0.0
39885,3,9885,[273 111 195 302 748],450,4,40535,4.100242767550071,0.0,0.0
39886,3,9886,[318 427  98 191 182],72,5,40540,4.100333771619298,40.0,0.0
39887,3,9887,[318 427  98 191 182],18,5,40545,4.100424757281553,40.0,0.0
39888,3,9888,[318 427  98 191 182],796,5,40550,4.100515724542421,40.0,0.0
39889,3,9889,[318 427  98 191 182],269,5,40555,4.100606673407483,40.0,0.0
39890,3,9890,[313 196 182 357  15],450,4,40559,4.100596501870387,0.0,0.0
39891,3,9891,[186 483  71  96  97],796,3,40562,4.100485240598464,0.0,0.0
39892,3,9892,[318 427  98 191 182],18,5,40567,4.100576164965127,40.0,0.0
39893,3,9893,[318 427  98 191 182],655,5,40572,4.100667070952092,40.0,0.0
39894,3,9894,[483 282 273 185 385],401,2,40574,4.100454775138959,0.0,0.0
39895,3,9895,[318 427  98 191 182],796,5,40579,4.10054567502021,40.0,0.0
39896,3,9896,[318 427  98 191 182],655,5,40584,4.100636556532282,40.0,0.0
39897,3,9897,[318 427  98 191 182],450,5,40589,4.1007274196807435,40.0,0.0
39898,3,9898,[405 204 179 568  88],577,1,40590,4.100414183250834,0.0,0.0
39899,3,9899,[ 70 508 257 268 187],655,1,40591,4.10010101010101,0.0,0.0
39900,3,9900,[318 427  98 191 182],796,5,40596,4.100191899808101,40.0,0.0
39901,3,9901,[655 496 234  11 215],450,4,40600,4.100181781458291,20.0,0.0
39902,3,9902,[318 427  98 191 182],796,5,40605,4.100272644653136,40.0,0.0
39903,3,9903,[318 427  98 191 182],72,5,40610,4.100363489499192,40.0,0.0
39904,3,9904,[318 427  98 191 182],18,5,40615,4.100454316002019,40.0,0.0
39905,3,9905,[333 144 423  64 269],655,1,40616,4.100141328487785,20.0,0.0
39906,3,9906,[318 427  98 191 182],450,5,40621,4.100232159079439,40.0,0.0
39907,3,9907,[288  98 508  70 275],344,4,40625,4.100222042793702,0.0,20.0
39908,3,9908,[318 427  98 191 182],796,5,40630,4.100312846906852,40.0,0.0
39909,3,9909,[483 405 121  88  97],796,4,40634,4.100302724520686,0.0,0.0
39910,3,9910,[195 313 496 135  82],807,4,40638,4.100292604177177,20.0,0.0
39911,3,9911,[  8 174   1 742 313],577,5,40643,4.100383373688459,0.0,0.0
39912,3,9912,[  9 357 202 403  69],796,4,40647,4.100373247251085,0.0,0.0
39913,3,9913,[318 427  98 191 182],655,5,40652,4.100463990316724,40.0,0.0
39914,3,9914,[318 427  98 191 182],796,5,40657,4.1005547150781645,40.0,0.0
39915,3,9915,[200 191  79 742 288],450,3,40660,4.100443727309399,0.0,0.0
39916,3,9916,[318 427  98 191 182],269,5,40665,4.100534435817283,40.0,0.0
39917,3,9917,[121 125 132 202 185],450,4,40669,4.100524299253882,0.0,0.0
39918,3,9918,[234   1 183 176 288],292,4,40673,4.100514164734348,0.0,0.0
39919,3,9919,[318 427  98 191 182],72,5,40678,4.100604838709677,40.0,0.0
39920,3,9920,[ 12   9   7 173 172],344,5,40683,4.100695494405806,0.0,0.0
39921,3,9921,[318 427  98 191 182],18,5,40688,4.100786131828261,40.0,0.0
39922,3,9922,[222 268 427 328 191],655,2,40690,4.100574423057543,20.0,0.0
39923,3,9923,[318 427  98 191 182],450,5,40695,4.100665054413543,40.0,0.0
39924,3,9924,[318 427  98 191 182],655,5,40700,4.100755667506297,40.0,0.0
39925,3,9925,[318 427  98 191 182],796,5,40705,4.100846262341326,40.0,0.0
39926,3,9926,[  1 118  89  97 235],756,2,40707,4.100634632819583,0.0,0.0
39927,3,9927,[ 11 194 151  22 191],296,4,40711,4.100624496373892,0.0,0.0
39928,3,9928,[318 427  98 191 182],796,5,40716,4.100715077047034,40.0,0.0
39929,3,9929,[210 185 427 143 215],655,3,40719,4.100604229607251,20.0,0.0
39930,3,9930,[268 216 200   1 153],655,2,40721,4.100392709696909,0.0,0.0
39931,3,9931,[318 427  98 191 182],72,5,40726,4.100483286347161,40.0,0.0
39932,3,9932,[318 427  98 191 182],18,5,40731,4.100573844759891,40.0,0.0
39933,3,9933,[318 427  98 191 182],450,5,40736,4.100664384940608,40.0,0.0
39934,3,9934,[118 216 286 127 228],344,3,40739,4.100553598389532,0.0,40.0
39935,3,9935,[385 471  88 546 132],786,5,40744,4.100644122383253,0.0,0.0
39936,3,9936,[215 322 173 175 427],151,3,40747,4.100533360169065,20.0,0.0
39937,3,9937,[228 132 175 265  12],457,5,40752,4.1006238679814855,0.0,0.0
39938,3,9938,[318 427  98 191 182],18,5,40757,4.1007143575812455,40.0,0.0
39939,3,9939,[ 15 173 195 186   7],450,3,40760,4.100603621730382,0.0,0.0
39940,3,9940,[  4 204 405 125 191],796,5,40765,4.100694095161453,0.0,0.0
39941,3,9941,[318 427  98 191 182],72,5,40770,4.100784550392275,40.0,0.0
39942,3,9942,[318 427  98 191 182],269,5,40775,4.100874987428342,40.0,0.0
39943,3,9943,[318 427  98 191 182],796,5,40780,4.100965406275141,40.0,0.0
39944,3,9944,[318 427  98 191 182],655,5,40785,4.1010558069381595,40.0,0.0
39945,3,9945,[318 427  98 191 182],655,5,40790,4.101146189422884,40.0,0.0
39946,3,9946,[318 427  98 191 182],18,5,40795,4.101236553734794,40.0,0.0
39947,3,9947,[265 237  88  97 655],450,5,40800,4.101326899879373,0.0,0.0
39948,3,9948,[318 427  98 191 182],655,5,40805,4.101417227862097,40.0,0.0
39949,3,9949,[318 427  98 191 182],72,5,40810,4.101507537688442,40.0,0.0
39950,3,9950,[318 427  98 191 182],796,5,40815,4.101597829363883,40.0,0.0
39951,3,9951,[333 282 187 121 273],693,1,40816,4.101286173633441,0.0,0.0
39952,3,9952,[318 427  98 191 182],796,5,40821,4.101376469406209,40.0,0.0
39953,3,9953,[181 403 200 322 196],504,3,40824,4.10126582278481,0.0,0.0
39954,3,9954,[ 71 294 144 168 185],796,4,40828,4.101255650426921,0.0,0.0
39955,3,9955,[195 222 237 265 174],72,3,40831,4.101145038167939,0.0,0.0
39956,3,9956,[269 197 185 238 173],421,2,40833,4.100934016269961,0.0,0.0
39957,3,9957,[143 234 161 187 423],786,4,40837,4.100923880297248,0.0,0.0
39958,3,9958,[318 427  98 191 182],450,5,40842,4.101014158047997,40.0,0.0
39959,3,9959,[318 427  98 191 182],450,5,40847,4.101104417670682,40.0,0.0
39960,3,9960,[173   4  56 294 185],457,4,40851,4.101094267643811,0.0,0.0
39961,3,9961,[318 427  98 191 182],269,5,40856,4.101184501104196,40.0,0.0
39962,3,9962,[318 427  98 191 182],72,5,40861,4.1012747164508685,40.0,0.0
39963,3,9963,[318 427  98 191 182],655,5,40866,4.101364913689282,40.0,0.0
39964,3,9964,[318 427  98 191 182],269,5,40871,4.101455092824887,40.0,0.0
39965,3,9965,[183 121 269 385 216],503,3,40874,4.101344571543247,0.0,0.0
39966,3,9966,[286 127 313 357  89],796,4,40878,4.101334403531655,0.0,40.0
39967,3,9967,[318 427  98 191 182],269,5,40883,4.10142455858748,40.0,0.0
39968,3,9968,[318 427  98 191 182],269,5,40888,4.101514695556224,40.0,0.0
39969,3,9969,[318 427  98 191 182],269,5,40893,4.10160481444333,40.0,0.0
39970,3,9970,[318 427  98 191 182],655,5,40898,4.101694915254237,40.0,0.0
39971,3,9971,[318 427  98 191 182],450,5,40903,4.101784997994384,40.0,0.0
39972,3,9972,[118 202   1 742 144],796,3,40906,4.10167452120726,0.0,0.0
39973,3,9973,[318 427  98 191 182],450,5,40911,4.101764587928614,40.0,0.0
39974,3,9974,[ 79  25 161   8 483],655,2,40913,4.101553884711779,0.0,0.0
39975,3,9975,[318 427  98 191 182],450,5,40918,4.101643945469126,40.0,0.0
39976,3,9976,[318 427  98 191 182],655,5,40923,4.101733988172797,40.0,0.0
39977,3,9977,[318 427  98 191 182],18,5,40928,4.101824012828222,40.0,0.0
39978,3,9978,[318 427  98 191 182],796,5,40933,4.101914019440826,40.0,0.0
39979,3,9979,[183 322 546 125 153],796,4,40937,4.101903807615231,0.0,0.0
39980,3,9980,[318 427  98 191 182],655,5,40942,4.101993788197575,40.0,0.0
39981,3,9981,[318 427  98 191 182],18,5,40947,4.102083750751352,40.0,0.0
39982,3,9982,[318 427  98 191 182],655,5,40952,4.102173695281979,40.0,0.0
39983,3,9983,[318 427  98 191 182],72,5,40957,4.102263621794871,40.0,0.0
39984,3,9984,[132 313 196 121 301],655,1,40958,4.101952929394091,0.0,0.0
39985,3,9985,[318 427  98 191 182],18,5,40963,4.102042860004006,40.0,0.0
39986,3,9986,[318 427  98 191 182],72,5,40968,4.102132772604386,40.0,0.0
39987,3,9987,[ 70  56 216 313 238],655,2,40970,4.101922306768122,0.0,0.0
39988,3,9988,[318 427  98 191 182],450,5,40975,4.1020122134347785,40.0,0.0
39989,3,9989,[742 191 200 211 117],796,3,40978,4.101901901901902,0.0,0.0
39990,3,9990,[318 427  98 191 182],72,5,40983,4.101991792613352,40.0,0.0
39991,3,9991,[204  97   8  82 144],655,0,40983,4.10158126501201,0.0,0.0
39992,3,9992,[ 64 742 143 588 125],457,5,40988,4.101671169818873,20.0,0.0
39993,3,9993,[186 215 185 211  15],655,1,40989,4.101360816489894,0.0,0.0
39994,3,9994,[318 427  98 191 182],18,5,40994,4.101450725362682,40.0,0.0
39995,3,9995,[ 79 117 195 181 161],756,3,40997,4.101340536214486,0.0,0.0
39996,3,9996,[ 70 151 216 597 117],174,3,41000,4.101230369110733,0.0,0.0
39997,3,9997,[318 427  98 191 182],72,5,41005,4.10132026405281,40.0,0.0
39998,3,9998,[318 427  98 191 182],269,5,41010,4.101410141014101,40.0,0.0
39999,3,9999,[275  98 191 515 153],296,5,41015,4.1015,0.0,20.0
40000,4,0,[742  71 117 276 286],593,4,4,4.0,0.0,20.0
40001,4,1,[742  71 117 286 273],796,2,6,3.0,0.0,20.0
40002,4,2,[323  25 546 385 294],256,4,10,3.3333333333333335,0.0,0.0
40003,4,3,[405 258 289 318  50],807,4,14,3.5,20.0,20.0
40004,4,4,[ 82   8  69 172 132],807,5,19,3.8,0.0,0.0
40005,4,5,[ 69  50  82 132 405],151,3,22,3.6666666666666665,0.0,20.0
40006,4,6,[275 405  56 200 301],450,4,26,3.7142857142857144,0.0,20.0
40007,4,7,[143 597 118 385 546],807,5,31,3.875,0.0,0.0
40008,4,8,[323 117  56  50 318],280,3,34,3.7777777777777777,20.0,20.0
40009,4,9,[222 202  28 210   1],798,3,37,3.7,0.0,0.0
40010,4,10,[423 357 222  88  82],457,5,42,3.8181818181818183,0.0,0.0
40011,4,11,[174  71 216 125 200],577,4,46,3.8333333333333335,0.0,0.0
40012,4,12,[ 22 173 204 187 322],629,4,50,3.8461538461538463,0.0,0.0
40013,4,13,[ 69 294 323 282  70],280,2,52,3.7142857142857144,0.0,0.0
40014,4,14,[183 222 238 588 200],786,5,57,3.8,0.0,0.0
40015,4,15,[238 179 515  79 282],296,5,62,3.875,0.0,0.0
40016,4,16,[127  88 168 237 194],503,5,67,3.9411764705882355,0.0,20.0
40017,4,17,[127  22  79   1  25],716,5,72,4.0,0.0,20.0
40018,4,18,[127  22  79   1  25],344,3,75,3.9473684210526314,0.0,20.0
40019,4,19,[132  82 546 235  12],457,3,78,3.9,0.0,0.0
40020,4,20,[435 237 427   4 508],535,4,82,3.9047619047619047,20.0,0.0
40021,4,21,[127 423 183  79  25],503,5,87,3.9545454545454546,0.0,20.0
40022,4,22,[127 423 183  79  25],457,5,92,4.0,0.0,20.0
40023,4,23,[127 423 183  79  25],693,3,95,3.9583333333333335,0.0,20.0
40024,4,24,[ 88 185 187 143 238],18,3,98,3.92,0.0,0.0
40025,4,25,[127 427  79  25 174],389,4,102,3.923076923076923,20.0,20.0
40026,4,26,[268 202  64 286  28],655,1,103,3.814814814814815,20.0,20.0
40027,4,27,[127 427 289  79 174],236,4,107,3.8214285714285716,20.0,20.0
40028,4,28,[300 357  98 286 269],450,5,112,3.8620689655172415,0.0,20.0
40029,4,29,[127 300  79  70  98],450,5,117,3.9,0.0,20.0
40030,4,30,[275 234 435 318 121],716,5,122,3.935483870967742,20.0,20.0
40031,4,31,[ 25 200 318 405  96],457,5,127,3.96875,20.0,0.0
40032,4,32,[196 333 276 228 172],655,2,129,3.909090909090909,0.0,0.0
40033,4,33,[127  79  98  56  96],421,5,134,3.9411764705882355,0.0,20.0
40034,4,34,[127  79  98  56  96],693,5,139,3.9714285714285715,0.0,20.0
40035,4,35,[202  95  69 125 318],786,5,144,4.0,20.0,0.0
40036,4,36,[127 300  79 121  98],719,2,146,3.945945945945946,0.0,20.0
40037,4,37,[210 238  50 276 288],629,5,151,3.973684210526316,0.0,20.0
40038,4,38,[204 268 210 195 234],655,0,151,3.871794871794872,0.0,0.0
40039,4,39,[588 111 175 195 204],18,2,153,3.825,0.0,0.0
40040,4,40,[ 56 180 282 403 300],796,4,157,3.8292682926829267,0.0,0.0
40041,4,41,[427  64 174 405  50],716,5,162,3.857142857142857,40.0,20.0
40042,4,42,[269 603 268 111 471],655,1,163,3.7906976744186047,20.0,0.0
40043,4,43,[ 69 603 143 204 121],330,5,168,3.8181818181818183,20.0,0.0
40044,4,44,[174 196 427 483 121],535,5,173,3.8444444444444446,20.0,0.0
40045,4,45,[313 471 427 179 121],655,3,176,3.8260869565217392,20.0,0.0
40046,4,46,[ 25 200 222 515  89],655,3,179,3.8085106382978724,0.0,0.0
40047,4,47,[257 135 210   1  25],401,2,181,3.7708333333333335,0.0,0.0
40048,4,48,[435 143  79  96  98],716,4,185,3.7755102040816326,0.0,0.0
40049,4,49,[603 385  88  25 282],450,4,189,3.78,20.0,0.0
40050,4,50,[742 328 301 179 318],655,2,191,3.7450980392156863,20.0,0.0
40051,4,51,[323 313  97 144 568],796,3,194,3.730769230769231,0.0,0.0
40052,4,52,[ 98  56 288 175 132],457,5,199,3.7547169811320753,0.0,0.0
40053,4,53,[185 357 215 183 176],655,3,202,3.740740740740741,0.0,0.0
40054,4,54,[328 194 135  11 245],629,2,204,3.709090909090909,0.0,0.0
40055,4,55,[288 117 132 125 427],655,1,205,3.6607142857142856,20.0,0.0
40056,4,56,[237 357 216 132 111],716,5,210,3.6842105263157894,0.0,0.0
40057,4,57,[427 144  98 175 187],421,4,214,3.689655172413793,20.0,0.0
40058,4,58,[ 64 200 182 423 194],457,5,219,3.711864406779661,20.0,0.0
40059,4,59,[ 12 144 182 427 187],796,5,224,3.7333333333333334,20.0,0.0
40060,4,60,[ 88   4  15 135 153],18,2,226,3.7049180327868854,0.0,0.0
40061,4,61,[191 175  82 118 237],655,1,227,3.661290322580645,0.0,0.0
40062,4,62,[191 168  56  71 357],450,4,231,3.6666666666666665,0.0,0.0
40063,4,63,[ 82  69 228 132  56],796,4,235,3.671875,0.0,0.0
40064,4,64,[ 70 423 302  96 144],450,5,240,3.6923076923076925,0.0,0.0
40065,4,65,[127 211  15 228 175],655,1,241,3.6515151515151514,0.0,20.0
40066,4,66,[302 435 144 318 403],655,2,243,3.626865671641791,20.0,0.0
40067,4,67,[435 179 197 568  15],655,1,244,3.588235294117647,0.0,0.0
40068,4,68,[302  89 153 168 313],450,5,249,3.608695652173913,0.0,0.0
40069,4,69,[25 98 64 50 22],716,5,254,3.6285714285714286,20.0,20.0
40070,4,70,[ 25 194 174 322 423],151,4,258,3.6338028169014085,0.0,0.0
40071,4,71,[357 257 271 603 222],655,2,260,3.611111111111111,20.0,0.0
40072,4,72,[161  98 202 655   7],457,5,265,3.6301369863013697,0.0,0.0
40073,4,73,[302  64 318 313  70],707,2,267,3.608108108108108,40.0,0.0
40074,4,74,[302   7 153 168 318],535,4,271,3.6133333333333333,20.0,0.0
40075,4,75,[286 435  25 258   4],450,3,274,3.6052631578947367,0.0,20.0
40076,4,76,[132  28  88  64 175],655,1,275,3.5714285714285716,20.0,0.0
40077,4,77,[153 191 168 655 318],401,2,277,3.551282051282051,20.0,0.0
40078,4,78,[143 258 195 655  97],457,5,282,3.569620253164557,0.0,0.0
40079,4,79,[125 204 117 483 111],280,3,285,3.5625,0.0,0.0
40080,4,80,[ 69 143 191 318 427],18,4,289,3.567901234567901,40.0,0.0
40081,4,81,[187 117 211  97 195],796,3,292,3.5609756097560976,0.0,0.0
40082,4,82,[182 597 172 143 173],269,1,293,3.5301204819277108,0.0,0.0
40083,4,83,[483  12  89 182 515],18,4,297,3.5357142857142856,0.0,0.0
40084,4,84,[ 50 385  79 118 182],593,4,301,3.541176470588235,0.0,20.0
40085,4,85,[483  56 515 603 194],18,3,304,3.5348837209302326,20.0,0.0
40086,4,86,[483  98 515 289 357],316,4,308,3.5402298850574714,0.0,0.0
40087,4,87,[100 215 301 111 211],796,2,310,3.522727272727273,0.0,20.0
40088,4,88,[161 427 318 191 483],450,4,314,3.5280898876404496,40.0,0.0
40089,4,89,[ 95 197 187 194 282],716,3,317,3.522222222222222,0.0,0.0
40090,4,90,[222 135  56 318 568],72,4,321,3.5274725274725274,20.0,0.0
40091,4,91,[161 318 427   7 357],450,5,326,3.5434782608695654,40.0,0.0
40092,4,92,[161 318 427   7 357],693,4,330,3.5483870967741935,40.0,0.0
40093,4,93,[ 82  50 195 603   8],23,4,334,3.5531914893617023,20.0,20.0
40094,4,94,[185 328  12 161 132],450,5,339,3.568421052631579,0.0,0.0
40095,4,95,[ 79 427 318 191   7],151,4,343,3.5729166666666665,40.0,0.0
40096,4,96,[423 153 286  25 185],330,5,348,3.5876288659793816,0.0,20.0
40097,4,97,[ 79 357 515  12  56],72,5,353,3.6020408163265305,0.0,0.0
40098,4,98,[194 127  69 435 318],503,4,357,3.606060606060606,20.0,20.0
40099,4,99,[508  79 427 357   7],655,3,360,3.6,20.0,0.0
40100,4,100,[323  64 483 588 181],796,4,364,3.603960396039604,20.0,0.0
40101,4,101,[187  82   8 301 258],796,3,367,3.5980392156862746,0.0,0.0
40102,4,102,[151 174 196 235  96],344,4,371,3.6019417475728157,0.0,0.0
40103,4,103,[216 515 427 181  12],18,4,375,3.605769230769231,20.0,0.0
40104,4,104,[ 12 238 357 515  56],655,2,377,3.5904761904761906,0.0,0.0
40105,4,105,[ 95 301 288 357 222],450,2,379,3.5754716981132075,0.0,0.0
40106,4,106,[318 427 275 385 179],450,5,384,3.588785046728972,40.0,20.0
40107,4,107,[204 121 275 144 127],655,2,386,3.574074074074074,0.0,40.0
40108,4,108,[216 588  22 322   7],280,5,391,3.5871559633027523,0.0,0.0
40109,4,109,[318 427 275 385 179],450,5,396,3.6,40.0,20.0
40110,4,110,[318 427 275 385 179],450,5,401,3.6126126126126126,40.0,20.0
40111,4,111,[318 427 275 385 179],450,5,406,3.625,40.0,20.0
40112,4,112,[546 496 180 271 333],796,4,410,3.6283185840707963,20.0,0.0
40113,4,113,[588 127  25 215 144],457,5,415,3.6403508771929824,0.0,20.0
40114,4,114,[496 318 275 385 179],593,4,419,3.643478260869565,40.0,20.0
40115,4,115,[191 597 301  12  96],450,5,424,3.6551724137931036,0.0,0.0
40116,4,116,[135  82 172 161 237],280,2,426,3.641025641025641,0.0,0.0
40117,4,117,[568 185  56 403 100],796,4,430,3.6440677966101696,0.0,20.0
40118,4,118,[117 168  88 235 357],716,4,434,3.6470588235294117,0.0,0.0
40119,4,119,[ 56 322 238  15  69],593,4,438,3.65,0.0,0.0
40120,4,120,[  4 597  12 234 210],796,3,441,3.644628099173554,0.0,0.0
40121,4,121,[125 289  98 176 186],786,5,446,3.6557377049180326,0.0,0.0
40122,4,122,[210   9  97 603 234],151,5,451,3.6666666666666665,20.0,0.0
40123,4,123,[515   9 151 427 318],269,5,456,3.6774193548387095,40.0,0.0
40124,4,124,[180 135 515 117 405],292,4,460,3.68,0.0,0.0
40125,4,125,[301 143   9 475 333],655,1,461,3.6587301587301586,0.0,0.0
40126,4,126,[210 318  28 100 176],786,5,466,3.6692913385826773,20.0,20.0
40127,4,127,[ 97  79 568 294 179],577,3,469,3.6640625,0.0,0.0
40128,4,128,[357 496 151 385 427],151,4,473,3.6666666666666665,40.0,0.0
40129,4,129,[357 216 151 427 318],18,4,477,3.669230769230769,40.0,0.0
40130,4,130,[ 11 161 121 135 143],457,5,482,3.6793893129770994,0.0,0.0
40131,4,131,[ 28 328  79 282 117],796,4,486,3.6818181818181817,0.0,0.0
40132,4,132,[ 12 276  64 176 195],655,2,488,3.669172932330827,20.0,0.0
40133,4,133,[258   4 127 328 182],655,2,490,3.656716417910448,0.0,20.0
40134,4,134,[100 568  50 135 235],330,4,494,3.6592592592592594,0.0,40.0
40135,4,135,[286 181 121 211 496],796,3,497,3.6544117647058822,20.0,20.0
40136,4,136,[ 97 216 210  69  64],577,4,501,3.656934306569343,20.0,0.0
40137,4,137,[125  98 301 132 204],796,4,505,3.6594202898550723,0.0,0.0
40138,4,138,[  9 286 191 357 748],796,3,508,3.6546762589928057,0.0,20.0
40139,4,139,[ 64 191 187 405 265],716,4,512,3.657142857142857,20.0,0.0
40140,4,140,[ 22 508  96  64 286],655,1,513,3.6382978723404253,20.0,20.0
40141,4,141,[271 282  56 357  28],655,1,514,3.619718309859155,0.0,0.0
40142,4,142,[258 181 238 301 318],655,1,515,3.6013986013986012,20.0,0.0
40143,4,143,[318 427 748 186 588],450,4,519,3.6041666666666665,40.0,0.0
40144,4,144,[153  95 269 194 118],796,4,523,3.606896551724138,0.0,0.0
40145,4,145,[228 182 237  79 132],655,2,525,3.595890410958904,0.0,0.0
40146,4,146,[  1 286   7  64   8],655,1,526,3.578231292517007,20.0,20.0
40147,4,147,[194 216 385 195   4],450,4,530,3.581081081081081,0.0,0.0
40148,4,148,[172  96  82 215 588],457,5,535,3.5906040268456376,0.0,0.0
40149,4,149,[496 216 265 515 357],716,5,540,3.6,20.0,0.0
40150,4,150,[496 216 265 515 357],716,5,545,3.609271523178808,20.0,0.0
40151,4,151,[276  88 268 238 191],655,2,547,3.598684210526316,0.0,0.0
40152,4,152,[603 127 125  22 237],18,2,549,3.588235294117647,20.0,20.0
40153,4,153,[405   9 423 211  98],655,1,550,3.5714285714285716,0.0,0.0
40154,4,154,[196  71 238 385 181],796,4,554,3.574193548387097,0.0,0.0
40155,4,155,[127 202 742 100 215],655,1,555,3.5576923076923075,0.0,40.0
40156,4,156,[222 276 181 191   9],786,4,559,3.5605095541401273,0.0,0.0
40157,4,157,[496 216 265 515 357],716,5,564,3.569620253164557,20.0,0.0
40158,4,158,[496 216 265 515 357],716,5,569,3.5786163522012577,20.0,0.0
40159,4,159,[125 234 423 228 238],151,5,574,3.5875,0.0,0.0
40160,4,160,[496 216 265 515 357],716,5,579,3.5962732919254656,20.0,0.0
40161,4,161,[187 318 100 135 195],18,3,582,3.5925925925925926,20.0,20.0
40162,4,162,[127  15 125 181 200],18,2,584,3.5828220858895707,0.0,20.0
40163,4,163,[111 235 300 121 405],15,2,586,3.573170731707317,0.0,0.0
40164,4,164,[318 216 265 515 357],655,4,590,3.5757575757575757,20.0,0.0
40165,4,165,[318  98 515 357 427],269,5,595,3.5843373493975905,40.0,0.0
40166,4,166,[318  98 515 357 427],535,2,597,3.5748502994011977,40.0,0.0
40167,4,167,[568 179  11 357 195],450,5,602,3.5833333333333335,0.0,0.0
40168,4,168,[655 125 153 196 100],401,2,604,3.57396449704142,0.0,20.0
40169,4,169,[202 180 318 100 186],269,2,606,3.5647058823529414,20.0,20.0
40170,4,170,[265 357 275  64 196],151,5,611,3.573099415204678,20.0,20.0
40171,4,171,[286  25 174  88 318],330,5,616,3.5813953488372094,20.0,20.0
40172,4,172,[318  79 427 748 588],450,5,621,3.5895953757225434,40.0,0.0
40173,4,173,[ 96 143  97 471 191],450,5,626,3.5977011494252875,0.0,0.0
40174,4,174,[  8 568 182 282  12],796,5,631,3.605714285714286,0.0,0.0
40175,4,175,[ 64 228 182 197 588],796,4,635,3.6079545454545454,20.0,0.0
40176,4,176,[ 25 100  69   4 258],457,5,640,3.615819209039548,0.0,20.0
40177,4,177,[471  79 276 121 117],256,4,644,3.6179775280898876,0.0,0.0
40178,4,178,[318  79 427 748 588],807,5,649,3.625698324022346,40.0,0.0
40179,4,179,[318  79 427 748 588],450,5,654,3.6333333333333333,40.0,0.0
40180,4,180,[151 215 196  88 176],796,5,659,3.6408839779005526,0.0,0.0
40181,4,181,[144 403 181 211  28],796,3,662,3.6373626373626373,0.0,0.0
40182,4,182,[237  22 172 100 118],280,1,663,3.622950819672131,0.0,20.0
40183,4,183,[318  79 427 748 588],450,5,668,3.630434782608696,40.0,0.0
40184,4,184,[ 79 597 153 313 483],450,4,672,3.6324324324324326,0.0,0.0
40185,4,185,[318  79 427 748 588],796,5,677,3.639784946236559,40.0,0.0
40186,4,186,[318  79 427 748 588],796,5,682,3.6470588235294117,40.0,0.0
40187,4,187,[318  79 427 748 588],796,5,687,3.654255319148936,40.0,0.0
40188,4,188,[168 257 237 294 222],716,5,692,3.6613756613756614,0.0,0.0
40189,4,189,[172 187 238 286   1],18,4,696,3.663157894736842,0.0,20.0
40190,4,190,[318  79 427 748 588],796,5,701,3.670157068062827,40.0,0.0
40191,4,191,[234 288 176   4 323],280,1,702,3.65625,0.0,0.0
40192,4,192,[318  79 427 748 588],450,5,707,3.6632124352331608,40.0,0.0
40193,4,193,[515  28 215 655 175],716,4,711,3.6649484536082473,0.0,0.0
40194,4,194,[127 195 151 603  64],292,5,716,3.6717948717948716,40.0,20.0
40195,4,195,[216  79 427 748 318],796,5,721,3.6785714285714284,40.0,0.0
40196,4,196,[216 258 194 180 597],796,4,725,3.6802030456852792,0.0,0.0
40197,4,197,[483 265  50  82 301],796,3,728,3.676767676767677,0.0,20.0
40198,4,198,[496 195  97 174 196],716,4,732,3.678391959798995,20.0,0.0
40199,4,199,[ 95 186 275 153  98],450,3,735,3.675,0.0,20.0
40200,4,200,[ 22  12   4 174 546],256,5,740,3.681592039800995,0.0,0.0
40201,4,201,[ 50  22  69 288 204],450,4,744,3.6831683168316833,0.0,20.0
40202,4,202,[ 12 195 180 265 568],280,3,747,3.6798029556650245,0.0,0.0
40203,4,203,[655 176 125 187 322],786,4,751,3.6813725490196076,0.0,0.0
40204,4,204,[174  88 144 215 125],450,5,756,3.6878048780487807,0.0,0.0
40205,4,205,[  1 197 211  56 161],450,5,761,3.6941747572815533,0.0,0.0
40206,4,206,[216  79 318 496 748],796,5,766,3.7004830917874396,40.0,0.0
40207,4,207,[588 318 483 286 197],450,4,770,3.701923076923077,20.0,20.0
40208,4,208,[216  79 318 496 748],280,4,774,3.7033492822966507,40.0,0.0
40209,4,209,[ 12 322 357 181 405],344,2,776,3.6952380952380954,0.0,0.0
40210,4,210,[294  96 210 385 132],655,0,776,3.677725118483412,0.0,0.0
40211,4,211,[318 187 196 211 118],504,3,779,3.6745283018867925,20.0,0.0
40212,4,212,[132 100 143 427 289],236,4,783,3.676056338028169,20.0,20.0
40213,4,213,[ 97 210   1  64 515],716,5,788,3.682242990654206,20.0,0.0
40214,4,214,[216 588 318 496  79],716,5,793,3.688372093023256,40.0,0.0
40215,4,215,[216 588 318 496  79],280,5,798,3.6944444444444446,40.0,0.0
40216,4,216,[121  28 318 215 238],716,5,803,3.7004608294930876,20.0,0.0
40217,4,217,[216 588 318 496  79],716,5,808,3.706422018348624,40.0,0.0
40218,4,218,[216 588 318 496  79],18,5,813,3.712328767123288,40.0,0.0
40219,4,219,[216 588 318 496  79],716,5,818,3.7181818181818183,40.0,0.0
40220,4,220,[258 748 181  69 322],151,3,821,3.7149321266968327,0.0,0.0
40221,4,221,[257 568   1 211 748],796,3,824,3.7117117117117115,0.0,0.0
40222,4,222,[385  98 183   4  25],577,5,829,3.717488789237668,0.0,0.0
40223,4,223,[385 403   4 100 210],655,0,829,3.700892857142857,0.0,20.0
40224,4,224,[318  79 588 427 496],577,5,834,3.7066666666666666,60.0,0.0
40225,4,225,[111 245 300 546 318],796,4,838,3.7079646017699117,20.0,0.0
40226,4,226,[435 211  69 405 508],655,0,838,3.6916299559471364,0.0,0.0
40227,4,227,[318  79 588 427 496],18,5,843,3.6973684210526314,60.0,0.0
40228,4,228,[318  79 588 427 496],796,5,848,3.703056768558952,60.0,0.0
40229,4,229,[742 245 195  88 183],796,3,851,3.7,0.0,0.0
40230,4,230,[318  79 588 427 496],807,5,856,3.705627705627706,60.0,0.0
40231,4,231,[318  79 588 427 496],716,5,861,3.711206896551724,60.0,0.0
40232,4,232,[318  79 588 427 496],18,5,866,3.7167381974248928,60.0,0.0
40233,4,233,[282 197 121 286 655],401,1,867,3.7051282051282053,0.0,20.0
40234,4,234,[182 172 151 257 237],457,4,871,3.706382978723404,0.0,0.0
40235,4,235,[318  79 588 427 496],796,5,876,3.711864406779661,60.0,0.0
40236,4,236,[318  79 588 427 496],716,5,881,3.717299578059072,60.0,0.0
40237,4,237,[318  79 588 427 496],716,5,886,3.722689075630252,60.0,0.0
40238,4,238,[144 195 228  96 216],23,4,890,3.723849372384937,0.0,0.0
40239,4,239,[318  79 588 427 496],577,5,895,3.7291666666666665,60.0,0.0
40240,4,240,[318  79 588 427 496],716,5,900,3.7344398340248963,60.0,0.0
40241,4,241,[ 88 546 245 100 202],796,3,903,3.731404958677686,0.0,20.0
40242,4,242,[318  79 588 427 496],450,5,908,3.736625514403292,60.0,0.0
40243,4,243,[176 210   1  22  11],655,0,908,3.721311475409836,0.0,0.0
40244,4,244,[318  79 588 427 496],716,5,913,3.726530612244898,60.0,0.0
40245,4,245,[210  96   1 187 194],796,3,916,3.7235772357723578,0.0,0.0
40246,4,246,[318  79 588 427 496],577,5,921,3.7287449392712553,60.0,0.0
40247,4,247,[176 313 405   8 168],503,4,925,3.7298387096774195,0.0,0.0
40248,4,248,[151 265 435  28 186],807,4,929,3.7309236947791167,0.0,0.0
40249,4,249,[318  79 588 427 496],450,5,934,3.736,60.0,0.0
40250,4,250,[318  79 588 427 496],807,5,939,3.741035856573705,60.0,0.0
40251,4,251,[173 234 286 655 742],593,3,942,3.738095238095238,0.0,20.0
40252,4,252,[403 125 191  98 215],457,5,947,3.7430830039525693,0.0,0.0
40253,4,253,[ 97 222 655  25 180],457,5,952,3.748031496062992,0.0,0.0
40254,4,254,[318  79 588 427 496],807,5,957,3.7529411764705882,60.0,0.0
40255,4,255,[318  79 588 427 496],18,5,962,3.7578125,60.0,0.0
40256,4,256,[172  98 100 222 117],786,5,967,3.762645914396887,0.0,20.0
40257,4,257,[ 56  79 228 202  96],23,4,971,3.7635658914728682,0.0,0.0
40258,4,258,[318  79 588 427 496],18,5,976,3.7683397683397684,60.0,0.0
40259,4,259,[385 257 200 496 282],716,3,979,3.7653846153846153,20.0,0.0
40260,4,260,[318  79 588 427 496],577,5,984,3.7701149425287355,60.0,0.0
40261,4,261,[211  88 135  69 174],716,4,988,3.7709923664122136,0.0,0.0
40262,4,262,[323 191 357 215 153],639,0,988,3.7566539923954374,0.0,0.0
40263,4,263,[ 97 268 185 125 427],655,2,990,3.75,20.0,0.0
40264,4,264,[318  79 427 588 496],18,5,995,3.7547169811320753,60.0,0.0
40265,4,265,[282 237 204 186 174],457,5,1000,3.7593984962406015,0.0,0.0
40266,4,266,[144 197 423 121 294],655,0,1000,3.745318352059925,0.0,0.0
40267,4,267,[234 215 257 125 135],655,1,1001,3.735074626865672,0.0,0.0
40268,4,268,[216  79 427 588 318],796,5,1006,3.7397769516728623,40.0,0.0
40269,4,269,[ 82  69 144  98 185],457,5,1011,3.7444444444444445,0.0,0.0
40270,4,270,[216  79 427 588 318],18,5,1016,3.7490774907749076,40.0,0.0
40271,4,271,[216  79 427 588 318],577,5,1021,3.7536764705882355,40.0,0.0
40272,4,272,[269  69 222  97 237],450,4,1025,3.7545787545787546,0.0,0.0
40273,4,273,[216 427 357 294   1],716,5,1030,3.759124087591241,20.0,0.0
40274,4,274,[222  79 196   4 588],457,5,1035,3.7636363636363637,0.0,0.0
40275,4,275,[385 211 234 515 161],655,1,1036,3.753623188405797,0.0,0.0
40276,4,276,[294  97 153 168 237],401,1,1037,3.743682310469314,0.0,0.0
40277,4,277,[187 186 475 318 210],503,4,1041,3.7446043165467624,20.0,0.0
40278,4,278,[216 588 427 496 318],577,5,1046,3.74910394265233,60.0,0.0
40279,4,279,[216 588 427 496 318],716,5,1051,3.7535714285714286,60.0,0.0
40280,4,280,[216 588 427 496 318],878,4,1055,3.7544483985765122,60.0,0.0
40281,4,281,[121 268 174   8 215],655,0,1055,3.7411347517730498,0.0,0.0
40282,4,282,[ 79 318 496 427 216],236,4,1059,3.7420494699646643,60.0,0.0
40283,4,283,[ 88 179 588 210 742],450,4,1063,3.742957746478873,0.0,0.0
40284,4,284,[ 88 238 282 183 191],457,5,1068,3.7473684210526317,0.0,0.0
40285,4,285,[ 71 118 288 496 117],450,2,1070,3.7412587412587412,20.0,0.0
40286,4,286,[151 100 175  88 179],269,4,1074,3.7421602787456445,0.0,20.0
40287,4,287,[132 210 174 194 282],535,4,1078,3.7430555555555554,0.0,0.0
40288,4,288,[197 125 275 269 655],796,2,1080,3.737024221453287,0.0,20.0
40289,4,289,[216  79 427 318 588],577,5,1085,3.7413793103448274,40.0,0.0
40290,4,290,[ 12   8 196 132 143],796,5,1090,3.745704467353952,0.0,0.0
40291,4,291,[197  98 286 196  28],450,5,1095,3.75,0.0,20.0
40292,4,292,[ 79 282 111 187 237],796,5,1100,3.7542662116040955,0.0,0.0
40293,4,293,[318  79 427 216 588],796,5,1105,3.758503401360544,40.0,0.0
40294,4,294,[588 300  69  56 318],885,4,1109,3.759322033898305,20.0,0.0
40295,4,295,[ 50  79 132 294 183],280,2,1111,3.7533783783783785,0.0,20.0
40296,4,296,[127 153 176 475 210],655,1,1112,3.744107744107744,0.0,20.0
40297,4,297,[ 50 172 357  88 385],401,2,1114,3.738255033557047,0.0,20.0
40298,4,298,[403 322 181 100 117],504,3,1117,3.7357859531772575,0.0,20.0
40299,4,299,[273 197 117 322  97],450,4,1121,3.736666666666667,0.0,0.0
40300,4,300,[423 161 173 125 132],152,5,1126,3.740863787375415,0.0,0.0
40301,4,301,[318  79 427 216 588],796,5,1131,3.7450331125827816,40.0,0.0
40302,4,302,[318  79 427 216 588],18,5,1136,3.7491749174917492,40.0,0.0
40303,4,303,[318  79 427 216 588],577,5,1141,3.7532894736842106,40.0,0.0
40304,4,304,[235 282 182  28  96],450,4,1145,3.7540983606557377,0.0,0.0
40305,4,305,[427  79 318 216 588],796,5,1150,3.758169934640523,40.0,0.0
40306,4,306,[427  79 318 216 588],716,5,1155,3.762214983713355,40.0,0.0
40307,4,307,[318 471 174 302  15],655,2,1157,3.7564935064935066,20.0,0.0
40308,4,308,[100 655 127   4 153],629,4,1161,3.7572815533980584,0.0,40.0
40309,4,309,[568  97 168  15 185],330,4,1165,3.7580645161290325,0.0,0.0
40310,4,310,[483 161 228 275  22],450,4,1169,3.7588424437299035,0.0,20.0
40311,4,311,[ 79 216 427 318 588],577,5,1174,3.7628205128205128,40.0,0.0
40312,4,312,[ 79 216 427 318 588],577,5,1179,3.7667731629392973,40.0,0.0
40313,4,313,[435 294 135 215 483],716,4,1183,3.767515923566879,0.0,0.0
40314,4,314,[ 11 100 655 228 483],457,5,1188,3.7714285714285714,0.0,20.0
40315,4,315,[ 79 216 427 318 588],716,5,1193,3.7753164556962027,40.0,0.0
40316,4,316,[ 79 216 427 318 588],450,5,1198,3.779179810725552,40.0,0.0
40317,4,317,[235 238  96 143 173],450,4,1202,3.779874213836478,0.0,0.0
40318,4,318,[ 25 173 181 471 111],577,4,1206,3.780564263322884,0.0,0.0
40319,4,319,[ 79 216 427 318 588],577,5,1211,3.784375,40.0,0.0
40320,4,320,[181   1 313  28 211],807,5,1216,3.7881619937694704,0.0,0.0
40321,4,321,[ 79 216 427 318 588],716,5,1221,3.7919254658385095,40.0,0.0
40322,4,322,[ 79 216 427 318 588],450,5,1226,3.7956656346749225,40.0,0.0
40323,4,323,[742 288  98 185 174],655,2,1228,3.7901234567901234,0.0,0.0
40324,4,324,[175 288 176 161 196],457,5,1233,3.793846153846154,0.0,0.0
40325,4,325,[ 79 427 318 216 588],450,5,1238,3.7975460122699385,40.0,0.0
40326,4,326,[ 28 322 655 195  50],786,4,1242,3.7981651376146788,0.0,20.0
40327,4,327,[ 22 111  12  98   9],344,4,1246,3.798780487804878,0.0,0.0
40328,4,328,[135 405 471  28 127],72,4,1250,3.7993920972644375,0.0,20.0
40329,4,329,[ 79 427 318 216 588],796,5,1255,3.803030303030303,40.0,0.0
40330,4,330,[ 79 427 318 216 588],450,5,1260,3.806646525679758,40.0,0.0
40331,4,331,[ 79 427 318 216 588],716,5,1265,3.8102409638554215,40.0,0.0
40332,4,332,[405 238 174  69 181],786,5,1270,3.813813813813814,0.0,0.0
40333,4,333,[ 70  25 111 318 132],151,5,1275,3.817365269461078,20.0,0.0
40334,4,334,[ 79 427 318 216 588],577,5,1280,3.8208955223880596,40.0,0.0
40335,4,335,[ 69 202 118 127  50],655,2,1282,3.8154761904761907,0.0,40.0
40336,4,336,[211  89 300 234  88],655,1,1283,3.807121661721068,0.0,0.0
40337,4,337,[301 111 333 655 483],655,1,1284,3.798816568047337,0.0,0.0
40338,4,338,[318  79 427 216 588],796,5,1289,3.8023598820059,40.0,0.0
40339,4,339,[ 50 111  89   9 286],796,3,1292,3.8,0.0,40.0
40340,4,340,[318  79 427 216 588],796,5,1297,3.803519061583578,40.0,0.0
40341,4,341,[301 125  22 168 742],450,5,1302,3.807017543859649,0.0,0.0
40342,4,342,[318  79 427 216 588],18,5,1307,3.8104956268221573,40.0,0.0
40343,4,343,[318  79 427 216 588],450,5,1312,3.813953488372093,40.0,0.0
40344,4,344,[318  79 427 216 588],577,5,1317,3.8173913043478263,40.0,0.0
40345,4,345,[318  79 427 216 588],577,5,1322,3.820809248554913,40.0,0.0
40346,4,346,[269 202 175 302   4],344,5,1327,3.824207492795389,0.0,0.0
40347,4,347,[144 216   9 196 118],655,1,1328,3.8160919540229883,0.0,0.0
40348,4,348,[385 100 172   4 222],344,4,1332,3.816618911174785,0.0,20.0
40349,4,349,[ 98 186 423 546 238],786,5,1337,3.82,0.0,0.0
40350,4,350,[ 79 216 187  71 185],389,4,1341,3.8205128205128207,0.0,0.0
40351,4,351,[ 79 427 318 588 216],716,5,1346,3.8238636363636362,40.0,0.0
40352,4,352,[ 79 427 318 588 216],18,5,1351,3.8271954674220963,40.0,0.0
40353,4,353,[ 97 210 127 427 197],18,5,1356,3.830508474576271,20.0,20.0
40354,4,354,[ 79 427 318 588 216],577,5,1361,3.8338028169014087,40.0,0.0
40355,4,355,[ 79 427 318 588 216],796,5,1366,3.837078651685393,40.0,0.0
40356,4,356,[172 161 183  69 301],593,5,1371,3.8403361344537816,0.0,0.0
40357,4,357,[322  89  98 546 173],151,3,1374,3.8379888268156424,0.0,0.0
40358,4,358,[  9  22  82 117   7],655,0,1374,3.8272980501392757,0.0,0.0
40359,4,359,[318 125  28 174   1],796,3,1377,3.825,20.0,0.0
40360,4,360,[238  50 427 117  95],796,4,1381,3.8254847645429364,20.0,20.0
40361,4,361,[125  97  12   8 200],18,3,1384,3.8232044198895028,0.0,0.0
40362,4,362,[427 318  79 588 216],716,5,1389,3.8264462809917354,40.0,0.0
40363,4,363,[ 50 237 211 210 185],796,3,1392,3.8241758241758244,0.0,20.0
40364,4,364,[427 318  79 588 216],450,5,1397,3.8273972602739725,40.0,0.0
40365,4,365,[427 318  79 588 216],577,5,1402,3.830601092896175,40.0,0.0
40366,4,366,[427 318  79 588 216],577,5,1407,3.8337874659400546,40.0,0.0
40367,4,367,[302   8 483 185 143],389,4,1411,3.8342391304347827,0.0,0.0
40368,4,368,[210 508 276 181 216],344,4,1415,3.834688346883469,0.0,0.0
40369,4,369,[427 318  79 588 216],796,5,1420,3.8378378378378377,40.0,0.0
40370,4,370,[118  82 385 238 655],504,3,1423,3.835579514824798,0.0,0.0
40371,4,371,[427 318  79 588 216],577,5,1428,3.838709677419355,40.0,0.0
40372,4,372,[427 318  79 588 216],796,5,1433,3.841823056300268,40.0,0.0
40373,4,373,[427 318  79 588 216],577,5,1438,3.8449197860962565,40.0,0.0
40374,4,374,[385 216 176 196 515],716,3,1441,3.8426666666666667,0.0,0.0
40375,4,375,[  1  50 168  89 435],151,5,1446,3.845744680851064,0.0,20.0
40376,4,376,[282  88  50 168 100],457,5,1451,3.848806366047745,0.0,40.0
40377,4,377,[427 318  79 588 216],716,5,1456,3.8518518518518516,40.0,0.0
40378,4,378,[655 276 286 111 235],280,4,1460,3.8522427440633247,0.0,20.0
40379,4,379,[427 318  79 588 216],450,5,1465,3.8552631578947367,40.0,0.0
40380,4,380,[195 117 196 153 172],885,2,1467,3.8503937007874014,0.0,0.0
40381,4,381,[603 300 210 191  15],151,4,1471,3.850785340314136,20.0,0.0
40382,4,382,[216 210 197 423 471],65,5,1476,3.85378590078329,0.0,0.0
40383,4,383,[237  50 515 161 187],716,3,1479,3.8515625,0.0,20.0
40384,4,384,[ 70 427 204 191 258],23,2,1481,3.846753246753247,20.0,0.0
40385,4,385,[  1 176  97 125  88],577,4,1485,3.8471502590673574,0.0,0.0
40386,4,386,[ 79 318 427 588 216],716,5,1490,3.850129198966408,40.0,0.0
40387,4,387,[144  25 135  15 100],450,2,1492,3.845360824742268,0.0,20.0
40388,4,388,[742 183  56 385  96],796,4,1496,3.845758354755784,0.0,0.0
40389,4,389,[197 515  88  15 111],655,1,1497,3.8384615384615386,0.0,0.0
40390,4,390,[ 11 405 318 265  82],716,5,1502,3.8414322250639388,20.0,0.0
40391,4,391,[288 127 235 174 742],256,4,1506,3.8418367346938775,0.0,20.0
40392,4,392,[ 79 318 427 588 216],796,5,1511,3.8447837150127224,40.0,0.0
40393,4,393,[385 195 515 222 211],807,4,1515,3.8451776649746194,0.0,0.0
40394,4,394,[ 79 318 427 588 216],716,5,1520,3.848101265822785,40.0,0.0
40395,4,395,[ 79 318 427 588 216],450,5,1525,3.851010101010101,40.0,0.0
40396,4,396,[ 79 318 427 588 216],450,5,1530,3.853904282115869,40.0,0.0
40397,4,397,[ 11 175 118 568 508],344,3,1533,3.851758793969849,0.0,0.0
40398,4,398,[ 64   1 258 195  12],450,5,1538,3.854636591478697,20.0,0.0
40399,4,399,[ 79 318 427 588 216],18,5,1543,3.8575,40.0,0.0
40400,4,400,[ 79 318 427 588 216],450,5,1548,3.8603491271820447,40.0,0.0
40401,4,401,[ 25   1 191 228 151],457,5,1553,3.86318407960199,0.0,0.0
40402,4,402,[ 79 318 427 588 216],577,5,1558,3.866004962779156,40.0,0.0
40403,4,403,[508  79 211 185 265],655,2,1560,3.8613861386138613,0.0,0.0
40404,4,404,[ 79 318 427 588 216],18,5,1565,3.8641975308641974,40.0,0.0
40405,4,405,[257 127 132 174 172],716,5,1570,3.8669950738916254,0.0,20.0
40406,4,406,[  4 385 200 222 100],786,5,1575,3.86977886977887,0.0,20.0
40407,4,407,[ 79 318 427 588 216],577,5,1580,3.872549019607843,40.0,0.0
40408,4,408,[186 603 211  88 483],796,3,1583,3.87041564792176,20.0,0.0
40409,4,409,[302 182  98 271 313],655,4,1587,3.870731707317073,0.0,0.0
40410,4,410,[427 318  79 588 216],577,5,1592,3.8734793187347933,40.0,0.0
40411,4,411,[427 318  79 588 216],18,5,1597,3.8762135922330097,40.0,0.0
40412,4,412,[427 318  79 588 216],716,5,1602,3.8789346246973366,40.0,0.0
40413,4,413,[427 318  79 588 216],450,5,1607,3.8816425120772946,40.0,0.0
40414,4,414,[427 318  79 588 216],450,5,1612,3.8843373493975903,40.0,0.0
40415,4,415,[427 318  79 588 216],577,5,1617,3.887019230769231,40.0,0.0
40416,4,416,[322 301 204 176   4],796,3,1620,3.884892086330935,0.0,0.0
40417,4,417,[427 318  79 588 216],577,5,1625,3.88755980861244,40.0,0.0
40418,4,418,[275  98 265 235  95],450,3,1628,3.8854415274463006,0.0,20.0
40419,4,419,[427 318  79 588 216],716,5,1633,3.888095238095238,40.0,0.0
40420,4,420,[196 191  70 100 357],591,5,1638,3.8907363420427554,0.0,20.0
40421,4,421,[655  56   4 423 186],504,3,1641,3.8886255924170614,0.0,0.0
40422,4,422,[357 111 423 211   4],151,5,1646,3.8912529550827424,0.0,0.0
40423,4,423,[427 318  79 588 216],796,5,1651,3.893867924528302,40.0,0.0
40424,4,424,[ 98 603 191  50 196],389,4,1655,3.8941176470588235,20.0,20.0
40425,4,425,[ 95 603   1 496 215],731,3,1658,3.892018779342723,40.0,0.0
40426,4,426,[427 318  79 588 216],577,5,1663,3.8946135831381734,40.0,0.0
40427,4,427,[427 318  79 588 216],577,5,1668,3.897196261682243,40.0,0.0
40428,4,428,[271 322 211  64 216],796,3,1671,3.895104895104895,20.0,0.0
40429,4,429,[427 318  79 588 216],18,5,1676,3.8976744186046512,40.0,0.0
40430,4,430,[427 318  79 588 216],577,5,1681,3.9002320185614847,40.0,0.0
40431,4,431,[427 318  79 588 216],716,5,1686,3.9027777777777777,40.0,0.0
40432,4,432,[  9 194 173 118 144],796,4,1690,3.903002309468822,0.0,0.0
40433,4,433,[427 318  79 588 216],716,5,1695,3.9055299539170507,40.0,0.0
40434,4,434,[228 286 333 423  12],655,0,1695,3.896551724137931,0.0,20.0
40435,4,435,[153 176 568 294 237],655,0,1695,3.8876146788990824,0.0,0.0
40436,4,436,[427 318  79 588 216],18,5,1700,3.8901601830663615,40.0,0.0
40437,4,437,[427 318  79 588 216],18,5,1705,3.8926940639269407,40.0,0.0
40438,4,438,[238  79 288  96 202],457,5,1710,3.8952164009111616,0.0,0.0
40439,4,439,[  4 161  25 196   1],577,5,1715,3.897727272727273,0.0,0.0
40440,4,440,[427 318  79 588 216],716,5,1720,3.9002267573696145,40.0,0.0
40441,4,441,[427 318  79 588 216],796,5,1725,3.9027149321266967,40.0,0.0
40442,4,442,[111   1  25 273 117],655,1,1726,3.8961625282167045,0.0,0.0
40443,4,443,[427 318  79 588 216],450,5,1731,3.8986486486486487,40.0,0.0
40444,4,444,[196  56  69 282 294],236,3,1734,3.896629213483146,0.0,0.0
40445,4,445,[427 318  79 588 216],18,5,1739,3.899103139013453,40.0,0.0
40446,4,446,[228 100 235 313 151],450,4,1743,3.8993288590604025,0.0,20.0
40447,4,447,[427 318  79 588 216],796,5,1748,3.9017857142857144,40.0,0.0
40448,4,448,[427 318  79 588 216],796,5,1753,3.9042316258351892,40.0,0.0
40449,4,449,[ 88  25 183 385 174],577,4,1757,3.9044444444444446,0.0,0.0
40450,4,450,[ 25 655 117 151  97],450,4,1761,3.9046563192904657,0.0,0.0
40451,4,451,[427 318  79 588 216],18,5,1766,3.9070796460176993,40.0,0.0
40452,4,452,[  9 403 197 235 191],269,3,1769,3.905077262693157,0.0,0.0
40453,4,453,[748 182 357 237 118],796,5,1774,3.907488986784141,0.0,0.0
40454,4,454,[427 318  79 588 216],18,5,1779,3.9098901098901098,40.0,0.0
40455,4,455,[427 318  79 588 216],18,5,1784,3.912280701754386,40.0,0.0
40456,4,456,[313 742 204  70 234],655,1,1785,3.9059080962800876,0.0,0.0
40457,4,457,[323 125 300  15 186],796,3,1788,3.903930131004367,0.0,0.0
40458,4,458,[268 143 211 302 483],269,3,1791,3.9019607843137254,0.0,0.0
40459,4,459,[427  79 318 588 216],450,5,1796,3.9043478260869566,40.0,0.0
40460,4,460,[423 301 180 238 211],11,2,1798,3.9002169197396963,0.0,0.0
40461,4,461,[427  79 318 588 216],450,5,1803,3.9025974025974026,40.0,0.0
40462,4,462,[427  79 318 588 216],716,5,1808,3.9049676025917925,40.0,0.0
40463,4,463,[427  79 318 588 216],796,5,1813,3.9073275862068964,40.0,0.0
40464,4,464,[483 135 173 257 238],389,2,1815,3.903225806451613,0.0,0.0
40465,4,465,[143  69  64 597 182],457,4,1819,3.90343347639485,20.0,0.0
40466,4,466,[ 79 427 318 588 216],796,5,1824,3.9057815845824413,40.0,0.0
40467,4,467,[ 79 427 318 588 216],796,5,1829,3.908119658119658,40.0,0.0
40468,4,468,[117  11 182  79 597],450,5,1834,3.91044776119403,0.0,0.0
40469,4,469,[ 79 427 318 588 216],18,5,1839,3.9127659574468083,40.0,0.0
40470,4,470,[275 197  22 515  50],655,3,1842,3.910828025477707,0.0,40.0
40471,4,471,[180 234 174 111 655],269,1,1843,3.9046610169491527,0.0,0.0
40472,4,472,[173 153 423 183 282],292,5,1848,3.9069767441860463,0.0,0.0
40473,4,473,[228  88   1  79 403],256,4,1852,3.9071729957805905,0.0,0.0
40474,4,474,[ 79 427 318 588 216],796,5,1857,3.909473684210526,40.0,0.0
40475,4,475,[ 79 427 318 588 216],18,5,1862,3.911764705882353,40.0,0.0
40476,4,476,[268  96 191 183 603],269,3,1865,3.909853249475891,20.0,0.0
40477,4,477,[132 161  22 181 173],796,5,1870,3.912133891213389,0.0,0.0
40478,4,478,[427 318  79 588 216],716,5,1875,3.914405010438413,40.0,0.0
40479,4,479,[ 11 216 435 173 483],450,4,1879,3.9145833333333333,0.0,0.0
40480,4,480,[427 318  79 588 216],450,5,1884,3.916839916839917,40.0,0.0
40481,4,481,[211 202 197 655  96],655,0,1884,3.908713692946058,0.0,0.0
40482,4,482,[427 318  79 588 216],450,5,1889,3.910973084886128,40.0,0.0
40483,4,483,[186  88 318 294 202],457,4,1893,3.9111570247933884,20.0,0.0
40484,4,484,[655 427 333 357  96],796,4,1897,3.911340206185567,20.0,0.0
40485,4,485,[  4 111 173 301 269],796,3,1900,3.909465020576132,0.0,0.0
40486,4,486,[216 182 195 228 174],655,2,1902,3.9055441478439423,0.0,0.0
40487,4,487,[238 318 176 235 197],716,3,1905,3.903688524590164,20.0,0.0
40488,4,488,[ 22 121 496 202 111],796,5,1910,3.905930470347648,20.0,0.0
40489,4,489,[172 191  82 276 143],457,5,1915,3.9081632653061225,0.0,0.0
40490,4,490,[427 318  79 588 216],450,5,1920,3.910386965376782,40.0,0.0
40491,4,491,[238 179 185 197  28],655,2,1922,3.9065040650406506,0.0,0.0
40492,4,492,[427 318  79 588 216],716,5,1927,3.9087221095334685,40.0,0.0
40493,4,493,[427 318  79 588 216],450,5,1932,3.9109311740890687,40.0,0.0
40494,4,494,[172 294 288 313 258],655,2,1934,3.907070707070707,0.0,0.0
40495,4,495,[427 318  79 588 216],716,5,1939,3.909274193548387,40.0,0.0
40496,4,496,[405   8 216 427 655],23,4,1943,3.909456740442656,20.0,0.0
40497,4,497,[ 98 143 483   8  22],457,5,1948,3.9116465863453813,0.0,0.0
40498,4,498,[405  97 168 183 172],577,4,1952,3.911823647294589,0.0,0.0
40499,4,499,[161 172  28 603 238],655,2,1954,3.908,20.0,0.0
40500,4,500,[357   7 196 234  11],629,3,1957,3.906187624750499,0.0,0.0
40501,4,501,[318 132 237 161 168],269,3,1960,3.904382470119522,20.0,0.0
40502,4,502,[318  79 427 588 216],450,5,1965,3.9065606361829026,40.0,0.0
40503,4,503,[318  79 427 588 216],450,5,1970,3.9087301587301586,40.0,0.0
40504,4,504,[318  79 427 588 216],18,5,1975,3.910891089108911,40.0,0.0
40505,4,505,[ 11 151 210 237 597],457,4,1979,3.911067193675889,0.0,0.0
40506,4,506,[ 79 111 179 181 216],577,4,1983,3.911242603550296,0.0,0.0
40507,4,507,[318  79 427 588 216],796,5,1988,3.9133858267716537,40.0,0.0
40508,4,508,[238 183   1 182 117],593,3,1991,3.911591355599214,0.0,0.0
40509,4,509,[ 15  79 265 294 597],457,3,1994,3.9098039215686273,0.0,0.0
40510,4,510,[257 286  15 265 204],655,0,1994,3.9021526418786694,0.0,20.0
40511,4,511,[357 234 286  79  70],151,5,1999,3.904296875,0.0,20.0
40512,4,512,[258 197 282 546  11],450,5,2004,3.9064327485380117,0.0,0.0
40513,4,513,[318  79 427 588 216],796,5,2009,3.9085603112840466,40.0,0.0
40514,4,514,[215 144 276 100  69],280,2,2011,3.904854368932039,0.0,20.0
40515,4,515,[228 294 204 588 546],457,3,2014,3.9031007751937983,0.0,0.0
40516,4,516,[216 568  97 496  88],450,5,2019,3.905222437137331,20.0,0.0
40517,4,517,[ 95 655 185 282 234],716,4,2023,3.9054054054054053,0.0,0.0
40518,4,518,[427  79 318 588 216],796,5,2028,3.907514450867052,40.0,0.0
40519,4,519,[427  79 318 588 216],796,5,2033,3.9096153846153845,40.0,0.0
40520,4,520,[427  79 318 588 216],18,5,2038,3.9117082533589254,40.0,0.0
40521,4,521,[427  79 318 588 216],450,5,2043,3.913793103448276,40.0,0.0
40522,4,522,[275  71 121 282 234],796,4,2047,3.9139579349904396,0.0,20.0
40523,4,523,[ 96  11 597  70   7],344,2,2049,3.9103053435114505,0.0,0.0
40524,4,524,[427  79 318 588 216],716,5,2054,3.9123809523809525,40.0,0.0
40525,4,525,[ 98  56 588   9 238],18,5,2059,3.914448669201521,0.0,0.0
40526,4,526,[427  79 318 588 216],18,5,2064,3.9165085388994307,40.0,0.0
40527,4,527,[202 323 111 100 135],280,2,2066,3.912878787878788,0.0,20.0
40528,4,528,[245 144  71 483 328],450,3,2069,3.9111531190926274,0.0,0.0
40529,4,529,[427  79 318 588 216],577,5,2074,3.913207547169811,40.0,0.0
40530,4,530,[286 196  15  11 174],655,0,2074,3.9058380414312617,0.0,20.0
40531,4,531,[100  97 357  28 187],450,5,2079,3.9078947368421053,0.0,20.0
40532,4,532,[427  79 318 588 216],577,5,2084,3.9099437148217637,40.0,0.0
40533,4,533,[427  79 318 588 216],450,5,2089,3.911985018726592,40.0,0.0
40534,4,534,[427  79 318 588 216],796,5,2094,3.914018691588785,40.0,0.0
40535,4,535,[427  79 318 588 216],716,5,2099,3.916044776119403,40.0,0.0
40536,4,536,[195 427 186 132  56],450,4,2103,3.916201117318436,20.0,0.0
40537,4,537,[435  22 318  56 180],535,3,2106,3.9144981412639406,20.0,0.0
40538,4,538,[132 228 187 238 405],796,4,2110,3.914656771799629,0.0,0.0
40539,4,539,[427 318  79 588 216],796,5,2115,3.9166666666666665,40.0,0.0
40540,4,540,[127  56   7 132 655],693,4,2119,3.9168207024029575,0.0,20.0
40541,4,541,[423 215 174 121 168],716,5,2124,3.918819188191882,0.0,0.0
40542,4,542,[301 265 117  71 185],450,4,2128,3.9189686924493556,0.0,0.0
40543,4,543,[ 79 427 318 588 216],450,5,2133,3.920955882352941,40.0,0.0
40544,4,544,[ 79 427 318 588 216],716,5,2138,3.922935779816514,40.0,0.0
40545,4,545,[ 79 427 318 588 216],716,5,2143,3.9249084249084247,40.0,0.0
40546,4,546,[ 70 748 181 174  96],280,2,2145,3.9213893967093236,0.0,0.0
40547,4,547,[ 79 427 318 588 216],577,5,2150,3.923357664233577,40.0,0.0
40548,4,548,[ 79 427 318 588 216],796,5,2155,3.925318761384335,40.0,0.0
40549,4,549,[197 153  11 172 302],535,3,2158,3.923636363636364,0.0,0.0
40550,4,550,[427  79 318 588 216],450,5,2163,3.9255898366606172,40.0,0.0
40551,4,551,[427  79 318 588 216],450,5,2168,3.927536231884058,40.0,0.0
40552,4,552,[ 71 288 655 183  79],280,3,2171,3.9258589511754067,0.0,0.0
40553,4,553,[172 121 194 294   8],457,4,2175,3.9259927797833933,0.0,0.0
40554,4,554,[  1 168  69 275 135],401,1,2176,3.9207207207207206,0.0,20.0
40555,4,555,[427  79 318 588 216],796,5,2181,3.922661870503597,40.0,0.0
40556,4,556,[568  56 135 197 151],389,3,2184,3.921005385996409,0.0,0.0
40557,4,557,[427  79 318 588 216],796,5,2189,3.9229390681003586,40.0,0.0
40558,4,558,[427  79 318 588 216],796,5,2194,3.924865831842576,40.0,0.0
40559,4,559,[ 82 200 195 202 111],151,2,2196,3.9214285714285713,0.0,0.0
40560,4,560,[427  79 318 588 216],18,5,2201,3.9233511586452763,40.0,0.0
40561,4,561,[427  79 318 588 216],577,5,2206,3.925266903914591,40.0,0.0
40562,4,562,[197 271 211 151 328],796,3,2209,3.9236234458259327,0.0,0.0
40563,4,563,[427  79 318 588 216],577,5,2214,3.925531914893617,40.0,0.0
40564,4,564,[222 144 200 302 568],450,3,2217,3.9238938053097345,0.0,0.0
40565,4,565,[168 143 302  96  69],450,5,2222,3.9257950530035335,0.0,0.0
40566,4,566,[313  97 127  69 179],655,3,2225,3.924162257495591,0.0,20.0
40567,4,567,[216 117 100 385 202],344,3,2228,3.9225352112676055,0.0,20.0
40568,4,568,[282 200  11 127 483],280,4,2232,3.922671353251318,0.0,20.0
40569,4,569,[ 79 427 318 588 216],450,5,2237,3.924561403508772,40.0,0.0
40570,4,570,[508  96  70 276 245],280,3,2240,3.9229422066549913,0.0,0.0
40571,4,571,[118  11 483 655  25],457,5,2245,3.924825174825175,0.0,0.0
40572,4,572,[132  50  64 275 568],716,5,2250,3.926701570680628,20.0,40.0
40573,4,573,[ 79 427 318 588 216],450,5,2255,3.9285714285714284,40.0,0.0
40574,4,574,[ 79 427 318 588 216],796,5,2260,3.9304347826086956,40.0,0.0
40575,4,575,[ 79 427 318 588 216],577,5,2265,3.9322916666666665,40.0,0.0
40576,4,576,[ 79 427 318 588 216],577,5,2270,3.934142114384749,40.0,0.0
40577,4,577,[318 508   7  82 135],280,3,2273,3.9325259515570936,20.0,0.0
40578,4,578,[273 132  79 176 100],796,3,2276,3.930915371329879,0.0,20.0
40579,4,579,[143 655 222  82 174],796,3,2279,3.929310344827586,0.0,0.0
40580,4,580,[ 79 427 318 588 216],450,5,2284,3.9311531841652325,40.0,0.0
40581,4,581,[496  64 357 318 143],450,5,2289,3.9329896907216493,60.0,0.0
40582,4,582,[ 79 427 318 588 216],18,5,2294,3.934819897084048,40.0,0.0
40583,4,583,[ 79 427 318 588 216],796,5,2299,3.9366438356164384,40.0,0.0
40584,4,584,[ 79 427 318 588 216],450,5,2304,3.9384615384615387,40.0,0.0
40585,4,585,[282  95   4 423 151],450,3,2307,3.9368600682593855,0.0,0.0
40586,4,586,[ 79 427 318 588 216],577,5,2312,3.938671209540034,40.0,0.0
40587,4,587,[  1 237 333 258 173],796,4,2316,3.938775510204082,0.0,0.0
40588,4,588,[ 79 427 318 588 216],716,5,2321,3.940577249575552,40.0,0.0
40589,4,589,[ 79 427 318 588 216],796,5,2326,3.942372881355932,40.0,0.0
40590,4,590,[427 273 210 204 257],796,3,2329,3.9407783417935702,20.0,0.0
40591,4,591,[ 25 200  95 483 215],450,1,2330,3.935810810810811,0.0,0.0
40592,4,592,[197 483 135 238  28],716,4,2334,3.935919055649241,0.0,0.0
40593,4,593,[ 89 191 318 132 238],457,5,2339,3.9377104377104377,20.0,0.0
40594,4,594,[ 97 185  79  64 195],450,5,2344,3.939495798319328,20.0,0.0
40595,4,595,[ 79 427 318 588 216],716,5,2349,3.9412751677852347,40.0,0.0
40596,4,596,[210  50 161  22 655],716,4,2353,3.9413735343383585,0.0,20.0
40597,4,597,[275 176 143 183 234],716,3,2356,3.939799331103679,0.0,20.0
40598,4,598,[273 228 180  71 197],796,2,2358,3.9365609348914856,0.0,0.0
40599,4,599,[235   4  89 275 288],457,4,2362,3.9366666666666665,0.0,20.0
40600,4,600,[195 313 228  89 172],450,5,2367,3.9384359400998337,0.0,0.0
40601,4,601,[ 88 200 289 191 508],655,2,2369,3.935215946843854,0.0,0.0
40602,4,602,[273 228 300  12 194],796,4,2373,3.9353233830845773,0.0,0.0
40603,4,603,[195 294 357 204 216],796,4,2377,3.935430463576159,0.0,0.0
40604,4,604,[ 12 269 742 603   9],796,2,2379,3.9322314049586775,20.0,0.0
40605,4,605,[ 79 427 318 588 216],716,5,2384,3.933993399339934,40.0,0.0
40606,4,606,[ 79 427 318 588 216],796,5,2389,3.9357495881383855,40.0,0.0
40607,4,607,[ 79 427 318 588 216],18,5,2394,3.9375,40.0,0.0
40608,4,608,[ 79 427 318 588 216],577,5,2399,3.9392446633825946,40.0,0.0
40609,4,609,[ 79 427 318 588 216],577,5,2404,3.940983606557377,40.0,0.0
40610,4,610,[ 79 427 318 588 216],18,5,2409,3.9427168576104745,40.0,0.0
40611,4,611,[313 200 215 194 161],796,5,2414,3.9444444444444446,0.0,0.0
40612,4,612,[ 79 427 318 588 216],577,5,2419,3.946166394779772,40.0,0.0
40613,4,613,[ 79 427 318 588 216],450,5,2424,3.9478827361563518,40.0,0.0
40614,4,614,[151 237 204 423 302],450,5,2429,3.9495934959349595,0.0,0.0
40615,4,615,[427  79 318 588 216],716,5,2434,3.9512987012987013,40.0,0.0
40616,4,616,[228 403 183  82 161],655,1,2435,3.946515397082658,0.0,0.0
40617,4,617,[237 100 183 496  82],577,5,2440,3.9482200647249193,20.0,20.0
40618,4,618,[427  79 318 588 216],716,5,2445,3.949919224555735,40.0,0.0
40619,4,619,[427  79 318 588 216],577,5,2450,3.9516129032258065,40.0,0.0
40620,4,620,[427  79 318 588 216],450,5,2455,3.9533011272141705,40.0,0.0
40621,4,621,[191 196 427 588 183],577,5,2460,3.954983922829582,20.0,0.0
40622,4,622,[ 69 135 257 333   4],655,1,2461,3.9502407704654896,0.0,0.0
40623,4,623,[ 79 427 318 588 216],716,5,2466,3.951923076923077,40.0,0.0
40624,4,624,[742 238 403 603  50],655,2,2468,3.9488,20.0,20.0
40625,4,625,[ 79 427 318 588 216],577,5,2473,3.950479233226837,40.0,0.0
40626,4,626,[ 82 655  70   9 186],504,3,2476,3.94896331738437,0.0,0.0
40627,4,627,[ 79 427 318 588 216],450,5,2481,3.950636942675159,40.0,0.0
40628,4,628,[301 385 197 117 403],796,3,2484,3.9491255961844196,0.0,0.0
40629,4,629,[ 79 427 318 588 216],716,5,2489,3.950793650793651,40.0,0.0
40630,4,630,[ 79 427 318 588 216],796,5,2494,3.9524564183835182,40.0,0.0
40631,4,631,[132 508 195 742 271],655,0,2494,3.9462025316455698,0.0,0.0
40632,4,632,[183  79 125 357 135],151,4,2498,3.9462875197472354,0.0,0.0
40633,4,633,[ 79 427 318 588 216],577,5,2503,3.94794952681388,40.0,0.0
40634,4,634,[294  28 257 153  69],655,0,2503,3.941732283464567,0.0,0.0
40635,4,635,[ 79 427 318 588 216],716,5,2508,3.943396226415094,40.0,0.0
40636,4,636,[496 546  28 143 117],236,3,2511,3.9419152276295133,20.0,0.0
40637,4,637,[276   8 258 195 111],457,4,2515,3.9420062695924765,0.0,0.0
40638,4,638,[238  98 603 216 196],655,3,2518,3.940532081377152,20.0,0.0
40639,4,639,[235 423 168 186 588],457,4,2522,3.940625,0.0,0.0
40640,4,640,[ 79 427 318 588 216],796,5,2527,3.9422776911076443,40.0,0.0
40641,4,641,[ 79 427 318 588 216],450,5,2532,3.94392523364486,40.0,0.0
40642,4,642,[186 742 301 125   1],655,0,2532,3.9377916018662518,0.0,0.0
40643,4,643,[ 79 427 318 588 216],716,5,2537,3.93944099378882,40.0,0.0
40644,4,644,[322  25  69 161 257],401,1,2538,3.9348837209302325,0.0,0.0
40645,4,645,[ 79 427 318 588 216],796,5,2543,3.9365325077399382,40.0,0.0
40646,4,646,[ 79 427 318 588 216],716,5,2548,3.938176197836167,40.0,0.0
40647,4,647,[597 237 294   7 323],256,4,2552,3.9382716049382718,0.0,0.0
40648,4,648,[496 197 168 423 172],18,3,2555,3.936825885978428,20.0,0.0
40649,4,649,[ 82 237 496 202 151],18,1,2556,3.9323076923076923,20.0,0.0
40650,4,650,[ 79 427 318 588 216],796,5,2561,3.93394777265745,40.0,0.0
40651,4,651,[153 385 603  50 176],503,2,2563,3.9309815950920246,20.0,20.0
40652,4,652,[435 228 181 215 385],151,3,2566,3.9295558958652372,0.0,0.0
40653,4,653,[ 79 427 318 588 216],716,5,2571,3.9311926605504586,40.0,0.0
40654,4,654,[ 79 427 318 588 216],716,5,2576,3.932824427480916,40.0,0.0
40655,4,655,[ 71  50 153 197  70],330,5,2581,3.9344512195121952,0.0,20.0
40656,4,656,[318 180 210 202  71],280,3,2584,3.933028919330289,20.0,0.0
40657,4,657,[ 79 427 318 588 216],450,5,2589,3.9346504559270516,40.0,0.0
40658,4,658,[ 79 427 318 588 216],716,5,2594,3.936267071320182,40.0,0.0
40659,4,659,[181 483  89 496 121],796,5,2599,3.937878787878788,20.0,0.0
40660,4,660,[204   4  15 655 125],577,4,2603,3.9379727685325263,0.0,0.0
40661,4,661,[ 79 427 318 588 216],716,5,2608,3.9395770392749245,40.0,0.0
40662,4,662,[ 79 427 318 588 216],577,5,2613,3.9411764705882355,40.0,0.0
40663,4,663,[ 79 427 318 588 216],716,5,2618,3.9427710843373496,40.0,0.0
40664,4,664,[ 79 427 318 588 216],577,5,2623,3.944360902255639,40.0,0.0
40665,4,665,[ 79 427 318 588 216],577,5,2628,3.945945945945946,40.0,0.0
40666,4,666,[ 22 288 180 655 187],450,4,2632,3.9460269865067468,0.0,0.0
40667,4,667,[132  97 427 294 496],796,3,2635,3.944610778443114,40.0,0.0
40668,4,668,[195 200 194 176 300],151,2,2637,3.9417040358744395,0.0,0.0
40669,4,669,[597 318 427 483 182],269,4,2641,3.9417910447761195,40.0,0.0
40670,4,670,[172 234 118 173  79],796,4,2645,3.941877794336811,0.0,0.0
40671,4,671,[ 79 427 318 588 216],450,5,2650,3.943452380952381,40.0,0.0
40672,4,672,[568 100 161 121 173],450,4,2654,3.9435364041604757,0.0,20.0
40673,4,673,[ 79 427 318 588 216],716,5,2659,3.9451038575667656,40.0,0.0
40674,4,674,[197 265 423  69 228],280,3,2662,3.9437037037037035,0.0,0.0
40675,4,675,[111 168  12 423 301],11,3,2665,3.9423076923076925,0.0,0.0
40676,4,676,[ 79 427 318 588 216],796,5,2670,3.943870014771049,40.0,0.0
40677,4,677,[182 228  22 238 191],450,5,2675,3.9454277286135695,0.0,0.0
40678,4,678,[ 79 427 318 588 216],18,5,2680,3.9469808541973492,40.0,0.0
40679,4,679,[ 79 427 318 588 216],796,5,2685,3.948529411764706,40.0,0.0
40680,4,680,[313 597   4 742 191],450,4,2689,3.948604992657856,0.0,0.0
40681,4,681,[ 79 427 318 588 216],796,5,2694,3.9501466275659824,40.0,0.0
40682,4,682,[742 200  22 403 228],457,5,2699,3.951683748169839,0.0,0.0
40683,4,683,[ 79 427 318 588 216],796,5,2704,3.953216374269006,40.0,0.0
40684,4,684,[ 69 172 111 204  11],344,3,2707,3.951824817518248,0.0,0.0
40685,4,685,[ 25 357  88   8 216],11,2,2709,3.9489795918367347,0.0,0.0
40686,4,686,[180 200 238 187  50],269,3,2712,3.947598253275109,0.0,20.0
40687,4,687,[655 187 191  98 222],655,3,2715,3.946220930232558,0.0,0.0
40688,4,688,[132 168 174  69 187],450,5,2720,3.9477503628447024,0.0,0.0
40689,4,689,[ 79 427 318 588 216],577,5,2725,3.949275362318841,40.0,0.0
40690,4,690,[ 79 427 318 588 216],450,5,2730,3.9507959479015917,40.0,0.0
40691,4,691,[ 79 427 318 588 216],796,5,2735,3.9523121387283235,40.0,0.0
40692,4,692,[ 50 508 180  56 197],535,4,2739,3.9523809523809526,0.0,20.0
40693,4,693,[318  79 427 588 216],577,5,2744,3.9538904899135447,40.0,0.0
40694,4,694,[483 180 143 215 235],457,4,2748,3.953956834532374,0.0,0.0
40695,4,695,[318  79 427 588 216],577,5,2753,3.9554597701149423,40.0,0.0
40696,4,696,[597 173 515   8 161],807,4,2757,3.9555236728837877,0.0,0.0
40697,4,697,[318  79 427 588 216],18,5,2762,3.95702005730659,40.0,0.0
40698,4,698,[ 25 245  70  69  56],593,3,2765,3.955650929899857,0.0,0.0
40699,4,699,[405   7  28 216  70],151,4,2769,3.9557142857142855,0.0,0.0
40700,4,700,[318  79 427 588 216],577,5,2774,3.9572039942938657,40.0,0.0
40701,4,701,[318  79 427 588 216],716,5,2779,3.9586894586894585,40.0,0.0
40702,4,702,[143 313 318  50 748],796,5,2784,3.9601706970128023,20.0,20.0
40703,4,703,[405  98 174 271 328],796,5,2789,3.961647727272727,0.0,0.0
40704,4,704,[294 288 196 125 222],655,0,2789,3.956028368794326,0.0,0.0
40705,4,705,[318  79 427 588 216],18,5,2794,3.9575070821529743,40.0,0.0
40706,4,706,[318  79 427 588 216],18,5,2799,3.958981612446959,40.0,0.0
40707,4,707,[318  79 427 588 216],18,5,2804,3.9604519774011298,40.0,0.0
40708,4,708,[318  79 427 588 216],796,5,2809,3.9619181946403383,40.0,0.0
40709,4,709,[318  79 427 588 216],577,5,2814,3.963380281690141,40.0,0.0
40710,4,710,[172 423  69 275   9],655,2,2816,3.9606188466947962,0.0,20.0
40711,4,711,[273 211 300   9 423],796,2,2818,3.957865168539326,0.0,0.0
40712,4,712,[121 237 204  70 568],593,5,2823,3.9593267882187937,0.0,0.0
40713,4,713,[ 11 191 742 471  88],457,5,2828,3.9607843137254903,0.0,0.0
40714,4,714,[ 12 211 180  98 215],18,4,2832,3.9608391608391607,0.0,0.0
40715,4,715,[182 196 655 423 204],629,5,2837,3.962290502793296,0.0,0.0
40716,4,716,[ 70 195 568 111   4],716,3,2840,3.9609483960948397,0.0,0.0
40717,4,717,[ 22 385 496  69 222],796,5,2845,3.9623955431754876,20.0,0.0
40718,4,718,[318  79 427 588 216],450,5,2850,3.963838664812239,40.0,0.0
40719,4,719,[496 282 427 210 318],535,4,2854,3.963888888888889,60.0,0.0
40720,4,720,[289  15 185 183 276],655,3,2857,3.9625520110957004,0.0,0.0
40721,4,721,[ 82 385 269 405  12],796,3,2860,3.961218836565097,0.0,0.0
40722,4,722,[ 79 181 318 183  56],693,3,2863,3.959889349930844,20.0,0.0
40723,4,723,[  7  98   1 228  97],151,5,2868,3.9613259668508287,0.0,0.0
40724,4,724,[427 318  79 588 216],450,5,2873,3.9627586206896552,40.0,0.0
40725,4,725,[423 496 294 318  88],450,5,2878,3.9641873278236917,40.0,0.0
40726,4,726,[655 196 273 603 271],655,2,2880,3.9614855570839063,20.0,0.0
40727,4,727,[182 202   7 403 200],655,2,2882,3.958791208791209,0.0,0.0
40728,4,728,[ 89 294 125 174  97],655,1,2883,3.954732510288066,0.0,0.0
40729,4,729,[ 79 427 318 588 216],450,5,2888,3.956164383561644,40.0,0.0
40730,4,730,[ 79 427 318 588 216],450,5,2893,3.9575923392612857,40.0,0.0
40731,4,731,[ 79 427 318 588 216],18,5,2898,3.959016393442623,40.0,0.0
40732,4,732,[ 79 427 318 588 216],450,5,2903,3.96043656207367,40.0,0.0
40733,4,733,[121 132   1 234 161],655,0,2903,3.955040871934605,0.0,0.0
40734,4,734,[269  22 211 318 435],704,4,2907,3.9551020408163264,20.0,0.0
40735,4,735,[ 79 427 318 588 216],18,5,2912,3.9565217391304346,40.0,0.0
40736,4,736,[ 79 427 318 588 216],716,5,2917,3.9579375848032563,40.0,0.0
40737,4,737,[187  88 172 144 655],450,5,2922,3.959349593495935,0.0,0.0
40738,4,738,[153 179   8 435 151],269,2,2924,3.9566982408660354,0.0,0.0
40739,4,739,[ 79 427 318 588 216],796,5,2929,3.958108108108108,40.0,0.0
40740,4,740,[294 313  82 215 216],577,5,2934,3.9595141700404857,0.0,0.0
40741,4,741,[ 79 427 318 588 216],450,5,2939,3.9609164420485174,40.0,0.0
40742,4,742,[546 204 117  95 568],716,4,2943,3.9609690444145356,0.0,0.0
40743,4,743,[423  79 135 180 313],280,4,2947,3.961021505376344,0.0,0.0
40744,4,744,[ 12 127 597 245 258],450,5,2952,3.96241610738255,0.0,20.0
40745,4,745,[222 471 257 196 216],716,4,2956,3.962466487935657,0.0,0.0
40746,4,746,[172  97 427 300   8],796,4,2960,3.962516733601071,20.0,0.0
40747,4,747,[300 423 186 588 245],450,4,2964,3.962566844919786,0.0,0.0
40748,4,748,[318  79 427 588 216],450,5,2969,3.9639519359145527,40.0,0.0
40749,4,749,[318  79 427 588 216],577,5,2974,3.965333333333333,40.0,0.0
40750,4,750,[318  79 427 588 216],577,5,2979,3.966711051930759,40.0,0.0
40751,4,751,[318  79 427 588 216],18,5,2984,3.9680851063829787,40.0,0.0
40752,4,752,[ 50 271 313  96 403],807,3,2987,3.9667994687915007,0.0,20.0
40753,4,753,[ 82 588 191 179 483],450,3,2990,3.9655172413793105,0.0,0.0
40754,4,754,[151 121  88 471  25],344,2,2992,3.962913907284768,0.0,0.0
40755,4,755,[ 70 121  95 423  69],330,5,2997,3.9642857142857144,0.0,0.0
40756,4,756,[ 71  12  97  25 125],577,5,3002,3.965653896961691,0.0,0.0
40757,4,757,[258 435 257 301 135],655,1,3003,3.961741424802111,0.0,0.0
40758,4,758,[200 427 655 234 172],151,4,3007,3.961791831357049,20.0,0.0
40759,4,759,[ 79 427 318 588 216],577,5,3012,3.963157894736842,40.0,0.0
40760,4,760,[ 79 427 318 588 216],796,5,3017,3.964520367936925,40.0,0.0
40761,4,761,[ 79 427 318 588 216],450,5,3022,3.9658792650918637,40.0,0.0
40762,4,762,[ 79 427 318 588 216],18,5,3027,3.967234600262123,40.0,0.0
40763,4,763,[174 302 202 143  69],269,0,3027,3.962041884816754,0.0,0.0
40764,4,764,[423 235 258   7 179],450,4,3031,3.962091503267974,0.0,0.0
40765,4,765,[ 50  88 144 176  11],280,1,3032,3.9582245430809397,0.0,20.0
40766,4,766,[210 427 153  98 357],269,3,3035,3.956975228161669,20.0,0.0
40767,4,767,[301  28   4 496   9],796,2,3037,3.9544270833333335,20.0,0.0
40768,4,768,[257 194 185   4 357],504,4,3041,3.954486345903771,0.0,0.0
40769,4,769,[183 286 323 180 273],796,1,3042,3.9506493506493507,0.0,20.0
40770,4,770,[202 300  89 222 313],655,2,3044,3.9481193255512324,0.0,0.0
40771,4,771,[ 25   8  89 357 127],457,5,3049,3.949481865284974,0.0,20.0
40772,4,772,[125 268 313   9  96],655,1,3050,3.9456662354463132,0.0,0.0
40773,4,773,[427  79 318 588 216],716,5,3055,3.94702842377261,40.0,0.0
40774,4,774,[427  79 318 588 216],796,5,3060,3.9483870967741934,40.0,0.0
40775,4,775,[276 181  56 427 568],269,3,3063,3.9471649484536084,20.0,0.0
40776,4,776,[427  79 318 588 216],450,5,3068,3.9485199485199485,40.0,0.0
40777,4,777,[237 135 301 288 597],450,3,3071,3.9473007712082264,0.0,0.0
40778,4,778,[300 435  70  56 427],535,3,3074,3.946084724005135,20.0,0.0
40779,4,779,[597 121 258 151  79],450,4,3078,3.9461538461538463,0.0,0.0
40780,4,780,[180 435  25 328 196],450,4,3082,3.9462227912932137,0.0,0.0
40781,4,781,[318 427  79 588 216],18,5,3087,3.9475703324808182,40.0,0.0
40782,4,782,[318 427  79 588 216],716,5,3092,3.9489144316730522,40.0,0.0
40783,4,783,[318 427  79 588 216],796,5,3097,3.9502551020408165,40.0,0.0
40784,4,784,[257 172  28 161  50],457,4,3101,3.9503184713375794,0.0,20.0
40785,4,785,[181 427 100 194 174],269,3,3104,3.94910941475827,20.0,20.0
40786,4,786,[173 282 276  96 508],280,2,3106,3.946632782719187,0.0,0.0
40787,4,787,[185 282  98 357  28],796,4,3110,3.946700507614213,0.0,0.0
40788,4,788,[318 427  79 588 216],18,5,3115,3.948035487959442,40.0,0.0
40789,4,789,[318 427  79 588 216],18,5,3120,3.949367088607595,40.0,0.0
40790,4,790,[318 427  79 588 216],716,5,3125,3.9506953223767383,40.0,0.0
40791,4,791,[318 427  79 588 216],577,5,3130,3.952020202020202,40.0,0.0
40792,4,792,[ 89 282 427 111 174],655,2,3132,3.949558638083228,20.0,0.0
40793,4,793,[191 194 196 265 172],236,1,3133,3.945843828715365,0.0,0.0
40794,4,794,[ 79 427 318 588 216],796,5,3138,3.9471698113207547,40.0,0.0
40795,4,795,[186 427 204 180  56],296,4,3142,3.9472361809045227,20.0,0.0
40796,4,796,[183 194 200 185 143],269,3,3145,3.946047678795483,0.0,0.0
40797,4,797,[186 318 568 191 200],796,4,3149,3.9461152882205512,20.0,0.0
40798,4,798,[322  50 288 300  71],450,3,3152,3.944931163954944,0.0,20.0
40799,4,799,[ 64 153  89 186 508],269,2,3154,3.9425,20.0,0.0
40800,4,800,[435 174  28  69 204],716,5,3159,3.943820224719101,0.0,0.0
40801,4,801,[ 79 427 318 588 216],450,5,3164,3.945137157107232,40.0,0.0
40802,4,802,[ 79 471 185 186 357],716,3,3167,3.9439601494396017,0.0,0.0
40803,4,803,[181 483 603   4 175],716,3,3170,3.942786069651741,20.0,0.0
40804,4,804,[153 197 135   1  96],716,3,3173,3.941614906832298,0.0,0.0
40805,4,805,[318  79 427 588 216],796,5,3178,3.9429280397022333,40.0,0.0
40806,4,806,[234  79 118  56 423],457,5,3183,3.9442379182156135,0.0,0.0
40807,4,807,[318  79 427 588 216],716,5,3188,3.9455445544554455,40.0,0.0
40808,4,808,[318  79 427 588 216],716,5,3193,3.9468479604449938,40.0,0.0
40809,4,809,[318  79 427 588 216],716,5,3198,3.948148148148148,40.0,0.0
40810,4,810,[ 11 118  15  12 423],174,3,3201,3.946979038224414,0.0,0.0
40811,4,811,[ 56 118 173  28 301],796,3,3204,3.9458128078817736,0.0,0.0
40812,4,812,[318  79 427 588 216],796,5,3209,3.947109471094711,40.0,0.0
40813,4,813,[318  79 427 588 216],18,5,3214,3.9484029484029484,40.0,0.0
40814,4,814,[318  79 427 588 216],450,5,3219,3.949693251533742,40.0,0.0
40815,4,815,[318 151  95 471 228],807,5,3224,3.950980392156863,20.0,0.0
40816,4,816,[176  22 405 197 423],716,4,3228,3.9510403916768664,0.0,0.0
40817,4,817,[318  79 427 588 216],796,5,3233,3.952322738386308,40.0,0.0
40818,4,818,[318  79 427 588 216],18,5,3238,3.9536019536019538,40.0,0.0
40819,4,819,[318  79 427 588 216],18,5,3243,3.954878048780488,40.0,0.0
40820,4,820,[318  79 427 588 216],450,5,3248,3.956151035322777,40.0,0.0
40821,4,821,[168 215 151 300 176],716,4,3252,3.9562043795620436,0.0,0.0
40822,4,822,[ 79 427 318 588 216],450,5,3257,3.9574726609963546,40.0,0.0
40823,4,823,[546 144 275 161 288],593,3,3260,3.9563106796116503,0.0,20.0
40824,4,824,[427  79 318 588 216],18,5,3265,3.9575757575757575,40.0,0.0
40825,4,825,[427  79 318 588 216],577,5,3270,3.9588377723970942,40.0,0.0
40826,4,826,[427  79 318 588 216],796,5,3275,3.9600967351874243,40.0,0.0
40827,4,827,[427  79 318 588 216],450,5,3280,3.9613526570048307,40.0,0.0
40828,4,828,[427  79 318 588 216],577,5,3285,3.962605548854041,40.0,0.0
40829,4,829,[427  79 318 588 216],18,5,3290,3.963855421686747,40.0,0.0
40830,4,830,[318 182 313   8  70],280,3,3293,3.9626955475330927,20.0,0.0
40831,4,831,[151 117 235 176  82],457,4,3297,3.9627403846153846,0.0,0.0
40832,4,832,[ 22   4 228 216 200],450,3,3300,3.9615846338535414,0.0,0.0
40833,4,833,[405 176 186 196 182],457,5,3305,3.962829736211031,0.0,0.0
40834,4,834,[ 96 132 161 200 245],796,4,3309,3.962874251497006,0.0,0.0
40835,4,835,[318  79 427 588 216],796,5,3314,3.964114832535885,40.0,0.0
40836,4,836,[508 288 125 222  95],280,2,3316,3.9617682198327357,0.0,0.0
40837,4,837,[318  79 427 588 216],716,5,3321,3.9630071599045347,40.0,0.0
40838,4,838,[318  79 427 588 216],18,5,3326,3.9642431466030987,40.0,0.0
40839,4,839,[245 173 323 191 168],796,3,3329,3.9630952380952382,0.0,0.0
40840,4,840,[ 64  22 742 161 235],256,4,3333,3.963139120095125,20.0,0.0
40841,4,841,[318  79 427 588 216],577,5,3338,3.96437054631829,40.0,0.0
40842,4,842,[588 173 228 161  70],786,5,3343,3.965599051008304,0.0,0.0
40843,4,843,[204 125 211 257 238],296,5,3348,3.9668246445497632,0.0,0.0
40844,4,844,[125 286  71 323 211],796,2,3350,3.964497041420118,0.0,20.0
40845,4,845,[318  79 427 588 216],18,5,3355,3.965721040189125,40.0,0.0
40846,4,846,[216 195 117   1  11],344,2,3357,3.9634002361275087,0.0,0.0
40847,4,847,[121 215 265 318  50],457,5,3362,3.964622641509434,20.0,20.0
40848,4,848,[185 211 194 197  56],535,4,3366,3.964664310954064,0.0,0.0
40849,4,849,[318  79 427 588 216],716,5,3371,3.9658823529411764,40.0,0.0
40850,4,850,[153 196  64 143 186],796,4,3375,3.9659224441833136,20.0,0.0
40851,4,851,[238  50 216 111 172],655,3,3378,3.964788732394366,0.0,20.0
40852,4,852,[ 96 132 222  12  25],655,0,3378,3.9601406799531067,0.0,0.0
40853,4,853,[546 742 196  25 210],693,1,3379,3.9566744730679155,0.0,0.0
40854,4,854,[ 69 121 318 153 174],503,3,3382,3.9555555555555557,20.0,0.0
40855,4,855,[318  79 427 588 216],716,5,3387,3.9567757009345796,40.0,0.0
40856,4,856,[301 127 176 200 117],450,4,3391,3.9568261376896148,0.0,20.0
40857,4,857,[333 100 210 175 111],655,0,3391,3.9522144522144522,0.0,20.0
40858,4,858,[318  79 427 588 216],716,5,3396,3.9534342258440045,40.0,0.0
40859,4,859,[151 423  25 132  11],716,5,3401,3.9546511627906975,0.0,0.0
40860,4,860,[483 508 301 215 117],655,1,3402,3.951219512195122,0.0,0.0
40861,4,861,[ 98 215 181 435   9],18,3,3405,3.9501160092807424,0.0,0.0
40862,4,862,[318  79 427 588 216],577,5,3410,3.951332560834299,40.0,0.0
40863,4,863,[210 269 435 275 181],296,4,3414,3.951388888888889,0.0,20.0
40864,4,864,[ 50 132 286  71 185],389,4,3418,3.9514450867052022,0.0,40.0
40865,4,865,[204 294 210  82 588],450,3,3421,3.9503464203233256,0.0,0.0
40866,4,866,[318  79 427 588 216],577,5,3426,3.9515570934256057,40.0,0.0
40867,4,867,[191 268 200   9 111],629,4,3430,3.9516129032258065,0.0,0.0
40868,4,868,[318  79 427 588 216],716,5,3435,3.952819332566168,40.0,0.0
40869,4,869,[568 300 222 182  70],655,1,3436,3.949425287356322,0.0,0.0
40870,4,870,[318 655  71 588 151],796,4,3440,3.949483352468427,20.0,0.0
40871,4,871,[318 427  79 588 216],18,5,3445,3.9506880733944953,40.0,0.0
40872,4,872,[183 181 125 143 405],151,3,3448,3.9495990836197024,0.0,0.0
40873,4,873,[318 427  79 588 216],577,5,3453,3.9508009153318078,40.0,0.0
40874,4,874,[288 200  89 655 286],655,2,3455,3.9485714285714284,0.0,20.0
40875,4,875,[187 275 435 210 483],716,4,3459,3.9486301369863015,0.0,20.0
40876,4,876,[ 11 179  22 151  98],535,3,3462,3.9475484606613453,0.0,0.0
40877,4,877,[265 194 197 258 132],629,5,3467,3.94874715261959,0.0,0.0
40878,4,878,[318 427  79 588 216],577,5,3472,3.949943117178612,40.0,0.0
40879,4,879,[318 427  79 588 216],18,5,3477,3.9511363636363637,40.0,0.0
40880,4,880,[318 427  79 588 216],450,5,3482,3.9523269012485813,40.0,0.0
40881,4,881,[ 88 176 435 185  50],269,1,3483,3.9489795918367347,0.0,20.0
40882,4,882,[238 181 568  11 237],457,5,3488,3.9501698754246886,0.0,0.0
40883,4,883,[318 427  79 588 216],450,5,3493,3.9513574660633486,40.0,0.0
40884,4,884,[318 427  79 588 216],796,5,3498,3.952542372881356,40.0,0.0
40885,4,885,[216 546  11 118 151],344,2,3500,3.950338600451467,0.0,0.0
40886,4,886,[742  64 118 168 194],796,4,3504,3.9503945885005636,20.0,0.0
40887,4,887,[318 185  97 117 194],236,3,3507,3.949324324324324,20.0,0.0
40888,4,888,[ 28  25 427 235 191],450,3,3510,3.9482564679415075,20.0,0.0
40889,4,889,[237   7   4 265 282],280,2,3512,3.946067415730337,0.0,0.0
40890,4,890,[588 180 191 568 202],457,5,3517,3.947250280583614,0.0,0.0
40891,4,891,[179 200 211 202  95],18,3,3520,3.9461883408071747,0.0,0.0
40892,4,892,[ 25 127 403 475  56],655,1,3521,3.942889137737962,0.0,20.0
40893,4,893,[318 427  79 588 216],450,5,3526,3.9440715883668904,40.0,0.0
40894,4,894,[269 204 294 153  96],23,3,3529,3.9430167597765364,0.0,0.0
40895,4,895,[275 265 197 215  71],535,4,3533,3.943080357142857,0.0,20.0
40896,4,896,[318 427  79 588 216],716,5,3538,3.9442586399108137,40.0,0.0
40897,4,897,[318 427  79 588 216],18,5,3543,3.94543429844098,40.0,0.0
40898,4,898,[742 125 185  15 265],457,5,3548,3.946607341490545,0.0,0.0
40899,4,899,[235   7 143 100 132],269,2,3550,3.9444444444444446,0.0,20.0
40900,4,900,[210   1  15 180 237],796,2,3552,3.942286348501665,0.0,0.0
40901,4,901,[117 182 153 127 237],655,2,3554,3.940133037694013,0.0,20.0
40902,4,902,[357   7 172 174 603],450,5,3559,3.9413067552602437,20.0,0.0
40903,4,903,[ 56 118 294 132  71],280,3,3562,3.940265486725664,0.0,0.0
40904,4,904,[111 173  98 275 288],450,4,3566,3.940331491712707,0.0,20.0
40905,4,905,[ 79 427 318 588 216],18,5,3571,3.9415011037527594,40.0,0.0
40906,4,906,[282 568 121 237 127],655,1,3572,3.938257993384785,0.0,20.0
40907,4,907,[603 276 215 568  56],655,2,3574,3.936123348017621,20.0,0.0
40908,4,908,[ 79 357 403 173  82],457,5,3579,3.937293729372937,0.0,0.0
40909,4,909,[ 79 427 318 588 216],18,5,3584,3.9384615384615387,40.0,0.0
40910,4,910,[265 144  28   7   8],655,0,3584,3.934138309549945,0.0,0.0
40911,4,911,[ 79 427 318 588 216],577,5,3589,3.9353070175438596,40.0,0.0
40912,4,912,[ 79 427 318 588 216],716,5,3594,3.936473165388828,40.0,0.0
40913,4,913,[195   1 187 483 269],535,3,3597,3.9354485776805253,0.0,0.0
40914,4,914,[ 11 173   4 117 191],344,3,3600,3.9344262295081966,0.0,0.0
40915,4,915,[385  71 111  25 151],401,2,3602,3.932314410480349,0.0,0.0
40916,4,916,[135   7 197 276 194],535,3,3605,3.931297709923664,0.0,0.0
40917,4,917,[ 79 427 318 588 216],796,5,3610,3.9324618736383443,40.0,0.0
40918,4,918,[ 88 127 655  79 185],719,3,3613,3.931447225244831,0.0,20.0
40919,4,919,[ 79 427 318 588 216],796,5,3618,3.9326086956521737,40.0,0.0
40920,4,920,[ 79 427 318 588 216],18,5,3623,3.9337676438653637,40.0,0.0
40921,4,921,[ 79 427 318 588 216],716,5,3628,3.934924078091106,40.0,0.0
40922,4,922,[ 79 427 318 588 216],716,5,3633,3.9360780065005416,40.0,0.0
40923,4,923,[ 79 427 318 588 216],716,5,3638,3.9372294372294374,40.0,0.0
40924,4,924,[ 79 427 318 588 216],18,5,3643,3.9383783783783786,40.0,0.0
40925,4,925,[ 79 427 318 588 216],796,5,3648,3.939524838012959,40.0,0.0
40926,4,926,[ 79 427 318 588 216],577,5,3653,3.9406688241639696,40.0,0.0
40927,4,927,[197   4 176 144 546],457,4,3657,3.9407327586206895,0.0,0.0
40928,4,928,[ 79 427 318 588 216],577,5,3662,3.9418729817007536,40.0,0.0
40929,4,929,[ 79 427 318 588 216],796,5,3667,3.943010752688172,40.0,0.0
40930,4,930,[357   9  11 597 288],593,3,3670,3.941997851772288,0.0,0.0
40931,4,931,[ 98 200  22   8  88],577,3,3673,3.9409871244635193,0.0,0.0
40932,4,932,[ 79 427 318 588 216],796,5,3678,3.942122186495177,40.0,0.0
40933,4,933,[ 79 427 318 588 216],796,5,3683,3.943254817987152,40.0,0.0
40934,4,934,[151 405 216 202   8],344,4,3687,3.9433155080213904,0.0,0.0
40935,4,935,[181  96 196 483   4],457,5,3692,3.9444444444444446,0.0,0.0
40936,4,936,[ 79 427 318 588 216],577,5,3697,3.945570971184632,40.0,0.0
40937,4,937,[210  50 180 132 100],269,2,3699,3.943496801705757,0.0,40.0
40938,4,938,[118  25  82  69 568],450,2,3701,3.9414270500532482,0.0,0.0
40939,4,939,[238 200 288 197 234],450,2,3703,3.9393617021276595,0.0,0.0
40940,4,940,[172 151 168 191 234],577,4,3707,3.9394261424017003,0.0,0.0
40941,4,941,[234 194   7  22 121],457,5,3712,3.940552016985138,0.0,0.0
40942,4,942,[127 385 228 496   1],796,4,3716,3.940615058324496,20.0,20.0
40943,4,943,[427 194 496 181 435],716,5,3721,3.9417372881355934,40.0,0.0
40944,4,944,[176 118 471 228 100],655,0,3721,3.9375661375661375,0.0,20.0
40945,4,945,[ 79 427 318 588 216],796,5,3726,3.938689217758985,40.0,0.0
40946,4,946,[111 173 655 269   1],450,5,3731,3.9398099260823654,0.0,0.0
40947,4,947,[  4 161 151 237  71],450,3,3734,3.938818565400844,0.0,0.0
40948,4,948,[ 79 427 318 588 216],796,5,3739,3.939936775553214,40.0,0.0
40949,4,949,[269 197 132  12 475],503,3,3742,3.9389473684210525,0.0,0.0
40950,4,950,[ 79 427 318 588 216],577,5,3747,3.9400630914826498,40.0,0.0
40951,4,951,[237 143 385 234  88],796,4,3751,3.9401260504201683,0.0,0.0
40952,4,952,[195 168 282 197 237],457,5,3756,3.9412381951731374,0.0,0.0
40953,4,953,[176  88 471  98 496],786,5,3761,3.942348008385744,20.0,0.0
40954,4,954,[ 25 168 294  97 121],450,3,3764,3.9413612565445026,0.0,0.0
40955,4,955,[179 357 153 143 176],450,5,3769,3.942468619246862,0.0,0.0
40956,4,956,[ 79 427 318 588 216],18,5,3774,3.9435736677115987,40.0,0.0
40957,4,957,[286 211 182 125  79],655,2,3776,3.941544885177453,0.0,20.0
40958,4,958,[234 385 118  97 302],151,2,3778,3.9395203336809175,0.0,0.0
40959,4,959,[655  98 186 183 318],450,4,3782,3.939583333333333,20.0,0.0
40960,4,960,[125 195 117 182 100],450,5,3787,3.9406867845993756,0.0,20.0
40961,4,961,[ 89 471 748 742 301],450,5,3792,3.941787941787942,0.0,0.0
40962,4,962,[216 234 269 238 174],23,4,3796,3.941848390446521,0.0,0.0
40963,4,963,[318 427  79 588 216],577,5,3801,3.9429460580912865,40.0,0.0
40964,4,964,[300  15 176 121 210],655,0,3801,3.938860103626943,0.0,0.0
40965,4,965,[  8  56  82 191   9],269,3,3804,3.937888198757764,0.0,0.0
40966,4,966,[ 97 423 151 135 202],457,5,3809,3.938986556359876,0.0,0.0
40967,4,967,[318 302 496 143 121],269,2,3811,3.93698347107438,40.0,0.0
40968,4,968,[427 318  79 588 216],450,5,3816,3.9380804953560373,40.0,0.0
40969,4,969,[427 318  79 588 216],577,5,3821,3.939175257731959,40.0,0.0
40970,4,970,[ 56 742  69  96  88],280,4,3825,3.9392378990731203,0.0,0.0
40971,4,971,[427 318  79 588 216],716,5,3830,3.9403292181069958,40.0,0.0
40972,4,972,[427 318  79 588 216],18,5,3835,3.9414182939362794,40.0,0.0
40973,4,973,[286  15 265  64 228],450,4,3839,3.9414784394250515,20.0,20.0
40974,4,974,[427 318  79 588 216],18,5,3844,3.9425641025641025,40.0,0.0
40975,4,975,[427 318  79 588 216],577,5,3849,3.9436475409836067,40.0,0.0
40976,4,976,[427 318  79 588 216],716,5,3854,3.9447287615148414,40.0,0.0
40977,4,977,[111 235 423 186   9],269,2,3856,3.9427402862985685,0.0,0.0
40978,4,978,[427 318  79 588 216],716,5,3861,3.943820224719101,40.0,0.0
40979,4,979,[180  15 151 153 183],450,4,3865,3.943877551020408,0.0,0.0
40980,4,980,[427 318  79 588 216],450,5,3870,3.944954128440367,40.0,0.0
40981,4,981,[427 318  79 588 216],18,5,3875,3.9460285132382893,40.0,0.0
40982,4,982,[275 276  12 483 161],457,5,3880,3.9471007121057986,0.0,20.0
40983,4,983,[427 318  79 588 216],450,5,3885,3.948170731707317,40.0,0.0
40984,4,984,[258 435  64 100 118],151,3,3888,3.947208121827411,20.0,20.0
40985,4,985,[301   4 597 275  89],796,4,3892,3.947261663286004,0.0,20.0
40986,4,986,[546 222 427 186 173],151,4,3896,3.9473150962512666,20.0,0.0
40987,4,987,[ 79 318 427 588 216],450,5,3901,3.9483805668016196,40.0,0.0
40988,4,988,[ 79 318 427 588 216],450,5,3906,3.949443882709808,40.0,0.0
40989,4,989,[121  71 118 196 216],577,4,3910,3.9494949494949494,0.0,0.0
40990,4,990,[ 79 318 427 588 216],577,5,3915,3.9505549949545915,40.0,0.0
40991,4,991,[282 385   7 216 173],457,5,3920,3.9516129032258065,0.0,0.0
40992,4,992,[ 79 318 427 588 216],796,5,3925,3.9526686807653575,40.0,0.0
40993,4,993,[ 79 318 427 588 216],18,5,3930,3.953722334004024,40.0,0.0
40994,4,994,[202 204 200 435 257],716,5,3935,3.9547738693467336,0.0,0.0
40995,4,995,[100   4 385 258 742],655,0,3935,3.9508032128514055,0.0,20.0
40996,4,996,[357 385 210  15 196],457,5,3940,3.9518555667001003,0.0,0.0
40997,4,997,[427  79 318 588 216],796,5,3945,3.9529058116232463,40.0,0.0
40998,4,998,[427  79 318 588 216],18,5,3950,3.953953953953954,40.0,0.0
40999,4,999,[172  98 100  89   7],786,5,3955,3.955,0.0,20.0
41000,4,1000,[ 79 318 427 588 216],577,5,3960,3.956043956043956,40.0,0.0
41001,4,1001,[ 79 318 427 588 216],796,5,3965,3.9570858283433132,40.0,0.0
41002,4,1002,[ 79 318 427 588 216],577,5,3970,3.9581256231306083,40.0,0.0
41003,4,1003,[ 79 318 427 588 216],450,5,3975,3.9591633466135456,40.0,0.0
41004,4,1004,[ 69  89 179 194 173],457,5,3980,3.9601990049751246,0.0,0.0
41005,4,1005,[234 191 195 427  70],18,3,3983,3.959244532803181,20.0,0.0
41006,4,1006,[ 79 318 427 588 216],450,5,3988,3.9602780536246276,40.0,0.0
41007,4,1007,[322 100 568 435 588],450,5,3993,3.9613095238095237,0.0,20.0
41008,4,1008,[403 655 187 194 174],72,4,3997,3.9613478691774033,0.0,0.0
41009,4,1009,[273 403 313 174 234],796,3,4000,3.9603960396039604,0.0,0.0
41010,4,1010,[ 79 318 427 588 216],796,5,4005,3.9614243323442135,40.0,0.0
41011,4,1011,[  7 215 195 294 186],450,4,4009,3.9614624505928853,0.0,0.0
41012,4,1012,[ 79 318 427 588 216],716,5,4014,3.96248766041461,40.0,0.0
41013,4,1013,[275 282  71  69 588],796,5,4019,3.9635108481262327,0.0,20.0
41014,4,1014,[ 79 318 427 588 216],796,5,4024,3.9645320197044334,40.0,0.0
41015,4,1015,[ 95 423 568  22 313],450,4,4028,3.9645669291338583,0.0,0.0
41016,4,1016,[ 79 318 427 588 216],716,5,4033,3.9655850540806292,40.0,0.0
41017,4,1017,[ 79 318 427 588 216],716,5,4038,3.9666011787819255,40.0,0.0
41018,4,1018,[ 25 588 222  82 603],716,5,4043,3.967615309126595,20.0,0.0
41019,4,1019,[144 185  11 568 211],693,4,4047,3.9676470588235295,0.0,0.0
41020,4,1020,[176 181  50 202 282],280,0,4047,3.9637610186092065,0.0,20.0
41021,4,1021,[ 82 568 301 423 135],389,3,4050,3.9628180039138945,0.0,0.0
41022,4,1022,[182 144 204  98  64],457,5,4055,3.9638318670576735,20.0,0.0
41023,4,1023,[202 603 181  71 423],18,2,4057,3.9619140625,20.0,0.0
41024,4,1024,[237 357 216 181  64],796,5,4062,3.9629268292682926,20.0,0.0
41025,4,1025,[194 100 385 172 168],401,2,4064,3.9610136452241713,0.0,20.0
41026,4,1026,[427 318  79 588 216],577,5,4069,3.962025316455696,40.0,0.0
41027,4,1027,[143 180 603 238  88],269,2,4071,3.96011673151751,20.0,0.0
41028,4,1028,[ 95 117 215 294 588],280,3,4074,3.9591836734693877,0.0,0.0
41029,4,1029,[ 22 216 228 174 405],344,3,4077,3.958252427184466,0.0,0.0
41030,4,1030,[172  25 182 318 143],593,3,4080,3.957322987390883,20.0,0.0
41031,4,1031,[118  28  96 121 237],72,2,4082,3.955426356589147,0.0,0.0
41032,4,1032,[423 276   8  22  69],457,5,4087,3.9564375605033884,0.0,0.0
41033,4,1033,[597  56 435  71  96],450,4,4091,3.9564796905222437,0.0,0.0
41034,4,1034,[258 508 427 318   1],535,4,4095,3.9565217391304346,40.0,0.0
41035,4,1035,[318 427  79 588 216],18,5,4100,3.9575289575289574,40.0,0.0
41036,4,1036,[318 427  79 588 216],796,5,4105,3.9585342333654774,40.0,0.0
41037,4,1037,[405 202 234 125 748],450,4,4109,3.958574181117534,0.0,0.0
41038,4,1038,[161 125  70 403  69],504,3,4112,3.9576515880654477,0.0,0.0
41039,4,1039,[ 97 273 210 194 197],401,4,4116,3.957692307692308,0.0,0.0
41040,4,1040,[191  56  89  12 655],457,5,4121,3.9586935638808836,0.0,0.0
41041,4,1041,[300 471 222  89 204],450,4,4125,3.9587332053742803,0.0,0.0
41042,4,1042,[318 427  79 588 216],796,5,4130,3.959731543624161,40.0,0.0
41043,4,1043,[294 197   4 328 182],450,4,4134,3.9597701149425286,0.0,0.0
41044,4,1044,[  9 515   7 204  79],655,2,4136,3.957894736842105,0.0,0.0
41045,4,1045,[318 427  79 588 216],18,5,4141,3.958891013384321,40.0,0.0
41046,4,1046,[318 427  79 588 216],716,5,4146,3.9598853868194843,40.0,0.0
41047,4,1047,[318 427  79 588 216],577,5,4151,3.96087786259542,40.0,0.0
41048,4,1048,[135 423 174  79 210],693,3,4154,3.9599618684461393,0.0,0.0
41049,4,1049,[235   7 196 151 222],457,4,4158,3.96,0.0,0.0
41050,4,1050,[282 275 271 496 197],796,4,4162,3.9600380589914366,20.0,20.0
41051,4,1051,[161   8  28 135  97],655,1,4163,3.9572243346007605,0.0,0.0
41052,4,1052,[196 294  12 195 211],796,3,4166,3.956315289648623,0.0,0.0
41053,4,1053,[204  25 111 405 100],655,0,4166,3.952561669829222,0.0,20.0
41054,4,1054,[237 427 118 180  22],796,4,4170,3.9526066350710902,20.0,0.0
41055,4,1055,[ 15 121  50 186  82],457,5,4175,3.953598484848485,0.0,20.0
41056,4,1056,[318 427  79 588 216],716,5,4180,3.954588457899716,40.0,0.0
41057,4,1057,[318 427  79 588 216],18,5,4185,3.955576559546314,40.0,0.0
41058,4,1058,[ 22  69 427 194 196],269,2,4187,3.9537299338999055,20.0,0.0
41059,4,1059,[175 204 238  25  98],18,3,4190,3.952830188679245,0.0,0.0
41060,4,1060,[ 71 357  69  15 405],593,4,4194,3.952874646559849,0.0,0.0
41061,4,1061,[318 427  79 588 216],716,5,4199,3.9538606403013183,40.0,0.0
41062,4,1062,[187 127   7 191  69],269,3,4202,3.9529633113828786,0.0,20.0
41063,4,1063,[318 427  79 588 216],450,5,4207,3.9539473684210527,40.0,0.0
41064,4,1064,[  1 269 318 204   4],535,3,4210,3.9530516431924885,20.0,0.0
41065,4,1065,[427 318  79 588 216],18,5,4215,3.9540337711069418,40.0,0.0
41066,4,1066,[273 268 111 655 475],655,1,4216,3.951265229615745,0.0,0.0
41067,4,1067,[427 318  79 588 216],450,5,4221,3.952247191011236,40.0,0.0
41068,4,1068,[125 197 117 181  70],401,2,4223,3.950420954162769,0.0,0.0
41069,4,1069,[ 97 318 427 271 269],796,3,4226,3.9495327102803737,40.0,0.0
41070,4,1070,[318 427  79 588 216],450,5,4231,3.950513538748833,40.0,0.0
41071,4,1071,[151 195 318  50 153],330,4,4235,3.950559701492537,20.0,20.0
41072,4,1072,[318 427  79 588 216],716,5,4240,3.951537744641193,40.0,0.0
41073,4,1073,[300   1 172 496 568],796,4,4244,3.9515828677839853,20.0,0.0
41074,4,1074,[ 12 475 427 357 191],655,3,4247,3.950697674418605,20.0,0.0
41075,4,1075,[144 121 127  64 153],655,2,4249,3.9488847583643123,20.0,20.0
41076,4,1076,[318 427  79 588 216],18,5,4254,3.949860724233983,40.0,0.0
41077,4,1077,[318 427  79 588 216],796,5,4259,3.950834879406308,40.0,0.0
41078,4,1078,[318 427  79 588 216],577,5,4264,3.9518072289156625,40.0,0.0
41079,4,1079,[318 427  79 588 216],18,5,4269,3.952777777777778,40.0,0.0
41080,4,1080,[ 22 405 153 194 191],450,5,4274,3.9537465309898243,0.0,0.0
41081,4,1081,[289  50 258 186 118],807,4,4278,3.9537892791127542,0.0,20.0
41082,4,1082,[318 427  79 588 216],577,5,4283,3.9547553093259467,40.0,0.0
41083,4,1083,[282   4 143 238 405],655,1,4284,3.952029520295203,0.0,0.0
41084,4,1084,[300 216 135 204  82],389,2,4286,3.9502304147465437,0.0,0.0
41085,4,1085,[  4 100  12 403 546],450,4,4290,3.9502762430939224,0.0,20.0
41086,4,1086,[ 82 238 174   8 132],330,5,4295,3.9512419503219873,0.0,0.0
41087,4,1087,[357 257 200  97 197],457,4,4299,3.9512867647058822,0.0,0.0
41088,4,1088,[318 427  79 588 216],18,5,4304,3.9522497704315884,40.0,0.0
41089,4,1089,[318 427  79 588 216],716,5,4309,3.953211009174312,40.0,0.0
41090,4,1090,[300 286  12 258 423],450,5,4314,3.954170485792851,0.0,20.0
41091,4,1091,[318 427  79 588 216],577,5,4319,3.9551282051282053,40.0,0.0
41092,4,1092,[318 427  79 588 216],577,5,4324,3.9560841720036595,40.0,0.0
41093,4,1093,[191 173 423  79 269],450,5,4329,3.957038391224863,0.0,0.0
41094,4,1094,[597 182 125  70 405],450,5,4334,3.9579908675799085,0.0,0.0
41095,4,1095,[ 97 265   9  25  82],151,4,4338,3.958029197080292,0.0,0.0
41096,4,1096,[143 183 258 135  82],151,3,4341,3.9571558796718325,0.0,0.0
41097,4,1097,[318 427  79 588 216],796,5,4346,3.9581056466302367,40.0,0.0
41098,4,1098,[257 228 211 121 603],655,1,4347,3.9554140127388533,20.0,0.0
41099,4,1099,[202 118 294 235 300],450,3,4350,3.9545454545454546,0.0,0.0
41100,4,1100,[435 132  70 135 175],18,4,4354,3.9545867393278837,0.0,0.0
41101,4,1101,[318 427  79 588 216],450,5,4359,3.955535390199637,40.0,0.0
41102,4,1102,[234 257 153 294  22],655,0,4359,3.951949229374433,0.0,0.0
41103,4,1103,[100  22 216 202  97],878,2,4361,3.95018115942029,0.0,20.0
41104,4,1104,[ 79 427 318 588 216],796,5,4366,3.951131221719457,40.0,0.0
41105,4,1105,[ 79 427 318 588 216],450,5,4371,3.9520795660036168,40.0,0.0
41106,4,1106,[ 79 427 318 588 216],716,5,4376,3.953026196928636,40.0,0.0
41107,4,1107,[ 98 301 328 323 143],796,3,4379,3.9521660649819497,0.0,0.0
41108,4,1108,[ 79 427 318 588 216],796,5,4384,3.9531109107303877,40.0,0.0
41109,4,1109,[ 79 427 318 588 216],716,5,4389,3.954054054054054,40.0,0.0
41110,4,1110,[ 79 427 318 588 216],577,5,4394,3.954995499549955,40.0,0.0
41111,4,1111,[435  97 282 117 385],401,2,4396,3.9532374100719423,0.0,0.0
41112,4,1112,[ 79 427 318 588 216],796,5,4401,3.954177897574124,40.0,0.0
41113,4,1113,[237 195 204 215 180],18,1,4402,3.9515260323159787,0.0,0.0
41114,4,1114,[427 318  79 588 216],577,5,4407,3.9524663677130043,40.0,0.0
41115,4,1115,[603 588 301  22 173],450,5,4412,3.953405017921147,20.0,0.0
41116,4,1116,[427 318  79 588 216],716,5,4417,3.954341987466428,40.0,0.0
41117,4,1117,[322 210 125 173 471],280,1,4418,3.9516994633273703,0.0,0.0
41118,4,1118,[121 135  70 655 194],151,5,4423,3.9526362823949954,0.0,0.0
41119,4,1119,[427 318  79 588 216],716,5,4428,3.9535714285714287,40.0,0.0
41120,4,1120,[313 276 258 508 237],463,4,4432,3.953612845673506,0.0,0.0
41121,4,1121,[121 187 588 300 269],796,4,4436,3.9536541889483066,0.0,0.0
41122,4,1122,[ 79 427 318 588 216],577,5,4441,3.954585930543188,40.0,0.0
41123,4,1123,[135 275 234  64 174],450,3,4444,3.9537366548042705,20.0,20.0
41124,4,1124,[195 423 603 111 588],450,5,4449,3.9546666666666668,20.0,0.0
41125,4,1125,[258 183  88 301 202],796,4,4453,3.9547069271758435,0.0,0.0
41126,4,1126,[603  79 508 121  22],655,2,4455,3.952972493345164,20.0,0.0
41127,4,1127,[118 228 237 588 238],796,4,4459,3.953014184397163,0.0,0.0
41128,4,1128,[194 588  25 182 273],450,3,4462,3.9521700620017715,0.0,0.0
41129,4,1129,[357  70  96 235 176],23,1,4463,3.949557522123894,0.0,0.0
41130,4,1130,[237  69 282 183 588],457,5,4468,3.9504862953138815,0.0,0.0
41131,4,1131,[427 318  79 588 216],577,5,4473,3.9514134275618376,40.0,0.0
41132,4,1132,[269 187 194  82 176],450,4,4477,3.9514563106796117,0.0,0.0
41133,4,1133,[ 64 322 258 173 385],450,5,4482,3.9523809523809526,20.0,0.0
41134,4,1134,[302 125 187 202 435],655,2,4484,3.950660792951542,0.0,0.0
41135,4,1135,[180 202 483   4   9],280,3,4487,3.949823943661972,0.0,0.0
41136,4,1136,[318 427  79 588 216],18,5,4492,3.9507475813544417,40.0,0.0
41137,4,1137,[318 427  79 588 216],450,5,4497,3.9516695957820738,40.0,0.0
41138,4,1138,[318 427  79 588 216],716,5,4502,3.9525899912203686,40.0,0.0
41139,4,1139,[234  89 176 322 200],151,2,4504,3.950877192982456,0.0,0.0
41140,4,1140,[185  89 202  69 294],450,5,4509,3.951796669588081,0.0,0.0
41141,4,1141,[318 427  79 588 216],577,5,4514,3.9527145359019262,40.0,0.0
41142,4,1142,[318 427  79 588 216],577,5,4519,3.953630796150481,40.0,0.0
41143,4,1143,[655 276 257  28  25],457,4,4523,3.9536713286713288,0.0,0.0
41144,4,1144,[180 172 197 168 322],796,2,4525,3.9519650655021836,0.0,0.0
41145,4,1145,[ 79 318 427 588 216],796,5,4530,3.9528795811518322,40.0,0.0
41146,4,1146,[ 79 318 427 588 216],18,5,4535,3.9537925021795988,40.0,0.0
41147,4,1147,[172 385 195 435 286],450,5,4540,3.9547038327526134,0.0,20.0
41148,4,1148,[318 427  79 588 216],18,5,4545,3.955613577023499,40.0,0.0
41149,4,1149,[318 427  79 588 216],450,5,4550,3.9565217391304346,40.0,0.0
41150,4,1150,[318 427  79 588 216],796,5,4555,3.95742832319722,40.0,0.0
41151,4,1151,[179  96 471 496 100],450,5,4560,3.9583333333333335,20.0,20.0
41152,4,1152,[269 197 127 100 204],629,4,4564,3.95836947094536,0.0,40.0
41153,4,1153,[318 427  79 588 216],18,5,4569,3.9592720970537263,40.0,0.0
41154,4,1154,[318 427  79 588 216],577,5,4574,3.9601731601731602,40.0,0.0
41155,4,1155,[318 427  79 588 216],18,5,4579,3.9610726643598615,40.0,0.0
41156,4,1156,[318 427  79 588 216],796,5,4584,3.961970613656007,40.0,0.0
41157,4,1157,[210 195 508 100 268],535,4,4588,3.9620034542314335,0.0,20.0
41158,4,1158,[191 195  82 238 322],796,2,4590,3.9603106125970666,0.0,0.0
41159,4,1159,[318 427  79 588 216],18,5,4595,3.961206896551724,40.0,0.0
41160,4,1160,[153  64  25 187   1],655,2,4597,3.959517657192076,20.0,0.0
41161,4,1161,[238 357 258 191  12],457,5,4602,3.9604130808950084,0.0,0.0
41162,4,1162,[ 22 568 427 322 237],450,5,4607,3.9613069647463455,20.0,0.0
41163,4,1163,[427 286 153  70 603],535,4,4611,3.961340206185567,40.0,20.0
41164,4,1164,[427 318  79 588 216],18,5,4616,3.9622317596566523,40.0,0.0
41165,4,1165,[132   4 238 471 215],457,5,4621,3.9631217838765007,0.0,0.0
41166,4,1166,[427 318  79 588 216],577,5,4626,3.9640102827763495,40.0,0.0
41167,4,1167,[ 96 302 475  15 268],269,2,4628,3.962328767123288,0.0,0.0
41168,4,1168,[ 25 678  96  22 195],344,3,4631,3.9615055603079554,0.0,0.0
41169,4,1169,[427 318  79 588 216],577,5,4636,3.9623931623931625,40.0,0.0
41170,4,1170,[175  88 173 238  15],11,2,4638,3.9607173356105894,0.0,0.0
41171,4,1171,[211 204 257  50 182],796,4,4642,3.960750853242321,0.0,20.0
41172,4,1172,[427 318  79 588 216],577,5,4647,3.9616368286445014,40.0,0.0
41173,4,1173,[ 82 111 186  25  15],18,2,4649,3.9599659284497446,0.0,0.0
41174,4,1174,[655 183 211  64   8],655,2,4651,3.9582978723404256,20.0,0.0
41175,4,1175,[427 318  79 588 216],577,5,4656,3.9591836734693877,40.0,0.0
41176,4,1176,[603 222 210 175  50],151,5,4661,3.960067969413764,20.0,20.0
41177,4,1177,[117 222 275 748  89],796,5,4666,3.960950764006791,0.0,20.0
41178,4,1178,[215 121  70 275  82],457,5,4671,3.9618320610687023,0.0,20.0
41179,4,1179,[ 22 471 117 180 597],457,4,4675,3.961864406779661,0.0,0.0
41180,4,1180,[127 100 202  95 588],786,5,4680,3.9627434377646065,0.0,40.0
41181,4,1181,[ 25 117 275  89 186],655,2,4682,3.961082910321489,0.0,20.0
41182,4,1182,[ 79 427 318 588 216],18,5,4687,3.9619611158072696,40.0,0.0
41183,4,1183,[228 403 234 265 172],280,1,4688,3.9594594594594597,0.0,0.0
41184,4,1184,[ 79 427 318 588 216],577,5,4693,3.960337552742616,40.0,0.0
41185,4,1185,[234 603 216 153  50],450,4,4697,3.960370994940978,20.0,20.0
41186,4,1186,[ 82 471 210 179 269],450,3,4700,3.9595619208087616,0.0,0.0
41187,4,1187,[ 79 427 318 588 216],450,5,4705,3.9604377104377106,40.0,0.0
41188,4,1188,[ 79 427 318 588 216],18,5,4710,3.9613120269133724,40.0,0.0
41189,4,1189,[ 79 427 318 588 216],796,5,4715,3.96218487394958,40.0,0.0
41190,4,1190,[ 79 427 318 588 216],796,5,4720,3.963056255247691,40.0,0.0
41191,4,1191,[ 79 427 318 588 216],796,5,4725,3.963926174496644,40.0,0.0
41192,4,1192,[ 79 427 318 588 216],577,5,4730,3.9647946353730092,40.0,0.0
41193,4,1193,[ 69 435 143  15  12],450,4,4734,3.9648241206030153,0.0,0.0
41194,4,1194,[ 56 143 174 202 175],18,4,4738,3.9648535564853558,0.0,0.0
41195,4,1195,[153   8 655 515 357],535,3,4741,3.9640468227424748,0.0,0.0
41196,4,1196,[222 143 655 210 405],786,5,4746,3.9649122807017543,0.0,0.0
41197,4,1197,[195  88 200 153 202],269,1,4747,3.9624373956594323,0.0,0.0
41198,4,1198,[ 88 118 194 117 282],796,5,4752,3.963302752293578,0.0,0.0
41199,4,1199,[195 180 182  12 100],450,5,4757,3.964166666666667,0.0,20.0
41200,4,1200,[ 79 427 318 588 216],18,5,4762,3.965029142381349,40.0,0.0
41201,4,1201,[228 234 546 276 265],786,3,4765,3.964226289517471,0.0,0.0
41202,4,1202,[ 79 427 318 588 216],18,5,4770,3.9650872817955114,40.0,0.0
41203,4,1203,[ 79 427 318 588 216],450,5,4775,3.965946843853821,40.0,0.0
41204,4,1204,[234  98 127 182 132],269,4,4779,3.96597510373444,0.0,20.0
41205,4,1205,[117 496   9 222 176],796,4,4783,3.9660033167495854,20.0,0.0
41206,4,1206,[357  12 180 204 228],796,4,4787,3.9660314830157417,0.0,0.0
41207,4,1207,[ 96 471 235 294  98],457,3,4790,3.9652317880794703,0.0,0.0
41208,4,1208,[ 79 427 318 588 216],18,5,4795,3.966087675765095,40.0,0.0
41209,4,1209,[ 79 427 318 588 216],450,5,4800,3.9669421487603307,40.0,0.0
41210,4,1210,[ 79 427 318 588 216],450,5,4805,3.967795210569777,40.0,0.0
41211,4,1211,[237 151 282 357 161],796,5,4810,3.9686468646864688,0.0,0.0
41212,4,1212,[ 79 427 318 588 216],796,5,4815,3.969497114591921,40.0,0.0
41213,4,1213,[ 79 427 318 588 216],796,5,4820,3.970345963756178,40.0,0.0
41214,4,1214,[258 191 181 228  50],151,4,4824,3.9703703703703703,0.0,20.0
41215,4,1215,[427 318  79 588 216],577,5,4829,3.971217105263158,40.0,0.0
41216,4,1216,[151 174 222 111 211],796,4,4833,3.9712407559572718,0.0,0.0
41217,4,1217,[318 427  79 588 216],450,5,4838,3.9720853858784895,40.0,0.0
41218,4,1218,[318 427  79 588 216],577,5,4843,3.9729286300246103,40.0,0.0
41219,4,1219,[515  22 216 172  25],655,3,4846,3.9721311475409835,0.0,0.0
41220,4,1220,[235  89 258 215  98],23,3,4849,3.9713349713349713,0.0,0.0
41221,4,1221,[  9 117 546 100  98],457,4,4853,3.9713584288052375,0.0,20.0
41222,4,1222,[318 427  79 588 216],450,5,4858,3.972199509403107,40.0,0.0
41223,4,1223,[318 427  79 588 216],716,5,4863,3.9730392156862746,40.0,0.0
41224,4,1224,[318 427  79 588 216],796,5,4868,3.9738775510204083,40.0,0.0
41225,4,1225,[318 427  79 588 216],716,5,4873,3.9747145187601958,40.0,0.0
41226,4,1226,[235 181 286 172 405],280,2,4875,3.9731051344743276,0.0,20.0
41227,4,1227,[  4 323 235  82 181],256,4,4879,3.9731270358306188,0.0,0.0
41228,4,1228,[  4 405 151 385  88],796,5,4884,3.973962571196094,0.0,0.0
41229,4,1229,[180 423  95 265 195],716,3,4887,3.973170731707317,0.0,0.0
41230,4,1230,[222 153 301 294  50],655,1,4888,3.9707554833468723,0.0,20.0
41231,4,1231,[328  82 216  89 151],796,4,4892,3.970779220779221,0.0,0.0
41232,4,1232,[427 318  79 588 216],716,5,4897,3.9716139497161396,40.0,0.0
41233,4,1233,[194  12 588 238 742],457,5,4902,3.972447325769854,0.0,0.0
41234,4,1234,[ 82  12 403 238 118],457,5,4907,3.9732793522267205,0.0,0.0
41235,4,1235,[385 174 423 117 322],450,5,4912,3.9741100323624594,0.0,0.0
41236,4,1236,[ 79 427 318 588 216],577,5,4917,3.974939369442199,40.0,0.0
41237,4,1237,[ 89 187 405 289   1],786,5,4922,3.975767366720517,0.0,0.0
41238,4,1238,[237 282  11  64 174],655,1,4923,3.973365617433414,20.0,0.0
41239,4,1239,[ 50 286 234 313 265],796,3,4926,3.9725806451612904,0.0,40.0
41240,4,1240,[ 79 318 427 588 216],577,5,4931,3.973408541498791,40.0,0.0
41241,4,1241,[597  25  12 180 173],11,1,4932,3.971014492753623,0.0,0.0
41242,4,1242,[ 88 215 235 603 143],716,4,4936,3.9710378117457763,20.0,0.0
41243,4,1243,[427 318  79 588 216],716,5,4941,3.9718649517684885,40.0,0.0
41244,4,1244,[403 118  95 111 323],796,4,4945,3.9718875502008033,0.0,0.0
41245,4,1245,[215 174   1   9 655],72,5,4950,3.972712680577849,0.0,0.0
41246,4,1246,[328 237 179 748 143],450,5,4955,3.9735364875701684,0.0,0.0
41247,4,1247,[143 196   8 282  64],457,5,4960,3.9743589743589745,20.0,0.0
41248,4,1248,[151 210 435 215 180],18,3,4963,3.9735788630904723,0.0,0.0
41249,4,1249,[ 11 568 222 228 195],693,3,4966,3.9728,0.0,0.0
41250,4,1250,[161 234 357 200 222],716,4,4970,3.972821742605915,0.0,0.0
41251,4,1251,[275 234  28 202 210],655,1,4971,3.970447284345048,0.0,20.0
41252,4,1252,[483 191  28 173  50],389,4,4975,3.970470869912211,0.0,20.0
41253,4,1253,[286  95  98 385 216],450,4,4979,3.970494417862839,0.0,20.0
41254,4,1254,[168 328 100 222  28],796,3,4982,3.9697211155378485,0.0,20.0
41255,4,1255,[194 204 172 748  95],796,5,4987,3.9705414012738856,0.0,0.0
41256,4,1256,[427 318  79 588 216],796,5,4992,3.971360381861575,40.0,0.0
41257,4,1257,[427 318  79 588 216],716,5,4997,3.9721780604133547,40.0,0.0
41258,4,1258,[191 423 216 111  98],151,4,5001,3.9722001588562352,0.0,0.0
41259,4,1259,[ 82 228 211 748 161],807,5,5006,3.973015873015873,0.0,0.0
41260,4,1260,[318 427  79 588 216],450,5,5011,3.9738302934179224,40.0,0.0
41261,4,1261,[100  12 748 483 282],280,2,5013,3.972266244057052,0.0,20.0
41262,4,1262,[168 655  50 175  98],878,3,5016,3.9714964370546317,0.0,20.0
41263,4,1263,[143  88 588 655 275],457,5,5021,3.9723101265822787,0.0,20.0
41264,4,1264,[318 427  79 588 216],716,5,5026,3.973122529644269,40.0,0.0
41265,4,1265,[318 427  79 588 216],716,5,5031,3.9739336492890995,40.0,0.0
41266,4,1266,[357 161  70 196 151],401,3,5034,3.973164956590371,0.0,0.0
41267,4,1267,[ 11   7  89  69 245],344,2,5036,3.971608832807571,0.0,0.0
41268,4,1268,[ 97 222 568 132 234],655,0,5036,3.9684791174152876,0.0,0.0
41269,4,1269,[427 318  79 588 216],796,5,5041,3.969291338582677,40.0,0.0
41270,4,1270,[ 98 174 496 273 597],796,4,5045,3.969315499606609,20.0,0.0
41271,4,1271,[  8 173  22 322  71],344,2,5047,3.967767295597484,0.0,0.0
41272,4,1272,[ 79 427 318 588 216],796,5,5052,3.9685781618224665,40.0,0.0
41273,4,1273,[180 179 403  22 135],450,4,5056,3.9686028257456827,0.0,0.0
41274,4,1274,[ 79 427 318 588 216],577,5,5061,3.969411764705882,40.0,0.0
41275,4,1275,[ 79 427 318 588 216],716,5,5066,3.970219435736677,40.0,0.0
41276,4,1276,[ 79 427 318 588 216],577,5,5071,3.971025841816758,40.0,0.0
41277,4,1277,[427 179  25 234  15],450,2,5073,3.9694835680751175,20.0,0.0
41278,4,1278,[ 97  25 168   9 187],504,4,5077,3.9695074276778732,0.0,0.0
41279,4,1279,[ 79 427 318 588 216],450,5,5082,3.9703125,40.0,0.0
41280,4,1280,[ 79 427 318 588 216],450,5,5087,3.9711163153786107,40.0,0.0
41281,4,1281,[ 79 427 318 588 216],716,5,5092,3.9719188767550704,40.0,0.0
41282,4,1282,[ 28 161 215  88 181],716,4,5096,3.971940763834762,0.0,0.0
41283,4,1283,[ 79 427 318 588 216],716,5,5101,3.972741433021807,40.0,0.0
41284,4,1284,[172 153 195 191 427],23,4,5105,3.972762645914397,20.0,0.0
41285,4,1285,[216  56 194 211 195],236,2,5107,3.9712286158631414,0.0,0.0
41286,4,1286,[ 56 121  15 597 742],11,2,5109,3.9696969696969697,0.0,0.0
41287,4,1287,[427 318  79 588 216],18,5,5114,3.970496894409938,40.0,0.0
41288,4,1288,[427 318  79 588 216],450,5,5119,3.9712955779674166,40.0,0.0
41289,4,1289,[121 143  95 228 144],716,4,5123,3.9713178294573646,0.0,0.0
41290,4,1290,[427 318  79 588 216],796,5,5128,3.9721146398140976,40.0,0.0
41291,4,1291,[427 318  79 588 216],716,5,5133,3.972910216718266,40.0,0.0
41292,4,1292,[427 318  79 588 216],716,5,5138,3.9737045630317094,40.0,0.0
41293,4,1293,[423  69 125 111  12],796,5,5143,3.974497681607419,0.0,0.0
41294,4,1294,[427 318  79 588 216],18,5,5148,3.975289575289575,40.0,0.0
41295,4,1295,[  4 204 135 125  88],655,1,5149,3.9729938271604937,0.0,0.0
41296,4,1296,[357  22 174 135 194],450,4,5153,3.9730146491904397,0.0,0.0
41297,4,1297,[318 234 276 179 183],457,5,5158,3.973805855161787,20.0,0.0
41298,4,1298,[143 742 179  15 238],457,5,5163,3.97459584295612,0.0,0.0
41299,4,1299,[ 95 179  79 435 237],450,4,5167,3.9746153846153844,0.0,0.0
41300,4,1300,[427 318  79 588 216],450,5,5172,3.975403535741737,40.0,0.0
41301,4,1301,[427 318  79 588 216],577,5,5177,3.9761904761904763,40.0,0.0
41302,4,1302,[237 276  82   1 288],256,4,5181,3.9762087490406754,0.0,0.0
41303,4,1303,[405 357  98 271   1],72,3,5184,3.9754601226993866,0.0,0.0
41304,4,1304,[427 318  79 588 216],796,5,5189,3.9762452107279693,40.0,0.0
41305,4,1305,[  8  70 194  15 655],878,2,5191,3.974732006125574,0.0,0.0
41306,4,1306,[427 318  79 588 216],796,5,5196,3.9755164498852333,40.0,0.0
41307,4,1307,[427 318  79 588 216],716,5,5201,3.9762996941896023,40.0,0.0
41308,4,1308,[301  70  69 181 125],655,0,5201,3.9732620320855614,0.0,0.0
41309,4,1309,[427 318  79 588 216],716,5,5206,3.9740458015267177,40.0,0.0
41310,4,1310,[405  97 427  98  82],450,4,5210,3.9740655987795575,20.0,0.0
41311,4,1311,[427 318  79 588 216],796,5,5215,3.9748475609756095,40.0,0.0
41312,4,1312,[427 318  79 588 216],796,5,5220,3.975628332063976,40.0,0.0
41313,4,1313,[322 117  22 173 176],280,3,5223,3.9748858447488584,0.0,0.0
41314,4,1314,[427 318  79 588 216],450,5,5228,3.975665399239544,40.0,0.0
41315,4,1315,[427 318  79 588 216],716,5,5233,3.9764437689969605,40.0,0.0
41316,4,1316,[427 318  79 588 216],716,5,5238,3.9772209567198176,40.0,0.0
41317,4,1317,[588  98  70 200 210],450,3,5241,3.9764795144157814,0.0,0.0
41318,4,1318,[427 318  79 588 216],796,5,5246,3.9772554965883247,40.0,0.0
41319,4,1319,[ 11   1  56 385 143],577,2,5248,3.9757575757575756,0.0,0.0
41320,4,1320,[427 318  79 588 216],18,5,5253,3.976532929598789,40.0,0.0
41321,4,1321,[427 318  79 588 216],18,5,5258,3.977307110438729,40.0,0.0
41322,4,1322,[427 318  79 588 216],577,5,5263,3.9780801209372636,40.0,0.0
41323,4,1323,[427 318  79 588 216],716,5,5268,3.9788519637462234,40.0,0.0
41324,4,1324,[ 69 678  22 235  50],280,3,5271,3.9781132075471697,0.0,20.0
41325,4,1325,[496 237 117 289 196],236,2,5273,3.9766214177978885,20.0,0.0
41326,4,1326,[ 56 202  12  69 237],457,5,5278,3.9773926149208743,0.0,0.0
41327,4,1327,[222 313  89 125 196],344,3,5281,3.976656626506024,0.0,0.0
41328,4,1328,[405 100 143 276 257],457,4,5285,3.976674191121144,0.0,20.0
41329,4,1329,[427 318  79 588 216],577,5,5290,3.9774436090225564,40.0,0.0
41330,4,1330,[204 176  50 385 322],344,3,5293,3.9767092411720513,0.0,20.0
41331,4,1331,[427 318  79 588 216],18,5,5298,3.9774774774774775,40.0,0.0
41332,4,1332,[135  82 742 117 403],457,5,5303,3.978244561140285,0.0,0.0
41333,4,1333,[427 318  79 588 216],577,5,5308,3.9790104947526235,40.0,0.0
41334,4,1334,[427 318  79 588 216],450,5,5313,3.979775280898876,40.0,0.0
41335,4,1335,[435 187  98 483 302],389,5,5318,3.980538922155689,0.0,0.0
41336,4,1336,[ 15 245 318 496  25],450,3,5321,3.9798055347793566,40.0,0.0
41337,4,1337,[333 435 185  64 179],236,3,5324,3.9790732436472345,20.0,0.0
41338,4,1338,[403 313 100 204 172],450,5,5329,3.9798356982823004,0.0,20.0
41339,4,1339,[427 318  79 588 216],796,5,5334,3.9805970149253733,40.0,0.0
41340,4,1340,[427 318  79 588 216],796,5,5339,3.9813571961222967,40.0,0.0
41341,4,1341,[ 82 258 655 181 117],457,5,5344,3.9821162444113263,0.0,0.0
41342,4,1342,[427 318  79 588 216],577,5,5349,3.982874162323157,40.0,0.0
41343,4,1343,[ 95 161 143 183 322],450,4,5353,3.9828869047619047,0.0,0.0
41344,4,1344,[302  70 202  96 268],655,1,5354,3.9806691449814124,0.0,0.0
41345,4,1345,[191 271 222  88  71],796,5,5359,3.9814264487369986,0.0,0.0
41346,4,1346,[ 79 427 318 588 216],716,5,5364,3.9821826280623607,40.0,0.0
41347,4,1347,[ 25  56  69 423 211],716,5,5369,3.9829376854599405,0.0,0.0
41348,4,1348,[181 210  82 273 265],796,2,5371,3.9814677538917715,0.0,0.0
41349,4,1349,[ 79 427 318 588 216],577,5,5376,3.982222222222222,40.0,0.0
41350,4,1350,[211  11 153 603  56],535,4,5380,3.9822353811991116,20.0,0.0
41351,4,1351,[471 328 475 181 117],655,0,5380,3.9792899408284024,0.0,0.0
41352,4,1352,[ 79 427 318 588 216],796,5,5385,3.9800443458980044,40.0,0.0
41353,4,1353,[179 121 655 196   4],535,4,5389,3.980059084194978,0.0,0.0
41354,4,1354,[216 175 191 234 603],23,3,5392,3.9793357933579334,20.0,0.0
41355,4,1355,[ 79 427 318 588 216],18,5,5397,3.980088495575221,40.0,0.0
41356,4,1356,[ 79 427 318 588 216],796,5,5402,3.980840088430361,40.0,0.0
41357,4,1357,[ 79 427 318 588 216],450,5,5407,3.9815905743740796,40.0,0.0
41358,4,1358,[ 79 427 318 588 216],577,5,5412,3.9823399558498895,40.0,0.0
41359,4,1359,[ 69 172 143 117 678],401,1,5413,3.9801470588235293,0.0,0.0
41360,4,1360,[  1  70 195 403 385],450,5,5418,3.9808963997060984,0.0,0.0
41361,4,1361,[ 28 194  50  25  69],504,3,5421,3.9801762114537445,0.0,20.0
41362,4,1362,[ 79 427 318 588 216],577,5,5426,3.980924431401321,40.0,0.0
41363,4,1363,[194 174 179 125 204],450,5,5431,3.981671554252199,0.0,0.0
41364,4,1364,[238  28 176 265 471],786,5,5436,3.9824175824175825,0.0,0.0
41365,4,1365,[ 64 100  98 121 483],450,3,5439,3.9816983894582725,20.0,20.0
41366,4,1366,[427 318  79 588 216],450,5,5444,3.982443306510607,40.0,0.0
41367,4,1367,[288 234   1 194  79],292,4,5448,3.982456140350877,0.0,0.0
41368,4,1368,[427 318  79 588 216],18,5,5453,3.983199415631848,40.0,0.0
41369,4,1369,[202 435  97  25 508],655,0,5453,3.9802919708029196,0.0,0.0
41370,4,1370,[318  96 100 588 153],280,4,5457,3.9803063457330414,20.0,20.0
41371,4,1371,[202 302 127 179  56],389,5,5462,3.9810495626822155,0.0,20.0
41372,4,1372,[288   4 182 180 183],450,3,5465,3.980335032774945,0.0,0.0
41373,4,1373,[183   7 568 196  56],577,2,5467,3.9788937409024747,0.0,0.0
41374,4,1374,[ 79 318 427 588 216],18,5,5472,3.9796363636363634,40.0,0.0
41375,4,1375,[265 588 183 197 222],280,2,5474,3.9781976744186047,0.0,0.0
41376,4,1376,[ 69  89 132 127 179],655,3,5477,3.9774872912127814,0.0,20.0
41377,4,1377,[ 79 318 427 588 216],450,5,5482,3.978229317851959,40.0,0.0
41378,4,1378,[ 96 204 655 183 194],504,2,5484,3.976794778825236,0.0,0.0
41379,4,1379,[427  79 318 588 216],796,5,5489,3.977536231884058,40.0,0.0
41380,4,1380,[427  79 318 588 216],796,5,5494,3.9782766111513395,40.0,0.0
41381,4,1381,[210 186 748  95 496],807,5,5499,3.979015918958032,20.0,0.0
41382,4,1382,[215 182 238 742 228],655,1,5500,3.9768618944323935,0.0,0.0
41383,4,1383,[185 269   8 655  82],655,1,5501,3.9747109826589595,0.0,0.0
41384,4,1384,[427  79 318 588 216],796,5,5506,3.9754512635379062,40.0,0.0
41385,4,1385,[  4 238 202 180 357],796,3,5509,3.974747474747475,0.0,0.0
41386,4,1386,[427  79 318 588 216],577,5,5514,3.97548666186013,40.0,0.0
41387,4,1387,[427  79 318 588 216],18,5,5519,3.9762247838616713,40.0,0.0
41388,4,1388,[427  79 318 588 216],577,5,5524,3.976961843052556,40.0,0.0
41389,4,1389,[427  79 318 588 216],450,5,5529,3.9776978417266187,40.0,0.0
41390,4,1390,[427  79 318 588 216],450,5,5534,3.9784327821711,40.0,0.0
41391,4,1391,[179 216 118   7 546],450,4,5538,3.978448275862069,0.0,0.0
41392,4,1392,[427  79 318 588 216],577,5,5543,3.979181622397703,40.0,0.0
41393,4,1393,[ 98 568 357 269 222],344,5,5548,3.9799139167862267,0.0,0.0
41394,4,1394,[655 185   8 111  50],457,4,5552,3.9799283154121863,0.0,20.0
41395,4,1395,[127  25 174 185 427],835,5,5557,3.9806590257879657,20.0,20.0
41396,4,1396,[ 50 318 515 127 172],401,2,5559,3.979241231209735,20.0,40.0
41397,4,1397,[427  79 318 588 216],577,5,5564,3.9799713876967098,40.0,0.0
41398,4,1398,[197 127 238 211 276],786,3,5567,3.9792709077912796,0.0,20.0
41399,4,1399,[427  79 318 588 216],577,5,5572,3.98,40.0,0.0
41400,4,1400,[ 96 210 496  89 121],796,4,5576,3.9800142755174877,20.0,0.0
41401,4,1401,[427  79 318 588 216],18,5,5581,3.9807417974322394,40.0,0.0
41402,4,1402,[427  79 318 588 216],450,5,5586,3.9814682822523166,40.0,0.0
41403,4,1403,[245 222 748 435 117],450,4,5590,3.9814814814814814,0.0,0.0
41404,4,1404,[427 318  79 588 216],577,5,5595,3.98220640569395,40.0,0.0
41405,4,1405,[427 318  79 588 216],716,5,5600,3.9829302987197726,40.0,0.0
41406,4,1406,[427 318  79 588 216],716,5,5605,3.9836531627576406,40.0,0.0
41407,4,1407,[405 333 196 186 271],796,4,5609,3.983664772727273,0.0,0.0
41408,4,1408,[228 588 603 405 185],450,5,5614,3.9843860894251244,20.0,0.0
41409,4,1409,[118  22  69   8 265],280,4,5618,3.9843971631205672,0.0,0.0
41410,4,1410,[186 111 180 144 174],716,2,5620,3.9829907866761163,0.0,0.0
41411,4,1411,[181 127 245 216 568],344,3,5623,3.9822946175637393,0.0,20.0
41412,4,1412,[318 427  79 588 216],450,5,5628,3.9830148619957537,40.0,0.0
41413,4,1413,[318 427  79 588 216],450,5,5633,3.983734087694484,40.0,0.0
41414,4,1414,[186 215 385  98 118],655,1,5634,3.981625441696113,0.0,0.0
41415,4,1415,[194 748 196 276 435],401,4,5638,3.981638418079096,0.0,0.0
41416,4,1416,[318 427  79 588 216],450,5,5643,3.9823570924488356,40.0,0.0
41417,4,1417,[318 427  79 588 216],716,5,5648,3.983074753173484,40.0,0.0
41418,4,1418,[318 427  79 588 216],716,5,5653,3.9837914023960534,40.0,0.0
41419,4,1419,[  7 427 121  28 269],450,4,5657,3.9838028169014086,20.0,0.0
41420,4,1420,[318 427  79 588 216],577,5,5662,3.984517945109078,40.0,0.0
41421,4,1421,[318 427  79 588 216],18,5,5667,3.9852320675105486,40.0,0.0
41422,4,1422,[318 427  79 588 216],450,5,5672,3.9859451862262825,40.0,0.0
41423,4,1423,[318 427  79 588 216],716,5,5677,3.9866573033707864,40.0,0.0
41424,4,1424,[ 71 403 176  98 471],450,4,5681,3.986666666666667,0.0,0.0
41425,4,1425,[237 588 100 151  95],330,5,5686,3.9873772791023843,0.0,20.0
41426,4,1426,[195 202 175 471   7],457,5,5691,3.988086895585144,0.0,0.0
41427,4,1427,[427  79 318 588 216],796,5,5696,3.988795518207283,40.0,0.0
41428,4,1428,[423 172 496 168 118],389,4,5700,3.9888033589923024,20.0,0.0
41429,4,1429,[597 216 742 357  25],593,3,5703,3.988111888111888,0.0,0.0
41430,4,1430,[427  79 318 588 216],796,5,5708,3.9888190076869323,40.0,0.0
41431,4,1431,[427  79 318 588 216],716,5,5713,3.9895251396648046,40.0,0.0
41432,4,1432,[427  79 318 588 216],796,5,5718,3.9902302861130496,40.0,0.0
41433,4,1433,[427  79 318 588 216],796,5,5723,3.990934449093445,40.0,0.0
41434,4,1434,[427  79 318 588 216],796,5,5728,3.9916376306620207,40.0,0.0
41435,4,1435,[427  79 318 588 216],796,5,5733,3.9923398328690807,40.0,0.0
41436,4,1436,[269 111 286 435 265],450,5,5738,3.993041057759221,0.0,20.0
41437,4,1437,[427  79 318 588 216],716,5,5743,3.9937413073713492,40.0,0.0
41438,4,1438,[333 121  89 515 197],655,2,5745,3.9923558026407227,0.0,0.0
41439,4,1439,[237 300 194 153 180],535,4,5749,3.9923611111111112,0.0,0.0
41440,4,1440,[176 191 121 194 143],716,4,5753,3.9923664122137406,0.0,0.0
41441,4,1441,[ 79 427 318 588 216],577,5,5758,3.9930651872399445,40.0,0.0
41442,4,1442,[496 211 276   8  98],535,3,5761,3.9923769923769923,20.0,0.0
41443,4,1443,[ 79 427 318 588 216],450,5,5766,3.9930747922437675,40.0,0.0
41444,4,1444,[186  56   1 313 515],296,4,5770,3.9930795847750864,0.0,0.0
41445,4,1445,[180 210 423 328 271],796,3,5773,3.992392807745505,0.0,0.0
41446,4,1446,[427 210 187 211 245],796,2,5775,3.9910158949550794,20.0,0.0
41447,4,1447,[  8 313 300 191 282],655,2,5777,3.9896408839779007,0.0,0.0
41448,4,1448,[  8 268   9 276 179],535,3,5780,3.9889579020013803,0.0,0.0
41449,4,1449,[ 79 427 318 588 216],716,5,5785,3.989655172413793,40.0,0.0
41450,4,1450,[180 186   7  88 176],786,5,5790,3.990351481736733,0.0,0.0
41451,4,1451,[423 588 127 655 273],796,3,5793,3.989669421487603,0.0,20.0
41452,4,1452,[ 79 427 318 588 216],577,5,5798,3.9903647625602203,40.0,0.0
41453,4,1453,[ 79 427 318 588 216],18,5,5803,3.9910591471801924,40.0,0.0
41454,4,1454,[ 79 427 318 588 216],450,5,5808,3.9917525773195877,40.0,0.0
41455,4,1455,[ 79 427 318 588 216],450,5,5813,3.9924450549450547,40.0,0.0
41456,4,1456,[180 210 228 271  25],72,3,5816,3.991763898421414,0.0,0.0
41457,4,1457,[ 79 427 318 588 216],577,5,5821,3.9924554183813443,40.0,0.0
41458,4,1458,[ 25  97 196 121   1],344,2,5823,3.9910897875257025,0.0,0.0
41459,4,1459,[ 28 194  15  98  71],577,4,5827,3.991095890410959,0.0,0.0
41460,4,1460,[245 161 471 237 210],593,2,5829,3.9897330595482545,0.0,0.0
41461,4,1461,[427 318  79 588 216],450,5,5834,3.990424076607387,40.0,0.0
41462,4,1462,[655 153  22 228 546],280,3,5837,3.989747095010253,0.0,0.0
41463,4,1463,[ 97 186   4  12  88],18,3,5840,3.989071038251366,0.0,0.0
41464,4,1464,[ 79 427 318 588 216],796,5,5845,3.9897610921501707,40.0,0.0
41465,4,1465,[ 79 427 318 588 216],450,5,5850,3.990450204638472,40.0,0.0
41466,4,1466,[ 79 427 318 588 216],796,5,5855,3.991138377641445,40.0,0.0
41467,4,1467,[655  25 265 181 210],457,5,5860,3.991825613079019,0.0,0.0
41468,4,1468,[ 79 427 318 588 216],18,5,5865,3.9925119128658952,40.0,0.0
41469,4,1469,[269 301 258 172  95],796,3,5868,3.9918367346938775,0.0,0.0
41470,4,1470,[597 176  28 357 318],450,5,5873,3.992522093813732,20.0,0.0
41471,4,1471,[ 79 427 318 588 216],18,5,5878,3.9932065217391304,40.0,0.0
41472,4,1472,[ 97 328 655 257 185],401,3,5881,3.992532247114732,0.0,0.0
41473,4,1473,[ 79 427 318 588 216],716,5,5886,3.993215739484396,40.0,0.0
41474,4,1474,[ 79 427 318 588 216],577,5,5891,3.9938983050847456,40.0,0.0
41475,4,1475,[ 79 427 318 588 216],450,5,5896,3.994579945799458,40.0,0.0
41476,4,1476,[ 11 273 153 435 187],629,3,5899,3.993906567366283,0.0,0.0
41477,4,1477,[ 79 427 318 588 216],18,5,5904,3.9945872801082545,40.0,0.0
41478,4,1478,[ 79 427 318 588 216],796,5,5909,3.99526707234618,40.0,0.0
41479,4,1479,[ 79 427 318 588 216],577,5,5914,3.995945945945946,40.0,0.0
41480,4,1480,[ 64 237 216  22 202],655,2,5916,3.9945982444294397,20.0,0.0
41481,4,1481,[ 79 427 318 588 216],716,5,5921,3.99527665317139,40.0,0.0
41482,4,1482,[603 187  88 121 210],450,3,5924,3.9946055293324343,20.0,0.0
41483,4,1483,[ 79 427 318 588 216],716,5,5929,3.9952830188679247,40.0,0.0
41484,4,1484,[191 603 302 286 435],704,4,5933,3.9952861952861953,20.0,20.0
41485,4,1485,[ 79 427 318 588 216],796,5,5938,3.9959623149394345,40.0,0.0
41486,4,1486,[405  79 181 385 143],23,4,5942,3.995965030262273,0.0,0.0
41487,4,1487,[ 79 427 318 588 216],18,5,5947,3.9966397849462365,40.0,0.0
41488,4,1488,[ 79 427 318 588 216],796,5,5952,3.997313633310947,40.0,0.0
41489,4,1489,[ 79 427 318 588 216],796,5,5957,3.997986577181208,40.0,0.0
41490,4,1490,[ 79 427 318 588 216],577,5,5962,3.998658618376928,40.0,0.0
41491,4,1491,[ 11 179 181 385 172],655,2,5964,3.997319034852547,0.0,0.0
41492,4,1492,[210 181 258 100 215],457,5,5969,3.9979906229068987,0.0,20.0
41493,4,1493,[403 313 282 197  96],280,1,5970,3.995983935742972,0.0,0.0
41494,4,1494,[257 276  96 234 151],457,4,5974,3.9959866220735787,0.0,0.0
41495,4,1495,[ 79 427 318 588 216],18,5,5979,3.996657754010695,40.0,0.0
41496,4,1496,[ 12 127 121 546 185],796,5,5984,3.997327989311957,0.0,20.0
41497,4,1497,[ 98 132  56 127 216],504,4,5988,3.9973297730307076,0.0,20.0
41498,4,1498,[238   1 181  64 333],796,3,5991,3.9966644429619747,20.0,0.0
41499,4,1499,[ 79 427 318 588 216],18,5,5996,3.997333333333333,40.0,0.0
41500,4,1500,[ 79 427 318 588 216],716,5,6001,3.9980013324450367,40.0,0.0
41501,4,1501,[174 125 235 100  95],280,2,6003,3.996671105193076,0.0,20.0
41502,4,1502,[  9 117 405  12  70],655,0,6003,3.9940119760479043,0.0,0.0
41503,4,1503,[322  25 423 403 235],450,3,6006,3.9933510638297873,0.0,0.0
41504,4,1504,[435 328 143 515  88],401,5,6011,3.994019933554817,0.0,0.0
41505,4,1505,[ 96 268 269 313 183],344,3,6014,3.9933598937583,0.0,0.0
41506,4,1506,[286 135  97 151 174],151,5,6019,3.994027869940279,0.0,20.0
41507,4,1507,[ 79 427 318 588 216],18,5,6024,3.9946949602122017,40.0,0.0
41508,4,1508,[ 79 427 318 588 216],450,5,6029,3.9953611663353215,40.0,0.0
41509,4,1509,[176 471   7 302  70],450,5,6034,3.996026490066225,0.0,0.0
41510,4,1510,[ 70  79  11 405 508],344,2,6036,3.99470549305096,0.0,0.0
41511,4,1511,[258  89 196 180 322],796,3,6039,3.994047619047619,0.0,0.0
41512,4,1512,[318  79 427 588 216],716,5,6044,3.994712491738268,40.0,0.0
41513,4,1513,[ 64  50 403 427  98],577,5,6049,3.9953764861294583,40.0,20.0
41514,4,1514,[318  79 427 588 216],577,5,6054,3.996039603960396,40.0,0.0
41515,4,1515,[318  79 427 588 216],796,5,6059,3.996701846965699,40.0,0.0
41516,4,1516,[ 69  15 423   4 194],450,3,6062,3.9960448253131178,0.0,0.0
41517,4,1517,[318  79 427 588 216],796,5,6067,3.996706192358366,40.0,0.0
41518,4,1518,[318  79 427 588 216],796,5,6072,3.9973666886109283,40.0,0.0
41519,4,1519,[318  79 427 588 216],796,5,6077,3.9980263157894735,40.0,0.0
41520,4,1520,[318  79 427 588 216],18,5,6082,3.9986850756081527,40.0,0.0
41521,4,1521,[  1 125  15 143   9],457,5,6087,3.9993429697766096,0.0,0.0
41522,4,1522,[318  79 427 588 216],796,5,6092,4.0,40.0,0.0
41523,4,1523,[318  79 427 588 216],716,5,6097,4.0006561679790025,40.0,0.0
41524,4,1524,[ 98 286 568 182 294],450,5,6102,4.001311475409836,0.0,20.0
41525,4,1525,[318  79 427 588 216],18,5,6107,4.001965923984272,40.0,0.0
41526,4,1526,[318  79 427 588 216],450,5,6112,4.002619515389653,40.0,0.0
41527,4,1527,[318  79 427 588 216],796,5,6117,4.003272251308901,40.0,0.0
41528,4,1528,[318  79 427 588 216],716,5,6122,4.003924133420536,40.0,0.0
41529,4,1529,[318  79 427 588 216],577,5,6127,4.004575163398693,40.0,0.0
41530,4,1530,[100 191  98 435 423],236,4,6131,4.004572175048987,0.0,20.0
41531,4,1531,[318  79 427 588 216],577,5,6136,4.005221932114883,40.0,0.0
41532,4,1532,[323  64 546  15 127],796,4,6140,4.005218525766471,20.0,20.0
41533,4,1533,[483 496 200 568 185],796,5,6145,4.00586701434159,20.0,0.0
41534,4,1534,[568  64 143 228 185],450,5,6150,4.006514657980456,20.0,0.0
41535,4,1535,[318  79 427 588 216],577,5,6155,4.007161458333333,40.0,0.0
41536,4,1536,[117   8 471 268 195],344,2,6157,4.005855562784645,0.0,0.0
41537,4,1537,[318  79 427 588 216],577,5,6162,4.006501950585175,40.0,0.0
41538,4,1538,[ 15 196  96 135 183],269,1,6163,4.00454840805718,0.0,0.0
41539,4,1539,[318  79 427 588 216],716,5,6168,4.005194805194805,40.0,0.0
41540,4,1540,[  9  50 117 286 237],277,4,6172,4.005191434133679,0.0,40.0
41541,4,1541,[318  79 427 588 216],796,5,6177,4.005836575875486,40.0,0.0
41542,4,1542,[172 546  50  56 323],256,3,6180,4.0051847051198965,0.0,20.0
41543,4,1543,[ 64 302  95 143 132],389,3,6183,4.004533678756476,20.0,0.0
41544,4,1544,[ 50 302  97 204  71],344,3,6186,4.003883495145631,0.0,20.0
41545,4,1545,[ 28 258 143  89 275],23,3,6189,4.003234152652005,0.0,20.0
41546,4,1546,[ 79 427 318 588 216],18,5,6194,4.00387847446671,40.0,0.0
41547,4,1547,[313 174 678  96 117],280,2,6196,4.002583979328166,0.0,0.0
41548,4,1548,[294 100   8  82 196],577,5,6201,4.00322788896062,0.0,20.0
41549,4,1549,[182 245  69 405 117],280,2,6203,4.001935483870968,0.0,0.0
41550,4,1550,[294  64 100  97 234],256,4,6207,4.0019342359767895,20.0,20.0
41551,4,1551,[195 186 257 211 423],504,4,6211,4.001932989690721,0.0,0.0
41552,4,1552,[ 79 318 427 588 216],18,5,6216,4.002575660012878,40.0,0.0
41553,4,1553,[ 79 318 427 588 216],577,5,6221,4.0032175032175035,40.0,0.0
41554,4,1554,[234 175 161  11 135],269,2,6223,4.001929260450161,0.0,0.0
41555,4,1555,[161 423 118  15 435],450,3,6226,4.0012853470437015,0.0,0.0
41556,4,1556,[ 15 100  50 204 496],236,1,6227,3.9993577392421322,20.0,40.0
41557,4,1557,[385 546  89 153  56],796,5,6232,4.0,0.0,0.0
41558,4,1558,[ 50 357 403 153   8],330,5,6237,4.000641436818474,0.0,20.0
41559,4,1559,[176  96 175 174 153],23,4,6241,4.000641025641026,0.0,0.0
41560,4,1560,[194 234 423  56  71],504,2,6243,3.999359385009609,0.0,0.0
41561,4,1561,[211 234 127  70 172],655,2,6245,3.998079385403329,0.0,20.0
41562,4,1562,[322 181 118 258 183],450,4,6249,3.998080614203455,0.0,0.0
41563,4,1563,[ 97 435 313 265  88],655,1,6250,3.99616368286445,0.0,0.0
41564,4,1564,[ 64 181 318 276   8],878,2,6252,3.994888178913738,40.0,0.0
41565,4,1565,[ 79 603 111 265 216],655,3,6255,3.9942528735632186,20.0,0.0
41566,4,1566,[ 88 174  98 196  28],796,4,6259,3.994256541161455,0.0,0.0
41567,4,1567,[403 357 127 153 135],269,3,6262,3.993622448979592,0.0,20.0
41568,4,1568,[ 79 318 427 588 216],796,5,6267,3.994263862332696,40.0,0.0
41569,4,1569,[ 79 318 427 588 216],796,5,6272,3.994904458598726,40.0,0.0
41570,4,1570,[ 79 318 427 588 216],450,5,6277,3.995544239338001,40.0,0.0
41571,4,1571,[182 423 603  25 204],389,4,6281,3.9955470737913488,20.0,0.0
41572,4,1572,[ 89 603 195 294 196],23,3,6284,3.9949141767323586,20.0,0.0
41573,4,1573,[ 79 318 427 588 216],796,5,6289,3.9955527318932655,40.0,0.0
41574,4,1574,[168 423 427 117 234],450,4,6293,3.9955555555555557,20.0,0.0
41575,4,1575,[ 79 318 427 588 216],450,5,6298,3.996192893401015,40.0,0.0
41576,4,1576,[ 79 318 427 588 216],796,5,6303,3.9968294229549777,40.0,0.0
41577,4,1577,[568 127 265 405 471],280,2,6305,3.9955640050697085,0.0,20.0
41578,4,1578,[186 275   1 191 143],786,5,6310,3.9962001266624445,0.0,20.0
41579,4,1579,[ 79 318 427 588 216],18,5,6315,3.9968354430379747,40.0,0.0
41580,4,1580,[ 79 318 427 588 216],450,5,6320,3.9974699557242253,40.0,0.0
41581,4,1581,[ 79 318 427 588 216],716,5,6325,3.9981036662452594,40.0,0.0
41582,4,1582,[ 79 318 427 588 216],450,5,6330,3.9987365761212885,40.0,0.0
41583,4,1583,[ 79 318 427 588 216],577,5,6335,3.999368686868687,40.0,0.0
41584,4,1584,[ 79 318 427 588 216],796,5,6340,4.0,40.0,0.0
41585,4,1585,[ 79 318 427 588 216],18,5,6345,4.00063051702396,40.0,0.0
41586,4,1586,[ 71 323  98 181 318],280,3,6348,4.0,20.0,0.0
41587,4,1587,[275 286 237 183 121],344,2,6350,3.9987405541561714,0.0,40.0
41588,4,1588,[ 70 187 568 288 132],655,1,6351,3.9968533668974198,0.0,0.0
41589,4,1589,[ 79 318 427 588 216],716,5,6356,3.9974842767295597,40.0,0.0
41590,4,1590,[ 79 318 427 588 216],450,5,6361,3.9981143934632306,40.0,0.0
41591,4,1591,[ 79 318 427 588 216],796,5,6366,3.998743718592965,40.0,0.0
41592,4,1592,[496   8  98   4 357],535,2,6368,3.997489014438167,20.0,0.0
41593,4,1593,[ 25 180  88 318 603],18,2,6370,3.9962358845671266,40.0,0.0
41594,4,1594,[ 79 427 318 588 216],18,5,6375,3.9968652037617556,40.0,0.0
41595,4,1595,[ 79 427 318 588 216],796,5,6380,3.9974937343358397,40.0,0.0
41596,4,1596,[ 28  11  70 111  22],716,5,6385,3.9981214777708205,0.0,0.0
41597,4,1597,[ 79 427 318 588 216],796,5,6390,3.9987484355444307,40.0,0.0
41598,4,1598,[ 79 427 318 588 216],796,5,6395,3.9993746091307067,40.0,0.0
41599,4,1599,[ 79 427 318 588 216],577,5,6400,4.0,40.0,0.0
41600,4,1600,[ 79 427 318 588 216],796,5,6405,4.000624609618988,40.0,0.0
41601,4,1601,[ 79 427 318 588 216],796,5,6410,4.001248439450687,40.0,0.0
41602,4,1602,[180 678 186 423 323],504,4,6414,4.001247660636307,0.0,0.0
41603,4,1603,[ 79 427 318 588 216],716,5,6419,4.001870324189526,40.0,0.0
41604,4,1604,[603 237 186  56 132],796,4,6423,4.001869158878504,20.0,0.0
41605,4,1605,[ 69 228 313 143 357],450,5,6428,4.002490660024907,0.0,0.0
41606,4,1606,[ 79 427 318 588 216],716,5,6433,4.003111387678905,40.0,0.0
41607,4,1607,[ 79 427 318 588 216],18,5,6438,4.003731343283582,40.0,0.0
41608,4,1608,[ 79 427 318 588 216],18,5,6443,4.004350528278434,40.0,0.0
41609,4,1609,[275 121 176  96 204],796,5,6448,4.004968944099379,0.0,20.0
41610,4,1610,[ 79 427 318 588 216],796,5,6453,4.005586592178771,40.0,0.0
41611,4,1611,[742 181 118   7 275],450,4,6457,4.005583126550868,0.0,20.0
41612,4,1612,[318  79 427 588 216],450,5,6462,4.006199628022319,40.0,0.0
41613,4,1613,[322 300 197 196 200],151,3,6465,4.0055762081784385,0.0,0.0
41614,4,1614,[318  79 427 588 216],18,5,6470,4.006191950464396,40.0,0.0
41615,4,1615,[ 15 179 357 144 300],655,2,6472,4.0049504950495045,0.0,0.0
41616,4,1616,[153 385 300 211 172],716,4,6476,4.004947433518862,0.0,0.0
41617,4,1617,[318  79 427 588 216],18,5,6481,4.005562422744129,40.0,0.0
41618,4,1618,[318  79 427 588 216],18,5,6486,4.006176652254478,40.0,0.0
41619,4,1619,[143 333 180 210 282],693,2,6488,4.004938271604939,0.0,0.0
41620,4,1620,[318  79 427 588 216],18,5,6493,4.005552128315855,40.0,0.0
41621,4,1621,[318  79 427 588 216],577,5,6498,4.00616522811344,40.0,0.0
41622,4,1622,[216 435  70 269  82],450,4,6502,4.006161429451633,0.0,0.0
41623,4,1623,[143  22 211 423 197],450,5,6507,4.0067733990147785,0.0,0.0
41624,4,1624,[357 173 168 405 435],11,3,6510,4.006153846153846,0.0,0.0
41625,4,1625,[185  97 588 135 215],18,2,6512,4.004920049200492,0.0,0.0
41626,4,1626,[276 132  98 118 313],280,3,6515,4.004302397049785,0.0,0.0
41627,4,1627,[ 98 143 174 427 186],911,3,6518,4.003685503685504,20.0,0.0
41628,4,1628,[603 265 118 195 121],716,3,6521,4.003069367710252,20.0,0.0
41629,4,1629,[257 245  79  88 144],796,4,6525,4.0030674846625764,0.0,0.0
41630,4,1630,[ 79 318 427 588 216],577,5,6530,4.0036787247087675,40.0,0.0
41631,4,1631,[194  82 546   1  64],457,4,6534,4.0036764705882355,20.0,0.0
41632,4,1632,[ 79 318 427 588 216],796,5,6539,4.0042865890998165,40.0,0.0
41633,4,1633,[ 79 318 427 588 216],577,5,6544,4.004895960832314,40.0,0.0
41634,4,1634,[ 79 318 427 588 216],716,5,6549,4.005504587155963,40.0,0.0
41635,4,1635,[301 195 127   1 100],344,4,6553,4.005501222493888,0.0,40.0
41636,4,1636,[ 15  22 257 301 186],655,0,6553,4.003054367745877,0.0,0.0
41637,4,1637,[546 265 185  50 597],796,5,6558,4.003663003663004,0.0,20.0
41638,4,1638,[196 269 191 153 210],655,1,6559,4.00183038438072,0.0,0.0
41639,4,1639,[194  95 100 238   8],23,5,6564,4.0024390243902435,0.0,20.0
41640,4,1640,[ 70  98 191 215 174],450,5,6569,4.003046922608166,0.0,0.0
41641,4,1641,[172   9 181 135 176],72,2,6571,4.001827040194884,0.0,0.0
41642,4,1642,[181 121 173 117   8],807,4,6575,4.001825928180158,0.0,0.0
41643,4,1643,[294 318  12 405 191],457,4,6579,4.001824817518248,20.0,0.0
41644,4,1644,[313 181 118 143 121],655,2,6581,4.000607902735562,0.0,0.0
41645,4,1645,[127 234 135  79 423],280,4,6585,4.000607533414338,0.0,20.0
41646,4,1646,[ 71  22 176 300 427],796,5,6590,4.001214329083181,20.0,0.0
41647,4,1647,[181  96 200 588   1],796,4,6594,4.00121359223301,0.0,0.0
41648,4,1648,[483  89 742 300  22],450,4,6598,4.001212856276531,0.0,0.0
41649,4,1649,[200 153 427   8 172],330,5,6603,4.001818181818182,20.0,0.0
41650,4,1650,[ 79 318 427 588 216],716,5,6608,4.002422774076317,40.0,0.0
41651,4,1651,[210  25 301 405 282],450,3,6611,4.00181598062954,0.0,0.0
41652,4,1652,[423 135 210 117 588],885,4,6615,4.001814882032668,0.0,0.0
41653,4,1653,[ 11  56 282 238 405],450,5,6620,4.0024183796856105,0.0,0.0
41654,4,1654,[ 12 471 385  15 191],457,5,6625,4.003021148036254,0.0,0.0
41655,4,1655,[186 238  95 111 168],450,3,6628,4.002415458937198,0.0,0.0
41656,4,1656,[289  88 273  25 175],655,1,6629,4.00060350030175,0.0,0.0
41657,4,1657,[318 100 204  89 194],72,4,6633,4.000603136308806,20.0,20.0
41658,4,1658,[183 173 175 172 238],23,4,6637,4.000602772754672,0.0,0.0
41659,4,1659,[ 79 318 427 588 216],450,5,6642,4.001204819277109,40.0,0.0
41660,4,1660,[ 79 318 427 588 216],577,5,6647,4.001806140878989,40.0,0.0
41661,4,1661,[  1 222  12 405 245],256,5,6652,4.0024067388688325,0.0,0.0
41662,4,1662,[117 265 210 183 322],796,3,6655,4.001803968731209,0.0,0.0
41663,4,1663,[282 143 197 546 588],796,4,6659,4.001802884615385,0.0,0.0
41664,4,1664,[237 151 187   1  69],716,4,6663,4.001801801801802,0.0,0.0
41665,4,1665,[ 79 318 427 588 216],577,5,6668,4.002400960384153,40.0,0.0
41666,4,1666,[ 88 655  11 186 515],269,2,6670,4.0011997600479905,0.0,0.0
41667,4,1667,[ 79 318 427 588 216],18,5,6675,4.001798561151079,40.0,0.0
41668,4,1668,[ 79 318 427 588 216],716,5,6680,4.0023966446974235,40.0,0.0
41669,4,1669,[  1   7 100 183 168],151,3,6683,4.001796407185629,0.0,20.0
41670,4,1670,[ 79 318 427 588 216],18,5,6688,4.002393776181927,40.0,0.0
41671,4,1671,[ 79 318 427 588 216],796,5,6693,4.00299043062201,40.0,0.0
41672,4,1672,[ 79 318 427 588 216],577,5,6698,4.003586371787208,40.0,0.0
41673,4,1673,[200 202 282  88 546],457,4,6702,4.003584229390681,0.0,0.0
41674,4,1674,[173 196 508 202 168],401,2,6704,4.0023880597014925,0.0,0.0
41675,4,1675,[ 79 318 427 588 216],18,5,6709,4.002983293556086,40.0,0.0
41676,4,1676,[186 191 269 168 180],796,2,6711,4.001788908765653,0.0,0.0
41677,4,1677,[ 79 318 427 588 216],796,5,6716,4.00238379022646,40.0,0.0
41678,4,1678,[  8 174  89  12 100],18,4,6720,4.002382370458606,0.0,20.0
41679,4,1679,[276   9 173 269 179],535,4,6724,4.002380952380952,0.0,0.0
41680,4,1680,[ 28  11  50 282 100],655,1,6725,4.00059488399762,0.0,40.0
41681,4,1681,[ 79 318 427 588 216],796,5,6730,4.001189060642092,40.0,0.0
41682,4,1682,[210 132 195 423  12],450,4,6734,4.001188354129531,0.0,0.0
41683,4,1683,[385 176 211 100   4],796,3,6737,4.000593824228028,0.0,20.0
41684,4,1684,[ 79 318 427 588 216],450,5,6742,4.001186943620178,40.0,0.0
41685,4,1685,[ 79 318 427 588 216],796,5,6747,4.001779359430605,40.0,0.0
41686,4,1686,[ 79 318 427 588 216],796,5,6752,4.002371072910492,40.0,0.0
41687,4,1687,[173 286 121  25 195],535,4,6756,4.002369668246446,0.0,20.0
41688,4,1688,[234 568 222 151  79],450,3,6759,4.001776198934281,0.0,0.0
41689,4,1689,[132 222  22 183  79],716,4,6763,4.001775147928994,0.0,0.0
41690,4,1690,[ 97 313 181  56 385],796,4,6767,4.0017740981667655,0.0,0.0
41691,4,1691,[ 79 318 427 588 216],18,5,6772,4.002364066193853,40.0,0.0
41692,4,1692,[ 79 318 427 588 216],716,5,6777,4.002953337271117,40.0,0.0
41693,4,1693,[ 79 318 427 588 216],716,5,6782,4.003541912632822,40.0,0.0
41694,4,1694,[ 79 318 427 588 216],450,5,6787,4.004129793510325,40.0,0.0
41695,4,1695,[ 79 318 427 588 216],450,5,6792,4.004716981132075,40.0,0.0
41696,4,1696,[423 237 333 273 568],796,4,6796,4.004714201532115,0.0,0.0
41697,4,1697,[ 79 318 427 588 216],796,5,6801,4.0053003533568905,40.0,0.0
41698,4,1698,[ 96 175 427 118 185],716,2,6803,4.004120070629782,20.0,0.0
41699,4,1699,[194 180 405   4 151],450,4,6807,4.004117647058823,0.0,0.0
41700,4,1700,[176 117 313 302 742],344,2,6809,4.002939447383892,0.0,0.0
41701,4,1701,[294   8 197  28  69],796,2,6811,4.001762632197415,0.0,0.0
41702,4,1702,[ 79 318 427 588 216],450,5,6816,4.002348796241926,40.0,0.0
41703,4,1703,[323 423 185 125 288],504,5,6821,4.002934272300469,0.0,0.0
41704,4,1704,[196 288 313   7 204],655,1,6822,4.001173020527859,0.0,0.0
41705,4,1705,[200 568 121 318 204],457,5,6827,4.0017584994138335,20.0,0.0
41706,4,1706,[ 79 318 427 588 216],796,5,6832,4.002343292325718,40.0,0.0
41707,4,1707,[ 70 385  79 357 568],450,5,6837,4.002927400468384,0.0,0.0
41708,4,1708,[204 322 100 328 176],151,1,6838,4.001170275014628,0.0,20.0
41709,4,1709,[ 82 318 258 186 204],504,3,6841,4.000584795321638,20.0,0.0
41710,4,1710,[ 79 318 427 588 216],450,5,6846,4.001168907071888,40.0,0.0
41711,4,1711,[196 111  11 127  82],457,4,6850,4.001168224299065,0.0,20.0
41712,4,1712,[111 275 194 546 515],716,4,6854,4.001167542323409,0.0,20.0
41713,4,1713,[ 50 111 161  70 182],655,2,6856,4.0,0.0,20.0
41714,4,1714,[ 79 318 427 588 216],577,5,6861,4.000583090379009,40.0,0.0
41715,4,1715,[ 28 121 286 289 515],655,1,6862,3.998834498834499,0.0,20.0
41716,4,1716,[ 79 318 427 588 216],18,5,6867,3.9994175888177055,40.0,0.0
41717,4,1717,[  7 200   1  88 121],655,1,6868,3.9976717112922002,0.0,0.0
41718,4,1718,[ 79 318 427 588 216],577,5,6873,3.9982547993019195,40.0,0.0
41719,4,1719,[ 79 318 427 588 216],450,5,6878,3.9988372093023257,40.0,0.0
41720,4,1720,[ 82  12 172 405  28],450,4,6882,3.99883788495061,0.0,0.0
41721,4,1721,[ 79 318 427 588 216],18,5,6887,3.9994192799070847,40.0,0.0
41722,4,1722,[161 238   8 228   7],655,0,6887,3.9970980847359256,0.0,0.0
41723,4,1723,[ 79 318 427 588 216],450,5,6892,3.9976798143851506,40.0,0.0
41724,4,1724,[185  98  69 111   8],11,3,6895,3.9971014492753625,0.0,0.0
41725,4,1725,[194 181  28 546 172],457,4,6899,3.9971031286210894,0.0,0.0
41726,4,1726,[475 603 153 197 118],655,1,6900,3.9953676896352057,20.0,0.0
41727,4,1727,[235 597 435 185 483],450,3,6903,3.9947916666666665,0.0,0.0
41728,4,1728,[318  79 427 588 216],450,5,6908,3.995373048004627,40.0,0.0
41729,4,1729,[318  79 427 588 216],450,5,6913,3.9959537572254336,40.0,0.0
41730,4,1730,[318  79 427 588 216],796,5,6918,3.996533795493934,40.0,0.0
41731,4,1731,[200 603 405 187 117],655,3,6921,3.9959584295612007,20.0,0.0
41732,4,1732,[196 357 168 191 546],450,5,6926,3.996537795729948,0.0,0.0
41733,4,1733,[200 597 172 403 237],450,4,6930,3.9965397923875434,0.0,0.0
41734,4,1734,[282 271   9 172 216],796,4,6934,3.996541786743516,0.0,0.0
41735,4,1735,[318  79 427 588 216],796,5,6939,3.997119815668203,40.0,0.0
41736,4,1736,[318  79 427 588 216],577,5,6944,3.997697179044329,40.0,0.0
41737,4,1737,[301 237 228 181 183],655,1,6945,3.9959723820483313,0.0,0.0
41738,4,1738,[318  79 427 588 216],18,5,6950,3.9965497412305924,40.0,0.0
41739,4,1739,[318  79 427 588 216],18,5,6955,3.9971264367816093,40.0,0.0
41740,4,1740,[318  79 427 588 216],577,5,6960,3.9977024698449166,40.0,0.0
41741,4,1741,[276 678 175 471  79],344,3,6963,3.997129735935706,0.0,0.0
41742,4,1742,[288 161 195 258 151],450,4,6967,3.9971313826735515,0.0,0.0
41743,4,1743,[ 69 322 197 588   1],450,5,6972,3.9977064220183487,0.0,0.0
41744,4,1744,[318  79 427 588 216],716,5,6977,3.9982808022922636,40.0,0.0
41745,4,1745,[318  79 427 588 216],577,5,6982,3.9988545246277205,40.0,0.0
41746,4,1746,[318  79 427 588 216],18,5,6987,3.999427590154551,40.0,0.0
41747,4,1747,[318  79 427 588 216],716,5,6992,4.0,40.0,0.0
41748,4,1748,[318  79 427 588 216],577,5,6997,4.000571755288736,40.0,0.0
41749,4,1749,[186 111 294  88 405],796,3,7000,4.0,0.0,0.0
41750,4,1750,[385  71 125  96 204],450,4,7004,4.0,0.0,0.0
41751,4,1751,[318  79 427 588 216],577,5,7009,4.0005707762557075,40.0,0.0
41752,4,1752,[318  79 427 588 216],18,5,7014,4.001140901312037,40.0,0.0
41753,4,1753,[318  79 427 588 216],577,5,7019,4.001710376282782,40.0,0.0
41754,4,1754,[318  79 427 588 216],18,5,7024,4.002279202279202,40.0,0.0
41755,4,1755,[222 235 127 483 210],457,4,7028,4.002277904328018,0.0,20.0
41756,4,1756,[222  69 182 121 294],655,1,7029,4.000569151963575,0.0,0.0
41757,4,1757,[496 275 175 135 186],716,2,7031,3.9994311717861204,20.0,20.0
41758,4,1758,[121   4 174 403   8],577,5,7036,4.0,0.0,0.0
41759,4,1759,[302 211 153 117  28],655,1,7037,3.9982954545454548,0.0,0.0
41760,4,1760,[286 181 483   9 655],151,5,7042,3.998864281658149,0.0,20.0
41761,4,1761,[318  79 427 588 216],716,5,7047,3.9994324631101024,40.0,0.0
41762,4,1762,[318  79 427 588 216],577,5,7052,4.0,40.0,0.0
41763,4,1763,[318  79 427 588 216],796,5,7057,4.000566893424036,40.0,0.0
41764,4,1764,[597 508 117 121  12],344,2,7059,3.99943342776204,0.0,0.0
41765,4,1765,[ 50   4 288 405  28],655,1,7060,3.997734994337486,0.0,20.0
41766,4,1766,[294 215  88 405 143],655,1,7061,3.996038483305037,0.0,0.0
41767,4,1767,[318  79 427 588 216],450,5,7066,3.996606334841629,40.0,0.0
41768,4,1768,[328  64 483  79 301],151,4,7070,3.996608253250424,20.0,0.0
41769,4,1769,[204  56 211 186 185],796,3,7073,3.996045197740113,0.0,0.0
41770,4,1770,[318  79 427 588 216],796,5,7078,3.996612083568605,40.0,0.0
41771,4,1771,[318  79 427 588 216],18,5,7083,3.9971783295711063,40.0,0.0
41772,4,1772,[228 597   7 151 194],23,3,7086,3.996615905245347,0.0,0.0
41773,4,1773,[273 181 742 286 748],796,2,7088,3.995490417136415,0.0,20.0
41774,4,1774,[318  79 427 588 216],18,5,7093,3.996056338028169,40.0,0.0
41775,4,1775,[ 56 215 288  64 235],457,4,7097,3.9960585585585586,20.0,0.0
41776,4,1776,[318  79 427 588 216],796,5,7102,3.996623522791221,40.0,0.0
41777,4,1777,[ 98 257  50  22 172],296,5,7107,3.9971878515185604,0.0,20.0
41778,4,1778,[143 175 200   9 483],655,3,7110,3.996627318718381,0.0,0.0
41779,4,1779,[ 28 257 300 597 313],796,4,7114,3.9966292134831463,0.0,0.0
41780,4,1780,[588 179 151  96  22],577,4,7118,3.9966311061201574,0.0,0.0
41781,4,1781,[318  79 427 588 216],18,5,7123,3.9971941638608306,40.0,0.0
41782,4,1782,[ 98  25  97 496 179],577,4,7127,3.997195737521032,20.0,0.0
41783,4,1783,[168  71 135 194  69],807,5,7132,3.997757847533632,0.0,0.0
41784,4,1784,[111 100 186 301 172],151,4,7136,3.9977591036414566,0.0,20.0
41785,4,1785,[318  79 427 588 216],18,5,7141,3.998320268756999,40.0,0.0
41786,4,1786,[318  79 427 588 216],716,5,7146,3.9988808058198098,40.0,0.0
41787,4,1787,[318  79 427 588 216],18,5,7151,3.999440715883669,40.0,0.0
41788,4,1788,[318  79 427 588 216],716,5,7156,4.0,40.0,0.0
41789,4,1789,[318  79 427 588 216],796,5,7161,4.0005586592178775,40.0,0.0
41790,4,1790,[204  25 197 271 100],72,4,7165,4.000558347292015,0.0,20.0
41791,4,1791,[183  11 258   7 245],450,5,7170,4.001116071428571,0.0,0.0
41792,4,1792,[333  64 282 118  98],796,5,7175,4.001673173452315,20.0,0.0
41793,4,1793,[ 89 496 111 132  97],151,5,7180,4.002229654403568,20.0,0.0
41794,4,1794,[318  79 427 588 216],450,5,7185,4.002785515320334,40.0,0.0
41795,4,1795,[515  25 234 216 182],18,3,7188,4.002227171492205,0.0,0.0
41796,4,1796,[144 483 197 185  96],457,5,7193,4.0027824151363385,0.0,0.0
41797,4,1797,[ 96  70 257 195 357],655,1,7194,4.00111234705228,0.0,0.0
41798,4,1798,[597 288 328 100 276],938,2,7196,4.0,0.0,20.0
41799,4,1799,[318  79 427 588 216],796,5,7201,4.000555555555556,40.0,0.0
41800,4,1800,[318  79 427 588 216],450,5,7206,4.001110494169906,40.0,0.0
41801,4,1801,[318  79 427 588 216],577,5,7211,4.001664816870144,40.0,0.0
41802,4,1802,[268 100 132   9 135],629,5,7216,4.002218524681087,0.0,20.0
41803,4,1803,[135 176  96 333 211],693,2,7218,4.001108647450111,0.0,0.0
41804,4,1804,[265 132  15 603 300],151,5,7223,4.001662049861496,20.0,0.0
41805,4,1805,[  7 135  97 471 186],655,1,7224,4.0,0.0,0.0
41806,4,1806,[318 187 173 153 161],716,3,7227,3.9994465965688986,20.0,0.0
41807,4,1807,[318  79 427 588 216],18,5,7232,4.0,40.0,0.0
41808,4,1808,[318  79 427 588 216],577,5,7237,4.000552791597568,40.0,0.0
41809,4,1809,[318  79 427 588 216],577,5,7242,4.001104972375691,40.0,0.0
41810,4,1810,[237 318 427 143 742],796,4,7246,4.001104362230811,40.0,0.0
41811,4,1811,[318  79 427 588 216],18,5,7251,4.001655629139073,40.0,0.0
41812,4,1812,[318  79 427 588 216],796,5,7256,4.002206287920574,40.0,0.0
41813,4,1813,[294 515 300 483 357],716,5,7261,4.002756339581037,0.0,0.0
41814,4,1814,[318  79 427 588 216],577,5,7266,4.003305785123967,40.0,0.0
41815,4,1815,[265 182 168 328 273],796,4,7270,4.003303964757709,0.0,0.0
41816,4,1816,[ 56 471 273 258 748],450,4,7274,4.003302146395157,0.0,0.0
41817,4,1817,[ 96 282 151 655 228],716,3,7277,4.002750275027503,0.0,0.0
41818,4,1818,[ 70 186 568 174 265],457,5,7282,4.003298515667949,0.0,0.0
41819,4,1819,[318  79 427 588 216],450,5,7287,4.003846153846154,40.0,0.0
41820,4,1820,[117 175 143  97 597],457,4,7291,4.00384404173531,0.0,0.0
41821,4,1821,[318  79 427 588 216],716,5,7296,4.004390779363337,40.0,0.0
41822,4,1822,[268 276 174 135 204],535,2,7298,4.003291278113,0.0,0.0
41823,4,1823,[  7  70 144 161 186],655,0,7298,4.00109649122807,0.0,0.0
41824,4,1824,[  8 427 300  82 210],655,1,7299,3.9994520547945207,20.0,0.0
41825,4,1825,[318  79 427 588 216],577,5,7304,4.0,40.0,0.0
41826,4,1826,[271 313  88 117 300],796,5,7309,4.000547345374931,0.0,0.0
41827,4,1827,[215 211  25 275 196],151,4,7313,4.00054704595186,0.0,20.0
41828,4,1828,[318  79 427 588 216],18,5,7318,4.001093493712411,40.0,0.0
41829,4,1829,[318  79 427 588 216],450,5,7323,4.001639344262295,40.0,0.0
41830,4,1830,[318  79 427 588 216],577,5,7328,4.002184598580011,40.0,0.0
41831,4,1831,[186 125  69 313 273],655,2,7330,4.001091703056769,0.0,0.0
41832,4,1832,[  4  79 322 181 161],256,5,7335,4.001636661211129,0.0,0.0
41833,4,1833,[318  79 427 588 216],18,5,7340,4.002181025081788,40.0,0.0
41834,4,1834,[ 88 135 568 603 496],389,2,7342,4.001089918256131,40.0,0.0
41835,4,1835,[318  79 427 588 216],577,5,7347,4.001633986928105,40.0,0.0
41836,4,1836,[235  88 678 173 385],344,1,7348,4.0,0.0,0.0
41837,4,1837,[405  82 117 257 186],655,0,7348,3.997823721436344,0.0,0.0
41838,4,1838,[318  79 427 588 216],577,5,7353,3.99836867862969,40.0,0.0
41839,4,1839,[300 176 216  12  88],693,2,7355,3.9972826086956523,0.0,0.0
41840,4,1840,[275  97 210 173 135],535,4,7359,3.997284084736556,0.0,20.0
41841,4,1841,[187 300 143 194 118],450,4,7363,3.99728555917481,0.0,0.0
41842,4,1842,[318  79 427 588 216],18,5,7368,3.997829625610418,40.0,0.0
41843,4,1843,[318  79 427 588 216],450,5,7373,3.9983731019522777,40.0,0.0
41844,4,1844,[318  79 427 588 216],716,5,7378,3.9989159891598915,40.0,0.0
41845,4,1845,[318  79 427 588 216],450,5,7383,3.9994582881906826,40.0,0.0
41846,4,1846,[195 215 185 196 276],655,2,7385,3.99837574445046,0.0,0.0
41847,4,1847,[318  79 427 588 216],450,5,7390,3.9989177489177488,40.0,0.0
41848,4,1848,[318  79 427 588 216],796,5,7395,3.9994591671173607,40.0,0.0
41849,4,1849,[185 357  69 210  50],655,3,7398,3.998918918918919,0.0,20.0
41850,4,1850,[132  88 179 328 322],450,5,7403,3.9994597514856833,0.0,0.0
41851,4,1851,[318  79 427 588 216],450,5,7408,4.0,40.0,0.0
41852,4,1852,[318  79 427 588 216],716,5,7413,4.000539665407447,40.0,0.0
41853,4,1853,[204 185  88  89 196],151,5,7418,4.001078748651564,0.0,0.0
41854,4,1854,[222   1  95 151 202],344,4,7422,4.001078167115903,0.0,0.0
41855,4,1855,[257 143  50  79 328],655,3,7425,4.000538793103448,0.0,20.0
41856,4,1856,[318  79 427 588 216],796,5,7430,4.001077005923532,40.0,0.0
41857,4,1857,[318  79 427 588 216],450,5,7435,4.001614639397201,40.0,0.0
41858,4,1858,[318  79 427 588 216],450,5,7440,4.0021516944593865,40.0,0.0
41859,4,1859,[180 121 271   9 153],796,3,7443,4.001612903225807,0.0,0.0
41860,4,1860,[318  79 427 588 216],577,5,7448,4.00214938205266,40.0,0.0
41861,4,1861,[403 183 135 181   9],655,2,7450,4.001074113856069,0.0,0.0
41862,4,1862,[318  79 427 588 216],450,5,7455,4.001610305958132,40.0,0.0
41863,4,1863,[ 97 121  71 435 135],450,2,7457,4.000536480686695,0.0,0.0
41864,4,1864,[174 194 302  98  64],535,3,7460,4.0,20.0,0.0
41865,4,1865,[237 235 603  25  56],591,3,7463,3.9994640943194,20.0,0.0
41866,4,1866,[ 79 318 427 588 216],716,5,7468,4.0,40.0,0.0
41867,4,1867,[143 276 176 215 288],504,3,7471,3.9994646680942183,0.0,0.0
41868,4,1868,[ 79 318 427 588 216],796,5,7476,4.0,40.0,0.0
41869,4,1869,[ 79 318 427 588 216],716,5,7481,4.000534759358289,40.0,0.0
41870,4,1870,[ 79 318 427 588 216],450,5,7486,4.001068947087119,40.0,0.0
41871,4,1871,[333 288 742  25 187],655,1,7487,3.9994658119658117,0.0,0.0
41872,4,1872,[191 183 161  28 603],796,4,7491,3.999466097170315,20.0,0.0
41873,4,1873,[568 483 302   8 143],269,1,7492,3.9978655282817503,0.0,0.0
41874,4,1874,[ 56   1  15 194 210],151,5,7497,3.9984,0.0,0.0
41875,4,1875,[286   9 127 471   1],655,1,7498,3.99680170575693,0.0,40.0
41876,4,1876,[568 323 210 265  79],798,5,7503,3.9973361747469367,0.0,0.0
41877,4,1877,[483 200  70  71 405],280,4,7507,3.9973375931842385,0.0,0.0
41878,4,1878,[238 597 286  69 132],174,3,7510,3.996806812134114,0.0,20.0
41879,4,1879,[100 187   9   7 200],786,5,7515,3.997340425531915,0.0,20.0
41880,4,1880,[ 79 318 427 588 216],577,5,7520,3.997873471557682,40.0,0.0
41881,4,1881,[117 176  28 100  88],504,3,7523,3.9973432518597236,0.0,20.0
41882,4,1882,[ 79 318 427 588 216],450,5,7528,3.9978757302177375,40.0,0.0
41883,4,1883,[ 79 318 427 588 216],450,5,7533,3.998407643312102,40.0,0.0
41884,4,1884,[ 79 318 427 588 216],18,5,7538,3.9989389920424405,40.0,0.0
41885,4,1885,[435 300  50 168  12],151,5,7543,3.999469777306469,0.0,20.0
41886,4,1886,[237 385  89 181 286],796,4,7547,3.999470058293588,0.0,20.0
41887,4,1887,[ 79 318 427 588 216],716,5,7552,4.0,40.0,0.0
41888,4,1888,[191  69 132 333   8],796,5,7557,4.000529380624669,0.0,0.0
41889,4,1889,[318 211 427 144 405],655,2,7559,3.9994708994708996,40.0,0.0
41890,4,1890,[ 79 318 427 588 216],450,5,7564,4.0,40.0,0.0
41891,4,1891,[403 202 245  71 282],280,1,7565,3.998414376321353,0.0,0.0
41892,4,1892,[ 79 318 427 588 216],577,5,7570,3.998943475964078,40.0,0.0
41893,4,1893,[ 79 318 427 588 216],796,5,7575,3.999472016895459,40.0,0.0
41894,4,1894,[ 79 318 427 588 216],796,5,7580,4.0,40.0,0.0
41895,4,1895,[ 79 318 427 588 216],716,5,7585,4.000527426160337,40.0,0.0
41896,4,1896,[ 79 318 427 588 216],716,5,7590,4.001054296257248,40.0,0.0
41897,4,1897,[132 197 211 168 173],389,4,7594,4.001053740779768,0.0,0.0
41898,4,1898,[ 79 318 427 588 216],577,5,7599,4.001579778830964,40.0,0.0
41899,4,1899,[234 197  79 288 318],450,3,7602,4.001052631578947,20.0,0.0
41900,4,1900,[ 79 318 427 588 216],450,5,7607,4.0015781167806415,40.0,0.0
41901,4,1901,[100  97  50 323 238],504,3,7610,4.001051524710831,0.0,40.0
41902,4,1902,[302   8 135 508 276],269,3,7613,4.000525486074619,0.0,0.0
41903,4,1903,[318  79 427 588 216],577,5,7618,4.001050420168068,40.0,0.0
41904,4,1904,[121 515 216  82 197],716,5,7623,4.001574803149606,0.0,0.0
41905,4,1905,[ 79 318 427 588 216],577,5,7628,4.002098635886673,40.0,0.0
41906,4,1906,[ 79 318 427 588 216],18,5,7633,4.002621919244887,40.0,0.0
41907,4,1907,[496  82 196  28 228],151,4,7637,4.002620545073375,20.0,0.0
41908,4,1908,[ 79 318 427 588 216],716,5,7642,4.003143006809848,40.0,0.0
41909,4,1909,[435 300  56 183  79],716,4,7646,4.003141361256544,0.0,0.0
41910,4,1910,[318  79 427 588 216],450,5,7651,4.003663003663004,40.0,0.0
41911,4,1911,[318  79 427 588 216],716,5,7656,4.00418410041841,40.0,0.0
41912,4,1912,[ 56  89 238 125 748],796,4,7660,4.004181913225301,0.0,0.0
41913,4,1913,[423 238 195  79 175],23,4,7664,4.004179728317659,0.0,0.0
41914,4,1914,[318  79 427 588 216],450,5,7669,4.004699738903394,40.0,0.0
41915,4,1915,[118 228 588   4 204],577,3,7672,4.004175365344468,0.0,0.0
41916,4,1916,[318  79 427 588 216],796,5,7677,4.004694835680751,40.0,0.0
41917,4,1917,[143 238  70  98 288],593,5,7682,4.005213764337852,0.0,0.0
41918,4,1918,[318  79 427 588 216],716,5,7687,4.005732152162585,40.0,0.0
41919,4,1919,[318  79 427 588 216],18,5,7692,4.00625,40.0,0.0
41920,4,1920,[200 195 197 174 204],269,2,7694,4.005205622071838,0.0,0.0
41921,4,1921,[125  88 100   1  79],593,4,7698,4.005202913631634,0.0,20.0
41922,4,1922,[202 234  95   7 174],577,3,7701,4.004680187207488,0.0,0.0
41923,4,1923,[655 200  11 118 125],280,2,7703,4.003638253638254,0.0,0.0
41924,4,1924,[318  79 427 588 216],577,5,7708,4.004155844155844,40.0,0.0
41925,4,1925,[403  89 100 238 186],18,3,7711,4.003634475597092,0.0,20.0
41926,4,1926,[318  79 427 588 216],796,5,7716,4.004151530877011,40.0,0.0
41927,4,1927,[318  79 427 588 216],577,5,7721,4.0046680497925315,40.0,0.0
41928,4,1928,[100 202 288   1 748],280,2,7723,4.003628823224469,0.0,20.0
41929,4,1929,[318  79 427 588 216],796,5,7728,4.0041450777202074,40.0,0.0
41930,4,1930,[318  79 427 588 216],716,5,7733,4.004660797514242,40.0,0.0
41931,4,1931,[515 275  89 100 202],18,3,7736,4.004140786749482,0.0,40.0
41932,4,1932,[183 403 100 121  79],655,2,7738,4.003103983445421,0.0,20.0
41933,4,1933,[ 79 318 427 588 216],450,5,7743,4.003619441571872,40.0,0.0
41934,4,1934,[435 328 471  89 153],450,5,7748,4.004134366925064,0.0,0.0
41935,4,1935,[ 79 318 427 588 216],796,5,7753,4.0046487603305785,40.0,0.0
41936,4,1936,[ 82 405 121 742  79],577,4,7757,4.0046463603510585,0.0,0.0
41937,4,1937,[328 202 183 300 194],796,5,7762,4.005159958720331,0.0,0.0
41938,4,1938,[ 79 318 427 588 216],450,5,7767,4.005673027333677,40.0,0.0
41939,4,1939,[603 210 111 427 216],655,3,7770,4.005154639175258,40.0,0.0
41940,4,1940,[238 153 294   9  50],296,4,7774,4.005151983513652,0.0,20.0
41941,4,1941,[ 79 318 427 588 216],18,5,7779,4.005664263645726,40.0,0.0
41942,4,1942,[ 64   1 173 215 282],450,5,7784,4.006176016469377,20.0,0.0
41943,4,1943,[ 79 318 427 588 216],716,5,7789,4.006687242798354,40.0,0.0
41944,4,1944,[ 79 318 427 588 216],796,5,7794,4.00719794344473,40.0,0.0
41945,4,1945,[ 50 182  69 385 210],503,3,7797,4.006680369989723,0.0,20.0
41946,4,1946,[275 172 144 318  11],401,3,7800,4.006163328197227,20.0,20.0
41947,4,1947,[ 79 318 427 588 216],18,5,7805,4.006673511293634,40.0,0.0
41948,4,1948,[289 423 302 300 216],655,2,7807,4.0056439199589535,0.0,0.0
41949,4,1949,[194  82 200 423 258],457,5,7812,4.006153846153846,0.0,0.0
41950,4,1950,[ 69 515 483 568   7],269,2,7814,4.00512557662737,0.0,0.0
41951,4,1951,[ 79 318 427 588 216],18,5,7819,4.005635245901639,40.0,0.0
41952,4,1952,[ 79 318 427 588 216],450,5,7824,4.006144393241168,40.0,0.0
41953,4,1953,[238 197  22 385 168],796,3,7827,4.005629477993859,0.0,0.0
41954,4,1954,[ 79 318 427 588 216],18,5,7832,4.00613810741688,40.0,0.0
41955,4,1955,[ 69 655  97  79 100],236,3,7835,4.00562372188139,0.0,20.0
41956,4,1956,[ 79 318 427 588 216],716,5,7840,4.00613183444047,40.0,0.0
41957,4,1957,[ 79 318 427 588 216],716,5,7845,4.006639427987743,40.0,0.0
41958,4,1958,[183 238  95 182 471],450,4,7849,4.006636038795304,0.0,0.0
41959,4,1959,[318  79 427 588 216],796,5,7854,4.007142857142857,40.0,0.0
41960,4,1960,[742 135 282  69 228],457,5,7859,4.007649158592555,0.0,0.0
41961,4,1961,[328 222 153 568 496],450,4,7863,4.007645259938838,20.0,0.0
41962,4,1962,[318  79 427 588 216],18,5,7868,4.008150789607743,40.0,0.0
41963,4,1963,[318  79 427 588 216],18,5,7873,4.008655804480652,40.0,0.0
41964,4,1964,[318  79 427 588 216],18,5,7878,4.009160305343512,40.0,0.0
41965,4,1965,[194 427 151  28 318],577,5,7883,4.009664292980672,40.0,0.0
41966,4,1966,[423 265 515  96  69],807,4,7887,4.009659379766141,0.0,0.0
41967,4,1967,[ 88   1   4  28 174],655,0,7887,4.007621951219512,0.0,0.0
41968,4,1968,[318  79 427 588 216],716,5,7892,4.0081259522600305,40.0,0.0
41969,4,1969,[222 275 111 258 127],457,4,7896,4.008121827411167,0.0,40.0
41970,4,1970,[318  79 427 588 216],450,5,7901,4.008625063419584,40.0,0.0
41971,4,1971,[597 176 748 161 496],450,5,7906,4.009127789046653,20.0,0.0
41972,4,1972,[435 228 191 174 195],151,3,7909,4.008616320324379,0.0,0.0
41973,4,1973,[357 144  97 385  11],593,5,7914,4.009118541033435,0.0,0.0
41974,4,1974,[318  79 427 588 216],716,5,7919,4.009620253164557,40.0,0.0
41975,4,1975,[151 294 179 423 196],450,5,7924,4.010121457489879,0.0,0.0
41976,4,1976,[318  79 427 588 216],796,5,7929,4.01062215477997,40.0,0.0
41977,4,1977,[318  79 427 588 216],450,5,7934,4.011122345803842,40.0,0.0
41978,4,1978,[318  79 427 588 216],796,5,7939,4.011622031328954,40.0,0.0
41979,4,1979,[318  79 427 588 216],577,5,7944,4.012121212121212,40.0,0.0
41980,4,1980,[135 322 132 117 294],450,4,7948,4.0121150933871785,0.0,0.0
41981,4,1981,[ 79 289 655 471 135],693,2,7950,4.0110998990918265,0.0,0.0
41982,4,1982,[228 132 100 151 173],292,5,7955,4.011598587997983,0.0,20.0
41983,4,1983,[318  79 427 588 216],716,5,7960,4.012096774193548,40.0,0.0
41984,4,1984,[318  79 427 588 216],716,5,7965,4.012594458438287,40.0,0.0
41985,4,1985,[194 301  64 403 273],450,4,7969,4.012588116817724,20.0,0.0
41986,4,1986,[318  79 427 588 216],577,5,7974,4.013085052843483,40.0,0.0
41987,4,1987,[318  79 427 588 216],18,5,7979,4.0135814889336014,40.0,0.0
41988,4,1988,[318  79 427 588 216],577,5,7984,4.014077425842132,40.0,0.0
41989,4,1989,[318  79 427 588 216],450,5,7989,4.014572864321608,40.0,0.0
41990,4,1990,[191  71  96  28  12],450,4,7993,4.014565544952285,0.0,0.0
41991,4,1991,[182   7 235 100  50],457,4,7997,4.014558232931727,0.0,40.0
41992,4,1992,[318  79 427 588 216],796,5,8002,4.015052684395384,40.0,0.0
41993,4,1993,[ 69 200 265 222  15],457,5,8007,4.0155466399197595,0.0,0.0
41994,4,1994,[181 245  82 202  69],450,4,8011,4.015538847117795,0.0,0.0
41995,4,1995,[144 385 286 186 322],796,2,8013,4.014529058116232,0.0,20.0
41996,4,1996,[318  79 427 588 216],450,5,8018,4.015022533800701,40.0,0.0
41997,4,1997,[ 96 301 187 435 181],296,5,8023,4.015515515515515,0.0,0.0
41998,4,1998,[318  79 427 588 216],577,5,8028,4.016008004002001,40.0,0.0
41999,4,1999,[185 191 168 143 111],796,5,8033,4.0165,0.0,0.0
42000,4,2000,[174 118  56 269 175],655,0,8033,4.0144927536231885,0.0,0.0
42001,4,2001,[ 82 121 357 496  98],716,5,8038,4.014985014985015,20.0,0.0
42002,4,2002,[151 202 118  28  64],450,4,8042,4.014977533699451,20.0,0.0
42003,4,2003,[125 546 204  25 135],457,4,8046,4.014970059880239,0.0,0.0
42004,4,2004,[ 28 471 216 282 191],655,2,8048,4.013965087281796,0.0,0.0
42005,4,2005,[318  79 427 588 216],716,5,8053,4.014456630109671,40.0,0.0
42006,4,2006,[318  79 427 588 216],796,5,8058,4.014947683109118,40.0,0.0
42007,4,2007,[318  79 427 588 216],796,5,8063,4.015438247011952,40.0,0.0
42008,4,2008,[318  79 427 588 216],716,5,8068,4.015928322548532,40.0,0.0
42009,4,2009,[318  79 427 588 216],577,5,8073,4.016417910447761,40.0,0.0
42010,4,2010,[ 96 655 181 151  70],504,3,8076,4.015912481352561,0.0,0.0
42011,4,2011,[318  79 427 588 216],18,5,8081,4.0164015904572565,40.0,0.0
42012,4,2012,[204 276   9  50 182],629,5,8086,4.016890213611525,0.0,20.0
42013,4,2013,[318  79 427 588 216],18,5,8091,4.017378351539225,40.0,0.0
42014,4,2014,[318  79 427 588 216],577,5,8096,4.017866004962779,40.0,0.0
42015,4,2015,[ 28  88   8 222 187],796,4,8100,4.017857142857143,0.0,0.0
42016,4,2016,[318  79 427 588 216],450,5,8105,4.018344075359445,40.0,0.0
42017,4,2017,[302 427 288 144 191],450,4,8109,4.018334985133796,20.0,0.0
42018,4,2018,[  7 176 228 185  71],23,3,8112,4.017830609212481,0.0,0.0
42019,4,2019,[ 79 318 427 588 216],450,5,8117,4.018316831683168,40.0,0.0
42020,4,2020,[228 471 161 235 117],280,3,8120,4.017812963879268,0.0,0.0
42021,4,2021,[ 79 318 427 588 216],796,5,8125,4.018298714144412,40.0,0.0
42022,4,2022,[ 79 318 427 588 216],18,5,8130,4.018783984181908,40.0,0.0
42023,4,2023,[ 79 318 427 588 216],716,5,8135,4.019268774703558,40.0,0.0
42024,4,2024,[ 79 318 427 588 216],577,5,8140,4.019753086419753,40.0,0.0
42025,4,2025,[ 79 318 427 588 216],716,5,8145,4.020236920039487,40.0,0.0
42026,4,2026,[179 125  11  96 313],436,4,8149,4.020226936359151,0.0,0.0
42027,4,2027,[ 79 318 427 588 216],796,5,8154,4.020710059171598,40.0,0.0
42028,4,2028,[153 173  95 111  88],280,3,8157,4.020206998521439,0.0,0.0
42029,4,2029,[483 216 194  56 238],716,5,8162,4.020689655172414,0.0,0.0
42030,4,2030,[ 79 318 427 588 216],577,5,8167,4.0211718365337275,40.0,0.0
42031,4,2031,[282  50 318 427  11],655,3,8170,4.020669291338582,40.0,20.0
42032,4,2032,[ 79 318 427 588 216],450,5,8175,4.021151008362026,40.0,0.0
42033,4,2033,[ 28 238  64 403 181],450,5,8180,4.021632251720748,20.0,0.0
42034,4,2034,[655 117   8 228 215],655,0,8180,4.019656019656019,0.0,0.0
42035,4,2035,[328 182 210 211 423],450,4,8184,4.019646365422397,0.0,0.0
42036,4,2036,[185 275 435 483 211],389,5,8189,4.02012763868434,0.0,20.0
42037,4,2037,[234  22  82 748 265],807,4,8193,4.020117762512267,0.0,0.0
42038,4,2038,[ 79 318 427 588 216],450,5,8198,4.020598332515939,40.0,0.0
42039,4,2039,[238 294 275 176 471],716,3,8201,4.020098039215687,0.0,20.0
42040,4,2040,[ 79 318 427 588 216],796,5,8206,4.020578147966683,40.0,0.0
42041,4,2041,[322 748 151  64 588],401,0,8206,4.0186092066601375,20.0,0.0
42042,4,2042,[200 202 151 237  88],18,0,8206,4.016642192853647,0.0,0.0
42043,4,2043,[318  79 427 588 216],716,5,8211,4.017123287671233,40.0,0.0
42044,4,2044,[318  79 427 588 216],716,5,8216,4.01760391198044,40.0,0.0
42045,4,2045,[405 181  28 125 204],457,5,8221,4.018084066471164,0.0,0.0
42046,4,2046,[318  79 427 588 216],577,5,8226,4.018563751831949,40.0,0.0
42047,4,2047,[318  79 427 588 216],796,5,8231,4.01904296875,40.0,0.0
42048,4,2048,[318  79 427 588 216],18,5,8236,4.019521717911176,40.0,0.0
42049,4,2049,[318  79 427 588 216],577,5,8241,4.02,40.0,0.0
42050,4,2050,[271 289 258 117 185],655,1,8242,4.018527547537786,0.0,0.0
42051,4,2051,[318  79 427 588 216],18,5,8247,4.019005847953216,40.0,0.0
42052,4,2052,[176  97 117   9 286],344,2,8249,4.0180224062347785,0.0,20.0
42053,4,2053,[318  79 427 588 216],18,5,8254,4.018500486854918,40.0,0.0
42054,4,2054,[204 161 143 288 238],593,5,8259,4.018978102189781,0.0,0.0
42055,4,2055,[318  79 427 588 216],18,5,8264,4.019455252918288,40.0,0.0
42056,4,2056,[ 88 286 216 117  11],655,1,8265,4.01798736023335,0.0,20.0
42057,4,2057,[127 313  98 174 125],344,3,8268,4.017492711370262,0.0,20.0
42058,4,2058,[318  79 427 588 216],796,5,8273,4.017969888295289,40.0,0.0
42059,4,2059,[318  79 427 588 216],450,5,8278,4.018446601941748,40.0,0.0
42060,4,2060,[471 153 202 328 271],655,0,8278,4.01649684619117,0.0,0.0
42061,4,2061,[318  79 427 588 216],577,5,8283,4.0169738118331715,40.0,0.0
42062,4,2062,[318  79 427 588 216],450,5,8288,4.017450315075133,40.0,0.0
42063,4,2063,[742 172 403  69  22],450,5,8293,4.017926356589148,0.0,0.0
42064,4,2064,[427  96 597  70 132],269,2,8295,4.016949152542373,20.0,0.0
42065,4,2065,[118 151  71  88 181],344,1,8296,4.015488867376573,0.0,0.0
42066,4,2066,[ 64 211 187 197 302],655,3,8299,4.014997581035317,20.0,0.0
42067,4,2067,[200 195 176 655 211],504,4,8303,4.014990328820116,0.0,0.0
42068,4,2068,[318  79 427 588 216],577,5,8308,4.015466408893185,40.0,0.0
42069,4,2069,[172   8 237 655 197],878,2,8310,4.0144927536231885,0.0,0.0
42070,4,2070,[318  79 427 588 216],450,5,8315,4.01496861419604,40.0,0.0
42071,4,2071,[318  79 427 588 216],796,5,8320,4.015444015444015,40.0,0.0
42072,4,2072,[318  79 427 588 216],18,5,8325,4.015918958031838,40.0,0.0
42073,4,2073,[  1 742 222 405 597],938,2,8327,4.014946962391514,0.0,0.0
42074,4,2074,[318  79 427 588 216],796,5,8332,4.015421686746988,40.0,0.0
42075,4,2075,[211 132 153 204 186],450,4,8336,4.015414258188825,0.0,0.0
42076,4,2076,[183 318 161  97 294],796,3,8339,4.014925373134329,20.0,0.0
42077,4,2077,[318  79 427 588 216],716,5,8344,4.015399422521655,40.0,0.0
42078,4,2078,[ 96 435 185  50 427],450,5,8349,4.015873015873016,20.0,20.0
42079,4,2079,[318  79 427 588 216],716,5,8354,4.016346153846154,40.0,0.0
42080,4,2080,[187 300 127 191 100],389,4,8358,4.0163382988947625,0.0,40.0
42081,4,2081,[318  79 427 588 216],18,5,8363,4.016810758885687,40.0,0.0
42082,4,2082,[135 185  98 318 144],535,2,8365,4.015842534805569,20.0,0.0
42083,4,2083,[318  79 427 588 216],796,5,8370,4.016314779270633,40.0,0.0
42084,4,2084,[183 423 471 210 257],655,1,8371,4.014868105515587,0.0,0.0
42085,4,2085,[ 15 216 210 195 515],269,1,8372,4.0134228187919465,0.0,0.0
42086,4,2086,[185  71 322 276 173],401,2,8374,4.012458073790129,0.0,0.0
42087,4,2087,[168 181 235 185 143],716,4,8378,4.012452107279693,0.0,0.0
42088,4,2088,[ 79 318 427 588 216],450,5,8383,4.012924844423169,40.0,0.0
42089,4,2089,[237 121 100 117 183],577,5,8388,4.013397129186603,0.0,20.0
42090,4,2090,[ 79 318 427 588 216],796,5,8393,4.013868962219034,40.0,0.0
42091,4,2091,[180 173 427 405 235],269,1,8394,4.012428298279159,20.0,0.0
42092,4,2092,[ 64 222 273  15 508],655,2,8396,4.011466794075489,20.0,0.0
42093,4,2093,[302 144 210 222 186],450,2,8398,4.010506208213944,0.0,0.0
42094,4,2094,[ 79 318 427 588 216],796,5,8403,4.010978520286396,40.0,0.0
42095,4,2095,[ 79 318 427 588 216],18,5,8408,4.011450381679389,40.0,0.0
42096,4,2096,[ 79 318 427 588 216],796,5,8413,4.011921793037673,40.0,0.0
42097,4,2097,[ 79 318 427 588 216],716,5,8418,4.012392755004766,40.0,0.0
42098,4,2098,[655 196 135 210 186],450,2,8420,4.01143401619819,0.0,0.0
42099,4,2099,[100 300 204 186 179],389,3,8423,4.010952380952381,0.0,20.0
42100,4,2100,[ 22  89 302 313 183],655,4,8427,4.010947168015231,0.0,0.0
42101,4,2101,[118 357 265 117 546],450,4,8431,4.010941960038059,0.0,0.0
42102,4,2102,[ 98 100 215 238 118],330,5,8436,4.011412268188303,0.0,20.0
42103,4,2103,[ 79 318 427 588 216],716,5,8441,4.011882129277566,40.0,0.0
42104,4,2104,[ 79 318 427 588 216],716,5,8446,4.012351543942993,40.0,0.0
42105,4,2105,[ 79 318 427 588 216],577,5,8451,4.012820512820513,40.0,0.0
42106,4,2106,[151 211 168  71 186],504,4,8455,4.01281442809682,0.0,0.0
42107,4,2107,[ 79 318 427 588 216],577,5,8460,4.013282732447818,40.0,0.0
42108,4,2108,[ 97  95 265 483 180],716,4,8464,4.013276434329066,0.0,0.0
42109,4,2109,[ 79 318 427 588 216],796,5,8469,4.013744075829384,40.0,0.0
42110,4,2110,[ 79 318 427 588 216],716,5,8474,4.014211274277594,40.0,0.0
42111,4,2111,[245  64 151 194 125],450,5,8479,4.01467803030303,20.0,0.0
42112,4,2112,[ 79 318 427 588 216],716,5,8484,4.015144344533838,40.0,0.0
42113,4,2113,[ 56 286 238 117   8],796,3,8487,4.014664143803216,0.0,20.0
42114,4,2114,[210 276  56 496 173],269,3,8490,4.01418439716312,20.0,0.0
42115,4,2115,[153 196 357  64 143],716,5,8495,4.014650283553875,20.0,0.0
42116,4,2116,[ 79 318 427 588 216],18,5,8500,4.01511572980633,40.0,0.0
42117,4,2117,[258 427 125  70 405],450,5,8505,4.015580736543909,20.0,0.0
42118,4,2118,[ 79 318 427 588 216],450,5,8510,4.016045304388863,40.0,0.0
42119,4,2119,[265 302 322 742 117],450,5,8515,4.0165094339622645,0.0,0.0
42120,4,2120,[161 125 313 215 200],577,4,8519,4.016501650165017,0.0,0.0
42121,4,2121,[ 64 742 313  82 357],450,4,8523,4.016493873704053,20.0,0.0
42122,4,2122,[ 79 318 427 588 216],18,5,8528,4.016957136128121,40.0,0.0
42123,4,2123,[ 79 318 427 588 216],18,5,8533,4.017419962335216,40.0,0.0
42124,4,2124,[216 237  11 174 132],655,1,8534,4.016,0.0,0.0
42125,4,2125,[222 603 597 483 144],23,3,8537,4.01552210724365,20.0,0.0
42126,4,2126,[322 597 118  69  79],593,3,8540,4.015044663845792,0.0,0.0
42127,4,2127,[  1 132 427 197  28],389,5,8545,4.015507518796992,20.0,0.0
42128,4,2128,[ 11   8  69 245 182],280,3,8548,4.0150305307656176,0.0,0.0
42129,4,2129,[ 79 318 427 588 216],796,5,8553,4.015492957746479,40.0,0.0
42130,4,2130,[423 176  15 183   8],457,5,8558,4.015954950727358,0.0,0.0
42131,4,2131,[191 118  71 265 357],450,3,8561,4.01547842401501,0.0,0.0
42132,4,2132,[  8 301 300  56 121],11,3,8564,4.015002344116268,0.0,0.0
42133,4,2133,[ 79 318 427 588 216],577,5,8569,4.015463917525773,40.0,0.0
42134,4,2134,[ 79 318 427 588 216],796,5,8574,4.015925058548009,40.0,0.0
42135,4,2135,[ 79 318 427 588 216],18,5,8579,4.016385767790262,40.0,0.0
42136,4,2136,[237 603 118 132 300],716,4,8583,4.0163781001403835,20.0,0.0
42137,4,2137,[172 268  69  88 286],503,4,8587,4.016370439663237,0.0,20.0
42138,4,2138,[100 161 186 471 405],786,5,8592,4.016830294530155,0.0,20.0
42139,4,2139,[183   8 144  70 100],280,2,8594,4.01588785046729,0.0,20.0
42140,4,2140,[588 215 748 168 100],796,4,8598,4.015880429705745,0.0,20.0
42141,4,2141,[742 196 234  98 228],655,1,8599,4.014472455648926,0.0,0.0
42142,4,2142,[ 79 318 427 588 216],716,5,8604,4.014932337844144,40.0,0.0
42143,4,2143,[265 515 191 197  79],72,5,8609,4.0153917910447765,0.0,0.0
42144,4,2144,[ 79 318 427 588 216],796,5,8614,4.015850815850816,40.0,0.0
42145,4,2145,[151 300 202  71 194],450,4,8618,4.015843429636533,0.0,0.0
42146,4,2146,[318  88  70 117 182],655,2,8620,4.014904517931998,20.0,0.0
42147,4,2147,[  8 245  50 200 322],593,2,8622,4.0139664804469275,0.0,20.0
42148,4,2148,[300 322 121  71 118],504,4,8626,4.013959981386692,0.0,0.0
42149,4,2149,[125 678 183 322 245],280,1,8627,4.0125581395348835,0.0,0.0
42150,4,2150,[ 79 318 427 588 216],18,5,8632,4.01301720130172,40.0,0.0
42151,4,2151,[301 215 265 302 121],535,3,8635,4.012546468401487,0.0,0.0
42152,4,2152,[180  64 135 172 215],457,5,8640,4.013005109150023,20.0,0.0
42153,4,2153,[742 118 235 294 288],450,2,8642,4.0120705663881155,0.0,0.0
42154,4,2154,[180   4 194 568 322],450,4,8646,4.012064965197216,0.0,0.0
42155,4,2155,[286 234 210 143 228],786,4,8650,4.012059369202226,0.0,20.0
42156,4,2156,[197 144 515 174  50],655,2,8652,4.011126564673157,0.0,20.0
42157,4,2157,[118 268 183 186 275],655,2,8654,4.010194624652456,0.0,20.0
42158,4,2158,[183 176 222 483 135],151,3,8657,4.0097267253358035,0.0,0.0
42159,4,2159,[ 79 318 427 588 216],18,5,8662,4.010185185185185,40.0,0.0
42160,4,2160,[ 79 318 427 588 216],577,5,8667,4.010643220731143,40.0,0.0
42161,4,2161,[ 96 265 273 269 435],450,4,8671,4.01063829787234,0.0,0.0
42162,4,2162,[234 168 288 222 186],264,5,8676,4.011095700416089,0.0,0.0
42163,4,2163,[ 79 318 427 588 216],716,5,8681,4.011552680221811,40.0,0.0
42164,4,2164,[ 82   8 742 211  96],655,0,8681,4.0096997690531175,0.0,0.0
42165,4,2165,[174 258 176 117 121],344,2,8683,4.008771929824562,0.0,0.0
42166,4,2166,[235 385 144  71 180],280,4,8687,4.008767881864329,0.0,0.0
42167,4,2167,[318  79 427 588 216],577,5,8692,4.009225092250922,40.0,0.0
42168,4,2168,[135 181 276 175 546],457,4,8696,4.009220839096358,0.0,0.0
42169,4,2169,[318  79 427 588 216],796,5,8701,4.009677419354839,40.0,0.0
42170,4,2170,[210 435 405   7  50],655,1,8702,4.008291110087518,0.0,20.0
42171,4,2171,[318  79 427 588 216],716,5,8707,4.008747697974218,40.0,0.0
42172,4,2172,[318  79 427 588 216],450,5,8712,4.009203865623562,40.0,0.0
42173,4,2173,[318  79 427 588 216],796,5,8717,4.009659613615455,40.0,0.0
42174,4,2174,[173 597 121 144 153],593,4,8721,4.009655172413793,0.0,0.0
42175,4,2175,[ 97  82 496 100 161],786,5,8726,4.010110294117647,20.0,20.0
42176,4,2176,[ 79 318 427 588 216],796,5,8731,4.010564997703262,40.0,0.0
42177,4,2177,[  8 427 496 655 588],577,5,8736,4.011019283746556,40.0,0.0
42178,4,2178,[ 79 318 427 588 216],18,5,8741,4.011473152822395,40.0,0.0
42179,4,2179,[ 79 318 427 588 216],450,5,8746,4.011926605504587,40.0,0.0
42180,4,2180,[ 79 318 427 588 216],18,5,8751,4.012379642365887,40.0,0.0
42181,4,2181,[237 475 187 121 173],269,2,8753,4.011457378551787,0.0,0.0
42182,4,2182,[172   7 185  50 294],256,3,8756,4.01099404489235,0.0,20.0
42183,4,2183,[ 79 318 427 588 216],18,5,8761,4.011446886446887,40.0,0.0
42184,4,2184,[ 79 318 427 588 216],796,5,8766,4.011899313501144,40.0,0.0
42185,4,2185,[196 597  98 300  70],450,5,8771,4.01235132662397,0.0,0.0
42186,4,2186,[186  89 117  25 182],450,3,8774,4.011888431641518,0.0,0.0
42187,4,2187,[144 185  22  70   7],535,3,8777,4.011425959780621,0.0,0.0
42188,4,2188,[200 265 302   7 403],450,4,8781,4.011420740063956,0.0,0.0
42189,4,2189,[121 515 294   1 322],733,1,8782,4.010045662100457,0.0,0.0
42190,4,2190,[318  79 427 588 216],577,5,8787,4.010497489730716,40.0,0.0
42191,4,2191,[185  88 118 496 238],151,4,8791,4.010492700729927,20.0,0.0
42192,4,2192,[273  69 423 185 282],236,4,8795,4.010487916096671,0.0,0.0
42193,4,2193,[318  79 427 588 216],716,5,8800,4.010938924339107,40.0,0.0
42194,4,2194,[403 194 568 435   4],450,4,8804,4.010933940774487,0.0,0.0
42195,4,2195,[ 64 194  15 127 405],72,4,8808,4.0109289617486334,20.0,20.0
42196,4,2196,[405 275 238  28 546],796,3,8811,4.010468821119709,0.0,20.0
42197,4,2197,[234   4  98 202 237],18,1,8812,4.0090991810737036,0.0,0.0
42198,4,2198,[742  69 111 172 301],655,1,8813,4.007730786721237,0.0,0.0
42199,4,2199,[200 234 182 100 153],264,5,8818,4.008181818181818,0.0,20.0
42200,4,2200,[151 301 187   1  22],796,3,8821,4.007723761926397,0.0,0.0
42201,4,2201,[318  79 427 588 216],716,5,8826,4.008174386920981,40.0,0.0
42202,4,2202,[318  79 427 588 216],577,5,8831,4.008624602814344,40.0,0.0
42203,4,2203,[ 64 121 151 427 496],450,4,8835,4.008620689655173,60.0,0.0
42204,4,2204,[427 172  82  22 475],655,2,8837,4.007709750566893,20.0,0.0
42205,4,2205,[318  79 427 588 216],450,5,8842,4.00815956482321,40.0,0.0
42206,4,2206,[ 88  64 318 132 172],716,5,8847,4.008608971454463,40.0,0.0
42207,4,2207,[742  98 179  15 568],577,2,8849,4.007699275362318,0.0,0.0
42208,4,2208,[183 181 588  95 742],577,5,8854,4.0081484834766865,0.0,0.0
42209,4,2209,[191 748 211 127 202],796,4,8858,4.0081447963800905,0.0,20.0
42210,4,2210,[117 588  95 211 483],796,4,8862,4.008141112618724,0.0,0.0
42211,4,2211,[318  79 427 588 216],18,5,8867,4.008589511754069,40.0,0.0
42212,4,2212,[176  25 748 172  70],450,4,8871,4.008585630366019,0.0,0.0
42213,4,2213,[318  79 427 588 216],716,5,8876,4.00903342366757,40.0,0.0
42214,4,2214,[318  79 427 588 216],577,5,8881,4.009480812641083,40.0,0.0
42215,4,2215,[318  79 427 588 216],577,5,8886,4.009927797833935,40.0,0.0
42216,4,2216,[323 118 185 180 269],796,2,8888,4.009021199819576,0.0,0.0
42217,4,2217,[318  79 427 588 216],716,5,8893,4.009467989179441,40.0,0.0
42218,4,2218,[318  79 427 588 216],450,5,8898,4.009914375844975,40.0,0.0
42219,4,2219,[121 301 286  70 183],593,5,8903,4.010360360360361,0.0,20.0
42220,4,2220,[423   4 328 276 125],655,1,8904,4.009004952723998,0.0,0.0
42221,4,2221,[174 288  89   9 748],256,5,8909,4.0094509450945095,0.0,0.0
42222,4,2222,[ 79 318 427 588 216],577,5,8914,4.009896536212326,40.0,0.0
42223,4,2223,[ 79 318 427 588 216],450,5,8919,4.010341726618705,40.0,0.0
42224,4,2224,[ 79 318 427 588 216],450,5,8924,4.0107865168539325,40.0,0.0
42225,4,2225,[238 151 196 182 288],450,4,8928,4.010781671159029,0.0,0.0
42226,4,2226,[197 228 655 100  97],796,1,8929,4.009429726088909,0.0,20.0
42227,4,2227,[ 79 318 427 588 216],577,5,8934,4.009874326750449,40.0,0.0
42228,4,2228,[275 172 187  22 100],796,4,8938,4.009869896814715,0.0,40.0
42229,4,2229,[ 79 318 427 588 216],796,5,8943,4.010313901345292,40.0,0.0
42230,4,2230,[183 282  98 423 181],716,3,8946,4.009861048857015,0.0,0.0
42231,4,2231,[ 79 318 427 588 216],577,5,8951,4.010304659498208,40.0,0.0
42232,4,2232,[546 210  22  95 385],577,3,8954,4.009852216748769,0.0,0.0
42233,4,2233,[ 79 318 427 588 216],577,5,8959,4.0102954341987465,40.0,0.0
42234,4,2234,[ 79 318 427 588 216],18,5,8964,4.010738255033557,40.0,0.0
42235,4,2235,[ 79 318 427 588 216],450,5,8969,4.011180679785331,40.0,0.0
42236,4,2236,[216 603 135 427 168],707,1,8970,4.009834599910595,40.0,0.0
42237,4,2237,[200 328 174 273 471],655,2,8972,4.00893655049151,0.0,0.0
42238,4,2238,[200 191 237  89 210],655,3,8975,4.008485931219294,0.0,0.0
42239,4,2239,[195  12   4  70 265],151,4,8979,4.008482142857143,0.0,0.0
42240,4,2240,[ 79 318 427 588 216],577,5,8984,4.00892458723784,40.0,0.0
42241,4,2241,[405 174 216 176 121],151,3,8987,4.008474576271187,0.0,0.0
42242,4,2242,[ 79 318 427 588 216],577,5,8992,4.008916629514044,40.0,0.0
42243,4,2243,[385  82 403 181 237],796,4,8996,4.008912655971479,0.0,0.0
42244,4,2244,[202  11 655 215 117],655,0,8996,4.007126948775055,0.0,0.0
42245,4,2245,[ 69 318   7 228 483],655,2,8998,4.0062333036509346,20.0,0.0
42246,4,2246,[191 228 568 183 200],655,3,9001,4.0057854917668,0.0,0.0
42247,4,2247,[111 200 186 215   8],18,2,9003,4.004893238434164,0.0,0.0
42248,4,2248,[ 79 318 427 588 216],577,5,9008,4.00533570475767,40.0,0.0
42249,4,2249,[ 79 318 427 588 216],577,5,9013,4.005777777777777,40.0,0.0
42250,4,2250,[ 79 318 427 588 216],450,5,9018,4.006219458018658,40.0,0.0
42251,4,2251,[ 79 318 427 588 216],450,5,9023,4.006660746003552,40.0,0.0
42252,4,2252,[210 204 294 678 117],401,2,9025,4.005770084332002,0.0,0.0
42253,4,2253,[ 69 471 216 111 143],389,2,9027,4.004880212954747,0.0,0.0
42254,4,2254,[ 79 318 427 588 216],18,5,9032,4.005321507760532,40.0,0.0
42255,4,2255,[238 483 183 168 597],269,3,9035,4.004875886524823,0.0,0.0
42256,4,2256,[ 79 318 427 588 216],577,5,9040,4.005316792202038,40.0,0.0
42257,4,2257,[ 79 318 427 588 216],450,5,9045,4.005757307351638,40.0,0.0
42258,4,2258,[216 180 200  15 603],450,3,9048,4.00531208499336,20.0,0.0
42259,4,2259,[286 588 174  89 216],450,5,9053,4.005752212389381,0.0,20.0
42260,4,2260,[ 79 318 427 588 216],716,5,9058,4.006191950464396,40.0,0.0
42261,4,2261,[  1 168  25  98 423],18,3,9061,4.005747126436781,0.0,0.0
42262,4,2262,[ 79 318 427 588 216],796,5,9066,4.006186478126381,40.0,0.0
42263,4,2263,[197 234 132  50 191],389,5,9071,4.006625441696113,0.0,20.0
42264,4,2264,[318 182 181 200  22],655,3,9074,4.006181015452539,20.0,0.0
42265,4,2265,[186 423 258 322  50],796,3,9077,4.0057369814651365,0.0,20.0
42266,4,2266,[258 588 423 471 275],450,5,9082,4.006175562417291,0.0,20.0
42267,4,2267,[153 405 186 202 183],796,4,9086,4.006172839506172,0.0,0.0
42268,4,2268,[ 79 318 427 588 216],716,5,9091,4.00661084178052,40.0,0.0
42269,4,2269,[ 79 318 427 588 216],796,5,9096,4.00704845814978,40.0,0.0
42270,4,2270,[258 183  64 222 234],655,2,9098,4.006164685160722,20.0,0.0
42271,4,2271,[194  96  56 258 204],457,5,9103,4.006602112676056,0.0,0.0
42272,4,2272,[151 357  64   7 275],457,5,9108,4.007039155301364,20.0,20.0
42273,4,2273,[ 79 318 427 588 216],18,5,9113,4.007475813544415,40.0,0.0
42274,4,2274,[268 161 475 179 132],655,1,9114,4.006153846153846,0.0,0.0
42275,4,2275,[153   9 135 100 276],269,4,9118,4.006151142355009,0.0,20.0
42276,4,2276,[289 195 597 204 257],807,4,9122,4.0061484409310495,0.0,0.0
42277,4,2277,[187 211 435  98 742],655,2,9124,4.005267778753292,0.0,0.0
42278,4,2278,[588 288 117 403 118],450,3,9127,4.004826678367706,0.0,0.0
42279,4,2279,[182 603 258 185 655],655,3,9130,4.004385964912281,20.0,0.0
42280,4,2280,[222 385 118  64 168],457,5,9135,4.004822446295484,20.0,0.0
42281,4,2281,[ 79  69 132 357   4],344,4,9139,4.004820333041192,0.0,0.0
42282,4,2282,[181 194 144   7 322],450,5,9144,4.005256241787122,0.0,0.0
42283,4,2283,[568 275 508 333 302],655,2,9146,4.004378283712785,0.0,20.0
42284,4,2284,[ 79 318 427 588 216],716,5,9151,4.004814004376367,40.0,0.0
42285,4,2285,[ 79 318 427 588 216],577,5,9156,4.005249343832021,40.0,0.0
42286,4,2286,[202 210  11 483 748],280,2,9158,4.004372540445999,0.0,0.0
42287,4,2287,[ 79 318 427 588 216],450,5,9163,4.0048076923076925,40.0,0.0
42288,4,2288,[202  12  89 318 385],450,5,9168,4.00524246395806,20.0,0.0
42289,4,2289,[597 588   1 234 496],807,4,9172,4.0052401746724895,20.0,0.0
42290,4,2290,[ 79 318 427 588 216],716,5,9177,4.005674378000873,40.0,0.0
42291,4,2291,[ 79 318 427 588 216],450,5,9182,4.006108202443281,40.0,0.0
42292,4,2292,[ 82 197  22 655 181],280,1,9183,4.004797208896642,0.0,0.0
42293,4,2293,[204 211 357 403  12],18,3,9186,4.004359197907585,0.0,0.0
42294,4,2294,[186 282 127 405  64],796,4,9190,4.004357298474946,20.0,20.0
42295,4,2295,[ 79 318 427 588 216],577,5,9195,4.004790940766551,40.0,0.0
42296,4,2296,[ 79 318 427 588 216],796,5,9200,4.0052242054854155,40.0,0.0
42297,4,2297,[ 79 318 427 588 216],450,5,9205,4.005657093124456,40.0,0.0
42298,4,2298,[ 79 318 427 588 216],716,5,9210,4.006089604175728,40.0,0.0
42299,4,2299,[403   1  71 271 176],796,4,9214,4.006086956521739,0.0,0.0
42300,4,2300,[237 181 174  56  64],72,3,9217,4.005649717514125,20.0,0.0
42301,4,2301,[234 742 328 100 202],796,2,9219,4.0047784535186794,0.0,20.0
42302,4,2302,[ 79 318 427 588 216],577,5,9224,4.005210594876249,40.0,0.0
42303,4,2303,[235 597 204 182   1],450,4,9228,4.005208333333333,0.0,0.0
42304,4,2304,[  4 273 245 200 176],450,2,9230,4.004338394793926,0.0,0.0
42305,4,2305,[ 79 318 427 588 216],716,5,9235,4.0047701647875105,40.0,0.0
42306,4,2306,[ 79 318 427 588 216],716,5,9240,4.005201560468141,40.0,0.0
42307,4,2307,[197  89   4 271 546],796,4,9244,4.005199306759099,0.0,0.0
42308,4,2308,[ 79 318 427 588 216],796,5,9249,4.005630142919013,40.0,0.0
42309,4,2309,[483 322  88 423 174],151,4,9253,4.005627705627705,0.0,0.0
42310,4,2310,[ 79 318 427 588 216],18,5,9258,4.006057983556902,40.0,0.0
42311,4,2311,[195 186 405 357 183],151,2,9260,4.005190311418685,0.0,0.0
42312,4,2312,[275 186 269 210  98],655,2,9262,4.004323389537397,0.0,20.0
42313,4,2313,[ 79 318 427 588 216],577,5,9267,4.004753673292999,40.0,0.0
42314,4,2314,[ 79 318 427 588 216],450,5,9272,4.0051835853131745,40.0,0.0
42315,4,2315,[257 204 300  28 385],716,4,9276,4.005181347150259,0.0,0.0
42316,4,2316,[ 88 186 300 496 483],389,2,9278,4.004315925766077,20.0,0.0
42317,4,2317,[210  70 423 222 435],450,3,9281,4.003882657463331,0.0,0.0
42318,4,2318,[ 79 318 427 588 216],18,5,9286,4.004312203536007,40.0,0.0
42319,4,2319,[215 546 176 100 403],280,1,9287,4.00301724137931,0.0,20.0
42320,4,2320,[ 79 318 427 588 216],716,5,9292,4.003446790176648,40.0,0.0
42321,4,2321,[742 546 182 276 204],593,2,9294,4.002583979328166,0.0,0.0
42322,4,2322,[ 79 318 427 588 216],716,5,9299,4.003013344812742,40.0,0.0
42323,4,2323,[ 79 318 427 588 216],577,5,9304,4.0034423407917386,40.0,0.0
42324,4,2324,[ 79 318 427 588 216],796,5,9309,4.0038709677419355,40.0,0.0
42325,4,2325,[  1 265 328 216  70],151,4,9313,4.003869303525366,0.0,0.0
42326,4,2326,[ 79 318 427 588 216],796,5,9318,4.0042973785990545,40.0,0.0
42327,4,2327,[ 79 318 427 588 216],796,5,9323,4.004725085910653,40.0,0.0
42328,4,2328,[196 235 117 121 258],344,1,9324,4.003434950622585,0.0,0.0
42329,4,2329,[ 97 153 423 210  50],504,3,9327,4.003004291845493,0.0,20.0
42330,4,2330,[318  79 427 588 216],716,5,9332,4.003432003432003,40.0,0.0
42331,4,2331,[318  79 427 588 216],450,5,9337,4.003859348198971,40.0,0.0
42332,4,2332,[294  97 496  64 483],707,2,9339,4.003000428632662,40.0,0.0
42333,4,2333,[318  79 427 588 216],716,5,9344,4.003427592116538,40.0,0.0
42334,4,2334,[289 127 313 546  98],693,3,9347,4.0029978586723765,0.0,20.0
42335,4,2335,[111  96 183   7 508],655,1,9348,4.001712328767123,0.0,0.0
42336,4,2336,[118 286 196 176  28],389,2,9350,4.000855798031664,0.0,20.0
42337,4,2337,[195 405  89 588 289],807,4,9354,4.000855431993156,0.0,0.0
42338,4,2338,[294 597 100   1 234],450,4,9358,4.000855066267635,0.0,20.0
42339,4,2339,[ 79 318 427 588 216],716,5,9363,4.001282051282051,40.0,0.0
42340,4,2340,[ 79 318 427 588 216],796,5,9368,4.001708671507902,40.0,0.0
42341,4,2341,[196 202  56 655 186],577,4,9372,4.001707941929975,0.0,0.0
42342,4,2342,[ 79 318 427 588 216],716,5,9377,4.002134016218523,40.0,0.0
42343,4,2343,[161 186 357  71   7],450,3,9380,4.001706484641638,0.0,0.0
42344,4,2344,[ 79 318 427 588 216],796,5,9385,4.002132196162047,40.0,0.0
42345,4,2345,[210 546 183 153  79],280,3,9388,4.001705029838022,0.0,0.0
42346,4,2346,[ 79 318 427 588 216],577,5,9393,4.002130379207499,40.0,0.0
42347,4,2347,[ 12  64 197 121 202],450,4,9397,4.002129471890971,20.0,0.0
42348,4,2348,[385 187 117  98 245],796,4,9401,4.002128565346956,0.0,0.0
42349,4,2349,[ 79 318 427 588 216],18,5,9406,4.002553191489362,40.0,0.0
42350,4,2350,[ 79 318 427 588 216],796,5,9411,4.002977456401531,40.0,0.0
42351,4,2351,[405 143 423  88  95],786,5,9416,4.003401360544218,0.0,0.0
42352,4,2352,[ 79 318 427 588 216],577,5,9421,4.003824904377391,40.0,0.0
42353,4,2353,[ 89 318 185   4 515],18,2,9423,4.002973661852167,20.0,0.0
42354,4,2354,[ 79 318 427 588 216],18,5,9428,4.003397027600849,40.0,0.0
42355,4,2355,[191  97 181  95 173],798,4,9432,4.00339558573854,0.0,0.0
42356,4,2356,[  7 597 180 546 742],457,3,9435,4.00296987696224,0.0,0.0
42357,4,2357,[257 197 269  56 403],655,0,9435,4.0012722646310435,0.0,0.0
42358,4,2358,[302 237 181 471 153],655,1,9436,4.0,0.0,0.0
42359,4,2359,[318  79 427 588 216],18,5,9441,4.000423728813559,40.0,0.0
42360,4,2360,[318  79 427 588 216],716,5,9446,4.000847098686997,40.0,0.0
42361,4,2361,[  1 496 269 215 258],796,3,9449,4.000423370025402,20.0,0.0
42362,4,2362,[228 258 191  50  79],23,4,9453,4.0004231908590775,0.0,20.0
42363,4,2363,[435 216  98 100  79],11,3,9456,4.0,0.0,20.0
42364,4,2364,[271 186  71 328 204],796,4,9460,4.0,0.0,0.0
42365,4,2365,[496 187 286 197 211],796,2,9462,3.9991546914623837,20.0,20.0
42366,4,2366,[ 89 237  88 117 111],796,5,9467,3.999577524292353,0.0,0.0
42367,4,2367,[318  79 427 588 216],450,5,9472,4.0,40.0,0.0
42368,4,2368,[318  79 427 588 216],796,5,9477,4.000422119037569,40.0,0.0
42369,4,2369,[318  79 427 588 216],18,5,9482,4.00084388185654,40.0,0.0
42370,4,2370,[204 143 151 121  69],151,5,9487,4.001265288907634,0.0,0.0
42371,4,2371,[318  79 427 588 216],577,5,9492,4.001686340640809,40.0,0.0
42372,4,2372,[ 82 427 182 403 187],269,3,9495,4.001264222503161,20.0,0.0
42373,4,2373,[403 471 234  82 515],807,4,9499,4.001263689974726,0.0,0.0
42374,4,2374,[125 286 234 135 603],450,3,9502,4.000842105263158,20.0,20.0
42375,4,2375,[318  79 427 588 216],18,5,9507,4.001262626262626,40.0,0.0
42376,4,2376,[318  79 427 588 216],450,5,9512,4.001682793437106,40.0,0.0
42377,4,2377,[ 56 202 175  50   8],18,4,9516,4.001682085786375,0.0,20.0
42378,4,2378,[318  79 427 588 216],450,5,9521,4.002101723413199,40.0,0.0
42379,4,2379,[183  82 121 127 235],457,4,9525,4.0021008403361344,0.0,20.0
42380,4,2380,[ 56 678 125 257  70],504,3,9528,4.001679966400672,0.0,0.0
42381,4,2381,[245 313  69 301 333],224,2,9530,4.000839630562552,0.0,0.0
42382,4,2382,[ 50 176  97 271 194],796,4,9534,4.00083927822073,0.0,20.0
42383,4,2383,[197 276 234  15  98],878,3,9537,4.0004194630872485,0.0,0.0
42384,4,2384,[496  89 204  25 748],151,4,9541,4.00041928721174,20.0,0.0
42385,4,2385,[111 222  70 427   1],151,5,9546,4.000838222967309,20.0,0.0
42386,4,2386,[322 176 202 289 173],786,4,9550,4.000837871805614,0.0,0.0
42387,4,2387,[ 95 234 197  56 282],280,2,9552,4.0,0.0,0.0
42388,4,2388,[ 12 258 268 328 173],629,4,9556,4.0,0.0,0.0
42389,4,2389,[216 200 174 237 496],18,3,9559,3.999581589958159,20.0,0.0
42390,4,2390,[748  69 235 273  50],450,3,9562,3.999163529903806,0.0,20.0
42391,4,2391,[ 79 318 427 588 216],716,5,9567,3.9995819397993313,40.0,0.0
42392,4,2392,[ 79 318 427 588 216],450,5,9572,4.0,40.0,0.0
42393,4,2393,[132 143 286 197 127],389,3,9575,3.999582289055973,0.0,40.0
42394,4,2394,[ 22 423 125 111 333],655,0,9575,3.997912317327766,0.0,0.0
42395,4,2395,[ 89 118 151 153 143],450,4,9579,3.9979131886477464,0.0,0.0
42396,4,2396,[483 228 475  98  96],296,5,9584,3.998331247392574,0.0,0.0
42397,4,2397,[210  88  98 403 172],256,4,9588,3.9983319432860718,0.0,0.0
42398,4,2398,[ 79 318 427 588 216],577,5,9593,3.9987494789495623,40.0,0.0
42399,4,2399,[  4  50 228 483 603],716,4,9597,3.99875,20.0,20.0
42400,4,2400,[ 79 318 427 588 216],716,5,9602,3.999167013744273,40.0,0.0
42401,4,2401,[ 79 318 427 588 216],18,5,9607,3.999583680266445,40.0,0.0
42402,4,2402,[ 79 318 427 588 216],18,5,9612,4.0,40.0,0.0
42403,4,2403,[ 79 318 427 588 216],796,5,9617,4.000415973377704,40.0,0.0
42404,4,2404,[ 79 318 427 588 216],450,5,9622,4.000831600831601,40.0,0.0
42405,4,2405,[118 197 313  56 318],280,2,9624,4.0,20.0,0.0
42406,4,2406,[ 79 318 427 588 216],450,5,9629,4.000415454923141,40.0,0.0
42407,4,2407,[271  98 187 237 173],796,5,9634,4.000830564784053,0.0,0.0
42408,4,2408,[173 168 222 483  70],716,5,9639,4.001245330012453,0.0,0.0
42409,4,2409,[ 79 318 427 588 216],796,5,9644,4.001659751037344,40.0,0.0
42410,4,2410,[ 79 318 427 588 216],18,5,9649,4.002073828287018,40.0,0.0
42411,4,2411,[546 172 568 357  82],716,4,9653,4.002072968490879,0.0,0.0
42412,4,2412,[ 79 318 427 588 216],450,5,9658,4.002486531288852,40.0,0.0
42413,4,2413,[ 79 318 427 588 216],18,5,9663,4.002899751449876,40.0,0.0
42414,4,2414,[216 187  11  97 265],450,5,9668,4.003312629399586,0.0,0.0
42415,4,2415,[ 79 318 427 588 216],18,5,9673,4.003725165562914,40.0,0.0
42416,4,2416,[196 173 186 197 603],796,3,9676,4.0033098882912705,20.0,0.0
42417,4,2417,[161 268 427 435  79],655,2,9678,4.002481389578164,20.0,0.0
42418,4,2418,[132 496 748  79 161],807,5,9683,4.002893757751137,20.0,0.0
42419,4,2419,[194 143  25  82  50],151,4,9687,4.002892561983471,0.0,20.0
42420,4,2420,[182 215   9 288 187],655,2,9689,4.002065262288311,0.0,0.0
42421,4,2421,[222 301 161   4 187],796,4,9693,4.0020644095788604,0.0,0.0
42422,4,2422,[234 742 257  79 588],796,3,9696,4.001650846058605,0.0,0.0
42423,4,2423,[483 655 175 191  22],457,5,9701,4.002062706270627,0.0,0.0
42424,4,2424,[603 118 300  12 195],796,5,9706,4.002474226804123,20.0,0.0
42425,4,2425,[172  89 301 508 357],344,5,9711,4.002885408079143,0.0,0.0
42426,4,2426,[ 79 318 427 588 216],716,5,9716,4.00329625051504,40.0,0.0
42427,4,2427,[ 79 318 427 588 216],577,5,9721,4.003706754530477,40.0,0.0
42428,4,2428,[200 118 195 215 597],450,3,9724,4.003293536434747,0.0,0.0
42429,4,2429,[ 79 196 216 132 204],344,5,9729,4.003703703703704,0.0,0.0
42430,4,2430,[121  15 194   1 748],151,4,9733,4.003702180172769,0.0,0.0
42431,4,2431,[ 79 318 427 588 216],577,5,9738,4.004111842105263,40.0,0.0
42432,4,2432,[ 79 318 427 588 216],450,5,9743,4.0045211672831895,40.0,0.0
42433,4,2433,[318 153 238 294  88],655,1,9744,4.00328677074774,20.0,0.0
42434,4,2434,[ 79 318 427 588 216],796,5,9749,4.003696098562628,40.0,0.0
42435,4,2435,[ 79 318 427 588 216],577,5,9754,4.004105090311987,40.0,0.0
42436,4,2436,[ 50  69 313 125 100],344,2,9756,4.003282724661469,0.0,40.0
42437,4,2437,[546  88 313  70 176],503,5,9761,4.003691550451189,0.0,0.0
42438,4,2438,[318  79 427 588 216],796,5,9766,4.00410004100041,40.0,0.0
42439,4,2439,[318  79 427 588 216],450,5,9771,4.004508196721312,40.0,0.0
42440,4,2440,[318  79 427 588 216],450,5,9776,4.0049160180253995,40.0,0.0
42441,4,2441,[318  79 427 588 216],450,5,9781,4.0053235053235055,40.0,0.0
42442,4,2442,[357 269 135 301 265],655,2,9783,4.004502660663119,0.0,0.0
42443,4,2443,[403  28   4 216 168],450,4,9787,4.004500818330605,0.0,0.0
42444,4,2444,[ 56 237 471 194 174],716,4,9791,4.004498977505112,0.0,0.0
42445,4,2445,[318  79 427 588 216],18,5,9796,4.004905968928863,40.0,0.0
42446,4,2446,[ 50 483 111  69  98],796,5,9801,4.005312627707397,0.0,20.0
42447,4,2447,[496 153  28 300 318],450,5,9806,4.005718954248366,40.0,0.0
42448,4,2448,[318  79 427 588 216],716,5,9811,4.0061249489587585,40.0,0.0
42449,4,2449,[318  79 427 588 216],577,5,9816,4.006530612244898,40.0,0.0
42450,4,2450,[318  79 427 588 216],716,5,9821,4.006935944512444,40.0,0.0
42451,4,2451,[318  79 427 588 216],577,5,9826,4.007340946166395,40.0,0.0
42452,4,2452,[235 238 294 132 172],23,3,9829,4.006930289441501,0.0,0.0
42453,4,2453,[318  79 427 588 216],577,5,9834,4.007334963325183,40.0,0.0
42454,4,2454,[204 234 423  22  64],577,4,9838,4.007331975560081,20.0,0.0
42455,4,2455,[172  70  56 118 271],72,2,9840,4.006514657980456,0.0,0.0
42456,4,2456,[597 427  22  69 186],796,4,9844,4.006512006512007,20.0,0.0
42457,4,2457,[282 222 172 265 183],236,2,9846,4.005695687550855,0.0,0.0
42458,4,2458,[294 179  69 258 655],450,5,9851,4.006100040666937,0.0,0.0
42459,4,2459,[ 79 318 427 588 216],796,5,9856,4.006504065040651,40.0,0.0
42460,4,2460,[174 228 211  70 313],450,5,9861,4.006907761072735,0.0,0.0
42461,4,2461,[588  11 237 275 195],450,5,9866,4.0073111291632815,0.0,20.0
42462,4,2462,[ 79 318 427 588 216],796,5,9871,4.0077141697117336,40.0,0.0
42463,4,2463,[742 181 271 568  64],655,1,9872,4.0064935064935066,20.0,0.0
42464,4,2464,[ 79 318 427 588 216],18,5,9877,4.006896551724138,40.0,0.0
42465,4,2465,[ 79 318 427 588 216],450,5,9882,4.007299270072993,40.0,0.0
42466,4,2466,[ 79 318 427 588 216],716,5,9887,4.007701661937576,40.0,0.0
42467,4,2467,[ 97 515 228 318 118],72,3,9890,4.007293354943274,20.0,0.0
42468,4,2468,[ 79 318 427 588 216],716,5,9895,4.007695423248279,40.0,0.0
42469,4,2469,[135 301 194 258  11],450,4,9899,4.007692307692308,0.0,0.0
42470,4,2470,[ 79 318 427 588 216],577,5,9904,4.008093889113719,40.0,0.0
42471,4,2471,[ 79 318 427 588 216],577,5,9909,4.008495145631068,40.0,0.0
42472,4,2472,[ 79 318 427 588 216],18,5,9914,4.008896077638496,40.0,0.0
42473,4,2473,[ 12 210  56 204 471],450,4,9918,4.0088924818108325,0.0,0.0
42474,4,2474,[ 79 318 427 588 216],796,5,9923,4.009292929292929,40.0,0.0
42475,4,2475,[546  97 117  56 144],796,4,9927,4.009289176090468,0.0,0.0
42476,4,2476,[ 22 197 328 187 268],629,4,9931,4.00928542591845,0.0,0.0
42477,4,2477,[ 79 318 427 588 216],577,5,9936,4.009685230024213,40.0,0.0
42478,4,2478,[ 50   1 181 197 143],401,2,9938,4.008874546187979,0.0,20.0
42479,4,2479,[435 471 238 237 403],450,5,9943,4.009274193548387,0.0,0.0
42480,4,2480,[ 79 318 427 588 216],450,5,9948,4.009673518742442,40.0,0.0
42481,4,2481,[118  56 257  70 273],655,1,9949,4.008460918614021,0.0,0.0
42482,4,2482,[117  82  89  22  96],756,3,9952,4.008054772452678,0.0,0.0
42483,4,2483,[118 197 151 257 132],457,4,9956,4.00805152979066,0.0,0.0
42484,4,2484,[ 79 318 427 588 216],716,5,9961,4.0084507042253525,40.0,0.0
42485,4,2485,[ 56 742  22 195  98],450,5,9966,4.008849557522124,0.0,0.0
42486,4,2486,[ 69 318 300 235 228],807,4,9970,4.0088459991958185,20.0,0.0
42487,4,2487,[ 79 318 427 588 216],716,5,9975,4.009244372990354,40.0,0.0
42488,4,2488,[ 79 318 427 588 216],716,5,9980,4.009642426677381,40.0,0.0
42489,4,2489,[  4 235  96 144 196],450,3,9983,4.009236947791164,0.0,0.0
42490,4,2490,[135  25 235 568 153],330,4,9987,4.009233239662786,0.0,0.0
42491,4,2491,[151 202 357 228  88],23,1,9988,4.008025682182986,0.0,0.0
42492,4,2492,[ 11 568 403 127 234],280,2,9990,4.007220216606498,0.0,20.0
42493,4,2493,[678   4 202  96 483],280,2,9992,4.006415396952686,0.0,0.0
42494,4,2494,[ 97  96 100  28 215],577,5,9997,4.006813627254509,0.0,20.0
42495,4,2495,[318 235 234  95  56],716,4,10001,4.006810897435898,20.0,0.0
42496,4,2496,[143  12 228  88 210],577,1,10002,4.005606728073689,0.0,0.0
42497,4,2497,[200 423 191 179 182],18,4,10006,4.005604483586869,0.0,0.0
42498,4,2498,[257 185 118 172 357],796,5,10011,4.0060024009603845,0.0,0.0
42499,4,2499,[275 144   7  25 597],450,4,10015,4.006,0.0,20.0
42500,4,2500,[211 173  98  56 121],535,3,10018,4.0055977608956415,0.0,0.0
42501,4,2501,[ 70  28 216 603 748],11,3,10021,4.00519584332534,20.0,0.0
42502,4,2502,[318  79 427 588 216],716,5,10026,4.005593288054335,40.0,0.0
42503,4,2503,[204 435  79 197 265],450,5,10031,4.0059904153354635,0.0,0.0
42504,4,2504,[318  79 427 588 216],577,5,10036,4.006387225548902,40.0,0.0
42505,4,2505,[318  79 427 588 216],18,5,10041,4.006783719074222,40.0,0.0
42506,4,2506,[318  79 427 588 216],577,5,10046,4.007179896290387,40.0,0.0
42507,4,2507,[318  79 427 588 216],18,5,10051,4.007575757575758,40.0,0.0
42508,4,2508,[ 70 127 275 202  98],450,5,10056,4.007971303308091,0.0,40.0
42509,4,2509,[423 301 286  22 121],796,3,10059,4.007569721115538,0.0,20.0
42510,4,2510,[176 181 143 258 257],457,4,10063,4.0075667064914375,0.0,0.0
42511,4,2511,[597 143 168 403 200],450,4,10067,4.007563694267516,0.0,0.0
42512,4,2512,[318  79 427 588 216],716,5,10072,4.007958615200955,40.0,0.0
42513,4,2513,[ 50 238  15 234  98],655,2,10074,4.007159904534606,0.0,20.0
42514,4,2514,[568 132 301  64 179],655,2,10076,4.006361829025845,20.0,0.0
42515,4,2515,[318  79 427 588 216],577,5,10081,4.006756756756757,40.0,0.0
42516,4,2516,[318  79 427 588 216],796,5,10086,4.00715137067938,40.0,0.0
42517,4,2517,[318  79 427 588 216],450,5,10091,4.007545671167593,40.0,0.0
42518,4,2518,[318  79 427 588 216],796,5,10096,4.0079396585946805,40.0,0.0
42519,4,2519,[318  79 427 588 216],577,5,10101,4.008333333333334,40.0,0.0
42520,4,2520,[286 588  56 235 508],280,4,10105,4.0083300277667595,0.0,20.0
42521,4,2521,[318  79 427 588 216],796,5,10110,4.008723235527359,40.0,0.0
42522,4,2522,[172 238 568 322 118],450,4,10114,4.008719778042013,0.0,0.0
42523,4,2523,[176 276  79 216 195],655,3,10117,4.008320126782884,0.0,0.0
42524,4,2524,[385 215  97 197 318],796,3,10120,4.007920792079208,20.0,0.0
42525,4,2525,[318  79 427 588 216],450,5,10125,4.008313539192399,40.0,0.0
42526,4,2526,[238 151 276  22 127],457,5,10130,4.008705975464978,0.0,20.0
42527,4,2527,[318  79 427 588 216],577,5,10135,4.009098101265823,40.0,0.0
42528,4,2528,[318  79 427 588 216],796,5,10140,4.0094899169632265,40.0,0.0
42529,4,2529,[318  79 427 588 216],796,5,10145,4.009881422924901,40.0,0.0
42530,4,2530,[318 153 125 385 117],450,5,10150,4.010272619517977,20.0,0.0
42531,4,2531,[ 28 268 301 357 211],655,1,10151,4.009083728278041,0.0,0.0
42532,4,2532,[127  97 423  64 125],450,5,10156,4.009474930911962,20.0,20.0
42533,4,2533,[318  79 427 588 216],796,5,10161,4.009865824782952,40.0,0.0
42534,4,2534,[286 322 597  56  12],796,3,10164,4.0094674556213015,0.0,20.0
42535,4,2535,[118 200 187 222 546],796,5,10169,4.009858044164038,0.0,0.0
42536,4,2536,[151 597 183 258 237],796,5,10174,4.0102483247930625,0.0,0.0
42537,4,2537,[423 117   1 180 235],292,4,10178,4.010244286840032,0.0,0.0
42538,4,2538,[318  79 427 588 216],577,5,10183,4.010634107916503,40.0,0.0
42539,4,2539,[ 50 195 185  56 111],236,3,10186,4.010236220472441,0.0,20.0
42540,4,2540,[318  79 427 588 216],18,5,10191,4.010625737898465,40.0,0.0
42541,4,2541,[483 215  89 121 238],655,2,10193,4.0098347757671124,0.0,0.0
42542,4,2542,[318  79 427 588 216],796,5,10198,4.010224144710971,40.0,0.0
42543,4,2543,[318  79 427 588 216],716,5,10203,4.01061320754717,40.0,0.0
42544,4,2544,[135   1 211 385 121],5,5,10208,4.0110019646365425,0.0,0.0
42545,4,2545,[235  25  70 228 153],450,3,10211,4.010604870384918,0.0,0.0
42546,4,2546,[357 211 265  50 118],796,4,10215,4.010600706713781,0.0,20.0
42547,4,2547,[318  79 427 588 216],796,5,10220,4.010989010989011,40.0,0.0
42548,4,2548,[318  79 427 588 216],450,5,10225,4.01137701059239,40.0,0.0
42549,4,2549,[183 568 515 300  12],655,2,10227,4.010588235294118,0.0,0.0
42550,4,2550,[318  79 427 588 216],716,5,10232,4.010976087808703,40.0,0.0
42551,4,2551,[357  88  64 183 245],796,4,10236,4.0109717868338555,20.0,0.0
42552,4,2552,[  8 186 210 183 471],457,5,10241,4.011359185272228,0.0,0.0
42553,4,2553,[318  79 427 588 216],577,5,10246,4.011746280344558,40.0,0.0
42554,4,2554,[182 237 403 210 357],796,4,10250,4.011741682974559,0.0,0.0
42555,4,2555,[174 195 496  64 143],236,2,10252,4.010954616588419,40.0,0.0
42556,4,2556,[318  79 427 588 216],18,5,10257,4.011341415721549,40.0,0.0
42557,4,2557,[ 15 435 269 153  64],629,4,10261,4.011336982017201,20.0,0.0
42558,4,2558,[175 216 289  50 186],655,2,10263,4.010550996483001,0.0,20.0
42559,4,2559,[318  79 427 588 216],796,5,10268,4.0109375,40.0,0.0
42560,4,2560,[318  79 427 588 216],450,5,10273,4.011323701679031,40.0,0.0
42561,4,2561,[318  79 427 588 216],450,5,10278,4.0117096018735365,40.0,0.0
42562,4,2562,[318  79 427 588 216],716,5,10283,4.012095200936403,40.0,0.0
42563,4,2563,[ 98 121  88 144 568],450,4,10287,4.012090483619345,0.0,0.0
42564,4,2564,[318  79 427 588 216],450,5,10292,4.012475633528265,40.0,0.0
42565,4,2565,[318  79 427 588 216],716,5,10297,4.012860483242401,40.0,0.0
42566,4,2566,[ 69 172 403 144  22],457,5,10302,4.013245033112582,0.0,0.0
42567,4,2567,[385 187 186 483 194],796,4,10306,4.0132398753894085,0.0,0.0
42568,4,2568,[318  79 427 588 216],450,5,10311,4.013623978201635,40.0,0.0
42569,4,2569,[385   8   9 275 742],344,3,10314,4.013229571984436,0.0,20.0
42570,4,2570,[318  79 427 588 216],796,5,10319,4.013613380007779,40.0,0.0
42571,4,2571,[322 196 258 180 153],504,4,10323,4.013608087091757,0.0,0.0
42572,4,2572,[ 70  64  96 222 196],716,4,10327,4.013602798289934,20.0,0.0
42573,4,2573,[197 300 153 275 423],716,5,10332,4.013986013986014,0.0,20.0
42574,4,2574,[215  82 385 546 185],457,4,10336,4.013980582524272,0.0,0.0
42575,4,2575,[318  79 427 588 216],450,5,10341,4.014363354037267,40.0,0.0
42576,4,2576,[318  79 427 588 216],450,5,10346,4.014745828482732,40.0,0.0
42577,4,2577,[318  79 427 588 216],18,5,10351,4.0151280062063615,40.0,0.0
42578,4,2578,[318  79 427 588 216],18,5,10356,4.015509887553315,40.0,0.0
42579,4,2579,[282 132 275 144  15],796,5,10361,4.015891472868217,0.0,20.0
42580,4,2580,[318  79 427 588 216],796,5,10366,4.016272762495157,40.0,0.0
42581,4,2581,[234 143 265 121 222],655,1,10367,4.015104570100697,0.0,0.0
42582,4,2582,[151 125  12 655 471],174,4,10371,4.015098722415796,0.0,0.0
42583,4,2583,[204 546 655 161 265],577,4,10375,4.015092879256966,0.0,0.0
42584,4,2584,[318  79 427 588 216],450,5,10380,4.015473887814314,40.0,0.0
42585,4,2585,[196  97   9 211 144],401,4,10384,4.015467904098995,0.0,0.0
42586,4,2586,[179  97 194 588 237],878,2,10386,4.014688828759181,0.0,0.0
42587,4,2587,[135 318 496  82 215],280,3,10389,4.0142967542503865,40.0,0.0
42588,4,2588,[237   8 121 132 597],796,5,10394,4.014677481653148,0.0,0.0
42589,4,2589,[ 79 318 427 588 216],450,5,10399,4.015057915057915,40.0,0.0
42590,4,2590,[144 196 265 588 385],457,5,10404,4.015438054805094,0.0,0.0
42591,4,2591,[275 435 318 603 215],450,5,10409,4.015817901234568,40.0,20.0
42592,4,2592,[ 79 318 427 588 216],450,5,10414,4.016197454685693,40.0,0.0
42593,4,2593,[196 181 322  22   4],344,2,10416,4.015420200462606,0.0,0.0
42594,4,2594,[588  79 301 127 100],796,3,10419,4.015028901734104,0.0,40.0
42595,4,2595,[423  79 151 174 286],236,3,10422,4.014637904468413,0.0,20.0
42596,4,2596,[228 222 357  15 121],786,3,10425,4.014247208317289,0.0,0.0
42597,4,2597,[ 79 318 427 588 216],716,5,10430,4.014626635873749,40.0,0.0
42598,4,2598,[153   8  71 678  69],280,4,10434,4.014621008080031,0.0,0.0
42599,4,2599,[176  69 153  82 144],280,2,10436,4.013846153846154,0.0,0.0
42600,4,2600,[ 79 318 427 588 216],577,5,10441,4.014225297962322,40.0,0.0
42601,4,2601,[ 79 318 427 588 216],450,5,10446,4.014604150653343,40.0,0.0
42602,4,2602,[ 79 318 427 588 216],577,5,10451,4.01498271225509,40.0,0.0
42603,4,2603,[ 79 318 427 588 216],577,5,10456,4.0153609831029184,40.0,0.0
42604,4,2604,[222 194   1  28  12],72,4,10460,4.015355086372361,0.0,0.0
42605,4,2605,[182  11 357 515 508],655,3,10463,4.014965464313123,0.0,0.0
42606,4,2606,[ 79 318 427 588 216],18,5,10468,4.015343306482547,40.0,0.0
42607,4,2607,[268  82 282 187   1],655,1,10469,4.014187116564417,0.0,0.0
42608,4,2608,[238  88 483 200   9],151,4,10473,4.01418167880414,0.0,0.0
42609,4,2609,[423 427 475 187 210],269,4,10477,4.014176245210728,20.0,0.0
42610,4,2610,[185  97  88 215 385],450,5,10482,4.01455381080046,0.0,0.0
42611,4,2611,[ 79 318 427 588 216],18,5,10487,4.014931087289433,40.0,0.0
42612,4,2612,[ 79 318 427 588 216],577,5,10492,4.0153080750095675,40.0,0.0
42613,4,2613,[ 79 318 427 588 216],450,5,10497,4.015684774292272,40.0,0.0
42614,4,2614,[ 79 318 427 588 216],450,5,10502,4.016061185468451,40.0,0.0
42615,4,2615,[357 215 185 210 300],716,5,10507,4.016437308868501,0.0,0.0
42616,4,2616,[ 79 318 427 588 216],18,5,10512,4.016813144822316,40.0,0.0
42617,4,2617,[ 79 318 427 588 216],18,5,10517,4.017188693659282,40.0,0.0
42618,4,2618,[ 25  96  12 385 216],450,4,10521,4.017182130584192,0.0,0.0
42619,4,2619,[322 471 121 132 288],344,2,10523,4.016412213740458,0.0,0.0
42620,4,2620,[597 176 282 568  98],796,5,10528,4.0167874856924835,0.0,0.0
42621,4,2621,[174 168 655 111  69],269,2,10530,4.016018306636155,0.0,0.0
42622,4,2622,[237 173  82 294 313],450,4,10534,4.016012199771255,0.0,0.0
42623,4,2623,[176   1 151 187 265],450,5,10539,4.016387195121951,0.0,0.0
42624,4,2624,[318  79 427 588 216],577,5,10544,4.016761904761905,40.0,0.0
42625,4,2625,[ 25 127 132 427 181],655,2,10546,4.015993907083016,20.0,20.0
42626,4,2626,[318  79 427 588 216],450,5,10551,4.016368481157214,40.0,0.0
42627,4,2627,[300 258 597 195 286],450,5,10556,4.016742770167427,0.0,20.0
42628,4,2628,[318  79 427 588 216],796,5,10561,4.01711677443895,40.0,0.0
42629,4,2629,[121 568 172 132 323],798,5,10566,4.017490494296578,0.0,0.0
42630,4,2630,[597 357 216 168   9],457,4,10570,4.017483846446218,0.0,0.0
42631,4,2631,[318  79 427 588 216],796,5,10575,4.017857142857143,40.0,0.0
42632,4,2632,[742 234 237 204 161],577,4,10579,4.017850360805165,0.0,0.0
42633,4,2633,[678 357 228 151 597],344,3,10582,4.017463933181473,0.0,0.0
42634,4,2634,[318  79 427 588 216],18,5,10587,4.017836812144212,40.0,0.0
42635,4,2635,[318  79 427 588 216],577,5,10592,4.018209408194234,40.0,0.0
42636,4,2636,[318  79 427 588 216],18,5,10597,4.018581721653394,40.0,0.0
42637,4,2637,[318  79 427 588 216],450,5,10602,4.018953752843063,40.0,0.0
42638,4,2638,[318  79 427 588 216],18,5,10607,4.019325502084123,40.0,0.0
42639,4,2639,[318  79 427 588 216],716,5,10612,4.0196969696969695,40.0,0.0
42640,4,2640,[127 258  12 194 318],457,5,10617,4.020068156001515,20.0,20.0
42641,4,2641,[ 50  96 187 568 172],450,5,10622,4.020439061317184,0.0,20.0
42642,4,2642,[357  95   8 748  56],796,5,10627,4.020809685962921,0.0,0.0
42643,4,2643,[100 294 216 183  25],577,5,10632,4.021180030257186,0.0,20.0
42644,4,2644,[318  79 427 588 216],716,5,10637,4.021550094517958,40.0,0.0
42645,4,2645,[200 273 215 423 172],450,3,10640,4.021164021164021,0.0,0.0
42646,4,2646,[318  79 427 588 216],577,5,10645,4.0215338118624855,40.0,0.0
42647,4,2647,[318  79 427 588 216],577,5,10650,4.02190332326284,40.0,0.0
42648,4,2648,[289 100 187 237 286],655,1,10651,4.02076255190638,0.0,40.0
42649,4,2649,[222 191 161 117   4],796,5,10656,4.021132075471698,0.0,0.0
42650,4,2650,[318  79 427 588 216],796,5,10661,4.021501320256507,40.0,0.0
42651,4,2651,[132 202  28 180 204],716,4,10665,4.021493212669683,0.0,0.0
42652,4,2652,[127   4 228 204  22],450,4,10669,4.021485111194874,0.0,20.0
42653,4,2653,[318  79 427 588 216],450,5,10674,4.021853805576488,40.0,0.0
42654,4,2654,[318  79 427 588 216],450,5,10679,4.022222222222222,40.0,0.0
42655,4,2655,[318  79 427 588 216],18,5,10684,4.022590361445783,40.0,0.0
42656,4,2656,[191 286 135 655 111],639,2,10686,4.0218291305984195,0.0,20.0
42657,4,2657,[318  79 427 588 216],796,5,10691,4.0221971407072985,40.0,0.0
42658,4,2658,[318  79 427 588 216],577,5,10696,4.022564874012787,40.0,0.0
42659,4,2659,[191   1 748 258 405],798,5,10701,4.022932330827068,0.0,0.0
42660,4,2660,[318  79 427 588 216],716,5,10706,4.023299511461857,40.0,0.0
42661,4,2661,[483 318  96 300  56],716,4,10710,4.023290758827949,20.0,0.0
42662,4,2662,[318  79 427 588 216],716,5,10715,4.023657529102516,40.0,0.0
42663,4,2663,[515  56 185   8  15],18,4,10719,4.023648648648648,0.0,0.0
42664,4,2664,[318  79 427 588 216],796,5,10724,4.024015009380863,40.0,0.0
42665,4,2665,[ 11 151 185 273 423],450,4,10728,4.024006001500375,0.0,0.0
42666,4,2666,[187 151 508  89 597],269,3,10731,4.0236220472440944,0.0,0.0
42667,4,2667,[300 111 427  22 182],450,5,10736,4.023988005997001,20.0,0.0
42668,4,2668,[ 79 318 427 588 216],450,5,10741,4.024353690520794,40.0,0.0
42669,4,2669,[ 79 318 427 588 216],450,5,10746,4.024719101123596,40.0,0.0
42670,4,2670,[ 79 318 427 588 216],796,5,10751,4.025084238113067,40.0,0.0
42671,4,2671,[475 168 111 100  88],269,3,10754,4.024700598802395,0.0,20.0
42672,4,2672,[483 265 185 180 294],716,4,10758,4.0246913580246915,0.0,0.0
42673,4,2673,[ 79 318 427 588 216],716,5,10763,4.025056095736724,40.0,0.0
42674,4,2674,[ 15 216 496 403 483],269,2,10765,4.024299065420561,20.0,0.0
42675,4,2675,[ 79 318 427 588 216],577,5,10770,4.024663677130045,40.0,0.0
42676,4,2676,[282  28 496  56  50],450,5,10775,4.025028016436309,20.0,20.0
42677,4,2677,[508   1   4 435 174],655,0,10775,4.02352501867065,0.0,0.0
42678,4,2678,[ 79 318 427 588 216],450,5,10780,4.023889511011571,40.0,0.0
42679,4,2679,[183  88 282 144  96],280,1,10781,4.022761194029851,0.0,0.0
42680,4,2680,[132 187 234 328 185],655,2,10783,4.022006713912719,0.0,0.0
42681,4,2681,[228   1  69 546 161],280,4,10787,4.02199850857569,0.0,0.0
42682,4,2682,[ 25 318 748  97   9],11,3,10790,4.021617592247484,20.0,0.0
42683,4,2683,[ 95 181 143  25 117],885,4,10794,4.021609538002981,0.0,0.0
42684,4,2684,[ 79 318 427 588 216],796,5,10799,4.021973929236499,40.0,0.0
42685,4,2685,[ 79 318 427 588 216],450,5,10804,4.022338049143708,40.0,0.0
42686,4,2686,[185  98 603 318 546],796,5,10809,4.02270189802754,40.0,0.0
42687,4,2687,[151 496 181 678 288],20,3,10812,4.022321428571429,20.0,0.0
42688,4,2688,[302 195 182 237 385],655,2,10814,4.021569356638156,0.0,0.0
42689,4,2689,[183  50 228 210 191],786,5,10819,4.021933085501859,0.0,20.0
42690,4,2690,[195 204 200 121 483],450,2,10821,4.02118171683389,0.0,0.0
42691,4,2691,[ 79 318 427 588 216],18,5,10826,4.021545319465082,40.0,0.0
42692,4,2692,[174 235 655 181 294],401,1,10827,4.0204233197177865,0.0,0.0
42693,4,2693,[ 79 318 427 588 216],796,5,10832,4.020786933927246,40.0,0.0
42694,4,2694,[282   4 238  79 405],655,1,10833,4.019666048237477,0.0,0.0
42695,4,2695,[ 79 318 427 588 216],577,5,10838,4.020029673590504,40.0,0.0
42696,4,2696,[ 79 318 427 588 216],577,5,10843,4.020393029291806,40.0,0.0
42697,4,2697,[ 79 318 427 588 216],18,5,10848,4.020756115641216,40.0,0.0
42698,4,2698,[742  71 211 161 423],796,3,10851,4.020377917747314,0.0,0.0
42699,4,2699,[ 79 318 427 588 216],796,5,10856,4.020740740740741,40.0,0.0
42700,4,2700,[ 79 318 427 588 216],18,5,10861,4.021103295075898,40.0,0.0
42701,4,2701,[222 191  15 144  70],457,5,10866,4.021465581051073,0.0,0.0
42702,4,2702,[185 603 269 187   4],18,2,10868,4.020717721050684,20.0,0.0
42703,4,2703,[172 301 427 173 265],535,3,10871,4.0203402366863905,20.0,0.0
42704,4,2704,[ 79 318 427 588 216],716,5,10876,4.020702402957486,40.0,0.0
42705,4,2705,[ 79 318 427 588 216],18,5,10881,4.021064301552107,40.0,0.0
42706,4,2706,[ 71  69 282 153 313],593,5,10886,4.021425932766901,0.0,0.0
42707,4,2707,[151 294 186  11 597],450,4,10890,4.0214180206794685,0.0,0.0
42708,4,2708,[ 79 318 427 588 216],716,5,10895,4.021779254337394,40.0,0.0
42709,4,2709,[ 79 318 427 588 216],796,5,10900,4.022140221402214,40.0,0.0
42710,4,2710,[172  70  96 125  97],450,5,10905,4.022500922168941,0.0,0.0
42711,4,2711,[ 79 318 427 588 216],796,5,10910,4.022861356932153,40.0,0.0
42712,4,2712,[195 423 237 153  71],450,4,10914,4.022852930335422,0.0,0.0
42713,4,2713,[238 127 234 216  98],18,4,10918,4.022844509948416,0.0,20.0
42714,4,2714,[ 79 318 427 588 216],450,5,10923,4.0232044198895025,40.0,0.0
42715,4,2715,[ 79 318 427 588 216],450,5,10928,4.023564064801178,40.0,0.0
42716,4,2716,[ 50 568 288 100 328],450,4,10932,4.023555391976444,0.0,40.0
42717,4,2717,[ 79 318 427 588 216],796,5,10937,4.023914643119941,40.0,0.0
42718,4,2718,[ 79 318 427 588 216],18,5,10942,4.0242736300110336,40.0,0.0
42719,4,2719,[357 175 117 200 144],457,5,10947,4.024632352941176,0.0,0.0
42720,4,2720,[ 79 318 427 588 216],716,5,10952,4.024990812201397,40.0,0.0
42721,4,2721,[ 79 318 427 588 216],577,5,10957,4.0253490080822925,40.0,0.0
42722,4,2722,[ 79 318 427 588 216],796,5,10962,4.025706940874036,40.0,0.0
42723,4,2723,[301 568 318  69 273],450,4,10966,4.025697503671072,20.0,0.0
42724,4,2724,[ 79 318 427 588 216],716,5,10971,4.026055045871559,40.0,0.0
42725,4,2725,[ 50  79 172 197 176],389,5,10976,4.026412325752018,0.0,20.0
42726,4,2726,[ 88 228  56 508 237],11,3,10979,4.026035936927026,0.0,0.0
42727,4,2727,[ 79 318 427 588 216],18,5,10984,4.026392961876833,40.0,0.0
42728,4,2728,[ 79 318 427 588 216],796,5,10989,4.0267497251740565,40.0,0.0
42729,4,2729,[275 294 153 181 234],23,3,10992,4.026373626373626,0.0,20.0
42730,4,2730,[  1 179 111 204 603],450,5,10997,4.026730135481508,20.0,0.0
42731,4,2731,[  4  88 269 568 357],796,4,11001,4.026720351390923,0.0,0.0
42732,4,2732,[ 79 318 427 588 216],716,5,11006,4.027076472740578,40.0,0.0
42733,4,2733,[ 79 318 427 588 216],450,5,11011,4.027432333577177,40.0,0.0
42734,4,2734,[ 15 176  79  82  70],457,5,11016,4.027787934186471,0.0,0.0
42735,4,2735,[215 100 496 168 196],535,5,11021,4.028143274853801,20.0,20.0
42736,4,2736,[ 69  12 197 496 121],450,4,11025,4.028132992327365,20.0,0.0
42737,4,2737,[194 435 273 748 117],450,4,11029,4.0281227173119065,0.0,0.0
42738,4,2738,[ 79 318 427 588 216],577,5,11034,4.028477546549836,40.0,0.0
42739,4,2739,[176  64 183 427 215],577,5,11039,4.028832116788321,40.0,0.0
42740,4,2740,[282  89 151 257 181],296,4,11043,4.02882159795695,0.0,0.0
42741,4,2741,[125  22  96 603 151],796,5,11048,4.0291757840991975,20.0,0.0
42742,4,2742,[ 79 318 427 588 216],716,5,11053,4.029529711994167,40.0,0.0
42743,4,2743,[234 333 742 328   9],796,2,11055,4.028790087463557,0.0,0.0
42744,4,2744,[ 79 318 427 588 216],716,5,11060,4.029143897996357,40.0,0.0
42745,4,2745,[ 79 318 427 588 216],577,5,11065,4.029497450837582,40.0,0.0
42746,4,2746,[568 183 235 118 405],716,2,11067,4.028758645795413,0.0,0.0
42747,4,2747,[ 79 318 427 588 216],18,5,11072,4.029112081513828,40.0,0.0
42748,4,2748,[127   9  64 423 111],236,5,11077,4.02946526009458,20.0,20.0
42749,4,2749,[ 64 300 234 301 196],151,5,11082,4.0298181818181815,20.0,0.0
42750,4,2750,[318 153 182 187 300],450,5,11087,4.03017084696474,20.0,0.0
42751,4,2751,[210 211 187 197 237],716,4,11091,4.0301598837209305,0.0,0.0
42752,4,2752,[403 181  82 197  88],655,0,11091,4.028695968034871,0.0,0.0
42753,4,2753,[ 82  98 179  69 121],577,4,11095,4.028685548293391,0.0,0.0
42754,4,2754,[215 211 195  15 191],18,3,11098,4.0283121597096185,0.0,0.0
42755,4,2755,[ 50 216 322 603 269],796,3,11101,4.027939042089986,20.0,20.0
42756,4,2756,[237 143 265 176 117],655,1,11102,4.026840768951759,0.0,0.0
42757,4,2757,[427  28 180 265 174],72,5,11107,4.027193618564177,20.0,0.0
42758,4,2758,[228 135 302 132 183],151,3,11110,4.026821312069591,0.0,0.0
42759,4,2759,[318  79 427 588 216],450,5,11115,4.0271739130434785,40.0,0.0
42760,4,2760,[100  89 328 175 288],655,1,11116,4.026077508149221,0.0,20.0
42761,4,2761,[  4 186 191 483 603],389,4,11120,4.026068066618392,20.0,0.0
42762,4,2762,[318  79 427 588 216],796,5,11125,4.026420557365182,40.0,0.0
42763,4,2763,[318  79 427 588 216],796,5,11130,4.026772793053546,40.0,0.0
42764,4,2764,[294 204 210  15 508],655,0,11130,4.025316455696203,0.0,0.0
42765,4,2765,[211  70 172 185 302],655,3,11133,4.0249457700650755,0.0,0.0
42766,4,2766,[ 79 318 427 588 216],450,5,11138,4.025298156848573,40.0,0.0
42767,4,2767,[161  88 655  12   8],280,3,11141,4.02492774566474,0.0,0.0
42768,4,2768,[ 79 318 427 588 216],796,5,11146,4.025279884434814,40.0,0.0
42769,4,2769,[405 117 678  69  96],807,3,11149,4.024909747292419,0.0,0.0
42770,4,2770,[ 79 318 427 588 216],450,5,11154,4.025261638397691,40.0,0.0
42771,4,2771,[183 153 238 423 496],450,5,11159,4.025613275613275,20.0,0.0
42772,4,2772,[269  50  71  82  70],23,2,11161,4.0248827984132705,0.0,20.0
42773,4,2773,[ 95 111 318 161 245],450,4,11165,4.024873828406633,20.0,0.0
42774,4,2774,[ 79 318 427 588 216],716,5,11170,4.025225225225225,40.0,0.0
42775,4,2775,[ 79 318 427 588 216],796,5,11175,4.025576368876081,40.0,0.0
42776,4,2776,[ 79 318 427 588 216],577,5,11180,4.025927259632697,40.0,0.0
42777,4,2777,[215 471 265 121 546],577,3,11183,4.0255579553635705,0.0,0.0
42778,4,2778,[748  88 300  28 121],450,4,11187,4.02554875854624,0.0,0.0
42779,4,2779,[322   1  22  69 215],450,5,11192,4.02589928057554,0.0,0.0
42780,4,2780,[ 79 318 427 588 216],450,5,11197,4.0262495505213955,40.0,0.0
42781,4,2781,[ 79 318 427 588 216],577,5,11202,4.0265995686556435,40.0,0.0
42782,4,2782,[132 302  15 273 100],655,2,11204,4.025871361839742,0.0,20.0
42783,4,2783,[475 200 508 238 302],269,4,11208,4.025862068965517,0.0,0.0
42784,4,2784,[301 181 318  82 234],796,2,11210,4.025134649910234,20.0,0.0
42785,4,2785,[118  96 187 117 125],796,5,11215,4.025484565685571,0.0,0.0
42786,4,2786,[318  79 427 588 216],716,5,11220,4.025834230355221,40.0,0.0
42787,4,2787,[318  79 427 588 216],716,5,11225,4.026183644189383,40.0,0.0
42788,4,2788,[568 194 202  95 173],389,2,11227,4.0254571531014705,0.0,0.0
42789,4,2789,[318  79 427 588 216],716,5,11232,4.025806451612903,40.0,0.0
42790,4,2790,[ 70  50 183  98  82],269,1,11233,4.024722321748477,0.0,20.0
42791,4,2791,[183 403 132 144 215],450,5,11238,4.025071633237823,0.0,0.0
42792,4,2792,[318  79 427 588 216],450,5,11243,4.025420694593627,40.0,0.0
42793,4,2793,[183  70 385 568 496],593,5,11248,4.025769506084467,20.0,0.0
42794,4,2794,[181 191  11  82  97],577,4,11252,4.0257602862254025,0.0,0.0
42795,4,2795,[318  79 427 588 216],716,5,11257,4.026108726752503,40.0,0.0
42796,4,2796,[301 127 183 496 181],450,5,11262,4.026456918126565,20.0,20.0
42797,4,2797,[235 172 194  71 435],807,3,11265,4.026090064331665,0.0,0.0
42798,4,2798,[423 196  97 174  64],450,5,11270,4.026438013576278,20.0,0.0
42799,4,2799,[204 185 286  28 258],655,1,11271,4.025357142857143,0.0,20.0
42800,4,2800,[515   1 174 187  88],655,2,11273,4.024634059264549,0.0,0.0
42801,4,2801,[181 185 121  71 211],450,3,11276,4.024268379728765,0.0,0.0
42802,4,2802,[ 79 318 427 588 216],577,5,11281,4.02461648234035,40.0,0.0
42803,4,2803,[200 655 118 202  11],457,5,11286,4.0249643366619114,0.0,0.0
42804,4,2804,[ 79 318 427 588 216],796,5,11291,4.025311942959002,40.0,0.0
42805,4,2805,[144 215 294  64 161],796,4,11295,4.025302922309337,20.0,0.0
42806,4,2806,[269 216 179 655   7],264,5,11300,4.025650160313502,0.0,0.0
42807,4,2807,[ 79 318 427 588 216],716,5,11305,4.025997150997151,40.0,0.0
42808,4,2808,[185 603 186 204 174],18,2,11307,4.025275898896404,20.0,0.0
42809,4,2809,[318 200 257  25   1],330,5,11312,4.025622775800712,20.0,0.0
42810,4,2810,[ 71  97 191 132 151],450,4,11316,4.025613660618997,0.0,0.0
42811,4,2811,[318  79 427 588 216],450,5,11321,4.0259601706970125,40.0,0.0
42812,4,2812,[318  79 427 588 216],450,5,11326,4.02630643441166,40.0,0.0
42813,4,2813,[ 25  95 200 168 215],330,4,11330,4.0262970859985785,0.0,0.0
42814,4,2814,[318  79 427 588 216],450,5,11335,4.0266429840142095,40.0,0.0
42815,4,2815,[318  79 427 588 216],450,5,11340,4.026988636363637,40.0,0.0
42816,4,2816,[258 197 211 194 271],796,3,11343,4.026624068157615,0.0,0.0
42817,4,2817,[ 50 288 655 174 423],655,1,11344,4.025550035486161,0.0,20.0
42818,4,2818,[288 215 180 127 282],457,5,11349,4.0258957076977655,0.0,20.0
42819,4,2819,[ 79 318 427 588 216],796,5,11354,4.026241134751773,40.0,0.0
42820,4,2820,[ 79 318 427 588 216],450,5,11359,4.026586316908897,40.0,0.0
42821,4,2821,[ 79 318 427 588 216],450,5,11364,4.026931254429483,40.0,0.0
42822,4,2822,[196 194 328 215  89],450,5,11369,4.027275947573504,0.0,0.0
42823,4,2823,[ 70 403 132 603  97],655,1,11370,4.026203966005665,20.0,0.0
42824,4,2824,[187 289  15   7 180],296,3,11373,4.025840707964602,0.0,0.0
42825,4,2825,[ 79 318 427 588 216],577,5,11378,4.026185421089879,40.0,0.0
42826,4,2826,[234 471 475 333 385],655,0,11378,4.024761230986912,0.0,0.0
42827,4,2827,[ 79 318 427 588 216],796,5,11383,4.025106082036775,40.0,0.0
42828,4,2828,[ 79 318 427 588 216],796,5,11388,4.025450689289501,40.0,0.0
42829,4,2829,[275  28 258  56  98],151,5,11393,4.025795053003534,0.0,20.0
42830,4,2830,[191 168 276 568 475],269,4,11397,4.025785941363476,0.0,0.0
42831,4,2831,[ 79 318 427 588 216],716,5,11402,4.026129943502825,40.0,0.0
42832,4,2832,[168 748  11  15 294],450,4,11406,4.026120720084716,0.0,0.0
42833,4,2833,[269 100 176 385 286],796,2,11408,4.025405786873677,0.0,40.0
42834,4,2834,[ 79 318 427 588 216],18,5,11413,4.025749559082892,40.0,0.0
42835,4,2835,[471 121 216 210 228],716,4,11417,4.02574047954866,0.0,0.0
42836,4,2836,[483   4 151 234 186],18,2,11419,4.025026436376454,0.0,0.0
42837,4,2837,[153 268 143 288 385],655,1,11420,4.023960535588443,0.0,0.0
42838,4,2838,[172  95   8  11 210],577,3,11423,4.023599859105318,0.0,0.0
42839,4,2839,[286 196 127 151 678],344,3,11426,4.023239436619718,0.0,40.0
42840,4,2840,[235  95 132  69 228],450,3,11429,4.022879267863428,0.0,0.0
42841,4,2841,[185 172 289 173 435],704,3,11432,4.022519352568613,0.0,0.0
42842,4,2842,[ 79 318 427 588 216],577,5,11437,4.02286317270489,40.0,0.0
42843,4,2843,[ 79 318 427 588 216],716,5,11442,4.023206751054852,40.0,0.0
42844,4,2844,[235 588 153 173 191],450,4,11446,4.0231985940246044,0.0,0.0
42845,4,2845,[ 88 423 275 385  98],796,5,11451,4.023541813070977,0.0,20.0
42846,4,2846,[ 25 282   1 313 276],593,2,11453,4.0228310502283104,0.0,0.0
42847,4,2847,[234  71 204 143 313],807,4,11457,4.022823033707865,0.0,0.0
42848,4,2848,[ 50 118 222 289 568],756,2,11459,4.022113022113022,0.0,20.0
42849,4,2849,[ 79 318 427 588 216],450,5,11464,4.022456140350878,40.0,0.0
42850,4,2850,[ 79 318 427 588 216],796,5,11469,4.0227990178884605,40.0,0.0
42851,4,2851,[ 79 318 427 588 216],796,5,11474,4.0231416549789625,40.0,0.0
42852,4,2852,[ 64  95 204   1  79],344,4,11478,4.023133543638275,20.0,0.0
42853,4,2853,[471 301 144  70 183],450,5,11483,4.023475823405747,0.0,0.0
42854,4,2854,[ 64 385 275  22 286],344,2,11485,4.02276707530648,20.0,40.0
42855,4,2855,[ 79 318 427 588 216],18,5,11490,4.023109243697479,40.0,0.0
42856,4,2856,[588 508  88 210   7],280,2,11492,4.022401120056003,0.0,0.0
42857,4,2857,[ 22 135 132  69 228],655,1,11493,4.021343596920924,0.0,0.0
42858,4,2858,[302 151   7 186 515],535,3,11496,4.020986358866737,0.0,0.0
42859,4,2859,[ 88  50 313 258 168],450,5,11501,4.021328671328671,0.0,20.0
42860,4,2860,[127 118  82 235 151],256,4,11505,4.021321216357917,0.0,20.0
42861,4,2861,[603   1 195 196 168],151,4,11509,4.021313766596785,20.0,0.0
42862,4,2862,[181 385 175 174 186],655,0,11509,4.019909186168355,0.0,0.0
42863,4,2863,[237 238 273  98  88],450,4,11513,4.019902234636872,0.0,0.0
42864,4,2864,[301 176 322 742 357],450,5,11518,4.020244328097731,0.0,0.0
42865,4,2865,[ 79 318 427 588 216],577,5,11523,4.020586182833217,40.0,0.0
42866,4,2866,[172 144 216 258 191],796,5,11528,4.020927799093129,0.0,0.0
42867,4,2867,[222 234 403 268 175],655,0,11528,4.019525801952581,0.0,0.0
42868,4,2868,[ 70 210 132 194  25],716,5,11533,4.0198675496688745,0.0,0.0
42869,4,2869,[302 182 111 196  70],450,5,11538,4.02020905923345,0.0,0.0
42870,4,2870,[ 79 318 427 588 216],577,5,11543,4.0205503308951585,40.0,0.0
42871,4,2871,[168 195 181 175 197],269,3,11546,4.020194986072424,0.0,0.0
42872,4,2872,[496 603 186 588 173],716,4,11550,4.020187956839541,40.0,0.0
42873,4,2873,[180 211 135 182 357],18,4,11554,4.020180932498261,0.0,0.0
42874,4,2874,[174 182  79 603 127],389,5,11559,4.020521739130435,20.0,20.0
42875,4,2875,[318  79 427 588 216],577,5,11564,4.02086230876217,40.0,0.0
42876,4,2876,[318  79 427 588 216],577,5,11569,4.021202641640598,40.0,0.0
42877,4,2877,[603 588 172  22  71],796,5,11574,4.021542738012509,20.0,0.0
42878,4,2878,[127 475 174 276 180],292,5,11579,4.021882598124349,0.0,20.0
42879,4,2879,[318  79 427 588 216],450,5,11584,4.022222222222222,40.0,0.0
42880,4,2880,[318  79 427 588 216],18,5,11589,4.022561610551891,40.0,0.0
42881,4,2881,[318  79 427 588 216],716,5,11594,4.022900763358779,40.0,0.0
42882,4,2882,[179 161 210 125 132],457,5,11599,4.023239680887964,0.0,0.0
42883,4,2883,[423 597 318  56 200],269,4,11603,4.023231622746186,20.0,0.0
42884,4,2884,[237 515 427 202 435],269,2,11605,4.022530329289428,20.0,0.0
42885,4,2885,[357 185 483 127 117],796,5,11610,4.022869022869023,0.0,20.0
42886,4,2886,[318  79 427 588 216],577,5,11615,4.0232074818150325,40.0,0.0
42887,4,2887,[318  79 427 588 216],796,5,11620,4.023545706371191,40.0,0.0
42888,4,2888,[318  79 427 588 216],450,5,11625,4.023883696780893,40.0,0.0
42889,4,2889,[318  79 427 588 216],716,5,11630,4.024221453287197,40.0,0.0
42890,4,2890,[302 655 597 135  15],269,2,11632,4.023521272915946,0.0,0.0
42891,4,2891,[318  79 427 588 216],450,5,11637,4.023858921161826,40.0,0.0
42892,4,2892,[196 357 215 655 546],450,5,11642,4.024196335983408,0.0,0.0
42893,4,2893,[200 151 237 202  50],330,5,11647,4.024533517622667,0.0,20.0
42894,4,2894,[183 265 427 483 588],450,4,11651,4.024525043177893,20.0,0.0
42895,4,2895,[427  89 300 182 161],655,3,11654,4.024171270718232,20.0,0.0
42896,4,2896,[318  79 427 588 216],796,5,11659,4.024508111839834,40.0,0.0
42897,4,2897,[318  79 427 588 216],577,5,11664,4.024844720496894,40.0,0.0
42898,4,2898,[117 265 181 496  88],716,5,11669,4.025181096929976,20.0,0.0
42899,4,2899,[318  79 427 588 216],577,5,11674,4.02551724137931,40.0,0.0
42900,4,2900,[318  79 427 588 216],18,5,11679,4.025853154084798,40.0,0.0
42901,4,2901,[568 234 185  82 216],457,5,11684,4.02618883528601,0.0,0.0
42902,4,2902,[200 313  79 195 100],655,3,11687,4.025835342748881,0.0,20.0
42903,4,2903,[ 95 183 186   1  70],5,5,11692,4.026170798898072,0.0,0.0
42904,4,2904,[318  79 427 588 216],577,5,11697,4.026506024096386,40.0,0.0
42905,4,2905,[318  79 427 588 216],716,5,11702,4.026841018582243,40.0,0.0
42906,4,2906,[546 265   1 210 597],450,4,11706,4.026831785345717,0.0,0.0
42907,4,2907,[ 22 195 427 143 423],807,4,11710,4.026822558459422,20.0,0.0
42908,4,2908,[423 183 385 174 228],457,5,11715,4.027157098659333,0.0,0.0
42909,4,2909,[ 25  28 121 195 111],716,4,11719,4.027147766323024,0.0,0.0
42910,4,2910,[186 300 144 135 357],693,3,11722,4.026794915836482,0.0,0.0
42911,4,2911,[194 328  28 275 269],796,3,11725,4.0264423076923075,0.0,20.0
42912,4,2912,[237 322  22 111 180],280,4,11729,4.026433230346721,0.0,0.0
42913,4,2913,[ 79 318 427 588 216],18,5,11734,4.026767330130405,40.0,0.0
42914,4,2914,[143  82  56 176 588],450,4,11738,4.026758147512864,0.0,0.0
42915,4,2915,[ 98  95  56 195 313],450,4,11742,4.026748971193416,0.0,0.0
42916,4,2916,[ 79 318 427 588 216],716,5,11747,4.027082619129242,40.0,0.0
42917,4,2917,[ 50 216 100 191 185],269,3,11750,4.026730637422893,0.0,40.0
42918,4,2918,[237 603 173  15 265],450,4,11754,4.02672147995889,20.0,0.0
42919,4,2919,[216 197  95 172 111],389,2,11756,4.026027397260274,0.0,0.0
42920,4,2920,[ 79 318 427 588 216],796,5,11761,4.026360835330366,40.0,0.0
42921,4,2921,[  1  97 211 271 111],655,0,11761,4.0249828884325805,0.0,0.0
42922,4,2922,[318  79 427 588 216],577,5,11766,4.025316455696203,40.0,0.0
42923,4,2923,[ 69 180 185  11 228],693,2,11768,4.024623803009576,0.0,0.0
42924,4,2924,[187  98 403 238  56],269,4,11772,4.024615384615385,0.0,0.0
42925,4,2925,[318  79 427 588 216],450,5,11777,4.024948735475051,40.0,0.0
42926,4,2926,[195 328 179  96 222],655,1,11778,4.023915271609156,0.0,0.0
42927,4,2927,[204 191 143 403 181],655,2,11780,4.023224043715847,0.0,0.0
42928,4,2928,[168 180 173 202 258],457,5,11785,4.023557528166609,0.0,0.0
42929,4,2929,[318  79 427 588 216],450,5,11790,4.023890784982935,40.0,0.0
42930,4,2930,[318  79 427 588 216],18,5,11795,4.024223814397817,40.0,0.0
42931,4,2931,[ 12 286 301   8 269],344,4,11799,4.0242155525238745,0.0,20.0
42932,4,2932,[194 265   8 179 496],878,3,11802,4.023866348448688,20.0,0.0
42933,4,2933,[ 12   9 269 275 118],344,4,11806,4.023858214042263,0.0,20.0
42934,4,2934,[228  25 333 328  70],655,0,11806,4.022487223168654,0.0,0.0
42935,4,2935,[172   9 185  11 508],269,3,11809,4.022138964577657,0.0,0.0
42936,4,2936,[302 172   8 655 508],269,2,11811,4.021450459652707,0.0,0.0
42937,4,2937,[403 423 151 215 568],330,5,11816,4.021783526208305,0.0,0.0
42938,4,2938,[202 318 286  25  97],401,4,11820,4.0217761143246005,20.0,20.0
42939,4,2939,[328 175 435 483 427],151,4,11824,4.021768707482993,20.0,0.0
42940,4,2940,[204  11  64 405 496],330,5,11829,4.022101326079564,40.0,0.0
42941,4,2941,[144 222   1 180 237],796,3,11832,4.021753908905507,0.0,0.0
42942,4,2942,[125  56  12 194  97],796,4,11836,4.021746517159361,0.0,0.0
42943,4,2943,[ 79 318 427 588 216],18,5,11841,4.022078804347826,40.0,0.0
42944,4,2944,[195 200 288   7 603],908,3,11844,4.021731748726656,20.0,0.0
42945,4,2945,[194 603 195 176  69],269,2,11846,4.0210454854039375,20.0,0.0
42946,4,2946,[300   1 127 286 211],796,2,11848,4.02035968781812,0.0,40.0
42947,4,2947,[318 238  97 435 197],18,5,11853,4.020691994572592,20.0,0.0
42948,4,2948,[318  79 427 588 216],716,5,11858,4.021024075957952,40.0,0.0
42949,4,2949,[546 655 273 237  95],796,3,11861,4.020677966101695,0.0,0.0
42950,4,2950,[ 79 318 427 588 216],18,5,11866,4.021009827177228,40.0,0.0
42951,4,2951,[ 96  50 215 127  22],280,3,11869,4.0206639566395665,0.0,40.0
42952,4,2952,[ 79 318 427 588 216],796,5,11874,4.020995597697257,40.0,0.0
42953,4,2953,[180 258 161 245 269],796,2,11876,4.02031144211239,0.0,0.0
42954,4,2954,[328  96 186 403 318],450,4,11880,4.020304568527918,20.0,0.0
42955,4,2955,[202 175 187  88 282],716,2,11882,4.019621109607578,0.0,0.0
42956,4,2956,[385  25 300 121 286],450,3,11885,4.0192762935407504,0.0,20.0
42957,4,2957,[ 12   8 471 333 222],655,0,11885,4.017917511832319,0.0,0.0
42958,4,2958,[508 172  22 515 435],269,2,11887,4.017235552551537,0.0,0.0
42959,4,2959,[318  79 427 588 216],450,5,11892,4.017567567567568,40.0,0.0
42960,4,2960,[117   1 268 288 111],174,3,11895,4.017223910840932,0.0,0.0
42961,4,2961,[318  79 427 588 216],450,5,11900,4.017555705604321,40.0,0.0
42962,4,2962,[318  79 427 588 216],18,5,11905,4.017887276409045,40.0,0.0
42963,4,2963,[318  79 427 588 216],450,5,11910,4.018218623481781,40.0,0.0
42964,4,2964,[121 546 100 597 496],796,4,11914,4.018212478920742,20.0,20.0
42965,4,2965,[318  79 427 588 216],796,5,11919,4.018543492919758,40.0,0.0
42966,4,2966,[318  79 427 588 216],577,5,11924,4.018874283788338,40.0,0.0
42967,4,2967,[ 25 127 117 275 471],716,4,11928,4.018867924528302,0.0,40.0
42968,4,2968,[176  25  71   1 496],577,5,11933,4.019198383294039,20.0,0.0
42969,4,2969,[318  79 427 588 216],716,5,11938,4.01952861952862,40.0,0.0
42970,4,2970,[318  79 427 588 216],450,5,11943,4.0198586334567485,40.0,0.0
42971,4,2971,[435 125 273 238 288],450,3,11946,4.019515477792732,0.0,0.0
42972,4,2972,[118  64 174 151 121],450,3,11949,4.019172552976791,20.0,0.0
42973,4,2973,[318  79 427 588 216],716,5,11954,4.019502353732347,40.0,0.0
42974,4,2974,[318  79 427 588 216],18,5,11959,4.019831932773109,40.0,0.0
42975,4,2975,[  1 276 405 234 257],457,4,11963,4.019825268817204,0.0,0.0
42976,4,2976,[100  50 286   8 181],878,2,11965,4.019146792072556,0.0,60.0
42977,4,2977,[328 125 200  28 496],450,4,11969,4.019140362659503,20.0,0.0
42978,4,2978,[269 132 496 597 275],450,5,11974,4.01946962067808,20.0,20.0
42979,4,2979,[405 234 568 228 258],655,0,11974,4.0181208053691275,0.0,0.0
42980,4,2980,[318  79 427 588 216],577,5,11979,4.018450184501845,40.0,0.0
42981,4,2981,[ 22 100 125 121 597],256,5,11984,4.018779342723005,0.0,20.0
42982,4,2982,[ 82 655 257   7 172],23,2,11986,4.018102581293999,0.0,0.0
42983,4,2983,[181 174 302 245 655],450,5,11991,4.01843163538874,0.0,0.0
42984,4,2984,[ 88 748  69 265  56],796,5,11996,4.018760469011725,0.0,0.0
42985,4,2985,[144 197 302 546 180],450,5,12001,4.019089082384461,0.0,0.0
42986,4,2986,[ 79 318 427 588 216],796,5,12006,4.019417475728155,40.0,0.0
42987,4,2987,[ 79 318 427 588 216],18,5,12011,4.019745649263721,40.0,0.0
42988,4,2988,[ 79 318 427 588 216],18,5,12016,4.0200736032117765,40.0,0.0
42989,4,2989,[ 79 318 427 588 216],450,5,12021,4.020401337792642,40.0,0.0
42990,4,2990,[742 172   9 118 483],280,3,12024,4.020060180541625,0.0,0.0
42991,4,2991,[  7 269 302 174  22],344,4,12028,4.020053475935829,0.0,0.0
42992,4,2992,[180 153 742   1 216],280,5,12033,4.0203808887403945,0.0,0.0
42993,4,2993,[318  79 427 588 216],716,5,12038,4.020708082832331,40.0,0.0
42994,4,2994,[197 179 135 210  11],457,5,12043,4.0210350584307175,0.0,0.0
42995,4,2995,[318  79 427 588 216],796,5,12048,4.021361815754339,40.0,0.0
42996,4,2996,[318  79 427 588 216],450,5,12053,4.021688355021689,40.0,0.0
42997,4,2997,[318  79 427 588 216],18,5,12058,4.022014676450968,40.0,0.0
42998,4,2998,[151 176   9 143 186],269,2,12060,4.021340446815605,0.0,0.0
42999,4,2999,[  4 286 748 216  50],796,4,12064,4.021333333333334,0.0,40.0
43000,4,3000,[423 496 286  15 235],330,5,12069,4.02165944685105,20.0,20.0
43001,4,3001,[185 318  89 132 191],151,4,12073,4.021652231845437,20.0,0.0
43002,4,3002,[ 96 118   8 132  79],796,5,12078,4.021978021978022,0.0,0.0
43003,4,3003,[216  56 318 173   7],457,5,12083,4.022303595206392,20.0,0.0
43004,4,3004,[294 597  79 180 186],450,4,12087,4.022296173044925,0.0,0.0
43005,4,3005,[132 176 216 403 318],504,3,12090,4.021956087824352,20.0,0.0
43006,4,3006,[144 191 234 597  28],23,0,12090,4.020618556701031,0.0,0.0
43007,4,3007,[121 258 161 588 403],807,4,12094,4.02061170212766,0.0,0.0
43008,4,3008,[ 79 318 427 588 216],18,5,12099,4.020937188434696,40.0,0.0
43009,4,3009,[ 70 151 194 200  98],151,4,12103,4.02093023255814,0.0,0.0
43010,4,3010,[204 176  12 183  96],344,5,12108,4.0212553968781135,0.0,0.0
43011,4,3011,[ 79 318 427 588 216],450,5,12113,4.021580345285525,40.0,0.0
43012,4,3012,[294  88 588 174  25],716,5,12118,4.021905077995354,0.0,0.0
43013,4,3013,[ 79 318 427 588 216],18,5,12123,4.022229595222296,40.0,0.0
43014,4,3014,[ 79 318 427 588 216],450,5,12128,4.022553897180763,40.0,0.0
43015,4,3015,[ 79 318 427 588 216],716,5,12133,4.0228779840848805,40.0,0.0
43016,4,3016,[313 237  22 385 121],577,5,12138,4.023201856148492,0.0,0.0
43017,4,3017,[568 173 197  28 182],450,5,12143,4.023525513585156,0.0,0.0
43018,4,3018,[318  79 427 588 216],577,5,12148,4.023848956608148,40.0,0.0
43019,4,3019,[195 125 288 234  89],655,1,12149,4.022847682119205,0.0,0.0
43020,4,3020,[ 79 318 427 588 216],796,5,12154,4.023171135385634,40.0,0.0
43021,4,3021,[200 100 289  98 238],786,5,12159,4.023494374586367,0.0,20.0
43022,4,3022,[118  28 333 423 546],174,2,12161,4.022825008269931,0.0,0.0
43023,4,3023,[ 79 318 427 588 216],450,5,12166,4.023148148148148,40.0,0.0
43024,4,3024,[ 79 318 427 588 216],716,5,12171,4.023471074380165,40.0,0.0
43025,4,3025,[ 79 318 427 588 216],450,5,12176,4.023793787177793,40.0,0.0
43026,4,3026,[ 22  56  88  70 496],450,5,12181,4.024116286752561,20.0,0.0
43027,4,3027,[ 79 318 427 588 216],450,5,12186,4.02443857331572,40.0,0.0
43028,4,3028,[174   7  15 182  79],256,5,12191,4.024760647078244,0.0,0.0
43029,4,3029,[357 204 403  71 200],796,5,12196,4.025082508250825,0.0,0.0
43030,4,3030,[318  79 427 588 216],18,5,12201,4.02540415704388,40.0,0.0
43031,4,3031,[318  79 427 588 216],796,5,12206,4.025725593667546,40.0,0.0
43032,4,3032,[265 403 118 172 423],796,5,12211,4.026046818331685,0.0,0.0
43033,4,3033,[288  50  64 286 427],123,1,12212,4.025049439683586,40.0,40.0
43034,4,3034,[318  79 427 588 216],450,5,12217,4.025370675453048,40.0,0.0
43035,4,3035,[318  79 427 588 216],716,5,12222,4.025691699604743,40.0,0.0
43036,4,3036,[185 175 176 202 197],655,1,12223,4.024695423114916,0.0,0.0
43037,4,3037,[318  79 427 588 216],18,5,12228,4.025016458196181,40.0,0.0
43038,4,3038,[ 15 357 118 282 204],457,5,12233,4.025337282000658,0.0,0.0
43039,4,3039,[318  79 427 588 216],450,5,12238,4.025657894736842,40.0,0.0
43040,4,3040,[318 185 568 258 100],450,5,12243,4.025978296612957,20.0,20.0
43041,4,3041,[144 153 191 210 597],450,4,12247,4.025969756738988,0.0,0.0
43042,4,3042,[183  50 111 215 405],457,4,12251,4.025961222477818,0.0,20.0
43043,4,3043,[180 318 271 200 121],796,4,12255,4.025952693823916,20.0,0.0
43044,4,3044,[318  79 427 588 216],450,5,12260,4.026272577996716,40.0,0.0
43045,4,3045,[318  79 427 588 216],577,5,12265,4.026592252133947,40.0,0.0
43046,4,3046,[ 98 197  69 153 125],18,3,12268,4.0262553331145385,0.0,0.0
43047,4,3047,[117 265 655   1 237],716,5,12273,4.0265748031496065,0.0,0.0
43048,4,3048,[423 300 222 301   1],450,4,12277,4.026566087241719,0.0,0.0
43049,4,3049,[318  79 427 588 216],716,5,12282,4.0268852459016395,40.0,0.0
43050,4,3050,[318  79 427 588 216],796,5,12287,4.027204195345789,40.0,0.0
43051,4,3051,[318  79 427 588 216],18,5,12292,4.027522935779817,40.0,0.0
43052,4,3052,[318  79 427 588 216],450,5,12297,4.027841467409106,40.0,0.0
43053,4,3053,[318  79 427 588 216],716,5,12302,4.028159790438769,40.0,0.0
43054,4,3054,[144 172 174 121 180],457,5,12307,4.0284779050736494,0.0,0.0
43055,4,3055,[318  79 427 588 216],450,5,12312,4.028795811518324,40.0,0.0
43056,4,3056,[318  79 427 588 216],577,5,12317,4.029113509977102,40.0,0.0
43057,4,3057,[318  79 427 588 216],577,5,12322,4.029431000654022,40.0,0.0
43058,4,3058,[318  79 427 588 216],716,5,12327,4.02974828375286,40.0,0.0
43059,4,3059,[222 181 655  79 300],693,1,12328,4.02875816993464,0.0,0.0
43060,4,3060,[175 151  98  25 196],716,4,12332,4.02874877491016,0.0,0.0
43061,4,3061,[286   7 135 265 742],450,4,12336,4.028739386022208,0.0,20.0
43062,4,3062,[111  56 301 202 228],151,5,12341,4.0290564805746,0.0,0.0
43063,4,3063,[ 82  95 181 546  15],796,4,12345,4.029046997389034,0.0,0.0
43064,4,3064,[588 197 185 191  95],796,4,12349,4.029037520391517,0.0,0.0
43065,4,3065,[182 202  70 265  11],457,5,12354,4.029354207436399,0.0,0.0
43066,4,3066,[318  79 427 588 216],577,5,12359,4.029670687968699,40.0,0.0
43067,4,3067,[318  79 427 588 216],716,5,12364,4.029986962190352,40.0,0.0
43068,4,3068,[318  79 427 588 216],796,5,12369,4.03030303030303,40.0,0.0
43069,4,3069,[318  79 427 588 216],796,5,12374,4.030618892508143,40.0,0.0
43070,4,3070,[318  79 427 588 216],18,5,12379,4.0309345490068385,40.0,0.0
43071,4,3071,[276 403  96 210 117],256,4,12383,4.030924479166667,0.0,0.0
43072,4,3072,[318  79 427 588 216],577,5,12388,4.03123983078425,40.0,0.0
43073,4,3073,[318  79 427 588 216],18,5,12393,4.0315549772283665,40.0,0.0
43074,4,3074,[318  79 427 588 216],450,5,12398,4.031869918699187,40.0,0.0
43075,4,3075,[318  79 427 588 216],716,5,12403,4.032184655396619,40.0,0.0
43076,4,3076,[318  79 427 588 216],577,5,12408,4.032499187520312,40.0,0.0
43077,4,3077,[318  79 427 588 216],18,5,12413,4.032813515269655,40.0,0.0
43078,4,3078,[655  28 435 265 289],236,3,12416,4.032478077297824,0.0,0.0
43079,4,3079,[318  79 427 588 216],450,5,12421,4.032792207792208,40.0,0.0
43080,4,3080,[318  79 427 588 216],450,5,12426,4.033106134371957,40.0,0.0
43081,4,3081,[172 333 176 294 180],796,3,12429,4.032770927968851,0.0,0.0
43082,4,3082,[318  79 427 588 216],716,5,12434,4.033084657800844,40.0,0.0
43083,4,3083,[121  25 245  97  88],504,4,12438,4.033073929961089,0.0,0.0
43084,4,3084,[318  79 427 588 216],716,5,12443,4.033387358184765,40.0,0.0
43085,4,3085,[185 176   7  96 515],655,2,12445,4.032728451069345,0.0,0.0
43086,4,3086,[471 215 234  96 197],280,1,12446,4.031746031746032,0.0,0.0
43087,4,3087,[318  79 427 588 216],450,5,12451,4.032059585492228,40.0,0.0
43088,4,3088,[318  79 427 588 216],18,5,12456,4.032372936225316,40.0,0.0
43089,4,3089,[318  79 427 588 216],450,5,12461,4.032686084142394,40.0,0.0
43090,4,3090,[234 357 100 237 288],504,3,12464,4.032351989647363,0.0,20.0
43091,4,3091,[216  15 202  25 100],65,4,12468,4.032341526520052,0.0,20.0
43092,4,3092,[ 89 117  97 302 237],655,2,12470,4.031684448755254,0.0,0.0
43093,4,3093,[405 435   9  64 153],151,3,12473,4.031351001939237,20.0,0.0
43094,4,3094,[235 357 200 655 182],269,4,12477,4.031340872374798,0.0,0.0
43095,4,3095,[318  79 427 588 216],796,5,12482,4.031653746770026,40.0,0.0
43096,4,3096,[153 121 294 200 204],450,3,12485,4.03132063287052,0.0,0.0
43097,4,3097,[318  79 427 588 216],716,5,12490,4.0316333118140735,40.0,0.0
43098,4,3098,[ 79 483 427 153 588],23,5,12495,4.031945788964182,20.0,0.0
43099,4,3099,[144 427  64 118  69],716,3,12498,4.031612903225806,40.0,0.0
43100,4,3100,[313 181 127 427 435],450,5,12503,4.031925185424057,20.0,20.0
43101,4,3101,[  1 176 222 127 748],796,4,12507,4.031914893617022,0.0,20.0
43102,4,3102,[100 216 185 318 385],401,4,12511,4.031904608443442,20.0,20.0
43103,4,3103,[318  79 427 588 216],450,5,12516,4.032216494845361,40.0,0.0
43104,4,3104,[318  79 427 588 216],450,5,12521,4.032528180354268,40.0,0.0
43105,4,3105,[111 238 245 282 210],593,3,12524,4.032195750160978,0.0,0.0
43106,4,3106,[ 98 515 186 174 427],18,5,12529,4.0325072417122625,20.0,0.0
43107,4,3107,[234 211  79 471 183],450,4,12533,4.032496782496782,0.0,0.0
43108,4,3108,[111 210   7 588  50],786,5,12538,4.032807976841428,0.0,20.0
43109,4,3109,[435 185 125 175  69],18,2,12540,4.032154340836013,0.0,0.0
43110,4,3110,[318  79 427 588 216],18,5,12545,4.032465445194471,40.0,0.0
43111,4,3111,[318  79 427 588 216],450,5,12550,4.032776349614396,40.0,0.0
43112,4,3112,[191 403  82 210 144],796,3,12553,4.032444587214905,0.0,0.0
43113,4,3113,[435   4 174 202 153],151,4,12557,4.032434168272318,0.0,0.0
43114,4,3114,[318  79 427 588 216],716,5,12562,4.0327447833065815,40.0,0.0
43115,4,3115,[318  79 427 588 216],716,5,12567,4.0330551989730425,40.0,0.0
43116,4,3116,[318  79 427 588 216],18,5,12572,4.033365415463587,40.0,0.0
43117,4,3117,[191 435 185 197  64],316,3,12575,4.033033996151379,20.0,0.0
43118,4,3118,[588  71  88 182 196],389,3,12578,4.032702789355563,0.0,0.0
43119,4,3119,[318  79 427 588 216],716,5,12583,4.033012820512821,40.0,0.0
43120,4,3120,[318  79 427 588 216],450,5,12588,4.033322652995834,40.0,0.0
43121,4,3121,[161 286  15  98 204],152,4,12592,4.03331197950032,0.0,20.0
43122,4,3122,[173  69 180 143 176],716,3,12595,4.032981107909062,0.0,0.0
43123,4,3123,[423 318 234  96  88],796,4,12599,4.032970550576184,20.0,0.0
43124,4,3124,[118 483 235 202 588],450,2,12601,4.03232,0.0,0.0
43125,4,3125,[318  79 427 588 216],450,5,12606,4.032629558541267,40.0,0.0
43126,4,3126,[  1 228 294 257 121],655,0,12606,4.031339942436841,0.0,0.0
43127,4,3127,[318  79 427 588 216],450,5,12611,4.031649616368286,40.0,0.0
43128,4,3128,[151 235 328 515 357],401,3,12614,4.031319910514541,0.0,0.0
43129,4,3129,[318  79 427 588 216],716,5,12619,4.031629392971246,40.0,0.0
43130,4,3130,[318 597 216  71  69],796,5,12624,4.031938677738742,20.0,0.0
43131,4,3131,[318  79 427 588 216],577,5,12629,4.032247765006385,40.0,0.0
43132,4,3132,[483  15 475 211 153],389,3,12632,4.0319182891797,0.0,0.0
43133,4,3133,[318  79 427 588 216],18,5,12637,4.032227185705169,40.0,0.0
43134,4,3134,[151   8   9 118 197],457,5,12642,4.032535885167464,0.0,0.0
43135,4,3135,[318  79 427 588 216],18,5,12647,4.032844387755102,40.0,0.0
43136,4,3136,[318  79 427 588 216],18,5,12652,4.033152693656359,40.0,0.0
43137,4,3137,[318  79 427 588 216],577,5,12657,4.033460803059273,40.0,0.0
43138,4,3138,[318  79 427 588 216],577,5,12662,4.0337687161516405,40.0,0.0
43139,4,3139,[318  79 427 588 216],18,5,12667,4.034076433121019,40.0,0.0
43140,4,3140,[318  79 427 588 216],716,5,12672,4.034383954154728,40.0,0.0
43141,4,3141,[318  79 427 588 216],577,5,12677,4.034691279439847,40.0,0.0
43142,4,3142,[ 98 121   8 234  88],655,1,12678,4.033725739739102,0.0,0.0
43143,4,3143,[318  79 427 588 216],18,5,12683,4.034033078880407,40.0,0.0
43144,4,3144,[318  79 427 588 216],18,5,12688,4.0343402225755165,40.0,0.0
43145,4,3145,[318  79 427 588 216],577,5,12693,4.034647171010807,40.0,0.0
43146,4,3146,[318  79 427 588 216],450,5,12698,4.034953924372418,40.0,0.0
43147,4,3147,[318  79 427 588 216],796,5,12703,4.035260482846252,40.0,0.0
43148,4,3148,[ 88 173  50 222 200],450,3,12706,4.034931724356939,0.0,20.0
43149,4,3149,[ 15 144 302 183 423],450,4,12710,4.034920634920635,0.0,0.0
43150,4,3150,[161 228 282 288 276],256,2,12712,4.034274833386227,0.0,0.0
43151,4,3151,[100 318 179 197  82],18,4,12716,4.034263959390863,20.0,20.0
43152,4,3152,[216 173  64 282 427],796,5,12721,4.034570250555027,40.0,0.0
43153,4,3153,[318  79 427 588 216],716,5,12726,4.034876347495244,40.0,0.0
43154,4,3154,[  1 357 182 172  88],796,4,12730,4.03486529318542,0.0,0.0
43155,4,3155,[318  79 427 588 216],716,5,12735,4.035171102661597,40.0,0.0
43156,4,3156,[ 28 385 235 216  15],330,5,12740,4.035476718403547,0.0,0.0
43157,4,3157,[318  79 427 588 216],716,5,12745,4.035782140595313,40.0,0.0
43158,4,3158,[125  69 182 655 597],450,5,12750,4.036087369420703,0.0,0.0
43159,4,3159,[313 175 234  70 135],655,2,12752,4.035443037974684,0.0,0.0
43160,4,3160,[471 483 186 597 222],450,2,12754,4.0347991142043655,0.0,0.0
43161,4,3161,[318  79 427 588 216],577,5,12759,4.035104364326376,40.0,0.0
43162,4,3162,[237 144 121 271 268],655,0,12759,4.033828643692697,0.0,0.0
43163,4,3163,[100 127 118 204 175],344,4,12763,4.033817951959545,0.0,40.0
43164,4,3164,[196 161 216 117 127],796,5,12768,4.034123222748815,0.0,20.0
43165,4,3165,[323 172 210  11 151],256,4,12772,4.0341124447252055,0.0,0.0
43166,4,3166,[161 118 483 174 313],280,2,12774,4.03347016103568,0.0,0.0
43167,4,3167,[ 56  12  22 603 194],450,5,12779,4.033775252525253,20.0,0.0
43168,4,3168,[318  79 427 588 216],577,5,12784,4.0340801514673394,40.0,0.0
43169,4,3169,[318  79 427 588 216],450,5,12789,4.034384858044164,40.0,0.0
43170,4,3170,[318  79 427 588 216],796,5,12794,4.034689372437716,40.0,0.0
43171,4,3171,[ 95 111  11 210 435],450,3,12797,4.034363177805801,0.0,0.0
43172,4,3172,[318  79 427 588 216],18,5,12802,4.034667507091081,40.0,0.0
43173,4,3173,[318  79 427 588 216],577,5,12807,4.034971644612476,40.0,0.0
43174,4,3174,[588 302  71 185 196],389,4,12811,4.03496062992126,0.0,0.0
43175,4,3175,[318  79 427 588 216],796,5,12816,4.035264483627204,40.0,0.0
43176,4,3176,[318  79 427 588 216],577,5,12821,4.035568146049733,40.0,0.0
43177,4,3177,[318  79 427 588 216],716,5,12826,4.0358716173694145,40.0,0.0
43178,4,3178,[427  56 196 328 127],796,5,12831,4.036174897766593,20.0,20.0
43179,4,3179,[318  79 427 588 216],450,5,12836,4.036477987421383,40.0,0.0
43180,4,3180,[318  79 427 588 216],577,5,12841,4.036780886513675,40.0,0.0
43181,4,3181,[318  79 427 588 216],450,5,12846,4.03708359522313,40.0,0.0
43182,4,3182,[318  79 427 588 216],796,5,12851,4.037386113729187,40.0,0.0
43183,4,3183,[318  79 427 588 216],18,5,12856,4.0376884422110555,40.0,0.0
43184,4,3184,[175 568 257  97 174],716,4,12860,4.037676609105181,0.0,0.0
43185,4,3185,[318  79 427 588 216],796,5,12865,4.037978656622724,40.0,0.0
43186,4,3186,[153 195 117 202 182],796,5,12870,4.038280514590524,0.0,0.0
43187,4,3187,[176 216 265 423 135],716,3,12873,4.037954830614805,0.0,0.0
43188,4,3188,[318  79 427 588 216],716,5,12878,4.038256506741925,40.0,0.0
43189,4,3189,[211 202 100 423  15],269,3,12881,4.037931034482758,0.0,20.0
43190,4,3190,[210  69  98 172  11],716,5,12886,4.038232528987778,0.0,0.0
43191,4,3191,[318  79 427 588 216],18,5,12891,4.038533834586466,40.0,0.0
43192,4,3192,[318  79 427 588 216],716,5,12896,4.038834951456311,40.0,0.0
43193,4,3193,[172 286  97 211  11],450,5,12901,4.0391358797745776,0.0,20.0
43194,4,3194,[318  79 427 588 216],716,5,12906,4.03943661971831,40.0,0.0
43195,4,3195,[318  79 427 588 216],18,5,12911,4.03973717146433,40.0,0.0
43196,4,3196,[ 97   9 215 237 603],18,2,12913,4.039099155458242,20.0,0.0
43197,4,3197,[318  79 427 588 216],716,5,12918,4.039399624765478,40.0,0.0
43198,4,3198,[ 79 173 403  50 135],457,5,12923,4.039699906220694,0.0,20.0
43199,4,3199,[318  79 427 588 216],18,5,12928,4.04,40.0,0.0
43200,4,3200,[318  79 427 588 216],716,5,12933,4.040299906279288,40.0,0.0
43201,4,3201,[318  79 427 588 216],796,5,12938,4.040599625234228,40.0,0.0
43202,4,3202,[318  79 427 588 216],18,5,12943,4.040899157040275,40.0,0.0
43203,4,3203,[257 234 151 183 546],504,3,12946,4.040574282147316,0.0,0.0
43204,4,3204,[318  79 427 588 216],796,5,12951,4.040873634945398,40.0,0.0
43205,4,3205,[318  79 427 588 216],577,5,12956,4.041172800998129,40.0,0.0
43206,4,3206,[ 56 238  82 132 135],18,3,12959,4.040848144683505,0.0,0.0
43207,4,3207,[318  79 427 588 216],716,5,12964,4.041147132169576,40.0,0.0
43208,4,3208,[174 216  82  95  97],796,3,12967,4.040822686195076,0.0,0.0
43209,4,3209,[238  98 215 357 300],796,4,12971,4.040809968847352,0.0,0.0
43210,4,3210,[318  79 427 588 216],796,5,12976,4.041108688881968,40.0,0.0
43211,4,3211,[237 471 173 191 288],344,3,12979,4.040784557907846,0.0,0.0
43212,4,3212,[173  50 211 194 257],807,4,12983,4.040771864301276,0.0,20.0
43213,4,3213,[265  50 588 216 385],577,5,12988,4.041070317361544,0.0,20.0
43214,4,3214,[ 79 318 427 588 216],796,5,12993,4.041368584758943,40.0,0.0
43215,4,3215,[588 405 228 294 286],280,2,12995,4.040733830845771,0.0,20.0
43216,4,3216,[ 25 269 195 179 182],18,3,12998,4.040410320174075,0.0,0.0
43217,4,3217,[265 182 210 300 161],655,1,12999,4.039465506525793,0.0,0.0
43218,4,3218,[ 56 143  97  12  50],457,5,13004,4.039763901832868,0.0,20.0
43219,4,3219,[313  96 211 118 117],807,4,13008,4.039751552795031,0.0,0.0
43220,4,3220,[286 427 196   9 300],535,3,13011,4.039428748835765,20.0,20.0
43221,4,3221,[ 79 318 427 588 216],18,5,13016,4.0397268777157045,40.0,0.0
43222,4,3222,[ 79 318 427 588 216],577,5,13021,4.040024821594788,40.0,0.0
43223,4,3223,[ 97  95 125  64 132],577,5,13026,4.040322580645161,20.0,0.0
43224,4,3224,[210 121 111 143 568],450,3,13029,4.04,0.0,0.0
43225,4,3225,[515 151 161 546  22],807,5,13034,4.0402975821450715,0.0,0.0
43226,4,3226,[161 234 546 179 742],577,2,13036,4.0396653238301825,0.0,0.0
43227,4,3227,[ 79 318 427 588 216],18,5,13041,4.039962825278811,40.0,0.0
43228,4,3228,[194 204 275 238 186],264,5,13046,4.0402601424589655,0.0,20.0
43229,4,3229,[ 79 318 427 588 216],796,5,13051,4.040557275541795,40.0,0.0
43230,4,3230,[ 12 385 111 288 328],450,4,13055,4.040544722995977,0.0,0.0
43231,4,3231,[ 79 318 427 588 216],716,5,13060,4.040841584158416,40.0,0.0
43232,4,3232,[ 79 318 427 588 216],577,5,13065,4.041138261676461,40.0,0.0
43233,4,3233,[153 204 196 515 427],535,4,13069,4.041125541125541,20.0,0.0
43234,4,3234,[183 179 237 111 423],577,4,13073,4.041112828438949,0.0,0.0
43235,4,3235,[ 64 286 216 282 211],655,2,13075,4.040482076637825,20.0,20.0
43236,4,3236,[ 79 318 427 588 216],796,5,13080,4.040778498609824,40.0,0.0
43237,4,3237,[ 79 318 427 588 216],716,5,13085,4.041074737492279,40.0,0.0
43238,4,3238,[211  22 185  98  50],796,4,13089,4.041062056190182,0.0,20.0
43239,4,3239,[ 79 318 427 588 216],450,5,13094,4.041358024691358,40.0,0.0
43240,4,3240,[ 79 318 427 588 216],716,5,13099,4.041653810552298,40.0,0.0
43241,4,3241,[ 79 318 427 588 216],796,5,13104,4.041949413942011,40.0,0.0
43242,4,3242,[ 79 318 427 588 216],796,5,13109,4.042244835029294,40.0,0.0
43243,4,3243,[403 175 318 196  11],457,5,13114,4.042540073982737,20.0,0.0
43244,4,3244,[176  22 180 125 200],450,4,13118,4.042526964560863,0.0,0.0
43245,4,3245,[ 82 282 475 202 211],655,0,13118,4.04128157732594,0.0,0.0
43246,4,3246,[181 216 294 276 265],457,4,13122,4.041268863566369,0.0,0.0
43247,4,3247,[ 79 318 427 588 216],577,5,13127,4.041564039408867,40.0,0.0
43248,4,3248,[186  11 100 265 238],450,4,13131,4.041551246537396,0.0,20.0
43249,4,3249,[ 79 318 427 588 216],450,5,13136,4.041846153846154,40.0,0.0
43250,4,3250,[127  97 234 194  70],18,3,13139,4.041525684404799,0.0,20.0
43251,4,3251,[ 79 318 427 588 216],18,5,13144,4.041820418204182,40.0,0.0
43252,4,3252,[294  88  64 200 202],457,4,13148,4.041807562250231,20.0,0.0
43253,4,3253,[ 79 318 427 588 216],577,5,13153,4.042102028272895,40.0,0.0
43254,4,3254,[ 82 100  15 174 289],655,0,13153,4.040860215053764,0.0,20.0
43255,4,3255,[186 238 475 187   1],655,1,13154,4.0399262899262895,0.0,0.0
43256,4,3256,[ 79 318 427 588 216],796,5,13159,4.040221062327295,40.0,0.0
43257,4,3257,[196  98 508 179  70],535,4,13163,4.0402087170042975,0.0,0.0
43258,4,3258,[118 187 286 161 202],796,4,13167,4.040196379257441,0.0,20.0
43259,4,3259,[ 79 318 427 588 216],716,5,13172,4.0404907975460125,40.0,0.0
43260,4,3260,[118 215 121 742 323],504,4,13176,4.040478380864766,0.0,0.0
43261,4,3261,[100 742 118 245  88],280,1,13177,4.039546290619252,0.0,20.0
43262,4,3262,[ 79 318 427 588 216],450,5,13182,4.039840637450199,40.0,0.0
43263,4,3263,[ 79 318 427 588 216],450,5,13187,4.0401348039215685,40.0,0.0
43264,4,3264,[143 435 187 100 237],18,4,13191,4.0401225114854515,0.0,20.0
43265,4,3265,[427 282 257  22 100],655,1,13192,4.039191671769749,20.0,20.0
43266,4,3266,[191 196 483 111 496],450,4,13196,4.039179675543312,20.0,0.0
43267,4,3267,[318  79 427 588 216],716,5,13201,4.0394736842105265,40.0,0.0
43268,4,3268,[215 132 216  28   9],504,5,13206,4.039767513000918,0.0,0.0
43269,4,3269,[742 100 210 118 385],796,2,13208,4.03914373088685,0.0,20.0
43270,4,3270,[268 183  97 588 301],344,3,13211,4.038826047080404,0.0,0.0
43271,4,3271,[318  79 427 588 216],796,5,13216,4.039119804400978,40.0,0.0
43272,4,3272,[318  79 427 588 216],18,5,13221,4.039413382218148,40.0,0.0
43273,4,3273,[318  79 427 588 216],796,5,13226,4.039706780696396,40.0,0.0
43274,4,3274,[216 143 153  22 275],450,5,13231,4.04,0.0,20.0
43275,4,3275,[195  79 333 121 132],693,3,13234,4.0396825396825395,0.0,0.0
43276,4,3276,[ 28  50 216 144  69],655,2,13236,4.039060115959719,0.0,20.0
43277,4,3277,[318  79 427 588 216],796,5,13241,4.039353264185479,40.0,0.0
43278,4,3278,[228 328  11 286 483],450,4,13245,4.039341262580055,0.0,20.0
43279,4,3279,[318  79 427 588 216],796,5,13250,4.039634146341464,40.0,0.0
43280,4,3280,[257 174 568   1  98],655,1,13251,4.0387077110637,0.0,0.0
43281,4,3281,[318  79 427 588 216],577,5,13256,4.039000609384521,40.0,0.0
43282,4,3282,[318  79 427 588 216],450,5,13261,4.039293329272008,40.0,0.0
43283,4,3283,[181 228  22 318 153],280,3,13264,4.038976857490865,20.0,0.0
43284,4,3284,[258 748 269 300 191],204,2,13266,4.038356164383561,0.0,0.0
43285,4,3285,[318  79 427 588 216],450,5,13271,4.038648813146683,40.0,0.0
43286,4,3286,[318  79 427 588 216],18,5,13276,4.0389412838454515,40.0,0.0
43287,4,3287,[175 121 288   4 118],457,5,13281,4.039233576642336,0.0,0.0
43288,4,3288,[318  79 427 588 216],18,5,13286,4.0395256916996045,40.0,0.0
43289,4,3289,[183  96 234 135 194],450,3,13289,4.039209726443769,0.0,0.0
43290,4,3290,[174   9 234 143 196],504,4,13293,4.039197812215132,0.0,0.0
43291,4,3291,[318  79 427 588 216],796,5,13298,4.039489671931956,40.0,0.0
43292,4,3292,[125 143 197 194 179],457,5,13303,4.039781354388096,0.0,0.0
43293,4,3293,[323 111 300 222 125],796,4,13307,4.039769277474195,0.0,0.0
43294,4,3294,[405 655 568  96 183],450,5,13312,4.040060698027314,0.0,0.0
43295,4,3295,[286 357 216 228 568],796,4,13316,4.040048543689321,0.0,20.0
43296,4,3296,[172 144  95 427 742],796,4,13320,4.040036396724295,20.0,0.0
43297,4,3297,[202 210   9  15 180],786,4,13324,4.0400242571255305,0.0,0.0
43298,4,3298,[161 234 496 180 168],716,3,13327,4.0397090027281,20.0,0.0
43299,4,3299,[ 89  97 121  15 196],786,3,13330,4.039393939393939,0.0,0.0
43300,4,3300,[286 197 588  11 153],401,1,13331,4.038473189942442,0.0,20.0
43301,4,3301,[318  79 427 588 216],716,5,13336,4.038764385221078,40.0,0.0
43302,4,3302,[423 275  11  56 742],655,1,13337,4.037844383893431,0.0,20.0
43303,4,3303,[222 294   8 269  98],23,4,13341,4.037832929782082,0.0,0.0
43304,4,3304,[210 257 132 181 496],807,5,13346,4.038124054462935,20.0,0.0
43305,4,3305,[ 79 318 427 588 216],18,5,13351,4.038415003024803,40.0,0.0
43306,4,3306,[185 385  11 197 182],655,2,13353,4.037798609011189,0.0,0.0
43307,4,3307,[ 79 318 427 588 216],796,5,13358,4.0380894800483675,40.0,0.0
43308,4,3308,[301  79 186  98 168],535,3,13361,4.037775763070414,0.0,0.0
43309,4,3309,[318  79 427 588 216],450,5,13366,4.038066465256797,40.0,0.0
43310,4,3310,[118 143 222  82 238],655,1,13367,4.0371488976140135,0.0,0.0
43311,4,3311,[318  79 427 588 216],18,5,13372,4.03743961352657,40.0,0.0
43312,4,3312,[318  79 427 588 216],796,5,13377,4.0377301539390285,40.0,0.0
43313,4,3313,[318  79 427 588 216],450,5,13382,4.038020519010259,40.0,0.0
43314,4,3314,[182 204  56 273  70],655,2,13384,4.0374057315233784,0.0,0.0
43315,4,3315,[318  79 427 588 216],18,5,13389,4.037696019300362,40.0,0.0
43316,4,3316,[  4 176 475 174 228],655,0,13389,4.036478745854688,0.0,0.0
43317,4,3317,[318  79 427 588 216],577,5,13394,4.036769138034961,40.0,0.0
43318,4,3318,[ 50 144 127 496 515],716,4,13398,4.036758059656523,20.0,40.0
43319,4,3319,[318  79 427 588 216],716,5,13403,4.037048192771084,40.0,0.0
43320,4,3320,[118 475 269 333   8],655,0,13403,4.0358325805480275,0.0,0.0
43321,4,3321,[318  79 427 588 216],577,5,13408,4.036122817579772,40.0,0.0
43322,4,3322,[  8 202 294 286 161],796,3,13411,4.035811014143846,0.0,20.0
43323,4,3323,[423  71 168  98 427],577,5,13416,4.036101083032491,20.0,0.0
43324,4,3324,[357  15 143 423   1],593,4,13420,4.0360902255639095,0.0,0.0
43325,4,3325,[318  79 427 588 216],577,5,13425,4.0363800360793745,40.0,0.0
43326,4,3326,[183 173 197 748 172],450,5,13430,4.036669672377517,0.0,0.0
43327,4,3327,[318  79 427 588 216],18,5,13435,4.036959134615385,40.0,0.0
43328,4,3328,[318  79 427 588 216],716,5,13440,4.037248422949835,40.0,0.0
43329,4,3329,[172 237  97 301 313],593,5,13445,4.0375375375375375,0.0,0.0
43330,4,3330,[318  79 427 588 216],18,5,13450,4.037826478534974,40.0,0.0
43331,4,3331,[318  79 427 588 216],716,5,13455,4.03811524609844,40.0,0.0
43332,4,3332,[318  79 427 588 216],450,5,13460,4.0384038403840385,40.0,0.0
43333,4,3333,[318  79 427 588 216],577,5,13465,4.03869226154769,40.0,0.0
43334,4,3334,[318  79 427 588 216],716,5,13470,4.0389805097451275,40.0,0.0
43335,4,3335,[132 496 313 176 197],796,4,13474,4.038968824940048,20.0,0.0
43336,4,3336,[318  79 427 588 216],450,5,13479,4.039256817500749,40.0,0.0
43337,4,3337,[  8  69 302 603  95],389,4,13483,4.039245056920311,20.0,0.0
43338,4,3338,[ 28 288  70  89   9],655,1,13484,4.038334830787661,0.0,0.0
43339,4,3339,[211 196 135 174 127],389,3,13487,4.038023952095808,0.0,20.0
43340,4,3340,[318  79 427 588 216],18,5,13492,4.038311882669859,40.0,0.0
43341,4,3341,[318  79 427 588 216],716,5,13497,4.0385996409335725,40.0,0.0
43342,4,3342,[318  79 427 588 216],18,5,13502,4.038887227041579,40.0,0.0
43343,4,3343,[168 153 301 144  89],450,5,13507,4.039174641148326,0.0,0.0
43344,4,3344,[ 56 186  89 258 100],296,4,13511,4.039162929745889,0.0,20.0
43345,4,3345,[ 50 195 196 471 234],72,4,13515,4.039151225343694,0.0,20.0
43346,4,3346,[182  79 276 100  11],280,3,13518,4.038840752913057,0.0,20.0
43347,4,3347,[318  79 427 588 216],577,5,13523,4.039127837514934,40.0,0.0
43348,4,3348,[ 22  64 403 153 273],655,2,13525,4.038518960883846,20.0,0.0
43349,4,3349,[318  79 427 588 216],796,5,13530,4.038805970149253,40.0,0.0
43350,4,3350,[318  79 427 588 216],450,5,13535,4.03909280811698,40.0,0.0
43351,4,3351,[172  70 200  88   9],18,2,13537,4.038484486873508,0.0,0.0
43352,4,3352,[318  79 427 588 216],716,5,13542,4.0387712496271995,40.0,0.0
43353,4,3353,[318  79 427 588 216],716,5,13547,4.039057841383423,40.0,0.0
43354,4,3354,[318  79 427 588 216],716,5,13552,4.039344262295082,40.0,0.0
43355,4,3355,[216 302 237  79 258],450,5,13557,4.039630512514899,0.0,0.0
43356,4,3356,[318  79 427 588 216],450,5,13562,4.0399165921954125,40.0,0.0
43357,4,3357,[318  79 427 588 216],796,5,13567,4.040202501488982,40.0,0.0
43358,4,3358,[ 97 588 100 183  64],457,5,13572,4.040488240547782,20.0,20.0
43359,4,3359,[173 197 135 546 257],457,3,13575,4.040178571428571,0.0,0.0
43360,4,3360,[318  79 427 588 216],450,5,13580,4.040464147575126,40.0,0.0
43361,4,3361,[275 301 195  98 181],655,2,13582,4.039857227840571,0.0,20.0
43362,4,3362,[ 71  97  96 194 174],504,4,13586,4.039845376152245,0.0,0.0
43363,4,3363,[318  79 427 588 216],716,5,13591,4.04013079667063,40.0,0.0
43364,4,3364,[182  95  12 215 286],280,3,13594,4.039821693907875,0.0,20.0
43365,4,3365,[318  79 427 588 216],796,5,13599,4.040106951871658,40.0,0.0
43366,4,3366,[318  79 427 588 216],716,5,13604,4.040392040392041,40.0,0.0
43367,4,3367,[318  79 427 588 216],796,5,13609,4.040676959619953,40.0,0.0
43368,4,3368,[318  79 427 588 216],450,5,13614,4.040961709706144,40.0,0.0
43369,4,3369,[172 196  28 286 125],151,5,13619,4.041246290801187,0.0,20.0
43370,4,3370,[318  79 427 588 216],796,5,13624,4.041530703055473,40.0,0.0
43371,4,3371,[ 89 546 483  88 181],457,4,13628,4.041518386714117,0.0,0.0
43372,4,3372,[186 496 427 121 216],269,2,13630,4.040913133708864,40.0,0.0
43373,4,3373,[282   9 546 238 161],457,4,13634,4.040901007705987,0.0,0.0
43374,4,3374,[318  79 427 588 216],18,5,13639,4.041185185185185,40.0,0.0
43375,4,3375,[318  79 427 588 216],450,5,13644,4.041469194312796,40.0,0.0
43376,4,3376,[318  79 427 588 216],18,5,13649,4.0417530352383775,40.0,0.0
43377,4,3377,[117  69 286 276  11],344,1,13650,4.040852575488454,0.0,20.0
43378,4,3378,[318  79 427 588 216],450,5,13655,4.041136430896715,40.0,0.0
43379,4,3379,[182  88 222 161 385],280,2,13657,4.040532544378698,0.0,0.0
43380,4,3380,[180 245 286  95 191],450,4,13661,4.040520556048507,0.0,20.0
43381,4,3381,[568 183  97 546 151],716,3,13664,4.040212891780012,0.0,0.0
43382,4,3382,[ 79 135 200 275 204],716,4,13668,4.040201005025126,0.0,20.0
43383,4,3383,[ 22 196  64 211 200],450,4,13672,4.040189125295508,20.0,0.0
43384,4,3384,[318  79 427 588 216],577,5,13677,4.040472673559822,40.0,0.0
43385,4,3385,[ 88  71 181 237 172],330,5,13682,4.040756054341406,0.0,0.0
43386,4,3386,[174 301 228 302   9],344,5,13687,4.041039267788603,0.0,0.0
43387,4,3387,[318  79 427 588 216],577,5,13692,4.041322314049586,40.0,0.0
43388,4,3388,[318  79 427 588 216],577,5,13697,4.041605193272352,40.0,0.0
43389,4,3389,[427 168 333 144 173],796,5,13702,4.04188790560472,20.0,0.0
43390,4,3390,[143 151 568  11 200],577,1,13703,4.040990858153937,0.0,0.0
43391,4,3391,[318  79 427 588 216],450,5,13708,4.04127358490566,40.0,0.0
43392,4,3392,[ 64 194 300  56 301],535,3,13711,4.04096669613911,20.0,0.0
43393,4,3393,[318  79 427 588 216],450,5,13716,4.04124926340601,40.0,0.0
43394,4,3394,[174 186 181 175  64],151,5,13721,4.041531664212076,20.0,0.0
43395,4,3395,[ 70 568 186 286 179],655,1,13722,4.040636042402827,0.0,20.0
43396,4,3396,[282 275 423 318 111],655,2,13724,4.040035325287018,20.0,20.0
43397,4,3397,[318  79 427 588 216],577,5,13729,4.040317834020012,40.0,0.0
43398,4,3398,[ 56 204 286 275 546],151,4,13733,4.040305972344807,0.0,40.0
43399,4,3399,[318  79 427 588 216],450,5,13738,4.040588235294118,40.0,0.0
43400,4,3400,[357 385 245  98 191],344,3,13741,4.040282269920612,0.0,0.0
43401,4,3401,[318  79 427 588 216],716,5,13746,4.040564373897707,40.0,0.0
43402,4,3402,[183  28 228 269 385],655,1,13747,4.039670878636497,0.0,0.0
43403,4,3403,[318  79 427 588 216],577,5,13752,4.039952996474736,40.0,0.0
43404,4,3404,[318  79 427 588 216],796,5,13757,4.040234948604993,40.0,0.0
43405,4,3405,[318  79 427 588 216],18,5,13762,4.040516735173224,40.0,0.0
43406,4,3406,[318  79 427 588 216],796,5,13767,4.040798356325213,40.0,0.0
43407,4,3407,[111 191 748  50 173],796,5,13772,4.041079812206573,0.0,20.0
43408,4,3408,[ 25 181 143 273 483],655,3,13775,4.040774420651218,0.0,0.0
43409,4,3409,[318  79 427 588 216],716,5,13780,4.041055718475073,40.0,0.0
43410,4,3410,[117 405 127 235   4],344,2,13782,4.040457343887423,0.0,20.0
43411,4,3411,[318  79 427 588 216],450,5,13787,4.0407385697538105,40.0,0.0
43412,4,3412,[151 322  98 245   7],344,3,13790,4.0404336360972755,0.0,0.0
43413,4,3413,[  1  50  88 151 195],457,5,13795,4.040714704159344,0.0,20.0
43414,4,3414,[318  79 427 588 216],577,5,13800,4.04099560761347,40.0,0.0
43415,4,3415,[100  98 215 197 176],280,1,13801,4.040105386416862,0.0,20.0
43416,4,3416,[181 222 215  25 175],344,3,13804,4.039800995024875,0.0,0.0
43417,4,3417,[318  79 427 588 216],450,5,13809,4.040081919251024,40.0,0.0
43418,4,3418,[127 168 235 318 403],457,4,13813,4.040070195963732,20.0,20.0
43419,4,3419,[385 185 313 173 333],796,5,13818,4.040350877192982,0.0,0.0
43420,4,3420,[222 748 269 245 111],796,3,13821,4.040046769950307,0.0,0.0
43421,4,3421,[318  79 427 588 216],796,5,13826,4.040327293980129,40.0,0.0
43422,4,3422,[318  79 427 588 216],577,5,13831,4.040607654104587,40.0,0.0
43423,4,3423,[318  79 427 588 216],577,5,13836,4.04088785046729,40.0,0.0
43424,4,3424,[ 96  50  98 175 597],23,4,13840,4.040875912408759,0.0,20.0
43425,4,3425,[496  70 471 153 269],450,5,13845,4.0411558669001755,20.0,0.0
43426,4,3426,[180 210 228 322   1],796,1,13846,4.040268456375839,0.0,0.0
43427,4,3427,[318  79 427 588 216],450,5,13851,4.040548424737456,40.0,0.0
43428,4,3428,[ 96 197 175 211 117],716,3,13854,4.040244969378827,0.0,0.0
43429,4,3429,[318  79 427 588 216],577,5,13859,4.040524781341108,40.0,0.0
43430,4,3430,[202 117 196 276 197],504,3,13862,4.040221509763917,0.0,0.0
43431,4,3431,[318  79 427 588 216],450,5,13867,4.040501165501166,40.0,0.0
43432,4,3432,[100 168 202 216  22],269,2,13869,4.039906787066705,0.0,20.0
43433,4,3433,[200 195 182 275 357],796,5,13874,4.040186371578335,0.0,20.0
43434,4,3434,[ 69 168 357 234 111],716,5,13879,4.040465793304222,0.0,0.0
43435,4,3435,[318  79 427 588 216],450,5,13884,4.040745052386496,40.0,0.0
43436,4,3436,[228 151 318 427 125],151,5,13889,4.041024148967122,40.0,0.0
43437,4,3437,[172 204 168  70  88],330,4,13893,4.041012216404886,0.0,0.0
43438,4,3438,[318  79 427 588 216],577,5,13898,4.041291072986334,40.0,0.0
43439,4,3439,[179  97  15 568  98],457,5,13903,4.04156976744186,0.0,0.0
43440,4,3440,[318  79 427 588 216],577,5,13908,4.041848299912816,40.0,0.0
43441,4,3441,[318  79 427 588 216],18,5,13913,4.042126670540384,40.0,0.0
43442,4,3442,[121  50  88 405 173],577,3,13916,4.04182399070578,0.0,20.0
43443,4,3443,[318  79 427 588 216],577,5,13921,4.042102206736353,40.0,0.0
43444,4,3444,[100  97 194 269 196],796,2,13923,4.041509433962264,0.0,20.0
43445,4,3445,[318  79 427 588 216],450,5,13928,4.04178757980267,40.0,0.0
43446,4,3446,[125  98  88 286 228],280,2,13930,4.0411952422396284,0.0,20.0
43447,4,3447,[ 50 204 117 210  98],655,2,13932,4.040603248259861,0.0,20.0
43448,4,3448,[ 96  22 234 483 568],457,5,13937,4.04088141490287,0.0,0.0
43449,4,3449,[215 235  22 111 508],280,3,13940,4.040579710144928,0.0,0.0
43450,4,3450,[318  79 427 588 216],716,5,13945,4.040857722399305,40.0,0.0
43451,4,3451,[318  79 427 588 216],577,5,13950,4.041135573580533,40.0,0.0
43452,4,3452,[318  79 427 588 216],716,5,13955,4.041413263828555,40.0,0.0
43453,4,3453,[318  79 427 588 216],716,5,13960,4.04169079328315,40.0,0.0
43454,4,3454,[318  79 427 588 216],796,5,13965,4.041968162083936,40.0,0.0
43455,4,3455,[ 56 282 216   9 300],655,1,13966,4.041087962962963,0.0,0.0
43456,4,3456,[181  11 405  25 568],716,5,13971,4.041365345675441,0.0,0.0
43457,4,3457,[427 435 216  97 175],11,3,13974,4.041064198958936,20.0,0.0
43458,4,3458,[194 234 143 313  56],577,2,13976,4.040474125469789,0.0,0.0
43459,4,3459,[318  79 427 588 216],796,5,13981,4.0407514450867055,40.0,0.0
43460,4,3460,[276 405 496 176 258],344,3,13984,4.040450736781277,20.0,0.0
43461,4,3461,[174 568 300 427 186],716,4,13988,4.040439052570768,20.0,0.0
43462,4,3462,[ 96 211   1  69 742],796,2,13990,4.039849841178169,0.0,0.0
43463,4,3463,[  8 211 276 186  69],269,2,13992,4.0392609699769055,0.0,0.0
43464,4,3464,[ 79 238  25 187 191],450,4,13996,4.039249639249639,0.0,0.0
43465,4,3465,[318  79 427 588 216],450,5,14001,4.039526832083093,40.0,0.0
43466,4,3466,[318  79 427 588 216],450,5,14006,4.0398038650129795,40.0,0.0
43467,4,3467,[435 182 655 597 568],450,5,14011,4.040080738177624,0.0,0.0
43468,4,3468,[210 357 195 471   7],450,4,14015,4.04006918420294,0.0,0.0
43469,4,3469,[597 135 179 181 288],457,4,14019,4.040057636887608,0.0,0.0
43470,4,3470,[318  79 427 588 216],716,5,14024,4.040334197637568,40.0,0.0
43471,4,3471,[318  79 427 588 216],450,5,14029,4.040610599078341,40.0,0.0
43472,4,3472,[568 118 172 161 151],716,3,14032,4.040310970342643,0.0,0.0
43473,4,3473,[318  79 427 588 216],450,5,14037,4.0405872193436965,40.0,0.0
43474,4,3474,[318  79 427 588 216],450,5,14042,4.040863309352518,40.0,0.0
43475,4,3475,[403 276 135 182 603],655,4,14046,4.040851553509781,20.0,0.0
43476,4,3476,[318  79 427 588 216],577,5,14051,4.041127408685648,40.0,0.0
43477,4,3477,[318  79 427 588 216],796,5,14056,4.0414031052328925,40.0,0.0
43478,4,3478,[318  79 427 588 216],796,5,14061,4.041678643288301,40.0,0.0
43479,4,3479,[245 179  96 185 132],504,4,14065,4.041666666666667,0.0,0.0
43480,4,3480,[153 179  22 172 161],655,2,14067,4.041080149382362,0.0,0.0
43481,4,3481,[313 748  69 357  25],450,4,14071,4.041068351522114,0.0,0.0
43482,4,3482,[257 176 588 191  96],23,2,14073,4.040482342807924,0.0,0.0
43483,4,3483,[483 180 117  71 301],450,3,14076,4.040183696900115,0.0,0.0
43484,4,3484,[423  64 588 385 318],457,5,14081,4.040459110473457,40.0,0.0
43485,4,3485,[588 294  88 100 111],401,3,14084,4.040160642570281,0.0,20.0
43486,4,3486,[117 100 427 151 328],236,2,14086,4.039575566389447,20.0,20.0
43487,4,3487,[257 313 427 275 508],296,5,14091,4.039850917431193,20.0,20.0
43488,4,3488,[318  79 427 588 216],450,5,14096,4.04012611063342,40.0,0.0
43489,4,3489,[ 28 185 588 328 153],796,4,14100,4.040114613180516,0.0,0.0
43490,4,3490,[318  79 427 588 216],450,5,14105,4.0403895731881985,40.0,0.0
43491,4,3491,[202  79 182 228 195],457,5,14110,4.040664375715922,0.0,0.0
43492,4,3492,[ 88  15 405 300 265],655,0,14110,4.039507586601775,0.0,0.0
43493,4,3493,[318  79 427 588 216],450,5,14115,4.039782484258729,40.0,0.0
43494,4,3494,[318  79 427 588 216],18,5,14120,4.0400572246065805,40.0,0.0
43495,4,3495,[187 258 127  56  11],655,2,14122,4.0394736842105265,0.0,20.0
43496,4,3496,[ 70 322   4 742 182],450,4,14126,4.03946239633972,0.0,0.0
43497,4,3497,[318  79 427 588 216],796,5,14131,4.039736992567181,40.0,0.0
43498,4,3498,[318  79 427 588 216],577,5,14136,4.040011431837668,40.0,0.0
43499,4,3499,[100   9 211 483 215],796,2,14138,4.039428571428571,0.0,20.0
43500,4,3500,[318  79 427 588 216],450,5,14143,4.039702942016567,40.0,0.0
43501,4,3501,[ 56  96 483 475 235],292,4,14147,4.039691604797259,0.0,0.0
43502,4,3502,[318  79 427 588 216],796,5,14152,4.039965743648302,40.0,0.0
43503,4,3503,[318  79 427 588 216],18,5,14157,4.040239726027397,40.0,0.0
43504,4,3504,[204  71 132 151 181],450,4,14161,4.040228245363766,0.0,0.0
43505,4,3505,[318  79 427 588 216],577,5,14166,4.040501996577296,40.0,0.0
43506,4,3506,[276  96 117 265 172],457,5,14171,4.040775591673795,0.0,0.0
43507,4,3507,[161 196 185 118 282],504,4,14175,4.040763968072976,0.0,0.0
43508,4,3508,[300 269   7 742 181],655,0,14175,4.039612425192362,0.0,0.0
43509,4,3509,[318  79 427 588 216],716,5,14180,4.0398860398860394,40.0,0.0
43510,4,3510,[318  79 427 588 216],577,5,14185,4.040159498718314,40.0,0.0
43511,4,3511,[237 180 127  56 294],796,3,14188,4.039863325740319,0.0,20.0
43512,4,3512,[423   4 172 210 222],716,4,14192,4.039851978366069,0.0,0.0
43513,4,3513,[318  79 427 588 216],716,5,14197,4.0401252134319865,40.0,0.0
43514,4,3514,[318  79 427 588 216],796,5,14202,4.040398293029872,40.0,0.0
43515,4,3515,[318  79 427 588 216],18,5,14207,4.0406712172923775,40.0,0.0
43516,4,3516,[ 15 265  28  79 655],577,4,14211,4.040659653113449,0.0,0.0
43517,4,3517,[318  79 427 588 216],796,5,14216,4.040932347924957,40.0,0.0
43518,4,3518,[318  79 427 588 216],577,5,14221,4.041204887752202,40.0,0.0
43519,4,3519,[132  11 301 269  12],344,4,14225,4.041193181818182,0.0,0.0
43520,4,3520,[318  79 427 588 216],18,5,14230,4.041465492757739,40.0,0.0
43521,4,3521,[427  64 204 228 127],796,5,14235,4.041737649063032,40.0,20.0
43522,4,3522,[245 603 216 100  22],796,3,14238,4.041441952881067,20.0,20.0
43523,4,3523,[143 222 121 483 238],457,5,14243,4.041713961407491,0.0,0.0
43524,4,3524,[318  79 427 588 216],716,5,14248,4.041985815602837,40.0,0.0
43525,4,3525,[405 185 211 176 204],269,2,14250,4.0414066931366985,0.0,0.0
43526,4,3526,[318  79 427 588 216],450,5,14255,4.041678480294868,40.0,0.0
43527,4,3527,[742 318  88 194 100],11,3,14258,4.041383219954649,20.0,20.0
43528,4,3528,[ 96 183 127 423  22],450,5,14263,4.041654859733636,0.0,20.0
43529,4,3529,[318  79 427 588 216],450,5,14268,4.041926345609065,40.0,0.0
43530,4,3530,[144 174 357 508 300],693,3,14271,4.041631265930332,0.0,0.0
43531,4,3531,[135 603 258 195  79],450,4,14275,4.0416194790486974,20.0,0.0
43532,4,3532,[202 258 172 135  97],655,2,14277,4.04104160769884,0.0,0.0
43533,4,3533,[318  79 427 588 216],577,5,14282,4.041312959818902,40.0,0.0
43534,4,3534,[183 186  56 100 174],457,5,14287,4.041584158415842,0.0,20.0
43535,4,3535,[186 210  64 187 294],450,3,14290,4.041289592760181,20.0,0.0
43536,4,3536,[ 56 197 597 173 294],457,3,14293,4.04099519366695,0.0,0.0
43537,4,3537,[318  79 427 588 216],18,5,14298,4.041266252119842,40.0,0.0
43538,4,3538,[318  79 427 588 216],450,5,14303,4.041537157389093,40.0,0.0
43539,4,3539,[ 98  28 323 132  50],798,4,14307,4.041525423728814,0.0,20.0
43540,4,3540,[202 423 234  50  89],269,1,14308,4.040666478395933,0.0,20.0
43541,4,3541,[275 282 117  50   4],716,3,14311,4.040372670807454,0.0,40.0
43542,4,3542,[318  79 427 588 216],796,5,14316,4.040643522438612,40.0,0.0
43543,4,3543,[496 423 471 228 286],450,5,14321,4.040914221218961,20.0,20.0
43544,4,3544,[475  88 603 318 144],655,2,14323,4.04033850493653,40.0,0.0
43545,4,3545,[ 25 161 423 238  50],457,5,14328,4.040609137055838,0.0,20.0
43546,4,3546,[181 143 271 273 257],655,2,14330,4.040033831406823,0.0,0.0
43547,4,3547,[318  79 427 588 216],450,5,14335,4.040304396843292,40.0,0.0
43548,4,3548,[318  79 427 588 216],450,5,14340,4.040574809805579,40.0,0.0
43549,4,3549,[318  79 427 588 216],450,5,14345,4.040845070422535,40.0,0.0
43550,4,3550,[ 25 300  97 655 202],450,4,14349,4.0408335680090115,0.0,0.0
43551,4,3551,[211  69   4 282 100],796,3,14352,4.04054054054054,0.0,20.0
43552,4,3552,[186 200  15 197 568],450,2,14354,4.03996622572474,0.0,0.0
43553,4,3553,[318  79 427 588 216],450,5,14359,4.040236353404614,40.0,0.0
43554,4,3554,[318  79 427 588 216],18,5,14364,4.040506329113924,40.0,0.0
43555,4,3555,[318  79 427 588 216],716,5,14369,4.040776152980877,40.0,0.0
43556,4,3556,[385 211 238  96 183],450,5,14374,4.04104582513354,0.0,0.0
43557,4,3557,[211 144 471 210  79],807,5,14379,4.041315345699831,0.0,0.0
43558,4,3558,[588 204 211 180 173],716,4,14383,4.041303737004776,0.0,0.0
43559,4,3559,[222   7 210 180 655],693,1,14384,4.040449438202248,0.0,0.0
43560,4,3560,[ 82 211 403 237 357],504,3,14387,4.040157259196855,0.0,0.0
43561,4,3561,[  4  12 215  64 144],450,4,14391,4.04014598540146,20.0,0.0
43562,4,3562,[273 153 204  71 210],236,0,14391,4.039012068481616,0.0,0.0
43563,4,3563,[273 268 245 405 546],344,1,14392,4.038159371492704,0.0,0.0
43564,4,3564,[318  79 427 588 216],796,5,14397,4.038429172510519,40.0,0.0
43565,4,3565,[318  79 427 588 216],450,5,14402,4.038698822209759,40.0,0.0
43566,4,3566,[318  79 427 588 216],716,5,14407,4.03896832071769,40.0,0.0
43567,4,3567,[318  79 427 588 216],716,5,14412,4.039237668161435,40.0,0.0
43568,4,3568,[183  95 196   1 385],23,3,14415,4.038946483608854,0.0,0.0
43569,4,3569,[301 172 318 111 603],796,4,14419,4.038935574229692,40.0,0.0
43570,4,3570,[268 568 405 427 187],655,2,14421,4.03836460375245,20.0,0.0
43571,4,3571,[318  79 427 588 216],796,5,14426,4.038633818589026,40.0,0.0
43572,4,3572,[273 318 173 483   8],796,4,14430,4.0386230058774135,20.0,0.0
43573,4,3573,[318  79 427 588 216],796,5,14435,4.038891997761612,40.0,0.0
43574,4,3574,[318  79 427 588 216],577,5,14440,4.039160839160839,40.0,0.0
43575,4,3575,[294   9 144  22 100],796,2,14442,4.0385906040268456,0.0,20.0
43576,4,3576,[173   7 182 151 294],450,5,14447,4.038859379368185,0.0,0.0
43577,4,3577,[191  64 286 204  70],344,3,14450,4.038569032979318,20.0,20.0
43578,4,3578,[603 275 237 265   4],450,4,14454,4.038558256496228,20.0,20.0
43579,4,3579,[385 357 228 173 275],716,4,14458,4.0385474860335195,0.0,20.0
43580,4,3580,[196  12 237 176 211],796,4,14462,4.038536721586149,0.0,0.0
43581,4,3581,[202 216 222 435 204],623,4,14466,4.038525963149079,0.0,0.0
43582,4,3582,[318  79 427 588 216],796,5,14471,4.0387943064471115,40.0,0.0
43583,4,3583,[ 95 568  50 200 121],577,3,14474,4.038504464285714,0.0,20.0
43584,4,3584,[ 69 168 211   4 132],504,5,14479,4.038772663877267,0.0,0.0
43585,4,3585,[318  79 427 588 216],450,5,14484,4.039040713887339,40.0,0.0
43586,4,3586,[318  79 427 588 216],450,5,14489,4.039308614441037,40.0,0.0
43587,4,3587,[318  79 427 588 216],577,5,14494,4.039576365663322,40.0,0.0
43588,4,3588,[318  79 427 588 216],796,5,14499,4.039843967679019,40.0,0.0
43589,4,3589,[318  79 427 588 216],577,5,14504,4.0401114206128135,40.0,0.0
43590,4,3590,[742 211 655 322 176],796,1,14505,4.039264828738513,0.0,0.0
43591,4,3591,[318  79 427 588 216],796,5,14510,4.039532293986637,40.0,0.0
43592,4,3592,[ 98   7 237  12 228],72,2,14512,4.0389646534929025,0.0,0.0
43593,4,3593,[176 172 111 427 234],796,4,14516,4.038953811908737,20.0,0.0
43594,4,3594,[ 28 300  11 268  88],655,0,14516,4.037830319888735,0.0,0.0
43595,4,3595,[318  79 427 588 216],716,5,14521,4.0380978865406005,40.0,0.0
43596,4,3596,[ 69 183 258 588 328],450,5,14526,4.03836530442035,0.0,0.0
43597,4,3597,[318  79 427 588 216],796,5,14531,4.038632573652029,40.0,0.0
43598,4,3598,[318  79 427 588 216],18,5,14536,4.038899694359544,40.0,0.0
43599,4,3599,[200 176 294 508 179],655,2,14538,4.038333333333333,0.0,0.0
43600,4,3600,[318  79 427 588 216],450,5,14543,4.038600388780894,40.0,0.0
43601,4,3601,[318  79 427 588 216],577,5,14548,4.038867295946696,40.0,0.0
43602,4,3602,[318  79 427 588 216],450,5,14553,4.0391340549542045,40.0,0.0
43603,4,3603,[546  96  95 300 603],450,4,14557,4.039123196448391,20.0,0.0
43604,4,3604,[191 300 405 508 435],11,3,14560,4.038834951456311,0.0,0.0
43605,4,3605,[100 181 161 186 496],389,3,14563,4.038546866333888,20.0,20.0
43606,4,3606,[187  89  88 179 282],450,5,14568,4.038813418353202,0.0,0.0
43607,4,3607,[403 275 282 289 288],655,1,14569,4.037971175166297,0.0,20.0
43608,4,3608,[238   1 100  25  95],18,4,14573,4.037960653920754,0.0,20.0
43609,4,3609,[318  79 427 588 216],796,5,14578,4.038227146814404,40.0,0.0
43610,4,3610,[176 357   9 603 187],269,4,14582,4.038216560509555,20.0,0.0
43611,4,3611,[318  79 427 588 216],716,5,14587,4.038482834994463,40.0,0.0
43612,4,3612,[318  79 427 588 216],18,5,14592,4.038748962081373,40.0,0.0
43613,4,3613,[ 56 168 357 235 186],269,3,14595,4.038461538461538,0.0,0.0
43614,4,3614,[210 313 216 196 121],344,3,14598,4.038174273858921,0.0,0.0
43615,4,3615,[269 175 235 588 202],23,3,14601,4.037887168141593,0.0,0.0
43616,4,3616,[200  50 471 405 144],655,2,14603,4.037323748963229,0.0,20.0
43617,4,3617,[  8 318 300 405 275],655,2,14605,4.036760641238253,20.0,20.0
43618,4,3618,[300 301 174 286 176],796,3,14608,4.036474164133739,0.0,20.0
43619,4,3619,[ 28 237 121 258 568],457,5,14613,4.036740331491712,0.0,0.0
43620,4,3620,[318  79 427 588 216],577,5,14618,4.037006351836509,40.0,0.0
43621,4,3621,[318  79 427 588 216],577,5,14623,4.037272225289895,40.0,0.0
43622,4,3622,[211 173 603 515 265],535,3,14626,4.03698592326801,20.0,0.0
43623,4,3623,[196  71 237 328 117],796,5,14631,4.037251655629139,0.0,0.0
43624,4,3624,[ 82 483 121 496 204],796,4,14635,4.037241379310345,20.0,0.0
43625,4,3625,[237 568 195 294 117],256,4,14639,4.03723110865968,0.0,0.0
43626,4,3626,[423 173 215 195 235],457,4,14643,4.037220843672457,0.0,0.0
43627,4,3627,[185 603 197 678 210],401,4,14647,4.037210584343991,20.0,0.0
43628,4,3628,[194 588 182  89 258],457,5,14652,4.037475888674566,0.0,0.0
43629,4,3629,[318  79 427 588 216],577,5,14657,4.037741046831956,40.0,0.0
43630,4,3630,[144 234 405 143   1],807,4,14661,4.037730652712751,0.0,0.0
43631,4,3631,[ 50 196  79  25  69],593,4,14665,4.037720264317181,0.0,20.0
43632,4,3632,[121 191 174 173 168],269,2,14667,4.037159372419488,0.0,0.0
43633,4,3633,[318  79 427 588 216],796,5,14672,4.037424325811777,40.0,0.0
43634,4,3634,[121  50 176 588 151],716,4,14676,4.037414030261348,0.0,20.0
43635,4,3635,[318  79 427 588 216],796,5,14681,4.037678767876788,40.0,0.0
43636,4,3636,[173  12 288   4 228],344,5,14686,4.037943359912015,0.0,0.0
43637,4,3637,[151 273 222  79 111],236,3,14689,4.037658053875756,0.0,0.0
43638,4,3638,[423 187 234 301 181],655,1,14690,4.0368233031052485,0.0,0.0
43639,4,3639,[318  79 427 588 216],18,5,14695,4.037087912087912,40.0,0.0
43640,4,3640,[357 322 111 204  50],401,3,14698,4.036803076078001,0.0,20.0
43641,4,3641,[318  79 427 588 216],716,5,14703,4.037067545304778,40.0,0.0
43642,4,3642,[318  79 427 588 216],796,5,14708,4.037331869338457,40.0,0.0
43643,4,3643,[318  79 427 588 216],577,5,14713,4.037596048298573,40.0,0.0
43644,4,3644,[318  79 427 588 216],796,5,14718,4.037860082304527,40.0,0.0
43645,4,3645,[ 50 211 135 121 173],151,5,14723,4.038123971475589,0.0,20.0
43646,4,3646,[172 215 183  79 125],796,5,14728,4.038387715930902,0.0,0.0
43647,4,3647,[161 235 275 742 655],450,4,14732,4.038377192982456,0.0,20.0
43648,4,3648,[  7 210  82 301 191],655,1,14733,4.037544532748698,0.0,0.0
43649,4,3649,[288 403 286  50 483],655,2,14735,4.036986301369863,0.0,40.0
43650,4,3650,[181 185 168  28 153],504,3,14738,4.036702273349767,0.0,0.0
43651,4,3651,[318  79 427 588 216],18,5,14743,4.036966046002191,40.0,0.0
43652,4,3652,[ 28  98   7 132 588],577,4,14747,4.036955926635642,0.0,0.0
43653,4,3653,[318  79 427 588 216],450,5,14752,4.037219485495347,40.0,0.0
43654,4,3654,[318  79 427 588 216],450,5,14757,4.037482900136799,40.0,0.0
43655,4,3655,[318  79 427 588 216],796,5,14762,4.037746170678337,40.0,0.0
43656,4,3656,[118 301 496  22  70],344,2,14764,4.037188952693465,20.0,0.0
43657,4,3657,[194  88 288  25 174],450,3,14767,4.036905412793876,0.0,0.0
43658,4,3658,[318  79 427 588 216],577,5,14772,4.037168625307461,40.0,0.0
43659,4,3659,[132   4 121 144 117],655,0,14772,4.036065573770492,0.0,0.0
43660,4,3660,[197 234 194 100 483],457,5,14777,4.036328871892925,0.0,20.0
43661,4,3661,[ 71 568 323   9  95],756,0,14777,4.0352266521026765,0.0,0.0
43662,4,3662,[144 151  71 197 161],796,4,14781,4.035217035217035,0.0,0.0
43663,4,3663,[318  79 427 588 216],450,5,14786,4.0354803493449785,40.0,0.0
43664,4,3664,[318  79 427 588 216],18,5,14791,4.035743519781719,40.0,0.0
43665,4,3665,[ 22 268 222  25 742],11,2,14793,4.03518821603928,0.0,0.0
43666,4,3666,[318  79 427 588 216],796,5,14798,4.035451322607035,40.0,0.0
43667,4,3667,[318  79 427 588 216],18,5,14803,4.035714285714286,40.0,0.0
43668,4,3668,[318  79 427 588 216],796,5,14808,4.035977105478332,40.0,0.0
43669,4,3669,[318  79 427 588 216],716,5,14813,4.036239782016349,40.0,0.0
43670,4,3670,[471 597 403 143 228],450,5,14818,4.036502315445382,0.0,0.0
43671,4,3671,[237 161 269 202 313],796,4,14822,4.036492374727668,0.0,0.0
43672,4,3672,[318  79 427 588 216],577,5,14827,4.036754696433433,40.0,0.0
43673,4,3673,[195 175 125 186 301],655,0,14827,4.035655960805661,0.0,0.0
43674,4,3674,[200  82 100 121  12],577,4,14831,4.035646258503402,0.0,20.0
43675,4,3675,[318  79 427 588 216],18,5,14836,4.0359085963003265,40.0,0.0
43676,4,3676,[ 28   1 200 181 423],330,5,14841,4.036170791406038,0.0,0.0
43677,4,3677,[318  79 427 588 216],18,5,14846,4.036432843936923,40.0,0.0
43678,4,3678,[318  79 427 588 216],450,5,14851,4.0366947540092415,40.0,0.0
43679,4,3679,[ 64 268 153 187 318],535,3,14854,4.036413043478261,40.0,0.0
43680,4,3680,[ 98 318  15 427 194],236,4,14858,4.036403151317577,40.0,0.0
43681,4,3681,[216 144 151 294 357],457,4,14862,4.036393264530147,0.0,0.0
43682,4,3682,[186 180 301 235 222],450,2,14864,4.035840347542764,0.0,0.0
43683,4,3683,[742 215 597 235 187],450,4,14868,4.035830618892508,0.0,0.0
43684,4,3684,[ 22  15 748 405  28],450,4,14872,4.035820895522388,0.0,0.0
43685,4,3685,[318  79 427 588 216],450,5,14877,4.036082474226804,40.0,0.0
43686,4,3686,[187  12   1  79 197],450,5,14882,4.036343911038785,0.0,0.0
43687,4,3687,[318  79 427 588 216],450,5,14887,4.0366052060737525,40.0,0.0
43688,4,3688,[174 144 748 215 172],450,5,14892,4.0368663594470044,0.0,0.0
43689,4,3689,[318  79 427 588 216],450,5,14897,4.037127371273713,40.0,0.0
43690,4,3690,[258 483  96 183 204],655,2,14899,4.036575453806557,0.0,0.0
43691,4,3691,[318  79 427 588 216],18,5,14904,4.036836403033586,40.0,0.0
43692,4,3692,[269  22 132 385 288],344,3,14907,4.036555645816409,0.0,0.0
43693,4,3693,[318  79 427 588 216],450,5,14912,4.036816459122902,40.0,0.0
43694,4,3694,[318  79 427 588 216],577,5,14917,4.0370771312584575,40.0,0.0
43695,4,3695,[318  79 427 588 216],716,5,14922,4.037337662337662,40.0,0.0
43696,4,3696,[318  79 427 588 216],450,5,14927,4.03759805247498,40.0,0.0
43697,4,3697,[318  79 427 588 216],796,5,14932,4.037858301784748,40.0,0.0
43698,4,3698,[ 56 202  95  71 172],23,3,14935,4.03757772370911,0.0,0.0
43699,4,3699,[275   8 216 235  56],591,3,14938,4.037297297297298,0.0,20.0
43700,4,3700,[269 483 245 202 302],450,4,14942,4.037287219670359,0.0,0.0
43701,4,3701,[151 238 125 182 143],450,5,14947,4.0375472717450025,0.0,0.0
43702,4,3702,[318  79 427 588 216],577,5,14952,4.03780718336484,40.0,0.0
43703,4,3703,[655 143 588 191 228],796,4,14956,4.037796976241901,0.0,0.0
43704,4,3704,[  7 234 258 216 546],693,3,14959,4.037516869095817,0.0,0.0
43705,4,3705,[318  79 427 588 216],796,5,14964,4.037776578521317,40.0,0.0
43706,4,3706,[496 273 183 483 197],450,3,14967,4.037496628001079,20.0,0.0
43707,4,3707,[318  79 427 588 216],577,5,14972,4.037756202804746,40.0,0.0
43708,4,3708,[132 471 294 185 204],716,4,14976,4.037746023186843,0.0,0.0
43709,4,3709,[318  79 427 588 216],796,5,14981,4.038005390835579,40.0,0.0
43710,4,3710,[302  79 151 132 258],344,4,14985,4.037995149555376,0.0,0.0
43711,4,3711,[  7 328 318 483 172],655,3,14988,4.037715517241379,20.0,0.0
43712,4,3712,[172 268 238   4  98],535,1,14989,4.036897387557231,0.0,0.0
43713,4,3713,[  8 216   9 405 182],655,2,14991,4.036348949919224,0.0,0.0
43714,4,3714,[191 100   1 194 237],796,3,14994,4.03606998654105,0.0,20.0
43715,4,3715,[318  79 427 588 216],18,5,14999,4.036329386437029,40.0,0.0
43716,4,3716,[318  79 427 588 216],18,5,15004,4.036588646758139,40.0,0.0
43717,4,3717,[318  79 427 588 216],577,5,15009,4.036847767616998,40.0,0.0
43718,4,3718,[191 282  79 597  25],450,4,15013,4.036837859639688,0.0,0.0
43719,4,3719,[318  79 427 588 216],450,5,15018,4.037096774193548,40.0,0.0
43720,4,3720,[211 187 125 179 183],450,5,15023,4.037355549583445,0.0,0.0
43721,4,3721,[318  79 427 588 216],18,5,15028,4.037614185921548,40.0,0.0
43722,4,3722,[ 82 100 183 111 471],457,4,15032,4.037604082728982,0.0,20.0
43723,4,3723,[186  28  70 194 187],18,3,15035,4.0373254564983885,0.0,0.0
43724,4,3724,[435 423 508 318 196],269,3,15038,4.037046979865772,20.0,0.0
43725,4,3725,[258 175 288 151 423],457,5,15043,4.037305421363392,0.0,0.0
43726,4,3726,[318  79 427 588 216],450,5,15048,4.03756372417494,40.0,0.0
43727,4,3727,[318  79 427 588 216],716,5,15053,4.037821888412017,40.0,0.0
43728,4,3728,[187 265  95 427 204],436,3,15056,4.037543577366586,20.0,0.0
43729,4,3729,[282 265 186  69 187],655,1,15057,4.0367292225201075,0.0,0.0
43730,4,3730,[318  79 427 588 216],18,5,15062,4.036987402841062,40.0,0.0
43731,4,3731,[ 69  89  22 100 228],450,5,15067,4.037245444801715,0.0,20.0
43732,4,3732,[276 313 202  71 294],280,2,15069,4.036699705330833,0.0,0.0
43733,4,3733,[318  79 427 588 216],18,5,15074,4.036957686127478,40.0,0.0
43734,4,3734,[294 125 302 181 172],450,5,15079,4.037215528781794,0.0,0.0
43735,4,3735,[318  79 427 588 216],18,5,15084,4.037473233404711,40.0,0.0
43736,4,3736,[318  79 427 588 216],716,5,15089,4.037730800107037,40.0,0.0
43737,4,3737,[333 423 168 318   9],796,4,15093,4.037720706260032,20.0,0.0
43738,4,3738,[318  79 427 588 216],450,5,15098,4.037978069002407,40.0,0.0
43739,4,3739,[265 748 403 172  69],450,5,15103,4.038235294117647,0.0,0.0
43740,4,3740,[265 176 187  22 597],450,5,15108,4.038492381716119,0.0,0.0
43741,4,3741,[245 237 228   7 323],280,1,15109,4.037680384820951,0.0,0.0
43742,4,3742,[322  64 204  88 273],450,4,15113,4.037670317926796,20.0,0.0
43743,4,3743,[515  88 268  28  79],655,2,15115,4.037126068376068,0.0,0.0
43744,4,3744,[135 322 435  64 301],629,3,15118,4.036849132176235,20.0,0.0
43745,4,3745,[318  79 427 588 216],716,5,15123,4.037106246663107,40.0,0.0
43746,4,3746,[357 282 191 222  28],796,4,15127,4.03709634374166,0.0,0.0
43747,4,3747,[318  79 427 588 216],450,5,15132,4.0373532550693705,40.0,0.0
43748,4,3748,[118  88 216 173 568],457,5,15137,4.037610029341158,0.0,0.0
43749,4,3749,[318  79 427 588 216],796,5,15142,4.037866666666667,40.0,0.0
43750,4,3750,[318  79 427 588 216],450,5,15147,4.038123167155425,40.0,0.0
43751,4,3751,[275 405 742 195 294],457,4,15151,4.038113006396588,0.0,20.0
43752,4,3752,[318  79 427 588 216],18,5,15156,4.038369304556355,40.0,0.0
43753,4,3753,[318  79 427 588 216],18,5,15161,4.038625466169419,40.0,0.0
43754,4,3754,[318  79 427 588 216],450,5,15166,4.038881491344873,40.0,0.0
43755,4,3755,[318  79 427 588 216],450,5,15171,4.039137380191693,40.0,0.0
43756,4,3756,[ 56  69   7 405 195],151,3,15174,4.0388607931860525,0.0,0.0
43757,4,3757,[318  79 427 588 216],450,5,15179,4.039116551357105,40.0,0.0
43758,4,3758,[318  79 427 588 216],716,5,15184,4.039372173450386,40.0,0.0
43759,4,3759,[ 11  88 300 403 144],693,2,15186,4.038829787234042,0.0,0.0
43760,4,3760,[174 546 228 603 318],450,5,15191,4.039085349641053,40.0,0.0
43761,4,3761,[318  79 427 588 216],450,5,15196,4.039340776182882,40.0,0.0
43762,4,3762,[228 176 546   8  25],457,4,15200,4.039330321551954,0.0,0.0
43763,4,3763,[ 28 322  97 258  64],151,4,15204,4.0393198724760895,20.0,0.0
43764,4,3764,[300 118 483 405 127],796,5,15209,4.039575033200531,0.0,20.0
43765,4,3765,[515 179 153  25 238],655,2,15211,4.0390334572490705,0.0,0.0
43766,4,3766,[  1 333 271 181 288],655,0,15211,4.037961242367932,0.0,0.0
43767,4,3767,[318  79 427 588 216],716,5,15216,4.038216560509555,40.0,0.0
43768,4,3768,[515 423 211  82 385],716,4,15220,4.038206420801274,0.0,0.0
43769,4,3769,[215  79 655  56 328],450,5,15225,4.038461538461538,0.0,0.0
43770,4,3770,[318  79 427 588 216],796,5,15230,4.0387165208167595,40.0,0.0
43771,4,3771,[318  79 427 588 216],716,5,15235,4.03897136797455,40.0,0.0
43772,4,3772,[125 546  25 211 655],151,4,15239,4.038961038961039,0.0,0.0
43773,4,3773,[318  79 427 588 216],18,5,15244,4.03921568627451,40.0,0.0
43774,4,3774,[ 89  70 435  25  88],18,2,15246,4.038675496688742,0.0,0.0
43775,4,3775,[597  15 172 195 210],269,0,15246,4.03760593220339,0.0,0.0
43776,4,3776,[269 237 191 238 211],796,2,15248,4.037066454858353,0.0,0.0
43777,4,3777,[204  11  12 357 202],655,1,15249,4.036262572789836,0.0,0.0
43778,4,3778,[318  79 427 588 216],716,5,15254,4.036517597247949,40.0,0.0
43779,4,3779,[ 11 202 151 286 172],344,3,15257,4.036243386243386,0.0,20.0
43780,4,3780,[313 385  28   1   9],796,2,15259,4.035704839989421,0.0,0.0
43781,4,3781,[211   1 423 173 182],503,4,15263,4.035695399259651,0.0,0.0
43782,4,3782,[597 186 405 294  97],450,4,15267,4.035685963521015,0.0,0.0
43783,4,3783,[318  79 427 588 216],18,5,15272,4.035940803382664,40.0,0.0
43784,4,3784,[318  79 427 588 216],18,5,15277,4.036195508586526,40.0,0.0
43785,4,3785,[313 655 195 187 483],693,2,15279,4.035657686212361,0.0,0.0
43786,4,3786,[245   1 195 423 357],796,3,15282,4.035384209136519,0.0,0.0
43787,4,3787,[ 82 237 182 176   8],280,1,15283,4.034582893347413,0.0,0.0
43788,4,3788,[318  79 427 588 216],716,5,15288,4.034837688044339,40.0,0.0
43789,4,3789,[238  97 127  28 318],655,2,15290,4.034300791556729,20.0,20.0
43790,4,3790,[318  79 427 588 216],716,5,15295,4.034555526246373,40.0,0.0
43791,4,3791,[ 70 435 204 182  11],655,1,15296,4.033755274261603,0.0,0.0
43792,4,3792,[318  79 427 588 216],18,5,15301,4.0340100184550485,40.0,0.0
43793,4,3793,[ 79 405 385 258  95],807,4,15305,4.034001054296257,0.0,0.0
43794,4,3794,[318  79 427 588 216],716,5,15310,4.034255599472991,40.0,0.0
43795,4,3795,[ 50  82  12  96 265],577,5,15315,4.034510010537407,0.0,20.0
43796,4,3796,[ 98  50 273 276 181],655,4,15319,4.034500921780353,0.0,20.0
43797,4,3797,[318  79 427 588 216],577,5,15324,4.034755134281201,40.0,0.0
43798,4,3798,[174 173 385 273 144],401,2,15326,4.034219531455646,0.0,0.0
43799,4,3799,[  1 187  56 300 161],655,1,15327,4.033421052631579,0.0,0.0
43800,4,3800,[742 202 268 135  15],655,1,15328,4.03262299394896,0.0,0.0
43801,4,3801,[318  79 427 588 216],450,5,15333,4.032877432930037,40.0,0.0
43802,4,3802,[588 176  28   4 234],796,3,15336,4.032605837496713,0.0,0.0
43803,4,3803,[135 132  50 286 202],389,3,15339,4.032334384858044,0.0,40.0
43804,4,3804,[211  79 302 427 179],389,5,15344,4.032588699080158,20.0,0.0
43805,4,3805,[100 435 202  15 403],269,1,15345,4.031791907514451,0.0,20.0
43806,4,3806,[405 181 235  69 588],330,5,15350,4.032046230627791,0.0,0.0
43807,4,3807,[176 294 197 471 182],655,1,15351,4.03125,0.0,0.0
43808,4,3808,[318  79 427 588 216],577,5,15356,4.031504331845629,40.0,0.0
43809,4,3809,[200  22  79 568 174],450,4,15360,4.031496062992126,0.0,0.0
43810,4,3810,[318  79 427 588 216],796,5,15365,4.031750196798741,40.0,0.0
43811,4,3811,[235  97   4 118 185],716,2,15367,4.031217208814271,0.0,0.0
43812,4,3812,[294 100 194 238 181],504,1,15368,4.030422239706268,0.0,20.0
43813,4,3813,[318  79 427 588 216],577,5,15373,4.030676455165181,40.0,0.0
43814,4,3814,[588  22 194 174 235],450,4,15377,4.030668414154652,0.0,0.0
43815,4,3815,[294 302 318  15 121],655,2,15379,4.030136268343815,20.0,0.0
43816,4,3816,[176  64 289 357 211],655,2,15381,4.0296044013623264,20.0,0.0
43817,4,3817,[318  79 427 588 216],716,5,15386,4.029858564693557,40.0,0.0
43818,4,3818,[318  79 427 588 216],450,5,15391,4.030112594920136,40.0,0.0
43819,4,3819,[234 603 357 210 151],716,5,15396,4.030366492146597,20.0,0.0
43820,4,3820,[318  79 427 588 216],450,5,15401,4.030620256477362,40.0,0.0
43821,4,3821,[174 191 257 333  15],796,5,15406,4.030873888016745,0.0,0.0
43822,4,3822,[318  79 427 588 216],18,5,15411,4.031127386868951,40.0,0.0
43823,4,3823,[318  79 427 588 216],450,5,15416,4.031380753138075,40.0,0.0
43824,4,3824,[200 186 187 496 423],450,3,15419,4.0311111111111115,20.0,0.0
43825,4,3825,[318  79 427 588 216],577,5,15424,4.031364349189754,40.0,0.0
43826,4,3826,[318  79 427 588 216],18,5,15429,4.031617454925529,40.0,0.0
43827,4,3827,[202 265  25 135 195],450,3,15432,4.031347962382445,0.0,0.0
43828,4,3828,[318  79 427 588 216],716,5,15437,4.031600940193262,40.0,0.0
43829,4,3829,[318  79 427 588 216],18,5,15442,4.0318537859007835,40.0,0.0
43830,4,3830,[318  79 427 588 216],450,5,15447,4.0321064996084575,40.0,0.0
43831,4,3831,[204 238 111 127 655],786,5,15452,4.032359081419624,0.0,20.0
43832,4,3832,[318  79 427 588 216],716,5,15457,4.032611531437516,40.0,0.0
43833,4,3833,[318  79 427 588 216],18,5,15462,4.032863849765258,40.0,0.0
43834,4,3834,[318  79 427 588 216],716,5,15467,4.033116036505867,40.0,0.0
43835,4,3835,[  9  70 100 288 127],344,4,15471,4.03310740354536,0.0,40.0
43836,4,3836,[ 28 144 121  79 222],655,1,15472,4.032316914255929,0.0,0.0
43837,4,3837,[318  79 427 588 216],796,5,15477,4.032569046378322,40.0,0.0
43838,4,3838,[125 385  25 294 118],450,3,15480,4.03230007814535,0.0,0.0
43839,4,3839,[318  79 427 588 216],450,5,15485,4.032552083333333,40.0,0.0
43840,4,3840,[302 301 742  82 483],450,3,15488,4.032283259567821,0.0,0.0
43841,4,3841,[318  79 427 588 216],450,5,15493,4.032535137948985,40.0,0.0
43842,4,3842,[ 50 216 603 222 742],655,3,15496,4.032266458495966,20.0,20.0
43843,4,3843,[ 69 301 269 423 172],450,5,15501,4.03251821019771,0.0,0.0
43844,4,3844,[318  79 427 588 216],450,5,15506,4.0327698309492845,40.0,0.0
43845,4,3845,[588 328   9  70 435],401,3,15509,4.032501300052002,0.0,0.0
43846,4,3846,[313 180 161 179 211],450,5,15514,4.032752794385235,0.0,0.0
43847,4,3847,[318  79 427 588 216],450,5,15519,4.033004158004158,40.0,0.0
43848,4,3848,[318  79 427 588 216],796,5,15524,4.033255391010652,40.0,0.0
43849,4,3849,[318  79 427 588 216],796,5,15529,4.0335064935064935,40.0,0.0
43850,4,3850,[318  79 427 588 216],450,5,15534,4.033757465593353,40.0,0.0
43851,4,3851,[ 97 273 597  70 100],344,2,15536,4.033229491173416,0.0,20.0
43852,4,3852,[275 172  98 471  95],344,4,15540,4.033220866856994,0.0,20.0
43853,4,3853,[318  79 427 588 216],450,5,15545,4.0334717176959005,40.0,0.0
43854,4,3854,[318 357 471  88 655],593,3,15548,4.033203631647211,20.0,0.0
43855,4,3855,[357 748 100 222 168],11,2,15550,4.032676348547718,0.0,20.0
43856,4,3856,[282 357 300 265  95],796,5,15555,4.032927145449832,0.0,0.0
43857,4,3857,[318  79 427 588 216],577,5,15560,4.033177812337999,40.0,0.0
43858,4,3858,[318  79 427 588 216],716,5,15565,4.033428349313294,40.0,0.0
43859,4,3859,[318  79 427 588 216],18,5,15570,4.033678756476684,40.0,0.0
43860,4,3860,[97 88  8 89 56],796,4,15574,4.033670033670034,0.0,0.0
43861,4,3861,[ 89 153 748 176 238],796,4,15578,4.033661315380632,0.0,0.0
43862,4,3862,[318  79 427 588 216],577,5,15583,4.033911467771162,40.0,0.0
43863,4,3863,[100 328 423 265 603],655,1,15584,4.033126293995859,20.0,20.0
43864,4,3864,[187 118  28  50 143],796,4,15588,4.033117723156533,0.0,20.0
43865,4,3865,[318  79 427 588 216],577,5,15593,4.033367822038282,40.0,0.0
43866,4,3866,[385 313  97 742 125],655,1,15594,4.032583397982933,0.0,0.0
43867,4,3867,[318  79 427 588 216],796,5,15599,4.032833505687694,40.0,0.0
43868,4,3868,[318  79 427 588 216],450,5,15604,4.03308348410442,40.0,0.0
43869,4,3869,[173 265 471 483 118],716,3,15607,4.0328165374677,0.0,0.0
43870,4,3870,[318  79 427 588 216],450,5,15612,4.033066391113407,40.0,0.0
43871,4,3871,[318  79 427 588 216],796,5,15617,4.03331611570248,40.0,0.0
43872,4,3872,[423 111 195   8 176],280,3,15620,4.033049315775885,0.0,0.0
43873,4,3873,[318  79 427 588 216],450,5,15625,4.033298915849252,40.0,0.0
43874,4,3874,[180 183  79 597 168],796,4,15629,4.033290322580645,0.0,0.0
43875,4,3875,[111 181 318 496  88],716,5,15634,4.033539731682146,40.0,0.0
43876,4,3876,[197 471   1 132 300],389,4,15638,4.0335310807325255,0.0,0.0
43877,4,3877,[143  71 181  79 204],18,3,15641,4.033264569365652,0.0,0.0
43878,4,3878,[132 471 222 197  25],457,5,15646,4.033513792214488,0.0,0.0
43879,4,3879,[496 210  11 588 275],344,4,15650,4.033505154639175,20.0,20.0
43880,4,3880,[288  98 357 265 508],655,2,15652,4.032981190414842,0.0,0.0
43881,4,3881,[ 64  89 172 300 238],796,4,15656,4.032972694487378,20.0,0.0
43882,4,3882,[265 313 588 215 216],280,3,15659,4.0327066701004375,0.0,0.0
43883,4,3883,[318  79 427 588 216],577,5,15664,4.032955715756952,40.0,0.0
43884,4,3884,[318  79 427 588 216],577,5,15669,4.033204633204633,40.0,0.0
43885,4,3885,[318  79 427 588 216],716,5,15674,4.03345342254246,40.0,0.0
43886,4,3886,[191 234 265  98 423],577,4,15678,4.033444816053512,0.0,0.0
43887,4,3887,[  9 238 121  89 742],655,1,15679,4.032664609053498,0.0,0.0
43888,4,3888,[187 237 182 435 234],655,2,15681,4.0321419388017485,0.0,0.0
43889,4,3889,[588 282 301 748 286],796,3,15684,4.031876606683805,0.0,20.0
43890,4,3890,[183 234  70 144 181],593,4,15688,4.031868414289386,0.0,0.0
43891,4,3891,[269 286  28 301 245],450,5,15693,4.032117163412128,0.0,20.0
43892,4,3892,[403 185 135  50   9],457,5,15698,4.032365784741844,0.0,20.0
43893,4,3893,[318  79 427 588 216],796,5,15703,4.0326142783769905,40.0,0.0
43894,4,3894,[318  79 427 588 216],796,5,15708,4.032862644415918,40.0,0.0
43895,4,3895,[318  79 427 588 216],18,5,15713,4.033110882956879,40.0,0.0
43896,4,3896,[318  79 427 588 216],577,5,15718,4.033358994098024,40.0,0.0
43897,4,3897,[471 403  82 276 111],457,4,15722,4.033350436121088,0.0,0.0
43898,4,3898,[318  79 427 588 216],18,5,15727,4.033598358553475,40.0,0.0
43899,4,3899,[176 568  95 328 182],796,5,15732,4.033846153846154,0.0,0.0
43900,4,3900,[318  79 427 588 216],796,5,15737,4.0340938220968985,40.0,0.0
43901,4,3901,[318  79 427 588 216],796,5,15742,4.0343413634033825,40.0,0.0
43902,4,3902,[ 82  12 202 173 568],796,4,15746,4.034332564693825,0.0,0.0
43903,4,3903,[191 405   7 328 742],450,5,15751,4.034579918032787,0.0,0.0
43904,4,3904,[ 22 265 181 143 125],457,5,15756,4.034827144686299,0.0,0.0
43905,4,3905,[328 258 742 322 125],796,3,15759,4.034562211981567,0.0,0.0
43906,4,3906,[318  79 427 588 216],796,5,15764,4.03480931661121,40.0,0.0
43907,4,3907,[318  79 427 588 216],18,5,15769,4.035056294779938,40.0,0.0
43908,4,3908,[655 179 196 215 385],504,4,15773,4.035047326682016,0.0,0.0
43909,4,3909,[ 96  15 143 300 275],450,4,15777,4.035038363171355,0.0,20.0
43910,4,3910,[222  25 196 174 405],450,3,15780,4.034773715162363,0.0,0.0
43911,4,3911,[318  79 427 588 216],18,5,15785,4.03502044989775,40.0,0.0
43912,4,3912,[318  79 427 588 216],450,5,15790,4.035267058522872,40.0,0.0
43913,4,3913,[318  79 427 588 216],18,5,15795,4.03551354113439,40.0,0.0
43914,4,3914,[318  79 427 588 216],577,5,15800,4.035759897828863,40.0,0.0
43915,4,3915,[ 79 269 235 405 268],344,2,15802,4.035240040858018,0.0,0.0
43916,4,3916,[318  79 427 588 216],796,5,15807,4.03548634158795,40.0,0.0
43917,4,3917,[318  79 427 588 216],18,5,15812,4.035732516590097,40.0,0.0
43918,4,3918,[318  79 427 588 216],18,5,15817,4.035978565960704,40.0,0.0
43919,4,3919,[318  79 427 588 216],716,5,15822,4.036224489795918,40.0,0.0
43920,4,3920,[588 179 182  12 210],450,4,15826,4.036215251211425,0.0,0.0
43921,4,3921,[ 70 234  56 121 135],450,2,15828,4.0356960734319225,0.0,0.0
43922,4,3922,[318  79 427 588 216],796,5,15833,4.035941881213357,40.0,0.0
43923,4,3923,[143 200 132   9 161],796,4,15837,4.0359327217125385,0.0,0.0
43924,4,3924,[471 597 568 423  70],593,3,15840,4.035668789808917,0.0,0.0
43925,4,3925,[318  79 427 588 216],18,5,15845,4.035914416709119,40.0,0.0
43926,4,3926,[318  79 427 588 216],716,5,15850,4.03615991851286,40.0,0.0
43927,4,3927,[318  79 427 588 216],18,5,15855,4.036405295315682,40.0,0.0
43928,4,3928,[318  79 427 588 216],450,5,15860,4.036650547213031,40.0,0.0
43929,4,3929,[318  79 427 588 216],716,5,15865,4.036895674300254,40.0,0.0
43930,4,3930,[318  79 427 588 216],450,5,15870,4.037140676672602,40.0,0.0
43931,4,3931,[318  79 427 588 216],716,5,15875,4.037385554425229,40.0,0.0
43932,4,3932,[143  56 196 655 211],716,5,15880,4.037630307653191,0.0,0.0
43933,4,3933,[ 97 174 153 282 258],450,5,15885,4.037874936451449,0.0,0.0
43934,4,3934,[318  79 427 588 216],18,5,15890,4.038119440914866,40.0,0.0
43935,4,3935,[318  79 427 588 216],716,5,15895,4.038363821138211,40.0,0.0
43936,4,3936,[301 172 132   7 655],535,4,15899,4.038354076708154,0.0,0.0
43937,4,3937,[117 496 215 216 204],330,5,15904,4.038598273235145,20.0,0.0
43938,4,3938,[275 183  98 318 568],655,4,15908,4.038588474232038,20.0,20.0
43939,4,3939,[318  79 427 588 216],577,5,15913,4.038832487309644,40.0,0.0
43940,4,3940,[318  79 427 588 216],796,5,15918,4.039076376554174,40.0,0.0
43941,4,3941,[161 151 187 202  98],716,3,15921,4.038812785388128,0.0,0.0
43942,4,3942,[  8 403 100 173 427],796,4,15925,4.038802941922394,20.0,20.0
43943,4,3943,[568 357 238 313 403],655,2,15927,4.038286004056795,0.0,0.0
43944,4,3944,[194 197 288 323 196],504,4,15931,4.038276299112801,0.0,0.0
43945,4,3945,[318  79 427 588 216],716,5,15936,4.038520020273695,40.0,0.0
43946,4,3946,[318  79 427 588 216],716,5,15941,4.038763617937674,40.0,0.0
43947,4,3947,[318  79 427 588 216],716,5,15946,4.039007092198582,40.0,0.0
43948,4,3948,[471 173 204  97 125],593,4,15950,4.03899721448468,0.0,0.0
43949,4,3949,[318  79 427 588 216],577,5,15955,4.039240506329114,40.0,0.0
43950,4,3950,[318  79 427 588 216],450,5,15960,4.039483675018983,40.0,0.0
43951,4,3951,[257  15 748 333  50],796,5,15965,4.039726720647773,0.0,20.0
43952,4,3952,[125 195  56 222 151],450,4,15969,4.039716670882874,0.0,0.0
43953,4,3953,[216 237 302 143  69],401,2,15971,4.039200809307031,0.0,0.0
43954,4,3954,[111   4 403  15 435],18,2,15973,4.038685208596713,0.0,0.0
43955,4,3955,[ 79  88 385 323   1],256,5,15978,4.038928210313448,0.0,0.0
43956,4,3956,[118 300 194 215 121],504,3,15981,4.038665655799848,0.0,0.0
43957,4,3957,[655 194 483  96   1],716,4,15985,4.0386558868115205,0.0,0.0
43958,4,3958,[318  79 427 588 216],18,5,15990,4.038898711795908,40.0,0.0
43959,4,3959,[423 216  11 603 215],716,5,15995,4.039141414141414,20.0,0.0
43960,4,3960,[318  79 427 588 216],577,5,16000,4.039383993940924,40.0,0.0
43961,4,3961,[273 172 496 748 603],450,4,16004,4.039374053508329,40.0,0.0
43962,4,3962,[318  79 427 588 216],716,5,16009,4.03961645218269,40.0,0.0
43963,4,3963,[  9 117 357 196 143],786,5,16014,4.039858728557014,0.0,0.0
43964,4,3964,[318  79 427 588 216],18,5,16019,4.040100882723833,40.0,0.0
43965,4,3965,[ 69 471 237 475 271],655,0,16019,4.039082198688855,0.0,0.0
43966,4,3966,[318  79 427 588 216],450,5,16024,4.03932442651878,40.0,0.0
43967,4,3967,[ 22 234 196 423 151],18,2,16026,4.038810483870968,0.0,0.0
43968,4,3968,[144 235  89 258 471],457,4,16030,4.038800705467372,0.0,0.0
43969,4,3969,[ 95  22 238  89 186],18,4,16034,4.038790931989924,0.0,0.0
43970,4,3970,[318  79 427 588 216],577,5,16039,4.039032989171493,40.0,0.0
43971,4,3971,[ 25 238 273 234 300],655,1,16040,4.038267875125881,0.0,0.0
43972,4,3972,[111 135 191   7 100],629,3,16043,4.038006544173169,0.0,20.0
43973,4,3973,[508 403  98 678  56],280,2,16045,4.03749370910921,0.0,0.0
43974,4,3974,[318  79 427 588 216],18,5,16050,4.037735849056604,40.0,0.0
43975,4,3975,[318  79 427 588 216],18,5,16055,4.037977867203219,40.0,0.0
43976,4,3976,[568 211 742 405 318],796,3,16058,4.037716872014081,20.0,0.0
43977,4,3977,[318  79 427 588 216],450,5,16063,4.037958773252891,40.0,0.0
43978,4,3978,[588 194   1 515  50],716,5,16068,4.038200552902739,0.0,20.0
43979,4,3979,[275 172 151  89 176],23,3,16071,4.037939698492463,0.0,20.0
43980,4,3980,[318  79 427 588 216],716,5,16076,4.038181361466968,40.0,0.0
43981,4,3981,[318  79 427 588 216],796,5,16081,4.038422903063787,40.0,0.0
43982,4,3982,[196 195 197   1  70],18,3,16084,4.038162189304544,0.0,0.0
43983,4,3983,[318  79 427 588 216],577,5,16089,4.038403614457831,40.0,0.0
43984,4,3984,[238  64  95 471 185],389,4,16093,4.038393977415307,20.0,0.0
43985,4,3985,[ 12 195 121 185 234],256,5,16098,4.038635223281485,0.0,0.0
43986,4,3986,[202 153 187  22  28],716,4,16102,4.038625532982192,0.0,0.0
43987,4,3987,[328 471  28 333 135],655,1,16103,4.037863590772317,0.0,0.0
43988,4,3988,[318  79 427 588 216],577,5,16108,4.038104788167461,40.0,0.0
43989,4,3989,[318  79 427 588 216],577,5,16113,4.038345864661654,40.0,0.0
43990,4,3990,[318  79 427 588 216],577,5,16118,4.038586820345778,40.0,0.0
43991,4,3991,[143 185  88 603 194],796,5,16123,4.038827655310621,20.0,0.0
43992,4,3992,[318  79 427 588 216],450,5,16128,4.039068369646882,40.0,0.0
43993,4,3993,[318  79 427 588 216],796,5,16133,4.039308963445167,40.0,0.0
43994,4,3994,[405 216  95 286 385],796,4,16137,4.039299123904881,0.0,20.0
43995,4,3995,[471 197 282 385 403],457,5,16142,4.03953953953954,0.0,0.0
43996,4,3996,[427 117 294 176  28],236,2,16144,4.039029271953965,20.0,0.0
43997,4,3997,[151  50 483 405 275],151,4,16148,4.039019509754877,0.0,40.0
43998,4,3998,[318  79 427 588 216],18,5,16153,4.039259814953739,40.0,0.0
43999,4,3999,[318  79 427 588 216],450,5,16158,4.0395,40.0,0.0
44000,4,4000,[427 237 179 211  82],269,3,16161,4.039240189952512,20.0,0.0
44001,4,4001,[318  79 427 588 216],577,5,16166,4.039480259870065,40.0,0.0
44002,4,4002,[318  79 427 588 216],18,5,16171,4.039720209842618,40.0,0.0
44003,4,4003,[202 195  79  95 483],23,4,16175,4.03971028971029,0.0,0.0
44004,4,4004,[318  79 427 588 216],716,5,16180,4.039950062421973,40.0,0.0
44005,4,4005,[655 185  64 202 118],655,2,16182,4.039440838741887,20.0,0.0
44006,4,4006,[222 216   9 385 172],457,5,16187,4.039680559021712,0.0,0.0
44007,4,4007,[318  79 427 588 216],796,5,16192,4.039920159680639,40.0,0.0
44008,4,4008,[597  22 197 286 234],450,4,16196,4.039910202045398,0.0,20.0
44009,4,4009,[318  15  70 210 515],18,5,16201,4.040149625935162,20.0,0.0
44010,4,4010,[603 300  69  50 183],450,5,16206,4.040388930441287,20.0,20.0
44011,4,4011,[318  79 427 588 216],716,5,16211,4.040628115653041,40.0,0.0
44012,4,4012,[238 151 301 282 125],296,4,16215,4.040617991527536,0.0,0.0
44013,4,4013,[318  79 427 588 216],796,5,16220,4.0408570004982565,40.0,0.0
44014,4,4014,[742 196  25 118 117],504,4,16224,4.040846824408468,0.0,0.0
44015,4,4015,[318  79 427 588 216],18,5,16229,4.041085657370518,40.0,0.0
44016,4,4016,[176 603   7 265 185],655,2,16231,4.040577545431915,20.0,0.0
44017,4,4017,[100  95 228  22 678],344,3,16234,4.040318566450971,0.0,20.0
44018,4,4018,[318  79 427 588 216],450,5,16239,4.040557352575267,40.0,0.0
44019,4,4019,[357 153 275 257 597],23,2,16241,4.040049751243781,0.0,20.0
44020,4,4020,[318  79 427 588 216],716,5,16246,4.04028848545138,40.0,0.0
44021,4,4021,[318  79 427 588 216],796,5,16251,4.040527100944804,40.0,0.0
44022,4,4022,[173 588 471 135 385],807,4,16255,4.040517027094208,0.0,0.0
44023,4,4023,[269   9 237  79 603],655,2,16257,4.040009940357853,20.0,0.0
44024,4,4024,[318  79 427 588 216],18,5,16262,4.040248447204969,40.0,0.0
44025,4,4025,[151   4 127  97 265],457,5,16267,4.040486835568803,0.0,20.0
44026,4,4026,[ 12 118 181 313 294],577,4,16271,4.040476781723367,0.0,0.0
44027,4,4027,[403  98  11 202  71],577,4,16275,4.040466732869911,0.0,0.0
44028,4,4028,[318  79 427 588 216],716,5,16280,4.040704889550757,40.0,0.0
44029,4,4029,[185 258 385 333 405],655,1,16281,4.039950372208437,0.0,0.0
44030,4,4030,[181 202 127 222 655],457,5,16286,4.040188538824113,0.0,20.0
44031,4,4031,[318  79 427 588 216],450,5,16291,4.040426587301587,40.0,0.0
44032,4,4032,[237 546 196 200 215],577,3,16294,4.040168608975948,0.0,0.0
44033,4,4033,[318  79 427 588 216],716,5,16299,4.040406544372831,40.0,0.0
44034,4,4034,[318  79 427 588 216],450,5,16304,4.0406443618339525,40.0,0.0
44035,4,4035,[151   7 323 176 216],23,2,16306,4.0401387512388505,0.0,0.0
44036,4,4036,[568 228  95   4 168],577,3,16309,4.039881099826604,0.0,0.0
44037,4,4037,[318  79 427 588 216],577,5,16314,4.040118870728083,40.0,0.0
44038,4,4038,[179  96  69 475 328],655,1,16315,4.0393661797474625,0.0,0.0
44039,4,4039,[483  89 357 385 235],457,4,16319,4.0393564356435645,0.0,0.0
44040,4,4040,[202 273  56 195 405],655,1,16320,4.038604305864885,0.0,0.0
44041,4,4041,[172 183 111  64 174],269,1,16321,4.0378525482434435,20.0,0.0
44042,4,4042,[318  79 427 588 216],796,5,16326,4.038090526836507,40.0,0.0
44043,4,4043,[318  79 427 588 216],450,5,16331,4.038328387734916,40.0,0.0
44044,4,4044,[ 69 655 195 603 151],269,3,16334,4.038071693448702,20.0,0.0
44045,4,4045,[ 56 568 273  98 245],796,3,16337,4.03781512605042,0.0,0.0
44046,4,4046,[125  95 322 273 127],450,3,16340,4.037558685446009,0.0,20.0
44047,4,4047,[318  79 427 588 216],18,5,16345,4.037796442687747,40.0,0.0
44048,4,4048,[132 403 234 427  88],18,2,16347,4.037293158804643,20.0,0.0
44049,4,4049,[318  79 427 588 216],18,5,16352,4.037530864197531,40.0,0.0
44050,4,4050,[318  79 427 588 216],18,5,16357,4.037768452234016,40.0,0.0
44051,4,4051,[471  97 151 181 202],344,2,16359,4.037265547877591,0.0,0.0
44052,4,4052,[318  79 427 588 216],796,5,16364,4.037503084135208,40.0,0.0
44053,4,4053,[318  79 427 588 216],450,5,16369,4.0377405032067095,40.0,0.0
44054,4,4054,[204  70 257  97 678],504,3,16372,4.0374845869297165,0.0,0.0
44055,4,4055,[143 471 423 168 210],389,3,16375,4.037228796844182,0.0,0.0
44056,4,4056,[265  79 273  12 176],796,4,16379,4.03721962040917,0.0,0.0
44057,4,4057,[318  79 427 588 216],18,5,16384,4.037456875308034,40.0,0.0
44058,4,4058,[318  79 427 588 216],577,5,16389,4.03769401330377,40.0,0.0
44059,4,4059,[318  79 427 588 216],577,5,16394,4.037931034482758,40.0,0.0
44060,4,4060,[143 318 385 174  96],655,2,16396,4.037429204629402,20.0,0.0
44061,4,4061,[318  79 427 588 216],577,5,16401,4.0376661742983755,40.0,0.0
44062,4,4062,[245 132 197 288   4],504,5,16406,4.0379030273197145,0.0,0.0
44063,4,4063,[318  79 427 588 216],18,5,16411,4.038139763779528,40.0,0.0
44064,4,4064,[121 588 194 172 301],450,4,16415,4.038130381303813,0.0,0.0
44065,4,4065,[168 161  12 269 179],450,5,16420,4.0383669454008855,0.0,0.0
44066,4,4066,[318  79 427 588 216],577,5,16425,4.038603393164495,40.0,0.0
44067,4,4067,[ 69 200 117  28  97],330,5,16430,4.038839724680432,0.0,0.0
44068,4,4068,[318  79 427 588 216],716,5,16435,4.039075940034406,40.0,0.0
44069,4,4069,[318  79 427 588 216],796,5,16440,4.03931203931204,40.0,0.0
44070,4,4070,[172 655 318 161  50],72,3,16443,4.039056742815033,20.0,20.0
44071,4,4071,[318  79 427 588 216],796,5,16448,4.039292730844794,40.0,0.0
44072,4,4072,[121   1   7 118 181],256,5,16453,4.039528602995335,0.0,0.0
44073,4,4073,[194  28 196 216   9],151,5,16458,4.039764359351988,0.0,0.0
44074,4,4074,[127 273 265  88 100],796,3,16461,4.039509202453988,0.0,40.0
44075,4,4075,[288 257  28 276 100],457,4,16465,4.039499509322866,0.0,20.0
44076,4,4076,[318  79 427 588 216],796,5,16470,4.039735099337748,40.0,0.0
44077,4,4077,[132  11  98 135 185],450,4,16474,4.039725355566454,0.0,0.0
44078,4,4078,[318  79 427 588 216],450,5,16479,4.039960774699681,40.0,0.0
44079,4,4079,[ 15 194  22  98 286],18,4,16483,4.039950980392157,0.0,20.0
44080,4,4080,[286  89 742  71 268],344,1,16484,4.039206076941926,0.0,20.0
44081,4,4081,[144 313 655 180   8],280,2,16486,4.038706516413523,0.0,0.0
44082,4,4082,[318  79 427 588 216],450,5,16491,4.038941954445261,40.0,0.0
44083,4,4083,[172  88 132 143 202],269,1,16492,4.038197845249755,0.0,0.0
44084,4,4084,[180 357 161 176 143],504,4,16496,4.038188494492044,0.0,0.0
44085,4,4085,[191  88 118   4 210],655,1,16497,4.037444933920705,0.0,0.0
44086,4,4086,[183 187 328   9 144],796,4,16501,4.037435771959872,0.0,0.0
44087,4,4087,[194 180 288  71  25],450,2,16503,4.036937377690802,0.0,0.0
44088,4,4088,[318  79 427 588 216],796,5,16508,4.037172902910247,40.0,0.0
44089,4,4089,[748  71 176 183 313],450,4,16512,4.037163814180929,0.0,0.0
44090,4,4090,[318  79 427 588 216],18,5,16517,4.037399168907357,40.0,0.0
44091,4,4091,[ 12 318 143 273 435],655,3,16520,4.037145650048876,20.0,0.0
44092,4,4092,[286 546 144  98 234],450,4,16524,4.037136574639629,0.0,20.0
44093,4,4093,[318  79 427 588 216],577,5,16529,4.037371763556424,40.0,0.0
44094,4,4094,[318  79 427 588 216],796,5,16534,4.0376068376068375,40.0,0.0
44095,4,4095,[318  79 427 588 216],577,5,16539,4.037841796875,40.0,0.0
44096,4,4096,[143 125 286  70 435],401,3,16542,4.037588479375152,0.0,20.0
44097,4,4097,[ 56 194 655   1 202],731,2,16544,4.037091264031234,0.0,0.0
44098,4,4098,[ 96 265  11 546 176],716,2,16546,4.036594291290559,0.0,0.0
44099,4,4099,[318  79 427 588 216],450,5,16551,4.036829268292683,40.0,0.0
44100,4,4100,[282 111  96 742 196],655,0,16551,4.035844915874177,0.0,0.0
44101,4,4101,[210 194 597 100 197],796,2,16553,4.0353486104339344,0.0,20.0
44102,4,4102,[318  79 427 588 216],18,5,16558,4.035583719229832,40.0,0.0
44103,4,4103,[318  79 427 588 216],577,5,16563,4.0358187134502925,40.0,0.0
44104,4,4104,[269 385 271   4 286],655,0,16563,4.03483556638246,0.0,20.0
44105,4,4105,[318  79 427 588 216],577,5,16568,4.035070628348758,40.0,0.0
44106,4,4106,[161 234  25 187 100],450,3,16571,4.03481860238617,0.0,20.0
44107,4,4107,[318  79 427 588 216],577,5,16576,4.035053554040895,40.0,0.0
44108,4,4108,[ 50  64  69 195 603],18,2,16578,4.0345582866877585,40.0,20.0
44109,4,4109,[318  79 427 588 216],450,5,16583,4.0347931873479315,40.0,0.0
44110,4,4110,[ 69  88 275  98  95],786,5,16588,4.03502797372902,0.0,20.0
44111,4,4111,[423 210   4 121 301],535,4,16592,4.035019455252918,0.0,0.0
44112,4,4112,[318  79 427 588 216],577,5,16597,4.035254072453197,40.0,0.0
44113,4,4113,[546 496 313 588  69],344,2,16599,4.03475935828877,20.0,0.0
44114,4,4114,[  7 423 117 300  22],450,5,16604,4.034993924665857,0.0,0.0
44115,4,4115,[153 211 301 100 191],296,5,16609,4.035228377065112,0.0,20.0
44116,4,4116,[471 153 286 194 172],389,3,16612,4.034976924945348,0.0,20.0
44117,4,4117,[318  79 427 588 216],716,5,16617,4.035211267605634,40.0,0.0
44118,4,4118,[318  79 427 588 216],18,5,16622,4.035445496479728,40.0,0.0
44119,4,4119,[  9 172 197 180 655],269,3,16625,4.035194174757281,0.0,0.0
44120,4,4120,[ 98 135  12 237 191],457,5,16630,4.035428294103373,0.0,0.0
44121,4,4121,[318  79 427 588 216],716,5,16635,4.035662299854439,40.0,0.0
44122,4,4122,[172 427 210  89 135],450,3,16638,4.035411108416202,20.0,0.0
44123,4,4123,[318  79 427 588 216],796,5,16643,4.035645004849661,40.0,0.0
44124,4,4124,[318  79 427 588 216],450,5,16648,4.035878787878788,40.0,0.0
44125,4,4125,[318  79 427 588 216],716,5,16653,4.036112457586039,40.0,0.0
44126,4,4126,[197 186 238  15 127],269,3,16656,4.035861400533075,0.0,20.0
44127,4,4127,[196  95 275 515 588],716,5,16661,4.03609496124031,0.0,20.0
44128,4,4128,[318  79 427 588 216],577,5,16666,4.036328408815693,40.0,0.0
44129,4,4129,[282 202 234 144 237],280,0,16666,4.035351089588378,0.0,0.0
44130,4,4130,[568 215 748  15 125],796,5,16671,4.035584604212056,0.0,0.0
44131,4,4131,[196 748 237 191 258],224,2,16673,4.035091965150048,0.0,0.0
44132,4,4132,[318  79 427 588 216],450,5,16678,4.035325429470118,40.0,0.0
44133,4,4133,[318  79 427 588 216],450,5,16683,4.0355587808418,40.0,0.0
44134,4,4134,[282 161 215 186 172],716,2,16685,4.035066505441354,0.0,0.0
44135,4,4135,[742 294 234 185 471],655,1,16686,4.034332688588008,0.0,0.0
44136,4,4136,[427 269 185  88 237],503,5,16691,4.0345661107082424,20.0,0.0
44137,4,4137,[ 22  97  95  71 186],577,5,16696,4.034799420009667,0.0,0.0
44138,4,4138,[427 153 318 228 176],151,3,16699,4.034549408069582,40.0,0.0
44139,4,4139,[435 132 204 194 127],236,3,16702,4.034299516908213,0.0,20.0
44140,4,4140,[301 300  98 235 748],450,4,16706,4.034291234001449,0.0,0.0
44141,4,4141,[318  79 427 588 216],450,5,16711,4.034524384355384,40.0,0.0
44142,4,4142,[197  70 496 318 211],450,5,16716,4.034757422157857,40.0,0.0
44143,4,4143,[318  79 427 588 216],450,5,16721,4.034990347490347,40.0,0.0
44144,4,4144,[211 191  22  11 357],716,5,16726,4.035223160434258,0.0,0.0
44145,4,4145,[318  79 427 588 216],450,5,16731,4.035455861070912,40.0,0.0
44146,4,4146,[655  69 216 132  79],450,5,16736,4.035688449481553,0.0,0.0
44147,4,4147,[318  79 427 588 216],716,5,16741,4.035920925747348,40.0,0.0
44148,4,4148,[318  79 427 588 216],577,5,16746,4.036153289949385,40.0,0.0
44149,4,4149,[153 288  88 202 117],280,3,16749,4.0359036144578315,0.0,0.0
44150,4,4150,[655 181 195 172 174],885,2,16751,4.035413153456998,0.0,0.0
44151,4,4151,[318  79 427 588 216],796,5,16756,4.035645472061657,40.0,0.0
44152,4,4152,[196 215 151 427 655],716,5,16761,4.035877678786419,20.0,0.0
44153,4,4153,[423  50 144 216 111],457,4,16765,4.035869041887337,0.0,20.0
44154,4,4154,[318  79 427 588 216],796,5,16770,4.036101083032491,40.0,0.0
44155,4,4155,[318  79 427 588 216],450,5,16775,4.0363330125120305,40.0,0.0
44156,4,4156,[228 153 265  12 118],450,4,16779,4.036324272311763,0.0,0.0
44157,4,4157,[318  79 427 588 216],577,5,16784,4.0365560365560365,40.0,0.0
44158,4,4158,[318  79 427 588 216],796,5,16789,4.036787689348401,40.0,0.0
44159,4,4159,[ 12  50 174  79 258],796,5,16794,4.037019230769231,0.0,20.0
44160,4,4160,[318  79 427 588 216],577,5,16799,4.037250660898822,40.0,0.0
44161,4,4161,[ 79  22  95 268  12],344,3,16802,4.037001441614608,0.0,0.0
44162,4,4162,[300 194 568 118 172],716,4,16806,4.036992553447034,0.0,0.0
44163,4,4163,[211 168 427 210  28],65,5,16811,4.037223823246878,20.0,0.0
44164,4,4164,[197 132  97 423 168],796,3,16814,4.036974789915966,0.0,0.0
44165,4,4165,[318  79 427 588 216],796,5,16819,4.037205952952473,40.0,0.0
44166,4,4166,[318  79 427 588 216],18,5,16824,4.037437005039597,40.0,0.0
44167,4,4167,[ 15 282 174   4  11],457,5,16829,4.037667946257198,0.0,0.0
44168,4,4168,[204 403 211 289  89],655,1,16830,4.036939313984169,0.0,0.0
44169,4,4169,[405 258 210 200 237],655,1,16831,4.03621103117506,0.0,0.0
44170,4,4170,[202 100 179 151 204],457,5,16836,4.036442100215775,0.0,20.0
44171,4,4171,[318  79 427 588 216],450,5,16841,4.036673058485139,40.0,0.0
44172,4,4172,[318  79 427 588 216],796,5,16846,4.0369039060627845,40.0,0.0
44173,4,4173,[318  79 427 588 216],577,5,16851,4.037134643028271,40.0,0.0
44174,4,4174,[ 22 603 222 196 271],796,5,16856,4.037365269461078,20.0,0.0
44175,4,4175,[196 238 258  97 182],457,5,16861,4.037595785440613,0.0,0.0
44176,4,4176,[  7 405 302 174 300],655,1,16862,4.036868565956428,0.0,0.0
44177,4,4177,[318  79 427 588 216],577,5,16867,4.037099090473911,40.0,0.0
44178,4,4178,[  1  95 197  88 202],798,3,16870,4.0368509212730315,0.0,0.0
44179,4,4179,[187 655 234 153 100],655,1,16871,4.036124401913876,0.0,20.0
44180,4,4180,[318  79 427 588 216],450,5,16876,4.036354939009806,40.0,0.0
44181,4,4181,[318  79 427 588 216],450,5,16881,4.036585365853658,40.0,0.0
44182,4,4182,[318  79 427 588 216],577,5,16886,4.036815682524504,40.0,0.0
44183,4,4183,[318  79 427 588 216],577,5,16891,4.037045889101338,40.0,0.0
44184,4,4184,[176  82 183 318 196],151,2,16893,4.036559139784946,20.0,0.0
44185,4,4185,[168  70 603 153 210],264,5,16898,4.036789297658863,20.0,0.0
44186,4,4186,[186 100  64 121 172],151,4,16902,4.036780511105803,20.0,20.0
44187,4,4187,[318  79 427 588 216],577,5,16907,4.037010506208214,40.0,0.0
44188,4,4188,[318  79 427 588 216],796,5,16912,4.037240391501552,40.0,0.0
44189,4,4189,[318  79 427 588 216],18,5,16917,4.0374701670644395,40.0,0.0
44190,4,4190,[318  79 427 588 216],18,5,16922,4.037699832975424,40.0,0.0
44191,4,4191,[318  79 427 588 216],577,5,16927,4.0379293893129775,40.0,0.0
44192,4,4192,[318  79 427 588 216],577,5,16932,4.038158836155497,40.0,0.0
44193,4,4193,[197   9 318 515 427],18,5,16937,4.038388173581307,40.0,0.0
44194,4,4194,[111 405   1 210 173],577,3,16940,4.038140643623361,0.0,0.0
44195,4,4195,[318  79 427 588 216],577,5,16945,4.03836987607245,40.0,0.0
44196,4,4196,[318  79 427 588 216],796,5,16950,4.038598999285203,40.0,0.0
44197,4,4197,[273 588 127 748 185],401,1,16951,4.0378751786565035,0.0,20.0
44198,4,4198,[588 328 271 318 181],796,5,16956,4.038104310550131,20.0,0.0
44199,4,4199,[211 237 322 234 174],796,2,16958,4.037619047619048,0.0,0.0
44200,4,4200,[282 121 483 194 187],296,5,16963,4.037848131397286,0.0,0.0
44201,4,4201,[187  82 568  12 168],450,4,16967,4.037839124226559,0.0,0.0
44202,4,4202,[ 88 202  50 357 127],344,4,16971,4.037830121341899,0.0,40.0
44203,4,4203,[127 186 258 180  70],504,3,16974,4.037583254043768,0.0,20.0
44204,4,4204,[318  79 427 588 216],577,5,16979,4.037812128418549,40.0,0.0
44205,4,4205,[318  79 427 588 216],716,5,16984,4.038040893961008,40.0,0.0
44206,4,4206,[318  79 427 588 216],18,5,16989,4.038269550748752,40.0,0.0
44207,4,4207,[180 151 294  97 181],457,4,16993,4.038260456273764,0.0,0.0
44208,4,4208,[ 50 655 174 204 121],401,2,16995,4.037776193870278,0.0,20.0
44209,4,4209,[269 234 143 187 222],796,3,16998,4.037529691211401,0.0,0.0
44210,4,4210,[318  79 427 588 216],716,5,17003,4.037758252196628,40.0,0.0
44211,4,4211,[ 22 357 496  97 173],344,3,17006,4.037511870845204,20.0,0.0
44212,4,4212,[318  79 427 588 216],450,5,17011,4.03774032755756,40.0,0.0
44213,4,4213,[318  79 427 588 216],716,5,17016,4.03796867584243,40.0,0.0
44214,4,4214,[237 143 471  88 197],716,4,17020,4.037959667852906,0.0,0.0
44215,4,4215,[318  79 427 588 216],450,5,17025,4.038187855787476,40.0,0.0
44216,4,4216,[318  79 427 588 216],450,5,17030,4.03841593549917,40.0,0.0
44217,4,4217,[318  79 427 588 216],18,5,17035,4.03864390706496,40.0,0.0
44218,4,4218,[318  79 427 588 216],716,5,17040,4.0388717705617445,40.0,0.0
44219,4,4219,[144  69  98 127 318],450,5,17045,4.039099526066351,20.0,20.0
44220,4,4220,[318  79 427 588 216],450,5,17050,4.039327173655532,40.0,0.0
44221,4,4221,[318  79 427 588 216],450,5,17055,4.039554713405969,40.0,0.0
44222,4,4222,[318  79 427 588 216],577,5,17060,4.03978214539427,40.0,0.0
44223,4,4223,[318  79 427 588 216],18,5,17065,4.04000946969697,40.0,0.0
44224,4,4224,[ 15 313 403  56 151],450,4,17069,4.04,0.0,0.0
44225,4,4225,[174 302 427 118 135],389,3,17072,4.0397539044013255,20.0,0.0
44226,4,4226,[318  79 427 588 216],716,5,17077,4.039981074047788,40.0,0.0
44227,4,4227,[ 70 210  56 215 117],72,5,17082,4.040208136234626,0.0,0.0
44228,4,4228,[125 245  96 294 202],796,3,17085,4.039962165996689,0.0,0.0
44229,4,4229,[318  79 427 588 216],716,5,17090,4.040189125295508,40.0,0.0
44230,4,4230,[318  79 427 588 216],450,5,17095,4.040415977310328,40.0,0.0
44231,4,4231,[318  79 427 588 216],18,5,17100,4.0406427221172025,40.0,0.0
44232,4,4232,[385 313 195 121 234],807,3,17103,4.040396881644224,0.0,0.0
44233,4,4233,[496 323  98 111 200],280,4,17107,4.040387340576287,20.0,0.0
44234,4,4234,[ 69  64 568   8 196],457,5,17112,4.040613931523023,20.0,0.0
44235,4,4235,[143  69 313 273 186],693,2,17114,4.040132200188857,0.0,0.0
44236,4,4236,[318  79 427 588 216],796,5,17119,4.040358744394619,40.0,0.0
44237,4,4237,[318  79 427 588 216],577,5,17124,4.040585181689476,40.0,0.0
44238,4,4238,[318  79 427 588 216],716,5,17129,4.040811512149092,40.0,0.0
44239,4,4239,[318  79 427 588 216],18,5,17134,4.041037735849057,40.0,0.0
44240,4,4240,[318  79 427 588 216],18,5,17139,4.0412638528648905,40.0,0.0
44241,4,4241,[318  79 427 588 216],577,5,17144,4.041489863272042,40.0,0.0
44242,4,4242,[211 748 180 333  69],796,3,17147,4.041244402545368,0.0,0.0
44243,4,4243,[483 228   1 257  97],655,1,17148,4.04052780395853,0.0,0.0
44244,4,4244,[318  79 427 588 216],18,5,17153,4.0407538280329796,40.0,0.0
44245,4,4245,[748 282 143 121 111],796,5,17158,4.040979745642958,0.0,0.0
44246,4,4246,[174 302 216 300   1],450,5,17163,4.041205556863669,0.0,0.0
44247,4,4247,[318  79 427 588 216],796,5,17168,4.041431261770245,40.0,0.0
44248,4,4248,[234 427 132 568  28],655,1,17169,4.040715462461756,20.0,0.0
44249,4,4249,[588 435  56 603 194],716,5,17174,4.0409411764705885,20.0,0.0
44250,4,4250,[151 127   8  89 161],269,2,17176,4.040461067984004,0.0,20.0
44251,4,4251,[318  79 427 588 216],796,5,17181,4.04068673565381,40.0,0.0
44252,4,4252,[333 742  88 471 508],693,0,17181,4.03973665647778,0.0,0.0
44253,4,4253,[210 143 228 588 222],450,3,17184,4.0394922425952045,0.0,0.0
44254,4,4254,[318  79 427 588 216],18,5,17189,4.039717978848413,40.0,0.0
44255,4,4255,[286  97 483 194  25],18,3,17192,4.0394736842105265,0.0,20.0
44256,4,4256,[318  79 427 588 216],18,5,17197,4.039699318769086,40.0,0.0
44257,4,4257,[ 96 196 216  15  12],450,4,17201,4.039689995302959,0.0,0.0
44258,4,4258,[271   1 568   4  98],796,4,17205,4.039680676215074,0.0,0.0
44259,4,4259,[118  64 322 187 318],796,4,17209,4.039671361502347,40.0,0.0
44260,4,4260,[318  79 427 588 216],450,5,17214,4.0398967378549635,40.0,0.0
44261,4,4261,[318  79 427 588 216],796,5,17219,4.040122008446739,40.0,0.0
44262,4,4262,[175 151  96 174 127],269,3,17222,4.039878020173587,0.0,20.0
44263,4,4263,[127 265 100  71 748],450,4,17226,4.039868667917449,0.0,40.0
44264,4,4264,[318  79 427 588 216],18,5,17231,4.0400937866354045,40.0,0.0
44265,4,4265,[318  79 427 588 216],796,5,17236,4.0403187998124706,40.0,0.0
44266,4,4266,[ 15 275 286 125  56],450,4,17240,4.040309350831966,0.0,40.0
44267,4,4267,[357 216 588 144   1],796,4,17244,4.040299906279288,0.0,0.0
44268,4,4268,[144 211 238 275 204],535,4,17248,4.0402904661513235,0.0,20.0
44269,4,4269,[ 28 211  97  50 496],236,2,17250,4.039812646370024,20.0,20.0
44270,4,4270,[179  88  50  56 333],655,2,17252,4.039335050339499,0.0,20.0
44271,4,4271,[318  79 427 588 216],796,5,17257,4.039559925093633,40.0,0.0
44272,4,4272,[318  79 427 588 216],796,5,17262,4.039784694593962,40.0,0.0
44273,4,4273,[  4 265  95 202 357],716,4,17266,4.039775386055218,0.0,0.0
44274,4,4274,[318  79 427 588 216],796,5,17271,4.04,40.0,0.0
44275,4,4275,[508 289  97 288 216],693,2,17273,4.039522918615528,0.0,0.0
44276,4,4276,[318  79 427 588 216],796,5,17278,4.0397474865559975,40.0,0.0
44277,4,4277,[318  79 427 588 216],796,5,17283,4.039971949509116,40.0,0.0
44278,4,4278,[275 294   4 483  95],716,4,17287,4.039962608086001,0.0,20.0
44279,4,4279,[318  79 427 588 216],716,5,17292,4.04018691588785,40.0,0.0
44280,4,4280,[318  79 427 588 216],577,5,17297,4.040411118897454,40.0,0.0
44281,4,4281,[143 333 173 742 127],796,4,17301,4.040401681457263,0.0,20.0
44282,4,4282,[318  79 427 588 216],796,5,17306,4.040625729628765,40.0,0.0
44283,4,4283,[318  79 427 588 216],450,5,17311,4.040849673202614,40.0,0.0
44284,4,4284,[318  79 427 588 216],577,5,17316,4.041073512252042,40.0,0.0
44285,4,4285,[300  95 405 117 483],450,3,17319,4.040830611292581,0.0,0.0
44286,4,4286,[403  89  50 200 183],796,5,17324,4.041054350361558,0.0,20.0
44287,4,4287,[ 70 168  50 196 187],535,4,17328,4.041044776119403,0.0,20.0
44288,4,4288,[318  79 427 588 216],716,5,17333,4.041268360923292,40.0,0.0
44289,4,4289,[268 197  11 195 194],269,3,17336,4.041025641025641,0.0,0.0
44290,4,4290,[318  79 427 588 216],577,5,17341,4.041249126077838,40.0,0.0
44291,4,4291,[318  79 427 588 216],18,5,17346,4.041472506989749,40.0,0.0
44292,4,4292,[318  79 427 588 216],450,5,17351,4.0416957838341485,40.0,0.0
44293,4,4293,[ 22 161   7 100 175],269,2,17353,4.041220307405682,0.0,20.0
44294,4,4294,[318  79 427 588 216],18,5,17358,4.041443538998836,40.0,0.0
44295,4,4295,[318  79 427 588 216],18,5,17363,4.041666666666667,40.0,0.0
44296,4,4296,[318  79 427 588 216],450,5,17368,4.041889690481732,40.0,0.0
44297,4,4297,[588 597 228  89 427],796,5,17373,4.0421126105165195,20.0,0.0
44298,4,4298,[275 132 125  56 215],655,1,17374,4.041404977901838,0.0,20.0
44299,4,4299,[  8  89  70 187 271],655,2,17376,4.040930232558139,0.0,0.0
44300,4,4300,[357 265 748 323 318],796,4,17380,4.040920716112532,20.0,0.0
44301,4,4301,[318  79 427 588 216],716,5,17385,4.041143654114365,40.0,0.0
44302,4,4302,[318  79 427 588 216],577,5,17390,4.041366488496398,40.0,0.0
44303,4,4303,[ 98 215 271  28   1],796,3,17393,4.041124535315985,0.0,0.0
44304,4,4304,[678 318 187 423  82],504,4,17397,4.041114982578398,20.0,0.0
44305,4,4305,[333 403  89 222 182],796,5,17402,4.041337668369716,0.0,0.0
44306,4,4306,[222 286  71 655  56],450,3,17405,4.041095890410959,0.0,20.0
44307,4,4307,[ 79  88 100 483 228],151,4,17409,4.04108635097493,0.0,20.0
44308,4,4308,[318  79 427 588 216],577,5,17414,4.041308888373172,40.0,0.0
44309,4,4309,[182 191 187 180 132],269,4,17418,4.0412993039443155,0.0,0.0
44310,4,4310,[313  56 118  15  22],450,3,17421,4.041057759220599,0.0,0.0
44311,4,4311,[318  79 427 588 216],796,5,17426,4.041280148423006,40.0,0.0
44312,4,4312,[318  79 427 588 216],450,5,17431,4.041502434500348,40.0,0.0
44313,4,4313,[318  79 427 588 216],716,5,17436,4.0417246175243395,40.0,0.0
44314,4,4314,[318  79 427 588 216],716,5,17441,4.041946697566628,40.0,0.0
44315,4,4315,[210 100  82  89 508],269,2,17443,4.04147358665431,0.0,20.0
44316,4,4316,[318  79 427 588 216],577,5,17448,4.041695621959694,40.0,0.0
44317,4,4317,[318  79 427 588 216],796,5,17453,4.041917554423344,40.0,0.0
44318,4,4318,[318  79 427 588 216],18,5,17458,4.042139384116694,40.0,0.0
44319,4,4319,[318  79 427 588 216],577,5,17463,4.042361111111111,40.0,0.0
44320,4,4320,[318  79 427 588 216],18,5,17468,4.0425827354778985,40.0,0.0
44321,4,4321,[318  79 427 588 216],577,5,17473,4.042804257288292,40.0,0.0
44322,4,4322,[318  79 427 588 216],796,5,17478,4.043025676613463,40.0,0.0
44323,4,4323,[191 168 471 202  79],577,4,17482,4.043015726179464,0.0,0.0
44324,4,4324,[318  79 427 588 216],577,5,17487,4.0432369942196535,40.0,0.0
44325,4,4325,[294 111 125  79 143],655,2,17489,4.042764678687009,0.0,0.0
44326,4,4326,[318  79 427 588 216],450,5,17494,4.042985902472845,40.0,0.0
44327,4,4327,[185 300 176 216 211],504,4,17498,4.042975970425139,0.0,0.0
44328,4,4328,[318  79 427 588 216],796,5,17503,4.043197043197043,40.0,0.0
44329,4,4329,[  4 275  25  50 483],655,3,17506,4.042956120092379,0.0,40.0
44330,4,4330,[603 423  89 196 197],655,2,17508,4.04248441468483,20.0,0.0
44331,4,4331,[222 273 228 496 153],796,4,17512,4.0424746075715605,20.0,0.0
44332,4,4332,[197 182 275 127 161],796,4,17516,4.0424648049849985,0.0,40.0
44333,4,4333,[318  79 427 588 216],18,5,17521,4.042685740655283,40.0,0.0
44334,4,4334,[  4 215 748 568 216],450,4,17525,4.042675893886966,0.0,0.0
44335,4,4335,[405 568  25   4 151],577,3,17528,4.0424354243542435,0.0,0.0
44336,4,4336,[603   1  11 100 496],450,5,17533,4.042656213972792,40.0,20.0
44337,4,4337,[588 276   4 132 125],457,5,17538,4.0428769017980635,0.0,0.0
44338,4,4338,[385  95  12 161 168],577,5,17543,4.043097487900438,0.0,0.0
44339,4,4339,[144  22 265 196 257],655,0,17543,4.042165898617512,0.0,0.0
44340,4,4340,[234 237  22 313 257],655,1,17544,4.041465100207326,0.0,0.0
44341,4,4341,[194 111  98 427 275],236,3,17547,4.041225241824044,20.0,20.0
44342,4,4342,[318  79 427 588 216],577,5,17552,4.041446005065623,40.0,0.0
44343,4,4343,[427  69  70 496   1],716,5,17557,4.041666666666667,40.0,0.0
44344,4,4344,[127 286 282  28 568],450,5,17562,4.041887226697353,0.0,40.0
44345,4,4345,[318  79 427 588 216],577,5,17567,4.042107685227796,40.0,0.0
44346,4,4346,[318  79 427 588 216],450,5,17572,4.042328042328043,40.0,0.0
44347,4,4347,[ 50 222 546 333 215],796,5,17577,4.042548298068077,0.0,20.0
44348,4,4348,[222  96 276  50  79],655,3,17580,4.042308576684295,0.0,20.0
44349,4,4349,[318  79 427 588 216],796,5,17585,4.0425287356321835,40.0,0.0
44350,4,4350,[ 22  56 186 197 237],269,2,17587,4.042059296713399,0.0,0.0
44351,4,4351,[318  79 427 588 216],18,5,17592,4.042279411764706,40.0,0.0
44352,4,4352,[318  79 427 588 216],796,5,17597,4.042499425683436,40.0,0.0
44353,4,4353,[234 117 181 172  50],693,1,17598,4.041800643086817,0.0,20.0
44354,4,4354,[ 97 282 385 200 265],450,4,17602,4.04179104477612,0.0,0.0
44355,4,4355,[318  79 427 588 216],716,5,17607,4.042011019283747,40.0,0.0
44356,4,4356,[144 286 127 258 588],796,4,17611,4.042001377094331,0.0,40.0
44357,4,4357,[ 22 286 546   4 322],450,4,17615,4.041991739329968,0.0,20.0
44358,4,4358,[117 515 210 275 273],401,3,17618,4.041752695572379,0.0,20.0
44359,4,4359,[318  79 427 588 216],577,5,17623,4.0419724770642205,40.0,0.0
44360,4,4360,[302 655 111 200 175],151,3,17626,4.041733547351525,0.0,0.0
44361,4,4361,[318  79 427 588 216],796,5,17631,4.041953232462173,40.0,0.0
44362,4,4362,[176 182 118 132 143],796,5,17636,4.042172816869127,0.0,0.0
44363,4,4363,[118  15 234 200  64],450,1,17637,4.04147571035747,20.0,0.0
44364,4,4364,[318  79 427 588 216],716,5,17642,4.0416953035509735,40.0,0.0
44365,4,4365,[  4  97 568   8  50],655,1,17643,4.040998625744389,0.0,20.0
44366,4,4366,[210  98  88 176  70],280,2,17645,4.040531257155942,0.0,0.0
44367,4,4367,[318  79 427 588 216],796,5,17650,4.040750915750916,40.0,0.0
44368,4,4368,[318  79 427 588 216],796,5,17655,4.04097047379263,40.0,0.0
44369,4,4369,[  1 180 153 111 435],18,4,17659,4.040961098398169,0.0,0.0
44370,4,4370,[257 655  96  97   8],796,3,17662,4.04072294669412,0.0,0.0
44371,4,4371,[111  88   7 153 288],280,4,17666,4.04071363220494,0.0,0.0
44372,4,4372,[111 195 153  95 173],796,5,17671,4.040932997941916,0.0,0.0
44373,4,4373,[318  79 427 588 216],450,5,17676,4.041152263374485,40.0,0.0
44374,4,4374,[318  79 427 588 216],796,5,17681,4.041371428571429,40.0,0.0
44375,4,4375,[179 111 515 191 204],18,3,17684,4.041133455210238,0.0,0.0
44376,4,4376,[215 118 186  69 275],457,5,17689,4.041352524560201,0.0,20.0
44377,4,4377,[202 496 597 405 268],344,2,17691,4.040886249428963,20.0,0.0
44378,4,4378,[423 174 182 151 111],457,4,17695,4.040876912537109,0.0,0.0
44379,4,4379,[196 161 183 200 405],796,5,17700,4.041095890410959,0.0,0.0
44380,4,4380,[  8 268  50 276 196],269,2,17702,4.0406299931522485,0.0,20.0
44381,4,4381,[ 15  12 118 483  69],450,2,17704,4.040164308534916,0.0,0.0
44382,4,4382,[318  79 427 588 216],716,5,17709,4.040383299110198,40.0,0.0
44383,4,4383,[ 50 403 588 427   4],796,5,17714,4.040602189781022,20.0,20.0
44384,4,4384,[318  79 427 588 216],716,5,17719,4.040820980615735,40.0,0.0
44385,4,4385,[210   1 174 196 173],577,4,17723,4.040811673506612,0.0,0.0
44386,4,4386,[318  79 427 588 216],450,5,17728,4.041030316845225,40.0,0.0
44387,4,4387,[496 111 302 222 197],450,4,17732,4.04102096627165,20.0,0.0
44388,4,4388,[318  79 427 588 216],577,5,17737,4.0412394622920935,40.0,0.0
44389,4,4389,[471  22  15 483 294],450,3,17740,4.041002277904328,0.0,0.0
44390,4,4390,[318  79 427 588 216],18,5,17745,4.041220678660897,40.0,0.0
44391,4,4391,[ 56 588 237 183 194],716,4,17749,4.041211293260473,0.0,0.0
44392,4,4392,[173 258  98  95 161],798,3,17752,4.040974277259276,0.0,0.0
44393,4,4393,[318  79 427 588 216],796,5,17757,4.041192535275376,40.0,0.0
44394,4,4394,[588 655  28 483 202],457,5,17762,4.041410693970421,0.0,0.0
44395,4,4395,[318  79 427 588 216],716,5,17767,4.041628753412193,40.0,0.0
44396,4,4396,[318  79 427 588 216],18,5,17772,4.04184671366841,40.0,0.0
44397,4,4397,[318  79 427 588 216],18,5,17777,4.04206457480673,40.0,0.0
44398,4,4398,[268  64  28 300 176],655,1,17778,4.041373039327119,20.0,0.0
44399,4,4399,[318  79 427 588 216],450,5,17783,4.0415909090909095,40.0,0.0
44400,4,4400,[ 50 265  96 435 288],450,4,17787,4.041581458759373,0.0,20.0
44401,4,4401,[  1 191 172 258 117],796,4,17791,4.04157201272149,0.0,0.0
44402,4,4402,[144 187 174 153 655],796,4,17795,4.041562570974335,0.0,0.0
44403,4,4403,[496 588  50 196 546],577,4,17799,4.041553133514986,20.0,20.0
44404,4,4404,[ 82 200 182 588  96],280,3,17802,4.041316685584563,0.0,0.0
44405,4,4405,[318  79 427 588 216],716,5,17807,4.041534271448025,40.0,0.0
44406,4,4406,[597 191  79 125  50],796,5,17812,4.041751758565918,0.0,20.0
44407,4,4407,[318  79 427 588 216],18,5,17817,4.041969147005445,40.0,0.0
44408,4,4408,[318  79 427 588 216],18,5,17822,4.042186436833749,40.0,0.0
44409,4,4409,[655 286 182  88  98],450,5,17827,4.042403628117913,0.0,20.0
44410,4,4410,[195 357 275 427 161],23,3,17830,4.042167309000226,20.0,20.0
44411,4,4411,[117  98 216 111 269],174,5,17835,4.042384406165005,0.0,0.0
44412,4,4412,[127 179 235  97  11],450,4,17839,4.042374801722184,0.0,20.0
44413,4,4413,[655  95 265 183 269],450,4,17843,4.042365201631173,0.0,0.0
44414,4,4414,[301 211  69  89  98],655,2,17845,4.041902604756512,0.0,0.0
44415,4,4415,[318  79 427 588 216],450,5,17850,4.042119565217392,40.0,0.0
44416,4,4416,[183 111 174 202 237],269,0,17850,4.041204437400951,0.0,0.0
44417,4,4417,[655 282 202  50 471],401,2,17852,4.040742417383432,0.0,20.0
44418,4,4418,[143 318 588 265   8],577,4,17856,4.040733197556008,20.0,0.0
44419,4,4419,[  7  69  79 168 405],151,4,17860,4.040723981900452,0.0,0.0
44420,4,4420,[182 603 168 427  64],796,5,17865,4.0409409635829,60.0,0.0
44421,4,4421,[197 238 194 403 286],18,3,17868,4.040705563093622,0.0,20.0
44422,4,4422,[ 69 111  56 275 117],457,4,17872,4.040696359936694,0.0,20.0
44423,4,4423,[111 216 265 183 655],786,5,17877,4.0409132007233275,0.0,0.0
44424,4,4424,[ 96  69 132   4 288],450,3,17880,4.040677966101695,0.0,0.0
44425,4,4425,[427   9 111  71 125],18,3,17883,4.040442837776774,20.0,0.0
44426,4,4426,[  1  79 603 180 121],450,4,17887,4.0404337022814545,20.0,0.0
44427,4,4427,[144 187 202 185 300],716,3,17890,4.040198735320686,0.0,0.0
44428,4,4428,[300  88 322 182 197],450,5,17895,4.040415443666742,0.0,0.0
44429,4,4429,[471 135 427  28  96],716,2,17897,4.039954853273137,20.0,0.0
44430,4,4430,[471 185  97 265 195],256,5,17902,4.040171518844504,0.0,0.0
44431,4,4431,[318  79 427 588 216],577,5,17907,4.040388086642599,40.0,0.0
44432,4,4432,[318  79 427 588 216],18,5,17912,4.040604556733589,40.0,0.0
44433,4,4433,[118   4 496 181 111],450,3,17915,4.040369869192602,20.0,0.0
44434,4,4434,[568 135  88 183 405],457,5,17920,4.040586245772266,0.0,0.0
44435,4,4435,[ 25 273 568 172  88],450,3,17923,4.040351668169522,0.0,0.0
44436,4,4436,[568 269 185 179 173],450,5,17928,4.040567951318458,0.0,0.0
44437,4,4437,[318  79 427 588 216],18,5,17933,4.040784136998648,40.0,0.0
44438,4,4438,[275  56  50 168 132],535,4,17937,4.040774949312908,0.0,40.0
44439,4,4439,[215  79 144 222 588],457,5,17942,4.040990990990991,0.0,0.0
44440,4,4440,[496 237 568  70 216],280,3,17945,4.040756586354425,20.0,0.0
44441,4,4441,[403 288 202 546 118],457,4,17949,4.040747411076092,0.0,0.0
44442,4,4442,[318  79 427 588 216],450,5,17954,4.04096331307675,40.0,0.0
44443,4,4443,[483 235   4 546 273],450,1,17955,4.04027902790279,0.0,0.0
44444,4,4444,[151 245 118 185 100],504,4,17959,4.040269966254218,0.0,20.0
44445,4,4445,[118 403 127   4 181],796,5,17964,4.040485829959514,0.0,20.0
44446,4,4446,[357  89 185 144 183],23,2,17966,4.040026984483922,0.0,0.0
44447,4,4447,[143 405 197  56   9],655,1,17967,4.039343525179856,0.0,0.0
44448,4,4448,[318  79 427 588 216],577,5,17972,4.039559451562149,40.0,0.0
44449,4,4449,[118 568  22 185  98],256,5,17977,4.039775280898876,0.0,0.0
44450,4,4450,[318  79 427 588 216],577,5,17982,4.039991013255448,40.0,0.0
44451,4,4451,[ 22  25  50 318 275],18,4,17986,4.039982030548068,20.0,40.0
44452,4,4452,[318  79 427 588 216],716,5,17991,4.040197619582304,40.0,0.0
44453,4,4453,[210 175 191 588  79],344,5,17996,4.04041311180961,0.0,0.0
44454,4,4454,[318  79 427 588 216],450,5,18001,4.040628507295174,40.0,0.0
44455,4,4455,[318  79 427 588 216],796,5,18006,4.040843806104129,40.0,0.0
44456,4,4456,[ 15 237 301 175 172],655,1,18007,4.040161543639219,0.0,0.0
44457,4,4457,[318  79 427 588 216],450,5,18012,4.040376850605653,40.0,0.0
44458,4,4458,[175  50 118  95 191],716,3,18015,4.040143529939448,0.0,20.0
44459,4,4459,[318  79 427 588 216],716,5,18020,4.040358744394619,40.0,0.0
44460,4,4460,[269 265 286 597 179],450,5,18025,4.040573862362699,0.0,20.0
44461,4,4461,[168 127 197 515 435],401,3,18028,4.04034065441506,0.0,20.0
44462,4,4462,[ 89 181 302 185 200],450,4,18032,4.0403316155052655,0.0,0.0
44463,4,4463,[183 132 423 318  69],716,4,18036,4.040322580645161,20.0,0.0
44464,4,4464,[301 191 405   7 125],344,3,18039,4.040089585666293,0.0,0.0
44465,4,4465,[318  79 427 588 216],716,5,18044,4.040304523063144,40.0,0.0
44466,4,4466,[318  79 427 588 216],18,5,18049,4.04051936422655,40.0,0.0
44467,4,4467,[ 56 197 568 678   1],280,2,18051,4.04006266786034,0.0,0.0
44468,4,4468,[318  79 427 588 216],796,5,18056,4.040277466994853,40.0,0.0
44469,4,4469,[318  79 427 588 216],577,5,18061,4.040492170022372,40.0,0.0
44470,4,4470,[ 28  25 121 132 222],655,0,18061,4.039588458957728,0.0,0.0
44471,4,4471,[172 245  64 748 300],450,5,18066,4.039803220035778,20.0,0.0
44472,4,4472,[318  79 427 588 216],18,5,18071,4.040017885088307,40.0,0.0
44473,4,4473,[301 153 143 195 183],151,2,18073,4.03956191327671,0.0,0.0
44474,4,4474,[318  79 427 588 216],577,5,18078,4.039776536312849,40.0,0.0
44475,4,4475,[318  79 427 588 216],796,5,18083,4.039991063449508,40.0,0.0
44476,4,4476,[125 427 216 405 176],151,3,18086,4.039758767031494,20.0,0.0
44477,4,4477,[318  79 427 588 216],716,5,18091,4.039973202322465,40.0,0.0
44478,4,4478,[ 82 385 172 546 357],151,2,18093,4.039517749497656,0.0,0.0
44479,4,4479,[161  89 496 210 204],796,4,18097,4.039508928571428,20.0,0.0
44480,4,4480,[318  79 427 588 216],716,5,18102,4.039723276054452,40.0,0.0
44481,4,4481,[318  79 427 588 216],796,5,18107,4.039937527889335,40.0,0.0
44482,4,4482,[ 79  69 275 228  98],450,5,18112,4.040151684140085,0.0,20.0
44483,4,4483,[318  79 427 588 216],577,5,18117,4.040365744870651,40.0,0.0
44484,4,4484,[318  79 427 588 216],18,5,18122,4.040579710144928,40.0,0.0
44485,4,4485,[ 15 271 194 357 195],72,4,18126,4.040570664288899,0.0,0.0
44486,4,4486,[318  79 427 588 216],18,5,18131,4.040784488522398,40.0,0.0
44487,4,4487,[318  79 427 588 216],450,5,18136,4.040998217468806,40.0,0.0
44488,4,4488,[322 144  25  71 121],593,3,18139,4.040766317665405,0.0,0.0
44489,4,4489,[318  79 427 588 216],450,5,18144,4.04097995545657,40.0,0.0
44490,4,4490,[196 215 427 403 234],655,1,18145,4.040302827877978,20.0,0.0
44491,4,4491,[318  79 427 588 216],577,5,18150,4.040516473731078,40.0,0.0
44492,4,4492,[276  96 568   9  25],655,1,18151,4.039839750723347,0.0,0.0
44493,4,4493,[237  12 403 655 161],655,0,18151,4.038940809968848,0.0,0.0
44494,4,4494,[318  79 427 588 216],796,5,18156,4.039154616240267,40.0,0.0
44495,4,4495,[235 282 182 185 294],256,2,18158,4.0387010676156585,0.0,0.0
44496,4,4496,[216 273  71 655   8],796,3,18161,4.0384700911718925,0.0,0.0
44497,4,4497,[318  79 427 588 216],796,5,18166,4.0386838594931085,40.0,0.0
44498,4,4498,[216 143 185 200  79],151,4,18170,4.038675261169149,0.0,0.0
44499,4,4499,[318  79 427 588 216],450,5,18175,4.038888888888889,40.0,0.0
44500,4,4500,[ 22 322 269 235 588],344,2,18177,4.038435903132637,0.0,0.0
44501,4,4501,[100  50 204  89  95],786,5,18182,4.038649489115948,0.0,40.0
44502,4,4502,[318  79 427 588 216],450,5,18187,4.038862980235399,40.0,0.0
44503,4,4503,[318  79 427 588 216],18,5,18192,4.039076376554174,40.0,0.0
44504,4,4504,[318  79 427 588 216],450,5,18197,4.039289678135405,40.0,0.0
44505,4,4505,[318  79 427 588 216],577,5,18202,4.039502885042166,40.0,0.0
44506,4,4506,[318  79 427 588 216],577,5,18207,4.039715997337475,40.0,0.0
44507,4,4507,[215 194 176 655 603],72,4,18211,4.0397071872227155,20.0,0.0
44508,4,4508,[143 471 118 161  70],593,4,18215,4.0396983810157465,0.0,0.0
44509,4,4509,[742  71 269 197 483],796,2,18217,4.0392461197339244,0.0,0.0
44510,4,4510,[471 176 135 318  96],716,1,18218,4.038572378630016,20.0,0.0
44511,4,4511,[191  88 328   1 132],655,1,18219,4.037898936170213,0.0,0.0
44512,4,4512,[318  79 427 588 216],577,5,18224,4.03811212054066,40.0,0.0
44513,4,4513,[427   4 357 275 181],716,4,18228,4.03810367744794,20.0,20.0
44514,4,4514,[ 82   4 194 423  96],450,3,18231,4.037873754152824,0.0,0.0
44515,4,4515,[318  79 427 588 216],716,5,18236,4.038086802480071,40.0,0.0
44516,4,4516,[588   1  71 282 265],450,4,18240,4.038078370599956,0.0,0.0
44517,4,4517,[121  69 153 143 286],330,5,18245,4.038291279327136,0.0,20.0
44518,4,4518,[ 97  50 257 194 202],523,5,18250,4.0385040938260675,0.0,20.0
44519,4,4519,[168 405 135 191  25],151,3,18253,4.038274336283186,0.0,0.0
44520,4,4520,[318  79 427 588 216],716,5,18258,4.03848706038487,40.0,0.0
44521,4,4521,[  8 357 228 603 275],796,5,18263,4.038699690402477,20.0,20.0
44522,4,4522,[172 546 144 405 183],593,3,18266,4.038470042007517,0.0,0.0
44523,4,4523,[211 202 187 204 172],18,2,18268,4.038019451812556,0.0,0.0
44524,4,4524,[ 64 216 117 200 195],796,5,18273,4.038232044198895,20.0,0.0
44525,4,4525,[168 275 265  82 151],151,4,18277,4.038223596995139,0.0,20.0
44526,4,4526,[318  79 427 588 216],716,5,18282,4.03843605036448,40.0,0.0
44527,4,4527,[276 385 176 202 483],280,3,18285,4.0382067137809186,0.0,0.0
44528,4,4528,[275 176 333  15 423],236,2,18287,4.037756679178627,0.0,20.0
44529,4,4529,[318  79 427 588 216],796,5,18292,4.037969094922738,40.0,0.0
44530,4,4530,[228 294  50 323 118],256,3,18295,4.03774001324211,0.0,20.0
44531,4,4531,[318  79 427 588 216],577,5,18300,4.037952338923213,40.0,0.0
44532,4,4532,[176 132 151 187 475],269,4,18304,4.037943966468123,0.0,0.0
44533,4,4533,[318  79 427 588 216],716,5,18309,4.038156153506837,40.0,0.0
44534,4,4534,[318  79 427 588 216],577,5,18314,4.038368246968027,40.0,0.0
44535,4,4535,[318  79 427 588 216],716,5,18319,4.03858024691358,40.0,0.0
44536,4,4536,[318  79 427 588 216],577,5,18324,4.038792153405334,40.0,0.0
44537,4,4537,[195 127  71 258  28],504,5,18329,4.039003966505068,0.0,20.0
44538,4,4538,[ 22 194 385 313 135],450,4,18333,4.038995373430271,0.0,0.0
44539,4,4539,[ 96  79 333 385   9],655,1,18334,4.038325991189427,0.0,0.0
44540,4,4540,[318  79 427 588 216],450,5,18339,4.038537767011672,40.0,0.0
44541,4,4541,[ 96 216 328 186 202],655,1,18340,4.0378687802730076,0.0,0.0
44542,4,4542,[318  79 427 588 216],716,5,18345,4.038080563504292,40.0,0.0
44543,4,4543,[328 176 245 185 318],450,5,18350,4.038292253521127,20.0,0.0
44544,4,4544,[245  56 161 235 181],280,3,18353,4.038063806380638,0.0,0.0
44545,4,4545,[748  88 318 568 191],796,5,18358,4.038275406951166,20.0,0.0
44546,4,4546,[185 655 111 144 176],716,3,18361,4.03804706399824,0.0,0.0
44547,4,4547,[318  79 427 588 216],716,5,18366,4.038258575197889,40.0,0.0
44548,4,4548,[318  79 427 588 216],716,5,18371,4.038469993405144,40.0,0.0
44549,4,4549,[318  79 427 588 216],577,5,18376,4.038681318681319,40.0,0.0
44550,4,4550,[ 70 118 322 143 496],450,4,18380,4.038672819160624,20.0,0.0
44551,4,4551,[187 333 111 202 269],796,4,18384,4.038664323374341,0.0,0.0
44552,4,4552,[318  79 427 588 216],796,5,18389,4.038875466725236,40.0,0.0
44553,4,4553,[275 191 357 294 245],450,5,18394,4.039086517347387,0.0,20.0
44554,4,4554,[237 269 265 300  98],535,2,18396,4.038638858397365,0.0,0.0
44555,4,4555,[  7  88 127 423 588],786,5,18401,4.038849868305531,0.0,20.0
44556,4,4556,[318  79 427 588 216],577,5,18406,4.039060785604565,40.0,0.0
44557,4,4557,[318  79 427 588 216],716,5,18411,4.039271610355419,40.0,0.0
44558,4,4558,[318  79 427 588 216],577,5,18416,4.039482342618995,40.0,0.0
44559,4,4559,[318  79 427 588 216],716,5,18421,4.03969298245614,40.0,0.0
44560,4,4560,[187  98 181 333 111],655,2,18423,4.039245779434334,0.0,0.0
44561,4,4561,[179 357  22 215 269],655,2,18425,4.0387987724682155,0.0,0.0
44562,4,4562,[275 211 300  64 318],655,3,18428,4.038571115494192,40.0,20.0
44563,4,4563,[318  79 427 588 216],577,5,18433,4.038781770376862,40.0,0.0
44564,4,4564,[168 176 655 143  96],796,4,18437,4.038773274917853,0.0,0.0
44565,4,4565,[405 195 132  79 127],655,2,18439,4.038326763031099,0.0,20.0
44566,4,4566,[427   9 483  82 235],269,3,18442,4.038099408802277,20.0,0.0
44567,4,4567,[318  79 427 588 216],577,5,18447,4.038309982486865,40.0,0.0
44568,4,4568,[258 423 282 211   9],693,2,18449,4.037863865178376,0.0,0.0
44569,4,4569,[483 127  71   8 174],796,5,18454,4.038074398249453,0.0,20.0
44570,4,4570,[318  79 427 588 216],796,5,18459,4.038284839203675,40.0,0.0
44571,4,4571,[318  79 427 588 216],577,5,18464,4.038495188101487,40.0,0.0
44572,4,4572,[300  69 515 301 117],655,1,18465,4.037830745681172,0.0,0.0
44573,4,4573,[ 88 276 257  89 483],655,3,18468,4.037603847835593,0.0,0.0
44574,4,4574,[318  79 427 588 216],18,5,18473,4.037814207650273,40.0,0.0
44575,4,4575,[237 318 185   9 258],796,4,18477,4.037805944055944,20.0,0.0
44576,4,4576,[ 79 210   1  82   9],72,4,18481,4.037797684072537,0.0,0.0
44577,4,4577,[195 271 588 333 125],796,5,18486,4.038007863695937,0.0,0.0
44578,4,4578,[318  79 427 588 216],450,5,18491,4.038217951517798,40.0,0.0
44579,4,4579,[100 282 185 286  95],450,4,18495,4.038209606986899,0.0,40.0
44580,4,4580,[275 318 423 172  64],450,5,18500,4.038419559048243,40.0,20.0
44581,4,4581,[318  79 427 588 216],450,5,18505,4.038629419467481,40.0,0.0
44582,4,4582,[265 172 403 118 135],72,2,18507,4.03818459524329,0.0,0.0
44583,4,4583,[318  79 427 588 216],450,5,18512,4.038394415357766,40.0,0.0
44584,4,4584,[ 22 121 127 300 153],450,4,18516,4.038386041439477,0.0,20.0
44585,4,4585,[234 200  79 111 245],280,3,18519,4.038159616223289,0.0,0.0
44586,4,4586,[222 117 483 183 118],450,2,18521,4.037715282319599,0.0,0.0
44587,4,4587,[318  79 427 588 216],796,5,18526,4.0379250217959894,40.0,0.0
44588,4,4588,[151  71 173  97 182],796,4,18530,4.0379167574635,0.0,0.0
44589,4,4589,[258 127 179 546 435],450,5,18535,4.038126361655773,0.0,20.0
44590,4,4590,[ 11 216 288 302 496],344,4,18539,4.038118057068177,20.0,0.0
44591,4,4591,[182 405 333 294 655],655,1,18540,4.0374564459930316,0.0,0.0
44592,4,4592,[318  79 427 588 216],796,5,18545,4.037666013498803,40.0,0.0
44593,4,4593,[318  79 427 588 216],796,5,18550,4.037875489769264,40.0,0.0
44594,4,4594,[318  79 427 588 216],716,5,18555,4.038084874863983,40.0,0.0
44595,4,4595,[ 82 323 135 282 483],280,2,18557,4.037641427328111,0.0,0.0
44596,4,4596,[276 153   8 195 174],535,4,18561,4.037633239068958,0.0,0.0
44597,4,4597,[318  79 427 588 216],18,5,18566,4.037842540234885,40.0,0.0
44598,4,4598,[318  79 427 588 216],716,5,18571,4.038051750380517,40.0,0.0
44599,4,4599,[318  79 427 588 216],796,5,18576,4.038260869565217,40.0,0.0
44600,4,4600,[318  79 427 588 216],577,5,18581,4.038469897848294,40.0,0.0
44601,4,4601,[483  50  11  15 181],269,1,18582,4.03780964797914,0.0,20.0
44602,4,4602,[318  79 427 588 216],577,5,18587,4.038018683467304,40.0,0.0
44603,4,4603,[181 111 245 282 176],280,1,18588,4.037358818418766,0.0,0.0
44604,4,4604,[ 50 313  69 143 300],450,5,18593,4.03756786102063,0.0,20.0
44605,4,4605,[318  79 427 588 216],450,5,18598,4.037776812852801,40.0,0.0
44606,4,4606,[318  79 427 588 216],716,5,18603,4.0379856739743865,40.0,0.0
44607,4,4607,[ 25 483 286 748 301],450,3,18606,4.037760416666667,0.0,20.0
44608,4,4608,[301  79  88 318 742],593,5,18611,4.037969190713821,20.0,0.0
44609,4,4609,[196 176   9 276 471],786,4,18615,4.037960954446855,0.0,0.0
44610,4,4610,[318  79 427 588 216],796,5,18620,4.038169594448059,40.0,0.0
44611,4,4611,[ 12  50 194 282 286],450,5,18625,4.038378143972246,0.0,40.0
44612,4,4612,[318  79 427 588 216],450,5,18630,4.038586603078257,40.0,0.0
44613,4,4613,[318  79 427 588 216],18,5,18635,4.038794971824881,40.0,0.0
44614,4,4614,[191 180 143 245 313],450,5,18640,4.039003250270856,0.0,0.0
44615,4,4615,[ 69 301 181  89  70],151,5,18645,4.03921143847487,0.0,0.0
44616,4,4616,[318  79 427 588 216],716,5,18650,4.03941953649556,40.0,0.0
44617,4,4617,[135 318 118 435 483],151,4,18654,4.039411000433088,20.0,0.0
44618,4,4618,[496 237   8 153 423],269,2,18656,4.038969473912102,20.0,0.0
44619,4,4619,[471 111 216 197  96],716,3,18659,4.0387445887445885,0.0,0.0
44620,4,4620,[318  79 427 588 216],716,5,18664,4.038952607660679,40.0,0.0
44621,4,4621,[318  79 427 588 216],450,5,18669,4.039160536564258,40.0,0.0
44622,4,4622,[318  79 427 588 216],577,5,18674,4.039368375513735,40.0,0.0
44623,4,4623,[385  12 111 191 144],457,4,18678,4.039359861591696,0.0,0.0
44624,4,4624,[275 185 118 655 197],457,5,18683,4.039567567567568,0.0,20.0
44625,4,4625,[403 237 328 655 286],224,3,18686,4.0393428447903155,0.0,20.0
44626,4,4626,[118  50 282  56  79],450,4,18690,4.039334341906203,0.0,20.0
44627,4,4627,[318  79 427 588 216],450,5,18695,4.039541918755402,40.0,0.0
44628,4,4628,[176  79   9  22 301],655,1,18696,4.038885288399222,0.0,0.0
44629,4,4629,[546 121 202  25 588],457,4,18700,4.038876889848812,0.0,0.0
44630,4,4630,[318  79 427 588 216],18,5,18705,4.039084431008422,40.0,0.0
44631,4,4631,[294 423 427 655  64],655,2,18707,4.038644214162349,40.0,0.0
44632,4,4632,[357   4 385 215 173],796,5,18712,4.038851715950788,0.0,0.0
44633,4,4633,[174   9 276  98  95],18,5,18717,4.039059128182995,0.0,0.0
44634,4,4634,[234 182  15 183 143],593,3,18720,4.038834951456311,0.0,0.0
44635,4,4635,[318  79 427 588 216],796,5,18725,4.039042277825712,40.0,0.0
44636,4,4636,[215 121 268  28 180],11,2,18727,4.03860254474876,0.0,0.0
44637,4,4637,[318  79 427 588 216],450,5,18732,4.038809831824062,40.0,0.0
44638,4,4638,[318  79 427 588 216],796,5,18737,4.039017029532227,40.0,0.0
44639,4,4639,[427  56 269 405 196],23,4,18741,4.039008620689655,20.0,0.0
44640,4,4640,[318  79 427 588 216],450,5,18746,4.03921568627451,40.0,0.0
44641,4,4641,[318  79 427 588 216],450,5,18751,4.0394226626454115,40.0,0.0
44642,4,4642,[318  79 427 588 216],796,5,18756,4.039629549860004,40.0,0.0
44643,4,4643,[318  79 427 588 216],18,5,18761,4.039836347975883,40.0,0.0
44644,4,4644,[471 121  12 180 568],457,5,18766,4.040043057050592,0.0,0.0
44645,4,4645,[187 121 182  98 216],256,4,18770,4.0400344382264315,0.0,0.0
44646,4,4646,[  1 172 215  56 200],655,2,18772,4.039595437916936,0.0,0.0
44647,4,4647,[125 289 496 276 238],786,4,18776,4.039586919104991,20.0,0.0
44648,4,4648,[748 216 357 191  56],151,3,18779,4.03936330393633,0.0,0.0
44649,4,4649,[318  79 427 588 216],18,5,18784,4.039569892473119,40.0,0.0
44650,4,4650,[471 282 161 483  79],280,3,18787,4.039346377123199,0.0,0.0
44651,4,4651,[ 50  69  11   8 153],280,4,18791,4.039337919174549,0.0,20.0
44652,4,4652,[318  79 427 588 216],796,5,18796,4.039544379969912,40.0,0.0
44653,4,4653,[318  79 427 588 216],716,5,18801,4.039750752041255,40.0,0.0
44654,4,4654,[ 82 186 423 748   1],807,5,18806,4.039957035445758,0.0,0.0
44655,4,4655,[318  79 427 588 216],450,5,18811,4.04016323024055,40.0,0.0
44656,4,4656,[ 64 405 357 132 234],796,4,18815,4.040154605969509,20.0,0.0
44657,4,4657,[  4 235 275 185  70],457,4,18819,4.04014598540146,0.0,20.0
44658,4,4658,[100 385 405 568 515],655,1,18820,4.039493453530801,0.0,20.0
44659,4,4659,[183 427 185 546 161],796,5,18825,4.039699570815451,20.0,0.0
44660,4,4660,[318  79 427 588 216],716,5,18830,4.039905599656726,40.0,0.0
44661,4,4661,[121 265 333 168  22],796,5,18835,4.04011154011154,0.0,0.0
44662,4,4662,[318  79 427 588 216],716,5,18840,4.040317392236758,40.0,0.0
44663,4,4663,[187 508 195 180  28],693,1,18841,4.039665523156089,0.0,0.0
44664,4,4664,[ 98  50 216 210  79],577,4,18845,4.039657020364416,0.0,20.0
44665,4,4665,[318 179 301 385 182],593,4,18849,4.039648521217317,20.0,0.0
44666,4,4666,[328 174  50 258 269],450,5,18854,4.039854296121706,0.0,20.0
44667,4,4667,[168 118 161  71  69],330,4,18858,4.039845758354756,0.0,0.0
44668,4,4668,[204 100  11 294 427],296,4,18862,4.03983722424502,20.0,20.0
44669,4,4669,[194 182 435 191  97],450,5,18867,4.040042826552463,0.0,0.0
44670,4,4670,[211   4 603 228 117],655,1,18868,4.039391993149218,20.0,0.0
44671,4,4671,[318  79 427 588 216],796,5,18873,4.039597602739726,40.0,0.0
44672,4,4672,[318  79 427 588 216],796,5,18878,4.039803124331264,40.0,0.0
44673,4,4673,[215  11 180 118 200],450,3,18881,4.039580658964485,0.0,0.0
44674,4,4674,[318  79 427 588 216],18,5,18886,4.039786096256685,40.0,0.0
44675,4,4675,[258 742 111 176  71],796,4,18890,4.03977758768178,0.0,0.0
44676,4,4676,[ 79 588 300 301 121],450,4,18894,4.03976908274535,0.0,0.0
44677,4,4677,[121 100 427 179 515],655,3,18897,4.039546814878153,20.0,20.0
44678,4,4678,[318  79 427 588 216],796,5,18902,4.039752083778585,40.0,0.0
44679,4,4679,[515   1 286 435 181],18,4,18906,4.03974358974359,0.0,20.0
44680,4,4680,[318  79 427 588 216],577,5,18911,4.03994872890408,40.0,0.0
44681,4,4681,[235  82 238 282 496],716,3,18914,4.039726612558735,20.0,0.0
44682,4,4682,[118 269 748 185 423],796,4,18918,4.039718129404228,0.0,0.0
44683,4,4683,[318  79 427 588 216],18,5,18923,4.039923142613151,40.0,0.0
44684,4,4684,[435 151 204  56 483],18,3,18926,4.039701173959445,0.0,0.0
44685,4,4685,[318  79 427 588 216],796,5,18931,4.039906103286385,40.0,0.0
44686,4,4686,[483 258 186  97 357],535,4,18935,4.039897589076168,0.0,0.0
44687,4,4687,[111  56 742 191 161],655,1,18936,4.039249146757679,0.0,0.0
44688,4,4688,[318  79 427 588 216],796,5,18941,4.0394540413734275,40.0,0.0
44689,4,4689,[ 97 144 328 151  50],796,4,18945,4.039445628997868,0.0,20.0
44690,4,4690,[496  98 186 172 273],450,3,18948,4.03922404604562,20.0,0.0
44691,4,4691,[318  79 427 588 216],450,5,18953,4.039428815004262,40.0,0.0
44692,4,4692,[132 144 257 245 603],796,4,18957,4.039420413381632,20.0,0.0
44693,4,4693,[318  79 427 588 216],796,5,18962,4.03962505325948,40.0,0.0
44694,4,4694,[318  79 427 588 216],716,5,18967,4.039829605963791,40.0,0.0
44695,4,4695,[183  82 127 182  22],280,2,18969,4.039395229982964,0.0,20.0
44696,4,4696,[318  79 427 588 216],577,5,18974,4.039599744517777,40.0,0.0
44697,4,4697,[322 357 182 143 568],450,5,18979,4.03980417198808,0.0,0.0
44698,4,4698,[318  79 427 588 216],18,5,18984,4.040008512449457,40.0,0.0
44699,4,4699,[357 322  12 211  79],796,3,18987,4.039787234042553,0.0,0.0
44700,4,4700,[318  79 427 588 216],18,5,18992,4.039991491172091,40.0,0.0
44701,4,4701,[153 132 174 183 168],269,2,18994,4.039557635048915,0.0,0.0
44702,4,4702,[318  79 427 588 216],796,5,18999,4.039761854135658,40.0,0.0
44703,4,4703,[318  79 427 588 216],716,5,19004,4.039965986394558,40.0,0.0
44704,4,4704,[385 403 135 111  69],450,4,19008,4.039957492029756,0.0,0.0
44705,4,4705,[318  79 427 588 216],716,5,19013,4.040161495962601,40.0,0.0
44706,4,4706,[258 483  11 185 127],450,4,19017,4.040152963671128,0.0,20.0
44707,4,4707,[318  79 427 588 216],796,5,19022,4.04035683942226,40.0,0.0
44708,4,4708,[ 89 508 269 282 435],296,5,19027,4.040560628583563,0.0,0.0
44709,4,4709,[300  64 186 268 238],535,3,19030,4.040339702760085,20.0,0.0
44710,4,4710,[197 748  69 275 471],450,5,19035,4.040543409042666,0.0,20.0
44711,4,4711,[318  79 427 588 216],577,5,19040,4.040747028862479,40.0,0.0
44712,4,4712,[318  79 427 588 216],450,5,19045,4.04095056227456,40.0,0.0
44713,4,4713,[318  79 427 588 216],796,5,19050,4.041154009333899,40.0,0.0
44714,4,4714,[187 568 111 405  79],450,5,19055,4.04135737009544,0.0,0.0
44715,4,4715,[ 82 289 196 276 508],655,1,19056,4.040712468193385,0.0,0.0
44716,4,4716,[127 276 273 655 257],401,1,19057,4.040067839728641,0.0,20.0
44717,4,4717,[318  79 427 588 216],716,5,19062,4.040271301398898,40.0,0.0
44718,4,4718,[318  79 427 588 216],796,5,19067,4.040474676838313,40.0,0.0
44719,4,4719,[117 180 318 181 143],716,4,19071,4.040466101694915,20.0,0.0
44720,4,4720,[ 56 127 471 318  79],72,5,19076,4.040669349714044,20.0,20.0
44721,4,4721,[318  79 427 588 216],796,5,19081,4.040872511647607,40.0,0.0
44722,4,4722,[318  79 427 588 216],18,5,19086,4.041075587550286,40.0,0.0
44723,4,4723,[318  79 427 588 216],18,5,19091,4.041278577476715,40.0,0.0
44724,4,4724,[ 97 187 235 173 143],450,4,19095,4.041269841269841,0.0,0.0
44725,4,4725,[318  79 427 588 216],796,5,19100,4.04147270418959,40.0,0.0
44726,4,4726,[318  79 427 588 216],796,5,19105,4.041675481277766,40.0,0.0
44727,4,4727,[168 186   4 151 121],457,5,19110,4.041878172588833,0.0,0.0
44728,4,4728,[ 70 515 748 191 204],401,4,19114,4.041869316980334,0.0,0.0
44729,4,4729,[181 385  79 172 100],5,4,19118,4.0418604651162795,0.0,20.0
44730,4,4730,[318  79 427 588 216],577,5,19123,4.042062988797294,40.0,0.0
44731,4,4731,[187 603 135  98 196],389,3,19126,4.041842772612004,20.0,0.0
44732,4,4732,[318  79 427 588 216],450,5,19131,4.042045214451722,40.0,0.0
44733,4,4733,[ 79  15 183  22 173],457,5,19136,4.042247570764681,0.0,0.0
44734,4,4734,[318  79 427 588 216],577,5,19141,4.042449841605069,40.0,0.0
44735,4,4735,[191 118 385 222 275],151,2,19143,4.042018581081081,0.0,20.0
44736,4,4736,[318  79 427 588 216],577,5,19148,4.042220814861727,40.0,0.0
44737,4,4737,[211   9 568 216 423],796,3,19151,4.042000844238075,0.0,0.0
44738,4,4738,[265 144   4 186 257],655,0,19151,4.041147921502427,0.0,0.0
44739,4,4739,[194 187 144 238 185],535,3,19154,4.040928270042194,0.0,0.0
44740,4,4740,[121 200  50 216 275],151,4,19158,4.04091963720734,0.0,40.0
44741,4,4741,[318  79 427 588 216],796,5,19163,4.041121889498102,40.0,0.0
44742,4,4742,[ 50 197 423 185  82],796,3,19166,4.04090238245836,0.0,20.0
44743,4,4743,[318  79 427 588 216],716,5,19171,4.04110455311973,40.0,0.0
44744,4,4744,[318  79 427 588 216],796,5,19176,4.041306638566913,40.0,0.0
44745,4,4745,[597 228 191 385 300],796,5,19181,4.041508638853772,0.0,0.0
44746,4,4746,[168 172  15 125  95],796,5,19186,4.041710554034127,0.0,0.0
44747,4,4747,[  4   1 228 742 153],280,3,19189,4.041491154170177,0.0,0.0
44748,4,4748,[318  79 427 588 216],450,5,19194,4.0416929879974735,40.0,0.0
44749,4,4749,[173 286 197  89 496],450,5,19199,4.041894736842106,20.0,20.0
44750,4,4750,[588 181 121 275 191],401,2,19201,4.0414649547463695,0.0,20.0
44751,4,4751,[318  79 427 588 216],716,5,19206,4.041666666666667,40.0,0.0
44752,4,4752,[238  82   1 269 111],655,0,19206,4.040816326530612,0.0,0.0
44753,4,4753,[318  79 427 588 216],18,5,19211,4.041018090029449,40.0,0.0
44754,4,4754,[186 185 135 121 143],655,3,19214,4.040799158780231,0.0,0.0
44755,4,4755,[276   9 269  22 215],344,3,19217,4.040580319596299,0.0,0.0
44756,4,4756,[318  79 427 588 216],18,5,19222,4.04078200546563,40.0,0.0
44757,4,4757,[318  79 427 588 216],18,5,19227,4.040983606557377,40.0,0.0
44758,4,4758,[318  79 427 588 216],450,5,19232,4.041185122924984,40.0,0.0
44759,4,4759,[318  79 427 588 216],796,5,19237,4.041386554621849,40.0,0.0
44760,4,4760,[318  79 427 588 216],577,5,19242,4.041587901701323,40.0,0.0
44761,4,4761,[318  79 427 588 216],796,5,19247,4.041789164216715,40.0,0.0
44762,4,4762,[216  28 111 211 546],151,4,19251,4.041780390510183,0.0,0.0
44763,4,4763,[318  79 427 588 216],577,5,19256,4.041981528127624,40.0,0.0
44764,4,4764,[182 302 143 471 153],655,3,19259,4.041762854144806,0.0,0.0
44765,4,4765,[318  79 427 588 216],716,5,19264,4.041963911036508,40.0,0.0
44766,4,4766,[ 11  56  28 655 302],450,5,19269,4.042164883574575,0.0,0.0
44767,4,4767,[405 427 179 742 483],450,4,19273,4.042156040268456,20.0,0.0
44768,4,4768,[  9 186 173 328 318],151,4,19277,4.042147200671001,20.0,0.0
44769,4,4769,[ 12   7  88 204 282],655,0,19277,4.041299790356394,0.0,0.0
44770,4,4770,[318  79 427 588 216],18,5,19282,4.041500733598826,40.0,0.0
44771,4,4771,[181 121   1 275  89],457,5,19287,4.041701592623638,0.0,20.0
44772,4,4772,[655 183 197  69 125],280,1,19288,4.041064320134088,0.0,0.0
44773,4,4773,[132 100 176 183 200],269,3,19291,4.0408462505236695,0.0,20.0
44774,4,4774,[273 300  64 117 132],655,2,19293,4.04041884816754,20.0,0.0
44775,4,4775,[ 25   8 234 204 200],18,1,19294,4.039782244556114,0.0,0.0
44776,4,4776,[318  79 427 588 216],796,5,19299,4.039983253087712,40.0,0.0
44777,4,4777,[318  79 427 588 216],716,5,19304,4.040184177480117,40.0,0.0
44778,4,4778,[ 22 282 483 197 135],457,5,19309,4.040385017786147,0.0,0.0
44779,4,4779,[132 195 289 275 403],655,1,19310,4.039748953974895,0.0,20.0
44780,4,4780,[318 144 258  70 483],655,2,19312,4.039322317506798,20.0,0.0
44781,4,4781,[294 427 435 289 237],296,3,19315,4.039104976997073,20.0,0.0
44782,4,4782,[318  79 427 588 216],450,5,19320,4.0393058749738655,40.0,0.0
44783,4,4783,[ 88 288 182   1 357],457,5,19325,4.03950668896321,0.0,0.0
44784,4,4784,[427 196  71 515 238],18,4,19329,4.039498432601881,20.0,0.0
44785,4,4785,[173 215 195 185   7],457,5,19334,4.039699122440451,0.0,0.0
44786,4,4786,[318  79 427 588 216],450,5,19339,4.039899728431168,40.0,0.0
44787,4,4787,[318  79 427 588 216],716,5,19344,4.040100250626566,40.0,0.0
44788,4,4788,[ 79 655 161 273 748],796,3,19347,4.039883065358112,0.0,0.0
44789,4,4789,[318  79 427 588 216],716,5,19352,4.040083507306889,40.0,0.0
44790,4,4790,[132   1 176 471 117],577,4,19356,4.040075140889167,0.0,0.0
44791,4,4791,[318  79 427 588 216],450,5,19361,4.040275459098497,40.0,0.0
44792,4,4792,[ 79  50 118 161 168],389,3,19364,4.0400584185270185,0.0,20.0
44793,4,4793,[318  79 427 588 216],18,5,19369,4.040258656654151,40.0,0.0
44794,4,4794,[318  79 427 588 216],577,5,19374,4.040458811261731,40.0,0.0
44795,4,4795,[111 191 172 385  71],401,2,19376,4.040033361134278,0.0,0.0
44796,4,4796,[328 301 211 423 191],796,3,19379,4.039816552011674,0.0,0.0
44797,4,4797,[125   9 186 211  71],18,4,19383,4.039808253438933,0.0,0.0
44798,4,4798,[318  79 427 588 216],450,5,19388,4.040008335069806,40.0,0.0
44799,4,4799,[175 125   9  11  82],457,5,19393,4.040208333333333,0.0,0.0
44800,4,4800,[318  79 427 588 216],577,5,19398,4.040408248281608,40.0,0.0
44801,4,4801,[257 202 222  56 333],655,0,19398,4.039566847147022,0.0,0.0
44802,4,4802,[117 187 135   1  25],655,2,19400,4.039142202789923,0.0,0.0
44803,4,4803,[181 508 182  70 172],535,3,19403,4.038925895087427,0.0,0.0
44804,4,4804,[127   4 385 403  82],504,4,19407,4.03891779396462,0.0,20.0
44805,4,4805,[318  79 427 588 216],577,5,19412,4.039117769454848,40.0,0.0
44806,4,4806,[483 172 234  98  64],796,4,19416,4.039109631786977,20.0,0.0
44807,4,4807,[197 125 323 282 132],796,3,19419,4.038893510815308,0.0,0.0
44808,4,4808,[181 172 385  11 168],330,4,19423,4.038885423164899,0.0,0.0
44809,4,4809,[195 435 597 161 180],269,0,19423,4.038045738045738,0.0,0.0
44810,4,4810,[318  79 427 588 216],796,5,19428,4.038245686967366,40.0,0.0
44811,4,4811,[318  79 427 588 216],796,5,19433,4.0384455527847045,40.0,0.0
44812,4,4812,[ 15 471 187 176 100],786,4,19437,4.038437564928319,0.0,20.0
44813,4,4813,[153  12 546 568 125],450,5,19442,4.038637307852098,0.0,0.0
44814,4,4814,[318  79 427 588 216],716,5,19447,4.038836967808931,40.0,0.0
44815,4,4815,[183  70 135 546 483],716,2,19449,4.038413621262459,0.0,0.0
44816,4,4816,[  4 100 173 161 216],450,4,19453,4.038405646668051,0.0,20.0
44817,4,4817,[318  79 427 588 216],796,5,19458,4.038605230386052,40.0,0.0
44818,4,4818,[742  56  25 568 200],457,5,19463,4.038804731272048,0.0,0.0
44819,4,4819,[748 144 588 300 151],450,5,19468,4.039004149377593,0.0,0.0
44820,4,4820,[210 118   4 603  64],655,2,19470,4.038581207218419,40.0,0.0
44821,4,4821,[471  15 202  25  28],65,5,19475,4.038780588967233,0.0,0.0
44822,4,4822,[ 89 405  70 175   7],151,4,19479,4.03877254820651,0.0,0.0
44823,4,4823,[ 64 180 196 742 234],457,5,19484,4.038971807628524,20.0,0.0
44824,4,4824,[235 176 265 197 288],450,3,19487,4.038756476683938,0.0,0.0
44825,4,4825,[ 15 174 202 288 385],256,4,19491,4.038748445917944,0.0,0.0
44826,4,4826,[318  79 427 588 216],577,5,19496,4.038947586492646,40.0,0.0
44827,4,4827,[318  79 427 588 216],577,5,19501,4.039146644573322,40.0,0.0
44828,4,4828,[195 125 111 265 427],151,4,19505,4.039138537999586,20.0,0.0
44829,4,4829,[318  79 427 588 216],577,5,19510,4.0393374741200825,40.0,0.0
44830,4,4830,[179 475 185 301  88],389,4,19514,4.039329331401366,0.0,0.0
44831,4,4831,[172 181 121 200 187],716,4,19518,4.03932119205298,0.0,0.0
44832,4,4832,[318  79 427 588 216],716,5,19523,4.039519966894269,40.0,0.0
44833,4,4833,[318  79 427 588 216],18,5,19528,4.039718659495242,40.0,0.0
44834,4,4834,[176   1   7  11  69],457,5,19533,4.039917269906929,0.0,0.0
44835,4,4835,[588 302  22 483 210],450,3,19536,4.039702233250621,0.0,0.0
44836,4,4836,[185 117 588 222 403],796,5,19541,4.039900764936944,0.0,0.0
44837,4,4837,[318  79 427 588 216],796,5,19546,4.040099214551468,40.0,0.0
44838,4,4838,[210   8  64  88 496],344,4,19550,4.040090927877661,40.0,0.0
44839,4,4839,[313 301 168 588 423],796,4,19554,4.040082644628099,0.0,0.0
44840,4,4840,[423  28 125 135 288],457,5,19559,4.040280933691386,0.0,0.0
44841,4,4841,[318  79 427 588 216],18,5,19564,4.040479140850888,40.0,0.0
44842,4,4842,[237 100 282  22 515],535,2,19566,4.040057815403675,0.0,20.0
44843,4,4843,[ 11 496  15  50  88],269,1,19567,4.039430222956234,20.0,20.0
44844,4,4844,[318  79 427 588 216],716,5,19572,4.0396284829721365,40.0,0.0
44845,4,4845,[111  96 238 403  28],450,5,19577,4.039826661163846,0.0,0.0
44846,4,4846,[483 196 118   8 144],457,5,19582,4.040024757582009,0.0,0.0
44847,4,4847,[496 197 118  88 200],796,4,19586,4.0400165016501655,20.0,0.0
44848,4,4848,[318  79 427 588 216],18,5,19591,4.040214477211796,40.0,0.0
44849,4,4849,[ 71 273  88 202 238],450,3,19594,4.04,0.0,0.0
44850,4,4850,[318  79 427 588 216],716,5,19599,4.040197897340755,40.0,0.0
44851,4,4851,[318  79 427 588 216],716,5,19604,4.040395713107997,40.0,0.0
44852,4,4852,[187 196 655 117  28],796,3,19607,4.04018133113538,0.0,0.0
44853,4,4853,[173   9 144 216   7],280,3,19610,4.03996703749485,0.0,0.0
44854,4,4854,[318  79 427 588 216],716,5,19615,4.040164778578784,40.0,0.0
44855,4,4855,[318  79 427 588 216],577,5,19620,4.0403624382207575,40.0,0.0
44856,4,4856,[318  79 427 588 216],796,5,19625,4.040560016471073,40.0,0.0
44857,4,4857,[286  79 435  98 475],503,2,19627,4.040139975298477,0.0,20.0
44858,4,4858,[318  79 427 588 216],577,5,19632,4.040337518007821,40.0,0.0
44859,4,4859,[318  79 427 588 216],577,5,19637,4.040534979423868,40.0,0.0
44860,4,4860,[318  79 427 588 216],18,5,19642,4.040732359596791,40.0,0.0
44861,4,4861,[121 194 403   1 603],72,3,19645,4.040518305224188,20.0,0.0
44862,4,4862,[228 135 496 210 568],450,3,19648,4.040304338885462,20.0,0.0
44863,4,4863,[318  79 427 588 216],450,5,19653,4.0405016447368425,40.0,0.0
44864,4,4864,[318  79 427 588 216],716,5,19658,4.040698869475848,40.0,0.0
44865,4,4865,[318  79 427 588 216],577,5,19663,4.040896013152486,40.0,0.0
44866,4,4866,[237 172  50 678 202],256,3,19666,4.0406821450585575,0.0,20.0
44867,4,4867,[ 70 275 483  15  79],18,5,19671,4.040879211175021,0.0,20.0
44868,4,4868,[168 100 237 568 197],457,5,19676,4.0410761963442186,0.0,20.0
44869,4,4869,[235 588 168 186 127],716,3,19679,4.040862422997947,0.0,20.0
44870,4,4870,[301 313 403 269   8],796,3,19682,4.04064873742558,0.0,0.0
44871,4,4871,[318  79 427 588 216],577,5,19687,4.040845648604269,40.0,0.0
44872,4,4872,[  4  12 237 175 197],655,0,19687,4.040016416991587,0.0,0.0
44873,4,4873,[471 197  15  70 191],72,5,19692,4.0402133771029956,0.0,0.0
44874,4,4874,[318  79 427 588 216],450,5,19697,4.040410256410256,40.0,0.0
44875,4,4875,[245 237  97 194  28],796,2,19699,4.039991796554553,0.0,0.0
44876,4,4876,[211   8 282 318 181],535,4,19703,4.039983596473242,20.0,0.0
44877,4,4877,[318  79 427 588 216],450,5,19708,4.040180401804018,40.0,0.0
44878,4,4878,[268 269 286  56 435],535,2,19710,4.03976224636196,0.0,20.0
44879,4,4879,[ 12 186  64 151 655],450,4,19714,4.039754098360656,20.0,0.0
44880,4,4880,[211 204 143  88 135],655,2,19716,4.039336201598033,0.0,0.0
44881,4,4881,[568 508  25  79  88],344,4,19720,4.039328144203195,0.0,0.0
44882,4,4882,[ 79 235 483 117 118],716,3,19723,4.0391152979725575,0.0,0.0
44883,4,4883,[318  79 427 588 216],796,5,19728,4.03931203931204,40.0,0.0
44884,4,4884,[318  79 427 588 216],450,5,19733,4.039508700102354,40.0,0.0
44885,4,4885,[318  79 427 588 216],796,5,19738,4.039705280392959,40.0,0.0
44886,4,4886,[318  79 427 588 216],450,5,19743,4.039901780233272,40.0,0.0
44887,4,4887,[318  79 427 588 216],450,5,19748,4.040098199672668,40.0,0.0
44888,4,4888,[ 95 135 228  25 405],450,2,19750,4.03968091634281,0.0,0.0
44889,4,4889,[168 435 111 228 195],716,4,19754,4.039672801635992,0.0,0.0
44890,4,4890,[ 70 196 172  79 117],655,2,19756,4.0392557759149454,0.0,0.0
44891,4,4891,[ 25 210 211 405 125],593,2,19758,4.038838920686835,0.0,0.0
44892,4,4892,[318  79 427 588 216],450,5,19763,4.039035356631923,40.0,0.0
44893,4,4893,[ 97 235 183  11 288],344,2,19765,4.038618716796077,0.0,0.0
44894,4,4894,[318  79 427 588 216],450,5,19770,4.038815117466803,40.0,0.0
44895,4,4895,[265 153 180 471 427],716,3,19773,4.038602941176471,20.0,0.0
44896,4,4896,[318  79 427 588 216],796,5,19778,4.038799264856034,40.0,0.0
44897,4,4897,[ 71 318 322 204 196],401,3,19781,4.03858717844018,20.0,0.0
44898,4,4898,[318  79 427 588 216],18,5,19786,4.038783425188814,40.0,0.0
44899,4,4899,[318  79 427 588 216],450,5,19791,4.038979591836735,40.0,0.0
44900,4,4900,[471 748  12 215 318],450,5,19796,4.039175678432973,20.0,0.0
44901,4,4901,[435  89 301 228 265],450,5,19801,4.03937168502652,0.0,0.0
44902,4,4902,[318  79 427 588 216],716,5,19806,4.039567611666326,40.0,0.0
44903,4,4903,[318  79 427 588 216],796,5,19811,4.039763458401305,40.0,0.0
44904,4,4904,[318  79 427 588 216],577,5,19816,4.0399592252803265,40.0,0.0
44905,4,4905,[318  79 427 588 216],796,5,19821,4.040154912352222,40.0,0.0
44906,4,4906,[185 202 204  69  96],457,5,19826,4.040350519665783,0.0,0.0
44907,4,4907,[196 197 603  12 245],450,5,19831,4.040546047269764,20.0,0.0
44908,4,4908,[318  79 427 588 216],18,5,19836,4.040741495212874,40.0,0.0
44909,4,4909,[172 127 117  64  50],450,5,19841,4.040936863543788,20.0,40.0
44910,4,4910,[216  50 289 135 176],693,2,19843,4.040521278761963,0.0,20.0
44911,4,4911,[111 125  98   8 173],457,4,19847,4.040513029315961,0.0,0.0
44912,4,4912,[318  79 427 588 216],796,5,19852,4.0407083248524325,40.0,0.0
44913,4,4913,[318  79 427 588 216],577,5,19857,4.040903540903541,40.0,0.0
44914,4,4914,[228 235  70   1 742],344,1,19858,4.04028484231943,0.0,0.0
44915,4,4915,[318  79 427 588 216],577,5,19863,4.040480065093572,40.0,0.0
44916,4,4916,[200 678 161 135  98],280,4,19867,4.040471832418141,0.0,0.0
44917,4,4917,[ 50 202 187 118   7],450,4,19871,4.0404636030906875,0.0,20.0
44918,4,4918,[  4 286 258 111 185],655,1,19872,4.039845497052246,0.0,20.0
44919,4,4919,[546 118 132 313  11],280,3,19875,4.039634146341464,0.0,0.0
44920,4,4920,[318  79 427 588 216],450,5,19880,4.039829302987198,40.0,0.0
44921,4,4921,[318  79 427 588 216],450,5,19885,4.040024380333198,40.0,0.0
44922,4,4922,[318  79 427 588 216],796,5,19890,4.040219378427788,40.0,0.0
44923,4,4923,[258 127 196  56  22],457,5,19895,4.040414297319253,0.0,20.0
44924,4,4924,[ 69 215 187 748 117],450,5,19900,4.040609137055838,0.0,0.0
44925,4,4925,[318  79 427 588 216],716,5,19905,4.040803897685749,40.0,0.0
44926,4,4926,[ 96 143 216 168 121],716,4,19909,4.040795615993505,0.0,0.0
44927,4,4927,[  4  64  22 603 313],796,5,19914,4.040990259740259,40.0,0.0
44928,4,4928,[405 143 471 216 222],457,5,19919,4.041184824508014,0.0,0.0
44929,4,4929,[318  79 427 588 216],716,5,19924,4.041379310344827,40.0,0.0
44930,4,4930,[318  79 427 588 216],796,5,19929,4.041573717298722,40.0,0.0
44931,4,4931,[328 153 182 288 276],655,2,19931,4.041159772911597,0.0,0.0
44932,4,4932,[318  79 427 588 216],577,5,19936,4.041354145550375,40.0,0.0
44933,4,4933,[127 435  97 111 173],401,3,19939,4.041143088771787,0.0,20.0
44934,4,4934,[ 88 273 210 191 132],236,2,19941,4.040729483282675,0.0,0.0
44935,4,4935,[318  79 427 588 216],796,5,19946,4.040923824959481,40.0,0.0
44936,4,4936,[318  79 427 588 216],796,5,19951,4.041118087907636,40.0,0.0
44937,4,4937,[546 172 183 258 357],23,2,19953,4.040704738760632,0.0,0.0
44938,4,4938,[174 204 257 515 471],401,4,19957,4.040696497266653,0.0,0.0
44939,4,4939,[185 275 655 197 174],401,4,19961,4.040688259109312,0.0,20.0
44940,4,4940,[276 151 483  70  97],401,4,19965,4.040680024286582,0.0,0.0
44941,4,4941,[194 132  79 496 603],796,5,19970,4.040874140024282,40.0,0.0
44942,4,4942,[ 69  88 496 215 151],330,5,19975,4.041068177220311,20.0,0.0
44943,4,4943,[318  79 427 588 216],577,5,19980,4.04126213592233,40.0,0.0
44944,4,4944,[318  79 427 588 216],577,5,19985,4.041456016177958,40.0,0.0
44945,4,4945,[318  79 427 588 216],577,5,19990,4.0416498180347755,40.0,0.0
44946,4,4946,[385 174  70  11 151],716,4,19994,4.041641398827572,0.0,0.0
44947,4,4947,[185 258 195 603   9],535,5,19999,4.041835084882781,20.0,0.0
44948,4,4948,[318  79 427 588 216],450,5,20004,4.042028692665185,40.0,0.0
44949,4,4949,[318  95 597 275 655],450,4,20008,4.042020202020202,20.0,20.0
44950,4,4950,[197   8 185 174 179],269,3,20011,4.041809735406988,0.0,0.0
44951,4,4951,[ 98 234 211 174  71],786,4,20015,4.041801292407108,0.0,0.0
44952,4,4952,[318  79 427 588 216],577,5,20020,4.041994750656168,40.0,0.0
44953,4,4953,[323 328   8 282 318],796,4,20024,4.041986273718208,20.0,0.0
44954,4,4954,[216  89 385 237 228],457,5,20029,4.042179616548941,0.0,0.0
44955,4,4955,[200 132 258 100 174],655,1,20030,4.041565778853914,0.0,20.0
44956,4,4956,[ 22 603 655  50 196],796,4,20034,4.04155739358483,20.0,20.0
44957,4,4957,[143 269  25 423  89],18,3,20037,4.0413473174667205,0.0,0.0
44958,4,4958,[118 289 483 200   4],655,2,20039,4.04093567251462,0.0,0.0
44959,4,4959,[318  79 427 588 216],716,5,20044,4.041129032258064,40.0,0.0
44960,4,4960,[100 161 196  50 191],450,5,20049,4.041322314049586,0.0,40.0
44961,4,4961,[ 79 234 197 515 194],18,3,20052,4.041112454655381,0.0,0.0
44962,4,4962,[202  50 127  71 132],504,3,20055,4.040902679830747,0.0,40.0
44963,4,4963,[269 302  22 301 423],655,1,20056,4.040290088638195,0.0,0.0
44964,4,4964,[423 211 153  50 185],796,4,20060,4.040281973816717,0.0,20.0
44965,4,4965,[318  79 427 588 216],18,5,20065,4.040475231574708,40.0,0.0
44966,4,4966,[318  79 427 588 216],796,5,20070,4.040668411516005,40.0,0.0
44967,4,4967,[318  79 427 588 216],796,5,20075,4.0408615136876005,40.0,0.0
44968,4,4968,[318  79 427 588 216],577,5,20080,4.0410545381364456,40.0,0.0
44969,4,4969,[196 288 125  50 111],344,4,20084,4.041046277665996,0.0,20.0
44970,4,4970,[ 50 118 127  98 174],72,3,20087,4.0408368537517605,0.0,40.0
44971,4,4971,[210 161  64 273  70],655,2,20089,4.040426387771521,20.0,0.0
44972,4,4972,[ 28 275 111 194 301],151,5,20094,4.040619344460085,0.0,20.0
44973,4,4973,[318  79 427 588 216],796,5,20099,4.040812223562525,40.0,0.0
44974,4,4974,[174 385 118 216 117],716,3,20102,4.0406030150753764,0.0,0.0
44975,4,4975,[483 257 161 435  25],655,1,20103,4.039991961414791,0.0,0.0
44976,4,4976,[318  79 427 588 216],716,5,20108,4.040184850311433,40.0,0.0
44977,4,4977,[328  98 132 210 322],151,3,20111,4.039975893933306,0.0,0.0
44978,4,4978,[318  79 427 588 216],18,5,20116,4.04016870857602,40.0,0.0
44979,4,4979,[117 161  15 151 275],152,5,20121,4.040361445783133,0.0,20.0
44980,4,4980,[318  79 427 588 216],450,5,20126,4.040554105601285,40.0,0.0
44981,4,4981,[318 132 271  56 127],655,2,20128,4.040144520272983,20.0,20.0
44982,4,4982,[318  79 427 588 216],450,5,20133,4.040337146297412,40.0,0.0
44983,4,4983,[318  79 427 588 216],577,5,20138,4.040529695024077,40.0,0.0
44984,4,4984,[318  79 427 588 216],716,5,20143,4.040722166499498,40.0,0.0
44985,4,4985,[318  79 427 588 216],450,5,20148,4.040914560770156,40.0,0.0
44986,4,4986,[496 197 180 471  98],450,5,20153,4.041106877882495,20.0,0.0
44987,4,4987,[318  79 427 588 216],716,5,20158,4.041299117882919,40.0,0.0
44988,4,4988,[318  79 427 588 216],450,5,20163,4.041491280817799,40.0,0.0
44989,4,4989,[273 276 597 471 302],344,3,20166,4.041282565130261,0.0,0.0
44990,4,4990,[ 98 125   7 385 588],786,5,20171,4.04147465437788,0.0,0.0
44991,4,4991,[318  79 427 588 216],450,5,20176,4.041666666666667,40.0,0.0
44992,4,4992,[318  79 427 588 216],450,5,20181,4.04185860204286,40.0,0.0
44993,4,4993,[318  79 427 588 216],450,5,20186,4.042050460552663,40.0,0.0
44994,4,4994,[403 237 121  70 196],450,4,20190,4.042042042042042,0.0,0.0
44995,4,4995,[318  79 427 588 216],18,5,20195,4.042233787029624,40.0,0.0
44996,4,4996,[318  79 427 588 216],796,5,20200,4.042425455273164,40.0,0.0
44997,4,4997,[318  79 427 588 216],450,5,20205,4.0426170468187275,40.0,0.0
44998,4,4998,[318  79 427 588 216],796,5,20210,4.042808561712342,40.0,0.0
44999,4,4999,[318  79 427 588 216],450,5,20215,4.043,40.0,0.0
45000,4,5000,[172  25 318  11 181],716,5,20220,4.043191361727654,20.0,0.0
45001,4,5001,[  4  28  79 118  97],655,1,20221,4.042582966813275,0.0,0.0
45002,4,5002,[318  79 427 588 216],716,5,20226,4.042774335398761,40.0,0.0
45003,4,5003,[318  79 427 588 216],18,5,20231,4.042965627498002,40.0,0.0
45004,4,5004,[318  79 427 588 216],796,5,20236,4.043156843156843,40.0,0.0
45005,4,5005,[  9  98 168 475 302],269,4,20240,4.04314822213344,0.0,0.0
45006,4,5006,[318  79 427 588 216],18,5,20245,4.043339324945077,40.0,0.0
45007,4,5007,[216 179 173 568 172],269,1,20246,4.042731629392971,0.0,0.0
45008,4,5008,[175 588 546 127 471],344,3,20249,4.042523457776003,0.0,20.0
45009,4,5009,[ 15 111 215 200 282],655,1,20250,4.041916167664671,0.0,0.0
45010,4,5010,[275 132 496  12 286],796,4,20254,4.041907802833766,20.0,40.0
45011,4,5011,[318  79 427 588 216],577,5,20259,4.042098962490024,40.0,0.0
45012,4,5012,[202 181 235 127 273],344,3,20262,4.041891083183723,0.0,20.0
45013,4,5013,[210 153 187 194 100],269,3,20265,4.041683286796968,0.0,20.0
45014,4,5014,[357 237 196 423 100],457,5,20270,4.041874376869392,0.0,20.0
45015,4,5015,[403  79 655 222 508],693,1,20271,4.041267942583732,0.0,0.0
45016,4,5016,[318  79 427 588 216],450,5,20276,4.041459039266494,40.0,0.0
45017,4,5017,[318  79 427 588 216],18,5,20281,4.041650059784775,40.0,0.0
45018,4,5018,[ 88   4  79 185 237],18,1,20282,4.041044032675832,0.0,0.0
45019,4,5019,[568 265 197 181 235],716,4,20286,4.041035856573705,0.0,0.0
45020,4,5020,[185 222 427 269 168],450,4,20290,4.041027683728341,20.0,0.0
45021,4,5021,[174  12  95 151  64],18,4,20294,4.041019514137794,20.0,0.0
45022,4,5022,[318  79 427 588 216],577,5,20299,4.0412104320127415,40.0,0.0
45023,4,5023,[318  79 427 588 216],577,5,20304,4.04140127388535,40.0,0.0
45024,4,5024,[318  79 427 588 216],796,5,20309,4.041592039800995,40.0,0.0
45025,4,5025,[ 50 215  56 294 597],457,3,20312,4.041384799044966,0.0,20.0
45026,4,5026,[318  79 427 588 216],450,5,20317,4.041575492341357,40.0,0.0
45027,4,5027,[318  79 427 588 216],450,5,20322,4.041766109785203,40.0,0.0
45028,4,5028,[318  79 427 588 216],796,5,20327,4.041956651421754,40.0,0.0
45029,4,5029,[318  79 427 588 216],796,5,20332,4.0421471172962224,40.0,0.0
45030,4,5030,[125 234 294 144   8],457,4,20336,4.042138739813159,0.0,0.0
45031,4,5031,[111 216  50 100 180],280,3,20339,4.041931637519872,0.0,40.0
45032,4,5032,[318  79 427 588 216],18,5,20344,4.042121994834095,40.0,0.0
45033,4,5033,[ 25 211 222 655 204],716,5,20349,4.042312276519667,0.0,0.0
45034,4,5034,[318  79 427 588 216],577,5,20354,4.042502482621648,40.0,0.0
45035,4,5035,[ 95 174  79 127 179],18,5,20359,4.042692613185068,0.0,20.0
45036,4,5036,[405 135  11 168 238],330,3,20362,4.042485606511812,0.0,0.0
45037,4,5037,[655 276 238 273 181],655,2,20364,4.042080190551807,0.0,0.0
45038,4,5038,[183 276  70  88 275],655,3,20367,4.0418733875769,0.0,20.0
45039,4,5039,[271 144 238 286 200],629,5,20372,4.042063492063492,0.0,20.0
45040,4,5040,[471 288 475 196 175],655,0,20372,4.041261654433644,0.0,0.0
45041,4,5041,[186 111 475 357 276],655,2,20374,4.04085680285601,0.0,0.0
45042,4,5042,[318  79 427 588 216],716,5,20379,4.041046995835812,40.0,0.0
45043,4,5043,[ 97 194 174  70  64],450,5,20384,4.041237113402062,20.0,0.0
45044,4,5044,[ 79 132 153  22 196],716,5,20389,4.041427155599604,0.0,0.0
45045,4,5045,[180  69   8 228 423],11,2,20391,4.0410225921522,0.0,0.0
45046,4,5046,[318  79 427 588 216],18,5,20396,4.041212601545473,40.0,0.0
45047,4,5047,[318  79 427 588 216],716,5,20401,4.041402535657686,40.0,0.0
45048,4,5048,[216 187 269  71 385],450,4,20405,4.041394335511982,0.0,0.0
45049,4,5049,[ 70 546 238  15 318],593,4,20409,4.041386138613861,20.0,0.0
45050,4,5050,[318  79 427 588 216],796,5,20414,4.041575925559295,40.0,0.0
45051,4,5051,[186 282 294   7  79],457,4,20418,4.041567695961995,0.0,0.0
45052,4,5052,[318  79 427 588 216],450,5,20423,4.041757371858302,40.0,0.0
45053,4,5053,[318  79 427 588 216],450,5,20428,4.041946972694896,40.0,0.0
45054,4,5054,[176 405 183 286 423],280,2,20430,4.041543026706232,0.0,20.0
45055,4,5055,[318  79 427 588 216],450,5,20435,4.0417325949367084,40.0,0.0
45056,4,5056,[318  79 427 588 216],796,5,20440,4.041922088194582,40.0,0.0
45057,4,5057,[318  79 427 588 216],450,5,20445,4.042111506524318,40.0,0.0
45058,4,5058,[ 64 216  22 153 174],796,5,20450,4.04230084997035,20.0,0.0
45059,4,5059,[ 69 153 269   9 210],655,0,20450,4.041501976284585,0.0,0.0
45060,4,5060,[273 546 403  79 174],693,2,20452,4.0410985971151945,0.0,0.0
45061,4,5061,[318  79 144   1 174],280,3,20455,4.040892927696563,20.0,0.0
45062,4,5062,[318  79 427 588 216],796,5,20460,4.041082362235828,40.0,0.0
45063,4,5063,[515 603 127   7  50],72,3,20463,4.040876777251185,20.0,40.0
45064,4,5064,[235 168 568 655 196],457,4,20467,4.040868706811451,0.0,0.0
45065,4,5065,[318  79 427 588 216],796,5,20472,4.041058033951836,40.0,0.0
45066,4,5066,[196   9  88 603 183],269,2,20474,4.040655220051312,20.0,0.0
45067,4,5067,[125 301 204 313 111],296,4,20478,4.040647198105762,0.0,0.0
45068,4,5068,[185 483 172 194 275],18,2,20480,4.04024462418623,0.0,20.0
45069,4,5069,[318  79 427 588 216],577,5,20485,4.040433925049309,40.0,0.0
45070,4,5070,[118  56 435  25   1],389,3,20488,4.040228751725498,0.0,0.0
45071,4,5071,[318  79 427 588 216],450,5,20493,4.040417981072555,40.0,0.0
45072,4,5072,[258 288 427 174 121],450,3,20496,4.040212891780012,20.0,0.0
45073,4,5073,[318  79 427 588 216],796,5,20501,4.040402049664959,40.0,0.0
45074,4,5074,[318  79 427 588 216],450,5,20506,4.040591133004926,40.0,0.0
45075,4,5075,[211 144 275 435 276],655,2,20508,4.040189125295508,0.0,20.0
45076,4,5076,[318  79 427 588 216],577,5,20513,4.040378176088241,40.0,0.0
45077,4,5077,[318  79 427 588 216],796,5,20518,4.040567152422214,40.0,0.0
45078,4,5078,[318 125 197 276  70],280,3,20521,4.04036227603859,20.0,0.0
45079,4,5079,[318  79 427 588 216],796,5,20526,4.040551181102362,40.0,0.0
45080,4,5080,[318  79 427 588 216],716,5,20531,4.040740011808699,40.0,0.0
45081,4,5081,[173 144 288  70 282],450,4,20535,4.04073199527745,0.0,0.0
45082,4,5082,[ 98  88 211 215  28],796,3,20538,4.040527247688373,0.0,0.0
45083,4,5083,[318  79 427 588 216],716,5,20543,4.040715971675846,40.0,0.0
45084,4,5084,[ 97 176 222  50 568],450,4,20547,4.04070796460177,0.0,20.0
45085,4,5085,[151 235 135 172 405],716,3,20550,4.040503342508848,0.0,0.0
45086,4,5086,[135 286 182  28  56],389,3,20553,4.04029880086495,0.0,20.0
45087,4,5087,[161 237 121  79 186],577,5,20558,4.040487421383648,0.0,0.0
45088,4,5088,[117 273  97  96 265],796,3,20561,4.040282963254078,0.0,0.0
45089,4,5089,[294   4 179 174   8],655,1,20562,4.039685658153242,0.0,0.0
45090,4,5090,[  9 546   7 655 423],151,4,20566,4.039677862895306,0.0,0.0
45091,4,5091,[603 273 546 322 597],796,3,20569,4.0394736842105265,20.0,0.0
45092,4,5092,[318  79 427 588 216],18,5,20574,4.039662281562929,40.0,0.0
45093,4,5093,[127 191 235 496 515],269,4,20578,4.039654495484884,20.0,20.0
45094,4,5094,[318  79 427 588 216],716,5,20583,4.039842983316977,40.0,0.0
45095,4,5095,[328   7 385 153 258],655,0,20583,4.039050235478807,0.0,0.0
45096,4,5096,[318  79 427 588 216],577,5,20588,4.039238767902688,40.0,0.0
45097,4,5097,[238  98 182 172 100],535,2,20590,4.038838760298156,0.0,20.0
45098,4,5098,[117  56 195 300 655],504,4,20594,4.038831143361444,0.0,0.0
45099,4,5099,[174  82 228 111 176],796,4,20598,4.038823529411765,0.0,0.0
45100,4,5100,[216 405 180 238   4],450,4,20602,4.038815918447363,0.0,0.0
45101,4,5101,[318  79 427 588 216],796,5,20607,4.039004312034496,40.0,0.0
45102,4,5102,[318  79 427 588 216],716,5,20612,4.039192631785224,40.0,0.0
45103,4,5103,[328 222 275  28 185],796,4,20616,4.039184952978056,0.0,20.0
45104,4,5104,[ 98   1  56 196 132],716,5,20621,4.039373163565132,0.0,0.0
45105,4,5105,[318  96 322 216 187],796,4,20625,4.039365452408931,20.0,0.0
45106,4,5106,[318  79 427 588 216],450,5,20630,4.039553553945565,40.0,0.0
45107,4,5107,[318  79 427 588 216],716,5,20635,4.03974158183242,40.0,0.0
45108,4,5108,[200  98 186 182 176],457,5,20640,4.0399295361127425,0.0,0.0
45109,4,5109,[176  96 111   1  50],457,4,20644,4.039921722113503,0.0,20.0
45110,4,5110,[ 22 427 183 268 603],269,3,20647,4.039718254744669,40.0,0.0
45111,4,5111,[318  79 427 588 216],18,5,20652,4.039906103286385,40.0,0.0
45112,4,5112,[234 385  70 222  82],457,5,20657,4.040093878349306,0.0,0.0
45113,4,5113,[ 82  79 222  56  69],450,3,20660,4.039890496675792,0.0,0.0
45114,4,5114,[483 161 144  11  56],693,3,20663,4.0396871945259045,0.0,0.0
45115,4,5115,[318  79 427 588 216],450,5,20668,4.039874902267396,40.0,0.0
45116,4,5116,[318  79 427 588 216],716,5,20673,4.040062536642564,40.0,0.0
45117,4,5117,[132 258 161 302 182],450,5,20678,4.040250097694412,0.0,0.0
45118,4,5118,[318  79 427 588 216],450,5,20683,4.040437585465911,40.0,0.0
45119,4,5119,[318  79 427 588 216],796,5,20688,4.040625,40.0,0.0
45120,4,5120,[265 357 385  28 118],796,4,20692,4.040617066979106,0.0,0.0
45121,4,5121,[  4   1 204 174 179],18,3,20695,4.040413900819992,0.0,0.0
45122,4,5122,[111 125 423 496   7],450,5,20700,4.040601210228382,20.0,0.0
45123,4,5123,[318  79 427 588 216],716,5,20705,4.040788446526151,40.0,0.0
45124,4,5124,[483 403 197 172 151],457,5,20710,4.040975609756098,0.0,0.0
45125,4,5125,[318  79 427 588 216],716,5,20715,4.041162699960983,40.0,0.0
45126,4,5126,[ 98 197 313 195  50],693,3,20718,4.040959625511995,0.0,20.0
45127,4,5127,[403  15  25 151 322],450,3,20721,4.040756630265211,0.0,0.0
45128,4,5128,[118  50 196 181 183],151,3,20724,4.040553714174303,0.0,20.0
45129,4,5129,[172  25 568 588  64],577,4,20728,4.040545808966861,20.0,0.0
45130,4,5130,[385 403   4  70 200],280,3,20731,4.040343013057884,0.0,0.0
45131,4,5131,[ 11 568 202  82 276],457,5,20736,4.040530007794232,0.0,0.0
45132,4,5132,[ 98 403   4 143 357],450,4,20740,4.040522111825443,0.0,0.0
45133,4,5133,[186 318  28  56  12],796,3,20743,4.040319439033892,20.0,0.0
45134,4,5134,[318  79 427 588 216],716,5,20748,4.040506329113924,40.0,0.0
45135,4,5135,[ 28 100 265  97 197],72,5,20753,4.040693146417445,0.0,20.0
45136,4,5136,[318  79 427 588 216],796,5,20758,4.040879890986957,40.0,0.0
45137,4,5137,[301 238 215  64 275],450,5,20763,4.041066562864928,20.0,20.0
45138,4,5138,[568 118 204 100 132],280,1,20764,4.040474800544853,0.0,20.0
45139,4,5139,[ 56 496 405 111  25],593,3,20767,4.040272373540856,20.0,0.0
45140,4,5140,[318  79 427 588 216],450,5,20772,4.040459054658626,40.0,0.0
45141,4,5141,[302 127  50  98  11],450,5,20777,4.040645663166083,0.0,40.0
45142,4,5142,[ 50 127 234 111  69],457,4,20781,4.0406377600622205,0.0,40.0
45143,4,5143,[181 117 173 143  15],796,5,20786,4.040824261275272,0.0,0.0
45144,4,5144,[294 318 313 197  56],655,2,20788,4.040427599611273,20.0,0.0
45145,4,5145,[318  79 427 588 216],796,5,20793,4.040614069179946,40.0,0.0
45146,4,5146,[  1   9 181 288  50],280,3,20796,4.040411890421605,0.0,20.0
45147,4,5147,[318  79 427 588 216],18,5,20801,4.0405982905982905,40.0,0.0
45148,4,5148,[318  79 427 588 216],18,5,20806,4.040784618372499,40.0,0.0
45149,4,5149,[318  79 427 588 216],716,5,20811,4.040970873786407,40.0,0.0
45150,4,5150,[286 191 100 328  25],401,4,20815,4.040962919821394,0.0,40.0
45151,4,5151,[328  22  69 322   4],796,4,20819,4.040954968944099,0.0,0.0
45152,4,5152,[318  79 427 588 216],716,5,20824,4.041141082864351,40.0,0.0
45153,4,5153,[318  79 427 588 216],796,5,20829,4.041327124563446,40.0,0.0
45154,4,5154,[318  79 427 588 216],18,5,20834,4.041513094083414,40.0,0.0
45155,4,5155,[318  79 427 588 216],577,5,20839,4.041698991466253,40.0,0.0
45156,4,5156,[318  79 427 588 216],716,5,20844,4.041884816753926,40.0,0.0
45157,4,5157,[200 471 288 215  96],280,3,20847,4.041682822799535,0.0,0.0
45158,4,5158,[318  79 427 588 216],796,5,20852,4.041868579182012,40.0,0.0
45159,4,5159,[200 172  79 269 125],18,2,20854,4.041472868217054,0.0,0.0
45160,4,5160,[202 245 117 191 385],344,2,20856,4.041077310598721,0.0,0.0
45161,4,5161,[135   9 195 423 286],655,1,20857,4.040488182874855,0.0,20.0
45162,4,5162,[  4   8 588 655 546],457,4,20861,4.040480340887081,0.0,0.0
45163,4,5163,[318  79 427 588 216],716,5,20866,4.040666150271107,40.0,0.0
45164,4,5164,[186 194 405 202 237],716,4,20870,4.040658276863504,0.0,0.0
45165,4,5165,[318  79 427 588 216],716,5,20875,4.04084397986837,40.0,0.0
45166,4,5166,[318  79 427 588 216],796,5,20880,4.041029610992839,40.0,0.0
45167,4,5167,[318  79 427 588 216],796,5,20885,4.041215170278638,40.0,0.0
45168,4,5168,[427  56 483  25 515],535,3,20888,4.04101373573225,20.0,0.0
45169,4,5169,[318  79 427 588 216],450,5,20893,4.04119922630561,40.0,0.0
45170,4,5170,[258  95   8 183 121],756,2,20895,4.04080448655966,0.0,0.0
45171,4,5171,[288 196 195 588   9],457,5,20900,4.040989945862336,0.0,0.0
45172,4,5172,[318  79 427 588 216],450,5,20905,4.041175333462208,40.0,0.0
45173,4,5173,[318  79 427 588 216],716,5,20910,4.0413606494008505,40.0,0.0
45174,4,5174,[135 228 313  25 302],450,3,20913,4.041159420289855,0.0,0.0
45175,4,5175,[427 215 181 143 216],330,5,20918,4.0413446676970635,20.0,0.0
45176,4,5176,[318  79 427 588 216],18,5,20923,4.041529843538729,40.0,0.0
45177,4,5177,[318  79 427 588 216],18,5,20928,4.041714947856315,40.0,0.0
45178,4,5178,[ 25  97 678 588 204],344,3,20931,4.041513805754007,0.0,0.0
45179,4,5179,[100 568 183 357  56],796,4,20935,4.0415057915057915,0.0,20.0
45180,4,5180,[168 403 215 182 357],18,2,20937,4.0411117544875506,0.0,0.0
45181,4,5181,[265 215 228 117 168],796,5,20942,4.0412967966036275,0.0,0.0
45182,4,5182,[ 69 187 185  89 176],796,5,20947,4.041481767316226,0.0,0.0
45183,4,5183,[127 257 276 288 151],460,2,20949,4.041087962962963,0.0,20.0
45184,4,5184,[318  79 427 588 216],796,5,20954,4.041272902603664,40.0,0.0
45185,4,5185,[655 132 357 187 181],504,3,20957,4.04107211723872,0.0,0.0
45186,4,5186,[265 174 302 234 153],655,1,20958,4.040485829959514,0.0,0.0
45187,4,5187,[286 144  12 322  70],450,5,20963,4.0406707787201235,0.0,20.0
45188,4,5188,[276 174 483  95 238],18,5,20968,4.040855656195799,0.0,0.0
45189,4,5189,[ 88 211   1  64 328],65,4,20972,4.040847784200385,20.0,0.0
45190,4,5190,[ 96 568  25 228 125],450,4,20976,4.040839915237912,0.0,0.0
45191,4,5191,[508  95 172  98  11],280,3,20979,4.040639445300462,0.0,0.0
45192,4,5192,[185   8 173 216 151],707,2,20981,4.040246485653765,0.0,0.0
45193,4,5193,[357 257  15 183 125],457,4,20985,4.040238737004236,0.0,0.0
45194,4,5194,[143 300  28 655 234],151,5,20990,4.040423484119345,0.0,0.0
45195,4,5195,[483 301   9   1  64],151,5,20995,4.040608160123171,20.0,0.0
45196,4,5196,[328 234 172 153 210],151,3,20998,4.040407927650568,0.0,0.0
45197,4,5197,[318  79 427 588 216],796,5,21003,4.040592535590612,40.0,0.0
45198,4,5198,[ 50 181 172  88 300],450,5,21008,4.040777072513945,0.0,20.0
45199,4,5199,[546  22 588  79 269],344,3,21011,4.040576923076923,0.0,0.0
45200,4,5200,[318  79 427 588 216],18,5,21016,4.040761392039992,40.0,0.0
45201,4,5201,[318  79 427 588 216],577,5,21021,4.040945790080738,40.0,0.0
45202,4,5202,[ 88 216 405 183 269],23,3,21024,4.040745723620988,0.0,0.0
45203,4,5203,[172 197 153 300 204],389,3,21027,4.04054573405073,0.0,0.0
45204,4,5204,[318  79 427 588 216],796,5,21032,4.040730067243036,40.0,0.0
45205,4,5205,[318  79 427 588 216],450,5,21037,4.040914329619669,40.0,0.0
45206,4,5206,[318  79 427 588 216],18,5,21042,4.041098521221433,40.0,0.0
45207,4,5207,[176 318 100 228 204],786,5,21047,4.041282642089094,20.0,20.0
45208,4,5208,[182 211 403 180 200],450,4,21051,4.041274716836245,0.0,0.0
45209,4,5209,[568 385  89 301 182],655,2,21053,4.040882917466411,0.0,0.0
45210,4,5210,[318  79 427 588 216],450,5,21058,4.04106697370946,40.0,0.0
45211,4,5211,[234 144  50 258 238],457,5,21063,4.0412509593246355,0.0,20.0
45212,4,5212,[117 191  79 182 194],457,5,21068,4.04143487435258,0.0,0.0
45213,4,5213,[ 71 121 117 197  97],401,2,21070,4.041043344840813,0.0,0.0
45214,4,5214,[546  50 273 427 215],450,4,21074,4.041035474592522,20.0,20.0
45215,4,5215,[ 88 125 117 276 191],344,2,21076,4.0406441717791415,0.0,0.0
45216,4,5216,[161 143 202 118 151],577,3,21079,4.040444700019168,0.0,0.0
45217,4,5217,[318  79 427 588 216],716,5,21084,4.040628593330778,40.0,0.0
45218,4,5218,[475 276   1 508 127],296,5,21089,4.04081241617168,0.0,20.0
45219,4,5219,[318  79 427 588 216],18,5,21094,4.040996168582375,40.0,0.0
45220,4,5220,[222 234  98 748 678],256,5,21099,4.041179850603332,0.0,0.0
45221,4,5221,[179 269  69 427  15],18,4,21103,4.041171964764458,20.0,0.0
45222,4,5222,[318  79 427 588 216],450,5,21108,4.041355542791499,40.0,0.0
45223,4,5223,[423  70 289 182 228],655,1,21109,4.040773353751915,0.0,0.0
45224,4,5224,[318  79 427 588 216],577,5,21114,4.040956937799043,40.0,0.0
45225,4,5225,[318  79 427 588 216],796,5,21119,4.041140451588213,40.0,0.0
45226,4,5226,[475 483 176   1 161],655,1,21120,4.040558637841975,0.0,0.0
45227,4,5227,[318  79 427 588 216],450,5,21125,4.040742157612854,40.0,0.0
45228,4,5228,[318 748 385  69  28],807,5,21130,4.040925607190667,20.0,0.0
45229,4,5229,[568 257 235 135 282],457,3,21133,4.040726577437859,0.0,0.0
45230,4,5230,[318  79 427 588 216],577,5,21138,4.040909959854712,40.0,0.0
45231,4,5231,[185 302 196  96 215],450,5,21143,4.041093272171254,0.0,0.0
45232,4,5232,[ 95  89 357 173 204],23,3,21146,4.040894324479266,0.0,0.0
45233,4,5233,[318  79 427 588 216],577,5,21151,4.0410775697363395,40.0,0.0
45234,4,5234,[318  79 427 588 216],450,5,21156,4.0412607449856734,40.0,0.0
45235,4,5235,[ 28 180 234 423 135],18,2,21158,4.0408708938120705,0.0,0.0
45236,4,5236,[173 187 301  88 273],450,4,21162,4.0408630895550885,0.0,0.0
45237,4,5237,[318  79 427 588 216],577,5,21167,4.041046200840015,40.0,0.0
45238,4,5238,[318  79 427 588 216],577,5,21172,4.041229242221798,40.0,0.0
45239,4,5239,[194 173 144 181 235],450,4,21176,4.041221374045802,0.0,0.0
45240,4,5240,[ 79 196 234   4 245],450,3,21179,4.041022705590536,0.0,0.0
45241,4,5241,[289 181 275 100 187],236,2,21181,4.040633346051125,0.0,40.0
45242,4,5242,[204 185 234 237 275],796,4,21185,4.040625596032806,0.0,20.0
45243,4,5243,[194 273  22 568 275],796,4,21189,4.040617848970252,0.0,20.0
45244,4,5244,[318  79 427 588 216],716,5,21194,4.040800762631077,40.0,0.0
45245,4,5245,[282 202 238 185 216],655,2,21196,4.040411742279832,0.0,0.0
45246,4,5246,[ 64 118  88 135 405],716,3,21199,4.040213455307795,20.0,0.0
45247,4,5247,[318  79 427 588 216],716,5,21204,4.040396341463414,40.0,0.0
45248,4,5248,[318  79 427 588 216],716,5,21209,4.040579157934845,40.0,0.0
45249,4,5249,[318  79 427 588 216],716,5,21214,4.040761904761904,40.0,0.0
45250,4,5250,[235  70   7 568 118],280,3,21217,4.040563702151971,0.0,0.0
45251,4,5251,[ 15 180 427  69 111],269,1,21218,4.03998476770754,20.0,0.0
45252,4,5252,[318  79 427 588 216],796,5,21223,4.040167523320008,40.0,0.0
45253,4,5253,[ 98 318   9 258 121],65,4,21227,4.040159878188047,20.0,0.0
45254,4,5254,[318  79 427 588 216],450,5,21232,4.04034253092293,40.0,0.0
45255,4,5255,[318  79 427 588 216],796,5,21237,4.040525114155251,40.0,0.0
45256,4,5256,[318  79 427 588 216],450,5,21242,4.040707627924672,40.0,0.0
45257,4,5257,[ 50 282 300 180   4],504,4,21246,4.04069988588817,0.0,20.0
45258,4,5258,[318  79 427 588 216],796,5,21251,4.040882297014641,40.0,0.0
45259,4,5259,[318  79 427 588 216],796,5,21256,4.04106463878327,40.0,0.0
45260,4,5260,[318  79 427 588 216],577,5,21261,4.041246911233606,40.0,0.0
45261,4,5261,[508 313  56 568  96],693,4,21265,4.041239072595971,0.0,0.0
45262,4,5262,[228 127 288 197  15],457,5,21270,4.041421242637279,0.0,20.0
45263,4,5263,[  4 318 423 275 168],450,4,21274,4.041413373860182,20.0,20.0
45264,4,5264,[202  56 173 496 276],280,3,21277,4.041215574548908,20.0,0.0
45265,4,5265,[183 301  96 271 196],796,4,21281,4.04120774781618,0.0,0.0
45266,4,5266,[318  79 427 588 216],796,5,21286,4.041389785456617,40.0,0.0
45267,4,5267,[  8  15 269 237 200],655,1,21287,4.04081245254366,0.0,0.0
45268,4,5268,[318  79 427 588 216],577,5,21292,4.0409944961093185,40.0,0.0
45269,4,5269,[318  79 427 588 216],577,5,21297,4.041176470588235,40.0,0.0
45270,4,5270,[ 70 302 271 100 508],655,1,21298,4.0405995067349645,0.0,20.0
45271,4,5271,[127 328 301 603  89],450,5,21303,4.040781487101669,20.0,20.0
45272,4,5272,[245 435  95 151 111],756,2,21305,4.040394462355396,0.0,0.0
45273,4,5273,[234 151 483  64 194],151,5,21310,4.040576412590064,20.0,0.0
45274,4,5274,[318  79 427 588 216],450,5,21315,4.040758293838863,40.0,0.0
45275,4,5275,[258  97   7 181 471],344,1,21316,4.040181956027293,0.0,0.0
45276,4,5276,[318  79 427 588 216],796,5,21321,4.040363843092666,40.0,0.0
45277,4,5277,[318  79 427 588 216],796,5,21326,4.040545661235316,40.0,0.0
45278,4,5278,[185 117  22 195 318],655,2,21328,4.040159121045653,20.0,0.0
45279,4,5279,[238 258 328 191 144],796,4,21332,4.040151515151515,0.0,0.0
45280,4,5280,[117 151 282 194   9],504,4,21336,4.040143912137853,0.0,0.0
45281,4,5281,[185 195  56 655 111],716,4,21340,4.040136312003029,0.0,0.0
45282,4,5282,[318  79 427 588 216],450,5,21345,4.040318001135718,40.0,0.0
45283,4,5283,[301 276 175  69 300],655,1,21346,4.039742619227858,0.0,0.0
45284,4,5284,[ 97 111 153   1 161],885,4,21350,4.039735099337748,0.0,0.0
45285,4,5285,[318  79 427 588 216],18,5,21355,4.039916761256149,40.0,0.0
45286,4,5286,[318  79 427 588 216],716,5,21360,4.040098354454322,40.0,0.0
45287,4,5287,[318  79 427 588 216],18,5,21365,4.040279878971256,40.0,0.0
45288,4,5288,[301 182  11 151 275],535,4,21369,4.040272263187748,0.0,20.0
45289,4,5289,[318  79 427 588 216],577,5,21374,4.040453686200378,40.0,0.0
45290,4,5290,[318  79 427 588 216],450,5,21379,4.04063504063504,40.0,0.0
45291,4,5291,[318  79 427 588 216],450,5,21384,4.040816326530612,40.0,0.0
45292,4,5292,[185 300 143 172  95],796,5,21389,4.04099754392594,0.0,0.0
45293,4,5293,[318  79 427 588 216],450,5,21394,4.041178692859841,40.0,0.0
45294,4,5294,[ 98  89 194 202   7],450,5,21399,4.041359773371105,0.0,0.0
45295,4,5295,[318  79 427 588 216],716,5,21404,4.04154078549849,40.0,0.0
45296,4,5296,[318  79 427 588 216],716,5,21409,4.041721729280725,40.0,0.0
45297,4,5297,[ 64 151  56 174   4],796,5,21414,4.041902604756512,20.0,0.0
45298,4,5298,[265 161  88  96 245],450,5,21419,4.042083411964522,0.0,0.0
45299,4,5299,[196 183 125   7 318],151,4,21423,4.042075471698113,20.0,0.0
45300,4,5300,[483 144   7 435 237],296,5,21428,4.042256178079608,0.0,0.0
45301,4,5301,[ 12   1 301 127 237],450,5,21433,4.042436816295737,0.0,20.0
45302,4,5302,[318  79 427 588 216],716,5,21438,4.042617386385065,40.0,0.0
45303,4,5303,[ 82 127 185 151 179],457,5,21443,4.042797888386124,0.0,20.0
45304,4,5304,[423 257  71  82 176],23,0,21443,4.042035815268615,0.0,0.0
45305,4,5305,[132 234 403 100  82],457,5,21448,4.04221635883905,0.0,20.0
45306,4,5306,[318  79 427 588 216],577,5,21453,4.0423968343697005,40.0,0.0
45307,4,5307,[318  79 427 588 216],450,5,21458,4.0425772418990205,40.0,0.0
45308,4,5308,[210  50 200 238 118],151,3,21461,4.042380862686005,0.0,20.0
45309,4,5309,[  8 121 216 385 187],796,5,21466,4.04256120527307,0.0,0.0
45310,4,5310,[180   9 117 385  97],504,5,21471,4.04274147994728,0.0,0.0
45311,4,5311,[ 71 427  28 153 318],18,4,21475,4.04273343373494,40.0,0.0
45312,4,5312,[ 95 313 286  88 111],450,4,21479,4.042725390551477,0.0,20.0
45313,4,5313,[655   4 300 405 597],450,4,21483,4.042717350395183,0.0,0.0
45314,4,5314,[318  79 427 588 216],796,5,21488,4.042897460018815,40.0,0.0
45315,4,5315,[318  79 427 588 216],18,5,21493,4.043077501881114,40.0,0.0
45316,4,5316,[182 333 153 275  12],629,5,21498,4.043257476020313,0.0,20.0
45317,4,5317,[275 286 144 471 202],401,4,21502,4.043249341857841,0.0,40.0
45318,4,5318,[144  64 180  89 385],450,5,21507,4.0434292160180485,20.0,0.0
45319,4,5319,[318  79 427 588 216],18,5,21512,4.0436090225563905,40.0,0.0
45320,4,5320,[300  69 185 597 357],796,5,21517,4.043788761510994,0.0,0.0
45321,4,5321,[318  79 427 588 216],450,5,21522,4.043968432919955,40.0,0.0
45322,4,5322,[282 275 228 597 300],796,5,21527,4.044148036821341,0.0,20.0
45323,4,5323,[234  97  69   9 183],796,2,21529,4.043764087152517,0.0,0.0
45324,4,5324,[318  79 427 588 216],796,5,21534,4.043943661971831,40.0,0.0
45325,4,5325,[125 161 176 245 195],280,1,21535,4.043372136687946,0.0,0.0
45326,4,5326,[197 161 195 186 127],655,1,21536,4.042800825980852,0.0,20.0
45327,4,5327,[318  79 427 588 216],577,5,21541,4.04298048048048,40.0,0.0
45328,4,5328,[258 125 174 427 234],151,5,21546,4.043160067554888,20.0,0.0
45329,4,5329,[427 111 405 275 180],796,4,21550,4.043151969981238,20.0,20.0
45330,4,5330,[318  79 427 588 216],450,5,21555,4.043331457512662,40.0,0.0
45331,4,5331,[234  88 257  95  82],23,1,21556,4.0427606901725435,0.0,0.0
45332,4,5332,[483 111 118  88  50],450,3,21559,4.04256516032252,0.0,20.0
45333,4,5333,[318  79 427 588 216],716,5,21564,4.042744656917885,40.0,0.0
45334,4,5334,[ 89 181 258  50 187],796,5,21569,4.0429240862230555,0.0,20.0
45335,4,5335,[318  79 427 588 216],577,5,21574,4.043103448275862,40.0,0.0
45336,4,5336,[173 275 144 568  97],716,4,21578,4.043095371931797,0.0,20.0
45337,4,5337,[ 79 215 471 204 237],716,4,21582,4.043087298613713,0.0,0.0
45338,4,5338,[742 655 183 300 174],693,1,21583,4.042517325341825,0.0,0.0
45339,4,5339,[191  70  11  69 176],269,1,21584,4.041947565543071,0.0,0.0
45340,4,5340,[211 403 187  15  71],796,4,21588,4.041939711664482,0.0,0.0
45341,4,5341,[318  79 427 588 216],716,5,21593,4.042119056533133,40.0,0.0
45342,4,5342,[135 196 183 234 176],151,3,21596,4.041924012726932,0.0,0.0
45343,4,5343,[153  25 568  12 117],450,4,21600,4.041916167664671,0.0,0.0
45344,4,5344,[194 172  79  97  69],18,2,21602,4.041534144059869,0.0,0.0
45345,4,5345,[318  79 427 588 216],716,5,21607,4.04171343060232,40.0,0.0
45346,4,5346,[286 202  64 328 238],796,3,21610,4.041518608565551,20.0,20.0
45347,4,5347,[127  11 403 173 121],457,5,21615,4.041697830964846,0.0,20.0
45348,4,5348,[318  79 427 588 216],18,5,21620,4.041876986352589,40.0,0.0
45349,4,5349,[191 237 286  15 168],796,4,21624,4.041869158878504,0.0,20.0
45350,4,5350,[ 11 597 405  98 182],269,2,21626,4.04148757241637,0.0,0.0
45351,4,5351,[318  79 427 588 216],716,5,21631,4.041666666666667,40.0,0.0
45352,4,5352,[318  79 427 588 216],577,5,21636,4.041845694003363,40.0,0.0
45353,4,5353,[238 286 588 202  70],330,5,21641,4.042024654463952,0.0,20.0
45354,4,5354,[318  79 427 588 216],577,5,21646,4.042203548085901,40.0,0.0
45355,4,5355,[318  79 427 588 216],577,5,21651,4.042382374906647,40.0,0.0
45356,4,5356,[100 211 294 228 194],450,5,21656,4.042561134963599,0.0,20.0
45357,4,5357,[318  79 427 588 216],18,5,21661,4.04273982829414,40.0,0.0
45358,4,5358,[318  79 427 588 216],450,5,21666,4.042918454935623,40.0,0.0
45359,4,5359,[318  79 427 588 216],796,5,21671,4.043097014925373,40.0,0.0
45360,4,5360,[237   4 300 318  79],450,4,21675,4.043088975937325,20.0,0.0
45361,4,5361,[318  79 427 588 216],716,5,21680,4.043267437523312,40.0,0.0
45362,4,5362,[215 235  22  69 216],344,1,21681,4.04269998135372,0.0,0.0
45363,4,5363,[  4 275 678  88 288],344,3,21684,4.042505592841163,0.0,20.0
45364,4,5364,[318  79 427 588 216],716,5,21689,4.042684063373718,40.0,0.0
45365,4,5365,[318  79 427 588 216],796,5,21694,4.042862467387253,40.0,0.0
45366,4,5366,[117 151 144  25 195],450,4,21698,4.042854481088131,0.0,0.0
45367,4,5367,[211 180 174 191  89],269,2,21700,4.0424739195231,0.0,0.0
45368,4,5368,[318  79 427 588 216],796,5,21705,4.042652262991246,40.0,0.0
45369,4,5369,[153 275 187 204 423],535,4,21709,4.042644320297952,0.0,20.0
45370,4,5370,[318  79 427 588 216],716,5,21714,4.042822565630236,40.0,0.0
45371,4,5371,[603  11 294 195 200],716,4,21718,4.042814594192107,20.0,0.0
45372,4,5372,[265 125  71 301 187],796,4,21722,4.042806625721199,0.0,0.0
45373,4,5373,[ 69 258 176  82  70],655,0,21722,4.042054335690361,0.0,0.0
45374,4,5374,[183 301 211  88  98],593,5,21727,4.042232558139535,0.0,0.0
45375,4,5375,[655 127   7 161 588],786,5,21732,4.042410714285714,0.0,20.0
45376,4,5376,[238  12 423 117 174],796,4,21736,4.042402826855124,0.0,0.0
45377,4,5377,[228  28 118 175 508],655,0,21736,4.041651171439197,0.0,0.0
45378,4,5378,[318  79 427 588 216],18,5,21741,4.041829336307864,40.0,0.0
45379,4,5379,[318  79 427 588 216],716,5,21746,4.042007434944238,40.0,0.0
45380,4,5380,[194 496 435  79 265],716,5,21751,4.042185467385244,20.0,0.0
45381,4,5381,[318  79 427 588 216],716,5,21756,4.042363433667782,40.0,0.0
45382,4,5382,[182 121 143 333 237],796,5,21761,4.04254133382872,0.0,0.0
45383,4,5383,[318  79 427 588 216],577,5,21766,4.042719167904903,40.0,0.0
45384,4,5384,[318  79 427 588 216],18,5,21771,4.042896935933148,40.0,0.0
45385,4,5385,[172  22 100 143 151],796,4,21775,4.042888971407352,0.0,20.0
45386,4,5386,[301 515 215  70 186],535,4,21779,4.0428810098385,0.0,0.0
45387,4,5387,[322 655 127   4 151],450,4,21783,4.0428730512249444,0.0,20.0
45388,4,5388,[318  79 427 588 216],796,5,21788,4.043050658749304,40.0,0.0
45389,4,5389,[210 265 153 294 228],655,0,21788,4.042300556586271,0.0,0.0
45390,4,5390,[  7 333 211 282 179],655,1,21789,4.041736227045075,0.0,0.0
45391,4,5391,[318  79 427 588 216],796,5,21794,4.041913946587537,40.0,0.0
45392,4,5392,[282 322 286 568 301],593,4,21798,4.04190617467087,0.0,20.0
45393,4,5393,[318  79 427 588 216],577,5,21803,4.042083796811272,40.0,0.0
45394,4,5394,[302 276 196 215 202],655,2,21805,4.041705282669138,0.0,0.0
45395,4,5395,[ 64  25 597 385 357],450,4,21809,4.041697553743513,20.0,0.0
45396,4,5396,[  4 222 100  15   8],796,4,21813,4.041689827682045,0.0,20.0
45397,4,5397,[172 300 282 111  12],450,5,21818,4.041867358280845,0.0,0.0
45398,4,5398,[ 71 313 118  98 300],796,5,21823,4.042044823115392,0.0,0.0
45399,4,5399,[ 12 200 222 117 228],450,3,21826,4.041851851851852,0.0,0.0
45400,4,5400,[318  79 427 588 216],796,5,21831,4.042029253841881,40.0,0.0
45401,4,5401,[318  79 427 588 216],716,5,21836,4.042206590151796,40.0,0.0
45402,4,5402,[216 179 483 258 300],655,3,21839,4.042013696094762,0.0,0.0
45403,4,5403,[143 132 117 273 186],796,3,21842,4.041820873427091,0.0,0.0
45404,4,5404,[313 187 181  56 265],655,2,21844,4.041443108233118,0.0,0.0
45405,4,5405,[318  79 427 588 216],716,5,21849,4.041620421753607,40.0,0.0
45406,4,5406,[597 300 546 301 194],796,4,21853,4.041612724246347,0.0,0.0
45407,4,5407,[318  79 427 588 216],716,5,21858,4.041789940828402,40.0,0.0
45408,4,5408,[318  79 427 588 216],577,5,21863,4.0419670918838975,40.0,0.0
45409,4,5409,[318  79 427 588 216],796,5,21868,4.042144177449168,40.0,0.0
45410,4,5410,[318  79 427 588 216],796,5,21873,4.042321197560525,40.0,0.0
45411,4,5411,[318  79 427 588 216],577,5,21878,4.04249815225425,40.0,0.0
45412,4,5412,[  1 100 275 258 294],296,4,21882,4.042490301126917,0.0,40.0
45413,4,5413,[237 197  25 275 196],535,5,21887,4.042667159216845,0.0,20.0
45414,4,5414,[245  97 144 655 234],450,4,21891,4.042659279778394,0.0,0.0
45415,4,5415,[268 286 187 182 475],629,5,21896,4.042836041358936,0.0,20.0
45416,4,5416,[318  79 427 588 216],796,5,21901,4.043012737677682,40.0,0.0
45417,4,5417,[ 22 100 245 286 403],796,2,21903,4.042635658914729,0.0,40.0
45418,4,5418,[265 423 546 121 385],450,4,21907,4.04262779110537,0.0,0.0
45419,4,5419,[ 69 185   1 257 301],655,1,21908,4.042066420664207,0.0,0.0
45420,4,5420,[318  79 427 588 216],18,5,21913,4.042243128574063,40.0,0.0
45421,4,5421,[161 268 237 597 276],269,2,21915,4.041866469937292,0.0,0.0
45422,4,5422,[ 97 294 118 172 144],457,4,21919,4.0418587497695,0.0,0.0
45423,4,5423,[318  79 427 588 216],450,5,21924,4.042035398230088,40.0,0.0
45424,4,5424,[ 88 135 471 186 238],457,5,21929,4.042211981566821,0.0,0.0
45425,4,5425,[318  79 427 588 216],796,5,21934,4.0423884998157025,40.0,0.0
45426,4,5426,[318  79 427 588 216],577,5,21939,4.042564953012715,40.0,0.0
45427,4,5427,[ 95 202  71 357 294],23,1,21940,4.042004421518055,0.0,0.0
45428,4,5428,[318  79 427 588 216],450,5,21945,4.042180880456806,40.0,0.0
45429,4,5429,[318  79 427 588 216],796,5,21950,4.042357274401473,40.0,0.0
45430,4,5430,[318  79 427 588 216],577,5,21955,4.042533603387958,40.0,0.0
45431,4,5431,[97 12 11 15 89],457,5,21960,4.042709867452135,0.0,0.0
45432,4,5432,[  4 185  70 546  71],450,3,21963,4.04251794588625,0.0,0.0
45433,4,5433,[318  79 427 588 216],577,5,21968,4.042694147957306,40.0,0.0
45434,4,5434,[603   4 471 475 179],389,5,21973,4.0428702851885925,20.0,0.0
45435,4,5435,[168  97 143 237 245],504,4,21977,4.042862398822663,0.0,0.0
45436,4,5436,[127  96 196 275 175],457,5,21982,4.043038440316351,0.0,40.0
45437,4,5437,[294 286 127 173 322],796,2,21984,4.042662743655756,0.0,40.0
45438,4,5438,[318  79 427 588 216],716,5,21989,4.042838757124471,40.0,0.0
45439,4,5439,[ 97 228   1 135 204],450,4,21993,4.042830882352941,0.0,0.0
45440,4,5440,[211 121 655 333 357],796,3,21996,4.042639220731483,0.0,0.0
45441,4,5441,[257 546 180 202 194],796,4,22000,4.042631385520029,0.0,0.0
45442,4,5442,[185 187 181 168 151],450,5,22005,4.042807275399595,0.0,0.0
45443,4,5443,[  7 423 194 132  11],577,3,22008,4.04261572373255,0.0,0.0
45444,4,5444,[318  79 427 588 216],577,5,22013,4.042791551882461,40.0,0.0
45445,4,5445,[181 423 100   9 237],269,3,22016,4.042600073448402,0.0,20.0
45446,4,5446,[161 181 118 195 183],693,1,22017,4.042041490728842,0.0,0.0
45447,4,5447,[318  79 427 588 216],450,5,22022,4.0422173274596185,40.0,0.0
45448,4,5448,[423 191   1 173 153],389,3,22025,4.042026059827491,0.0,0.0
45449,4,5449,[318  79 427 588 216],577,5,22030,4.042201834862385,40.0,0.0
45450,4,5450,[318  79 427 588 216],716,5,22035,4.042377545404513,40.0,0.0
45451,4,5451,[313 597 151 748  25],938,3,22038,4.042186353631695,0.0,0.0
45452,4,5452,[318  79 427 588 216],577,5,22043,4.042362002567394,40.0,0.0
45453,4,5453,[204  22 483 168 603],716,5,22048,4.042537587092043,20.0,0.0
45454,4,5454,[318  79 427 588 216],577,5,22053,4.042713107241063,40.0,0.0
45455,4,5455,[318  79 427 588 216],18,5,22058,4.0428885630498534,40.0,0.0
45456,4,5456,[318  79 427 588 216],577,5,22063,4.0430639545537845,40.0,0.0
45457,4,5457,[318  79 427 588 216],716,5,22068,4.043239281788201,40.0,0.0
45458,4,5458,[ 28  79 143 302 168],450,5,22073,4.043414544788423,0.0,0.0
45459,4,5459,[268 187 174  82 186],655,1,22074,4.042857142857143,0.0,0.0
45460,4,5460,[ 96 175  82 546 235],457,3,22077,4.042666178355613,0.0,0.0
45461,4,5461,[357 118 172 275 313],593,4,22081,4.042658366898572,0.0,20.0
45462,4,5462,[318  79 427 588 216],577,5,22086,4.042833607907743,40.0,0.0
45463,4,5463,[483 234 313 742 173],280,2,22088,4.0424597364568085,0.0,0.0
45464,4,5464,[191 588 282 655 200],796,4,22092,4.042451967063129,0.0,0.0
45465,4,5465,[423  88 185 151 179],389,4,22096,4.042444200512257,0.0,0.0
45466,4,5466,[  7   8 172 196  88],655,1,22097,4.041887689775014,0.0,0.0
45467,4,5467,[742 194 180  79 318],796,3,22100,4.041697147037308,20.0,0.0
45468,4,5468,[318  79 427 588 216],716,5,22105,4.041872371548729,40.0,0.0
45469,4,5469,[318  79 427 588 216],577,5,22110,4.042047531992687,40.0,0.0
45470,4,5470,[318  79 427 588 216],577,5,22115,4.042222628404313,40.0,0.0
45471,4,5471,[186 215 385  95 748],450,3,22118,4.04203216374269,0.0,0.0
45472,4,5472,[135 181 174 328 238],655,1,22119,4.041476338388453,0.0,0.0
45473,4,5473,[318  79 427 588 216],577,5,22124,4.0416514431859705,40.0,0.0
45474,4,5474,[515 471 179 195 294],655,2,22126,4.041278538812786,0.0,0.0
45475,4,5475,[144 216 471 742 273],450,4,22130,4.04127100073046,0.0,0.0
45476,4,5476,[216 121 100 257 483],655,2,22132,4.040898301990141,0.0,20.0
45477,4,5477,[273 183 742 125 216],344,3,22135,4.04070828769624,0.0,0.0
45478,4,5478,[318  79 427 588 216],18,5,22140,4.0408833728782625,40.0,0.0
45479,4,5479,[318  79 427 588 216],796,5,22145,4.041058394160584,40.0,0.0
45480,4,5480,[117 168  95 194  82],577,5,22150,4.041233351578179,0.0,0.0
45481,4,5481,[318  79 427 588 216],450,5,22155,4.041408245165997,40.0,0.0
45482,4,5482,[318  79 427 588 216],450,5,22160,4.041583074958964,40.0,0.0
45483,4,5483,[100 275 111 151   9],401,3,22163,4.041393143690737,0.0,40.0
45484,4,5484,[318  79 427 588 216],18,5,22168,4.041567912488605,40.0,0.0
45485,4,5485,[ 22  82 328  64 202],796,4,22172,4.041560335399198,20.0,0.0
45486,4,5486,[179 357 215   1 301],655,2,22174,4.041188263167487,0.0,0.0
45487,4,5487,[318  79 427 588 216],716,5,22179,4.041362973760933,40.0,0.0
45488,4,5488,[318  79 427 588 216],796,5,22184,4.041537620695937,40.0,0.0
45489,4,5489,[318  79 427 588 216],796,5,22189,4.041712204007286,40.0,0.0
45490,4,5490,[318  79 427 588 216],716,5,22194,4.04188672372974,40.0,0.0
45491,4,5491,[182  97 496 186 197],18,5,22199,4.042061179898034,20.0,0.0
45492,4,5492,[318  79 427 588 216],796,5,22204,4.042235572546878,40.0,0.0
45493,4,5493,[318  79 427 588 216],18,5,22209,4.042409901710958,40.0,0.0
45494,4,5494,[273 258 194 302 179],450,4,22213,4.042402183803458,0.0,0.0
45495,4,5495,[204  79 125 100 742],655,1,22214,4.041848617176128,0.0,20.0
45496,4,5496,[318  79 427 588 216],450,5,22219,4.042022921593596,40.0,0.0
45497,4,5497,[ 96 237 161 125 318],450,5,22224,4.042197162604584,20.0,0.0
45498,4,5498,[176   1 300 100 257],389,3,22227,4.042007637752318,0.0,20.0
45499,4,5499,[196 191 275 496   9],151,4,22231,4.042,20.0,20.0
45500,4,5500,[405 328 127 174 302],655,2,22233,4.041628794764589,0.0,20.0
45501,4,5501,[546 143 117  25 194],577,3,22236,4.041439476553981,0.0,0.0
45502,4,5502,[197 483  28 655 117],716,5,22241,4.041613665273487,0.0,0.0
45503,4,5503,[282  69 597  79 182],796,5,22246,4.041787790697675,0.0,0.0
45504,4,5504,[195 118 168 258 546],504,4,22250,4.041780199818347,0.0,0.0
45505,4,5505,[265 132 161 118 237],655,0,22250,4.041046131492917,0.0,0.0
45506,4,5506,[318  79 427 588 216],18,5,22255,4.041220265117124,40.0,0.0
45507,4,5507,[275  25  96 202 200],457,5,22260,4.041394335511982,0.0,20.0
45508,4,5508,[318  79 427 588 216],577,5,22265,4.041568342711926,40.0,0.0
45509,4,5509,[318  79 427 588 216],716,5,22270,4.0417422867513615,40.0,0.0
45510,4,5510,[235 228 174 194   4],450,3,22273,4.0415532571221195,0.0,0.0
45511,4,5511,[318  79 427 588 216],577,5,22278,4.0417271407837445,40.0,0.0
45512,4,5512,[135  69 286 191 181],18,2,22280,4.0413567930346455,0.0,20.0
45513,4,5513,[423 483 405 222 204],280,2,22282,4.040986579615524,0.0,0.0
45514,4,5514,[153 127 151 194 118],504,2,22284,4.040616500453309,0.0,20.0
45515,4,5515,[ 71 238 191 655 111],786,5,22289,4.040790427846265,0.0,0.0
45516,4,5516,[179 132 181 294 204],450,5,22294,4.040964292187783,0.0,0.0
45517,4,5517,[318  79 427 588 216],577,5,22299,4.041138093512142,40.0,0.0
45518,4,5518,[483  64 597 196 328],450,4,22303,4.041130639608625,20.0,0.0
45519,4,5519,[174 195 118 117 173],292,4,22307,4.041123188405797,0.0,0.0
45520,4,5520,[ 88 143 210 181  95],716,5,22312,4.041296866509691,0.0,0.0
45521,4,5521,[168 323 132 238  88],796,3,22315,4.041108294096342,0.0,0.0
45522,4,5522,[ 97 275 191  88 215],655,2,22317,4.0407387289516565,0.0,20.0
45523,4,5523,[318  79 427 588 216],796,5,22322,4.040912382331643,40.0,0.0
45524,4,5524,[135 121 276 318 195],535,3,22325,4.040723981900452,20.0,0.0
45525,4,5525,[153 322  82 257 357],796,3,22328,4.040535649656171,0.0,0.0
45526,4,5526,[196 385 143   4 235],457,4,22332,4.040528315541885,0.0,0.0
45527,4,5527,[143  89  79 597 235],457,3,22335,4.04034008683068,0.0,0.0
45528,4,5528,[173 121 300 357 204],151,5,22340,4.040513655272201,0.0,0.0
45529,4,5529,[288   9 313  56 546],693,2,22342,4.0401446654611215,0.0,0.0
45530,4,5530,[318  79 427 588 216],450,5,22347,4.040318206472609,40.0,0.0
45531,4,5531,[318  79 427 588 216],796,5,22352,4.040491684743311,40.0,0.0
45532,4,5532,[423 222 234 183  88],450,3,22355,4.0403036327489605,0.0,0.0
45533,4,5533,[318  79 427 588 216],18,5,22360,4.040477050957716,40.0,0.0
45534,4,5534,[318  79 427 588 216],796,5,22365,4.040650406504065,40.0,0.0
45535,4,5535,[204 174  88 194  56],796,5,22370,4.040823699421965,0.0,0.0
45536,4,5536,[ 98 204 471 125 405],786,5,22375,4.04099692974535,0.0,0.0
45537,4,5537,[ 69 603 508  12 742],11,2,22377,4.040628385698808,20.0,0.0
45538,4,5538,[318  79 427 588 216],796,5,22382,4.040801588734428,40.0,0.0
45539,4,5539,[318  79 427 588 216],577,5,22387,4.040974729241877,40.0,0.0
45540,4,5540,[483 174 197  89 127],457,5,22392,4.041147807255008,0.0,20.0
45541,4,5541,[496  56 181 216  71],593,5,22397,4.04132082280765,20.0,0.0
45542,4,5542,[318  79 427 588 216],577,5,22402,4.04149377593361,40.0,0.0
45543,4,5543,[ 79 179  71 483 275],535,4,22406,4.041486291486292,0.0,20.0
45544,4,5544,[127 173 153 215  95],450,4,22410,4.0414788097385035,0.0,20.0
45545,4,5545,[318  79 427 588 216],577,5,22415,4.041651640822214,40.0,0.0
45546,4,5546,[245 118 385  71 322],344,0,22415,4.040923021453038,0.0,0.0
45547,4,5547,[200 288 515 144 195],655,2,22417,4.040555155010814,0.0,0.0
45548,4,5548,[286 405  98 132 496],503,3,22420,4.040367633807893,20.0,20.0
45549,4,5549,[318  79 427 588 216],796,5,22425,4.04054054054054,40.0,0.0
45550,4,5550,[318  79 427 588 216],716,5,22430,4.04071338497568,40.0,0.0
45551,4,5551,[ 70  96 197 143  82],504,4,22434,4.040706051873199,0.0,0.0
45552,4,5552,[215 183 328 228  64],796,5,22439,4.040878804249955,20.0,0.0
45553,4,5553,[318  79 427 588 216],796,5,22444,4.041051494418437,40.0,0.0
45554,4,5554,[318  79 427 588 216],18,5,22449,4.041224122412241,40.0,0.0
45555,4,5555,[238 357 403 228 186],457,5,22454,4.041396688264939,0.0,0.0
45556,4,5556,[195 176 197 234 174],693,2,22456,4.041029332373583,0.0,0.0
45557,4,5557,[318  79 427 588 216],796,5,22461,4.041201871176682,40.0,0.0
45558,4,5558,[286 238 180 132 194],535,4,22465,4.04119445943515,0.0,20.0
45559,4,5559,[318  79 427 588 216],577,5,22470,4.0413669064748206,40.0,0.0
45560,4,5560,[234  15 496  50 546],593,3,22473,4.04117964394893,20.0,20.0
45561,4,5561,[168 174 196 200 300],796,5,22478,4.041352031643294,0.0,0.0
45562,4,5562,[144 357 515 135 182],655,4,22482,4.041344598238361,0.0,0.0
45563,4,5563,[289 196  12 276 179],655,2,22484,4.04097771387491,0.0,0.0
45564,4,5564,[318  79 427 588 216],716,5,22489,4.04115004492363,40.0,0.0
45565,4,5565,[216 186  64 172 161],716,3,22492,4.04096298957959,20.0,0.0
45566,4,5566,[318  79 427 588 216],18,5,22497,4.041135261361595,40.0,0.0
45567,4,5567,[357  89 475 301 403],655,2,22499,4.040768678160919,0.0,0.0
45568,4,5568,[318  79 427 588 216],716,5,22504,4.0409409229664215,40.0,0.0
45569,4,5569,[318  79 427 588 216],716,5,22509,4.041113105924596,40.0,0.0
45570,4,5570,[385 179 161  69 153],655,1,22510,4.040567223119727,0.0,0.0
45571,4,5571,[132 200  15 258 322],450,3,22513,4.040380473797559,0.0,0.0
45572,4,5572,[121 151 191 135  79],450,3,22516,4.040193791494707,0.0,0.0
45573,4,5573,[132 313  25  69 294],577,5,22521,4.040365984930032,0.0,0.0
45574,4,5574,[318  79 427 588 216],796,5,22526,4.040538116591928,40.0,0.0
45575,4,5575,[161 100  64  25 423],450,4,22530,4.040530846484936,20.0,20.0
45576,4,5576,[187  56 127  96 405],655,2,22532,4.040164963241886,0.0,20.0
45577,4,5577,[257 423 435 273   1],655,1,22533,4.039619935460738,0.0,0.0
45578,4,5578,[742 125 117 215 405],344,0,22533,4.0388958594730235,0.0,0.0
45579,4,5579,[151 237 118  79 597],344,2,22535,4.038530465949821,0.0,0.0
45580,4,5580,[357 568   8 176 202],655,1,22536,4.037986024010034,0.0,0.0
45581,4,5581,[318  79 427 588 216],18,5,22541,4.038158366176997,40.0,0.0
45582,4,5582,[318  79 427 588 216],796,5,22546,4.038330646605767,40.0,0.0
45583,4,5583,[318  79 427 588 216],716,5,22551,4.038502865329513,40.0,0.0
45584,4,5584,[173 276 182 135  22],535,1,22552,4.037958818263205,0.0,0.0
45585,4,5585,[318  79 427 588 216],577,5,22557,4.03813104189044,40.0,0.0
45586,4,5586,[318  79 427 588 216],716,5,22562,4.038303203866118,40.0,0.0
45587,4,5587,[ 88  11 202 234  69],457,5,22567,4.0384753042233354,0.0,0.0
45588,4,5588,[ 15  56 237 258 405],796,5,22572,4.038647342995169,0.0,0.0
45589,4,5589,[318  79 427 588 216],450,5,22577,4.038819320214669,40.0,0.0
45590,4,5590,[318  79 427 588 216],18,5,22582,4.038991235914863,40.0,0.0
45591,4,5591,[318  79 427 588 216],577,5,22587,4.039163090128755,40.0,0.0
45592,4,5592,[318  79 427 588 216],450,5,22592,4.039334882889326,40.0,0.0
45593,4,5593,[118 273 186  71 546],450,1,22593,4.0387915623882735,0.0,0.0
45594,4,5594,[318 385 179 181 168],450,5,22598,4.038963360142985,20.0,0.0
45595,4,5595,[  1 313  56 301 176],796,3,22601,4.038777698355968,0.0,0.0
45596,4,5596,[318  79 427 588 216],18,5,22606,4.038949437198499,40.0,0.0
45597,4,5597,[ 70 496 237 197 216],269,2,22608,4.038585209003215,20.0,0.0
45598,4,5598,[174 333 385 215 186],655,0,22608,4.03786390426862,0.0,0.0
45599,4,5599,[237 603  98 423  70],18,3,22611,4.037678571428572,20.0,0.0
45600,4,5600,[318  79 427 588 216],18,5,22616,4.037850383860025,40.0,0.0
45601,4,5601,[318  79 427 588 216],716,5,22621,4.038022134951803,40.0,0.0
45602,4,5602,[318  79 427 588 216],796,5,22626,4.038193824736748,40.0,0.0
45603,4,5603,[318  79 427 588 216],18,5,22631,4.03836545324768,40.0,0.0
45604,4,5604,[322 204 153 118 435],450,4,22635,4.03835860838537,0.0,0.0
45605,4,5605,[318  79 427 588 216],577,5,22640,4.038530146271851,40.0,0.0
45606,4,5606,[318  79 427 588 216],450,5,22645,4.038701622971286,40.0,0.0
45607,4,5607,[318  79 427 588 216],18,5,22650,4.038873038516405,40.0,0.0
45608,4,5608,[282 195 313 655 423],236,3,22653,4.03868782314138,0.0,0.0
45609,4,5609,[318  79 427 588 216],577,5,22658,4.038859180035651,40.0,0.0
45610,4,5610,[435 237 275  98  25],535,4,22662,4.038852254500089,0.0,20.0
45611,4,5611,[318  79 427 588 216],796,5,22667,4.039023521026372,40.0,0.0
45612,4,5612,[318  79 427 588 216],450,5,22672,4.039194726527704,40.0,0.0
45613,4,5613,[182 202 423  50 228],457,5,22677,4.039365871036694,0.0,20.0
45614,4,5614,[210 318   8 181  97],577,4,22681,4.039358860195904,20.0,0.0
45615,4,5615,[196 328  50 179 483],655,3,22684,4.039173789173789,0.0,20.0
45616,4,5616,[588 202 111   8 258],796,5,22689,4.039344846003204,0.0,0.0
45617,4,5617,[238 182 234 742 111],796,2,22691,4.038981844072624,0.0,0.0
45618,4,5618,[111 286  64 742 181],344,2,22693,4.038618971347215,20.0,20.0
45619,4,5619,[ 50 313 181  22  56],280,2,22695,4.038256227758007,0.0,20.0
45620,4,5620,[ 70  79 655 125 204],457,5,22700,4.038427326098559,0.0,0.0
45621,4,5621,[318  79 427 588 216],450,5,22705,4.0385983635716824,40.0,0.0
45622,4,5622,[403 318 125  15 127],796,5,22710,4.038769340209853,20.0,20.0
45623,4,5623,[318  79 427 588 216],18,5,22715,4.038940256045519,40.0,0.0
45624,4,5624,[ 89 182 175  28 135],18,2,22717,4.038577777777777,0.0,0.0
45625,4,5625,[  7  98 151 195 237],535,4,22721,4.0385709207252045,0.0,0.0
45626,4,5626,[318  79 427 588 216],577,5,22726,4.038741780700195,40.0,0.0
45627,4,5627,[100  12 294 215 132],457,4,22730,4.038734896943852,0.0,20.0
45628,4,5628,[191 234 237 153  22],796,4,22734,4.038728015633327,0.0,0.0
45629,4,5629,[313 483 185 181  98],655,4,22738,4.038721136767318,0.0,0.0
45630,4,5630,[ 95 515  89  96 127],807,3,22741,4.038536671994317,0.0,20.0
45631,4,5631,[  4  64 202  70 483],151,5,22746,4.038707386363637,20.0,0.0
45632,4,5632,[204  64 172 405 127],716,5,22751,4.038878040120717,20.0,20.0
45633,4,5633,[185  69 427 195 568],450,5,22756,4.039048633297835,20.0,0.0
45634,4,5634,[185  64 275 151 403],796,5,22761,4.03921916592724,20.0,20.0
45635,4,5635,[318  79 427 588 216],18,5,22766,4.039389638041164,40.0,0.0
45636,4,5636,[475 174 403 153 187],269,2,22768,4.039027851694163,0.0,0.0
45637,4,5637,[265 322 273 222  95],796,3,22771,4.038843561546647,0.0,0.0
45638,4,5638,[100 423 182 435 210],629,5,22776,4.039014009576166,0.0,20.0
45639,4,5639,[268 515 195 211 301],535,3,22779,4.038829787234042,0.0,0.0
45640,4,5640,[318  79 427 588 216],450,5,22784,4.039000177273533,40.0,0.0
45641,4,5641,[405 204 185 269 151],796,4,22788,4.038993264799716,0.0,0.0
45642,4,5642,[318  79 427 588 216],577,5,22793,4.039163565479355,40.0,0.0
45643,4,5643,[357 143 275 237  98],716,5,22798,4.039333805811482,0.0,20.0
45644,4,5644,[144 153 215 197  82],655,0,22798,4.038618246235607,0.0,0.0
45645,4,5645,[318 185  88 496 427],18,3,22801,4.038434289762664,60.0,0.0
45646,4,5646,[182  50  12 168  69],457,5,22806,4.0386045687975916,0.0,20.0
45647,4,5647,[318  79 427 588 216],450,5,22811,4.038774787535411,40.0,0.0
45648,4,5648,[405 496 216 276 245],593,2,22813,4.038413878562578,20.0,0.0
45649,4,5649,[318  79 427 588 216],577,5,22818,4.03858407079646,40.0,0.0
45650,4,5650,[318  79 427 588 216],450,5,22823,4.038754202795966,40.0,0.0
45651,4,5651,[194  79 237  56 222],716,5,22828,4.0389242745930645,0.0,0.0
45652,4,5652,[318  79 427 588 216],450,5,22833,4.039094286219706,40.0,0.0
45653,4,5653,[132  95   8 153  88],796,5,22838,4.039264237707817,0.0,0.0
45654,4,5654,[318  79 427 588 216],450,5,22843,4.039434129089302,40.0,0.0
45655,4,5655,[318  79 427 588 216],450,5,22848,4.03960396039604,40.0,0.0
45656,4,5656,[191   4   8 132 143],457,5,22853,4.03977373165989,0.0,0.0
45657,4,5657,[318  79 427 588 216],450,5,22858,4.03994344291269,40.0,0.0
45658,4,5658,[318  79 427 588 216],716,5,22863,4.040113094186252,40.0,0.0
45659,4,5659,[ 88 132 546 269 238],174,3,22866,4.039929328621908,0.0,0.0
45660,4,5660,[423 403 176 117 216],457,5,22871,4.040098922451864,0.0,0.0
45661,4,5661,[405 322  82  50 748],796,3,22874,4.039915224302367,0.0,20.0
45662,4,5662,[318  79 427 588 216],577,5,22879,4.040084760727529,40.0,0.0
45663,4,5663,[111 195 211  15 318],236,3,22882,4.039901129943503,20.0,0.0
45664,4,5664,[742 269 181 211  12],450,5,22887,4.0400706090026475,0.0,0.0
45665,4,5665,[111 172 125  89   7],655,2,22889,4.039710554182845,0.0,0.0
45666,4,5666,[318  79 427 588 216],796,5,22894,4.039880007058408,40.0,0.0
45667,4,5667,[132  97 117 127 144],693,5,22899,4.040049400141143,0.0,20.0
45668,4,5668,[318  79 427 588 216],18,5,22904,4.040218733462692,40.0,0.0
45669,4,5669,[318  79 427 588 216],577,5,22909,4.040388007054673,40.0,0.0
45670,4,5670,[318  79 427 588 216],716,5,22914,4.040557220948687,40.0,0.0
45671,4,5671,[427 172 183 211  56],151,4,22918,4.040550070521862,20.0,0.0
45672,4,5672,[318  79 427 588 216],796,5,22923,4.040719196192491,40.0,0.0
45673,4,5673,[144 173 176 161 143],23,1,22924,4.040183292210081,0.0,0.0
45674,4,5674,[216 471 172 435 597],450,5,22929,4.040352422907489,0.0,0.0
45675,4,5675,[  1 196   7 100 111],151,4,22933,4.040345313601128,0.0,20.0
45676,4,5676,[496 175 210 111 471],344,4,22937,4.040338206799366,20.0,0.0
45677,4,5677,[318  79 427 588 216],716,5,22942,4.040507220852413,40.0,0.0
45678,4,5678,[483 183 403  89 197],796,4,22946,4.04050008804367,0.0,0.0
45679,4,5679,[318  79 427 588 216],796,5,22951,4.040669014084507,40.0,0.0
45680,4,5680,[237 211 294 181 238],504,1,22952,4.040133779264214,0.0,0.0
45681,4,5681,[318  79 427 588 216],796,5,22957,4.04030271031327,40.0,0.0
45682,4,5682,[ 82  98 318 258  56],450,4,22961,4.040295618511349,20.0,0.0
45683,4,5683,[172 211  96 427  98],296,5,22966,4.040464461646728,20.0,0.0
45684,4,5684,[271 288 143  70 117],655,1,22967,4.039929639401935,0.0,0.0
45685,4,5685,[313 238 515 276  82],655,3,22970,4.039746746394654,0.0,0.0
45686,4,5686,[ 71 172  22 222 568],796,5,22975,4.0399155969755585,0.0,0.0
45687,4,5687,[ 88 132 204 121 187],503,3,22978,4.039732770745429,0.0,0.0
45688,4,5688,[318  79 427 588 216],577,5,22983,4.0399015644225695,40.0,0.0
45689,4,5689,[318  79 427 588 216],577,5,22988,4.040070298769772,40.0,0.0
45690,4,5690,[ 56 174 294 216 245],504,3,22991,4.03988754173256,0.0,0.0
45691,4,5691,[175 176 268 271 435],655,0,22991,4.039177793394238,0.0,0.0
45692,4,5692,[427 238 182 275   7],450,5,22996,4.039346565958194,20.0,20.0
45693,4,5693,[318  79 427 588 216],450,5,23001,4.039515279241306,40.0,0.0
45694,4,5694,[111  82 234 323  71],796,2,23003,4.039157155399473,0.0,0.0
45695,4,5695,[496  12 597 151 118],344,3,23006,4.038974719101123,20.0,0.0
45696,4,5696,[318  79 427 588 216],577,5,23011,4.039143408811655,40.0,0.0
45697,4,5697,[  9 294  64 111 269],629,3,23014,4.038961038961039,20.0,0.0
45698,4,5698,[678  79 435   1 427],807,3,23017,4.038778733111072,20.0,0.0
45699,4,5699,[318  79 427 588 216],796,5,23022,4.038947368421053,40.0,0.0
45700,4,5700,[210 302 183 191  70],450,4,23026,4.038940536747939,0.0,0.0
45701,4,5701,[237 100 204   7 603],655,1,23027,4.038407576289021,20.0,20.0
45702,4,5702,[215 132  69 222 100],344,3,23030,4.0382254953533225,0.0,20.0
45703,4,5703,[161 742 135 385  88],655,1,23031,4.037692847124824,0.0,0.0
45704,4,5704,[173  15 100 132 111],629,5,23036,4.03786152497809,0.0,20.0
45705,4,5705,[  7  82 172 322 121],786,3,23039,4.0376796354714335,0.0,0.0
45706,4,5706,[153 333 210 117 111],655,0,23039,4.036972139477834,0.0,0.0
45707,4,5707,[127 161 655 204 187],72,5,23044,4.037140854940435,0.0,20.0
45708,4,5708,[318  79 427 588 216],796,5,23049,4.03730951129795,40.0,0.0
45709,4,5709,[471 269  12  79 111],344,4,23053,4.037302977232924,0.0,0.0
45710,4,5710,[ 56 194 100 238 195],18,3,23056,4.037121344773245,0.0,20.0
45711,4,5711,[427 210  88 286 197],151,5,23061,4.037289915966387,20.0,20.0
45712,4,5712,[181 172  89 216 483],796,5,23066,4.037458428146333,0.0,0.0
45713,4,5713,[318  79 427 588 216],716,5,23071,4.037626881344067,40.0,0.0
45714,4,5714,[318  79 427 588 216],577,5,23076,4.037795275590551,40.0,0.0
45715,4,5715,[273 197 603 301  89],655,3,23079,4.037613715885234,20.0,0.0
45716,4,5716,[125 143 173 118 265],151,4,23083,4.03760713661011,0.0,0.0
45717,4,5717,[427 144 200   9 597],796,4,23087,4.037600559636236,20.0,0.0
45718,4,5718,[318  79 427 588 216],716,5,23092,4.037768840706417,40.0,0.0
45719,4,5719,[318  79 427 588 216],450,5,23097,4.037937062937063,40.0,0.0
45720,4,5720,[318  79 427 588 216],716,5,23102,4.038105226359028,40.0,0.0
45721,4,5721,[172  82 216 186  88],151,4,23106,4.0380985669346385,0.0,0.0
45722,4,5722,[172  28 300 471 196],389,3,23109,4.0379171763061334,0.0,0.0
45723,4,5723,[222 357  25 228 161],716,4,23113,4.037910552061495,0.0,0.0
45724,4,5724,[  1 496  12 143  64],151,5,23118,4.038078602620088,40.0,0.0
45725,4,5725,[318  79 427 588 216],18,5,23123,4.038246594481313,40.0,0.0
45726,4,5726,[ 50  96 275  22 100],450,5,23128,4.038414527675921,0.0,60.0
45727,4,5727,[318  79 427 588 216],577,5,23133,4.038582402234637,40.0,0.0
45728,4,5728,[318  79 427 588 216],450,5,23138,4.038750218188166,40.0,0.0
45729,4,5729,[318  79 427 588 216],716,5,23143,4.03891797556719,40.0,0.0
45730,4,5730,[318  79 427 588 216],716,5,23148,4.039085674402373,40.0,0.0
45731,4,5731,[385 202   4 197 118],280,1,23149,4.038555478018144,0.0,0.0
45732,4,5732,[427  64  69 385  15],577,4,23153,4.038548752834467,40.0,0.0
45733,4,5733,[318  79 427 588 216],450,5,23158,4.038716428322288,40.0,0.0
45734,4,5734,[222 182  70 508 276],280,2,23160,4.038360941586748,0.0,0.0
45735,4,5735,[318  79 427 588 216],450,5,23165,4.0385285913528595,40.0,0.0
45736,4,5736,[258  12 269 328 245],629,2,23167,4.038173261286387,0.0,0.0
45737,4,5737,[318  79 427 588 216],18,5,23172,4.038340885325898,40.0,0.0
45738,4,5738,[435 181 195 144 197],655,0,23172,4.0376372190277054,0.0,0.0
45739,4,5739,[222 300  82 258 153],450,3,23175,4.0374564459930316,0.0,0.0
45740,4,5740,[318  79 427 588 216],450,5,23180,4.03762410729838,40.0,0.0
45741,4,5741,[111 265  28  95   8],796,4,23184,4.037617554858934,0.0,0.0
45742,4,5742,[ 69 151 204 269 234],18,1,23185,4.037088629636079,0.0,0.0
45743,4,5743,[161  22 168 211 153],450,5,23190,4.037256267409471,0.0,0.0
45744,4,5744,[ 79 269   8 216 182],503,4,23194,4.0372497824194955,0.0,0.0
45745,4,5745,[318  79 427 588 216],577,5,23199,4.037417333797424,40.0,0.0
45746,4,5746,[318  79 427 588 216],18,5,23204,4.037584826866191,40.0,0.0
45747,4,5747,[318  79 427 588 216],716,5,23209,4.0377522616562285,40.0,0.0
45748,4,5748,[173 603 143  79 275],756,3,23212,4.037571751608976,20.0,20.0
45749,4,5749,[228 678 276 423 200],280,3,23215,4.0373913043478264,0.0,0.0
45750,4,5750,[318  79 427 588 216],796,5,23220,4.037558685446009,40.0,0.0
45751,4,5751,[204 173 228  79 153],23,4,23224,4.037552155771905,0.0,0.0
45752,4,5752,[  8  89  69 282 269],655,1,23225,4.037024161307144,0.0,0.0
45753,4,5753,[172 385  56 196 588],450,5,23230,4.037191518943343,0.0,0.0
45754,4,5754,[ 70 176  96  79 471],280,3,23233,4.037011294526499,0.0,0.0
45755,4,5755,[318  79 427 588 216],18,5,23238,4.037178596247394,40.0,0.0
45756,4,5756,[318  79 427 588 216],577,5,23243,4.037345839847142,40.0,0.0
45757,4,5757,[318  79 427 588 216],716,5,23248,4.037513025356026,40.0,0.0
45758,4,5758,[318  79 427 588 216],796,5,23253,4.037680152804306,40.0,0.0
45759,4,5759,[318  79 427 588 216],716,5,23258,4.037847222222222,40.0,0.0
45760,4,5760,[318  79 427 588 216],450,5,23263,4.038014233639993,40.0,0.0
45761,4,5761,[748   9 135 100 117],280,3,23266,4.0378340853870185,0.0,20.0
45762,4,5762,[405  28 269   1  64],450,5,23271,4.0380010411244145,20.0,0.0
45763,4,5763,[ 70 286 238  11   9],11,3,23274,4.037820957668286,0.0,20.0
45764,4,5764,[294 301 222 427  79],296,4,23278,4.037814397224631,20.0,0.0
45765,4,5765,[318  79 427 588 216],716,5,23283,4.037981269510926,40.0,0.0
45766,4,5766,[318  79 427 588 216],450,5,23288,4.038148083925785,40.0,0.0
45767,4,5767,[318  79 427 588 216],796,5,23293,4.038314840499306,40.0,0.0
45768,4,5768,[276 265 202  50 258],629,5,23298,4.0384815392615705,0.0,20.0
45769,4,5769,[ 15 111  98 269  22],629,4,23302,4.038474870017331,0.0,0.0
45770,4,5770,[173 200 265 228 282],280,2,23304,4.03812164269624,0.0,0.0
45771,4,5771,[ 97 258 328 237 111],796,4,23308,4.038115038115038,0.0,0.0
45772,4,5772,[318  79 427 588 216],577,5,23313,4.038281655984757,40.0,0.0
45773,4,5773,[186 176 483 111 197],389,3,23316,4.038101835815725,0.0,0.0
45774,4,5774,[318  79 427 588 216],796,5,23321,4.038268398268398,40.0,0.0
45775,4,5775,[471 237 181 288 179],593,4,23325,4.038261772853185,0.0,0.0
45776,4,5776,[318  79 427 588 216],18,5,23330,4.038428249956725,40.0,0.0
45777,4,5777,[144 118 135 405 176],450,3,23333,4.038248528902734,0.0,0.0
45778,4,5778,[318  79 427 588 216],577,5,23338,4.038414950683509,40.0,0.0
45779,4,5779,[328   9  25 483  88],401,4,23342,4.03840830449827,0.0,0.0
45780,4,5780,[238 161 588 603   1],450,5,23347,4.038574641065559,20.0,0.0
45781,4,5781,[318  79 427 588 216],450,5,23352,4.038740920096853,40.0,0.0
45782,4,5782,[125 191 273 265  15],450,3,23355,4.038561300363133,0.0,0.0
45783,4,5783,[ 50 328 132 385 117],655,1,23356,4.038035961272476,0.0,20.0
45784,4,5784,[174  11   4  88 200],655,1,23357,4.037510803802939,0.0,0.0
45785,4,5785,[183 187 235 546  56],450,4,23361,4.037504320774283,0.0,0.0
45786,4,5786,[318  79 427 588 216],18,5,23366,4.037670641092103,40.0,0.0
45787,4,5787,[127 182 191  15 174],629,4,23370,4.03766413268832,0.0,20.0
45788,4,5788,[318  79 427 588 216],716,5,23375,4.037830367939195,40.0,0.0
45789,4,5789,[269 301 405 588 204],344,4,23379,4.0378238341968915,0.0,0.0
45790,4,5790,[273 118 275  56 222],655,2,23381,4.037471939216025,0.0,20.0
45791,4,5791,[ 82 483 153 258 603],655,2,23383,4.037120165745856,20.0,0.0
45792,4,5792,[318  79 427 588 216],716,5,23388,4.0372863801139305,40.0,0.0
45793,4,5793,[210 423 168 568 200],577,2,23390,4.036934760096652,0.0,0.0
45794,4,5794,[265 357 423 269 403],450,5,23395,4.037100949094047,0.0,0.0
45795,4,5795,[237 194 328  98 135],65,5,23400,4.037267080745342,0.0,0.0
45796,4,5796,[257   1 333  79 655],796,3,23403,4.037088149042608,0.0,0.0
45797,4,5797,[318  79 427 588 216],577,5,23408,4.037254225595032,40.0,0.0
45798,4,5798,[318  79 427 588 216],716,5,23413,4.037420244869805,40.0,0.0
45799,4,5799,[121 655 288 100 144],450,3,23416,4.037241379310345,0.0,20.0
45800,4,5800,[568 161 197  25 435],72,5,23421,4.037407343561455,0.0,0.0
45801,4,5801,[ 22 228 121 405 191],450,4,23425,4.037400896242675,0.0,0.0
45802,4,5802,[216 282  98   4 143],593,5,23430,4.037566775805618,0.0,0.0
45803,4,5803,[175 222 318   1 100],457,5,23435,4.037732598208132,20.0,20.0
45804,4,5804,[191 135 186 176 588],835,4,23439,4.037726098191214,0.0,0.0
45805,4,5805,[238 257 191 111 475],655,1,23440,4.037202893558388,0.0,0.0
45806,4,5806,[222  79 288 183 588],457,5,23445,4.037368692956776,0.0,0.0
45807,4,5807,[210 161 191 257 405],457,4,23449,4.037362258953168,0.0,0.0
45808,4,5808,[ 69 258 144 597 161],796,5,23454,4.037527973833706,0.0,0.0
45809,4,5809,[318  79 427 588 216],450,5,23459,4.037693631669535,40.0,0.0
45810,4,5810,[318  79 427 588 216],796,5,23464,4.037859232490105,40.0,0.0
45811,4,5811,[318  79 427 588 216],716,5,23469,4.038024776324845,40.0,0.0
45812,4,5812,[318  79 427 588 216],577,5,23474,4.038190263203165,40.0,0.0
45813,4,5813,[318 588 204 211  79],18,4,23478,4.038183694530444,20.0,0.0
45814,4,5814,[318  79 427 588 216],796,5,23483,4.038349097162511,40.0,0.0
45815,4,5815,[194 435 195 496   9],535,5,23488,4.038514442916093,20.0,0.0
45816,4,5816,[197 238 127 423  82],269,4,23492,4.038507821901324,0.0,20.0
45817,4,5817,[ 98 179 588 187  89],18,4,23496,4.038501203162599,0.0,0.0
45818,4,5818,[318  79 427 588 216],796,5,23501,4.038666437532222,40.0,0.0
45819,4,5819,[286 237 194 135 275],18,2,23503,4.038316151202749,0.0,40.0
45820,4,5820,[603 111 197  12  88],151,5,23508,4.038481360590964,20.0,0.0
45821,4,5821,[318  79 427 588 216],18,5,23513,4.038646513225696,40.0,0.0
45822,4,5822,[318  79 427 588 216],716,5,23518,4.038811609136184,40.0,0.0
45823,4,5823,[318  79 427 588 216],450,5,23523,4.038976648351649,40.0,0.0
45824,4,5824,[275 194 111 181 176],389,4,23527,4.038969957081545,0.0,20.0
45825,4,5825,[318  79 427 588 216],577,5,23532,4.03913491246138,40.0,0.0
45826,4,5826,[234 144  97 175 183],716,2,23534,4.038784966535095,0.0,0.0
45827,4,5827,[742 197 186 275 273],450,3,23537,4.038606726149623,0.0,20.0
45828,4,5828,[180  50 483  71 328],796,4,23541,4.038600102933608,0.0,20.0
45829,4,5829,[318  79 427 588 216],577,5,23546,4.03876500857633,40.0,0.0
45830,4,5830,[318  79 427 588 216],18,5,23551,4.038929857657348,40.0,0.0
45831,4,5831,[318  79 427 588 216],18,5,23556,4.039094650205762,40.0,0.0
45832,4,5832,[215 181 258  98  56],457,5,23561,4.0392593862506425,0.0,0.0
45833,4,5833,[111 179 286  56  71],18,4,23565,4.039252656839218,0.0,20.0
45834,4,5834,[405 294 117 471 322],280,2,23567,4.038903170522707,0.0,0.0
45835,4,5835,[427 300 127 191 143],716,5,23572,4.039067854694997,20.0,20.0
45836,4,5836,[318  79 427 588 216],577,5,23577,4.039232482439609,40.0,0.0
45837,4,5837,[294 187 216 151 568],716,4,23581,4.039225762247345,0.0,0.0
45838,4,5838,[318  79 427 588 216],577,5,23586,4.039390306559342,40.0,0.0
45839,4,5839,[132 183 211  79 191],450,5,23591,4.039554794520548,0.0,0.0
45840,4,5840,[257  89   7  22 185],457,4,23595,4.03954802259887,0.0,0.0
45841,4,5841,[276 132 197 238 202],174,4,23599,4.03954125299555,0.0,0.0
45842,4,5842,[194   8 257 127   7],457,4,23603,4.039534485709396,0.0,20.0
45843,4,5843,[318  79 427 588 216],577,5,23608,4.039698836413415,40.0,0.0
45844,4,5844,[318  79 427 588 216],18,5,23613,4.039863130881095,40.0,0.0
45845,4,5845,[423 294   4  82 235],280,2,23615,4.0395141977420455,0.0,0.0
45846,4,5846,[ 88  79 132 483 228],23,4,23619,4.039507439712673,0.0,0.0
45847,4,5847,[318  79 427 588 216],716,5,23624,4.039671682626539,40.0,0.0
45848,4,5848,[ 96 111 185 588 385],716,3,23627,4.039493930586425,0.0,0.0
45849,4,5849,[187 471  15  89 127],786,4,23631,4.039487179487179,0.0,20.0
45850,4,5850,[318  79 427 588 216],796,5,23636,4.039651341651,40.0,0.0
45851,4,5851,[318  79 427 588 216],450,5,23641,4.039815447710184,40.0,0.0
45852,4,5852,[216   7 132 508 187],269,3,23644,4.039637792584999,0.0,0.0
45853,4,5853,[385 405   4 176 153],280,2,23646,4.03928937478647,0.0,0.0
45854,4,5854,[200 215 483 228 301],450,3,23649,4.039111870196414,0.0,0.0
45855,4,5855,[318  79 427 588 216],577,5,23654,4.039275956284153,40.0,0.0
45856,4,5856,[318  79 427 588 216],716,5,23659,4.03943998634113,40.0,0.0
45857,4,5857,[187 183 121 655 175],716,2,23661,4.0390918402185045,0.0,0.0
45858,4,5858,[151 546 313 597  69],450,5,23666,4.0392558457074585,0.0,0.0
45859,4,5859,[318  79 427 588 216],450,5,23671,4.039419795221843,40.0,0.0
45860,4,5860,[318  79 427 588 216],18,5,23676,4.039583688790309,40.0,0.0
45861,4,5861,[117 176 435  22 301],450,5,23681,4.039747526441488,0.0,0.0
45862,4,5862,[121 204 742 234  82],655,0,23681,4.039058502473137,0.0,0.0
45863,4,5863,[176 405  98 194 282],292,4,23685,4.039051841746248,0.0,0.0
45864,4,5864,[318  79 427 588 216],716,5,23690,4.03921568627451,40.0,0.0
45865,4,5865,[318  79 427 588 216],577,5,23695,4.0393794749403344,40.0,0.0
45866,4,5866,[655 211 195 186 172],796,2,23697,4.039031873189024,0.0,0.0
45867,4,5867,[161  12 405 174 176],796,5,23702,4.039195637355147,0.0,0.0
45868,4,5868,[182 282  89 268 258],655,2,23704,4.0388481853808145,0.0,0.0
45869,4,5869,[318  79 427 588 216],716,5,23709,4.0390119250425895,40.0,0.0
45870,4,5870,[ 70 568 286  11 200],450,4,23713,4.039005280190768,0.0,20.0
45871,4,5871,[318  79 427 588 216],796,5,23718,4.0391689373297,40.0,0.0
45872,4,5872,[  4 742 185 265 181],796,4,23722,4.039162268006129,0.0,0.0
45873,4,5873,[318  79 427 588 216],796,5,23727,4.03932584269663,40.0,0.0
45874,4,5874,[196 237  22 186 215],450,4,23731,4.03931914893617,0.0,0.0
45875,4,5875,[195 121 174 211  97],151,4,23735,4.03931245745405,0.0,0.0
45876,4,5876,[318  79 427 588 216],796,5,23740,4.039475923090012,40.0,0.0
45877,4,5877,[318  79 427 588 216],18,5,23745,4.039639333106499,40.0,0.0
45878,4,5878,[318  79 427 588 216],450,5,23750,4.0398026875318935,40.0,0.0
45879,4,5879,[318  79 427 588 216],18,5,23755,4.039965986394558,40.0,0.0
45880,4,5880,[127 175 144 742 273],655,2,23757,4.039619112395851,0.0,20.0
45881,4,5881,[318  79 427 588 216],18,5,23762,4.039782386943217,40.0,0.0
45882,4,5882,[318  79 427 588 216],18,5,23767,4.039945605983342,40.0,0.0
45883,4,5883,[187  95 313 273 282],796,4,23771,4.039938817131203,0.0,0.0
45884,4,5884,[318  79 427 588 216],450,5,23776,4.0401019541206455,40.0,0.0
45885,4,5885,[ 25 294 318 265 135],655,2,23778,4.039755351681957,20.0,0.0
45886,4,5886,[151 181  69   1 265],716,5,23783,4.039918464413113,0.0,0.0
45887,4,5887,[318  79 427 588 216],716,5,23788,4.040081521739131,40.0,0.0
45888,4,5888,[318  79 427 588 216],450,5,23793,4.040244523688233,40.0,0.0
45889,4,5889,[194 210  22 286 423],450,4,23797,4.040237691001698,0.0,20.0
45890,4,5890,[301  70 211 483  82],151,4,23801,4.040230860634867,0.0,0.0
45891,4,5891,[318  79 427 588 216],450,5,23806,4.040393754243041,40.0,0.0
45892,4,5892,[318  79 427 588 216],577,5,23811,4.0405565925674525,40.0,0.0
45893,4,5893,[318  79 427 588 216],796,5,23816,4.0407193756362405,40.0,0.0
45894,4,5894,[318  79 427 588 216],450,5,23821,4.040882103477523,40.0,0.0
45895,4,5895,[132 183 161 194 186],457,5,23826,4.041044776119403,0.0,0.0
45896,4,5896,[318  79 427 588 216],796,5,23831,4.041207393589961,40.0,0.0
45897,4,5897,[ 12   4 216 191 588],344,5,23836,4.0413699559172604,0.0,0.0
45898,4,5898,[268  79   8   7 132],535,3,23839,4.041193422614002,0.0,0.0
45899,4,5899,[173 357 135 234 238],151,5,23844,4.041355932203389,0.0,0.0
45900,4,5900,[265 588  95 125  28],577,5,23849,4.041518386714117,0.0,0.0
45901,4,5901,[318 427  79 588 216],450,5,23854,4.041680786174179,40.0,0.0
45902,4,5902,[318 427  79 588 216],577,5,23859,4.041843130611554,40.0,0.0
45903,4,5903,[196  70 222 185  25],457,5,23864,4.042005420054201,0.0,0.0
45904,4,5904,[143 135 294 228 427],450,4,23868,4.041998306519899,20.0,0.0
45905,4,5905,[318 427  79 588 216],450,5,23873,4.042160514730782,40.0,0.0
45906,4,5906,[100 313 216 183 275],593,4,23877,4.0421533773489084,0.0,40.0
45907,4,5907,[271  82 172 111 173],796,4,23881,4.042146242383209,0.0,0.0
45908,4,5908,[318 427  79 588 216],577,5,23886,4.04230834320528,40.0,0.0
45909,4,5909,[318 427  79 588 216],18,5,23891,4.042470389170897,40.0,0.0
45910,4,5910,[318 427  79 588 216],796,5,23896,4.042632380307901,40.0,0.0
45911,4,5911,[187 273 204 215 168],436,4,23900,4.042625169147497,0.0,0.0
45912,4,5912,[318 427  79 588 216],18,5,23905,4.04278707931676,40.0,0.0
45913,4,5913,[125 568 200 127 153],655,2,23907,4.0424416638484955,0.0,20.0
45914,4,5914,[275 286  88 238 234],786,4,23911,4.042434488588334,0.0,40.0
45915,4,5915,[318 427  79 588 216],716,5,23916,4.0425963488843815,40.0,0.0
45916,4,5916,[318 427  79 588 216],450,5,23921,4.042758154470171,40.0,0.0
45917,4,5917,[127 117  56  22 202],280,4,23925,4.0427509293680295,0.0,20.0
45918,4,5918,[195 182 111 475 202],655,1,23926,4.042236864335192,0.0,0.0
45919,4,5919,[121 268 357 286 515],296,5,23931,4.042398648648649,0.0,20.0
45920,4,5920,[405  64 194 132  98],292,4,23935,4.042391487924337,20.0,0.0
45921,4,5921,[318 427  79 588 216],796,5,23940,4.042553191489362,40.0,0.0
45922,4,5922,[318 427  79 588 216],18,5,23945,4.042714840452473,40.0,0.0
45923,4,5923,[318 427  79 588 216],450,5,23950,4.0428764348413235,40.0,0.0
45924,4,5924,[ 64 258 301 603 168],535,5,23955,4.0430379746835445,40.0,0.0
45925,4,5925,[318 427  79 588 216],18,5,23960,4.04319946000675,40.0,0.0
45926,4,5926,[318 427  79 588 216],18,5,23965,4.043360890838535,40.0,0.0
45927,4,5927,[318 427  79 588 216],450,5,23970,4.043522267206478,40.0,0.0
45928,4,5928,[222 180  88 318   8],796,4,23974,4.04351492663181,20.0,0.0
45929,4,5929,[318 427  79 588 216],450,5,23979,4.0436762225969645,40.0,0.0
45930,4,5930,[318 427  79 588 216],796,5,23984,4.043837464171303,40.0,0.0
45931,4,5931,[318 427  79 588 216],716,5,23989,4.043998651382333,40.0,0.0
45932,4,5932,[318 427  79 588 216],18,5,23994,4.044159784257543,40.0,0.0
45933,4,5933,[318 427  79 588 216],577,5,23999,4.044320862824402,40.0,0.0
45934,4,5934,[183 100 144 234 313],593,4,24003,4.044313395113732,0.0,20.0
45935,4,5935,[175 483 271 222 405],655,1,24004,4.043800539083558,0.0,0.0
45936,4,5936,[318 427  79 588 216],716,5,24009,4.043961596766043,40.0,0.0
45937,4,5937,[ 97 546 135 100 185],151,3,24012,4.043785786460088,0.0,20.0
45938,4,5938,[302 174   9 191 301],655,2,24014,4.043441656844586,0.0,0.0
45939,4,5939,[318 427  79 588 216],450,5,24019,4.043602693602693,40.0,0.0
45940,4,5940,[318 427  79 588 216],18,5,24024,4.043763676148797,40.0,0.0
45941,4,5941,[318 427  79 588 216],577,5,24029,4.0439246045102655,40.0,0.0
45942,4,5942,[276 153  15  50 234],18,4,24033,4.043917213528521,0.0,20.0
45943,4,5943,[318 427  79 588 216],577,5,24038,4.044078061911171,40.0,0.0
45944,4,5944,[318 427  79 588 216],18,5,24043,4.044238856181665,40.0,0.0
45945,4,5945,[318 427  79 588 216],450,5,24048,4.044399596367306,40.0,0.0
45946,4,5946,[265 215 161 186 423],450,4,24052,4.044392130485959,0.0,0.0
45947,4,5947,[318 427  79 588 216],450,5,24057,4.044552790854069,40.0,0.0
45948,4,5948,[ 15 276 237 204 161],457,5,24062,4.044713397209615,0.0,0.0
45949,4,5949,[318 427  79 588 216],450,5,24067,4.044873949579832,40.0,0.0
45950,4,5950,[228 180 215  25 275],457,5,24072,4.0450344479919345,0.0,20.0
45951,4,5951,[318 427  79 588 216],450,5,24077,4.045194892473118,40.0,0.0
45952,4,5952,[216 211 194 222  70],5,4,24081,4.0451873005207455,0.0,0.0
45953,4,5953,[318 427  79 588 216],716,5,24086,4.045347665435002,40.0,0.0
45954,4,5954,[  7 568 403 127 322],256,5,24091,4.045507976490344,0.0,20.0
45955,4,5955,[318 427  79 588 216],450,5,24096,4.045668233713902,40.0,0.0
45956,4,5956,[318 427  79 588 216],716,5,24101,4.045828437132785,40.0,0.0
45957,4,5957,[597 276 196 204   9],174,4,24105,4.045820745216516,0.0,0.0
45958,4,5958,[318 427  79 588 216],577,5,24110,4.045980869273368,40.0,0.0
45959,4,5959,[186 179 403 182 237],18,3,24113,4.045805369127517,0.0,0.0
45960,4,5960,[318 427  79 588 216],577,5,24118,4.045965442039926,40.0,0.0
45961,4,5961,[144  56 588 173 568],796,5,24123,4.046125461254612,0.0,0.0
45962,4,5962,[185 237 172 204 153],503,3,24126,4.045950025155124,0.0,0.0
45963,4,5963,[ 28 234 300 127 144],693,2,24128,4.04560697518444,0.0,20.0
45964,4,5964,[318 427  79 588 216],577,5,24133,4.045766974015088,40.0,0.0
45965,4,5965,[318 427  79 588 216],577,5,24138,4.04592691920885,40.0,0.0
45966,4,5966,[318 427  79 588 216],18,5,24143,4.046086810792693,40.0,0.0
45967,4,5967,[ 64 182 200 403 286],18,3,24146,4.045911528150134,20.0,20.0
45968,4,5968,[318 210 132 357 202],151,5,24151,4.046071368738482,20.0,0.0
45969,4,5969,[318 427  79 588 216],796,5,24156,4.046231155778894,40.0,0.0
45970,4,5970,[318 427  79 588 216],18,5,24161,4.046390889298275,40.0,0.0
45971,4,5971,[ 95   4  82 194 228],577,4,24165,4.046383121232418,0.0,0.0
45972,4,5972,[318 427  79 588 216],577,5,24170,4.046542775824544,40.0,0.0
45973,4,5973,[405 135 471 403 288],450,3,24173,4.046367592902578,0.0,0.0
45974,4,5974,[216 245 168 118 195],796,4,24177,4.046359832635983,0.0,0.0
45975,4,5975,[318 427  79 588 216],18,5,24182,4.046519410977242,40.0,0.0
45976,4,5976,[ 22 269  25   7 111],344,4,24186,4.046511627906977,0.0,0.0
45977,4,5977,[318 427  79 588 216],796,5,24191,4.046671127467381,40.0,0.0
45978,4,5978,[ 22 385 187 258 210],655,1,24192,4.046161565479177,0.0,0.0
45979,4,5979,[202 181   1  95 318],18,3,24195,4.0459866220735785,20.0,0.0
45980,4,5980,[210 196 174 176 258],504,4,24199,4.0459789332887475,0.0,0.0
45981,4,5981,[  4  89 405 568 288],655,1,24200,4.045469742561016,0.0,0.0
45982,4,5982,[483 235  98 172 194],269,3,24203,4.045295002507103,0.0,0.0
45983,4,5983,[318 427  79 588 216],796,5,24208,4.045454545454546,40.0,0.0
45984,4,5984,[318 427  79 588 216],18,5,24213,4.045614035087719,40.0,0.0
45985,4,5985,[318 427  79 588 216],796,5,24218,4.045773471433344,40.0,0.0
45986,4,5986,[200 245   8 153 173],796,4,24222,4.045765825956239,0.0,0.0
45987,4,5987,[318 427  79 588 216],450,5,24227,4.045925183700735,40.0,0.0
45988,4,5988,[427  79  71 153 195],18,4,24231,4.045917515444983,20.0,0.0
45989,4,5989,[318 427  79 588 216],716,5,24236,4.046076794657763,40.0,0.0
45990,4,5990,[191 286 222 179 180],296,5,24241,4.046236020697713,0.0,20.0
45991,4,5991,[185 196 237  56 318],535,4,24245,4.046228304405875,20.0,0.0
45992,4,5992,[318 427  79 588 216],450,5,24250,4.046387452027365,40.0,0.0
45993,4,5993,[ 70 204 496  22 182],450,5,24255,4.046546546546547,20.0,0.0
45994,4,5994,[318 427  79 588 216],577,5,24260,4.046705587989992,40.0,0.0
45995,4,5995,[  8 300 515 405   7],655,1,24261,4.046197464976651,0.0,0.0
45996,4,5996,[174  79 271 357 172],796,5,24266,4.046356511589128,0.0,0.0
45997,4,5997,[318 427  79 588 216],18,5,24271,4.046515505168389,40.0,0.0
45998,4,5998,[265   9 100 181 179],535,4,24275,4.046507751291882,0.0,20.0
45999,4,5999,[179  70 322 301 151],450,5,24280,4.046666666666667,0.0,0.0
46000,4,6000,[179 655 191 210   9],269,4,24284,4.046658890184969,0.0,0.0
46001,4,6001,[318 427  79 588 216],796,5,24289,4.046817727424192,40.0,0.0
46002,4,6002,[328 228 496 161 143],450,5,24294,4.046976511744128,20.0,0.0
46003,4,6003,[318 427  79 588 216],716,5,24299,4.047135243171219,40.0,0.0
46004,4,6004,[  1 603  96 187   4],796,4,24303,4.047127393838468,20.0,0.0
46005,4,6005,[ 97 235 127 276 222],256,3,24306,4.046953046953047,0.0,20.0
46006,4,6006,[ 64 132  82 271 172],655,2,24308,4.046612285666722,20.0,0.0
46007,4,6007,[471  88 196 597   1],450,5,24313,4.046770972037284,0.0,0.0
46008,4,6008,[318 427  79 588 216],716,5,24318,4.046929605591613,40.0,0.0
46009,4,6009,[196 194 118 180  25],457,5,24323,4.047088186356073,0.0,0.0
46010,4,6010,[100  98 235 143  12],457,4,24327,4.047080352686741,0.0,20.0
46011,4,6011,[318 427  79 588 216],796,5,24332,4.047238855622089,40.0,0.0
46012,4,6012,[200 132 215 117 121],330,5,24337,4.047397305837352,0.0,0.0
46013,4,6013,[328  22 265 234 196],450,4,24341,4.047389424675757,0.0,0.0
46014,4,6014,[318 427  79 588 216],450,5,24346,4.047547797173732,40.0,0.0
46015,4,6015,[ 50 168  69 237 125],457,5,24351,4.047706117021277,0.0,20.0
46016,4,6016,[175 210 333  56 183],655,1,24352,4.047199601130131,0.0,0.0
46017,4,6017,[568 427 216 117 196],693,4,24356,4.047191758059156,20.0,0.0
46018,4,6018,[ 89 153 191 186 427],911,4,24360,4.0471839175942845,20.0,0.0
46019,4,6019,[318  79 427 588 216],18,5,24365,4.04734219269103,40.0,0.0
46020,4,6020,[318  79 427 588 216],18,5,24370,4.0475004152134195,40.0,0.0
46021,4,6021,[  7  50 471 742 195],457,5,24375,4.047658585187645,0.0,20.0
46022,4,6022,[318  79 427 588 216],716,5,24380,4.047816702639881,40.0,0.0
46023,4,6023,[318 655  89  15 216],796,4,24384,4.047808764940239,20.0,0.0
46024,4,6024,[276 546 258 143 176],504,3,24387,4.047634854771784,0.0,0.0
46025,4,6025,[318  79 427 588 216],796,5,24392,4.047792897444408,40.0,0.0
46026,4,6026,[183 237 282 181  96],655,1,24393,4.047287207565954,0.0,0.0
46027,4,6027,[318  79 427 588 216],450,5,24398,4.047445255474453,40.0,0.0
46028,4,6028,[183 175 257 515 127],655,3,24401,4.047271520981921,0.0,20.0
46029,4,6029,[194 403 111 323 257],798,4,24405,4.04726368159204,0.0,0.0
46030,4,6030,[318  79 427 588 216],577,5,24410,4.047421654783618,40.0,0.0
46031,4,6031,[318  79 427 588 216],18,5,24415,4.047579575596817,40.0,0.0
46032,4,6032,[118 294  22  56 235],457,3,24418,4.047405934029505,0.0,0.0
46033,4,6033,[655 210 258 301 191],629,3,24421,4.047232350016572,0.0,0.0
46034,4,6034,[318  79 427 588 216],450,5,24426,4.047390223695112,40.0,0.0
46035,4,6035,[318  79 427 588 216],450,5,24431,4.047548045062956,40.0,0.0
46036,4,6036,[318  79 427 588 216],450,5,24436,4.047705814146099,40.0,0.0
46037,4,6037,[144 655 508  15 118],655,0,24436,4.0470354421994035,0.0,0.0
46038,4,6038,[257 186 222 403 135],5,4,24440,4.0470276535850305,0.0,0.0
46039,4,6039,[180  56  98 173 508],280,3,24443,4.046854304635762,0.0,0.0
46040,4,6040,[655 238  89 132 191],450,5,24448,4.047012084092038,0.0,0.0
46041,4,6041,[ 88  96   9 196 496],269,2,24450,4.046673286991062,20.0,0.0
46042,4,6042,[153 194  97  64 210],401,3,24453,4.04650008274036,20.0,0.0
46043,4,6043,[318  79 427 588 216],577,5,24458,4.046657842488418,40.0,0.0
46044,4,6044,[318  79 427 588 216],577,5,24463,4.046815550041356,40.0,0.0
46045,4,6045,[ 88 121 204  82 275],796,4,24467,4.046807806814423,0.0,20.0
46046,4,6046,[ 88  50 191 222 275],23,3,24470,4.046634694890028,0.0,40.0
46047,4,6047,[111 202 435 210  79],655,1,24471,4.0461309523809526,0.0,0.0
46048,4,6048,[268 191 258  56 405],11,4,24475,4.046123326169615,0.0,0.0
46049,4,6049,[210 143 483 508 135],401,3,24478,4.0459504132231405,0.0,0.0
46050,4,6050,[153  88 191 185  11],401,3,24481,4.045777557428524,0.0,0.0
46051,4,6051,[118 235 191 151 127],450,3,24484,4.0456047587574355,0.0,20.0
46052,4,6052,[294 597 269 143 405],450,5,24489,4.0457624318519745,0.0,0.0
46053,4,6053,[318  79 427 588 216],450,5,24494,4.045920052857615,40.0,0.0
46054,4,6054,[197 318 282  96 568],796,4,24498,4.045912469033857,20.0,0.0
46055,4,6055,[  1 385 194 302 405],151,2,24500,4.04557463672391,0.0,0.0
46056,4,6056,[222  98 194  71 168],450,3,24503,4.045402014198448,0.0,0.0
46057,4,6057,[195  50 125 302 173],344,4,24507,4.045394519643446,0.0,20.0
46058,4,6058,[318  79 427 588 216],450,5,24512,4.045552071298895,40.0,0.0
46059,4,6059,[318  79 427 588 216],796,5,24517,4.045709570957095,40.0,0.0
46060,4,6060,[ 71  69 357 210 742],796,3,24520,4.045537040092394,0.0,0.0
46061,4,6061,[265 191  79 258 143],151,4,24524,4.045529528208512,0.0,0.0
46062,4,6062,[318  79 427 588 216],716,5,24529,4.045686953653307,40.0,0.0
46063,4,6063,[318  79 427 588 216],450,5,24534,4.045844327176781,40.0,0.0
46064,4,6064,[597 180 234 271 300],796,3,24537,4.045671887881286,0.0,0.0
46065,4,6065,[318  79 427 588 216],577,5,24542,4.045829212001319,40.0,0.0
46066,4,6066,[318  79 427 588 216],450,5,24547,4.045986484259107,40.0,0.0
46067,4,6067,[ 64 302 300 328  56],151,3,24550,4.045814106789717,20.0,0.0
46068,4,6068,[173 191 300  98  50],151,4,24554,4.045806557917285,0.0,20.0
46069,4,6069,[318  79 427 588 216],716,5,24559,4.045963756177924,40.0,0.0
46070,4,6070,[288 405 435 568 235],450,3,24562,4.045791467633009,0.0,0.0
46071,4,6071,[181 125  25 405 300],151,4,24566,4.045783926218709,0.0,0.0
46072,4,6072,[318  79 427 588 216],796,5,24571,4.045941050551622,40.0,0.0
46073,4,6073,[318  79 427 588 216],450,5,24576,4.046098123147844,40.0,0.0
46074,4,6074,[318  79 427 588 216],450,5,24581,4.046255144032922,40.0,0.0
46075,4,6075,[318  79 427 588 216],18,5,24586,4.04641211323239,40.0,0.0
46076,4,6076,[318  79 427 588 216],796,5,24591,4.046569030771763,40.0,0.0
46077,4,6077,[228 216 191  82  64],151,3,24594,4.04639684106614,20.0,0.0
46078,4,6078,[403 180  12 100 144],280,2,24596,4.046060207270933,0.0,20.0
46079,4,6079,[269 286 483  12 603],796,3,24599,4.045888157894737,20.0,20.0
46080,4,6080,[318  79 427 588 216],716,5,24604,4.0460450583785565,40.0,0.0
46081,4,6081,[117 245 197 179 234],450,4,24608,4.04603748766853,0.0,0.0
46082,4,6082,[132  98 118 508  82],655,1,24609,4.045536741739274,0.0,0.0
46083,4,6083,[258 153 328 302   1],151,2,24611,4.045200525969757,0.0,0.0
46084,4,6084,[318  79 427 588 216],577,5,24616,4.045357436318817,40.0,0.0
46085,4,6085,[496 603 168 144 273],796,4,24620,4.045349983568847,40.0,0.0
46086,4,6086,[ 28 427  88 234  64],796,3,24623,4.045178248726795,40.0,0.0
46087,4,6087,[328 275 333 300  56],796,5,24628,4.045335085413929,0.0,20.0
46088,4,6088,[  7  64  79 216  98],719,4,24632,4.045327640006569,20.0,0.0
46089,4,6089,[318  79 427 588 216],450,5,24637,4.0454844006568145,40.0,0.0
46090,4,6090,[318  79 427 588 216],796,5,24642,4.045641109834182,40.0,0.0
46091,4,6091,[318  79 427 588 216],577,5,24647,4.045797767564018,40.0,0.0
46092,4,6092,[ 79 423 405  64   8],796,5,24652,4.045954373871656,20.0,0.0
46093,4,6093,[186 180 405 161 228],796,3,24655,4.045782737118477,0.0,0.0
46094,4,6094,[588 237   1 125  22],457,5,24660,4.045939294503691,0.0,0.0
46095,4,6095,[483 183 187  70 228],655,3,24663,4.045767716535433,0.0,0.0
46096,4,6096,[318  79 427 588 216],450,5,24668,4.045924225028703,40.0,0.0
46097,4,6097,[318  79 427 588 216],716,5,24673,4.046080682190882,40.0,0.0
46098,4,6098,[318  79 427 588 216],716,5,24678,4.046237088047221,40.0,0.0
46099,4,6099,[318  79 427 588 216],18,5,24683,4.046393442622951,40.0,0.0
46100,4,6100,[301  11  89 180  71],450,4,24687,4.04638583838715,0.0,0.0
46101,4,6101,[318  79 427 588 216],716,5,24692,4.046542117338578,40.0,0.0
46102,4,6102,[ 56 100  25 385 678],504,4,24696,4.046534491233819,0.0,20.0
46103,4,6103,[318  79 427 588 216],796,5,24701,4.0466906946264745,40.0,0.0
46104,4,6104,[318  79 427 588 216],716,5,24706,4.046846846846847,40.0,0.0
46105,4,6105,[318  79 427 588 216],18,5,24711,4.047002947920078,40.0,0.0
46106,4,6106,[318  79 427 588 216],18,5,24716,4.047158997871295,40.0,0.0
46107,4,6107,[318  79 427 588 216],577,5,24721,4.047314996725606,40.0,0.0
46108,4,6108,[318  79 427 588 216],796,5,24726,4.0474709445081025,40.0,0.0
46109,4,6109,[258 118 302 222 153],151,2,24728,4.0471358428805235,0.0,0.0
46110,4,6110,[121 228 288 153 144],655,0,24728,4.046473572246768,0.0,0.0
46111,4,6111,[275 143 603 153 286],389,2,24730,4.046138743455497,20.0,40.0
46112,4,6112,[  7 195 183 313 172],344,4,24734,4.046131195812204,0.0,0.0
46113,4,6113,[195 235  98   1 405],256,4,24738,4.04612365063788,0.0,0.0
46114,4,6114,[132 222  64 211 568],716,5,24743,4.046279640228946,20.0,0.0
46115,4,6115,[318  79 427 588 216],577,5,24748,4.04643557880968,40.0,0.0
46116,4,6116,[318  79 427 588 216],18,5,24753,4.046591466405101,40.0,0.0
46117,4,6117,[185 294 117 603 222],716,5,24758,4.046747303040209,20.0,0.0
46118,4,6118,[185 228 294  22 143],796,4,24762,4.046739663343684,0.0,0.0
46119,4,6119,[172 181 385 215 100],344,2,24764,4.04640522875817,0.0,20.0
46120,4,6120,[187 191 471 496 357],450,5,24769,4.046561019441268,20.0,0.0
46121,4,6121,[ 15 603  22 294 186],655,1,24770,4.046063377981052,20.0,0.0
46122,4,6122,[318  79 427 588 216],716,5,24775,4.046219173607708,40.0,0.0
46123,4,6123,[125 258 318 144 182],457,5,24780,4.046374918354017,20.0,0.0
46124,4,6124,[318  79 427 588 216],577,5,24785,4.046530612244898,40.0,0.0
46125,4,6125,[210 127 182 121  50],796,4,24789,4.046523016650343,0.0,40.0
46126,4,6126,[318  79 427 588 216],18,5,24794,4.046678635547576,40.0,0.0
46127,4,6127,[588 143 333 328 228],796,5,24799,4.046834203655353,0.0,0.0
46128,4,6128,[275 100  97   9  98],878,3,24802,4.046663403491597,0.0,40.0
46129,4,6129,[318  79 427 588 216],450,5,24807,4.046818923327896,40.0,0.0
46130,4,6130,[204 168 151 194 117],504,3,24810,4.046648181373349,0.0,0.0
46131,4,6131,[211 234 143 405 200],593,3,24813,4.046477495107632,0.0,0.0
46132,4,6132,[318  79 427 588 216],450,5,24818,4.046632969183108,40.0,0.0
46133,4,6133,[597 235   7  22 496],269,1,24819,4.046136289533746,20.0,0.0
46134,4,6134,[ 79 300 197 111  82],151,4,24823,4.046128769356153,0.0,0.0
46135,4,6135,[135 237  22 357 286],655,2,24825,4.045795306388527,0.0,20.0
46136,4,6136,[144 202 403 322 269],450,5,24830,4.045950790288415,0.0,0.0
46137,4,6137,[176 191 194 475  69],389,5,24835,4.0461062235255785,0.0,0.0
46138,4,6138,[ 88 228  22 185 423],11,3,24838,4.045935820166151,0.0,0.0
46139,4,6139,[318  79 427 588 216],18,5,24843,4.046091205211726,40.0,0.0
46140,4,6140,[328  96 185 117 302],655,2,24845,4.045758019866471,0.0,0.0
46141,4,6141,[182  12 427  50  89],18,4,24849,4.045750569846955,20.0,20.0
46142,4,6142,[318  79 427 588 216],577,5,24854,4.045905909164903,40.0,0.0
46143,4,6143,[496 187  22 111  71],18,4,24858,4.0458984375,20.0,0.0
46144,4,6144,[318  79 427 588 216],450,5,24863,4.046053702196908,40.0,0.0
46145,4,6145,[318  79 427 588 216],18,5,24868,4.04620891636837,40.0,0.0
46146,4,6146,[318  79 427 588 216],796,5,24873,4.0463640800390435,40.0,0.0
46147,4,6147,[ 69 265  70 405 135],716,4,24877,4.046356538711776,0.0,0.0
46148,4,6148,[127 211 588 100 515],401,3,24880,4.046186371767767,0.0,40.0
46149,4,6149,[ 11 153 181 210 185],450,4,24884,4.046178861788618,0.0,0.0
46150,4,6150,[318  79 427 588 216],18,5,24889,4.046333929442367,40.0,0.0
46151,4,6151,[318  79 427 588 216],796,5,24894,4.046488946684005,40.0,0.0
46152,4,6152,[117   4 127  79  97],457,5,24899,4.046643913538111,0.0,20.0
46153,4,6153,[318  79 427 588 216],796,5,24904,4.04679883002925,40.0,0.0
46154,4,6154,[125 568 191 127 271],796,5,24909,4.046953696181966,0.0,20.0
46155,4,6155,[423 216 300   7   4],655,1,24910,4.046458739441196,0.0,0.0
46156,4,6156,[318 265 313 182 144],655,3,24913,4.046288777001787,20.0,0.0
46157,4,6157,[483 257 210 176 127],655,2,24915,4.045956479376421,0.0,20.0
46158,4,6158,[186  79 423 603 313],655,3,24918,4.045786653677545,20.0,0.0
46159,4,6159,[ 12 300 173 135 313],450,4,24922,4.045779220779221,0.0,0.0
46160,4,6160,[118 435 121 135 318],655,2,24924,4.045447167667587,20.0,0.0
46161,4,6161,[318  79 427 588 216],716,5,24929,4.045602077247647,40.0,0.0
46162,4,6162,[318  79 427 588 216],450,5,24934,4.045756936556872,40.0,0.0
46163,4,6163,[318  79 427 588 216],796,5,24939,4.045911745619727,40.0,0.0
46164,4,6164,[318  79 427 588 216],716,5,24944,4.046066504460665,40.0,0.0
46165,4,6165,[318  79 427 588 216],796,5,24949,4.046221213104119,40.0,0.0
46166,4,6166,[318  79 427 588 216],716,5,24954,4.04637587157451,40.0,0.0
46167,4,6167,[313  22 144 427 186],655,2,24956,4.046044098573281,20.0,0.0
46168,4,6168,[318  79 427 588 216],18,5,24961,4.046198735613552,40.0,0.0
46169,4,6169,[204  15 161 568 143],796,5,24966,4.046353322528363,0.0,0.0
46170,4,6170,[ 50 238 496 405 215],716,5,24971,4.046507859342084,20.0,20.0
46171,4,6171,[318  79 427 588 216],450,5,24976,4.046662346079067,40.0,0.0
46172,4,6172,[318  79 427 588 216],716,5,24981,4.046816782763648,40.0,0.0
46173,4,6173,[235 427 742 655 204],450,4,24985,4.046809199870425,20.0,0.0
46174,4,6174,[318  79 427 588 216],577,5,24990,4.046963562753036,40.0,0.0
46175,4,6175,[151  82  50 153 238],18,3,24993,4.046794041450777,0.0,20.0
46176,4,6176,[318  79 427 588 216],577,5,24998,4.046948356807512,40.0,0.0
46177,4,6177,[318  79 427 588 216],18,5,25003,4.047102622207834,40.0,0.0
46178,4,6178,[318  79 427 588 216],716,5,25008,4.047256837676,40.0,0.0
46179,4,6179,[318  79 427 588 216],577,5,25013,4.047411003236246,40.0,0.0
46180,4,6180,[ 15  56  22 185 125],457,5,25018,4.0475651189127975,0.0,0.0
46181,4,6181,[ 50 172  95 185 197],18,3,25021,4.047395664833387,0.0,20.0
46182,4,6182,[427  96 265 271 197],72,4,25025,4.047387999353065,20.0,0.0
46183,4,6183,[318  79 427 588 216],716,5,25030,4.0475420439844765,40.0,0.0
46184,4,6184,[268  22 197 258 161],655,0,25030,4.046887631366209,0.0,0.0
46185,4,6185,[318  79 427 588 216],796,5,25035,4.0470417070805045,40.0,0.0
46186,4,6186,[318  79 427 588 216],796,5,25040,4.047195732988524,40.0,0.0
46187,4,6187,[180 118 322 144 318],796,3,25043,4.047026502908856,20.0,0.0
46188,4,6188,[ 28 603 568 269 179],450,5,25048,4.047180481499434,20.0,0.0
46189,4,6189,[318  79 427 588 216],450,5,25053,4.047334410339257,40.0,0.0
46190,4,6190,[ 11 357 237 186 168],269,2,25055,4.047003715070264,0.0,0.0
46191,4,6191,[318  79 427 588 216],796,5,25060,4.047157622739018,40.0,0.0
46192,4,6192,[318  79 427 588 216],450,5,25065,4.04731148070402,40.0,0.0
46193,4,6193,[ 69 197 294  79 191],716,5,25070,4.047465288989344,0.0,0.0
46194,4,6194,[318  79 427 588 216],796,5,25075,4.0476190476190474,40.0,0.0
46195,4,6195,[  1 222 151 117 245],756,3,25078,4.047449967721111,0.0,0.0
46196,4,6196,[127 234 132 210 194],269,3,25081,4.04728094239148,0.0,20.0
46197,4,6197,[483  71   8 275 300],535,4,25085,4.047273313972249,0.0,20.0
46198,4,6198,[194 185 191  71 678],401,3,25088,4.047104371672851,0.0,0.0
46199,4,6199,[385   1 282 117  79],655,1,25089,4.046612903225807,0.0,0.0
46200,4,6200,[187 173 222  12 196],450,4,25093,4.046605386228028,0.0,0.0
46201,4,6201,[318  79 427 588 216],716,5,25098,4.046759109964528,40.0,0.0
46202,4,6202,[210 258 273  64 173],629,4,25102,4.046751571820087,20.0,0.0
46203,4,6203,[318  79 427 588 216],450,5,25107,4.046905222437137,40.0,0.0
46204,4,6204,[125 144 222 423 186],450,3,25110,4.046736502820306,0.0,0.0
46205,4,6205,[ 56 200 228  28 286],151,4,25114,4.046728971962617,0.0,20.0
46206,4,6206,[318  79 427 588 216],18,5,25119,4.046882551957467,40.0,0.0
46207,4,6207,[405 742 245 403  95],450,4,25123,4.046875,0.0,0.0
46208,4,6208,[313 132  56 273 179],655,3,25126,4.046706393944274,0.0,0.0
46209,4,6209,[269 301 173 237 174],535,5,25131,4.046859903381643,0.0,0.0
46210,4,6210,[234  64 282 117 294],457,4,25135,4.046852358718403,20.0,0.0
46211,4,6211,[182 597 403  89 385],457,4,25139,4.046844816484224,0.0,0.0
46212,4,6212,[318  79 427 588 216],716,5,25144,4.046998229518751,40.0,0.0
46213,4,6213,[ 82 161 222 186 328],655,0,25144,4.04634695848085,0.0,0.0
46214,4,6214,[257 197 118  98 265],798,3,25147,4.046178600160901,0.0,0.0
46215,4,6215,[ 64 245 385  15 237],256,5,25152,4.046332046332046,20.0,0.0
46216,4,6216,[161  69 125 117  71],577,5,25157,4.046485443139778,0.0,0.0
46217,4,6217,[269 483   1 234 322],450,3,25160,4.046317143776133,0.0,0.0
46218,4,6218,[269 318  56 423 211],18,5,25165,4.0464704936484965,20.0,0.0
46219,4,6219,[318  79 427 588 216],577,5,25170,4.046623794212219,40.0,0.0
46220,4,6220,[318  79 427 588 216],716,5,25175,4.046777045491079,40.0,0.0
46221,4,6221,[318  79 427 588 216],450,5,25180,4.04693024750884,40.0,0.0
46222,4,6222,[196 182   9 228   4],655,1,25181,4.046440623493492,0.0,0.0
46223,4,6223,[288  15 161 173 111],457,4,25185,4.046433161953727,0.0,0.0
46224,4,6224,[125  71 100 288 546],450,3,25188,4.046265060240964,0.0,20.0
46225,4,6225,[318  79 427 588 216],18,5,25193,4.046418246064889,40.0,0.0
46226,4,6226,[318  79 427 588 216],796,5,25198,4.046571382688293,40.0,0.0
46227,4,6227,[318  79 427 588 216],18,5,25203,4.046724470134874,40.0,0.0
46228,4,6228,[ 56 161  50 546  96],457,4,25207,4.046716969015893,0.0,20.0
46229,4,6229,[318  79 427 588 216],450,5,25212,4.0468699839486355,40.0,0.0
46230,4,6230,[318  79 427 588 216],450,5,25217,4.0470229497672925,40.0,0.0
46231,4,6231,[302 179  56 313 196],655,3,25220,4.046854942233633,0.0,0.0
46232,4,6232,[318  79 427 588 216],577,5,25225,4.047007861382962,40.0,0.0
46233,4,6233,[151 176  98 121 204],20,0,25225,4.046358678216234,0.0,0.0
46234,4,6234,[271 300 403 427 742],655,1,25226,4.045870088211708,20.0,0.0
46235,4,6235,[318  79 427 588 216],18,5,25231,4.046023091725465,40.0,0.0
46236,4,6236,[144 483 423  96 117],693,3,25234,4.045855379188713,0.0,0.0
46237,4,6237,[318  79 427 588 216],450,5,25239,4.04600833600513,40.0,0.0
46238,4,6238,[111 135 127 216 144],716,3,25242,4.045840679596089,0.0,20.0
46239,4,6239,[ 82 568   8 427 603],269,2,25244,4.045512820512821,40.0,0.0
46240,4,6240,[ 56 357 238 200 313],450,4,25248,4.0455055279602625,0.0,0.0
46241,4,6241,[318  79 427 588 216],577,5,25253,4.0456584428067925,40.0,0.0
46242,4,6242,[318  79 427 588 216],796,5,25258,4.045811308665706,40.0,0.0
46243,4,6243,[318  79 427 588 216],796,5,25263,4.0459641255605385,40.0,0.0
46244,4,6244,[318  79 427 588 216],716,5,25268,4.046116893514812,40.0,0.0
46245,4,6245,[257 100 182 216   1],457,4,25272,4.046109510086455,0.0,20.0
46246,4,6246,[318  79 427 588 216],450,5,25277,4.046262205858812,40.0,0.0
46247,4,6247,[318  79 427 588 216],716,5,25282,4.046414852752881,40.0,0.0
46248,4,6248,[318  79 427 588 216],716,5,25287,4.046567450792127,40.0,0.0
46249,4,6249,[318  79 427 588 216],577,5,25292,4.04672,40.0,0.0
46250,4,6250,[318  79 427 588 216],577,5,25297,4.046872500399936,40.0,0.0
46251,4,6251,[235 183 357 265 185],716,3,25300,4.046705054382597,0.0,0.0
46252,4,6252,[215 603   4 483 357],655,3,25303,4.046537661922278,20.0,0.0
46253,4,6253,[143 186 179  88 151],18,3,25306,4.046370322993284,0.0,0.0
46254,4,6254,[318  79 427 588 216],796,5,25311,4.046522781774581,40.0,0.0
46255,4,6255,[318  79 427 588 216],450,5,25316,4.046675191815857,40.0,0.0
46256,4,6256,[748 655 483   9 132],796,3,25319,4.046507911139524,0.0,0.0
46257,4,6257,[318  79 427 588 216],796,5,25324,4.046660274848194,40.0,0.0
46258,4,6258,[471 742 135 121  12],655,1,25325,4.04617351014539,0.0,0.0
46259,4,6259,[ 88  69 121 496  70],344,1,25326,4.045686900958467,20.0,0.0
46260,4,6260,[222 323  22 183  70],280,2,25328,4.045360166107651,0.0,0.0
46261,4,6261,[228 118 196  97  88],655,0,25328,4.044714148834238,0.0,0.0
46262,4,6262,[ 28 313 144   1 257],796,3,25331,4.0445473415296185,0.0,0.0
46263,4,6263,[318  79 427 588 216],18,5,25336,4.044699872286079,40.0,0.0
46264,4,6264,[471  89 125  11   4],256,5,25341,4.044852354349561,0.0,0.0
46265,4,6265,[318  79 427 588 216],796,5,25346,4.045004787743377,40.0,0.0
46266,4,6266,[132 172 144 117 313],655,2,25348,4.044678474549226,0.0,0.0
46267,4,6267,[318  79 427 588 216],796,5,25353,4.044830887045309,40.0,0.0
46268,4,6268,[153   4 496 546 302],450,4,25357,4.044823735843037,20.0,0.0
46269,4,6269,[211 179 286  98 196],655,2,25359,4.044497607655503,0.0,20.0
46270,4,6270,[318  79 427 588 216],716,5,25364,4.04464997608037,40.0,0.0
46271,4,6271,[ 64 568 333 275 196],796,5,25369,4.044802295918367,20.0,20.0
46272,4,6272,[318  79 427 588 216],716,5,25374,4.044954567192731,40.0,0.0
46273,4,6273,[ 64 300 179 258  50],655,3,25377,4.04478801402614,20.0,20.0
46274,4,6274,[318  79 427 588 216],450,5,25382,4.044940239043824,40.0,0.0
46275,4,6275,[318  79 427 588 216],450,5,25387,4.045092415551307,40.0,0.0
46276,4,6276,[313 603  50 151 215],450,5,25392,4.04524454357177,20.0,20.0
46277,4,6277,[318  79 427 588 216],18,5,25397,4.045396623128385,40.0,0.0
46278,4,6278,[132 183  70 385  98],450,5,25402,4.045548654244306,0.0,0.0
46279,4,6279,[ 98  22 234 423  25],716,5,25407,4.045700636942676,0.0,0.0
46280,4,6280,[318  79 427 588 216],796,5,25412,4.045852571246617,40.0,0.0
46281,4,6281,[ 79   4  15 403 202],18,2,25414,4.045526902260427,0.0,0.0
46282,4,6282,[318  79 427 588 216],18,5,25419,4.0456788158523,40.0,0.0
46283,4,6283,[121 568 195   9 271],72,3,25422,4.04551241247613,0.0,0.0
46284,4,6284,[ 89  70 176 200 427],269,2,25424,4.045186953062848,20.0,0.0
46285,4,6285,[ 82 186   1  96  28],655,0,25424,4.044543429844098,0.0,0.0
46286,4,6286,[427 182 111 475 204],389,4,25428,4.044536344838556,20.0,0.0
46287,4,6287,[318  79 427 588 216],450,5,25433,4.044688295165394,40.0,0.0
46288,4,6288,[318  79 427 588 216],796,5,25438,4.044840197169662,40.0,0.0
46289,4,6289,[127 183  98   8 144],280,3,25441,4.0446740858505565,0.0,20.0
46290,4,6290,[143 196 318  70  89],450,5,25446,4.04482594182165,20.0,0.0
46291,4,6291,[228  79 197 172 176],655,2,25448,4.044500953591863,0.0,0.0
46292,4,6292,[318  79 427 588 216],18,5,25453,4.044652788812967,40.0,0.0
46293,4,6293,[318  79 427 588 216],450,5,25458,4.044804575786463,40.0,0.0
46294,4,6294,[318  79 427 588 216],450,5,25463,4.044956314535345,40.0,0.0
46295,4,6295,[318  79 427 588 216],796,5,25468,4.045108005082592,40.0,0.0
46296,4,6296,[ 69 405   1  88 200],151,3,25471,4.044942035890107,0.0,0.0
46297,4,6297,[318  79 427 588 216],18,5,25476,4.045093680533503,40.0,0.0
46298,4,6298,[234 405 238 173  56],450,4,25480,4.045086521670107,0.0,0.0
46299,4,6299,[318  79 427 588 216],18,5,25485,4.045238095238095,40.0,0.0
46300,4,6300,[318  79 427 588 216],716,5,25490,4.045389620695127,40.0,0.0
46301,4,6301,[258 180 508 179  50],535,5,25495,4.045541098064106,0.0,20.0
46302,4,6302,[151 127 318 143  15],450,4,25499,4.045533872759004,20.0,20.0
46303,4,6303,[357  69 385 174 748],450,5,25504,4.0456852791878175,0.0,0.0
46304,4,6304,[318  79 427 588 216],18,5,25509,4.045836637589215,40.0,0.0
46305,4,6305,[216  82 210 191 194],796,3,25512,4.045670789724072,0.0,0.0
46306,4,6306,[318  79 427 588 216],796,5,25517,4.045822102425876,40.0,0.0
46307,4,6307,[318  79 427 588 216],18,5,25522,4.045973367152822,40.0,0.0
46308,4,6308,[318  79 427 588 216],18,5,25527,4.046124583927722,40.0,0.0
46309,4,6309,[ 15  89  98 100 286],655,2,25529,4.0458003169572105,0.0,40.0
46310,4,6310,[318  79 427 588 216],796,5,25534,4.045951513230866,40.0,0.0
46311,4,6311,[403 269  11  25 185],450,4,25538,4.0459442332065905,0.0,0.0
46312,4,6312,[322 328 268 273 187],629,2,25540,4.045620148899097,0.0,0.0
46313,4,6313,[603 655 197 403 276],269,4,25544,4.045612923661704,20.0,0.0
46314,4,6314,[276 182 357  98 144],655,4,25548,4.045605700712589,0.0,0.0
46315,4,6315,[197 515 222 568 508],655,1,25549,4.0451234958834705,0.0,0.0
46316,4,6316,[258 185 655 194 275],450,5,25554,4.045274655690992,0.0,20.0
46317,4,6317,[181 301 286  82 185],151,4,25558,4.045267489711934,0.0,20.0
46318,4,6318,[603 125 111 172 265],450,5,25563,4.045418578889064,20.0,0.0
46319,4,6319,[181 245 385 174 143],504,4,25567,4.045411392405064,0.0,0.0
46320,4,6320,[127 143 204  95 357],786,5,25572,4.045562411010916,0.0,20.0
46321,4,6321,[202 182 235 475 187],269,3,25575,4.045397026257514,0.0,0.0
46322,4,6322,[318  79 427 588 216],450,5,25580,4.045547999367389,40.0,0.0
46323,4,6323,[191 276 603 200 215],18,2,25582,4.045224541429475,20.0,0.0
46324,4,6324,[423  69 216 174 405],269,1,25583,4.044743083003953,0.0,0.0
46325,4,6325,[318  79 427 588 216],716,5,25588,4.044894087891242,40.0,0.0
46326,4,6326,[318  79 427 588 216],577,5,25593,4.045045045045045,40.0,0.0
46327,4,6327,[318  79 427 588 216],18,5,25598,4.04519595448799,40.0,0.0
46328,4,6328,[194 111 186 471 276],457,4,25602,4.045188813398641,0.0,0.0
46329,4,6329,[318  79 427 588 216],716,5,25607,4.045339652448657,40.0,0.0
46330,4,6330,[125 215 403 127 357],655,2,25609,4.0450165850576525,0.0,20.0
46331,4,6331,[318  79 427 588 216],577,5,25614,4.045167403663929,40.0,0.0
46332,4,6332,[318  79 427 588 216],796,5,25619,4.04531817464077,40.0,0.0
46333,4,6333,[318  79 427 588 216],18,5,25624,4.045468898010736,40.0,0.0
46334,4,6334,[597 271 161  12 588],796,5,25629,4.045619573796369,0.0,0.0
46335,4,6335,[161  82 228 175 471],655,0,25629,4.0449810606060606,0.0,0.0
46336,4,6336,[268 483 313 275 187],296,5,25634,4.0451317658197885,0.0,20.0
46337,4,6337,[318  79 427 588 216],18,5,25639,4.045282423477437,40.0,0.0
46338,4,6338,[318  79 427 588 216],450,5,25644,4.0454330336015145,40.0,0.0
46339,4,6339,[ 50 182 435 191 216],321,3,25647,4.045268138801262,0.0,20.0
46340,4,6340,[603 111 275 222 172],716,5,25652,4.045418703674499,20.0,20.0
46341,4,6341,[318  79 427 588 216],450,5,25657,4.04556922106591,40.0,0.0
46342,4,6342,[318  79 427 588 216],450,5,25662,4.0457196909979505,40.0,0.0
46343,4,6343,[496   1 118 144 181],796,4,25666,4.045712484237074,20.0,0.0
46344,4,6344,[318  79 427 588 216],716,5,25671,4.045862884160757,40.0,0.0
46345,4,6345,[318  79 427 588 216],796,5,25676,4.046013236684526,40.0,0.0
46346,4,6346,[318  79 427 588 216],716,5,25681,4.046163541830786,40.0,0.0
46347,4,6347,[ 82 588 117 222 183],786,5,25686,4.046313799621928,0.0,0.0
46348,4,6348,[318  79 427 588 216],18,5,25691,4.046464010080328,40.0,0.0
46349,4,6349,[200 125 427 202 257],655,2,25693,4.0461417322834645,20.0,0.0
46350,4,6350,[237 655 300 202 423],639,0,25693,4.045504644937805,0.0,0.0
46351,4,6351,[182 300  11 238 185],535,3,25696,4.045340050377834,0.0,0.0
46352,4,6352,[318  79 427 588 216],577,5,25701,4.045490319534078,40.0,0.0
46353,4,6353,[546 153  25  56 194],151,3,25704,4.045325779036827,0.0,0.0
46354,4,6354,[357 269 195 301 234],450,4,25708,4.045318646734854,0.0,0.0
46355,4,6355,[318  79 427 588 216],18,5,25713,4.045468848332284,40.0,0.0
46356,4,6356,[237  56 302   4 282],655,1,25714,4.044989775051125,0.0,0.0
46357,4,6357,[318  79 427 588 216],450,5,25719,4.04513998112614,40.0,0.0
46358,4,6358,[118 276 273  69 313],344,2,25721,4.044818367667872,0.0,0.0
46359,4,6359,[318  79 427 588 216],450,5,25726,4.044968553459119,40.0,0.0
46360,4,6360,[318  79 427 588 216],18,5,25731,4.045118692029555,40.0,0.0
46361,4,6361,[179 143 111 228 588],450,5,25736,4.045268783401446,0.0,0.0
46362,4,6362,[318  71 322 161  69],593,4,25740,4.045261669024045,20.0,0.0
46363,4,6363,[568 597 132 111 210],344,4,25744,4.045254556882464,0.0,0.0
46364,4,6364,[318  79 427 588 216],716,5,25749,4.0454045561665355,40.0,0.0
46365,4,6365,[211 216 289  69 237],655,1,25750,4.04492617027961,0.0,0.0
46366,4,6366,[ 11  56 182 127 176],280,3,25753,4.044762054342705,0.0,20.0
46367,4,6367,[302 568  97 294   4],450,4,25757,4.044755025125628,0.0,0.0
46368,4,6368,[ 70  11 483 268  98],269,3,25760,4.044590987596169,0.0,0.0
46369,4,6369,[211 187 176  79 275],236,1,25761,4.044113029827315,0.0,20.0
46370,4,6370,[210  69 183 121 174],503,4,25765,4.04410610579187,0.0,0.0
46371,4,6371,[318  79 427 588 216],577,5,25770,4.044256120527307,40.0,0.0
46372,4,6372,[318  79 427 588 216],18,5,25775,4.0444060881845285,40.0,0.0
46373,4,6373,[318  79 427 588 216],450,5,25780,4.044556008785692,40.0,0.0
46374,4,6374,[197 323 234 742 202],504,3,25783,4.044392156862745,0.0,0.0
46375,4,6375,[174 153 313  50 496],280,2,25785,4.044071518193225,20.0,20.0
46376,4,6376,[318  79 427 588 216],18,5,25790,4.044221420730751,40.0,0.0
46377,4,6377,[183 288  69 196 222],344,4,25794,4.044214487300094,0.0,0.0
46378,4,6378,[471 258 275 435 568],450,5,25799,4.044364320426399,0.0,20.0
46379,4,6379,[318  79 427 588 216],796,5,25804,4.0445141065830725,40.0,0.0
46380,4,6380,[318  79 427 588 216],18,5,25809,4.044663845792195,40.0,0.0
46381,4,6381,[318  79 427 588 216],716,5,25814,4.0448135380758385,40.0,0.0
46382,4,6382,[117 135 269 282 748],450,4,25818,4.044806517311609,0.0,0.0
46383,4,6383,[318  79 427 588 216],716,5,25823,4.044956140350878,40.0,0.0
46384,4,6384,[357  96  28 202 173],23,2,25825,4.044635865309319,0.0,0.0
46385,4,6385,[318  79 427 588 216],18,5,25830,4.044785468211713,40.0,0.0
46386,4,6386,[282 111 288  15 286],450,3,25833,4.044621888210427,0.0,20.0
46387,4,6387,[172 235 405 302  12],450,4,25837,4.044614902943018,0.0,0.0
46388,4,6388,[132 245 275 111 748],796,4,25841,4.044607919862263,0.0,20.0
46389,4,6389,[168 318  64  12 276],18,4,25845,4.044600938967136,40.0,0.0
46390,4,6390,[318  79 427 588 216],18,5,25850,4.044750430292599,40.0,0.0
46391,4,6391,[176 202 385 237 483],280,2,25852,4.0444305381727155,0.0,0.0
46392,4,6392,[185 135 357 318   9],401,3,25855,4.044267167214141,20.0,0.0
46393,4,6393,[318  79 427 588 216],18,5,25860,4.044416640600563,40.0,0.0
46394,4,6394,[318  79 427 588 216],577,5,25865,4.044566067240031,40.0,0.0
46395,4,6395,[318  79 427 588 216],18,5,25870,4.044715447154472,40.0,0.0
46396,4,6396,[195   9 132 471  98],457,5,25875,4.044864780365796,0.0,0.0
46397,4,6397,[ 64 568  56 182  12],457,5,25880,4.045014066895905,20.0,0.0
46398,4,6398,[118 546 100 435 228],151,2,25882,4.044694483513049,0.0,20.0
46399,4,6399,[180   9 194 282 471],535,4,25886,4.0446875,0.0,0.0
46400,4,6400,[237 301 100 194 182],796,3,25889,4.044524293079206,0.0,20.0
46401,4,6401,[318  79 427 588 216],18,5,25894,4.0446735395189,40.0,0.0
46402,4,6402,[ 69 603 234 328  71],796,4,25898,4.044666562548805,20.0,0.0
46403,4,6403,[235  71 405 423  82],807,4,25902,4.044659587757652,0.0,0.0
46404,4,6404,[238 118 294 183 121],504,1,25903,4.044184231069477,0.0,0.0
46405,4,6405,[318  79 427 588 216],796,5,25908,4.044333437402435,40.0,0.0
46406,4,6406,[318  79 427 588 216],450,5,25913,4.044482597159357,40.0,0.0
46407,4,6407,[269 181   7  12  69],344,3,25916,4.044319600499376,0.0,0.0
46408,4,6408,[238 357 301 121 211],593,5,25921,4.044468715868311,0.0,0.0
46409,4,6409,[318  79 427 588 216],796,5,25926,4.044617784711389,40.0,0.0
46410,4,6410,[197 258 211 202 273],655,1,25927,4.044142879425986,0.0,0.0
46411,4,6411,[318  79 427 588 216],18,5,25932,4.044291952588896,40.0,0.0
46412,4,6412,[318  79 427 588 216],18,5,25937,4.044440979260877,40.0,0.0
46413,4,6413,[111 423  89 204 597],796,5,25942,4.044589959463673,0.0,0.0
46414,4,6414,[515 187 132 111 195],716,3,25945,4.044427123928293,0.0,0.0
46415,4,6415,[268 222 173 385 678],344,2,25947,4.044108478802992,0.0,0.0
46416,4,6416,[427 135 265 181   9],535,3,25950,4.043945769050959,20.0,0.0
46417,4,6417,[318  79 427 588 216],796,5,25955,4.044094733561857,40.0,0.0
46418,4,6418,[318  79 427 588 216],716,5,25960,4.044243651659137,40.0,0.0
46419,4,6419,[318  79 427 588 216],450,5,25965,4.044392523364486,40.0,0.0
46420,4,6420,[153 117 237 197  88],401,2,25967,4.0440741317551785,0.0,0.0
46421,4,6421,[318  79 427 588 216],450,5,25972,4.0442229834942385,40.0,0.0
46422,4,6422,[496 202 742 173 111],450,5,25977,4.0443717888837,20.0,0.0
46423,4,6423,[175  79  69 228  89],655,2,25979,4.044053549190536,0.0,0.0
46424,4,6424,[286 318  50 174 185],835,4,25983,4.044046692607004,20.0,40.0
46425,4,6425,[183 197 215 182 423],655,2,25985,4.043728602552132,0.0,0.0
46426,4,6426,[427 237 153 435 197],535,5,25990,4.0438773922514395,20.0,0.0
46427,4,6427,[195 286 238  50 427],796,3,25993,4.043714996888612,20.0,40.0
46428,4,6428,[ 56 742 132 357 215],450,5,25998,4.043863742417172,0.0,0.0
46429,4,6429,[318  79 427 588 216],796,5,26003,4.044012441679627,40.0,0.0
46430,4,6430,[183  82 127 288 216],655,3,26006,4.043850101072928,0.0,20.0
46431,4,6431,[318  79 427 588 216],450,5,26011,4.0439987562189055,40.0,0.0
46432,4,6432,[197 271 100 273 174],655,1,26012,4.043525571273123,0.0,20.0
46433,4,6433,[  9 323 234 496 313],280,2,26014,4.043207957724588,20.0,0.0
46434,4,6434,[318  79 427 588 216],577,5,26019,4.043356643356644,40.0,0.0
46435,4,6435,[427  28 568 471  89],450,5,26024,4.043505282784338,20.0,0.0
46436,4,6436,[318  79 427 588 216],450,5,26029,4.0436538760292065,40.0,0.0
46437,4,6437,[483 197 196 173  89],457,5,26034,4.043802423112768,0.0,0.0
46438,4,6438,[318  79 427 588 216],18,5,26039,4.043950924056531,40.0,0.0
46439,4,6439,[318  79 427 588 216],796,5,26044,4.044099378881987,40.0,0.0
46440,4,6440,[318  79 427 588 216],577,5,26049,4.04424778761062,40.0,0.0
46441,4,6441,[173  69 748 568 153],280,2,26051,4.043930456380006,0.0,0.0
46442,4,6442,[258 135  97  64 286],450,4,26055,4.043923638056806,20.0,20.0
46443,4,6443,[318  79 427 588 216],577,5,26060,4.04407200496586,40.0,0.0
46444,4,6444,[210 288 235  64 742],344,3,26063,4.043910007757952,20.0,0.0
46445,4,6445,[265 597 273  56 282],450,4,26067,4.043903195780329,0.0,0.0
46446,4,6446,[228 211  88 597 215],796,4,26071,4.04389638591593,0.0,0.0
46447,4,6447,[ 69 238 118 234 153],450,3,26074,4.043734491315137,0.0,0.0
46448,4,6448,[ 97 385  95  82   4],716,3,26077,4.043572646922003,0.0,0.0
46449,4,6449,[ 28 318  22 423 194],716,5,26082,4.043720930232558,20.0,0.0
46450,4,6450,[318  79 427 588 216],450,5,26087,4.043869167570919,40.0,0.0
46451,4,6451,[427 125 405 200 318],796,5,26092,4.044017358958462,40.0,0.0
46452,4,6452,[318  79 427 588 216],796,5,26097,4.044165504416551,40.0,0.0
46453,4,6453,[216 603  88 288 515],655,3,26100,4.044003718624109,20.0,0.0
46454,4,6454,[318  79 427 588 216],450,5,26105,4.044151820294346,40.0,0.0
46455,4,6455,[153 318 237  89  69],450,5,26110,4.044299876084263,20.0,0.0
46456,4,6456,[318  79 427 588 216],18,5,26115,4.044447886015178,40.0,0.0
46457,4,6457,[238  88  69 301 215],655,0,26115,4.043821616599566,0.0,0.0
46458,4,6458,[  1  22 135  96 568],450,4,26119,4.04381483201734,0.0,0.0
46459,4,6459,[153   7  70 276 191],655,2,26121,4.043498452012384,0.0,0.0
46460,4,6460,[161 235  15 318 403],269,1,26122,4.043027395140071,20.0,0.0
46461,4,6461,[187 313 180 286 172],450,5,26127,4.043175487465181,0.0,20.0
46462,4,6462,[318  79 427 588 216],577,5,26132,4.043323533962556,40.0,0.0
46463,4,6463,[318  79 427 588 216],796,5,26137,4.043471534653466,40.0,0.0
46464,4,6464,[ 11 135  28 302 210],655,2,26139,4.043155452436195,0.0,0.0
46465,4,6465,[318  79 427 588 216],796,5,26144,4.0433034333436435,40.0,0.0
46466,4,6466,[318  79 427 588 216],450,5,26149,4.043451368486161,40.0,0.0
46467,4,6467,[269 215 211 210  28],450,4,26153,4.0434446505875075,0.0,0.0
46468,4,6468,[318  79 427 588 216],577,5,26158,4.043592518163549,40.0,0.0
46469,4,6469,[222 211 200 202 121],655,1,26159,4.043122102009273,0.0,0.0
46470,4,6470,[195 181 191 271 153],796,5,26164,4.043269973728944,0.0,0.0
46471,4,6471,[234 100 357  28 273],655,2,26166,4.042954264524104,0.0,20.0
46472,4,6472,[318  79 427 588 216],18,5,26171,4.043102116483856,40.0,0.0
46473,4,6473,[318  79 427 588 216],18,5,26176,4.043249922767995,40.0,0.0
46474,4,6474,[276 186  97  70 117],786,4,26180,4.043243243243243,0.0,0.0
46475,4,6475,[318  79 427 588 216],716,5,26185,4.0433909820877085,40.0,0.0
46476,4,6476,[228 423 125  69  98],280,3,26188,4.043229890381349,0.0,0.0
46477,4,6477,[222  56 403  97 117],796,4,26192,4.043223217042297,0.0,0.0
46478,4,6478,[153 132 125 174 483],450,4,26196,4.043216545763235,0.0,0.0
46479,4,6479,[318  79 427 588 216],716,5,26201,4.043364197530864,40.0,0.0
46480,4,6480,[197 186 191 508  88],655,1,26202,4.042894615028545,0.0,0.0
46481,4,6481,[ 88 273 427 508 196],693,1,26203,4.042425177414378,20.0,0.0
46482,4,6482,[215  25 172 238 151],18,1,26204,4.041955884621317,0.0,0.0
46483,4,6483,[318  79 427 588 216],18,5,26209,4.042103639728563,40.0,0.0
46484,4,6484,[222 187 179 268  12],655,2,26211,4.0417887432536626,0.0,0.0
46485,4,6485,[318  79 427 588 216],796,5,26216,4.041936478569226,40.0,0.0
46486,4,6486,[318  79 427 588 216],716,5,26221,4.0420841683366735,40.0,0.0
46487,4,6487,[111 268 175 475  50],655,1,26222,4.041615289765721,0.0,20.0
46488,4,6488,[318  79 427 588 216],577,5,26227,4.041762983510556,40.0,0.0
46489,4,6489,[318  79 427 588 216],18,5,26232,4.04191063174114,40.0,0.0
46490,4,6490,[111 385  95   8  64],344,4,26236,4.041904175011554,20.0,0.0
46491,4,6491,[318  79 427 588 216],577,5,26241,4.042051756007393,40.0,0.0
46492,4,6492,[118 172  50 195 215],344,3,26244,4.041891267518866,0.0,20.0
46493,4,6493,[132 238 546 286   1],450,5,26249,4.042038805050816,0.0,20.0
46494,4,6494,[100 211 678 269 301],860,1,26250,4.041570438799076,0.0,20.0
46495,4,6495,[318  79 427 588 216],18,5,26255,4.041717980295567,40.0,0.0
46496,4,6496,[ 71 174 210 144 100],796,3,26258,4.04155764198861,0.0,20.0
46497,4,6497,[168 288 111 181 210],450,3,26261,4.041397353031702,0.0,0.0
46498,4,6498,[318  79 427 588 216],796,5,26266,4.041544853054316,40.0,0.0
46499,4,6499,[132 234   8 405  64],577,3,26269,4.041384615384615,20.0,0.0
46500,4,6500,[328 153 181  71 427],450,4,26273,4.0413782495000765,20.0,0.0
46501,4,6501,[182 235 288 742 194],457,4,26277,4.041371885573669,0.0,0.0
46502,4,6502,[118 187 180 288 427],693,1,26278,4.0409041980624325,20.0,0.0
46503,4,6503,[318  79 427 588 216],577,5,26283,4.041051660516605,40.0,0.0
46504,4,6504,[202 180 385 265 100],786,5,26288,4.04119907763259,0.0,20.0
46505,4,6505,[742  69 210 143 191],450,4,26292,4.041192745158315,0.0,0.0
46506,4,6506,[ 12  69  25 210 427],655,1,26293,4.04072537267558,20.0,0.0
46507,4,6507,[286 210 100 182  69],655,1,26294,4.040258143822987,0.0,40.0
46508,4,6508,[318  79 427 588 216],716,5,26299,4.040405592256875,40.0,0.0
46509,4,6509,[568 180  96 195 323],280,2,26301,4.040092165898617,0.0,0.0
46510,4,6510,[318  79 427 588 216],577,5,26306,4.04023959453233,40.0,0.0
46511,4,6511,[172  11 210 127 100],450,4,26310,4.040233415233415,0.0,40.0
46512,4,6512,[318  79 427 588 216],450,5,26315,4.040380776907723,40.0,0.0
46513,4,6513,[ 70 405 153 483 181],269,1,26316,4.039914031317163,0.0,0.0
46514,4,6514,[496 234  89 197  15],269,2,26318,4.03960092095165,20.0,0.0
46515,4,6515,[117 288 275 385 678],344,2,26320,4.0392879066912215,0.0,20.0
46516,4,6516,[318  79 427 588 216],450,5,26325,4.039435323001381,40.0,0.0
46517,4,6517,[200 655 423  82 153],269,3,26328,4.039275851488187,0.0,0.0
46518,4,6518,[742 435 302 318 132],450,5,26333,4.039423224420924,20.0,0.0
46519,4,6519,[11 71  9 56 98],593,4,26337,4.03941717791411,0.0,0.0
46520,4,6520,[318  79 427 588 216],716,5,26342,4.039564483974851,40.0,0.0
46521,4,6521,[200 211 405 300 118],450,3,26345,4.039405090463048,0.0,0.0
46522,4,6522,[318  79 427 588 216],18,5,26350,4.039552353211713,40.0,0.0
46523,4,6523,[318  79 427 588 216],450,5,26355,4.039699570815451,40.0,0.0
46524,4,6524,[ 95 197 423  15 235],450,2,26357,4.0393869731800764,0.0,0.0
46525,4,6525,[273 196 234 211  11],450,3,26360,4.03922770456635,0.0,0.0
46526,4,6526,[435  64 655 127 385],450,5,26365,4.0393749042439095,20.0,20.0
46527,4,6527,[ 64  98 742  89 483],457,5,26370,4.039522058823529,20.0,0.0
46528,4,6528,[318  79 427 588 216],796,5,26375,4.03966916832593,40.0,0.0
46529,4,6529,[132  64 197 168  70],151,5,26380,4.039816232771822,20.0,0.0
46530,4,6530,[318  79 427 588 216],450,5,26385,4.039963252181901,40.0,0.0
46531,4,6531,[318  79 427 588 216],18,5,26390,4.040110226576853,40.0,0.0
46532,4,6532,[318  79 427 588 216],18,5,26395,4.040257155977346,40.0,0.0
46533,4,6533,[302 300 204 132 187],450,5,26400,4.040404040404041,0.0,0.0
46534,4,6534,[318  79 427 588 216],450,5,26405,4.040550879877582,40.0,0.0
46535,4,6535,[318  79 427 588 216],716,5,26410,4.040697674418604,40.0,0.0
46536,4,6536,[168 258  71 271  96],807,2,26412,4.040385497934833,0.0,0.0
46537,4,6537,[318  79 427 588 216],577,5,26417,4.0405322728663196,40.0,0.0
46538,4,6538,[318  79 427 588 216],796,5,26422,4.040679002905643,40.0,0.0
46539,4,6539,[216 200 257 294 678],504,4,26426,4.040672782874617,0.0,0.0
46540,4,6540,[333 300 194  64 234],629,5,26431,4.040819446567803,20.0,0.0
46541,4,6541,[318  79 427 588 216],577,5,26436,4.040966065423418,40.0,0.0
46542,4,6542,[237  64 132 333 197],796,4,26440,4.0409598043710835,20.0,0.0
46543,4,6543,[318  79 427 588 216],18,5,26445,4.041106356968215,40.0,0.0
46544,4,6544,[185 121  82  88 568],457,5,26450,4.041252864782277,0.0,0.0
46545,4,6545,[  4 655 257 151 427],716,4,26454,4.0412465627864345,20.0,0.0
46546,4,6546,[161 168  88 294 194],504,2,26456,4.040934779288223,0.0,0.0
46547,4,6547,[168 403 161 191 435],450,5,26461,4.04108124618204,0.0,0.0
46548,4,6548,[ 71 237 273 161 275],796,4,26465,4.041074973278363,0.0,20.0
46549,4,6549,[318  79 427 588 216],450,5,26470,4.041221374045802,40.0,0.0
46550,4,6550,[ 79 237 172 405   9],344,3,26473,4.041062433216303,0.0,0.0
46551,4,6551,[ 95 143   8  69 257],807,5,26478,4.041208791208791,0.0,0.0
46552,4,6552,[318  79 427 588 216],577,5,26483,4.0413551045322755,40.0,0.0
46553,4,6553,[318  79 427 588 216],716,5,26488,4.041501373207201,40.0,0.0
46554,4,6554,[200 197 180 568 288],450,3,26491,4.041342486651411,0.0,0.0
46555,4,6555,[318  79 427 588 216],18,5,26496,4.041488712629652,40.0,0.0
46556,4,6556,[ 88 234 121 471 135],457,5,26501,4.041634894006405,0.0,0.0
46557,4,6557,[568 275 168 187 186],796,4,26505,4.041628545288198,0.0,20.0
46558,4,6558,[204  50 161 127  71],504,3,26508,4.0414697362402805,0.0,40.0
46559,4,6559,[318  79 427 588 216],796,5,26513,4.041615853658537,40.0,0.0
46560,4,6560,[ 98 172 282 483 275],296,5,26518,4.041761926535589,0.0,20.0
46561,4,6561,[151  71 182 202  12],18,3,26521,4.041603169765316,0.0,0.0
46562,4,6562,[211  82 471 313 168],807,5,26526,4.041749200060948,0.0,0.0
46563,4,6563,[318  79 427 588 216],450,5,26531,4.041895185862279,40.0,0.0
46564,4,6564,[318  79 427 588 216],450,5,26536,4.042041127189642,40.0,0.0
46565,4,6565,[273 405 127 403  64],450,4,26540,4.042034724337496,20.0,20.0
46566,4,6566,[100   1 427 238 202],18,4,26544,4.042028323435359,20.0,20.0
46567,4,6567,[318  79 427 588 216],716,5,26549,4.042174177831912,40.0,0.0
46568,4,6568,[301 191 174 748  22],796,4,26553,4.042167757649566,0.0,0.0
46569,4,6569,[318  79 427 588 216],18,5,26558,4.042313546423135,40.0,0.0
46570,4,6570,[427 276 238 357  50],18,5,26563,4.042459290823315,20.0,20.0
46571,4,6571,[318  79 427 588 216],450,5,26568,4.042604990870359,40.0,0.0
46572,4,6572,[  1 132  28 172 588],457,5,26573,4.042750646584512,0.0,0.0
46573,4,6573,[302 100 174  97 301],344,4,26577,4.042744143595984,0.0,20.0
46574,4,6574,[191 588  70 313 269],450,5,26582,4.042889733840304,0.0,0.0
46575,4,6575,[144  69 427 423 238],716,4,26586,4.0428832116788325,20.0,0.0
46576,4,6576,[121 678 288 181  22],256,5,26591,4.043028736506006,0.0,0.0
46577,4,6577,[318  79 427 588 216],796,5,26596,4.043174217087261,40.0,0.0
46578,4,6578,[144 423 196  82 204],716,4,26600,4.043167654658763,0.0,0.0
46579,4,6579,[318  79 427 588 216],450,5,26605,4.043313069908814,40.0,0.0
46580,4,6580,[318  79 427 588 216],716,5,26610,4.043458440966418,40.0,0.0
46581,4,6581,[125 215 222 403 237],280,0,26610,4.0428441203281675,0.0,0.0
46582,4,6582,[318  79 427 588 216],18,5,26615,4.042989518456631,40.0,0.0
46583,4,6583,[318  79 427 588 216],450,5,26620,4.043134872417983,40.0,0.0
46584,4,6584,[181 135  50 257  88],716,4,26624,4.043128321943811,0.0,20.0
46585,4,6585,[144 385 471 186 182],655,1,26625,4.042666261767385,0.0,0.0
46586,4,6586,[318  79 427 588 216],450,5,26630,4.0428115986033095,40.0,0.0
46587,4,6587,[ 25 174   1 423 288],655,0,26630,4.042197935640559,0.0,0.0
46588,4,6588,[182 237 742 153  25],655,1,26631,4.041736227045075,0.0,0.0
46589,4,6589,[318  79 427 588 216],450,5,26636,4.041881638846737,40.0,0.0
46590,4,6590,[100 313  12   4 197],796,3,26639,4.041723562433622,0.0,20.0
46591,4,6591,[318  79 427 588 216],716,5,26644,4.041868932038835,40.0,0.0
46592,4,6592,[ 97   4  98 603 222],716,4,26648,4.04186258152586,20.0,0.0
46593,4,6593,[318  79 427 588 216],716,5,26653,4.042007885956931,40.0,0.0
46594,4,6594,[294 100 588 183 151],450,5,26658,4.042153146322972,0.0,20.0
46595,4,6595,[ 15 273 234 655 182],450,2,26660,4.041843541540327,0.0,0.0
46596,4,6596,[318  79 427 588 216],716,5,26665,4.041988782780051,40.0,0.0
46597,4,6597,[318  79 427 588 216],796,5,26670,4.042133979993937,40.0,0.0
46598,4,6598,[ 96 357   4 496 118],796,5,26675,4.042279133202,20.0,0.0
46599,4,6599,[175 427 403 111 121],655,1,26676,4.041818181818182,20.0,0.0
46600,4,6600,[318  79 427 588 216],577,5,26681,4.041963338888047,40.0,0.0
46601,4,6601,[318  79 427 588 216],18,5,26686,4.042108451984247,40.0,0.0
46602,4,6602,[273  50 210 275  11],629,3,26689,4.041950628502196,0.0,40.0
46603,4,6603,[318  79 427 588 216],577,5,26694,4.042095699576015,40.0,0.0
46604,4,6604,[196 258 435   4 508],655,0,26694,4.041483724451173,0.0,0.0
46605,4,6605,[318  79 427 588 216],18,5,26699,4.041628822282774,40.0,0.0
46606,4,6606,[318  79 427 588 216],796,5,26704,4.041773876191917,40.0,0.0
46607,4,6607,[294 174 117  50 210],655,1,26705,4.041313559322034,0.0,20.0
46608,4,6608,[235 405 200   7 385],457,4,26709,4.041307308216069,0.0,0.0
46609,4,6609,[318  79 427 588 216],577,5,26714,4.041452344931922,40.0,0.0
46610,4,6610,[ 88 237 301 235 197],450,4,26718,4.041446074723945,0.0,0.0
46611,4,6611,[318  79 427 588 216],577,5,26723,4.041591046581972,40.0,0.0
46612,4,6612,[748 186 385 118 403],450,3,26726,4.041433539996976,0.0,0.0
46613,4,6613,[216 276 385 357 271],655,3,26729,4.041276081040218,0.0,0.0
46614,4,6614,[237 313  69 508 475],655,1,26730,4.040816326530612,0.0,0.0
46615,4,6615,[118 216 187  56  71],450,3,26733,4.040659008464329,0.0,0.0
46616,4,6616,[318  79 427 588 216],716,5,26738,4.04080398972344,40.0,0.0
46617,4,6617,[318  79 427 588 216],796,5,26743,4.040948927168329,40.0,0.0
46618,4,6618,[187 294 423 215 197],796,3,26746,4.040791660371657,0.0,0.0
46619,4,6619,[286 265 288 294 161],655,0,26746,4.040181268882176,0.0,20.0
46620,4,6620,[318  79 427 588 216],450,5,26751,4.040326234707748,40.0,0.0
46621,4,6621,[318  79 427 588 216],716,5,26756,4.040471156750226,40.0,0.0
46622,4,6622,[318  79 427 588 216],796,5,26761,4.040616035029442,40.0,0.0
46623,4,6623,[318  79 427 588 216],716,5,26766,4.040760869565218,40.0,0.0
46624,4,6624,[127  82   9  88 111],796,3,26769,4.040603773584905,0.0,20.0
46625,4,6625,[427 125 173 655 273],450,4,26773,4.040597645638394,20.0,0.0
46626,4,6626,[271 204 603 168 301],796,4,26777,4.0405915195412705,20.0,0.0
46627,4,6627,[318  79 427 588 216],18,5,26782,4.040736270368135,40.0,0.0
46628,4,6628,[ 98 202 288 322 161],504,4,26786,4.040730125207422,0.0,0.0
46629,4,6629,[318  79 427 588 216],450,5,26791,4.040874811463047,40.0,0.0
46630,4,6630,[318  79 427 588 216],577,5,26796,4.041019454079325,40.0,0.0
46631,4,6631,[471 135  79 568  12],72,5,26801,4.041164053075995,0.0,0.0
46632,4,6632,[ 82   9 276 237  12],174,4,26805,4.041157847127996,0.0,0.0
46633,4,6633,[435   9  69 182 195],655,1,26806,4.040699427193247,0.0,0.0
46634,4,6634,[318  79 427 588 216],450,5,26811,4.040844009042954,40.0,0.0
46635,4,6635,[237 127 183  95 265],280,3,26814,4.040687160940325,0.0,20.0
46636,4,6636,[318  79 427 588 216],450,5,26819,4.04083170106976,40.0,0.0
46637,4,6637,[318  79 427 588 216],450,5,26824,4.040976197649894,40.0,0.0
46638,4,6638,[318  79 427 588 216],450,5,26829,4.041120650700407,40.0,0.0
46639,4,6639,[288 235 471 597 117],457,3,26832,4.040963855421687,0.0,0.0
46640,4,6640,[515 168 186 153  56],535,3,26835,4.0408071073633485,0.0,0.0
46641,4,6641,[318  79 427 588 216],18,5,26840,4.040951520626318,40.0,0.0
46642,4,6642,[318  79 427 588 216],18,5,26845,4.041095890410959,40.0,0.0
46643,4,6643,[318  79 427 588 216],716,5,26850,4.041240216736906,40.0,0.0
46644,4,6644,[318  79 427 588 216],18,5,26855,4.041384499623777,40.0,0.0
46645,4,6645,[318  79 427 588 216],796,5,26860,4.0415287390911825,40.0,0.0
46646,4,6646,[176 175  89   7 276],269,2,26862,4.041221603731007,0.0,0.0
46647,4,6647,[318  79 427 588 216],796,5,26867,4.041365824308063,40.0,0.0
46648,4,6648,[318  79 427 588 216],450,5,26872,4.041510001503986,40.0,0.0
46649,4,6649,[ 98 423  15 168 234],389,4,26876,4.041503759398497,0.0,0.0
46650,4,6650,[318  79 427 588 216],450,5,26881,4.041647872500376,40.0,0.0
46651,4,6651,[238  56  12 286 423],655,0,26881,4.041040288634997,0.0,20.0
46652,4,6652,[187 300 286 204 257],389,2,26883,4.040733503682549,0.0,20.0
46653,4,6653,[318  79 427 588 216],450,5,26888,4.04087766756838,40.0,0.0
46654,4,6654,[ 96 127 202 496 143],796,5,26893,4.0410217881292265,20.0,20.0
46655,4,6655,[185 195  25 161  96],504,5,26898,4.041165865384615,0.0,0.0
46656,4,6656,[183 313 197 496 144],796,4,26902,4.041159681538231,20.0,0.0
46657,4,6657,[282 405  89 202 275],796,5,26907,4.041303694803244,0.0,20.0
46658,4,6658,[215 276 182  28  15],457,5,26912,4.0414476648145365,0.0,0.0
46659,4,6659,[318  79 427 588 216],450,5,26917,4.041591591591591,40.0,0.0
46660,4,6660,[318  79 427 588 216],18,5,26922,4.041735475153881,40.0,0.0
46661,4,6661,[127 181   4  89 200],457,5,26927,4.041879315520864,0.0,20.0
46662,4,6662,[318  79 427 588 216],796,5,26932,4.042023112711991,40.0,0.0
46663,4,6663,[318  79 427 588 216],18,5,26937,4.042166866746698,40.0,0.0
46664,4,6664,[318  79 427 588 216],716,5,26942,4.042310577644411,40.0,0.0
46665,4,6665,[ 88 265 301 313 748],450,5,26947,4.042454245424542,0.0,0.0
46666,4,6666,[655 176 191 471  70],786,5,26952,4.042597870106495,0.0,0.0
46667,4,6667,[ 95 655 234 235  82],280,2,26954,4.042291541691662,0.0,0.0
46668,4,6668,[211 268 302 282 187],535,1,26955,4.041835357624831,0.0,0.0
46669,4,6669,[318  79 427 588 216],716,5,26960,4.041979010494753,40.0,0.0
46670,4,6670,[318  79 427 588 216],796,5,26965,4.042122620296807,40.0,0.0
46671,4,6671,[ 69 200 121  15   4],796,5,26970,4.04226618705036,0.0,0.0
46672,4,6672,[204 302 275  98 144],655,3,26973,4.042109995504271,0.0,20.0
46673,4,6673,[322 568 546  79   1],450,5,26978,4.042253521126761,0.0,0.0
46674,4,6674,[318  79 427 588 216],18,5,26983,4.042397003745318,40.0,0.0
46675,4,6675,[318  79 427 588 216],450,5,26988,4.042540443379269,40.0,0.0
46676,4,6676,[318  79 427 588 216],577,5,26993,4.042683840047926,40.0,0.0
46677,4,6677,[568   4 161 228 195],280,1,26994,4.042228212039533,0.0,0.0
46678,4,6678,[318  79 427 588 216],577,5,26999,4.042371612516844,40.0,0.0
46679,4,6679,[318  79 427 588 216],716,5,27004,4.04251497005988,40.0,0.0
46680,4,6680,[187 357 328  69 117],450,5,27009,4.042658284687921,0.0,0.0
46681,4,6681,[318  79 427 588 216],796,5,27014,4.042801556420233,40.0,0.0
46682,4,6682,[ 98 132 385  69 144],796,5,27019,4.042944785276074,0.0,0.0
46683,4,6683,[265 357 322 186  97],786,4,27023,4.0429383602633155,0.0,0.0
46684,4,6684,[187   1 125 161  98],655,2,27025,4.042632759910247,0.0,0.0
46685,4,6685,[187  50 118  25 568],389,2,27027,4.042327250972181,0.0,20.0
46686,4,6686,[300 180  96 435 197],450,5,27032,4.042470465081501,0.0,0.0
46687,4,6687,[318  79 427 588 216],716,5,27037,4.042613636363637,40.0,0.0
46688,4,6688,[318  79 427 588 216],577,5,27042,4.042756764837794,40.0,0.0
46689,4,6689,[318  79 427 588 216],796,5,27047,4.042899850523169,40.0,0.0
46690,4,6690,[202 196 187 117 125],796,5,27052,4.0430428934389475,0.0,0.0
46691,4,6691,[273   7 471 153   4],655,1,27053,4.042588164973102,0.0,0.0
46692,4,6692,[318  79 427 588 216],577,5,27058,4.042731211713731,40.0,0.0
46693,4,6693,[318  79 427 588 216],716,5,27063,4.042874215715567,40.0,0.0
46694,4,6694,[269 176 313 238  82],450,4,27067,4.042867811799851,0.0,0.0
46695,4,6695,[603   7 357 333 200],655,3,27070,4.042712066905615,20.0,0.0
46696,4,6696,[125 195  96 181 245],796,4,27074,4.042705689114529,0.0,0.0
46697,4,6697,[276 176 265  69  95],786,4,27078,4.042699313227829,0.0,0.0
46698,4,6698,[318  79 427 588 216],716,5,27083,4.042842215256008,40.0,0.0
46699,4,6699,[546 186 200  97  98],577,3,27086,4.042686567164179,0.0,0.0
46700,4,6700,[318  79 427 588 216],716,5,27091,4.042829428443516,40.0,0.0
46701,4,6701,[318  79 427 588 216],577,5,27096,4.042972247090421,40.0,0.0
46702,4,6702,[ 50 258 238 357 210],296,4,27100,4.042965836192749,0.0,20.0
46703,4,6703,[200 328 186 228 318],450,3,27103,4.042810262529833,20.0,0.0
46704,4,6704,[ 56 655 405 215 483],450,4,27107,4.042803877703206,0.0,0.0
46705,4,6705,[318  79 427 588 216],577,5,27112,4.042946614971667,40.0,0.0
46706,4,6706,[588 357 195 204 403],457,5,27117,4.043089309676457,0.0,0.0
46707,4,6707,[318  79 427 588 216],577,5,27122,4.043231961836613,40.0,0.0
46708,4,6708,[357  70 100 180  56],11,4,27126,4.043225517960948,0.0,20.0
46709,4,6709,[191 185  50 161  28],655,3,27129,4.043070044709389,0.0,20.0
46710,4,6710,[603 748 333   1 405],796,4,27133,4.043063626881239,20.0,0.0
46711,4,6711,[181 135 210  56 508],693,2,27135,4.042759237187128,0.0,0.0
46712,4,6712,[318  79 427 588 216],796,5,27140,4.042901832265753,40.0,0.0
46713,4,6713,[275   7 175 186 197],321,4,27144,4.042895442359249,0.0,20.0
46714,4,6714,[318  79 427 588 216],18,5,27149,4.0430379746835445,40.0,0.0
46715,4,6715,[183  97 301 237   4],655,1,27150,4.042584871947588,0.0,0.0
46716,4,6716,[174 234 200  56 117],450,3,27153,4.042429656096472,0.0,0.0
46717,4,6717,[ 79 483 175 403 143],655,3,27156,4.042274486454302,0.0,0.0
46718,4,6718,[318  79 427 588 216],716,5,27161,4.042417026343206,40.0,0.0
46719,4,6719,[597 742  88 161 186],450,4,27165,4.042410714285714,0.0,0.0
46720,4,6720,[318  79 427 588 216],577,5,27170,4.042553191489362,40.0,0.0
46721,4,6721,[318  79 427 588 216],577,5,27175,4.042695626301696,40.0,0.0
46722,4,6722,[ 25 111 135  15 568],450,2,27177,4.042391789379741,0.0,0.0
46723,4,6723,[ 28 427 288 546  96],693,2,27179,4.042088042831648,20.0,0.0
46724,4,6724,[194 118 202 238 125],796,4,27183,4.0420817843866175,0.0,0.0
46725,4,6725,[318  79 427 588 216],18,5,27188,4.042224204579245,40.0,0.0
46726,4,6726,[174 300  56 151 100],796,4,27192,4.0422179277538275,0.0,20.0
46727,4,6727,[172 655 742 238 282],796,2,27194,4.04191438763377,0.0,0.0
46728,4,6728,[258   4 179 222 288],655,1,27195,4.041462327240303,0.0,0.0
46729,4,6729,[265 186 222 197  69],151,5,27200,4.041604754829123,0.0,0.0
46730,4,6730,[318  79 427 588 216],796,5,27205,4.041747140098054,40.0,0.0
46731,4,6731,[603 238 172  15  96],655,2,27207,4.041443850267379,20.0,0.0
46732,4,6732,[181 546 215 258  88],23,2,27209,4.041140650527254,0.0,0.0
46733,4,6733,[197  97 176 496 742],450,5,27214,4.041283041283041,20.0,0.0
46734,4,6734,[603 174 191 323 117],796,4,27218,4.0412769116555305,20.0,0.0
46735,4,6735,[185 403 202  22 603],18,1,27219,4.040825415676959,20.0,0.0
46736,4,6736,[655 100 597 588 111],450,5,27224,4.040967789817426,0.0,20.0
46737,4,6737,[127 187  56 151 195],450,5,27229,4.041110121697833,0.0,20.0
46738,4,6738,[318  79 427 588 216],796,5,27234,4.041252411336994,40.0,0.0
46739,4,6739,[  8 173 111 127  88],280,3,27237,4.041097922848665,0.0,20.0
46740,4,6740,[318  79 427 588 216],796,5,27242,4.041240172081293,40.0,0.0
46741,4,6741,[318  79 427 588 216],577,5,27247,4.04138237911599,40.0,0.0
46742,4,6742,[ 89  22  88 202 215],457,5,27252,4.041524543971526,0.0,0.0
46743,4,6743,[603 301 655 427  79],655,3,27255,4.0413701067615655,40.0,0.0
46744,4,6744,[318  79 427 588 216],577,5,27260,4.041512231282431,40.0,0.0
46745,4,6745,[174 313 237 318 117],796,5,27265,4.041654313667358,20.0,0.0
46746,4,6746,[202 288 475 568 127],655,1,27266,4.041203497850897,0.0,20.0
46747,4,6747,[318  79 427 588 216],796,5,27271,4.041345583876704,40.0,0.0
46748,4,6748,[318  79 427 588 216],716,5,27276,4.041487627796711,40.0,0.0
46749,4,6749,[132  70  56 222 405],716,5,27281,4.04162962962963,0.0,0.0
46750,4,6750,[276 175 328  96 257],655,1,27282,4.041179084580063,0.0,0.0
46751,4,6751,[318  79 427 588 216],796,5,27287,4.0413210900473935,40.0,0.0
46752,4,6752,[318  79 427 588 216],18,5,27292,4.041463053457722,40.0,0.0
46753,4,6753,[318  79 427 588 216],450,5,27297,4.04160497482973,40.0,0.0
46754,4,6754,[302 186 132 168 496],151,4,27301,4.04159881569208,20.0,0.0
46755,4,6755,[ 96 405 483 515 265],716,4,27305,4.041592658377739,0.0,0.0
46756,4,6756,[191   1 125 268 100],296,5,27310,4.041734497558088,0.0,20.0
46757,4,6757,[318  79 427 588 216],716,5,27315,4.041876294761764,40.0,0.0
46758,4,6758,[237  15 286  98   7],450,4,27319,4.04187009912709,0.0,20.0
46759,4,6759,[286 268  98 111 333],629,5,27324,4.042011834319527,0.0,20.0
46760,4,6760,[318  79 427 588 216],796,5,27329,4.042153527584677,40.0,0.0
46761,4,6761,[ 22 172 403 471 237],280,1,27330,4.04170363797693,0.0,0.0
46762,4,6762,[318  79 427 588 216],716,5,27335,4.041845334910542,40.0,0.0
46763,4,6763,[318  79 427 588 216],716,5,27340,4.041986989946777,40.0,0.0
46764,4,6764,[318  79 427 588 216],577,5,27345,4.042128603104213,40.0,0.0
46765,4,6765,[318  79 427 588 216],18,5,27350,4.042270174401419,40.0,0.0
46766,4,6766,[151  15   8 172 121],457,5,27355,4.042411703856953,0.0,0.0
46767,4,6767,[405  79 111 515 168],716,5,27360,4.042553191489362,0.0,0.0
46768,4,6768,[210 546 678 235 191],344,2,27362,4.042251440390014,0.0,0.0
46769,4,6769,[286  98 427 143 222],151,5,27367,4.042392909896603,20.0,20.0
46770,4,6770,[132 204 323  15 328],796,4,27371,4.042386648944026,0.0,0.0
46771,4,6771,[288  89 235 234 423],457,4,27375,4.0423803898405195,0.0,0.0
46772,4,6772,[318  79 427 588 216],716,5,27380,4.042521777646538,40.0,0.0
46773,4,6773,[318  79 427 588 216],18,5,27385,4.042663123708296,40.0,0.0
46774,4,6774,[172 100 191 282 187],236,2,27387,4.0423616236162365,0.0,20.0
46775,4,6775,[318  79 427 588 216],796,5,27392,4.04250295159386,40.0,0.0
46776,4,6776,[318  79 427 588 216],450,5,27397,4.042644237863361,40.0,0.0
46777,4,6777,[318  79 427 588 216],716,5,27402,4.042785482443199,40.0,0.0
46778,4,6778,[118  70 121  25 222],716,4,27406,4.04277917096917,0.0,0.0
46779,4,6779,[318  79 427 588 216],18,5,27411,4.042920353982301,40.0,0.0
46780,4,6780,[318  79 427 588 216],577,5,27416,4.043061495354667,40.0,0.0
46781,4,6781,[483 151 173 235 318],401,2,27418,4.042760247714538,20.0,0.0
46782,4,6782,[318  79 427 588 216],796,5,27423,4.042901371074746,40.0,0.0
46783,4,6783,[153 215 568 196 275],450,5,27428,4.043042452830188,0.0,20.0
46784,4,6784,[211  28   8  82 204],655,0,27428,4.042446573323508,0.0,0.0
46785,4,6785,[318  79 427 588 216],18,5,27433,4.042587680518715,40.0,0.0
46786,4,6786,[318  79 427 588 216],716,5,27438,4.042728746132312,40.0,0.0
46787,4,6787,[238 423 385 273  50],796,3,27441,4.042575132586918,0.0,20.0
46788,4,6788,[742 294  96 282 216],256,3,27444,4.042421564295183,0.0,0.0
46789,4,6789,[161 748 194 180 282],796,4,27448,4.042415316642121,0.0,0.0
46790,4,6790,[195 187 182 568 176],72,4,27452,4.042409070829039,0.0,0.0
46791,4,6791,[318  79 427 588 216],450,5,27457,4.042550058892815,40.0,0.0
46792,4,6792,[318  79 427 588 216],450,5,27462,4.042691005446783,40.0,0.0
46793,4,6793,[ 28 275 144 323 403],796,3,27465,4.042537533117456,0.0,20.0
46794,4,6794,[258  70 748  11 210],450,4,27469,4.042531272994849,0.0,0.0
46795,4,6795,[183 257  96 238 144],655,1,27470,4.042083578575633,0.0,0.0
46796,4,6796,[161 216  12 100 204],577,5,27475,4.042224510813594,0.0,20.0
46797,4,6797,[318  79 427 588 216],577,5,27480,4.042365401588703,40.0,0.0
46798,4,6798,[121 197   8 210 300],796,3,27483,4.042212090013237,0.0,0.0
46799,4,6799,[161 135 427 286  64],389,2,27485,4.041911764705882,40.0,20.0
46800,4,6800,[ 28 546 210 294 174],796,2,27487,4.041611527716512,0.0,0.0
46801,4,6801,[318  28 568  22 237],796,4,27491,4.041605410173478,20.0,0.0
46802,4,6802,[427 118 313 435  98],450,4,27495,4.041599294428928,20.0,0.0
46803,4,6803,[282 187 748 127 125],796,5,27500,4.041740152851264,0.0,20.0
46804,4,6804,[318  79 427 588 216],18,5,27505,4.041880969875092,40.0,0.0
46805,4,6805,[318  79 427 588 216],18,5,27510,4.04202174551866,40.0,0.0
46806,4,6806,[318  79 427 588 216],450,5,27515,4.042162479800206,40.0,0.0
46807,4,6807,[318  79 427 588 216],450,5,27520,4.042303172737955,40.0,0.0
46808,4,6808,[318  79 427 588 216],796,5,27525,4.042443824350125,40.0,0.0
46809,4,6809,[  4 100 286 289  22],655,0,27525,4.041850220264317,0.0,40.0
46810,4,6810,[288 508 176 568 427],655,1,27526,4.041403611804434,20.0,0.0
46811,4,6811,[ 11 143 191 228 210],450,4,27530,4.041397533763946,0.0,0.0
46812,4,6812,[318  79 427 588 216],796,5,27535,4.0415382357258185,40.0,0.0
46813,4,6813,[318  79 427 588 216],450,5,27540,4.041678896389786,40.0,0.0
46814,4,6814,[588 100  98 603 496],796,4,27544,4.041672780630961,40.0,20.0
46815,4,6815,[185 216  69 180  22],457,5,27549,4.04181338028169,0.0,0.0
46816,4,6816,[403 471 202 222 228],450,4,27553,4.041807246589409,0.0,0.0
46817,4,6817,[275 405 300 144 174],796,5,27558,4.041947785274274,0.0,20.0
46818,4,6818,[318  79 427 588 216],577,5,27563,4.042088282739405,40.0,0.0
46819,4,6819,[435 258 185 333 172],655,2,27565,4.0417888563049855,0.0,0.0
46820,4,6820,[ 69 222  15  11 191],457,5,27570,4.041929335874506,0.0,0.0
46821,4,6821,[143  12 265  79 286],655,2,27572,4.041630020521841,0.0,20.0
46822,4,6822,[ 88 211  64  98 111],389,3,27575,4.041477356001759,20.0,0.0
46823,4,6823,[294 496 385 204 179],450,5,27580,4.041617819460727,20.0,0.0
46824,4,6824,[275 204 144 286 302],655,2,27582,4.041318681318681,0.0,40.0
46825,4,6825,[237   1 181   4 143],716,4,27586,4.041312628186346,0.0,0.0
46826,4,6826,[153  88 471 328 117],655,0,27586,4.040720667936136,0.0,0.0
46827,4,6827,[127 385 427  98 215],716,4,27590,4.040714704159344,20.0,20.0
46828,4,6828,[435 275 294 179 118],450,4,27594,4.040708742129155,0.0,20.0
46829,4,6829,[ 70  56 603 655 238],23,3,27597,4.040556368960469,20.0,0.0
46830,4,6830,[161 265 204 187 168],436,3,27600,4.040404040404041,0.0,0.0
46831,4,6831,[318  79 427 588 216],796,5,27605,4.0405444964871196,40.0,0.0
46832,4,6832,[ 97 423 228  89 191],72,3,27608,4.040392214254354,0.0,0.0
46833,4,6833,[483 258 211 237  56],796,4,27612,4.040386303775241,0.0,0.0
46834,4,6834,[ 50   1 186 257  28],835,3,27615,4.040234089246526,0.0,20.0
46835,4,6835,[196   8  69 546 471],344,2,27617,4.039935634874196,0.0,0.0
46836,4,6836,[  9 117 161  50 423],655,1,27618,4.0394910048266786,0.0,20.0
46837,4,6837,[318  79 427 588 216],796,5,27623,4.039631471190407,40.0,0.0
46838,4,6838,[405 471 161 496 286],786,5,27628,4.039771896476093,20.0,20.0
46839,4,6839,[151  96 405 435 515],807,3,27631,4.0396198830409356,0.0,0.0
46840,4,6840,[173 202 182 187  64],389,4,27635,4.039614091507089,20.0,0.0
46841,4,6841,[318  79 427 588 216],796,5,27640,4.039754457760889,40.0,0.0
46842,4,6842,[318  79 427 588 216],18,5,27645,4.039894782989917,40.0,0.0
46843,4,6843,[318  79 427 588 216],716,5,27650,4.040035067212156,40.0,0.0
46844,4,6844,[ 15  96 153 121   1],450,3,27653,4.039883126369613,0.0,0.0
46845,4,6845,[153  89 603 403 161],796,5,27658,4.040023371311715,20.0,0.0
46846,4,6846,[423 568  11 186   7],577,2,27660,4.039725427194392,0.0,0.0
46847,4,6847,[ 71 191 202 132  70],18,4,27664,4.039719626168225,0.0,0.0
46848,4,6848,[318  79 427 588 216],18,5,27669,4.0398598335523435,40.0,0.0
46849,4,6849,[318  79 427 588 216],577,5,27674,4.04,40.0,0.0
46850,4,6850,[151 186 185 237   9],535,5,27679,4.04014012552912,0.0,0.0
46851,4,6851,[153 197 471 204 175],716,3,27682,4.039988324576766,0.0,0.0
46852,4,6852,[  7 204 186 100 191],655,1,27683,4.039544724937984,0.0,20.0
46853,4,6853,[302  98 318 111   4],450,4,27687,4.039538955354537,20.0,0.0
46854,4,6854,[318  79 427 588 216],796,5,27692,4.039679066374909,40.0,0.0
46855,4,6855,[508 235 132 568 216],344,4,27696,4.039673278879813,0.0,0.0
46856,4,6856,[496 655  22 100 427],796,3,27699,4.039521656701181,40.0,20.0
46857,4,6857,[318  79 427 588 216],577,5,27704,4.039661708953047,40.0,0.0
46858,4,6858,[ 98 748  15 423 427],151,4,27708,4.039655926519901,20.0,0.0
46859,4,6859,[318  79 427 588 216],796,5,27713,4.039795918367347,40.0,0.0
46860,4,6860,[ 79 357  22 435 132],450,5,27718,4.039935869406792,0.0,0.0
46861,4,6861,[127 100 323 204 245],280,1,27719,4.0394928592247155,0.0,40.0
46862,4,6862,[257 186 435  69 168],5,3,27722,4.03934139589101,0.0,0.0
46863,4,6863,[318  79 427 588 216],450,5,27727,4.039481351981352,40.0,0.0
46864,4,6864,[ 98 288   4 125  50],593,5,27732,4.039621267297888,0.0,20.0
46865,4,6865,[318  79 427 588 216],716,5,27737,4.039761141858433,40.0,0.0
46866,4,6866,[318  79 427 588 216],796,5,27742,4.039900975680792,40.0,0.0
46867,4,6867,[318  79 427 588 216],18,5,27747,4.04004076878276,40.0,0.0
46868,4,6868,[318  79 427 588 216],18,5,27752,4.040180521182123,40.0,0.0
46869,4,6869,[318  79 427 588 216],18,5,27757,4.0403202328966525,40.0,0.0
46870,4,6870,[ 64 228 294 357 546],716,4,27761,4.040314364721293,20.0,0.0
46871,4,6871,[215 175 508 200 143],655,2,27763,4.040017462165308,0.0,0.0
46872,4,6872,[318  79 427 588 216],450,5,27768,4.040157136621563,40.0,0.0
46873,4,6873,[318  79 427 588 216],796,5,27773,4.040296770439337,40.0,0.0
46874,4,6874,[318  79 427 588 216],796,5,27778,4.040436363636363,40.0,0.0
46875,4,6875,[748 234 144 185 301],796,3,27781,4.040285049447353,0.0,0.0
46876,4,6876,[568 111  25 186 210],389,0,27781,4.039697542533081,0.0,0.0
46877,4,6877,[ 97 282  70 294 211],655,0,27781,4.039110206455365,0.0,0.0
46878,4,6878,[318  79 427 588 216],18,5,27786,4.039249890972525,40.0,0.0
46879,4,6879,[100 265 748 135  70],450,4,27790,4.039244186046512,0.0,20.0
46880,4,6880,[301  96  88 286  22],344,2,27792,4.038947827350675,0.0,20.0
46881,4,6881,[238 427 257 271  22],796,4,27796,4.038942167974426,20.0,0.0
46882,4,6882,[318  79 427 588 216],577,5,27801,4.039081795728607,40.0,0.0
46883,4,6883,[318  79 427 588 216],577,5,27806,4.039221382916908,40.0,0.0
46884,4,6884,[405  79 323 172 276],256,3,27809,4.039070442992012,0.0,0.0
46885,4,6885,[323 294 385 179 197],504,3,27812,4.038919546906767,0.0,0.0
46886,4,6886,[318  79 427 588 216],450,5,27817,4.039059096849136,40.0,0.0
46887,4,6887,[318  79 427 588 216],796,5,27822,4.039198606271777,40.0,0.0
46888,4,6888,[318  79 427 588 216],18,5,27827,4.039338075192336,40.0,0.0
46889,4,6889,[300 234 181 135  28],807,4,27831,4.03933236574746,0.0,0.0
46890,4,6890,[ 64  82 100 282  70],457,5,27836,4.039471774778697,20.0,20.0
46891,4,6891,[318  79 427 588 216],450,5,27841,4.039611143354614,40.0,0.0
46892,4,6892,[318  79 427 588 216],450,5,27846,4.039750471492819,40.0,0.0
46893,4,6893,[ 96 423 235 427  22],807,3,27849,4.0395996518711925,20.0,0.0
46894,4,6894,[318  79 427 588 216],450,5,27854,4.039738941261784,40.0,0.0
46895,4,6895,[228  56 111 202  95],577,3,27857,4.039588167053364,0.0,0.0
46896,4,6896,[405 111 546 597   1],450,5,27862,4.039727417717848,0.0,0.0
46897,4,6897,[318  79 427 588 216],716,5,27867,4.039866628008118,40.0,0.0
46898,4,6898,[265 275 191 168  64],316,3,27870,4.039715900855197,20.0,20.0
46899,4,6899,[ 25  98 483 194 475],389,4,27874,4.039710144927536,0.0,0.0
46900,4,6900,[318  79 427 588 216],450,5,27879,4.039849297203304,40.0,0.0
46901,4,6901,[210 234   4 282  89],450,2,27881,4.039553752535497,0.0,0.0
46902,4,6902,[  7 125 748 144  64],292,2,27883,4.039258293495582,20.0,0.0
46903,4,6903,[  7 333 508  50 276],839,2,27885,4.03896292004635,0.0,20.0
46904,4,6904,[318  79 427 588 216],577,5,27890,4.039102099927589,40.0,0.0
46905,4,6905,[318  79 427 588 216],716,5,27895,4.039241239501883,40.0,0.0
46906,4,6906,[200  22 191   4 176],450,3,27898,4.03909077747213,0.0,0.0
46907,4,6907,[ 69 204 435 265 125],450,5,27903,4.039229878401853,0.0,0.0
46908,4,6908,[182   7 194 211  25],264,5,27908,4.039368939064988,0.0,0.0
46909,4,6909,[ 56 144 222 235 173],280,2,27910,4.0390738060781475,0.0,0.0
46910,4,6910,[153  79 176 328 195],151,1,27911,4.038634061640862,0.0,0.0
46911,4,6911,[204  70 195  79 271],655,1,27912,4.038194444444445,0.0,0.0
46912,4,6912,[318  79 427 588 216],716,5,27917,4.038333574424996,40.0,0.0
46913,4,6913,[144 143   1 300  25],655,1,27918,4.037894127856523,0.0,0.0
46914,4,6914,[318  79 427 588 216],796,5,27923,4.0380332610267535,40.0,0.0
46915,4,6915,[318  79 427 588 216],18,5,27928,4.038172353961827,40.0,0.0
46916,4,6916,[318 210 117 276 742],280,4,27932,4.038166835333237,20.0,0.0
46917,4,6917,[318  79 427 588 216],18,5,27937,4.038305868748193,40.0,0.0
46918,4,6918,[318  79 427 588 216],18,5,27942,4.038444861974273,40.0,0.0
46919,4,6919,[ 96 117 111 215 222],796,5,27947,4.038583815028901,0.0,0.0
46920,4,6920,[427 385 265  82 195],450,4,27951,4.038578240138708,20.0,0.0
46921,4,6921,[318  79 427 588 216],450,5,27956,4.038717133776365,40.0,0.0
46922,4,6922,[ 97   1 427 245  79],450,5,27961,4.0388559872887475,20.0,0.0
46923,4,6923,[357 144 237 597 182],796,5,27966,4.038994800693241,0.0,0.0
46924,4,6924,[588 211 568 168 174],389,4,27970,4.03898916967509,0.0,0.0
46925,4,6925,[318  79 427 588 216],18,5,27975,4.0391279237655215,40.0,0.0
46926,4,6926,[357 257 471 318 173],457,4,27979,4.03912227515519,20.0,0.0
46927,4,6927,[135 385 215  82 288],280,3,27982,4.0389722863741335,0.0,0.0
46928,4,6928,[318  79 427 588 216],796,5,27987,4.039110982825805,40.0,0.0
46929,4,6929,[318  79 427 588 216],796,5,27992,4.039249639249639,40.0,0.0
46930,4,6930,[318  79 427 588 216],577,5,27997,4.0393882556629634,40.0,0.0
46931,4,6931,[318  79 427 588 216],796,5,28002,4.039526832083093,40.0,0.0
46932,4,6932,[168 174 483  56 118],151,4,28006,4.039521130823597,0.0,0.0
46933,4,6933,[318  79 427 588 216],450,5,28011,4.039659648110758,40.0,0.0
46934,4,6934,[318  79 427 588 216],716,5,28016,4.039798125450613,40.0,0.0
46935,4,6935,[211 125 153  97 182],18,4,28020,4.039792387543253,0.0,0.0
46936,4,6936,[318  79 427 588 216],577,5,28025,4.039930805823843,40.0,0.0
46937,4,6937,[117 196 118  28  88],796,4,28029,4.039925050446815,0.0,0.0
46938,4,6938,[185 748  50 385 222],256,5,28034,4.040063409713215,0.0,20.0
46939,4,6939,[300 174 181  50 125],655,1,28035,4.039625360230548,0.0,20.0
46940,4,6940,[588  69 153 237   9],18,3,28038,4.0394755798876245,0.0,0.0
46941,4,6941,[318  79 427 588 216],796,5,28043,4.039613944108326,40.0,0.0
46942,4,6942,[318  79 427 588 216],716,5,28048,4.039752268471842,40.0,0.0
46943,4,6943,[151  96  64 117 216],796,5,28053,4.0398905529953915,20.0,0.0
46944,4,6944,[228 357 180 111  79],716,4,28057,4.039884809215263,0.0,0.0
46945,4,6945,[333 211 234 655   1],796,1,28058,4.039447163835301,0.0,0.0
46946,4,6946,[117 405 228 174 161],577,3,28061,4.03929753850583,0.0,0.0
46947,4,6947,[216 475 385 288 197],655,1,28062,4.038860103626943,0.0,0.0
46948,4,6948,[318 143 196 234 111],716,5,28067,4.038998417038423,20.0,0.0
46949,4,6949,[318  79 427 588 216],18,5,28072,4.039136690647482,40.0,0.0
46950,4,6950,[318  79 427 588 216],796,5,28077,4.039274924471299,40.0,0.0
46951,4,6951,[182 185 195 222 204],796,5,28082,4.039413118527043,0.0,0.0
46952,4,6952,[318  79 427 588 216],796,5,28087,4.039551272831871,40.0,0.0
46953,4,6953,[318  79 427 588 216],577,5,28092,4.039689387402934,40.0,0.0
46954,4,6954,[318 121  28 496 322],450,4,28096,4.039683680805176,40.0,0.0
46955,4,6955,[318  79 427 588 216],716,5,28101,4.039821736630247,40.0,0.0
46956,4,6956,[318  79 427 588 216],796,5,28106,4.039959752766998,40.0,0.0
46957,4,6957,[318  79 427 588 216],796,5,28111,4.040097729232538,40.0,0.0
46958,4,6958,[ 71 328   4 603 200],450,2,28113,4.039804569622072,20.0,0.0
46959,4,6959,[318  79 427 588 216],796,5,28118,4.039942528735632,40.0,0.0
46960,4,6960,[237 318  70   4 265],655,1,28119,4.039505818129579,20.0,0.0
46961,4,6961,[ 11 288 174 301 228],344,4,28123,4.039500143636886,0.0,0.0
46962,4,6962,[173 132 403  50 117],796,5,28128,4.039638087031452,0.0,20.0
46963,4,6963,[228 215  50 176 183],280,0,28128,4.039058012636416,0.0,20.0
46964,4,6964,[318  79 427 588 216],796,5,28133,4.039195979899498,40.0,0.0
46965,4,6965,[187 322 471 186 153],450,4,28137,4.039190353143842,0.0,0.0
46966,4,6966,[185 215 234 135 200],655,3,28140,4.039041194201235,0.0,0.0
46967,4,6967,[318  79 427 588 216],577,5,28145,4.039179104477612,40.0,0.0
46968,4,6968,[  7 144 475 100 197],629,4,28149,4.039173482565648,0.0,20.0
46969,4,6969,[ 22  12  15   4 100],577,4,28153,4.039167862266858,0.0,20.0
46970,4,6970,[385  50 173 748 496],450,5,28158,4.039305695022235,20.0,20.0
46971,4,6971,[151 153 215   1   4],450,4,28162,4.039300057372347,0.0,0.0
46972,4,6972,[100  12   4 265  88],577,4,28166,4.039294421339452,0.0,20.0
46973,4,6973,[742  56   1 194 282],796,3,28169,4.039145397189562,0.0,0.0
46974,4,6974,[215 300 234 174 100],796,3,28172,4.038996415770609,0.0,20.0
46975,4,6975,[ 82 210   4 313 194],796,3,28175,4.03884747706422,0.0,0.0
46976,4,6976,[300 186 313 238 153],450,4,28179,4.0388419091299985,0.0,0.0
46977,4,6977,[ 22  70 204  98 294],716,5,28184,4.038979650329607,0.0,0.0
46978,4,6978,[568 275 405 301 282],450,5,28189,4.039117352056168,0.0,20.0
46979,4,6979,[318  79 427 588 216],716,5,28194,4.039255014326647,40.0,0.0
46980,4,6980,[546 435   1 496 235],716,3,28197,4.039106145251397,20.0,0.0
46981,4,6981,[215  98 603 173 176],23,3,28200,4.038957318819822,20.0,0.0
46982,4,6982,[318  79 427 588 216],18,5,28205,4.039094944866103,40.0,0.0
46983,4,6983,[ 82 172 181 385 100],330,5,28210,4.039232531500573,0.0,20.0
46984,4,6984,[318  79 427 588 216],716,5,28215,4.039370078740157,40.0,0.0
46985,4,6985,[318  79 427 588 216],577,5,28220,4.039507586601775,40.0,0.0
46986,4,6986,[318  79 427 588 216],577,5,28225,4.039645055102333,40.0,0.0
46987,4,6987,[318  79 427 588 216],716,5,28230,4.039782484258729,40.0,0.0
46988,4,6988,[  7 143  96 427 357],269,2,28232,4.0394906281299185,20.0,0.0
46989,4,6989,[ 22 237 202  82 161],796,4,28236,4.039484978540773,0.0,0.0
46990,4,6990,[405 496 546  28 294],796,3,28239,4.039336289515091,20.0,0.0
46991,4,6991,[ 64 294 318 125 172],577,5,28244,4.0394736842105265,40.0,0.0
46992,4,6992,[318  79 427 588 216],796,5,28249,4.03961103961104,40.0,0.0
46993,4,6993,[ 89 301 275   1 185],450,5,28254,4.039748355733486,0.0,20.0
46994,4,6994,[237  15 100 194 135],72,4,28258,4.0397426733380986,0.0,20.0
46995,4,6995,[318  79 427 588 216],716,5,28263,4.039879931389366,40.0,0.0
46996,4,6996,[318  79 427 588 216],577,5,28268,4.040017150207231,40.0,0.0
46997,4,6997,[318  79 427 588 216],18,5,28273,4.040154329808517,40.0,0.0
46998,4,6998,[318  79 427 588 216],716,5,28278,4.04029147021003,40.0,0.0
46999,4,6999,[318  79 427 588 216],18,5,28283,4.0404285714285715,40.0,0.0
47000,4,7000,[318  79 427 588 216],796,5,28288,4.040565633480932,40.0,0.0
47001,4,7001,[318  79 427 588 216],577,5,28293,4.04070265638389,40.0,0.0
47002,4,7002,[302 202 210 200 186],151,3,28296,4.0405540482650295,0.0,0.0
47003,4,7003,[235 100 143 173  11],401,2,28298,4.040262707024557,0.0,20.0
47004,4,7004,[302 282 127 357 132],655,3,28301,4.0401142041399,0.0,20.0
47005,4,7005,[318  79 427 588 216],716,5,28306,4.0402512132457895,40.0,0.0
47006,4,7006,[175 204  28  25 405],716,4,28310,4.040245468816897,0.0,0.0
47007,4,7007,[151 181 258  97 153],796,4,28314,4.040239726027397,0.0,0.0
47008,4,7008,[125  22 245 191  11],224,2,28316,4.039948637466115,0.0,0.0
47009,4,7009,[427 197 183  88 117],450,5,28321,4.040085592011413,20.0,0.0
47010,4,7010,[173  50   4 238  89],796,4,28325,4.040079874482955,0.0,20.0
47011,4,7011,[125 403 202  88 200],450,4,28329,4.040074158585282,0.0,0.0
47012,4,7012,[ 70 471  82 269 187],655,1,28330,4.0396406673320975,0.0,0.0
47013,4,7013,[187 197  69 179 282],504,3,28333,4.03949244368406,0.0,0.0
47014,4,7014,[318  79 427 588 216],18,5,28338,4.039629365645046,40.0,0.0
47015,4,7015,[318 197 132  82   9],457,5,28343,4.039766248574686,20.0,0.0
47016,4,7016,[ 56 265  82 258 275],796,4,28347,4.039760581445062,0.0,20.0
47017,4,7017,[174   4 196 125 144],796,5,28352,4.039897406668566,0.0,0.0
47018,4,7018,[197 182 153 588 237],18,4,28356,4.039891722467588,0.0,0.0
47019,4,7019,[318  79 427 588 216],796,5,28361,4.04002849002849,40.0,0.0
47020,4,7020,[318  79 427 588 216],716,5,28366,4.0401652186298245,40.0,0.0
47021,4,7021,[318  79 427 588 216],450,5,28371,4.040301908288237,40.0,0.0
47022,4,7022,[185 135 172 183 179],450,4,28375,4.040296169728037,0.0,0.0
47023,4,7023,[318  79 427 588 216],716,5,28380,4.040432801822323,40.0,0.0
47024,4,7024,[318  79 427 588 216],577,5,28385,4.040569395017793,40.0,0.0
47025,4,7025,[144  96 258 427 186],655,1,28386,4.040136635354398,20.0,0.0
47026,4,7026,[423  96 275  22  98],655,2,28388,4.039846307101181,0.0,20.0
47027,4,7027,[144 153 403 202 300],796,5,28393,4.039982925441093,0.0,0.0
47028,4,7028,[318  79 427 588 216],577,5,28398,4.040119504908238,40.0,0.0
47029,4,7029,[318  79 427 588 216],577,5,28403,4.040256045519204,40.0,0.0
47030,4,7030,[174 121  89 237  22],450,4,28407,4.040250320011379,0.0,0.0
47031,4,7031,[357 143 288 132 153],450,4,28411,4.040244596131968,0.0,0.0
47032,4,7032,[196 269 568 471   8],344,4,28415,4.040238873880279,0.0,0.0
47033,4,7033,[318  79 427 588 216],796,5,28420,4.040375319874894,40.0,0.0
47034,4,7034,[300 202 235  22 144],450,4,28424,4.040369580668088,0.0,0.0
47035,4,7035,[405 471   1  50  79],256,5,28429,4.040505969300739,0.0,20.0
47036,4,7036,[318  79 427 588 216],577,5,28434,4.040642319170101,40.0,0.0
47037,4,7037,[117   1 275 235  79],756,3,28437,4.0404944586530265,0.0,20.0
47038,4,7038,[603 265 427  88 151],716,5,28442,4.040630771416394,40.0,0.0
47039,4,7039,[ 56 435 269 174  97],450,5,28447,4.040767045454546,0.0,0.0
47040,4,7040,[ 96 186 173 176 151],796,4,28451,4.0407612555034795,0.0,0.0
47041,4,7041,[403  69 265 127 483],655,2,28453,4.040471456972451,0.0,20.0
47042,4,7042,[318  79 427 588 216],577,5,28458,4.040607695584268,40.0,0.0
47043,4,7043,[318  79 427 588 216],796,5,28463,4.040743895513913,40.0,0.0
47044,4,7044,[318  79 427 588 216],450,5,28468,4.040880056777857,40.0,0.0
47045,4,7045,[318  79 427 588 216],796,5,28473,4.041016179392563,40.0,0.0
47046,4,7046,[748 195 258 273 483],796,4,28477,4.0410103590180215,0.0,0.0
47047,4,7047,[318  79 427 588 216],18,5,28482,4.041146424517594,40.0,0.0
47048,4,7048,[318  79 427 588 216],796,5,28487,4.041282451411548,40.0,0.0
47049,4,7049,[318  79 427 588 216],796,5,28492,4.041418439716312,40.0,0.0
47050,4,7050,[318  79 427 588 216],450,5,28497,4.041554389448305,40.0,0.0
47051,4,7051,[ 96 235 405 135 175],457,4,28501,4.041548496880318,0.0,0.0
47052,4,7052,[318  79 427 588 216],18,5,28506,4.041684389621437,40.0,0.0
47053,4,7053,[318  79 427 588 216],18,5,28511,4.041820243833286,40.0,0.0
47054,4,7054,[318  79 427 588 216],796,5,28516,4.041956059532247,40.0,0.0
47055,4,7055,[318  79 427 588 216],716,5,28521,4.042091836734694,40.0,0.0
47056,4,7056,[318  79 427 588 216],716,5,28526,4.042227575456993,40.0,0.0
47057,4,7057,[318  79 427 588 216],716,5,28531,4.0423632757155,40.0,0.0
47058,4,7058,[151 603  97  89  79],756,4,28535,4.042357274401473,20.0,0.0
47059,4,7059,[405 135 238   1 294],655,1,28536,4.041926345609065,0.0,0.0
47060,4,7060,[132 100 222 483 597],23,4,28540,4.041920407874239,0.0,20.0
47061,4,7061,[318  79 427 588 216],796,5,28545,4.042056074766355,40.0,0.0
47062,4,7062,[568 172 318 216 215],330,5,28550,4.042191703242248,20.0,0.0
47063,4,7063,[ 11  82 357 228 313],655,2,28552,4.041902604756512,0.0,0.0
47064,4,7064,[ 69 100 508 194 748],401,2,28554,4.041613588110404,0.0,20.0
47065,4,7065,[357  50   9 181 322],796,3,28557,4.041466176054345,0.0,20.0
47066,4,7066,[318  79 427 588 216],796,5,28562,4.041601811235319,40.0,0.0
47067,4,7067,[318  79 427 588 216],716,5,28567,4.041737408036219,40.0,0.0
47068,4,7068,[318  79 427 588 216],796,5,28572,4.041872966473334,40.0,0.0
47069,4,7069,[ 98 210  89  25 271],655,2,28574,4.041584158415842,0.0,0.0
47070,4,7070,[  1  98  71 125 228],786,5,28579,4.041719700183849,0.0,0.0
47071,4,7071,[318  79 427 588 216],577,5,28584,4.041855203619909,40.0,0.0
47072,4,7072,[ 28 405 215 186 117],450,4,28588,4.041849286017249,0.0,0.0
47073,4,7073,[318  79 427 588 216],450,5,28593,4.041984732824427,40.0,0.0
47074,4,7074,[127 183 385 195 153],504,3,28596,4.041837455830389,0.0,20.0
47075,4,7075,[182 276 275 151 546],457,4,28600,4.041831543244771,0.0,20.0
47076,4,7076,[318  79 427 588 216],577,5,28605,4.0419669351420096,40.0,0.0
47077,4,7077,[318  79 427 588 216],450,5,28610,4.042102288782142,40.0,0.0
47078,4,7078,[313   1  97  89 202],655,2,28612,4.0418138155106655,0.0,0.0
47079,4,7079,[ 97 172  15 275  64],330,5,28617,4.041949152542373,20.0,20.0
47080,4,7080,[265  71 483 135 405],450,2,28619,4.041660782375371,0.0,0.0
47081,4,7081,[318  79 427 588 216],796,5,28624,4.0417961027958205,40.0,0.0
47082,4,7082,[318  79 427 588 216],716,5,28629,4.041931385006353,40.0,0.0
47083,4,7083,[ 56 175 143 333 385],655,1,28630,4.041501976284585,0.0,0.0
47084,4,7084,[318  79 427 588 216],796,5,28635,4.041637261820748,40.0,0.0
47085,4,7085,[318  79 427 588 216],716,5,28640,4.0417725091730174,40.0,0.0
47086,4,7086,[ 88 275 301 121 286],593,4,28644,4.041766614928743,0.0,40.0
47087,4,7087,[318  79 427 588 216],18,5,28649,4.041901805869075,40.0,0.0
47088,4,7088,[179 655 161 238 215],655,1,28650,4.04147270418959,0.0,0.0
47089,4,7089,[318  79 427 588 216],450,5,28655,4.041607898448519,40.0,0.0
47090,4,7090,[173   4 211  11 127],716,4,28659,4.041602030743196,0.0,20.0
47091,4,7091,[318  79 427 588 216],796,5,28664,4.041737168640722,40.0,0.0
47092,4,7092,[195 655 238   7 191],457,5,28669,4.041872268433667,0.0,0.0
47093,4,7093,[318  79 427 588 216],716,5,28674,4.042007330138145,40.0,0.0
47094,4,7094,[435 144 235 181 210],716,3,28677,4.0418604651162795,0.0,0.0
47095,4,7095,[318  79 427 588 216],796,5,28682,4.041995490417136,40.0,0.0
47096,4,7096,[144 282 275 197 187],716,2,28684,4.041707763843878,0.0,20.0
47097,4,7097,[288 186 144 175 265],655,0,28684,4.041138348830657,0.0,0.0
47098,4,7098,[318  79 427 588 216],18,5,28689,4.041273418791379,40.0,0.0
47099,4,7099,[318  79 427 588 216],796,5,28694,4.041408450704226,40.0,0.0
47100,4,7100,[ 15  95 568 172 546],577,2,28696,4.041120968877623,0.0,0.0
47101,4,7101,[216 185   8 222 275],23,5,28701,4.041255984229794,0.0,20.0
47102,4,7102,[318  79 427 588 216],577,5,28706,4.0413909615655355,40.0,0.0
47103,4,7103,[427 195 176   4  88],796,5,28711,4.041525900900901,20.0,0.0
47104,4,7104,[318  79 427 588 216],796,5,28716,4.041660802251935,40.0,0.0
47105,4,7105,[100 197 181 168 174],503,5,28721,4.041795665634675,0.0,20.0
47106,4,7106,[237  82 200  97 182],655,2,28723,4.041508372027579,0.0,0.0
47107,4,7107,[318  79 427 588 216],577,5,28728,4.0416432189082725,40.0,0.0
47108,4,7108,[301 202  71  50 276],344,4,28732,4.041637361091574,0.0,20.0
47109,4,7109,[  7  79 742 202 216],450,5,28737,4.041772151898734,0.0,0.0
47110,4,7110,[ 11  50 275  88 258],450,5,28742,4.041906904795387,0.0,40.0
47111,4,7111,[318  79 427 588 216],716,5,28747,4.0420416197975255,40.0,0.0
47112,4,7112,[172  82   8 132  11],280,3,28750,4.041895121608323,0.0,0.0
47113,4,7113,[196  82 176 117  79],577,5,28755,4.04202980039359,0.0,0.0
47114,4,7114,[265 215 176 161  56],72,4,28759,4.042023893183416,0.0,0.0
47115,4,7115,[471 172 204 427 235],450,4,28763,4.042017987633502,20.0,0.0
47116,4,7116,[318  79 427 588 216],796,5,28768,4.042152592384432,40.0,0.0
47117,4,7117,[318  79 427 588 216],577,5,28773,4.042287159314414,40.0,0.0
47118,4,7118,[318  79 427 588 216],577,5,28778,4.042421688439387,40.0,0.0
47119,4,7119,[318  79 427 588 216],450,5,28783,4.042556179775281,40.0,0.0
47120,4,7120,[318  79 427 588 216],18,5,28788,4.042690633338014,40.0,0.0
47121,4,7121,[318  79 427 588 216],577,5,28793,4.042825049143499,40.0,0.0
47122,4,7122,[ 79  12 182 196 273],796,4,28797,4.042819036922645,0.0,0.0
47123,4,7123,[318  79 427 588 216],796,5,28802,4.042953396967995,40.0,0.0
47124,4,7124,[174 186 588  82 187],389,4,28806,4.042947368421053,0.0,0.0
47125,4,7125,[200 546 211 191 301],450,4,28810,4.042941341566096,0.0,0.0
47126,4,7126,[318  79 427 588 216],450,5,28815,4.043075627893924,40.0,0.0
47127,4,7127,[313 234 265 111 117],577,4,28819,4.043069584736251,0.0,0.0
47128,4,7128,[318  79 427 588 216],796,5,28824,4.0432038154018795,40.0,0.0
47129,4,7129,[318  79 427 588 216],450,5,28829,4.043338008415147,40.0,0.0
47130,4,7130,[197 182 257 191 385],796,4,28833,4.043331931005469,0.0,0.0
47131,4,7131,[  4  79 357 210 211],593,4,28837,4.043325855300056,0.0,0.0
47132,4,7132,[318  79 427 588 216],18,5,28842,4.043459974765176,40.0,0.0
47133,4,7133,[318  79 427 588 216],577,5,28847,4.043594056630221,40.0,0.0
47134,4,7134,[483  64  56 427 172],236,4,28851,4.0435879467414155,40.0,0.0
47135,4,7135,[405 121 174 144 127],457,5,28856,4.04372197309417,0.0,20.0
47136,4,7136,[127  69 313  96 222],655,2,28858,4.043435617206109,0.0,20.0
47137,4,7137,[318  79 427 588 216],796,5,28863,4.043569627346596,40.0,0.0
47138,4,7138,[318  79 427 588 216],716,5,28868,4.04370359994397,40.0,0.0
47139,4,7139,[496 742   8 168  82],796,3,28871,4.0435574229691875,20.0,0.0
47140,4,7140,[118 423 210 275  79],655,2,28873,4.0432712505251365,0.0,20.0
47141,4,7141,[318  79 427 588 216],716,5,28878,4.043405208625035,40.0,0.0
47142,4,7142,[318  79 427 588 216],18,5,28883,4.043539129217415,40.0,0.0
47143,4,7143,[318  79 427 588 216],18,5,28888,4.043673012318029,40.0,0.0
47144,4,7144,[161  12  79 135 282],457,5,28893,4.043806857942617,0.0,0.0
47145,4,7145,[318  79 427 588 216],577,5,28898,4.043940666106913,40.0,0.0
47146,4,7146,[427 234 197 318 176],72,4,28902,4.043934517979572,40.0,0.0
47147,4,7147,[318  79 427 588 216],796,5,28907,4.044068270844992,40.0,0.0
47148,4,7148,[234 655 183 174 237],457,5,28912,4.044201986291789,0.0,0.0
47149,4,7149,[269 288 357  71   8],344,4,28916,4.044195804195804,0.0,0.0
47150,4,7150,[318  79 427 588 216],18,5,28921,4.044329464410572,40.0,0.0
47151,4,7151,[204 215 175 237 185],11,2,28923,4.044043624161074,0.0,0.0
47152,4,7152,[318  79 427 588 216],577,5,28928,4.044177268279044,40.0,0.0
47153,4,7153,[  4 100 118 174  97],796,3,28931,4.0440313111545985,0.0,20.0
47154,4,7154,[318  79 427 588 216],18,5,28936,4.044164919636618,40.0,0.0
47155,4,7155,[318  79 427 588 216],577,5,28941,4.044298490776971,40.0,0.0
47156,4,7156,[173 174  69 197 168],796,4,28945,4.044292301243538,0.0,0.0
47157,4,7157,[318  79 427 588 216],577,5,28950,4.044425817267393,40.0,0.0
47158,4,7158,[  1  28 204 186 181],796,2,28952,4.044140243050705,0.0,0.0
47159,4,7159,[  4 195 568 234 180],457,5,28957,4.04427374301676,0.0,0.0
47160,4,7160,[318  79 427 588 216],577,5,28962,4.044407205697528,40.0,0.0
47161,4,7161,[ 64  50 185  22  89],316,2,28964,4.044121753700084,20.0,20.0
47162,4,7162,[318  79 427 588 216],796,5,28969,4.044255200335055,40.0,0.0
47163,4,7163,[318  79 427 588 216],18,5,28974,4.044388609715243,40.0,0.0
47164,4,7164,[748  56 175 151 222],151,4,28978,4.044382414515003,0.0,0.0
47165,4,7165,[318  79 427 588 216],716,5,28983,4.044515768908735,40.0,0.0
47166,4,7166,[318  79 427 588 216],577,5,28988,4.044649086089019,40.0,0.0
47167,4,7167,[121 427 655 597 748],796,4,28992,4.044642857142857,20.0,0.0
47168,4,7168,[ 95 181 301  64 222],450,3,28995,4.044497140465895,20.0,0.0
47169,4,7169,[ 12 172  96 268 111],344,4,28999,4.044490934449094,0.0,0.0
47170,4,7170,[318  79 427 588 216],18,5,29004,4.044624180727932,40.0,0.0
47171,4,7171,[300 546 318 385 423],450,5,29009,4.044757389849415,20.0,0.0
47172,4,7172,[ 82 271 328  15 143],796,4,29013,4.044751150146382,0.0,0.0
47173,4,7173,[143 655 288 568  25],450,3,29016,4.044605519933092,0.0,0.0
47174,4,7174,[318  79 427 588 216],796,5,29021,4.044738675958188,40.0,0.0
47175,4,7175,[318  79 427 588 216],450,5,29026,4.044871794871795,40.0,0.0
47176,4,7176,[318  79 427 588 216],796,5,29031,4.045004876689425,40.0,0.0
47177,4,7177,[318  79 427 588 216],577,5,29036,4.045137921426581,40.0,0.0
47178,4,7178,[318  79 427 588 216],450,5,29041,4.04527092909876,40.0,0.0
47179,4,7179,[318  79 427 588 216],716,5,29046,4.045403899721449,40.0,0.0
47180,4,7180,[289  98 385 135 186],655,2,29048,4.045119064197187,0.0,0.0
47181,4,7181,[ 88 172 121 153 237],796,5,29053,4.045252018936229,0.0,0.0
47182,4,7182,[318  79 427 588 216],450,5,29058,4.045384936655993,40.0,0.0
47183,4,7183,[318  79 427 588 216],577,5,29063,4.0455178173719375,40.0,0.0
47184,4,7184,[318  79 427 588 216],796,5,29068,4.045650661099513,40.0,0.0
47185,4,7185,[238 286 357 588 235],450,4,29072,4.0456443083774,0.0,20.0
47186,4,7186,[318  79 427 588 216],450,5,29077,4.04577709753722,40.0,0.0
47187,4,7187,[135 427 275 294 588],450,4,29081,4.045770728992766,20.0,20.0
47188,4,7188,[318  79 427 588 216],796,5,29086,4.045903463624983,40.0,0.0
47189,4,7189,[318  79 427 588 216],450,5,29091,4.046036161335188,40.0,0.0
47190,4,7190,[318  79 427 588 216],18,5,29096,4.046168822138784,40.0,0.0
47191,4,7191,[318  79 427 588 216],450,5,29101,4.046301446051168,40.0,0.0
47192,4,7192,[318  79 427 588 216],796,5,29106,4.046434033087724,40.0,0.0
47193,4,7193,[318  79 427 588 216],577,5,29111,4.046566583263831,40.0,0.0
47194,4,7194,[603 181  96 132 127],796,5,29116,4.046699096594858,20.0,20.0
47195,4,7195,[301  97 125  70 151],151,5,29121,4.046831573096164,0.0,0.0
47196,4,7196,[ 56 215  96 427  28],655,1,29122,4.046408225649576,20.0,0.0
47197,4,7197,[318  79 427 588 216],796,5,29127,4.046540705751598,40.0,0.0
47198,4,7198,[318  79 427 588 216],796,5,29132,4.046673149048479,40.0,0.0
47199,4,7199,[144 286 197  15 210],655,0,29132,4.046111111111111,0.0,20.0
47200,4,7200,[  7 197 302 191  22],269,2,29134,4.0458269684766,0.0,0.0
47201,4,7201,[318  79 427 588 216],716,5,29139,4.045959455706748,40.0,0.0
47202,4,7202,[ 88 603 181 180 215],450,5,29144,4.046091906150215,20.0,0.0
47203,4,7203,[195 588  25 211 471],716,3,29147,4.045946696279844,0.0,0.0
47204,4,7204,[ 69   1  70 234 286],450,4,29151,4.045940319222762,0.0,20.0
47205,4,7205,[318  79 427 588 216],577,5,29156,4.046072717180127,40.0,0.0
47206,4,7206,[405 275 301 127 288],655,2,29158,4.045788816428472,0.0,40.0
47207,4,7207,[318  79 427 588 216],796,5,29163,4.045921198668147,40.0,0.0
47208,4,7208,[ 79 186 196 127  15],796,4,29167,4.045914828686365,0.0,20.0
47209,4,7209,[318  79 427 588 216],577,5,29172,4.046047156726768,40.0,0.0
47210,4,7210,[318  79 427 588 216],450,5,29177,4.046179448065455,40.0,0.0
47211,4,7211,[187 222 111 483 294],236,3,29180,4.046034387132557,0.0,0.0
47212,4,7212,[ 28 194 191 215 300],796,4,29184,4.046028004990989,0.0,0.0
47213,4,7213,[318  79 427 588 216],450,5,29189,4.046160243970058,40.0,0.0
47214,4,7214,[186 200 313 185 257],835,4,29193,4.046153846153846,0.0,0.0
47215,4,7215,[ 50 127 483  64 197],18,5,29198,4.046286031042128,20.0,40.0
47216,4,7216,[215 204 127  97 222],796,4,29202,4.046279617569628,0.0,20.0
47217,4,7217,[181 195  25 357 172],330,4,29206,4.046273205874203,0.0,0.0
47218,4,7218,[ 88 496 183  56 174],269,2,29208,4.045989749272753,20.0,0.0
47219,4,7219,[318  79 427 588 216],18,5,29213,4.04612188365651,40.0,0.0
47220,4,7220,[127 313 655   4 132],796,4,29217,4.046115496468633,0.0,20.0
47221,4,7221,[318  79 427 588 216],716,5,29222,4.046247576848518,40.0,0.0
47222,4,7222,[318  79 427 588 216],18,5,29227,4.0463796206562375,40.0,0.0
47223,4,7223,[318  79 427 588 216],18,5,29232,4.046511627906977,40.0,0.0
47224,4,7224,[435 200 234 313 196],655,2,29234,4.046228373702422,0.0,0.0
47225,4,7225,[357   4 655 302 211],151,4,29238,4.046221976197066,0.0,0.0
47226,4,7226,[318  79 427 588 216],18,5,29243,4.04635395046354,40.0,0.0
47227,4,7227,[318  79 427 588 216],716,5,29248,4.046485888212507,40.0,0.0
47228,4,7228,[ 50   1  56 471 405],655,1,29249,4.04606446258127,0.0,20.0
47229,4,7229,[ 82 275 202 603  79],798,3,29252,4.0459197786998615,20.0,20.0
47230,4,7230,[318  79 427 588 216],577,5,29257,4.046051721753561,40.0,0.0
47231,4,7231,[603 222 181 228 215],72,2,29259,4.045768805309734,20.0,0.0
47232,4,7232,[318  79 427 588 216],18,5,29264,4.045900732752662,40.0,0.0
47233,4,7233,[185 333 187 313 216],796,5,29269,4.046032623721316,0.0,0.0
47234,4,7234,[318  79 427 588 216],716,5,29274,4.046164478230822,40.0,0.0
47235,4,7235,[176  96 228 117 403],72,2,29276,4.045881702598121,0.0,0.0
47236,4,7236,[318  79 427 588 216],796,5,29281,4.04601354152273,40.0,0.0
47237,4,7237,[176 202 186   9 405],457,5,29286,4.046145344017685,0.0,0.0
47238,4,7238,[318  79 427 588 216],796,5,29291,4.04627711009808,40.0,0.0
47239,4,7239,[318 405  82  28  71],450,3,29294,4.046132596685083,20.0,0.0
47240,4,7240,[318  79 427 588 216],18,5,29299,4.046264328131474,40.0,0.0
47241,4,7241,[357 655 121 258 333],796,4,29303,4.046257939795637,0.0,0.0
47242,4,7242,[318  79 427 588 216],450,5,29308,4.0463896175617835,40.0,0.0
47243,4,7243,[508  15 475 603 238],269,4,29312,4.046383213694091,20.0,0.0
47244,4,7244,[403 483 237 153 204],18,2,29314,4.046100759144237,0.0,0.0
47245,4,7245,[318  79 427 588 216],716,5,29319,4.046232404085012,40.0,0.0
47246,4,7246,[195  22 179   4 180],450,4,29323,4.0462260245618875,0.0,0.0
47247,4,7247,[318  79 427 588 216],796,5,29328,4.046357615894039,40.0,0.0
47248,4,7248,[ 97 300  98   4 186],716,3,29331,4.046213270795972,0.0,0.0
47249,4,7249,[216 144 405 186 204],716,3,29334,4.046068965517241,0.0,0.0
47250,4,7250,[318  79 427 588 216],450,5,29339,4.046200524065646,40.0,0.0
47251,4,7251,[ 25 174   7 288 471],344,4,29343,4.0461941533370105,0.0,0.0
47252,4,7252,[176 194   7 181 173],577,4,29347,4.04618778436509,0.0,0.0
47253,4,7253,[318  79 427 588 216],18,5,29352,4.046319272125724,40.0,0.0
47254,4,7254,[318  79 427 588 216],450,5,29357,4.04645072363887,40.0,0.0
47255,4,7255,[294 197 179 568 588],450,5,29362,4.046582138919515,0.0,0.0
47256,4,7256,[318  79 427 588 216],18,5,29367,4.046713517982638,40.0,0.0
47257,4,7257,[318  79 427 588 216],796,5,29372,4.0468448608432075,40.0,0.0
47258,4,7258,[655 121  28 483 127],796,3,29375,4.046700647472104,0.0,20.0
47259,4,7259,[318  79 427 588 216],796,5,29380,4.046831955922865,40.0,0.0
47260,4,7260,[135  22 313 273 187],655,4,29384,4.0468255061286325,0.0,0.0
47261,4,7261,[222  12 302 176 427],655,2,29386,4.046543651886533,20.0,0.0
47262,4,7262,[318  79 427 588 216],450,5,29391,4.04667492771582,40.0,0.0
47263,4,7263,[ 82  70 168 174 100],18,3,29394,4.046530837004405,0.0,20.0
47264,4,7264,[288 143  98 265  95],436,3,29397,4.046386785960083,0.0,0.0
47265,4,7265,[117 151 405 161  25],450,4,29401,4.0463804018717315,0.0,0.0
47266,4,7266,[318  79 427 588 216],18,5,29406,4.046511627906977,40.0,0.0
47267,4,7267,[265 289 508 275 181],655,1,29407,4.046092460099064,0.0,20.0
47268,4,7268,[176  88 322 100 276],280,2,29409,4.04581097812629,0.0,20.0
47269,4,7269,[ 50  12  11 318 172],450,5,29414,4.045942228335626,20.0,20.0
47270,4,7270,[318  79 427 588 216],577,5,29419,4.04607344244258,40.0,0.0
47271,4,7271,[ 56 172 195 483 174],535,3,29422,4.045929592959296,0.0,0.0
47272,4,7272,[318  79 427 588 216],796,5,29427,4.046060772721023,40.0,0.0
47273,4,7273,[313 265  95 215 471],450,4,29431,4.0460544404729175,0.0,0.0
47274,4,7274,[318  79 427 588 216],716,5,29436,4.046185567010309,40.0,0.0
47275,4,7275,[175 483 191  69 195],655,2,29438,4.045904343045629,0.0,0.0
47276,4,7276,[ 96  98  71 235 202],23,2,29440,4.045623196372131,0.0,0.0
47277,4,7277,[216 196 210 179 187],786,5,29445,4.045754328112118,0.0,0.0
47278,4,7278,[318  79 427 588 216],577,5,29450,4.045885423821954,40.0,0.0
47279,4,7279,[318  79 427 588 216],18,5,29455,4.046016483516484,40.0,0.0
47280,4,7280,[496 144 125 237  71],280,2,29457,4.045735475896168,20.0,0.0
47281,4,7281,[318  79 427 588 216],18,5,29462,4.045866520186762,40.0,0.0
47282,4,7282,[ 89 275  96 258 427],450,5,29467,4.045997528491006,20.0,20.0
47283,4,7283,[173 135 144  22 215],535,2,29469,4.045716639209226,0.0,0.0
47284,4,7284,[294  89 182 588 202],450,5,29474,4.045847632120796,0.0,0.0
47285,4,7285,[318  79 427 588 216],716,5,29479,4.045978589074938,40.0,0.0
47286,4,7286,[318  79 427 588 216],577,5,29484,4.046109510086455,40.0,0.0
47287,4,7287,[318  89  12  15 211],18,4,29488,4.046103183315038,20.0,0.0
47288,4,7288,[318  79 427 588 216],450,5,29493,4.0462340513101935,40.0,0.0
47289,4,7289,[318  79 427 588 216],716,5,29498,4.04636488340192,40.0,0.0
47290,4,7290,[318  79 427 588 216],577,5,29503,4.046495679604992,40.0,0.0
47291,4,7291,[215  50 176  11  97],344,2,29505,4.04621503017005,0.0,20.0
47292,4,7292,[125 275 181 161 179],450,5,29510,4.046345811051693,0.0,20.0
47293,4,7293,[318  79 427 588 216],18,5,29515,4.046476556073485,40.0,0.0
47294,4,7294,[318  79 427 588 216],18,5,29520,4.046607265250171,40.0,0.0
47295,4,7295,[ 88  98  25  69 197],457,5,29525,4.0467379385964914,0.0,0.0
47296,4,7296,[ 71   1 282 237 176],796,4,29529,4.046731533506921,0.0,0.0
47297,4,7297,[318  79 427 588 216],450,5,29534,4.046862154014798,40.0,0.0
47298,4,7298,[328 191 403 423 300],796,5,29539,4.046992738731333,0.0,0.0
47299,4,7299,[273 194  11 181   7],450,4,29543,4.046986301369863,0.0,0.0
47300,4,7300,[318 202 234 174 118],796,4,29547,4.046979865771812,20.0,0.0
47301,4,7301,[117 300 423 742 216],450,5,29552,4.047110380717611,0.0,0.0
47302,4,7302,[318  79 427 588 216],450,5,29557,4.0472408599205805,40.0,0.0
47303,4,7303,[318  79 427 588 216],577,5,29562,4.0473713033953995,40.0,0.0
47304,4,7304,[197 275  22 182 228],796,4,29566,4.047364818617385,0.0,20.0
47305,4,7305,[210  69 191 153 588],18,4,29570,4.047358335614564,0.0,0.0
47306,4,7306,[185 200  69  11 176],269,2,29572,4.047078144245244,0.0,0.0
47307,4,7307,[258 318  64 191 405],457,5,29577,4.047208538587849,40.0,0.0
47308,4,7308,[318  79 427 588 216],18,5,29582,4.047338897249966,40.0,0.0
47309,4,7309,[ 50 222 179 288 357],457,5,29587,4.047469220246238,0.0,20.0
47310,4,7310,[318  79 427 588 216],450,5,29592,4.0475995075913005,40.0,0.0
47311,4,7311,[318  79 427 588 216],716,5,29597,4.047729759299781,40.0,0.0
47312,4,7312,[  1  98 186 117 546],796,3,29600,4.047586489812662,0.0,0.0
47313,4,7313,[276 174 210 195 322],786,3,29603,4.047443259502324,0.0,0.0
47314,4,7314,[174 143 204 216 318],796,5,29608,4.047573479152427,20.0,0.0
47315,4,7315,[300 269 288 186 435],450,3,29611,4.047430289775834,0.0,0.0
47316,4,7316,[132  97 127  88 568],655,1,29612,4.047013803471368,0.0,20.0
47317,4,7317,[322 185  79 210 151],151,4,29616,4.0470073790653185,0.0,0.0
47318,4,7318,[269   4 678 176 215],344,3,29619,4.046864325727558,0.0,0.0
47319,4,7319,[318  79 427 588 216],18,5,29624,4.046994535519126,40.0,0.0
47320,4,7320,[318  79 427 588 216],18,5,29629,4.047124709739107,40.0,0.0
47321,4,7321,[ 79 161 597 127  12],796,5,29634,4.047254848402076,0.0,20.0
47322,4,7322,[118 121 196  98 176],344,3,29637,4.047111839410078,0.0,0.0
47323,4,7323,[318  79 427 588 216],450,5,29642,4.047241944292736,40.0,0.0
47324,4,7324,[318  79 427 588 216],796,5,29647,4.047372013651877,40.0,0.0
47325,4,7325,[258 423 118 185 282],504,4,29651,4.047365547365548,0.0,0.0
47326,4,7326,[176 403 423 187 132],655,1,29652,4.046949638324007,0.0,0.0
47327,4,7327,[655 182 174 258 143],796,4,29656,4.046943231441048,0.0,0.0
47328,4,7328,[318  79 427 588 216],716,5,29661,4.047073270568973,40.0,0.0
47329,4,7329,[168 257 196 603 588],798,3,29664,4.046930422919509,20.0,0.0
47330,4,7330,[ 97 234  15 100   1],450,3,29667,4.046787614240895,0.0,20.0
47331,4,7331,[318  79 427 588 216],577,5,29672,4.046917621385706,40.0,0.0
47332,4,7332,[496 180  88 127  97],796,3,29675,4.046774853402427,20.0,20.0
47333,4,7333,[318  79 427 588 216],796,5,29680,4.0469048268339245,40.0,0.0
47334,4,7334,[318  79 427 588 216],716,5,29685,4.047034764826176,40.0,0.0
47335,4,7335,[742 195 655 174 748],450,5,29690,4.047164667393675,0.0,0.0
47336,4,7336,[318  79 427 588 216],796,5,29695,4.047294534550907,40.0,0.0
47337,4,7337,[318  79 427 588 216],450,5,29700,4.047424366312347,40.0,0.0
47338,4,7338,[318  79 427 588 216],450,5,29705,4.047554162692465,40.0,0.0
47339,4,7339,[  1 125  79 282 276],256,3,29708,4.047411444141689,0.0,0.0
47340,4,7340,[ 15   4 273  12 215],796,4,29712,4.0474049856967715,0.0,0.0
47341,4,7341,[ 79   9   8 318 357],796,4,29716,4.0473985290111685,20.0,0.0
47342,4,7342,[  4  22  82 151 238],457,5,29721,4.0475282582050935,0.0,0.0
47343,4,7343,[318  79 427 588 216],18,5,29726,4.0476579520697165,40.0,0.0
47344,4,7344,[181 423 173 132 202],23,3,29729,4.047515316541865,0.0,0.0
47345,4,7345,[289 100   9 597 121],938,2,29731,4.0472365913422275,0.0,20.0
47346,4,7346,[118  82 269 173  11],450,3,29734,4.047094051994011,0.0,0.0
47347,4,7347,[318  79 427 588 216],577,5,29739,4.047223734349483,40.0,0.0
47348,4,7348,[318  79 427 588 216],796,5,29744,4.047353381412437,40.0,0.0
47349,4,7349,[121  15  12 216 182],457,5,29749,4.047482993197279,0.0,0.0
47350,4,7350,[318  79 427 588 216],577,5,29754,4.047612569718406,40.0,0.0
47351,4,7351,[200 183 196  70 118],504,2,29756,4.047334058759521,0.0,0.0
47352,4,7352,[318  79 427 588 216],577,5,29761,4.047463620291038,40.0,0.0
47353,4,7353,[ 69 655  70 191  98],655,2,29763,4.0471852053304325,0.0,0.0
47354,4,7354,[ 96 200  82 186 275],716,3,29766,4.047042828008157,0.0,20.0
47355,4,7355,[172 153 127 655 118],655,2,29768,4.046764545948886,0.0,20.0
47356,4,7356,[318  79 427 588 216],796,5,29773,4.046894114448825,40.0,0.0
47357,4,7357,[318  79 427 588 216],577,5,29778,4.047023647730361,40.0,0.0
47358,4,7358,[318  79 427 588 216],450,5,29783,4.0471531458078545,40.0,0.0
47359,4,7359,[318  79 427 588 216],796,5,29788,4.047282608695652,40.0,0.0
47360,4,7360,[  1  88 121  71 118],756,1,29789,4.0468686319793505,0.0,0.0
47361,4,7361,[117 427  71  79 300],450,4,29793,4.046862265688672,20.0,0.0
47362,4,7362,[286  97  64 191   8],796,3,29796,4.046720086921092,20.0,20.0
47363,4,7363,[222  11 144   1 265],292,4,29800,4.046713742531233,0.0,0.0
47364,4,7364,[196 328 597 202 179],450,5,29805,4.04684317718941,0.0,0.0
47365,4,7365,[276 187 318 288 185],655,4,29809,4.046836817811567,20.0,0.0
47366,4,7366,[151 275 161 294   7],457,4,29813,4.046830460160174,0.0,20.0
47367,4,7367,[318  79 427 588 216],18,5,29818,4.0469598262757875,40.0,0.0
47368,4,7368,[318  79 427 588 216],577,5,29823,4.0470891572804994,40.0,0.0
47369,4,7369,[ 64 195 135 215 194],716,3,29826,4.0469470827679785,20.0,0.0
47370,4,7370,[546 216 228 181  98],577,3,29829,4.046805046805047,0.0,0.0
47371,4,7371,[483  15  89 222  82],457,5,29834,4.046934346174715,0.0,0.0
47372,4,7372,[300 385 483 405 175],655,1,29835,4.046521090465211,0.0,0.0
47373,4,7373,[357 100  11 483 748],450,4,29839,4.04651478166531,0.0,20.0
47374,4,7374,[258 546  79 273 121],693,2,29841,4.046237288135593,0.0,0.0
47375,4,7375,[318  79 427 588 216],577,5,29846,4.046366594360086,40.0,0.0
47376,4,7376,[318 127 182  98 496],796,5,29851,4.046495865527993,40.0,20.0
47377,4,7377,[275 191 153 186 127],796,4,29855,4.046489563567363,0.0,40.0
47378,4,7378,[273 318 144   1 423],796,3,29858,4.0463477435966935,20.0,0.0
47379,4,7379,[286   7 483 276 118],280,4,29862,4.046341463414634,0.0,20.0
47380,4,7380,[127  95 196  79 168],18,3,29865,4.0461997019374065,0.0,20.0
47381,4,7381,[318  79 427 588 216],796,5,29870,4.046328908154972,40.0,0.0
47382,4,7382,[210 423  71  50  82],577,4,29874,4.046322633075985,0.0,20.0
47383,4,7383,[  1 265 125 180 183],292,4,29878,4.046316359696641,0.0,0.0
47384,4,7384,[318  79 427 588 216],716,5,29883,4.046445497630332,40.0,0.0
47385,4,7385,[318  79 427 588 216],577,5,29888,4.046574600595721,40.0,0.0
47386,4,7386,[318  79 427 588 216],18,5,29893,4.046703668607012,40.0,0.0
47387,4,7387,[ 50 153 185 301 118],389,3,29896,4.04656199242014,0.0,20.0
47388,4,7388,[318  79 427 588 216],450,5,29901,4.046691027202598,40.0,0.0
47389,4,7389,[483 182 153 228 269],450,4,29905,4.046684709066306,0.0,0.0
47390,4,7390,[318  79 427 588 216],716,5,29910,4.046813692328508,40.0,0.0
47391,4,7391,[  8 183  82 132 385],655,1,29911,4.046401515151516,0.0,0.0
47392,4,7392,[318  79 427 588 216],796,5,29916,4.046530501826052,40.0,0.0
47393,4,7393,[318  79 427 588 216],716,5,29921,4.046659453611036,40.0,0.0
47394,4,7394,[ 96 237   7   4 176],280,2,29923,4.046382691007437,0.0,0.0
47395,4,7395,[111 405 215 483 194],457,4,29927,4.046376419686317,0.0,0.0
47396,4,7396,[153 228 427 186 196],151,4,29931,4.046370150060835,20.0,0.0
47397,4,7397,[423 151 100 195 216],796,4,29935,4.046363882130305,0.0,20.0
47398,4,7398,[318  79 427 588 216],18,5,29940,4.046492769293148,40.0,0.0
47399,4,7399,[318  79 427 588 216],18,5,29945,4.046621621621622,40.0,0.0
47400,4,7400,[132 302 508 471 216],655,2,29947,4.046345088501554,0.0,0.0
47401,4,7401,[318  79 427 588 216],450,5,29952,4.046473925965955,40.0,0.0
47402,4,7402,[153 185 568 435 300],450,5,29957,4.046602728623531,0.0,0.0
47403,4,7403,[118 237  79 151 172],716,4,29961,4.046596434359805,0.0,0.0
47404,4,7404,[237 125   7 588 508],344,3,29964,4.0464550979068195,0.0,0.0
47405,4,7405,[318  79 427 588 216],450,5,29969,4.046583850931677,40.0,0.0
47406,4,7406,[318  79 427 588 216],716,5,29974,4.046712569191306,40.0,0.0
47407,4,7407,[111 237  15 121  11],11,3,29977,4.046571274298056,0.0,0.0
47408,4,7408,[318  79 427 588 216],18,5,29982,4.046699959508706,40.0,0.0
47409,4,7409,[318 294 258 275 515],902,3,29985,4.0465587044534415,20.0,20.0
47410,4,7410,[318  79 427 588 216],796,5,29990,4.046687356632034,40.0,0.0
47411,4,7411,[318  79 427 588 216],796,5,29995,4.04681597409606,40.0,0.0
47412,4,7412,[318  79 427 588 216],577,5,30000,4.046944556859571,40.0,0.0
47413,4,7413,[597 323 237 282 125],256,4,30004,4.046938224979768,0.0,0.0
47414,4,7414,[318  79 427 588 216],577,5,30009,4.0470667565745115,40.0,0.0
47415,4,7415,[318  79 427 588 216],18,5,30014,4.047195253505933,40.0,0.0
47416,4,7416,[143  25 215 179   1],577,3,30017,4.0470540649858435,0.0,0.0
47417,4,7417,[655 301 294 200  12],796,2,30019,4.046778107306552,0.0,0.0
47418,4,7418,[318  79 427 588 216],18,5,30024,4.046906591184796,40.0,0.0
47419,4,7419,[318  79 427 588 216],450,5,30029,4.0470350404312665,40.0,0.0
47420,4,7420,[ 25 328 403 175  28],655,0,30029,4.046489691416252,0.0,0.0
47421,4,7421,[176  22 333  70 202],655,0,30029,4.045944489355969,0.0,0.0
47422,4,7422,[318  79 427 588 216],796,5,30034,4.046073016300687,40.0,0.0
47423,4,7423,[182 191 318 173 175],269,4,30038,4.046066810344827,20.0,0.0
47424,4,7424,[269  96 322 568 258],796,3,30041,4.045925925925926,0.0,0.0
47425,4,7425,[286 144 215  15 273],655,1,30042,4.045515755453811,0.0,20.0
47426,4,7426,[318  79 427 588 216],450,5,30047,4.04564427090346,40.0,0.0
47427,4,7427,[318  79 427 588 216],18,5,30052,4.0457727517501345,40.0,0.0
47428,4,7428,[318  79 427 588 216],450,5,30057,4.045901198007807,40.0,0.0
47429,4,7429,[318  79 427 588 216],796,5,30062,4.046029609690444,40.0,0.0
47430,4,7430,[ 11 508 234 405 265],280,2,30064,4.045754272641636,0.0,0.0
47431,4,7431,[318  79 427 588 216],796,5,30069,4.045882669537137,40.0,0.0
47432,4,7432,[318  79 427 588 216],450,5,30074,4.046011031884838,40.0,0.0
47433,4,7433,[318  79 427 588 216],18,5,30079,4.046139359698682,40.0,0.0
47434,4,7434,[318  79 427 588 216],577,5,30084,4.0462676529926025,40.0,0.0
47435,4,7435,[301 245 185 117 483],450,4,30088,4.0462614308768154,0.0,0.0
47436,4,7436,[210 100 742 179 143],504,4,30092,4.046255210434315,0.0,20.0
47437,4,7437,[318  79 427 588 216],796,5,30097,4.046383436407637,40.0,0.0
47438,4,7438,[210 200 257 216 143],330,5,30102,4.046511627906977,0.0,0.0
47439,4,7439,[200 269 405 151 125],796,4,30106,4.046505376344086,0.0,0.0
47440,4,7440,[318  79 427 588 216],577,5,30111,4.046633517000403,40.0,0.0
47441,4,7441,[318  79 427 588 216],796,5,30116,4.046761623219565,40.0,0.0
47442,4,7442,[143 655 185 153 100],450,5,30121,4.046889695015451,0.0,20.0
47443,4,7443,[301  88 117 100 183],344,3,30124,4.046749059645352,0.0,20.0
47444,4,7444,[357  79   1 153 282],716,4,30128,4.046742780389523,0.0,0.0
47445,4,7445,[275 271 471   9 423],655,1,30129,4.046333601933925,0.0,20.0
47446,4,7446,[273 168 210 237 568],796,3,30132,4.046193097891768,0.0,0.0
47447,4,7447,[172 300 265  95  64],716,5,30137,4.0463211600429645,20.0,0.0
47448,4,7448,[ 15  64  69  50 216],577,4,30141,4.046314941602899,20.0,20.0
47449,4,7449,[423 191 234 318 210],151,4,30145,4.0463087248322145,20.0,0.0
47450,4,7450,[546 265 121 195 275],457,4,30149,4.046302509730237,0.0,20.0
47451,4,7451,[  1 257 294  70  11],655,0,30149,4.045759527643586,0.0,0.0
47452,4,7452,[ 25 385 168 204 322],504,4,30153,4.0457533878974905,0.0,0.0
47453,4,7453,[318  79 427 588 216],716,5,30158,4.045881405956534,40.0,0.0
47454,4,7454,[121 328 191 197  69],151,3,30161,4.045741113346748,0.0,0.0
47455,4,7455,[186  69 216  15 210],389,1,30162,4.045332618025751,0.0,0.0
47456,4,7456,[318  79 427 588 216],18,5,30167,4.045460641008448,40.0,0.0
47457,4,7457,[ 11 204 100  15 423],457,5,30172,4.045588629659426,0.0,20.0
47458,4,7458,[186  71 328 405   4],796,4,30176,4.045582517763775,0.0,0.0
47459,4,7459,[318  79 427 588 216],796,5,30181,4.045710455764075,40.0,0.0
47460,4,7460,[318  79 427 588 216],716,5,30186,4.04583835946924,40.0,0.0
47461,4,7461,[265 121  89  25 357],151,5,30191,4.045966228893058,0.0,0.0
47462,4,7462,[318  79 427 588 216],796,5,30196,4.04609406404931,40.0,0.0
47463,4,7463,[258 234 301  69   1],450,4,30200,4.046087888531618,0.0,0.0
47464,4,7464,[318  79 427 588 216],796,5,30205,4.046215673141326,40.0,0.0
47465,4,7465,[318  79 427 588 216],716,5,30210,4.046343423519957,40.0,0.0
47466,4,7466,[655 179  69  71 216],236,2,30212,4.04606937190304,0.0,0.0
47467,4,7467,[216 238 127 215 483],457,5,30217,4.046197107659347,0.0,20.0
47468,4,7468,[318  79 427 588 216],577,5,30222,4.0463248092114075,40.0,0.0
47469,4,7469,[318  79 427 588 216],716,5,30227,4.046452476572958,40.0,0.0
47470,4,7470,[ 12 216  89  22 173],457,5,30232,4.04658010975773,0.0,0.0
47471,4,7471,[318  79 427 588 216],716,5,30237,4.046707708779444,40.0,0.0
47472,4,7472,[318  79 427 588 216],716,5,30242,4.046835273651813,40.0,0.0
47473,4,7473,[318  79 427 588 216],796,5,30247,4.046962804388547,40.0,0.0
47474,4,7474,[275 328 127 265  97],655,2,30249,4.046688963210702,0.0,40.0
47475,4,7475,[318  79 427 588 216],796,5,30254,4.046816479400749,40.0,0.0
47476,4,7476,[191 515 168  50 496],878,5,30259,4.046943961481878,20.0,20.0
47477,4,7477,[100  12 357 286  89],151,4,30263,4.046937683872693,0.0,40.0
47478,4,7478,[301 153 179 333 186],655,1,30264,4.0465302847974325,0.0,0.0
47479,4,7479,[318  79 427 588 216],18,5,30269,4.046657754010695,40.0,0.0
47480,4,7480,[187 318 742 258   8],655,2,30271,4.046384173238872,20.0,0.0
47481,4,7481,[318  79 427 588 216],577,5,30276,4.046511627906977,40.0,0.0
47482,4,7482,[318  79 427 588 216],18,5,30281,4.046639048509956,40.0,0.0
47483,4,7483,[234  89  64 118   4],457,5,30286,4.046766435061464,20.0,0.0
47484,4,7484,[  9 742 186 258 328],655,0,30286,4.0462257849031396,0.0,0.0
47485,4,7485,[ 71  95 186 195 385],796,4,30290,4.046219609938552,0.0,0.0
47486,4,7486,[132 118 181 405 144],280,1,30291,4.045812742086283,0.0,0.0
47487,4,7487,[132 202 151 483 357],457,5,30296,4.045940170940171,0.0,0.0
47488,4,7488,[655 127 568 191  70],72,5,30301,4.046067565763119,0.0,20.0
47489,4,7489,[318  79 427 588 216],450,5,30306,4.0461949265687585,40.0,0.0
47490,4,7490,[127 546 286 183  98],280,4,30310,4.046188759845148,0.0,40.0
47491,4,7491,[318  79 427 588 216],796,5,30315,4.046316070475173,40.0,0.0
47492,4,7492,[318  79 427 588 216],716,5,30320,4.046443347123982,40.0,0.0
47493,4,7493,[603  15 234 121 286],655,1,30321,4.046036829463571,20.0,20.0
47494,4,7494,[  4 181 100 742 322],344,2,30323,4.0457638425617075,0.0,20.0
47495,4,7495,[423 328 181 196   7],655,0,30323,4.045224119530416,0.0,0.0
47496,4,7496,[318  79 427 588 216],18,5,30328,4.045351473922903,40.0,0.0
47497,4,7497,[318  79 427 588 216],796,5,30333,4.045478794345159,40.0,0.0
47498,4,7498,[ 89  88 268 318 238],655,2,30335,4.045206027470329,20.0,0.0
47499,4,7499,[183  97 257 742 197],655,1,30336,4.0448,0.0,0.0
47500,4,7500,[318  79 427 588 216],716,5,30341,4.04492734302093,40.0,0.0
47501,4,7501,[191 180 276  96 143],457,5,30346,4.045054652092775,0.0,0.0
47502,4,7502,[318  79 427 588 216],450,5,30351,4.045181927229108,40.0,0.0
47503,4,7503,[127 471 275  69 546],344,2,30353,4.044909381663113,0.0,40.0
47504,4,7504,[ 56   8 258 357 508],655,1,30354,4.044503664223851,0.0,0.0
47505,4,7505,[182 275   7 234 202],629,4,30358,4.044497735145217,0.0,20.0
47506,4,7506,[318  79 427 588 216],796,5,30363,4.044625016651126,40.0,0.0
47507,4,7507,[318  79 427 588 216],18,5,30368,4.044752264251465,40.0,0.0
47508,4,7508,[318  79 427 588 216],450,5,30373,4.044879477959782,40.0,0.0
47509,4,7509,[ 71 127  11 328  28],450,4,30377,4.044873501997337,0.0,20.0
47510,4,7510,[588 216 257 204 275],796,5,30382,4.045000665690321,0.0,20.0
47511,4,7511,[216 204 238 328 210],796,3,30385,4.04486155484558,0.0,0.0
47512,4,7512,[318  79 427 588 216],450,5,30390,4.04498868627712,40.0,0.0
47513,4,7513,[318  79 427 588 216],716,5,30395,4.045115783870109,40.0,0.0
47514,4,7514,[318  79 427 588 216],796,5,30400,4.0452428476380575,40.0,0.0
47515,4,7515,[471 117 191 216  22],655,2,30402,4.044970729111229,0.0,0.0
47516,4,7516,[318  79 427 588 216],18,5,30407,4.04509777836903,40.0,0.0
47517,4,7517,[  1 483 423 161 111],450,4,30411,4.045091779728652,0.0,0.0
47518,4,7518,[  4 322 202  89   7],256,4,30415,4.045085782683867,0.0,0.0
47519,4,7519,[318  79 427 588 216],796,5,30420,4.045212765957447,40.0,0.0
47520,4,7520,[318  79 427 588 216],796,5,30425,4.045339715463369,40.0,0.0
47521,4,7521,[318  79 427 588 216],796,5,30430,4.045466631215103,40.0,0.0
47522,4,7522,[318  79 427 588 216],577,5,30435,4.045593513226106,40.0,0.0
47523,4,7523,[318  79 427 588 216],716,5,30440,4.045720361509836,40.0,0.0
47524,4,7524,[323  79 195 245 222],256,5,30445,4.045847176079734,0.0,0.0
47525,4,7525,[286 211 275 435 322],450,5,30450,4.045973956949243,0.0,40.0
47526,4,7526,[191 216 125  12  89],344,4,30454,4.045967849076657,0.0,0.0
47527,4,7527,[318  79 427 588 216],577,5,30459,4.0460945802337935,40.0,0.0
47528,4,7528,[300 197  11   4 288],655,0,30459,4.045557178908221,0.0,0.0
47529,4,7529,[471 678 427 271 546],807,3,30462,4.045418326693227,20.0,0.0
47530,4,7530,[127 597 118 187 496],796,5,30467,4.045545080334617,20.0,20.0
47531,4,7531,[132 196   7 403 195],655,0,30467,4.045007966011683,0.0,0.0
47532,4,7532,[144  12 183  89 143],457,5,30472,4.045134740475242,0.0,0.0
47533,4,7533,[318  79 427 588 216],577,5,30477,4.045261481284842,40.0,0.0
47534,4,7534,[318  79 427 588 216],716,5,30482,4.045388188453882,40.0,0.0
47535,4,7535,[318  79 427 588 216],450,5,30487,4.045514861995754,40.0,0.0
47536,4,7536,[318  79 427 588 216],450,5,30492,4.045641501923843,40.0,0.0
47537,4,7537,[318  79 427 588 216],450,5,30497,4.045768108251526,40.0,0.0
47538,4,7538,[318  79 427 588 216],796,5,30502,4.045894680992174,40.0,0.0
47539,4,7539,[318  79 427 588 216],18,5,30507,4.046021220159151,40.0,0.0
47540,4,7540,[181  64  98 196 127],236,4,30511,4.046015117358441,20.0,20.0
47541,4,7541,[588 202 121 161  50],450,4,30515,4.046009016176081,0.0,20.0
47542,4,7542,[318  79 427 588 216],450,5,30520,4.0461354898581465,40.0,0.0
47543,4,7543,[318  79 427 588 216],796,5,30525,4.046261930010605,40.0,0.0
47544,4,7544,[318  79 427 588 216],450,5,30530,4.046388336646786,40.0,0.0
47545,4,7545,[216 191  98 273   9],655,4,30534,4.046382189239332,0.0,0.0
47546,4,7546,[318  79 427 588 216],796,5,30539,4.046508546442295,40.0,0.0
47547,4,7547,[318  79 427 588 216],796,5,30544,4.046634870164282,40.0,0.0
47548,4,7548,[144 168 294 318 546],450,5,30549,4.0467611604185985,20.0,0.0
47549,4,7549,[318  79 427 588 216],577,5,30554,4.046887417218543,40.0,0.0
47550,4,7550,[318  79 427 588 216],450,5,30559,4.047013640577407,40.0,0.0
47551,4,7551,[ 69 302 194  15 176],151,3,30562,4.046875,0.0,0.0
47552,4,7552,[ 28 300   1 195  11],655,0,30562,4.046339202965709,0.0,0.0
47553,4,7553,[185  28 153  64 301],796,3,30565,4.046200688377019,20.0,0.0
47554,4,7554,[ 11 121  12 403 275],457,5,30570,4.046326935804103,0.0,20.0
47555,4,7555,[318  79 427 588 216],796,5,30575,4.046453149814717,40.0,0.0
47556,4,7556,[ 70 153 215   1  15],330,5,30580,4.046579330422126,0.0,0.0
47557,4,7557,[318  79 427 588 216],796,5,30585,4.046705477639587,40.0,0.0
47558,4,7558,[318  79 427 588 216],796,5,30590,4.0468315914803545,40.0,0.0
47559,4,7559,[318  79 427 588 216],18,5,30595,4.046957671957672,40.0,0.0
47560,4,7560,[ 96 117 195 174  97],457,5,30600,4.047083719084777,0.0,0.0
47561,4,7561,[  1  88 202 111 515],716,5,30605,4.047209732874901,0.0,0.0
47562,4,7562,[ 69 265  82 200   7],457,5,30610,4.047335713341266,0.0,0.0
47563,4,7563,[471  69  22 174 275],716,4,30614,4.047329455314649,0.0,20.0
47564,4,7564,[318  79 427 588 216],577,5,30619,4.047455386649042,40.0,0.0
47565,4,7565,[318  79 427 588 216],796,5,30624,4.047581284694687,40.0,0.0
47566,4,7566,[318  79 427 588 216],577,5,30629,4.047707149464781,40.0,0.0
47567,4,7567,[318  79 427 588 216],18,5,30634,4.047832980972516,40.0,0.0
47568,4,7568,[180 183  79 187   4],716,1,30635,4.047430307834588,0.0,0.0
47569,4,7569,[318  79 427 588 216],796,5,30640,4.047556142668428,40.0,0.0
47570,4,7570,[318  79 427 588 216],716,5,30645,4.0476819442609955,40.0,0.0
47571,4,7571,[ 15 282  50  11 655],457,5,30650,4.047807712625462,0.0,20.0
47572,4,7572,[318  79 427 588 216],18,5,30655,4.04793344777499,40.0,0.0
47573,4,7573,[318  79 427 588 216],577,5,30660,4.048059149722736,40.0,0.0
47574,4,7574,[172 238  97 195 282],457,5,30665,4.0481848184818485,0.0,0.0
47575,4,7575,[318  79 427 588 216],577,5,30670,4.0483104540654695,40.0,0.0
47576,4,7576,[185 603 125 333 289],655,2,30672,4.048040121420087,20.0,0.0
47577,4,7577,[318  79 427 588 216],450,5,30677,4.04816574294009,40.0,0.0
47578,4,7578,[597  28 125 216 173],450,5,30682,4.0482913313102,0.0,0.0
47579,4,7579,[318  79 427 588 216],450,5,30687,4.048416886543536,40.0,0.0
47580,4,7580,[318   8 597 385 211],593,3,30690,4.0482785912148795,20.0,0.0
47581,4,7581,[318  79 427 588 216],18,5,30695,4.048404115009232,40.0,0.0
47582,4,7582,[ 25 385 282 144 143],450,4,30699,4.048397731768429,0.0,0.0
47583,4,7583,[318  79 427 588 216],577,5,30704,4.048523206751055,40.0,0.0
47584,4,7584,[318  79 427 588 216],796,5,30709,4.048648648648649,40.0,0.0
47585,4,7585,[318  79 427 588 216],18,5,30714,4.0487740574742945,40.0,0.0
47586,4,7586,[228 300 435  15 282],655,0,30714,4.048240411229735,0.0,0.0
47587,4,7587,[100 111  25  88  11],11,2,30716,4.047970479704797,0.0,20.0
47588,4,7588,[143 211 385 181 318],151,4,30720,4.047964158650679,20.0,0.0
47589,4,7589,[318  79 427 588 216],716,5,30725,4.0480895915678525,40.0,0.0
47590,4,7590,[318  79 427 588 216],716,5,30730,4.048214991437228,40.0,0.0
47591,4,7591,[318  79 427 588 216],796,5,30735,4.048340358271865,40.0,0.0
47592,4,7592,[288 302 568  89 187],655,3,30738,4.048202291584354,0.0,0.0
47593,4,7593,[153 265   8 161 333],655,0,30738,4.047669212536213,0.0,0.0
47594,4,7594,[318  79 427 588 216],796,5,30743,4.047794601711653,40.0,0.0
47595,4,7595,[  4 125   1 322 127],256,5,30748,4.047919957872565,0.0,20.0
47596,4,7596,[204 121  96 603 228],655,1,30749,4.047518757404238,20.0,0.0
47597,4,7597,[ 89 276  50  98 186],655,4,30753,4.047512503290339,0.0,20.0
47598,4,7598,[210 234 151 245  71],504,4,30757,4.047506250822477,0.0,0.0
47599,4,7599,[568  56  97  96 111],796,4,30761,4.0475,0.0,0.0
47600,4,7600,[143 568 655 300 423],655,1,30762,4.04709906591238,0.0,0.0
47601,4,7601,[265 423 143 435 405],151,4,30766,4.04709287029729,0.0,0.0
47602,4,7602,[318  79 427 588 216],577,5,30771,4.047218203340787,40.0,0.0
47603,4,7603,[276 125 161 168 194],457,5,30776,4.047343503419253,0.0,0.0
47604,4,7604,[ 97 228 237  96 143],577,3,30779,4.047205785667324,0.0,0.0
47605,4,7605,[182 180 403 183 143],796,4,30783,4.047199579279516,0.0,0.0
47606,4,7606,[185 172 118 300  12],796,5,30788,4.047324832391219,0.0,0.0
47607,4,7607,[132 191  89 176   8],457,5,30793,4.047450052576235,0.0,0.0
47608,4,7608,[289 508 216 273 257],655,2,30795,4.047180969904061,0.0,0.0
47609,4,7609,[318  79 427 588 216],577,5,30800,4.0473061760841,40.0,0.0
47610,4,7610,[318  79 427 588 216],450,5,30805,4.047431349362764,40.0,0.0
47611,4,7611,[318  79 427 588 216],796,5,30810,4.047556489753021,40.0,0.0
47612,4,7612,[318  79 427 588 216],577,5,30815,4.0476815972678315,40.0,0.0
47613,4,7613,[318  79 427 588 216],716,5,30820,4.0478066719201475,40.0,0.0
47614,4,7614,[403 405 202 269 181],796,4,30824,4.047800393959291,0.0,0.0
47615,4,7615,[318  79 427 588 216],577,5,30829,4.047925420168068,40.0,0.0
47616,4,7616,[318  79 427 588 216],450,5,30834,4.0480504135486415,40.0,0.0
47617,4,7617,[318  79 427 588 216],716,5,30839,4.04817537411394,40.0,0.0
47618,4,7618,[ 50 121  79 174 202],344,4,30843,4.048169051056569,0.0,20.0
47619,4,7619,[222 265 588 196   9],786,5,30848,4.048293963254594,0.0,0.0
47620,4,7620,[168   8 275  82 174],18,3,30851,4.048156409919958,0.0,20.0
47621,4,7621,[144 328   8  56 179],655,1,30852,4.0477564943584365,0.0,0.0
47622,4,7622,[ 98 204 222 194  64],450,4,30856,4.047750229568411,20.0,0.0
47623,4,7623,[318  79 427 588 216],18,5,30861,4.0478751311647425,40.0,0.0
47624,4,7624,[318  79 427 588 216],450,5,30866,4.048,40.0,0.0
47625,4,7625,[275 181 216 269 301],450,5,30871,4.04812483608707,0.0,20.0
47626,4,7626,[211 183   4 175  25],264,5,30876,4.048249639438835,0.0,0.0
47627,4,7627,[318  79 427 588 216],577,5,30881,4.04837441006817,40.0,0.0
47628,4,7628,[186  97 191 204  98],786,5,30886,4.048499147987941,0.0,0.0
47629,4,7629,[318  79 427 588 216],450,5,30891,4.0486238532110095,40.0,0.0
47630,4,7630,[483 172 153  69 111],796,5,30896,4.048748525750229,0.0,0.0
47631,4,7631,[318  79 427 588 216],450,5,30901,4.048873165618448,40.0,0.0
47632,4,7632,[318  79 427 588 216],796,5,30906,4.048997772828508,40.0,0.0
47633,4,7633,[318  79 427 588 216],577,5,30911,4.049122347393241,40.0,0.0
47634,4,7634,[318  79 427 588 216],716,5,30916,4.049246889325475,40.0,0.0
47635,4,7635,[175  98 172 568 301],344,5,30921,4.04937139863803,0.0,0.0
47636,4,7636,[168 195 127 100 179],269,4,30925,4.049364933874558,0.0,40.0
47637,4,7637,[318  79 427 588 216],796,5,30930,4.049489395129615,40.0,0.0
47638,4,7638,[176 117 222  64 125],796,5,30935,4.049613823798927,20.0,0.0
47639,4,7639,[ 69  70 427 237 174],330,5,30940,4.049738219895288,20.0,0.0
47640,4,7640,[181 357 174 121 403],269,1,30941,4.049339091741919,0.0,0.0
47641,4,7641,[282 194 153 127 176],504,2,30943,4.049070923841926,0.0,20.0
47642,4,7642,[508  96  28 742 475],655,0,30943,4.048541148763574,0.0,0.0
47643,4,7643,[313 678 125 183  98],280,1,30944,4.048142333856619,0.0,0.0
47644,4,7644,[234 271 301 196  15],629,4,30948,4.0481360366252455,0.0,0.0
47645,4,7645,[318  79 427 588 216],577,5,30953,4.048260528380853,40.0,0.0
47646,4,7646,[135 127 403 282 234],280,2,30955,4.047992676866745,0.0,20.0
47647,4,7647,[318  79 427 588 216],577,5,30960,4.048117154811716,40.0,0.0
47648,4,7648,[603  82 144 187  12],450,4,30964,4.048110864165251,20.0,0.0
47649,4,7649,[197  28 301 215  12],151,4,30968,4.048104575163399,0.0,0.0
47650,4,7650,[318  79 427 588 216],716,5,30973,4.048228989674552,40.0,0.0
47651,4,7651,[318  79 427 588 216],716,5,30978,4.048353371667538,40.0,0.0
47652,4,7652,[546  50 127 202  89],256,4,30982,4.048347053443094,0.0,40.0
47653,4,7653,[318  79 427 588 216],577,5,30987,4.048471387509799,40.0,0.0
47654,4,7654,[318  79 427 588 216],716,5,30992,4.048595689092097,40.0,0.0
47655,4,7655,[ 79 328 286 427 196],655,2,30994,4.048328108672936,20.0,20.0
47656,4,7656,[127 210 655 483 265],716,5,30999,4.048452396499934,0.0,20.0
47657,4,7657,[237 172 273 183 655],450,4,31003,4.048446069469835,0.0,0.0
47658,4,7658,[318  79 427 588 216],577,5,31008,4.048570309439874,40.0,0.0
47659,4,7659,[318  79 427 588 216],577,5,31013,4.048694516971279,40.0,0.0
47660,4,7660,[318  79 427 588 216],577,5,31018,4.048818692076752,40.0,0.0
47661,4,7661,[ 88 496  82 200  15],786,4,31022,4.04881232054294,20.0,0.0
47662,4,7662,[318  79 427 588 216],450,5,31027,4.048936447866371,40.0,0.0
47663,4,7663,[318  79 427 588 216],577,5,31032,4.049060542797495,40.0,0.0
47664,4,7664,[151 216 204 200 191],457,5,31037,4.049184605348989,0.0,0.0
47665,4,7665,[385 161  25 143 235],716,2,31039,4.048917297156274,0.0,0.0
47666,4,7666,[176  69 216 423  25],11,1,31040,4.048519629581323,0.0,0.0
47667,4,7667,[ 97 135 127 168 202],457,5,31045,4.048643714136672,0.0,20.0
47668,4,7668,[  8 238  15  88 200],655,1,31046,4.048246185943409,0.0,0.0
47669,4,7669,[318  79 427 588 216],577,5,31051,4.048370273794003,40.0,0.0
47670,4,7670,[179 117 210 132  82],457,5,31056,4.048494329292139,0.0,0.0
47671,4,7671,[125 496 187 385 143],796,5,31061,4.048618352450469,20.0,0.0
47672,4,7672,[318  79 427 588 216],716,5,31066,4.048742343281637,40.0,0.0
47673,4,7673,[318  79 427 588 216],18,5,31071,4.04886630179828,40.0,0.0
47674,4,7674,[318  79 427 588 216],18,5,31076,4.04899022801303,40.0,0.0
47675,4,7675,[318  79 427 588 216],716,5,31081,4.049114121938509,40.0,0.0
47676,4,7676,[318  79 427 588 216],450,5,31086,4.049237983587338,40.0,0.0
47677,4,7677,[176 357 183 132 118],504,2,31088,4.04897108622037,0.0,0.0
47678,4,7678,[172 182  71 405 385],593,3,31091,4.0488344836567265,0.0,0.0
47679,4,7679,[265  12 197  22 196],450,5,31096,4.048958333333333,0.0,0.0
47680,4,7680,[269 597 245 153 185],796,3,31099,4.048821767998959,0.0,0.0
47681,4,7681,[ 82 197 742 568 117],450,4,31103,4.048815412652955,0.0,0.0
47682,4,7682,[143 197 435 100 186],269,2,31105,4.048548743980216,0.0,20.0
47683,4,7683,[275 153 185 423 300],535,4,31109,4.048542425819885,0.0,20.0
47684,4,7684,[318  79 427 588 216],716,5,31114,4.048666232921275,40.0,0.0
47685,4,7685,[ 70 176  64 302 182],655,3,31117,4.048529794431434,20.0,0.0
47686,4,7686,[318  79 427 588 216],18,5,31122,4.048653570963965,40.0,0.0
47687,4,7687,[ 88  64 568 655 603],655,2,31124,4.048387096774194,40.0,0.0
47688,4,7688,[318  79 427 588 216],796,5,31129,4.0485108596696575,40.0,0.0
47689,4,7689,[318  79 427 588 216],577,5,31134,4.048634590377113,40.0,0.0
47690,4,7690,[174  82 588  28  50],796,3,31137,4.048498244701599,0.0,20.0
47691,4,7691,[318  79 427 588 216],716,5,31142,4.048621944877795,40.0,0.0
47692,4,7692,[181  79 187 202 300],716,4,31146,4.048615624593786,0.0,0.0
47693,4,7693,[318  79 427 588 216],716,5,31151,4.048739277358981,40.0,0.0
47694,4,7694,[ 69  15 118  96 403],450,3,31154,4.048602988953866,0.0,0.0
47695,4,7695,[222 183   9 135 603],655,3,31157,4.048466735966736,20.0,0.0
47696,4,7696,[301 185 135  22  64],450,4,31161,4.048460439132129,20.0,0.0
47697,4,7697,[318  79 427 588 216],716,5,31166,4.048584047804624,40.0,0.0
47698,4,7698,[318  79 427 588 216],450,5,31171,4.048707624366801,40.0,0.0
47699,4,7699,[318  79 427 588 216],450,5,31176,4.0488311688311684,40.0,0.0
47700,4,7700,[357  50  79 210 174],457,5,31181,4.048954681210232,0.0,20.0
47701,4,7701,[276  15 180 183 483],269,2,31183,4.048688652298105,0.0,0.0
47702,4,7702,[318  79 427 588 216],716,5,31188,4.048812151109957,40.0,0.0
47703,4,7703,[357  25 118  95 568],716,4,31192,4.048805815160955,0.0,0.0
47704,4,7704,[318  79 427 588 216],716,5,31197,4.048929266709929,40.0,0.0
47705,4,7705,[318  79 427 588 216],450,5,31202,4.049052686218531,40.0,0.0
47706,4,7706,[318  79 427 588 216],577,5,31207,4.049176073699234,40.0,0.0
47707,4,7707,[200 151  64   9  97],151,4,31211,4.049169693824598,20.0,0.0
47708,4,7708,[318  79 427 588 216],577,5,31216,4.049293034115968,40.0,0.0
47709,4,7709,[153  79 202 211  22],655,1,31217,4.0488975356679635,0.0,0.0
47710,4,7710,[318  79 427 588 216],450,5,31222,4.04902087926339,40.0,0.0
47711,4,7711,[318  79 427 588 216],716,5,31227,4.0491441908713695,40.0,0.0
47712,4,7712,[318  79 427 588 216],450,5,31232,4.049267470504343,40.0,0.0
47713,4,7713,[318  79 427 588 216],577,5,31237,4.049390718174747,40.0,0.0
47714,4,7714,[222  70  11   9 655],457,5,31242,4.0495139338950095,0.0,0.0
47715,4,7715,[153 597 238  82 300],450,4,31246,4.049507516848108,0.0,0.0
47716,4,7716,[318  79 427 588 216],716,5,31251,4.0496306854995465,40.0,0.0
47717,4,7717,[357 100 111 153 318],593,5,31256,4.04975382223374,20.0,20.0
47718,4,7718,[300 423 238 100 200],629,5,31261,4.049876927063091,0.0,20.0
47719,4,7719,[  4 301 185  56 289],655,1,31262,4.0494818652849744,0.0,0.0
47720,4,7720,[265  82 200 215 301],450,3,31265,4.049345939645124,0.0,0.0
47721,4,7721,[234 357 222  88  28],457,5,31270,4.0494690494690495,0.0,0.0
47722,4,7722,[318  79 427 588 216],450,5,31275,4.0495921274116276,40.0,0.0
47723,4,7723,[ 56 328  15 318 200],796,5,31280,4.049715173485241,20.0,0.0
47724,4,7724,[318  79 427 588 216],796,5,31285,4.049838187702266,40.0,0.0
47725,4,7725,[471 427  15 153  95],389,2,31287,4.049572870825783,20.0,0.0
47726,4,7726,[318  79 427 588 216],716,5,31292,4.049695871618998,40.0,0.0
47727,4,7727,[ 98   9  64 237 286],494,4,31296,4.049689440993789,20.0,20.0
47728,4,7728,[318  79 427 588 216],716,5,31301,4.049812394876439,40.0,0.0
47729,4,7729,[318  79 427 588 216],18,5,31306,4.04993531694696,40.0,0.0
47730,4,7730,[ 11 215 180 405 211],716,4,31310,4.04992885784504,0.0,0.0
47731,4,7731,[318  79 427 588 216],577,5,31315,4.0500517330574235,40.0,0.0
47732,4,7732,[318  79 427 588 216],577,5,31320,4.050174576490366,40.0,0.0
47733,4,7733,[275 197  69 176 194],503,5,31325,4.050297388156193,0.0,20.0
47734,4,7734,[318  79 427 588 216],18,5,31330,4.050420168067227,40.0,0.0
47735,4,7735,[269   7 265 496 211],535,4,31334,4.050413650465357,20.0,0.0
47736,4,7736,[  7  70 143 100 168],450,5,31339,4.0505363836112185,0.0,20.0
47737,4,7737,[234 144 483 275 179],450,3,31342,4.050400620315327,0.0,20.0
47738,4,7738,[318  79 427 588 216],577,5,31347,4.050523323426799,40.0,0.0
47739,4,7739,[  4 100 196 118 483],796,4,31351,4.050516795865633,0.0,20.0
47740,4,7740,[318  79 427 588 216],450,5,31356,4.050639452267149,40.0,0.0
47741,4,7741,[ 71 176 423 202  95],577,5,31361,4.050762076982692,0.0,0.0
47742,4,7742,[385 597 100 568 210],450,4,31365,4.050755521115846,0.0,20.0
47743,4,7743,[ 15 100 197 234 172],450,3,31368,4.050619834710743,0.0,20.0
47744,4,7744,[318  79 427 588 216],577,5,31373,4.0507424144609425,40.0,0.0
47745,4,7745,[294 132  50 172  79],450,5,31378,4.050864962561322,0.0,20.0
47746,4,7746,[318  79 427 588 216],18,5,31383,4.050987479024139,40.0,0.0
47747,4,7747,[318  79 427 588 216],450,5,31388,4.0511099638616415,40.0,0.0
47748,4,7748,[318  79 427 588 216],450,5,31393,4.051232417086076,40.0,0.0
47749,4,7749,[180  64 748 151 173],450,5,31398,4.051354838709678,20.0,0.0
47750,4,7750,[318  79 427 588 216],18,5,31403,4.0514772287446785,40.0,0.0
47751,4,7751,[204 191 435 357 588],401,4,31407,4.051470588235294,0.0,0.0
47752,4,7752,[318  79 427 588 216],796,5,31412,4.051592931768348,40.0,0.0
47753,4,7753,[258 508 118   9  12],655,0,31412,4.051070415269538,0.0,0.0
47754,4,7754,[322 265 301 197 183],151,3,31415,4.050934880722115,0.0,0.0
47755,4,7755,[748 168 183  95 181],450,4,31419,4.050928313563692,0.0,0.0
47756,4,7756,[318  79 427 588 216],18,5,31424,4.051050663916462,40.0,0.0
47757,4,7757,[168 191 403 121 172],457,5,31429,4.051172982727507,0.0,0.0
47758,4,7758,[385  56 258 423 125],450,5,31434,4.051295270009022,0.0,0.0
47759,4,7759,[318  79 427 588 216],796,5,31439,4.0514175257731955,40.0,0.0
47760,4,7760,[318  79 427 588 216],577,5,31444,4.051539750032212,40.0,0.0
47761,4,7761,[318  79 427 588 216],716,5,31449,4.051661942798248,40.0,0.0
47762,4,7762,[546 143 173  70 258],23,2,31451,4.051397655545537,0.0,0.0
47763,4,7763,[318  79 427 588 216],18,5,31456,4.051519835136528,40.0,0.0
47764,4,7764,[245 210  89 132 173],796,3,31459,4.051384417256922,0.0,0.0
47765,4,7765,[318  79 427 588 216],716,5,31464,4.051506567087304,40.0,0.0
47766,4,7766,[ 98 132 273 234 405],796,3,31467,4.051371185786018,0.0,0.0
47767,4,7767,[318  79 427 588 216],18,5,31472,4.0514933058702365,40.0,0.0
47768,4,7768,[127 186 204  89 181],18,2,31474,4.051229244433003,0.0,20.0
47769,4,7769,[294 200 228  96  69],796,4,31478,4.051222651222651,0.0,0.0
47770,4,7770,[186 215 288  98  22],655,1,31479,4.05083000900785,0.0,0.0
47771,4,7771,[435 234 286   4 202],655,0,31479,4.050308800823469,0.0,20.0
47772,4,7772,[187 191 194  79 286],236,3,31482,4.050173678116558,0.0,20.0
47773,4,7773,[168 143 194 211 173],807,4,31486,4.050167224080267,0.0,0.0
47774,4,7774,[276 435 186 300   8],655,1,31487,4.049774919614148,0.0,0.0
47775,4,7775,[318  79 427 588 216],796,5,31492,4.049897119341564,40.0,0.0
47776,4,7776,[294  88 257 273 427],655,2,31494,4.04963353478205,20.0,0.0
47777,4,7777,[257  22 143 318 265],716,5,31499,4.0497557212651065,20.0,0.0
47778,4,7778,[318  79 427 588 216],796,5,31504,4.049877876333719,40.0,0.0
47779,4,7779,[173 235 435 216  70],716,4,31508,4.04987146529563,0.0,0.0
47780,4,7780,[  1 183   7 215 182],280,2,31510,4.049608019534764,0.0,0.0
47781,4,7781,[196   1 357 237 144],655,1,31511,4.049216139809817,0.0,0.0
47782,4,7782,[318  79 427 588 216],716,5,31516,4.049338301426185,40.0,0.0
47783,4,7783,[196 181  71  69 161],796,5,31521,4.049460431654676,0.0,0.0
47784,4,7784,[588 294 269 125 172],450,5,31526,4.049582530507386,0.0,0.0
47785,4,7785,[318  79 427 588 216],716,5,31531,4.049704597996404,40.0,0.0
47786,4,7786,[ 69 197 173 180 265],786,4,31535,4.049698214973674,0.0,0.0
47787,4,7787,[318  79 427 588 216],796,5,31540,4.049820236260914,40.0,0.0
47788,4,7788,[318  79 427 588 216],577,5,31545,4.0499422262164595,40.0,0.0
47789,4,7789,[197 385 471  79  11],450,5,31550,4.050064184852375,0.0,0.0
47790,4,7790,[234 182 174 568 357],72,5,31555,4.050186112180722,0.0,0.0
47791,4,7791,[118 301 322 483  50],796,3,31558,4.050051334702259,0.0,20.0
47792,4,7792,[318  79 427 588 216],18,5,31563,4.05017323238804,40.0,0.0
47793,4,7793,[318  79 427 588 216],716,5,31568,4.050295098793944,40.0,0.0
47794,4,7794,[318  79 427 588 216],450,5,31573,4.0504169339320075,40.0,0.0
47795,4,7795,[588 238 125 546 385],457,4,31577,4.050410466906106,0.0,0.0
47796,4,7796,[100 118 273 742   8],796,2,31579,4.050147492625369,0.0,20.0
47797,4,7797,[318  79 427 588 216],796,5,31584,4.050269299820466,40.0,0.0
47798,4,7798,[125 174 161 210  64],450,4,31588,4.050262854212079,20.0,0.0
47799,4,7799,[144 496 200 385  98],450,4,31592,4.05025641025641,20.0,0.0
47800,4,7800,[ 95 257 471  11 546],716,3,31595,4.05012177925907,0.0,0.0
47801,4,7801,[318  79 427 588 216],18,5,31600,4.050243527300692,40.0,0.0
47802,4,7802,[318  79 427 588 216],450,5,31605,4.05036524413687,40.0,0.0
47803,4,7803,[318  79 427 588 216],716,5,31610,4.0504869297796,40.0,0.0
47804,4,7804,[318  79 427 588 216],450,5,31615,4.050608584240871,40.0,0.0
47805,4,7805,[318  79 427 588 216],450,5,31620,4.050730207532667,40.0,0.0
47806,4,7806,[ 64  89 183 276 111],344,5,31625,4.050851799666965,20.0,0.0
47807,4,7807,[568  79 385 228 210],280,2,31627,4.050589139344262,0.0,0.0
47808,4,7808,[151 211 588 286 546],796,3,31630,4.050454603662441,0.0,20.0
47809,4,7809,[172 210 135 655 195],629,5,31635,4.050576184379001,0.0,0.0
47810,4,7810,[603 215 216   1  28],151,4,31639,4.0505697093842015,20.0,0.0
47811,4,7811,[318  79 427 588 216],18,5,31644,4.050691244239632,40.0,0.0
47812,4,7812,[318  79 427 588 216],796,5,31649,4.050812747984129,40.0,0.0
47813,4,7813,[405  25 265 204  64],655,1,31650,4.050422318914769,20.0,0.0
47814,4,7814,[228 176   7 655 286],786,5,31655,4.050543825975688,0.0,20.0
47815,4,7815,[186 288 603 132 161],655,1,31656,4.050153531218014,20.0,0.0
47816,4,7816,[318  79 427 588 216],450,5,31661,4.050275041576052,40.0,0.0
47817,4,7817,[237  97 238 125 179],65,3,31664,4.050140700946534,0.0,0.0
47818,4,7818,[195 186 168  15 125],151,4,31668,4.050134288272157,0.0,0.0
47819,4,7819,[318  79 427 588 216],450,5,31673,4.050255754475703,40.0,0.0
47820,4,7820,[318  79 427 588 216],18,5,31678,4.050377189617696,40.0,0.0
47821,4,7821,[204  79 117  98 568],577,4,31682,4.05037074916901,0.0,0.0
47822,4,7822,[568 268 357 132 185],269,4,31686,4.0503643103668665,0.0,0.0
47823,4,7823,[318  79 427 588 216],450,5,31691,4.050485685071575,40.0,0.0
47824,4,7824,[153 588  71  97 215],796,4,31695,4.050479233226837,0.0,0.0
47825,4,7825,[211  64  25  56 742],450,4,31699,4.050472783030923,20.0,0.0
47826,4,7826,[318  79 427 588 216],796,5,31704,4.050594097355309,40.0,0.0
47827,4,7827,[318  79 427 588 216],450,5,31709,4.050715380684721,40.0,0.0
47828,4,7828,[200  56 211 238 385],151,3,31712,4.050581172563546,0.0,0.0
47829,4,7829,[318  79 427 588 216],796,5,31717,4.050702426564496,40.0,0.0
47830,4,7830,[300 204 742 678 127],504,4,31721,4.0506959519856975,0.0,20.0
47831,4,7831,[118 483 655 546 197],457,4,31725,4.050689479060265,0.0,0.0
47832,4,7832,[318  79 427 588 216],577,5,31730,4.050810672794587,40.0,0.0
47833,4,7833,[ 22  88 318 151 182],796,5,31735,4.050931835588461,20.0,0.0
47834,4,7834,[182 357  71 180 196],18,4,31739,4.050925335035099,0.0,0.0
47835,4,7835,[  1 496 228 313 111],344,3,31742,4.050791220010209,20.0,0.0
47836,4,7836,[318  79 427 588 216],577,5,31747,4.050912338905193,40.0,0.0
47837,4,7837,[ 22 204 427 588 237],18,3,31750,4.0507782597601425,20.0,0.0
47838,4,7838,[318  79 427 588 216],450,5,31755,4.050899349406812,40.0,0.0
47839,4,7839,[318  79 427 588 216],577,5,31760,4.051020408163265,40.0,0.0
47840,4,7840,[318  79 427 588 216],450,5,31765,4.051141436041322,40.0,0.0
47841,4,7841,[174 204  70 235 111],269,0,31765,4.050624840601888,0.0,0.0
47842,4,7842,[318  79 427 588 216],577,5,31770,4.050745888053041,40.0,0.0
47843,4,7843,[318  79 427 588 216],450,5,31775,4.05086690464049,40.0,0.0
47844,4,7844,[318  79 427 588 216],18,5,31780,4.050987890376036,40.0,0.0
47845,4,7845,[318  79 427 588 216],577,5,31785,4.051108845271476,40.0,0.0
47846,4,7846,[318  79 427 588 216],577,5,31790,4.051229769338601,40.0,0.0
47847,4,7847,[318  79 427 588 216],577,5,31795,4.051350662589194,40.0,0.0
47848,4,7848,[194 191 127 483  98],562,5,31800,4.051471525035036,0.0,20.0
47849,4,7849,[174  71 187  50  79],796,5,31805,4.051592356687898,0.0,20.0
47850,4,7850,[276 405  79 265 288],457,5,31810,4.051713157559546,0.0,0.0
47851,4,7851,[655 328 204 508 286],401,2,31812,4.051451859398879,0.0,20.0
47852,4,7852,[196  98 546 257 174],504,5,31817,4.0515726473959,0.0,0.0
47853,4,7853,[ 71 322 357 742 132],796,3,31820,4.05143875732111,0.0,0.0
47854,4,7854,[405 100 187 286 168],503,3,31823,4.051304901336728,0.0,40.0
47855,4,7855,[318  79 427 588 216],450,5,31828,4.05142566191446,40.0,0.0
47856,4,7856,[318  79 427 588 216],18,5,31833,4.051546391752577,40.0,0.0
47857,4,7857,[318  79 427 588 216],450,5,31838,4.051667090862815,40.0,0.0
47858,4,7858,[471  28 496  15  95],577,3,31841,4.051533273953429,20.0,0.0
47859,4,7859,[318  79 427 588 216],716,5,31846,4.051653944020356,40.0,0.0
47860,4,7860,[333  11 185 294 135],655,2,31848,4.051392952550566,0.0,0.0
47861,4,7861,[318  79 427 588 216],716,5,31853,4.051513609768507,40.0,0.0
47862,4,7862,[235 357 191 286  12],450,4,31857,4.051507058374666,0.0,20.0
47863,4,7863,[318  79 427 588 216],796,5,31862,4.051627670396745,40.0,0.0
47864,4,7864,[318  79 427 588 216],18,5,31867,4.0517482517482515,40.0,0.0
47865,4,7865,[318  79 427 588 216],716,5,31872,4.051868802440885,40.0,0.0
47866,4,7866,[318  79 427 588 216],577,5,31877,4.051989322486335,40.0,0.0
47867,4,7867,[318  79 427 588 216],577,5,31882,4.052109811896289,40.0,0.0
47868,4,7868,[318  79 427 588 216],18,5,31887,4.052230270682425,40.0,0.0
47869,4,7869,[ 25 271 161  50   8],655,1,31888,4.0518424396442185,0.0,20.0
47870,4,7870,[318  79 427 588 216],450,5,31893,4.051962901791386,40.0,0.0
47871,4,7871,[179 496 294 132 173],577,4,31897,4.051956300813008,20.0,0.0
47872,4,7872,[318  79 427 588 216],18,5,31902,4.052076717896608,40.0,0.0
47873,4,7873,[318  79 427 588 216],796,5,31907,4.052197104394208,40.0,0.0
47874,4,7874,[318  79 427 588 216],450,5,31912,4.05231746031746,40.0,0.0
47875,4,7875,[300 288  70  64 603],655,2,31914,4.05205688166582,40.0,0.0
47876,4,7876,[318  79 427 588 216],577,5,31919,4.052177224831789,40.0,0.0
47877,4,7877,[318  79 427 588 216],577,5,31924,4.052297537446052,40.0,0.0
47878,4,7878,[318  79 427 588 216],577,5,31929,4.052417819520244,40.0,0.0
47879,4,7879,[318  79 427 588 216],796,5,31934,4.05253807106599,40.0,0.0
47880,4,7880,[ 95 202  69  15 100],330,5,31939,4.052658292094912,0.0,20.0
47881,4,7881,[318  79 427 588 216],577,5,31944,4.052778482618625,40.0,0.0
47882,4,7882,[111 182  79 121  98],457,4,31948,4.052771787390587,0.0,0.0
47883,4,7883,[496 118  15 423 210],330,5,31953,4.05289193302892,20.0,0.0
47884,4,7884,[118 127 121  79  89],72,2,31955,4.052631578947368,0.0,20.0
47885,4,7885,[258   9  25 111  50],277,4,31959,4.05262490489475,0.0,20.0
47886,4,7886,[ 95 234 403 357 597],450,3,31962,4.052491441612781,0.0,0.0
47887,4,7887,[318  79 427 588 216],796,5,31967,4.052611561866126,40.0,0.0
47888,4,7888,[403  64 546  79   7],457,4,31971,4.052604892888833,20.0,0.0
47889,4,7889,[318  79 427 588 216],18,5,31976,4.052724968314322,40.0,0.0
47890,4,7890,[273 282 748 196  64],401,1,31977,4.05233810670384,20.0,0.0
47891,4,7891,[216 300 423 204  98],450,5,31982,4.0524581855043085,0.0,0.0
47892,4,7892,[318  79 427 588 216],450,5,31987,4.05257823387812,40.0,0.0
47893,4,7893,[318  79 427 588 216],18,5,31992,4.052698251836838,40.0,0.0
47894,4,7894,[318  79 427 588 216],716,5,31997,4.05281823939202,40.0,0.0
47895,4,7895,[202 117 196 405 597],344,2,31999,4.052558257345491,0.0,0.0
47896,4,7896,[318  79 427 588 216],577,5,32004,4.052678232240091,40.0,0.0
47897,4,7897,[202 228 174 427 204],796,5,32009,4.052798176753608,20.0,0.0
47898,4,7898,[161 546 328 125   4],450,4,32013,4.052791492593999,0.0,0.0
47899,4,7899,[191 269 423  98 271],655,2,32015,4.05253164556962,0.0,0.0
47900,4,7900,[318  79 427 588 216],577,5,32020,4.05265156309328,40.0,0.0
47901,4,7901,[179 568 135  22 597],457,4,32024,4.05264490002531,0.0,0.0
47902,4,7902,[127 117  89   9 153],655,2,32026,4.052385170188536,0.0,20.0
47903,4,7903,[ 11 357 204 483   7],450,4,32030,4.052378542510121,0.0,0.0
47904,4,7904,[196 282 328 144 271],796,5,32035,4.052498418722328,0.0,0.0
47905,4,7905,[318  79 427 588 216],450,5,32040,4.0526182646091575,40.0,0.0
47906,4,7906,[318  79 427 588 216],18,5,32045,4.052738080182117,40.0,0.0
47907,4,7907,[ 28 597 603 333 183],796,4,32049,4.052731411229135,20.0,0.0
47908,4,7908,[215 405  12 202 195],450,5,32054,4.052851182197497,0.0,0.0
47909,4,7909,[  4 496   1 127 235],716,3,32057,4.052718078381795,20.0,20.0
47910,4,7910,[318  79 427 588 216],18,5,32062,4.05283782075591,40.0,0.0
47911,4,7911,[318  79 427 588 216],18,5,32067,4.052957532861476,40.0,0.0
47912,4,7912,[ 25 168 275 194 182],389,4,32071,4.052950840389233,0.0,20.0
47913,4,7913,[435 111  98 216 185],389,3,32074,4.052817791256002,0.0,0.0
47914,4,7914,[ 28 121 173 568  50],457,5,32079,4.052937460518004,0.0,20.0
47915,4,7915,[318  79 427 588 216],796,5,32084,4.053057099545224,40.0,0.0
47916,4,7916,[ 79 435 471 301  64],655,2,32086,4.052797776935708,20.0,0.0
47917,4,7917,[318  79 427 588 216],716,5,32091,4.0529174033846935,40.0,0.0
47918,4,7918,[318  79 427 588 216],716,5,32096,4.053036999621164,40.0,0.0
47919,4,7919,[318  79 427 588 216],796,5,32101,4.053156565656566,40.0,0.0
47920,4,7920,[318  79 427 588 216],18,5,32106,4.053276101502336,40.0,0.0
47921,4,7921,[318  79 427 588 216],716,5,32111,4.053395607169906,40.0,0.0
47922,4,7922,[318  79 427 588 216],796,5,32116,4.053515082670706,40.0,0.0
47923,4,7923,[318  79 427 588 216],577,5,32121,4.053634528016153,40.0,0.0
47924,4,7924,[318  79 427 588 216],796,5,32126,4.053753943217665,40.0,0.0
47925,4,7925,[125 186  89 282 100],457,5,32131,4.0538733282866515,0.0,20.0
47926,4,7926,[496 423 196 172 194],716,5,32136,4.053992683234515,20.0,0.0
47927,4,7927,[318  79 427 588 216],577,5,32141,4.054112008072654,40.0,0.0
47928,4,7928,[318  79 427 588 216],18,5,32146,4.054231302812461,40.0,0.0
47929,4,7929,[ 12 202  89 153 187],655,2,32148,4.053972257250946,0.0,0.0
47930,4,7930,[318  79 427 588 216],796,5,32153,4.054091539528433,40.0,0.0
47931,4,7931,[655 471 143 258  28],693,2,32155,4.053832576903681,0.0,0.0
47932,4,7932,[196 276  95 202 187],786,4,32159,4.053825790999622,0.0,0.0
47933,4,7933,[318  79 427 588 216],577,5,32164,4.053945046634737,40.0,0.0
47934,4,7934,[318  79 427 588 216],796,5,32169,4.05406427221172,40.0,0.0
47935,4,7935,[318  79 427 588 216],796,5,32174,4.054183467741935,40.0,0.0
47936,4,7936,[318  79 427 588 216],716,5,32179,4.054302633236739,40.0,0.0
47937,4,7937,[238 301 405 204  69],11,1,32180,4.053917863441673,0.0,0.0
47938,4,7938,[318  79 427 588 216],796,5,32185,4.054037032371835,40.0,0.0
47939,4,7939,[318  79 427 588 216],450,5,32190,4.054156171284634,40.0,0.0
47940,4,7940,[318  79 427 588 216],796,5,32195,4.054275280191412,40.0,0.0
47941,4,7941,[318  79 427 588 216],796,5,32200,4.0543943591035,40.0,0.0
47942,4,7942,[323  50 258 210 742],756,2,32202,4.054135716983508,0.0,20.0
47943,4,7943,[318  79 427 588 216],577,5,32207,4.0542547834843905,40.0,0.0
47944,4,7944,[173 100 132 357 176],786,5,32212,4.054373820012587,0.0,20.0
47945,4,7945,[ 25 288 313 234  56],593,3,32215,4.054241127611377,0.0,0.0
47946,4,7946,[ 71 125 191  69  82],18,2,32217,4.053982634956587,0.0,0.0
47947,4,7947,[318  79 427 588 216],716,5,32222,4.054101660795169,40.0,0.0
47948,4,7948,[318  79 427 588 216],577,5,32227,4.054220656686375,40.0,0.0
47949,4,7949,[268 180 173  89 185],269,2,32229,4.053962264150943,0.0,0.0
47950,4,7950,[127 318   9 216 132],796,4,32233,4.053955477298453,20.0,20.0
47951,4,7951,[111 143  89 161 100],756,4,32237,4.053948692152917,0.0,20.0
47952,4,7952,[235 215 423 405 588],450,4,32241,4.053941908713693,0.0,0.0
47953,4,7953,[183 216 211  96 181],450,5,32246,4.05406084988685,0.0,0.0
47954,4,7954,[318  79 427 588 216],450,5,32251,4.054179761156505,40.0,0.0
47955,4,7955,[ 88 174  25 172 153],389,2,32253,4.053921568627451,0.0,0.0
47956,4,7956,[276  50 211 357 403],504,2,32255,4.05366344099535,0.0,20.0
47957,4,7957,[197 204 742 588 168],457,5,32260,4.0537823573762255,0.0,0.0
47958,4,7958,[318  79 427 588 216],716,5,32265,4.053901243874859,40.0,0.0
47959,4,7959,[286 172 100 302 185],707,3,32268,4.053768844221105,0.0,40.0
47960,4,7960,[318  79 427 588 216],716,5,32273,4.053887702549931,40.0,0.0
47961,4,7961,[202 151 125 318 471],577,4,32277,4.053880934438583,20.0,0.0
47962,4,7962,[435 179  50   9 168],269,3,32280,4.053748587215874,0.0,20.0
47963,4,7963,[176   8 318  79 222],796,5,32285,4.053867403314917,20.0,0.0
47964,4,7964,[172 318 179  15 276],593,4,32289,4.053860640301318,20.0,0.0
47965,4,7965,[143 237 546 172 195],796,5,32294,4.053979412503138,0.0,0.0
47966,4,7966,[318  79 427 588 216],716,5,32299,4.054098154888917,40.0,0.0
47967,4,7967,[318  79 427 588 216],450,5,32304,4.054216867469879,40.0,0.0
47968,4,7968,[202 265 269 655 271],796,3,32307,4.054084577738737,0.0,0.0
47969,4,7969,[211 204  12 132  96],796,4,32311,4.054077791718946,0.0,0.0
47970,4,7970,[185  15 265  96  50],655,2,32313,4.053820097854723,0.0,20.0
47971,4,7971,[678 403 222 496 204],280,1,32314,4.053437029603613,20.0,0.0
47972,4,7972,[318  79 427 588 216],796,5,32319,4.0535557506584725,40.0,0.0
47973,4,7973,[313 273  97 228 508],344,3,32322,4.053423626787058,0.0,0.0
47974,4,7974,[318  79 427 588 216],450,5,32327,4.053542319749217,40.0,0.0
47975,4,7975,[318  79 427 588 216],18,5,32332,4.053660982948847,40.0,0.0
47976,4,7976,[210 603 196 286 194],535,4,32336,4.053654255985959,20.0,20.0
47977,4,7977,[318  79 427 588 216],450,5,32341,4.05377287540737,40.0,0.0
47978,4,7978,[318  79 427 588 216],18,5,32346,4.053891465095877,40.0,0.0
47979,4,7979,[318  79 427 588 216],716,5,32351,4.054010025062657,40.0,0.0
47980,4,7980,[427 132 202 235 196],269,2,32353,4.053752662573612,20.0,0.0
47981,4,7981,[318  79 427 588 216],18,5,32358,4.053871210223002,40.0,0.0
47982,4,7982,[318  79 427 588 216],796,5,32363,4.0539897281723665,40.0,0.0
47983,4,7983,[357  79 168 172 210],535,2,32365,4.05373246492986,0.0,0.0
47984,4,7984,[161 210 300  95 294],716,4,32369,4.05372573575454,0.0,0.0
47985,4,7985,[ 79 385  71  50   8],344,3,32372,4.0535937891309795,0.0,20.0
47986,4,7986,[318 427  79 588 216],716,5,32377,4.053712282458996,40.0,0.0
47987,4,7987,[318 427  79 588 216],450,5,32382,4.0538307461191785,40.0,0.0
47988,4,7988,[194 546 180  15 117],450,4,32386,4.0538240080110155,0.0,0.0
47989,4,7989,[318 427  79 588 216],577,5,32391,4.053942428035044,40.0,0.0
47990,4,7990,[318 427  79 588 216],450,5,32396,4.054060818420723,40.0,0.0
47991,4,7991,[111 151  11 202 216],401,3,32399,4.053928928928929,0.0,0.0
47992,4,7992,[ 25 125 275 161 588],450,4,32403,4.05392218190917,0.0,20.0
47993,4,7993,[127 168  71 216  97],450,4,32407,4.053915436577433,0.0,20.0
47994,4,7994,[427 258   9 333 187],693,2,32409,4.053658536585366,20.0,0.0
47995,4,7995,[318 427  79 588 216],796,5,32414,4.053776888444222,40.0,0.0
47996,4,7996,[318 427  79 588 216],716,5,32419,4.053895210704014,40.0,0.0
47997,4,7997,[318 427  79 588 216],18,5,32424,4.0540135033758435,40.0,0.0
47998,4,7998,[318 427  79 588 216],796,5,32429,4.0541317664708085,40.0,0.0
47999,4,7999,[228 191   1  69  82],151,3,32432,4.054,0.0,0.0
48000,4,8000,[318 195   4 125 496],151,4,32436,4.053993250843645,40.0,0.0
48001,4,8001,[186 288  89 228  98],655,2,32438,4.053736565858535,0.0,0.0
48002,4,8002,[318 427  79 588 216],18,5,32443,4.053854804448332,40.0,0.0
48003,4,8003,[132  50 568 195 176],796,5,32448,4.053973013493254,0.0,20.0
48004,4,8004,[ 56 234 273 289 127],655,2,32450,4.053716427232979,0.0,20.0
48005,4,8005,[269 181  88 172 403],655,1,32451,4.053334998750937,0.0,0.0
48006,4,8006,[210 204 313 191 143],577,3,32454,4.053203446983889,0.0,0.0
48007,4,8007,[100 204 200 435 196],236,1,32455,4.052822177822178,0.0,20.0
48008,4,8008,[318 427  79 588 216],18,5,32460,4.052940442002747,40.0,0.0
48009,4,8009,[ 70 117 313  56  15],450,4,32464,4.052933832709114,0.0,0.0
48010,4,8010,[318 427  79 588 216],450,5,32469,4.053052053426539,40.0,0.0
48011,4,8011,[ 64 678 191  89 318],316,3,32472,4.052920619071393,40.0,0.0
48012,4,8012,[318 427  79 588 216],577,5,32477,4.053038811930612,40.0,0.0
48013,4,8013,[275 125 302 268  69],655,2,32479,4.0527826303968055,0.0,20.0
48014,4,8014,[153 496 118  11 187],716,3,32482,4.052651278852152,20.0,0.0
48015,4,8015,[172   4   8 222   7],344,5,32487,4.052769461077844,0.0,0.0
48016,4,8016,[318 237  70 300 144],716,4,32491,4.052762878882375,20.0,0.0
48017,4,8017,[127 234  28 265 211],450,4,32495,4.05275629832876,0.0,20.0
48018,4,8018,[  4 143 194  15 328],450,3,32498,4.052625015587979,0.0,0.0
48019,4,8019,[318 427  79 588 216],796,5,32503,4.052743142144639,40.0,0.0
48020,4,8020,[ 28  69 258 234 273],655,1,32504,4.052362548310684,0.0,0.0
48021,4,8021,[282 117 111 265 100],236,2,32506,4.052106706556969,0.0,20.0
48022,4,8022,[318 427  79 588 216],450,5,32511,4.052224853546055,40.0,0.0
48023,4,8023,[  9  89 202  95 385],796,4,32515,4.052218344965104,0.0,0.0
48024,4,8024,[318 427  79 588 216],796,5,32520,4.052336448598131,40.0,0.0
48025,4,8025,[ 97 238 323 183 322],796,1,32521,4.051956142536755,0.0,0.0
48026,4,8026,[318 427  79 588 216],577,5,32526,4.052074249408247,40.0,0.0
48027,4,8027,[289 117 302 742 186],655,1,32527,4.051694070752367,0.0,0.0
48028,4,8028,[318 427  79 588 216],18,5,32532,4.051812180844439,40.0,0.0
48029,4,8029,[216 181 196   1 385],344,2,32534,4.051556662515567,0.0,0.0
48030,4,8030,[748  64 328  11 405],450,5,32539,4.051674760303823,20.0,0.0
48031,4,8031,[174 546 211 275 222],23,4,32543,4.051668326693227,0.0,20.0
48032,4,8032,[ 69 294 121 204 603],655,1,32544,4.05128843520478,20.0,0.0
48033,4,8033,[161 357 282 483 237],401,2,32546,4.0510331092855365,0.0,0.0
48034,4,8034,[ 50 132 172 496 435],18,4,32550,4.051026757934038,20.0,20.0
48035,4,8035,[318 427  79 588 216],577,5,32555,4.051144848183176,40.0,0.0
48036,4,8036,[135 144 180 161 121],693,2,32557,4.050889635436108,0.0,0.0
48037,4,8037,[318 427  79 588 216],18,5,32562,4.051007713361533,40.0,0.0
48038,4,8038,[121 302  79 176  50],344,4,32566,4.051001368329394,0.0,20.0
48039,4,8039,[191 508   7 204 216],344,5,32571,4.051119402985075,0.0,0.0
48040,4,8040,[318 427  79 588 216],796,5,32576,4.051237408282552,40.0,0.0
48041,4,8041,[275 121 194 302  15],151,4,32580,4.051231037055459,0.0,20.0
48042,4,8042,[318 427  79 588 216],716,5,32585,4.051348999129678,40.0,0.0
48043,4,8043,[318 427  79 588 216],577,5,32590,4.051466931874689,40.0,0.0
48044,4,8044,[121 100 546 161   1],593,3,32593,4.051336233685519,0.0,20.0
48045,4,8045,[200 100 195  97 235],457,4,32597,4.051329853343276,0.0,20.0
48046,4,8046,[318 427  79 588 216],577,5,32602,4.051447744501056,40.0,0.0
48047,4,8047,[318 427  79 588 216],577,5,32607,4.051565606361829,40.0,0.0
48048,4,8048,[ 56 318 222 258 273],450,3,32610,4.051434960864704,20.0,0.0
48049,4,8049,[173  56 118   1 234],292,4,32614,4.051428571428572,0.0,0.0
48050,4,8050,[ 56 180 294  22 300],450,5,32619,4.051546391752577,0.0,0.0
48051,4,8051,[100 135  25 269  69],450,3,32622,4.0514157973174365,0.0,20.0
48052,4,8052,[318 427  79 588 216],577,5,32627,4.051533589966472,40.0,0.0
48053,4,8053,[200 294 471 435   1],655,1,32628,4.0511547057362804,0.0,0.0
48054,4,8054,[ 11 234 210 301 191],655,1,32629,4.050775915580385,0.0,0.0
48055,4,8055,[318 143 202  22 180],18,4,32633,4.050769612711023,20.0,0.0
48056,4,8056,[748 357 132 200 265],151,3,32636,4.050639195730421,0.0,0.0
48057,4,8057,[318 427  79 588 216],796,5,32641,4.050757011665426,40.0,0.0
48058,4,8058,[318 427  79 588 216],796,5,32646,4.05087479836208,40.0,0.0
48059,4,8059,[318 427  79 588 216],18,5,32651,4.050992555831265,40.0,0.0
48060,4,8060,[318 427  79 588 216],577,5,32656,4.051110284083861,40.0,0.0
48061,4,8061,[111 318 210 100 423],450,4,32660,4.051103944430662,20.0,20.0
48062,4,8062,[111 161   7 318   8],457,4,32664,4.051097606349994,20.0,0.0
48063,4,8063,[ 97 234 191  96   1],716,4,32668,4.05109126984127,0.0,0.0
48064,4,8064,[318 427  79 588 216],577,5,32673,4.051208927464352,40.0,0.0
48065,4,8065,[215 161 195 385 423],280,3,32676,4.051078601537317,0.0,0.0
48066,4,8066,[258 186  25 286 176],151,4,32680,4.05107226974092,0.0,20.0
48067,4,8067,[318 427  79 588 216],796,5,32685,4.051189885969261,40.0,0.0
48068,4,8068,[  9 234   4 228 215],655,0,32685,4.050687817573429,0.0,0.0
48069,4,8069,[174 323 197 202 210],639,1,32686,4.050309789343246,0.0,0.0
48070,4,8070,[318 427  79 588 216],716,5,32691,4.050427456325115,40.0,0.0
48071,4,8071,[328 427 228  22 405],655,1,32692,4.050049554013875,20.0,0.0
48072,4,8072,[546  28 237 174 302],450,5,32697,4.050167224080267,0.0,0.0
48073,4,8073,[318 427  79 588 216],450,5,32702,4.050284864998761,40.0,0.0
48074,4,8074,[318 427  79 588 216],18,5,32707,4.050402476780186,40.0,0.0
48075,4,8075,[588 216  22 603   8],18,4,32711,4.050396235760277,20.0,0.0
48076,4,8076,[ 71 405 204  98 143],450,4,32715,4.05038999628575,0.0,0.0
48077,4,8077,[318 427  79 588 216],577,5,32720,4.0505075513741025,40.0,0.0
48078,4,8078,[183 211  88  69  98],269,2,32722,4.050253744275282,0.0,0.0
48079,4,8079,[172  69 568 385 228],457,5,32727,4.050371287128713,0.0,0.0
48080,4,8080,[318 427  79 588 216],716,5,32732,4.050488800890979,40.0,0.0
48081,4,8081,[318 427  79 588 216],18,5,32737,4.050606285572878,40.0,0.0
48082,4,8082,[318 427  79 588 216],450,5,32742,4.0507237411852035,40.0,0.0
48083,4,8083,[318 427  79 588 216],577,5,32747,4.050841167738743,40.0,0.0
48084,4,8084,[333  50 210 385   1],655,1,32748,4.050463821892393,0.0,20.0
48085,4,8085,[318 427  79 588 216],450,5,32753,4.050581251545882,40.0,0.0
48086,4,8086,[435   9  50 508 117],655,1,32754,4.0502040311611225,0.0,20.0
48087,4,8087,[318 427  79 588 216],796,5,32759,4.050321463897132,40.0,0.0
48088,4,8088,[318 427  79 588 216],577,5,32764,4.050438867597973,40.0,0.0
48089,4,8089,[427 182 194   7 111],450,5,32769,4.050556242274413,20.0,0.0
48090,4,8090,[318 427  79 588 216],18,5,32774,4.050673587937214,40.0,0.0
48091,4,8091,[318 427  79 588 216],796,5,32779,4.050790904597133,40.0,0.0
48092,4,8092,[318 427  79 588 216],796,5,32784,4.05090819226492,40.0,0.0
48093,4,8093,[318 427  79 588 216],716,5,32789,4.051025450951322,40.0,0.0
48094,4,8094,[125  79  97 161  88],593,5,32794,4.051142680667079,0.0,0.0
48095,4,8095,[204 186 268 210 258],655,0,32794,4.050642292490118,0.0,0.0
48096,4,8096,[204  82   4 496 322],796,3,32797,4.050512535506978,20.0,0.0
48097,4,8097,[742 176  56 121 282],693,2,32799,4.050259323289701,0.0,0.0
48098,4,8098,[318 427  79 588 216],450,5,32804,4.050376589702433,40.0,0.0
48099,4,8099,[135 269 125 258 483],655,2,32806,4.050123456790123,0.0,0.0
48100,4,8100,[ 56 202  69  79 210],577,3,32809,4.049993827922479,0.0,0.0
48101,4,8101,[ 56 597 100 228 238],23,4,32813,4.049987657368551,0.0,20.0
48102,4,8102,[185 301 175   8 215],11,3,32816,4.049858077255338,0.0,0.0
48103,4,8103,[300 100 427 603  28],908,4,32820,4.049851924975321,40.0,20.0
48104,4,8104,[318 427  79 588 216],577,5,32825,4.04996915484269,40.0,0.0
48105,4,8105,[117  22 300 276 269],629,4,32829,4.049962990377498,0.0,0.0
48106,4,8106,[ 15   1 176 204 282],457,5,32834,4.050080177624276,0.0,0.0
48107,4,8107,[318 427  79 588 216],796,5,32839,4.050197335964479,40.0,0.0
48108,4,8108,[ 88   9 132  50 302],151,4,32843,4.050191145640646,0.0,20.0
48109,4,8109,[186 222 273 174 427],655,2,32845,4.049938347718865,20.0,0.0
48110,4,8110,[546  95 186 127 237],716,3,32848,4.049808901491801,0.0,20.0
48111,4,8111,[237 678 185 403   7],256,5,32853,4.049926035502959,0.0,0.0
48112,4,8112,[318 427  79 588 216],450,5,32858,4.050043140638482,40.0,0.0
48113,4,8113,[318 427  79 588 216],796,5,32863,4.050160216909046,40.0,0.0
48114,4,8114,[222 588 168 153 181],450,4,32867,4.05015403573629,0.0,0.0
48115,4,8115,[318 427  79 588 216],716,5,32872,4.050271069492361,40.0,0.0
48116,4,8116,[202  98 191 161 238],655,2,32874,4.050018479733891,0.0,0.0
48117,4,8117,[318 427  79 588 216],716,5,32879,4.0501355013550135,40.0,0.0
48118,4,8118,[  4  88 427 258  98],796,5,32884,4.050252494149526,20.0,0.0
48119,4,8119,[318 427  79 588 216],18,5,32889,4.0503694581280785,40.0,0.0
48120,4,8120,[318 427  79 588 216],18,5,32894,4.050486393301318,40.0,0.0
48121,4,8121,[318 427  79 588 216],577,5,32899,4.0506032996798815,40.0,0.0
48122,4,8122,[258 222  98 153 211],151,4,32903,4.050597070048012,0.0,0.0
48123,4,8123,[318 427  79 588 216],796,5,32908,4.050713934022649,40.0,0.0
48124,4,8124,[161 121 111  56 568],593,5,32913,4.050830769230769,0.0,0.0
48125,4,8125,[ 64  70  15 151   1],457,5,32918,4.050947575682993,20.0,0.0
48126,4,8126,[294 185 515  82  79],716,5,32923,4.051064353389934,0.0,0.0
48127,4,8127,[318 427  79 588 216],577,5,32928,4.051181102362205,40.0,0.0
48128,4,8128,[174 286  15  97 588],878,2,32930,4.050928773526879,0.0,20.0
48129,4,8129,[210 588  95 183 655],786,5,32935,4.051045510455104,0.0,0.0
48130,4,8130,[318 427  79 588 216],577,5,32940,4.05116221866929,40.0,0.0
48131,4,8131,[196 257 322   9  88],504,4,32944,4.05115592720118,0.0,0.0
48132,4,8132,[183 471  28 655 202],655,1,32945,4.050780769703676,0.0,0.0
48133,4,8133,[471 172 597 405  70],457,4,32949,4.050774526678141,0.0,0.0
48134,4,8134,[204 322  11 302 282],450,5,32954,4.050891210817455,0.0,0.0
48135,4,8135,[568 273  71 211 238],450,3,32957,4.050762045231072,0.0,0.0
48136,4,8136,[100 258 245 546  50],796,3,32960,4.050632911392405,0.0,40.0
48137,4,8137,[ 12 195  25 161  64],457,5,32965,4.050749569918899,20.0,0.0
48138,4,8138,[ 95 568 118 161 196],577,3,32968,4.050620469345128,0.0,0.0
48139,4,8139,[215 197 117 125   1],280,2,32970,4.0503685503685505,0.0,0.0
48140,4,8140,[318 427  79 588 216],450,5,32975,4.050485198378578,40.0,0.0
48141,4,8141,[318 427  79 588 216],796,5,32980,4.0506018177352,40.0,0.0
48142,4,8142,[ 88  71 125 294 385],504,3,32983,4.050472798722829,0.0,0.0
48143,4,8143,[318 427  79 588 216],796,5,32988,4.050589390962672,40.0,0.0
48144,4,8144,[318 427  79 588 216],796,5,32993,4.050705954573358,40.0,0.0
48145,4,8145,[ 88 546 286  79 216],796,4,32997,4.050699729928799,0.0,20.0
48146,4,8146,[318 427  79 588 216],450,5,33002,4.050816251380876,40.0,0.0
48147,4,8147,[196 179 202 655 168],457,5,33007,4.050932744231713,0.0,0.0
48148,4,8148,[318 427  79 588 216],18,5,33012,4.05104920849184,40.0,0.0
48149,4,8149,[ 22 235 471 125 318],450,4,33016,4.0510429447852765,20.0,0.0
48150,4,8150,[318 427  79 588 216],796,5,33021,4.05115936694884,40.0,0.0
48151,4,8151,[210  50  88 423  96],457,5,33026,4.051275760549558,0.0,20.0
48152,4,8152,[  1 427 173 187 588],389,4,33030,4.051269471360236,20.0,0.0
48153,4,8153,[228 471 568 245 385],344,2,33032,4.051017905322541,0.0,0.0
48154,4,8154,[318 427  79 588 216],796,5,33037,4.05113427345187,40.0,0.0
48155,4,8155,[204  50 568 179 294],450,5,33042,4.05125061304561,0.0,20.0
48156,4,8156,[318 427  79 588 216],796,5,33047,4.051366924114258,40.0,0.0
48157,4,8157,[318 427  79 588 216],796,5,33052,4.051483206668301,40.0,0.0
48158,4,8158,[276   9  11 483 174],457,5,33057,4.051599460718225,0.0,0.0
48159,4,8159,[318 427  79 588 216],450,5,33062,4.05171568627451,40.0,0.0
48160,4,8160,[318 427  79 588 216],796,5,33067,4.051831883347629,40.0,0.0
48161,4,8161,[  7 265 282  79 228],655,1,33068,4.051457975986278,0.0,0.0
48162,4,8162,[173  88  96 265  69],450,5,33073,4.051574176160726,0.0,0.0
48163,4,8163,[235 194 100 322  69],401,2,33075,4.051322880940715,0.0,20.0
48164,4,8164,[318 427  79 588 216],450,5,33080,4.051439069197795,40.0,0.0
48165,4,8165,[318 427  79 588 216],450,5,33085,4.051555228998286,40.0,0.0
48166,4,8166,[318 427  79 588 216],18,5,33090,4.051671360352639,40.0,0.0
48167,4,8167,[423  12  56 655 546],151,4,33094,4.051665034280117,0.0,0.0
48168,4,8168,[211 161 174  88  98],716,4,33098,4.0516587097563965,0.0,0.0
48169,4,8169,[182 194  98 427 202],450,5,33103,4.0517747858017135,20.0,0.0
48170,4,8170,[235 125  25   4  15],457,4,33107,4.051768449394199,0.0,0.0
48171,4,8171,[405 515 435 121 144],655,1,33108,4.051395007342144,0.0,0.0
48172,4,8172,[318 427  79 588 216],577,5,33113,4.051511073045393,40.0,0.0
48173,4,8173,[111 100 153 427 172],296,4,33117,4.051504771225838,20.0,20.0
48174,4,8174,[318 427  79 588 216],18,5,33122,4.051620795107033,40.0,0.0
48175,4,8175,[318 427  79 588 216],716,5,33127,4.051736790606654,40.0,0.0
48176,4,8176,[318 427  79 588 216],450,5,33132,4.05185275773511,40.0,0.0
48177,4,8177,[111 144 153 475 168],292,5,33137,4.051968696502812,0.0,0.0
48178,4,8178,[318 427  79 588 216],716,5,33142,4.052084606920161,40.0,0.0
48179,4,8179,[ 98 471 427 282  97],655,2,33144,4.051833740831296,20.0,0.0
48180,4,8180,[318 427  79 588 216],577,5,33149,4.051949639408385,40.0,0.0
48181,4,8181,[211 191  28  69 222],151,4,33153,4.051943290149108,0.0,0.0
48182,4,8182,[182  11 286 258 475],629,4,33157,4.051936942441647,0.0,20.0
48183,4,8183,[405 175 222 161 176],457,5,33162,4.052052785923753,0.0,0.0
48184,4,8184,[318 427  79 588 216],577,5,33167,4.052168601099573,40.0,0.0
48185,4,8185,[258 748  71 111 117],450,4,33171,4.0521622281944785,0.0,0.0
48186,4,8186,[173 132 118 191  79],562,4,33175,4.05215585684622,0.0,0.0
48187,4,8187,[ 79 117 161 301 282],450,5,33180,4.052271617000488,0.0,0.0
48188,4,8188,[ 97  28 182 276 144],457,5,33185,4.052387348882648,0.0,0.0
48189,4,8189,[318 427  79 588 216],796,5,33190,4.052503052503052,40.0,0.0
48190,4,8190,[132   1  28  96  69],577,5,33195,4.052618727872055,0.0,0.0
48191,4,8191,[ 25 215   9 202 200],457,5,33200,4.052734375,0.0,0.0
48192,4,8192,[143 405 238 173  15],151,4,33204,4.052727938484072,0.0,0.0
48193,4,8193,[318 427  79 588 216],18,5,33209,4.052843544056627,40.0,0.0
48194,4,8194,[546 200 176 748 185],151,1,33210,4.052471018913972,0.0,0.0
48195,4,8195,[318 427  79 588 216],796,5,33215,4.0525866276232305,40.0,0.0
48196,4,8196,[318 427  79 588 216],577,5,33220,4.0527022081249235,40.0,0.0
48197,4,8197,[318 427  79 588 216],18,5,33225,4.052817760429373,40.0,0.0
48198,4,8198,[318 427  79 588 216],450,5,33230,4.052933284546896,40.0,0.0
48199,4,8199,[318 427  79 588 216],577,5,33235,4.053048780487805,40.0,0.0
48200,4,8200,[318 427  79 588 216],796,5,33240,4.053164248262407,40.0,0.0
48201,4,8201,[318 427  79 588 216],18,5,33245,4.0532796878810045,40.0,0.0
48202,4,8202,[318 427  79 588 216],796,5,33250,4.053395099353895,40.0,0.0
48203,4,8203,[318 427  79 588 216],577,5,33255,4.05351048269137,40.0,0.0
48204,4,8204,[ 96 180 183 423 475],292,5,33260,4.053625837903717,0.0,0.0
48205,4,8205,[318 427  79 588 216],716,5,33265,4.0537411650012185,40.0,0.0
48206,4,8206,[318 427  79 588 216],450,5,33270,4.053856463994151,40.0,0.0
48207,4,8207,[318 427  79 588 216],450,5,33275,4.053971734892787,40.0,0.0
48208,4,8208,[286   8 174  64 183],796,4,33279,4.053965160190035,20.0,20.0
48209,4,8209,[180 196 202 357 216],18,3,33282,4.053836784409257,0.0,0.0
48210,4,8210,[ 82 427  25 127 423],716,5,33287,4.053952015588845,20.0,20.0
48211,4,8211,[435 385 403 118 179],655,1,33288,4.0535801266439355,0.0,0.0
48212,4,8212,[ 50 117 153 328 286],629,4,33292,4.05357360282479,0.0,40.0
48213,4,8213,[196  97 237 318 403],224,4,33296,4.0535670805941075,20.0,0.0
48214,4,8214,[318 427  79 588 216],716,5,33301,4.053682288496653,40.0,0.0
48215,4,8215,[318 427  79 588 216],577,5,33306,4.05379746835443,40.0,0.0
48216,4,8216,[121 568 245 471 357],450,4,33310,4.053790921260801,0.0,0.0
48217,4,8217,[318 427  79 588 216],796,5,33315,4.053906059868581,40.0,0.0
48218,4,8218,[ 12 265 546 195 322],280,4,33319,4.0538995011558585,0.0,0.0
48219,4,8219,[318 427  79 588 216],716,5,33324,4.054014598540146,40.0,0.0
48220,4,8220,[237  12 153 200 204],18,2,33326,4.053764748814013,0.0,0.0
48221,4,8221,[318 427  79 588 216],577,5,33331,4.053879834590124,40.0,0.0
48222,4,8222,[  4 603 196 475 405],655,1,33332,4.053508451903198,20.0,0.0
48223,4,8223,[ 70 568 153 200 211],593,5,33337,4.053623540856031,0.0,0.0
48224,4,8224,[168  95 194 403 174],18,2,33339,4.053373860182371,0.0,0.0
48225,4,8225,[318 427  79 588 216],577,5,33344,4.053488937515196,40.0,0.0
48226,4,8226,[289 405 748 258 271],807,3,33347,4.0533608848912115,0.0,0.0
48227,4,8227,[357 742 385 183 268],344,2,33349,4.053111327175499,0.0,0.0
48228,4,8228,[597  15 144 174 655],593,3,33352,4.052983351561551,0.0,0.0
48229,4,8229,[318 427  79 588 216],18,5,33357,4.053098420413122,40.0,0.0
48230,4,8230,[318 427  79 588 216],577,5,33362,4.053213461304823,40.0,0.0
48231,4,8231,[318 427  79 588 216],18,5,33367,4.053328474246841,40.0,0.0
48232,4,8232,[318 427  79 588 216],577,5,33372,4.053443459249363,40.0,0.0
48233,4,8233,[172 183  88 151 597],450,5,33377,4.053558416322565,0.0,0.0
48234,4,8234,[318 427  79 588 216],450,5,33382,4.053673345476624,40.0,0.0
48235,4,8235,[228  97 323 100 173],756,1,33383,4.05330257406508,0.0,20.0
48236,4,8236,[125 135  22 211  25],450,3,33386,4.053174699526527,0.0,0.0
48237,4,8237,[318 427  79 588 216],18,5,33391,4.053289633406166,40.0,0.0
48238,4,8238,[318 427  79 588 216],716,5,33396,4.0534045393858475,40.0,0.0
48239,4,8239,[318 427  79 588 216],450,5,33401,4.053519417475728,40.0,0.0
48240,4,8240,[132 471 597 127 176],457,4,33405,4.053512923188934,0.0,20.0
48241,4,8241,[318 427  79 588 216],18,5,33410,4.053627760252366,40.0,0.0
48242,4,8242,[318 427  79 588 216],18,5,33415,4.0537425694528695,40.0,0.0
48243,4,8243,[238 403 234   1 200],796,2,33417,4.0534934497816595,0.0,0.0
48244,4,8244,[318 427  79 588 216],18,5,33422,4.05360824742268,40.0,0.0
48245,4,8245,[318 427  79 588 216],796,5,33427,4.05372301722047,40.0,0.0
48246,4,8246,[  4  69 215  64   9],151,4,33431,4.053716502970778,20.0,0.0
48247,4,8247,[318 427  79 588 216],577,5,33436,4.053831231813773,40.0,0.0
48248,4,8248,[318 427  79 588 216],450,5,33441,4.053945932840344,40.0,0.0
48249,4,8249,[179   8 318 423 357],18,5,33446,4.054060606060606,20.0,0.0
48250,4,8250,[153  25 286 423 179],18,4,33450,4.054054054054054,0.0,20.0
48251,4,8251,[211   1 200 238 515],655,2,33452,4.053805138148328,0.0,0.0
48252,4,8252,[318 427  79 588 216],577,5,33457,4.053919786744214,40.0,0.0
48253,4,8253,[318 427  79 588 216],450,5,33462,4.054034407559971,40.0,0.0
48254,4,8254,[ 88 143 357  98 234],655,3,33465,4.053906723198062,0.0,0.0
48255,4,8255,[196 286 234 300 301],629,4,33469,4.05390019379845,0.0,20.0
48256,4,8256,[300 265 258 176 118],655,0,33469,4.053409228533366,0.0,0.0
48257,4,8257,[125 258 257  88 265],798,4,33473,4.05340276095907,0.0,0.0
48258,4,8258,[318 427  79 588 216],796,5,33478,4.053517374984865,40.0,0.0
48259,4,8259,[ 82 328 172 210 176],655,1,33479,4.0531476997578695,0.0,0.0
48260,4,8260,[ 96  64 135 195  28],457,5,33484,4.053262316910786,20.0,0.0
48261,4,8261,[276 132 183 222 423],655,2,33486,4.053013798111837,0.0,0.0
48262,4,8262,[318 427  79 588 216],577,5,33491,4.0531284037274595,40.0,0.0
48263,4,8263,[  1 176 423 181 173],389,4,33495,4.0531219748305904,0.0,0.0
48264,4,8264,[546 265  69  50 186],807,5,33500,4.053236539624924,0.0,20.0
48265,4,8265,[318 427  79 588 216],18,5,33505,4.053351076699734,40.0,0.0
48266,4,8266,[ 69 100 301  98   4],629,3,33508,4.053223660336276,0.0,20.0
48267,4,8267,[318 427  79 588 216],796,5,33513,4.053338171262699,40.0,0.0
48268,4,8268,[318 427  79 588 216],796,5,33518,4.053452654492683,40.0,0.0
48269,4,8269,[194 655 234 269   4],450,3,33521,4.053325272067714,0.0,0.0
48270,4,8270,[318 427  79 588 216],716,5,33526,4.053439729174223,40.0,0.0
48271,4,8271,[318 427  79 588 216],577,5,33531,4.0535541586073505,40.0,0.0
48272,4,8272,[318 427  79 588 216],577,5,33536,4.0536685603771305,40.0,0.0
48273,4,8273,[748 300 127  28 265],292,4,33540,4.053662073966643,0.0,20.0
48274,4,8274,[ 56 423 265 161 286],450,5,33545,4.053776435045317,0.0,20.0
48275,4,8275,[132 403 216  71 211],450,4,33549,4.053769937167714,0.0,0.0
48276,4,8276,[271  97  56 435 282],655,0,33549,4.053280173976078,0.0,0.0
48277,4,8277,[235 269 282 118  22],450,3,33552,4.053152935491664,0.0,0.0
48278,4,8278,[318 294 471 197 118],655,1,33553,4.052784152675444,20.0,0.0
48279,4,8279,[318 427  79 588 216],18,5,33558,4.052898550724637,40.0,0.0
48280,4,8280,[318 427  79 588 216],716,5,33563,4.05301292114479,40.0,0.0
48281,4,8281,[237 357   4 210 143],716,4,33567,4.053006520164211,0.0,0.0
48282,4,8282,[172 195 197 238 181],457,5,33572,4.053120849933599,0.0,0.0
48283,4,8283,[318 427  79 588 216],18,5,33577,4.053235152100434,40.0,0.0
48284,4,8284,[318 427  79 588 216],577,5,33582,4.053349426674713,40.0,0.0
48285,4,8285,[318 427  79 588 216],18,5,33587,4.053463673666426,40.0,0.0
48286,4,8286,[200   4 125 403 210],450,2,33589,4.053215880294437,0.0,0.0
48287,4,8287,[195 423 187 435 603],535,4,33593,4.05320945945946,20.0,0.0
48288,4,8288,[318 427  79 588 216],18,5,33598,4.053323681988177,40.0,0.0
48289,4,8289,[318   4 144  56 258],457,5,33603,4.053437876960193,20.0,0.0
48290,4,8290,[655 132 183 257 333],655,1,33604,4.053069593535159,0.0,0.0
48291,4,8291,[200 216 100 403  97],504,4,33608,4.05306319343946,0.0,20.0
48292,4,8292,[318 427  79 588 216],577,5,33613,4.053177378511998,40.0,0.0
48293,4,8293,[180  88 202 269   9],18,3,33616,4.053050397877984,0.0,0.0
48294,4,8294,[318 427  79 588 216],18,5,33621,4.053164556962026,40.0,0.0
48295,4,8295,[216 318  28 210  64],330,5,33626,4.05327868852459,40.0,0.0
48296,4,8296,[403 153  95  15 195],796,5,33631,4.05339279257563,0.0,0.0
48297,4,8297,[318 427  79 588 216],18,5,33636,4.053506869125091,40.0,0.0
48298,4,8298,[ 56 282  95  71 161],796,5,33641,4.053620918182913,0.0,0.0
48299,4,8299,[318 427  79 588 216],450,5,33646,4.053734939759036,40.0,0.0
48300,4,8300,[127 265 187 168   1],450,5,33651,4.05384893386339,0.0,20.0
48301,4,8301,[546 180 235 187 118],450,3,33654,4.053721994700072,0.0,0.0
48302,4,8302,[125 161 121 132   7],450,4,33658,4.053715524509213,0.0,0.0
48303,4,8303,[318 427  79 588 216],450,5,33663,4.053829479768786,40.0,0.0
48304,4,8304,[111 403  25 172 294],457,3,33666,4.053702588801927,0.0,0.0
48305,4,8305,[318 427  79 588 216],716,5,33671,4.053816518179629,40.0,0.0
48306,4,8306,[197 655   7 403 286],280,2,33673,4.053569278921391,0.0,20.0
48307,4,8307,[318 427  79 588 216],577,5,33678,4.053683196918633,40.0,0.0
48308,4,8308,[191 238 300 151 568],389,3,33681,4.053556384643158,0.0,0.0
48309,4,8309,[318 427  79 588 216],796,5,33686,4.0536702767749695,40.0,0.0
48310,4,8310,[ 98  82 176 100 179],450,4,33690,4.053663819035014,0.0,20.0
48311,4,8311,[568  25 269 322 153],450,4,33694,4.053657362848893,0.0,0.0
48312,4,8312,[435 168 161 100 204],450,5,33699,4.053771201732227,0.0,20.0
48313,4,8313,[318 427  79 588 216],796,5,33704,4.053885013230695,40.0,0.0
48314,4,8314,[  1  69 237 222  22],280,3,33707,4.053758268190018,0.0,0.0
48315,4,8315,[216 121 132 183 423],693,2,33709,4.0535113035113035,0.0,0.0
48316,4,8316,[318 427  79 588 216],716,5,33714,4.053625105206204,40.0,0.0
48317,4,8317,[318 427  79 588 216],18,5,33719,4.053738879538351,40.0,0.0
48318,4,8318,[ 28 197 204  25  71],389,4,33723,4.053732419761991,0.0,0.0
48319,4,8319,[318 427  79 588 216],796,5,33728,4.053846153846154,40.0,0.0
48320,4,8320,[ 79  82  25 197 196],18,2,33730,4.053599327003966,0.0,0.0
48321,4,8321,[127 172 153 195 175],269,2,33732,4.053352559480894,0.0,20.0
48322,4,8322,[385  50  89  95 234],23,4,33736,4.053346149225039,0.0,20.0
48323,4,8323,[318 427  79 588 216],18,5,33741,4.053459875060067,40.0,0.0
48324,4,8324,[191 588  89 180 403],450,5,33746,4.053573573573574,0.0,0.0
48325,4,8325,[588   7 597  50 603],23,4,33750,4.053567139082393,20.0,20.0
48326,4,8326,[135 187 196 144 322],450,4,33754,4.053560706136664,0.0,0.0
48327,4,8327,[273  95  11 185 546],450,3,33757,4.053434197886648,0.0,0.0
48328,4,8328,[318 427  79 588 216],577,5,33762,4.053547844879337,40.0,0.0
48329,4,8329,[318 427  79 588 216],796,5,33767,4.053661464585835,40.0,0.0
48330,4,8330,[318 427  79 588 216],796,5,33772,4.053775057015964,40.0,0.0
48331,4,8331,[318 427  79 588 216],716,5,33777,4.0538886221795485,40.0,0.0
48332,4,8332,[318 427  79 588 216],716,5,33782,4.054002160086403,40.0,0.0
48333,4,8333,[318 427  79 588 216],796,5,33787,4.054115670746341,40.0,0.0
48334,4,8334,[597   7 313 228 237],344,2,33789,4.053869226154769,0.0,0.0
48335,4,8335,[318 427  79 588 216],796,5,33794,4.053982725527831,40.0,0.0
48336,4,8336,[ 82 179 265  25 301],450,3,33797,4.05385630322658,0.0,0.0
48337,4,8337,[194 318  96 173 161],577,5,33802,4.053969776924922,20.0,0.0
48338,4,8338,[318 427  79 588 216],18,5,33807,4.054083223408083,40.0,0.0
48339,4,8339,[318 427  79 588 216],450,5,33812,4.054196642685851,40.0,0.0
48340,4,8340,[318 427  79 588 216],577,5,33817,4.054310034768013,40.0,0.0
48341,4,8341,[228 216 181 288  97],655,1,33818,4.053943898345721,0.0,0.0
48342,4,8342,[318 427  79 588 216],796,5,33823,4.054057293539494,40.0,0.0
48343,4,8343,[318 427  79 588 216],796,5,33828,4.054170661553212,40.0,0.0
48344,4,8344,[471 228 588 210 183],280,1,33829,4.05380467345716,0.0,0.0
48345,4,8345,[318 427  79 588 216],450,5,33834,4.05391804457225,40.0,0.0
48346,4,8346,[546 172  71  25  11],593,3,33837,4.053791781478376,0.0,0.0
48347,4,8347,[  8  88 423 405 742],11,2,33839,4.053545759463344,0.0,0.0
48348,4,8348,[185 100  82 186 546],450,3,33842,4.053419571206132,0.0,20.0
48349,4,8349,[546  25 235 405 742],256,4,33846,4.053413173652695,0.0,0.0
48350,4,8350,[318 427  79 588 216],716,5,33851,4.053526523769609,40.0,0.0
48351,4,8351,[183 132 196  50 742],344,4,33855,4.053520114942529,0.0,20.0
48352,4,8352,[318 427  79 588 216],796,5,33860,4.0536334251167245,40.0,0.0
48353,4,8353,[172   1 655 282 483],655,2,33862,4.053387598755087,0.0,0.0
48354,4,8354,[318 427  79 588 216],716,5,33867,4.053500897666068,40.0,0.0
48355,4,8355,[161 187 385 174 175],716,1,33868,4.053135471517472,0.0,0.0
48356,4,8356,[318 427  79 588 216],450,5,33873,4.053248773483308,40.0,0.0
48357,4,8357,[318 427  79 588 216],577,5,33878,4.053362048336923,40.0,0.0
48358,4,8358,[257   4  89 357 333],655,2,33880,4.053116401483431,0.0,0.0
48359,4,8359,[318 427  79 588 216],450,5,33885,4.05322966507177,40.0,0.0
48360,4,8360,[318 427  79 588 216],577,5,33890,4.053342901566798,40.0,0.0
48361,4,8361,[151 211  22 197 195],269,3,33893,4.053216933747907,0.0,0.0
48362,4,8362,[294 215 127 132 234],716,5,33898,4.053330144684922,0.0,20.0
48363,4,8363,[216 168 237 144 180],450,5,33903,4.053443328550933,0.0,0.0
48364,4,8364,[210 333 403   1 211],655,0,33903,4.052958756724447,0.0,0.0
48365,4,8365,[ 97  79 435 237 496],18,4,33907,4.052952426488166,20.0,0.0
48366,4,8366,[328 238 183 151 197],796,3,33910,4.052826580614318,0.0,0.0
48367,4,8367,[ 89 185 655 222   8],457,5,33915,4.052939770554493,0.0,0.0
48368,4,8368,[191 125 483 183 175],151,3,33918,4.052813956267176,0.0,0.0
48369,4,8369,[318 427  79 588 216],577,5,33923,4.0529271206690565,40.0,0.0
48370,4,8370,[125 197 153  69 271],796,4,33927,4.052920797993071,0.0,0.0
48371,4,8371,[403 427 211 515  82],269,3,33930,4.052795031055901,20.0,0.0
48372,4,8372,[288 127 204 405  88],655,1,33931,4.052430431147736,0.0,20.0
48373,4,8373,[173  82 168 144  64],450,4,33935,4.0524241700501555,20.0,0.0
48374,4,8374,[318 302 385 423 100],655,2,33937,4.052179104477612,20.0,20.0
48375,4,8375,[318 427  79 588 216],18,5,33942,4.052292263610315,40.0,0.0
48376,4,8376,[357 286 294 215  97],796,2,33944,4.0520472722931835,0.0,20.0
48377,4,8377,[357  89 238 235 202],450,4,33948,4.052041059918835,0.0,0.0
48378,4,8378,[215 153 100 222   4],450,3,33951,4.051915503043323,0.0,20.0
48379,4,8379,[202 265 216 257 179],457,4,33955,4.051909307875895,0.0,0.0
48380,4,8380,[ 89 117 195  95 196],786,5,33960,4.052022431690729,0.0,0.0
48381,4,8381,[318 427  79 588 216],18,5,33965,4.052135528513482,40.0,0.0
48382,4,8382,[194 568 161 121 300],450,4,33969,4.052129309316474,0.0,0.0
48383,4,8383,[318 427  79 588 216],450,5,33974,4.052242366412214,40.0,0.0
48384,4,8384,[318 427  79 588 216],796,5,33979,4.052355396541443,40.0,0.0
48385,4,8385,[318 427  79 588 216],577,5,33984,4.052468399713809,40.0,0.0
48386,4,8386,[ 71 168   4 211 282],535,3,33987,4.052342911648981,0.0,0.0
48387,4,8387,[405 132  82 186  56],796,3,33990,4.0522174535050075,0.0,0.0
48388,4,8388,[ 98 597 269 300  96],796,4,33994,4.052211228990345,0.0,0.0
48389,4,8389,[318 427  79 588 216],18,5,33999,4.052324195470798,40.0,0.0
48390,4,8390,[173 117 195 168 200],450,4,34003,4.052317959718747,0.0,0.0
48391,4,8391,[186 257 195  82  97],655,0,34003,4.051835081029552,0.0,0.0
48392,4,8392,[  1  98 655 282 385],450,5,34008,4.0519480519480515,0.0,0.0
48393,4,8393,[318 427  79 588 216],450,5,34013,4.052060995949487,40.0,0.0
48394,4,8394,[174 333 385 568 168],796,5,34018,4.052173913043478,0.0,0.0
48395,4,8395,[121   8 174 211 127],655,1,34019,4.0518103858980465,0.0,20.0
48396,4,8396,[318 427  79 588 216],577,5,34024,4.051923305942599,40.0,0.0
48397,4,8397,[318 427  79 588 216],18,5,34029,4.052036199095022,40.0,0.0
48398,4,8398,[182 238  88 215  70],655,1,34030,4.051672818192642,0.0,0.0
48399,4,8399,[318 427  79 588 216],18,5,34035,4.051785714285714,40.0,0.0
48400,4,8400,[318 427  79 588 216],577,5,34040,4.051898583501964,40.0,0.0
48401,4,8401,[318 427  79 588 216],716,5,34045,4.052011425850988,40.0,0.0
48402,4,8402,[655 265 127  95 196],450,4,34049,4.052005236225158,0.0,20.0
48403,4,8403,[318 427  79 588 216],450,5,34054,4.0521180390290334,40.0,0.0
48404,4,8404,[603 118 100 471 143],655,2,34056,4.051873884592505,20.0,20.0
48405,4,8405,[318 427  79 588 216],716,5,34061,4.051986676183678,40.0,0.0
48406,4,8406,[238 237   8 234   1],457,5,34066,4.052099440942072,0.0,0.0
48407,4,8407,[  7 597 496 179 187],269,3,34069,4.05197431018078,20.0,0.0
48408,4,8408,[ 82 222 405  79 132],807,5,34074,4.052087049589725,0.0,0.0
48409,4,8409,[318 427  79 588 216],18,5,34079,4.052199762187872,40.0,0.0
48410,4,8410,[318 427  79 588 216],577,5,34084,4.052312447984781,40.0,0.0
48411,4,8411,[318 427  79 588 216],716,5,34089,4.052425106990015,40.0,0.0
48412,4,8412,[151 186 300 301 427],796,3,34092,4.052300011886366,20.0,0.0
48413,4,8413,[211 265 172 357  56],796,4,34096,4.052293796054196,0.0,0.0
48414,4,8414,[318 191 180 215 273],450,4,34100,4.052287581699346,20.0,0.0
48415,4,8415,[475  56  69 191 211],269,4,34104,4.052281368821292,0.0,0.0
48416,4,8416,[318 427  79 588 216],18,5,34109,4.052393964595462,40.0,0.0
48417,4,8417,[143 200  15 385 211],786,4,34113,4.052387740555951,0.0,0.0
48418,4,8418,[318 427  79 588 216],577,5,34118,4.052500296947381,40.0,0.0
48419,4,8419,[318 427  79 588 216],796,5,34123,4.052612826603325,40.0,0.0
48420,4,8420,[ 64 132 125   4 678],344,3,34126,4.052487828048926,20.0,0.0
48421,4,8421,[ 89 237 183 182 151],796,5,34131,4.052600332462598,0.0,0.0
48422,4,8422,[318 427  79 588 216],18,5,34136,4.0527128101626495,40.0,0.0
48423,4,8423,[269 132 176 286 210],344,4,34140,4.052706552706553,0.0,20.0
48424,4,8424,[271  15   9 483 357],796,4,34144,4.052700296735905,0.0,0.0
48425,4,8425,[318 427  79 588 216],796,5,34149,4.052812722525516,40.0,0.0
48426,4,8426,[318 427  79 588 216],450,5,34154,4.052925121632847,40.0,0.0
48427,4,8427,[318 427  79 588 216],18,5,34159,4.053037494067395,40.0,0.0
48428,4,8428,[318 427  79 588 216],577,5,34164,4.053149839838652,40.0,0.0
48429,4,8429,[187  89 132 234  98],18,3,34167,4.053024911032028,0.0,0.0
48430,4,8430,[153 323 117 127 288],504,4,34171,4.053018621753054,0.0,20.0
48431,4,8431,[318 427  79 588 216],716,5,34176,4.053130929791271,40.0,0.0
48432,4,8432,[318 427  79 588 216],450,5,34181,4.053243211194118,40.0,0.0
48433,4,8433,[588 423  22   1 435],18,5,34186,4.0533554659710695,0.0,0.0
48434,4,8434,[318 427  79 588 216],716,5,34191,4.053467694131594,40.0,0.0
48435,4,8435,[748  56 118  96 172],256,3,34194,4.053342816500711,0.0,0.0
48436,4,8436,[318 427  79 588 216],796,5,34199,4.053455019556714,40.0,0.0
48437,4,8437,[318 427  79 588 216],577,5,34204,4.0535671960180135,40.0,0.0
48438,4,8438,[ 88 161 265 172  98],716,4,34208,4.053560848441759,0.0,0.0
48439,4,8439,[318 427  79 588 216],577,5,34213,4.053672985781991,40.0,0.0
48440,4,8440,[748  71 271 144 289],807,4,34217,4.053666627176875,0.0,0.0
48441,4,8441,[318 427  79 588 216],18,5,34222,4.053778725420517,40.0,0.0
48442,4,8442,[318 427  79 588 216],450,5,34227,4.053890797110032,40.0,0.0
48443,4,8443,[318 427  79 588 216],796,5,34232,4.054002842254856,40.0,0.0
48444,4,8444,[403 143  98 273 100],655,3,34235,4.053878034339846,0.0,20.0
48445,4,8445,[318 427  79 588 216],450,5,34240,4.053990054463651,40.0,0.0
48446,4,8446,[496 405 182 742  15],796,4,34244,4.053983662838878,20.0,0.0
48447,4,8447,[655 423 173  50 153],23,3,34247,4.053858901515151,0.0,20.0
48448,4,8448,[275 195 216 215 597],457,4,34251,4.0538525269262635,0.0,20.0
48449,4,8449,[245 168 174 196 215],796,4,34255,4.053846153846154,0.0,0.0
48450,4,8450,[282 471 427  97  25],450,4,34259,4.053839782274287,20.0,0.0
48451,4,8451,[282 257 655 125 273],796,3,34262,4.053715097018457,0.0,0.0
48452,4,8452,[318 427  79 588 216],577,5,34267,4.053827043653141,40.0,0.0
48453,4,8453,[318 427  79 588 216],450,5,34272,4.053938963804116,40.0,0.0
48454,4,8454,[125  28 222  70 191],224,3,34275,4.053814311058545,0.0,0.0
48455,4,8455,[196 125 288 471 294],655,0,34275,4.05333491012299,0.0,0.0
48456,4,8456,[318 427  79 588 216],18,5,34280,4.053446848764337,40.0,0.0
48457,4,8457,[318 427  79 588 216],716,5,34285,4.053558760936392,40.0,0.0
48458,4,8458,[186 238 100 183  15],450,3,34288,4.0534342120818065,0.0,20.0
48459,4,8459,[153 742 132  69 269],450,5,34293,4.05354609929078,0.0,0.0
48460,4,8460,[588 161 181 180  96],716,2,34295,4.053303392034039,0.0,0.0
48461,4,8461,[180 181  12 403 196],450,5,34300,4.053415268258095,0.0,0.0
48462,4,8462,[173 197 228 176 471],716,3,34303,4.053290795226279,0.0,0.0
48463,4,8463,[176 216 269 237  95],344,4,34307,4.05328449905482,0.0,0.0
48464,4,8464,[196  69 186 121 176],577,5,34312,4.053396337861784,0.0,0.0
48465,4,8465,[  9 183 423  98 276],269,4,34316,4.053390030711079,0.0,0.0
48466,4,8466,[318 427  79 588 216],577,5,34321,4.0535018306365895,40.0,0.0
48467,4,8467,[318 427  79 588 216],577,5,34326,4.053613604156825,40.0,0.0
48468,4,8468,[ 25 496 405 211  89],450,4,34330,4.05360727358602,20.0,0.0
48469,4,8469,[318 427  79 588 216],18,5,34335,4.053719008264463,40.0,0.0
48470,4,8470,[ 25 153  28  82 168],330,4,34339,4.0537126667453665,0.0,0.0
48471,4,8471,[546 195 300 161 471],716,1,34340,4.053352219074599,0.0,0.0
48472,4,8472,[271 286  95 405 151],796,4,34344,4.053345922341555,0.0,20.0
48473,4,8473,[318 427  79 588 216],577,5,34349,4.053457635119188,40.0,0.0
48474,4,8474,[174  25 196 176 195],504,4,34353,4.053451327433629,0.0,0.0
48475,4,8475,[427 210 143 182 435],269,2,34355,4.053209060877773,20.0,0.0
48476,4,8476,[318 427  79 588 216],18,5,34360,4.053320750265424,40.0,0.0
48477,4,8477,[357 435 202 238 132],655,1,34361,4.052960603916018,0.0,0.0
48478,4,8478,[  1 210 143 235 197],401,3,34364,4.052836419389079,0.0,0.0
48479,4,8479,[483 202 245 176 111],796,4,34368,4.052830188679246,0.0,0.0
48480,4,8480,[318 427  79 588 216],577,5,34373,4.052941870062493,40.0,0.0
48481,4,8481,[265 197 258  64 210],629,5,34378,4.053053525112002,20.0,0.0
48482,4,8482,[318 427  79 588 216],796,5,34383,4.053165153837086,40.0,0.0
48483,4,8483,[265 185 191 405   9],457,5,34388,4.053276756247053,0.0,0.0
48484,4,8484,[318 427  79 588 216],577,5,34393,4.053388332351208,40.0,0.0
48485,4,8485,[318 427  79 588 216],716,5,34398,4.0534998821588495,40.0,0.0
48486,4,8486,[ 64 183 483 132 282],655,3,34401,4.053375751148816,20.0,0.0
48487,4,8487,[144 234  11 276  82],457,5,34406,4.053487276154571,0.0,0.0
48488,4,8488,[475 180 655 173 153],269,2,34408,4.05324537636942,0.0,0.0
48489,4,8489,[318 427  79 588 216],716,5,34413,4.053356890459364,40.0,0.0
48490,4,8490,[ 28 258 100 185 546],457,4,34417,4.053350606524555,0.0,20.0
48491,4,8491,[546 228 265  69 151],457,4,34421,4.0533443240697125,0.0,0.0
48492,4,8492,[318 427  79 588 216],716,5,34426,4.0534557871188035,40.0,0.0
48493,4,8493,[318 427  79 588 216],18,5,34431,4.053567223922769,40.0,0.0
48494,4,8494,[318 302 117 186 275],655,3,34434,4.053443201883461,20.0,20.0
48495,4,8495,[294  25 168 216  12],457,4,34438,4.053436911487759,0.0,0.0
48496,4,8496,[323 202 204 100 286],280,1,34439,4.053077556784747,0.0,40.0
48497,4,8497,[318 427  79 588 216],577,5,34444,4.053188985643681,40.0,0.0
48498,4,8498,[180   8  12 181 144],796,4,34448,4.053182727379692,0.0,0.0
48499,4,8499,[  1 196 222 181  79],151,5,34453,4.0532941176470585,0.0,0.0
48500,4,8500,[153 318 237 135  79],535,3,34456,4.053170215268792,20.0,0.0
48501,4,8501,[318 427  79 588 216],450,5,34461,4.053281580804517,40.0,0.0
48502,4,8502,[318 427  79 588 216],796,5,34466,4.053392920145831,40.0,0.0
48503,4,8503,[100 161 210  82 197],756,2,34468,4.053151458137347,0.0,20.0
48504,4,8504,[318 427  79 588 216],18,5,34473,4.05326278659612,40.0,0.0
48505,4,8505,[318 427  79 588 216],577,5,34478,4.053374088878439,40.0,0.0
48506,4,8506,[289 333 215 179 144],655,1,34479,4.053015163982603,0.0,0.0
48507,4,8507,[318 427  79 588 216],577,5,34484,4.053126469205454,40.0,0.0
48508,4,8508,[172 196 423 176 603],796,5,34489,4.053237748266541,20.0,0.0
48509,4,8509,[143 318 275 187  98],716,4,34493,4.0532314923619275,20.0,20.0
48510,4,8510,[183  69 151 215   1],716,4,34497,4.053225237927388,0.0,0.0
48511,4,8511,[318 427  79 588 216],716,5,34502,4.053336466165414,40.0,0.0
48512,4,8512,[318 427  79 588 216],796,5,34507,4.053447668272055,40.0,0.0
48513,4,8513,[318 427  79 588 216],716,5,34512,4.053558844256519,40.0,0.0
48514,4,8514,[318 427  79 588 216],450,5,34517,4.053669994128009,40.0,0.0
48515,4,8515,[318 301 182 257 161],796,4,34521,4.053663691874119,20.0,0.0
48516,4,8516,[100 496 210 435 234],450,3,34524,4.053539978865798,20.0,20.0
48517,4,8517,[318 427  79 588 216],796,5,34529,4.053651091805588,40.0,0.0
48518,4,8518,[318 427  79 588 216],18,5,34534,4.053762178659467,40.0,0.0
48519,4,8519,[318 427  79 588 216],450,5,34539,4.05387323943662,40.0,0.0
48520,4,8520,[318 427  79 588 216],450,5,34544,4.053984274146227,40.0,0.0
48521,4,8521,[318 427  79 588 216],716,5,34549,4.054095282797466,40.0,0.0
48522,4,8522,[237 168 603 173   7],535,5,34554,4.0542062653995075,20.0,0.0
48523,4,8523,[318 427  79 588 216],716,5,34559,4.0543172219615204,40.0,0.0
48524,4,8524,[318 427  79 588 216],450,5,34564,4.054428152492669,40.0,0.0
48525,4,8525,[318 427  79 588 216],796,5,34569,4.054539057002112,40.0,0.0
48526,4,8526,[318 427  79 588 216],450,5,34574,4.054649935499003,40.0,0.0
48527,4,8527,[318 427  79 588 216],796,5,34579,4.054760787992495,40.0,0.0
48528,4,8528,[ 11 194 125 204 168],457,5,34584,4.054871614491734,0.0,0.0
48529,4,8529,[318 427  79 588 216],577,5,34589,4.0549824150058615,40.0,0.0
48530,4,8530,[161 237  71 117  28],885,5,34594,4.055093189544016,0.0,0.0
48531,4,8531,[318 427  79 588 216],450,5,34599,4.055203938115331,40.0,0.0
48532,4,8532,[228 275  95 121 289],798,3,34602,4.055080276573304,0.0,20.0
48533,4,8533,[318 427  79 588 216],577,5,34607,4.05519100070307,40.0,0.0
48534,4,8534,[ 97 211 172 181 237],786,5,34612,4.055301698886936,0.0,0.0
48535,4,8535,[318 427  79 588 216],796,5,34617,4.055412371134021,40.0,0.0
48536,4,8536,[ 82 333 300 294 100],655,0,34617,4.054937331615322,0.0,20.0
48537,4,8537,[588 100  50  88 275],23,4,34621,4.054930897165613,0.0,60.0
48538,4,8538,[211 300 435 182 234],389,4,34625,4.054924464222977,0.0,0.0
48539,4,8539,[318 427  79 588 216],577,5,34630,4.055035128805621,40.0,0.0
48540,4,8540,[ 50  22  95 187 186],796,4,34634,4.055028685165672,0.0,20.0
48541,4,8541,[423 175 603 204 187],269,4,34638,4.0550222430344185,20.0,0.0
48542,4,8542,[318 427  79 588 216],577,5,34643,4.055132857310078,40.0,0.0
48543,4,8543,[546  71  89 186 121],796,4,34647,4.055126404494382,0.0,0.0
48544,4,8544,[588 328 269 748 174],450,5,34652,4.055236980690462,0.0,0.0
48545,4,8545,[318 427  79 588 216],796,5,34657,4.055347531008659,40.0,0.0
48546,4,8546,[318 427  79 588 216],18,5,34662,4.055458055458056,40.0,0.0
48547,4,8547,[195 202 187 211 216],504,3,34665,4.055334581188582,0.0,0.0
48548,4,8548,[269  89 483 125 181],296,5,34670,4.055445081296058,0.0,0.0
48549,4,8549,[318 427  79 588 216],577,5,34675,4.055555555555555,40.0,0.0
48550,4,8550,[173  95 222 216 172],5,4,34679,4.055549058589639,0.0,0.0
48551,4,8551,[318 427  79 588 216],796,5,34684,4.055659494855004,40.0,0.0
48552,4,8552,[202  98 275 234   1],151,5,34689,4.055769905296387,0.0,20.0
48553,4,8553,[318 427  79 588 216],796,5,34694,4.055880289922843,40.0,0.0
48554,4,8554,[318 427  79 588 216],450,5,34699,4.055990648743425,40.0,0.0
48555,4,8555,[195  88 483 423 265],280,3,34702,4.055867227676484,0.0,0.0
48556,4,8556,[318 427  79 588 216],450,5,34707,4.055977562229754,40.0,0.0
48557,4,8557,[655 318 175 132 174],269,4,34711,4.055971021266651,20.0,0.0
48558,4,8558,[318 427  79 588 216],577,5,34716,4.056081317910971,40.0,0.0
48559,4,8559,[ 15   9 196 173 301],796,3,34719,4.055957943925233,0.0,0.0
48560,4,8560,[127 182 180 294   1],457,4,34723,4.055951407545847,0.0,20.0
48561,4,8561,[286   7 288 546 117],450,4,34727,4.055944872693296,0.0,20.0
48562,4,8562,[318 427  79 588 216],18,5,34732,4.056055120868854,40.0,0.0
48563,4,8563,[318 427  79 588 216],796,5,34737,4.056165343297525,40.0,0.0
48564,4,8564,[318 427  79 588 216],450,5,34742,4.056275539988325,40.0,0.0
48565,4,8565,[323 275 222 471 742],938,2,34744,4.056035489143124,0.0,20.0
48566,4,8566,[318 427  79 588 216],716,5,34749,4.056145675265554,40.0,0.0
48567,4,8567,[  9 121  97   7 132],655,0,34749,4.055672268907563,0.0,0.0
48568,4,8568,[196 173 215 176  50],450,5,34754,4.055782471700315,0.0,20.0
48569,4,8569,[185 748 121 273 655],401,1,34755,4.055425904317386,0.0,0.0
48570,4,8570,[318 427  79 588 216],450,5,34760,4.05553611013884,40.0,0.0
48571,4,8571,[202 210  70  69 235],280,3,34763,4.055412972468502,0.0,0.0
48572,4,8572,[318 427  79 588 216],577,5,34768,4.055523154088417,40.0,0.0
48573,4,8573,[286 135  79 222 204],655,2,34770,4.0552834149755075,0.0,20.0
48574,4,8574,[234  96   8 546 197],796,3,34773,4.055160349854227,0.0,0.0
48575,4,8575,[318 427  79 588 216],18,5,34778,4.05527052238806,40.0,0.0
48576,4,8576,[204 153 234 300 216],655,1,34779,4.054914305701294,0.0,0.0
48577,4,8577,[318 427  79 588 216],796,5,34784,4.055024481231056,40.0,0.0
48578,4,8578,[187 427 475 175 234],269,4,34788,4.05501806737382,20.0,0.0
48579,4,8579,[211 271 183 268  50],655,2,34790,4.054778554778554,0.0,20.0
48580,4,8580,[289 195 748 168 403],807,4,34794,4.054772171075633,0.0,0.0
48581,4,8581,[265 186 405 228  79],577,3,34797,4.054649265905383,0.0,0.0
48582,4,8582,[273 275  64 200 228],796,4,34801,4.054642898753349,20.0,20.0
48583,4,8583,[  9 238 125   7 181],151,5,34806,4.05475302889096,0.0,0.0
48584,4,8584,[318 427  79 588 216],450,5,34811,4.0548631333721605,40.0,0.0
48585,4,8585,[318 427  79 588 216],716,5,34816,4.054973212205916,40.0,0.0
48586,4,8586,[357  64 127 655 294],796,3,34819,4.054850355188075,20.0,20.0
48587,4,8587,[111 125  28  82 204],577,5,34824,4.054960409874243,0.0,0.0
48588,4,8588,[318 427  79 588 216],18,5,34829,4.0550704389335195,40.0,0.0
48589,4,8589,[216 183   8 143 546],593,3,34832,4.0549476135040745,0.0,0.0
48590,4,8590,[318 427  79 588 216],716,5,34837,4.0550576184379,40.0,0.0
48591,4,8591,[318 427  79 588 216],716,5,34842,4.055167597765363,40.0,0.0
48592,4,8592,[318 427  79 588 216],450,5,34847,4.055277551495403,40.0,0.0
48593,4,8593,[111  97 423 211 318],236,4,34851,4.055271119385618,20.0,0.0
48594,4,8594,[318 427  79 588 216],18,5,34856,4.055381035485747,40.0,0.0
48595,4,8595,[318 427  79 588 216],796,5,34861,4.055490926012099,40.0,0.0
48596,4,8596,[127  22 173 183 210],280,2,34863,4.055251832034431,0.0,20.0
48597,4,8597,[435  50 235 196 238],450,4,34867,4.055245405908351,0.0,20.0
48598,4,8598,[172 204   1  25 196],577,5,34872,4.055355273869054,0.0,0.0
48599,4,8599,[435  50 275 222   4],655,2,34874,4.055116279069767,0.0,40.0
48600,4,8600,[  4 427  69 228 125],577,4,34878,4.055109870945239,20.0,0.0
48601,4,8601,[318 427  79 588 216],18,5,34883,4.055219716345036,40.0,0.0
48602,4,8602,[200 302 132 471  79],655,3,34886,4.055097059165408,0.0,0.0
48603,4,8603,[318 427  79 588 216],577,5,34891,4.0552068805206885,40.0,0.0
48604,4,8604,[318 427  79 588 216],796,5,34896,4.055316676350959,40.0,0.0
48605,4,8605,[ 95 403   1 483 323],280,3,34899,4.055194050662329,0.0,0.0
48606,4,8606,[ 69 135  82  22 515],655,2,34901,4.05495526896712,0.0,0.0
48607,4,8607,[ 96 313 100 273 603],450,4,34905,4.054948884758364,20.0,20.0
48608,4,8608,[181 172 300 186  98],655,2,34907,4.05471018701359,0.0,0.0
48609,4,8609,[318 427  79 588 216],18,5,34912,4.0548199767711965,40.0,0.0
48610,4,8610,[ 25 100 238 181  70],504,2,34914,4.054581349436767,0.0,20.0
48611,4,8611,[288 168 127 655 172],450,4,34918,4.054575011611704,0.0,20.0
48612,4,8612,[318 427  79 588 216],450,5,34923,4.05468477882271,40.0,0.0
48613,4,8613,[234 483 100   7  69],151,4,34927,4.0546784304620385,0.0,20.0
48614,4,8614,[318 427  79 588 216],716,5,34932,4.054788160185723,40.0,0.0
48615,4,8615,[318 427  79 588 216],716,5,34937,4.054897864438255,40.0,0.0
48616,4,8616,[322 273 357 144  25],401,3,34940,4.054775443889985,0.0,0.0
48617,4,8617,[ 96 258 228 318 127],796,5,34945,4.054885124158737,20.0,20.0
48618,4,8618,[508  88 742 435  12],11,2,34947,4.054646710755308,0.0,0.0
48619,4,8619,[ 64   8 245 194  98],796,4,34951,4.054640371229699,20.0,0.0
48620,4,8620,[318 427  79 588 216],577,5,34956,4.054750028998956,40.0,0.0
48621,4,8621,[318 427  79 588 216],18,5,34961,4.054859661331478,40.0,0.0
48622,4,8622,[318 427  79 588 216],796,5,34966,4.054969268236113,40.0,0.0
48623,4,8623,[318 427  79 588 216],716,5,34971,4.055078849721707,40.0,0.0
48624,4,8624,[318 427  79 588 216],716,5,34976,4.055188405797101,40.0,0.0
48625,4,8625,[318 427  79 588 216],577,5,34981,4.055297936471134,40.0,0.0
48626,4,8626,[318 427  79 588 216],716,5,34986,4.055407441752637,40.0,0.0
48627,4,8627,[318 427  79 588 216],450,5,34991,4.05551692165044,40.0,0.0
48628,4,8628,[318 427  79 588 216],577,5,34996,4.055626376173369,40.0,0.0
48629,4,8629,[125 748 132  22  88],280,2,34998,4.0553881807647745,0.0,0.0
48630,4,8630,[182 143   4 228 435],450,4,35002,4.055381763410961,0.0,0.0
48631,4,8631,[ 12 118 245 322 403],796,3,35005,4.055259499536608,0.0,0.0
48632,4,8632,[318 427  79 588 216],577,5,35010,4.055368933163443,40.0,0.0
48633,4,8633,[318 427  79 588 216],18,5,35015,4.055478341440815,40.0,0.0
48634,4,8634,[269 191 222 546 423],450,4,35019,4.055471916618413,0.0,0.0
48635,4,8635,[318 427  79 588 216],796,5,35024,4.055581287633164,40.0,0.0
48636,4,8636,[200  15  88 216 318],457,5,35029,4.055690633321755,20.0,0.0
48637,4,8637,[318 427  79 588 216],450,5,35034,4.0557999536929845,40.0,0.0
48638,4,8638,[318 427  79 588 216],18,5,35039,4.055909248755643,40.0,0.0
48639,4,8639,[258 194 405  69 185],450,5,35044,4.056018518518519,0.0,0.0
48640,4,8640,[ 22 161 328 385 200],450,4,35048,4.056012035644023,0.0,0.0
48641,4,8641,[ 88 318 183 135  95],280,3,35051,4.055889840314742,20.0,0.0
48642,4,8642,[403 168  12 143 179],18,3,35054,4.055767673261599,0.0,0.0
48643,4,8643,[318 427  79 588 216],577,5,35059,4.055876908838501,40.0,0.0
48644,4,8644,[196 216 210 100 237],796,3,35062,4.055754771544245,0.0,20.0
48645,4,8645,[318 427  79 588 216],18,5,35067,4.055863983344899,40.0,0.0
48646,4,8646,[588  89 318 183 357],786,5,35072,4.055973169885509,20.0,0.0
48647,4,8647,[318 427  79 588 216],577,5,35077,4.056082331174838,40.0,0.0
48648,4,8648,[216 211 286 202 322],796,2,35079,4.055844606312869,0.0,20.0
48649,4,8649,[318 427  79 588 216],577,5,35084,4.055953757225433,40.0,0.0
48650,4,8650,[174 300   4 435 302],535,2,35086,4.055716102184719,0.0,0.0
48651,4,8651,[318 427  79 588 216],716,5,35091,4.055825242718447,40.0,0.0
48652,4,8652,[ 89 117 143  15 191],450,4,35095,4.055818791170692,0.0,0.0
48653,4,8653,[174 144 211 117 204],716,4,35099,4.055812341113936,0.0,0.0
48654,4,8654,[318 427  79 588 216],18,5,35104,4.055921432697862,40.0,0.0
48655,4,8655,[168 216 172 111 496],151,5,35109,4.056030499075786,20.0,0.0
48656,4,8656,[191 302 187 603 288],655,4,35113,4.056024026799122,20.0,0.0
48657,4,8657,[313 216 597 271  56],796,5,35118,4.056133056133056,0.0,0.0
48658,4,8658,[318 427  79 588 216],450,5,35123,4.056242060284098,40.0,0.0
48659,4,8659,[234 194 655 153 183],450,4,35127,4.056235565819861,0.0,0.0
48660,4,8660,[ 56  97 143 234 118],577,1,35128,4.055882692529731,0.0,0.0
48661,4,8661,[318 427  79 588 216],796,5,35133,4.055991687831909,40.0,0.0
48662,4,8662,[186 143 191  95 216],786,5,35138,4.0561006579706795,0.0,0.0
48663,4,8663,[318 427  79 588 216],577,5,35143,4.056209602954755,40.0,0.0
48664,4,8664,[275 603 174  95  82],23,4,35147,4.056203115983843,20.0,20.0
48665,4,8665,[318 427  79 588 216],796,5,35152,4.056312024001846,40.0,0.0
48666,4,8666,[294  25  70 483  97],655,1,35153,4.055959386177455,0.0,0.0
48667,4,8667,[222 195 300 235 328],450,3,35156,4.055837563451776,0.0,0.0
48668,4,8668,[318 427  79 588 216],450,5,35161,4.055946475948783,40.0,0.0
48669,4,8669,[144 427 173  25 403],5,1,35162,4.055594002306805,20.0,0.0
48670,4,8670,[202 271 258 211 191],655,1,35163,4.0552416099642485,0.0,0.0
48671,4,8671,[678 423 265 127 385],280,4,35167,4.055235239852398,0.0,20.0
48672,4,8672,[234 403 271   4 357],655,1,35168,4.054882970137207,0.0,0.0
48673,4,8673,[318 427  79 588 216],716,5,35173,4.054991929905465,40.0,0.0
48674,4,8674,[ 69 135  97 181 121],401,1,35174,4.054639769452449,0.0,0.0
48675,4,8675,[318 427  79 588 216],716,5,35179,4.054748732134624,40.0,0.0
48676,4,8676,[179 185 403 111 174],457,4,35183,4.054742422496254,0.0,0.0
48677,4,8677,[318 427  79 588 216],18,5,35188,4.054851348236921,40.0,0.0
48678,4,8678,[222 289 515  69   4],655,1,35189,4.054499366286438,0.0,0.0
48679,4,8679,[318 427  79 588 216],577,5,35194,4.054608294930875,40.0,0.0
48680,4,8680,[318 427  79 588 216],716,5,35199,4.0547171984794375,40.0,0.0
48681,4,8681,[318 427  79 588 216],18,5,35204,4.054826076940797,40.0,0.0
48682,4,8682,[  1 100 300 181 210],796,2,35206,4.054589427617183,0.0,20.0
48683,4,8683,[357   1 228 427 276],655,3,35209,4.054467987102718,20.0,0.0
48684,4,8684,[318 427  79 588 216],796,5,35214,4.054576856649396,40.0,0.0
48685,4,8685,[273  12  89 313   8],655,3,35217,4.054455445544554,0.0,0.0
48686,4,8686,[318 427  79 588 216],577,5,35222,4.054564291470013,40.0,0.0
48687,4,8687,[357 197 405 258 100],457,5,35227,4.054673112338858,0.0,20.0
48688,4,8688,[ 64 197 194  11 288],292,4,35231,4.05466682011739,20.0,0.0
48689,4,8689,[ 56 181 173   4 172],577,4,35235,4.054660529344074,0.0,0.0
48690,4,8690,[318 427  79 588 216],796,5,35240,4.054769301576344,40.0,0.0
48691,4,8691,[318 427  79 588 216],18,5,35245,4.054878048780488,40.0,0.0
48692,4,8692,[176 568 195  12 222],693,3,35248,4.054756700793742,0.0,0.0
48693,4,8693,[318 427  79 588 216],716,5,35253,4.054865424430642,40.0,0.0
48694,4,8694,[173   1 172  64 496],796,4,35257,4.054859114433582,40.0,0.0
48695,4,8695,[168 144 496 204 748],796,5,35262,4.054967801287948,20.0,0.0
48696,4,8696,[181 111   8  88 328],796,5,35267,4.055076463148212,0.0,0.0
48697,4,8697,[318 427  79 588 216],18,5,35272,4.055185100022994,40.0,0.0
48698,4,8698,[ 98  56 385  88  12],280,4,35276,4.055178756178871,0.0,0.0
48699,4,8699,[132  28 328 427 222],236,5,35281,4.0552873563218395,20.0,0.0
48700,4,8700,[318 427  79 588 216],450,5,35286,4.055395931502126,40.0,0.0
48701,4,8701,[318 427  79 588 216],577,5,35291,4.055504481728338,40.0,0.0
48702,4,8702,[100 127 111 385 222],450,4,35295,4.055498104102034,0.0,40.0
48703,4,8703,[318 427  79 588 216],450,5,35300,4.055606617647059,40.0,0.0
48704,4,8704,[196 234  95  28 257],796,3,35303,4.0554853532452615,0.0,0.0
48705,4,8705,[318 427  79 588 216],716,5,35308,4.055593843326442,40.0,0.0
48706,4,8706,[435 234   4  25  97],655,0,35308,4.055128057884461,0.0,0.0
48707,4,8707,[318 427  79 588 216],716,5,35313,4.055236564079008,40.0,0.0
48708,4,8708,[318 427  79 588 216],577,5,35318,4.05534504535538,40.0,0.0
48709,4,8709,[318 427  79 588 216],716,5,35323,4.055453501722158,40.0,0.0
48710,4,8710,[597 202 678 117 385],344,1,35324,4.055102743657445,0.0,0.0
48711,4,8711,[318 427  79 588 216],577,5,35329,4.055211202938476,40.0,0.0
48712,4,8712,[318 427  79 588 216],716,5,35334,4.05531963732354,40.0,0.0
48713,4,8713,[127 195 172 471  97],457,5,35339,4.055428046821207,0.0,20.0
48714,4,8714,[257 197   9 215 202],504,4,35343,4.055421686746988,0.0,0.0
48715,4,8715,[318 427  79 588 216],450,5,35348,4.055530059660395,40.0,0.0
48716,4,8716,[318 427  79 588 216],450,5,35353,4.055638407709075,40.0,0.0
48717,4,8717,[ 71 597  89 200 483],450,2,35355,4.055402615278734,0.0,0.0
48718,4,8718,[211 210 174 153 483],535,5,35360,4.055510953090951,0.0,0.0
48719,4,8719,[405 294 302 322 258],733,1,35361,4.055160550458716,0.0,0.0
48720,4,8720,[318 427  79 588 216],577,5,35366,4.0552688911822035,40.0,0.0
48721,4,8721,[318 427  79 588 216],577,5,35371,4.0553772070626,40.0,0.0
48722,4,8722,[172 179  71 427 302],389,5,35376,4.055485498108449,20.0,0.0
48723,4,8723,[318 427  79 588 216],450,5,35381,4.0555937643282896,40.0,0.0
48724,4,8724,[ 69 194 238 318  25],11,2,35383,4.055358166189111,20.0,0.0
48725,4,8725,[318 427  79 588 216],450,5,35388,4.055466422186569,40.0,0.0
48726,4,8726,[127 117 655 118 483],796,4,35392,4.055460066460411,0.0,20.0
48727,4,8727,[ 79 176 173 258 210],450,4,35396,4.05545371219065,0.0,0.0
48728,4,8728,[ 50 385 546 273  96],796,4,35400,4.05544735937679,0.0,20.0
48729,4,8729,[204 194 100  70 132],535,5,35405,4.055555555555555,0.0,20.0
48730,4,8730,[318 427  79 588 216],796,5,35410,4.055663726949948,40.0,0.0
48731,4,8731,[318 427  79 588 216],796,5,35415,4.055771873568483,40.0,0.0
48732,4,8732,[127 235 300 496 273],450,3,35418,4.0556509790450015,20.0,20.0
48733,4,8733,[238  69 125 427  15],450,4,35422,4.055644607281887,20.0,0.0
48734,4,8734,[228 568 222 357   7],655,1,35423,4.0552947910704065,0.0,0.0
48735,4,8735,[257 176 323   8 333],796,4,35427,4.055288461538462,0.0,0.0
48736,4,8736,[318 427  79 588 216],18,5,35432,4.055396589218267,40.0,0.0
48737,4,8737,[318 427  79 588 216],18,5,35437,4.055504692149233,40.0,0.0
48738,4,8738,[ 25 276 135   1 100],18,3,35440,4.055383911202655,0.0,20.0
48739,4,8739,[357 568 216  97 405],796,4,35444,4.055377574370709,0.0,0.0
48740,4,8740,[ 97 211  64 234 288],655,1,35445,4.055028028829653,20.0,0.0
48741,4,8741,[318 427  79 588 216],796,5,35450,4.055136124456646,40.0,0.0
48742,4,8742,[238  15 269 186  98],296,3,35453,4.055015440924168,0.0,0.0
48743,4,8743,[318 427  79 588 216],577,5,35458,4.055123513266239,40.0,0.0
48744,4,8744,[172 100  71 173 655],535,4,35462,4.055117209834191,0.0,20.0
48745,4,8745,[ 25 597 118 127 183],457,4,35466,4.055110907843586,0.0,20.0
48746,4,8746,[318 427  79 588 216],18,5,35471,4.055218932205327,40.0,0.0
48747,4,8747,[385 180  95 172  11],716,3,35474,4.055098308184728,0.0,0.0
48748,4,8748,[117  79 318 118 257],716,4,35478,4.055092010515487,20.0,0.0
48749,4,8749,[318 427  79 588 216],577,5,35483,4.0552,40.0,0.0
48750,4,8750,[318 427  79 588 216],18,5,35488,4.0553079648040224,40.0,0.0
48751,4,8751,[318 427  79 588 216],18,5,35493,4.055415904936015,40.0,0.0
48752,4,8752,[197 238 333  98 603],655,2,35495,4.055181080772306,20.0,0.0
48753,4,8753,[318 427  79 588 216],796,5,35500,4.0552890107379485,40.0,0.0
48754,4,8754,[216 427 185 186  88],151,5,35505,4.055396916047973,20.0,0.0
48755,4,8755,[294 194 216 172 151],457,4,35509,4.055390589310187,0.0,0.0
48756,4,8756,[204  69 475 234 300],389,4,35513,4.055384264017357,0.0,0.0
48757,4,8757,[318 427  79 588 216],18,5,35518,4.055492121488925,40.0,0.0
48758,4,8758,[238 100 568 202 186],457,5,35523,4.055599954332687,0.0,20.0
48759,4,8759,[215 603 286  79 237],535,3,35526,4.0554794520547945,20.0,20.0
48760,4,8760,[187 257 191 100 265],655,2,35528,4.0552448350644905,0.0,20.0
48761,4,8761,[423  96  95 318 180],280,5,35533,4.055352659210226,20.0,0.0
48762,4,8762,[181 200 173 655 168],450,4,35537,4.055346342576743,0.0,0.0
48763,4,8763,[318 427  79 588 216],716,5,35542,4.055454130534002,40.0,0.0
48764,4,8764,[182 257 175 100 132],457,4,35546,4.055447803764975,0.0,20.0
48765,4,8765,[275 182 186 265  56],450,4,35550,4.055441478439425,0.0,20.0
48766,4,8766,[216  82 176 127 151],716,4,35554,4.055435154556861,0.0,20.0
48767,4,8767,[423  12 288 222 185],655,1,35555,4.055086678832117,0.0,0.0
48768,4,8768,[318 427  79 588 216],450,5,35560,4.055194434941271,40.0,0.0
48769,4,8769,[ 28 276  97 182 144],457,5,35565,4.055302166476625,0.0,0.0
48770,4,8770,[742 265 276 508 204],655,1,35566,4.0549538251054615,0.0,0.0
48771,4,8771,[ 98 197 275  70 168],450,5,35571,4.055061559507524,0.0,20.0
48772,4,8772,[318 427  79 588 216],796,5,35576,4.05516926934914,40.0,0.0
48773,4,8773,[318 427  79 588 216],796,5,35581,4.055276954638705,40.0,0.0
48774,4,8774,[196 301 300 176  71],389,3,35584,4.055156695156695,0.0,0.0
48775,4,8775,[318 427  79 588 216],716,5,35589,4.055264357338195,40.0,0.0
48776,4,8776,[318 427  79 588 216],716,5,35594,4.055371994986897,40.0,0.0
48777,4,8777,[195 234 132 135  82],280,2,35596,4.0551378446115285,0.0,0.0
48778,4,8778,[238 228   1 742 385],457,5,35601,4.055245472149448,0.0,0.0
48779,4,8779,[181 179 222  79 257],296,5,35606,4.055353075170843,0.0,0.0
48780,4,8780,[318 427  79 588 216],18,5,35611,4.055460653684091,40.0,0.0
48781,4,8781,[318 427  79 588 216],450,5,35616,4.055568207697563,40.0,0.0
48782,4,8782,[405 168 423 216 546],577,3,35619,4.055448024592963,0.0,0.0
48783,4,8783,[318 427  79 588 216],577,5,35624,4.055555555555555,40.0,0.0
48784,4,8784,[ 28 197 183 143 483],450,4,35628,4.055549231644849,0.0,0.0
48785,4,8785,[318 427  79 588 216],577,5,35633,4.055656726610517,40.0,0.0
48786,4,8786,[318 427  79 588 216],577,5,35638,4.055764197109366,40.0,0.0
48787,4,8787,[318 427  79 588 216],716,5,35643,4.055871643149749,40.0,0.0
48788,4,8788,[318 427  79 588 216],577,5,35648,4.055979064740016,40.0,0.0
48789,4,8789,[234 405 258 588  71],450,3,35651,4.055858930602958,0.0,0.0
48790,4,8790,[282 496 405 173 265],716,4,35655,4.055852576498692,20.0,0.0
48791,4,8791,[202 183 185 180 118],450,4,35659,4.055846223839854,0.0,0.0
48792,4,8792,[603   1 153  88 151],330,5,35664,4.055953599454111,20.0,0.0
48793,4,8793,[173 301 151  22 427],796,4,35668,4.055947236752331,20.0,0.0
48794,4,8794,[151 125  28 318 435],151,5,35673,4.0560545764639,20.0,0.0
48795,4,8795,[100   9  98 228 151],344,5,35678,4.056161891768986,0.0,20.0
48796,4,8796,[121 197 210 181 195],504,4,35682,4.056155507559395,0.0,0.0
48797,4,8797,[318 427  79 588 216],716,5,35687,4.056262786997045,40.0,0.0
48798,4,8798,[328 183 118   1 194],796,4,35691,4.056256392771906,0.0,0.0
48799,4,8799,[385  71 546 357 216],796,5,35696,4.056363636363637,0.0,0.0
48800,4,8800,[742 403 568 405 235],280,2,35698,4.056129985228951,0.0,0.0
48801,4,8801,[318 427  79 588 216],716,5,35703,4.056237218813906,40.0,0.0
48802,4,8802,[318 427  79 588 216],577,5,35708,4.056344428035897,40.0,0.0
48803,4,8803,[318 427  79 588 216],796,5,35713,4.056451612903226,40.0,0.0
48804,4,8804,[127 302 313 286  25],450,4,35717,4.056445201590006,0.0,40.0
48805,4,8805,[ 79 204  98 185  56],11,3,35720,4.056325232795821,0.0,0.0
48806,4,8806,[100 228 194 475 515],292,5,35725,4.056432383331441,0.0,20.0
48807,4,8807,[  7 282  96  12 100],655,0,35725,4.055971843778384,0.0,20.0
48808,4,8808,[235 210 273  15  97],450,1,35726,4.055624929049835,0.0,0.0
48809,4,8809,[318 427  79 588 216],716,5,35731,4.055732122587968,40.0,0.0
48810,4,8810,[318 427  79 588 216],796,5,35736,4.0558392917943475,40.0,0.0
48811,4,8811,[ 69 179 183 180 186],269,1,35737,4.0554925102133454,0.0,0.0
48812,4,8812,[144 427 118 271 211],796,4,35741,4.055486213548168,20.0,0.0
48813,4,8813,[318 427  79 588 216],18,5,35746,4.055593374177445,40.0,0.0
48814,4,8814,[318 427  79 588 216],577,5,35751,4.055700510493477,40.0,0.0
48815,4,8815,[ 56 118 546 185 269],450,4,35755,4.055694192377495,0.0,0.0
48816,4,8816,[ 97   9 282  69  79],593,4,35759,4.055687875694681,0.0,0.0
48817,4,8817,[237 174 423 385 176],655,0,35759,4.055227942844183,0.0,0.0
48818,4,8818,[117 237 357  88 111],593,5,35764,4.055335072003628,0.0,0.0
48819,4,8819,[216   8 181  95 210],577,4,35768,4.055328798185941,0.0,0.0
48820,4,8820,[ 69 288 405  25 182],457,5,35773,4.055435891622265,0.0,0.0
48821,4,8821,[ 69 269   8   7 276],344,4,35777,4.055429607798685,0.0,0.0
48822,4,8822,[318 427  79 588 216],796,5,35782,4.055536665533265,40.0,0.0
48823,4,8823,[125 202  96 174 200],457,5,35787,4.05564369900272,0.0,0.0
48824,4,8824,[268 195  12  64 179],655,2,35789,4.055410764872521,20.0,0.0
48825,4,8825,[742 215 197 111  50],457,4,35793,4.055404486743711,0.0,20.0
48826,4,8826,[318 427  79 588 216],716,5,35798,4.055511498810468,40.0,0.0
48827,4,8827,[318 427  79 588 216],18,5,35803,4.055618486633439,40.0,0.0
48828,4,8828,[318 427  79 588 216],450,5,35808,4.055725450220863,40.0,0.0
48829,4,8829,[222  64 385 135 257],457,4,35812,4.055719139297849,20.0,0.0
48830,4,8830,[318 427  79 588 216],450,5,35817,4.055826067263051,40.0,0.0
48831,4,8831,[318 427  79 588 216],796,5,35822,4.055932971014493,40.0,0.0
48832,4,8832,[  4  88 271 196 483],655,1,35823,4.055587003283143,0.0,0.0
48833,4,8833,[318 427  79 588 216],450,5,35828,4.055693909893593,40.0,0.0
48834,4,8834,[318 427  79 588 216],796,5,35833,4.055800792303339,40.0,0.0
48835,4,8835,[ 89  70 228 174 100],5,5,35838,4.055907650520598,0.0,20.0
48836,4,8836,[117 313 215 258 168],796,5,35843,4.0560144845535815,0.0,0.0
48837,4,8837,[ 97  25  88 322 121],450,3,35846,4.0558949988685224,0.0,0.0
48838,4,8838,[318 427  79 588 216],18,5,35851,4.05600181015952,40.0,0.0
48839,4,8839,[318 427  79 588 216],18,5,35856,4.056108597285068,40.0,0.0
48840,4,8840,[318 427  79 588 216],577,5,35861,4.056215360253365,40.0,0.0
48841,4,8841,[318 427  79 588 216],18,5,35866,4.056322099072608,40.0,0.0
48842,4,8842,[135  56 202 423 176],457,5,35871,4.05642881375099,0.0,0.0
48843,4,8843,[508 117 475 238 127],655,1,35872,4.056083220262325,0.0,20.0
48844,4,8844,[655 185 234  25 168],151,5,35877,4.056189937817976,0.0,0.0
48845,4,8845,[318 427  79 588 216],18,5,35882,4.056296631245761,40.0,0.0
48846,4,8846,[ 64 132 301 121  97],344,3,35885,4.056177235220979,20.0,0.0
48847,4,8847,[216  50   7  12 144],450,5,35890,4.05628390596745,0.0,20.0
48848,4,8848,[385   7 237  89 118],655,1,35891,4.05593852412702,0.0,0.0
48849,4,8849,[318 427  79 588 216],577,5,35896,4.056045197740113,40.0,0.0
48850,4,8850,[318 427  79 588 216],450,5,35901,4.056151847248898,40.0,0.0
48851,4,8851,[318 427  79 588 216],18,5,35906,4.056258472661545,40.0,0.0
48852,4,8852,[318 427  79 588 216],450,5,35911,4.056365073986219,40.0,0.0
48853,4,8853,[318 427  79 588 216],796,5,35916,4.056471651231082,40.0,0.0
48854,4,8854,[125 258 742   1 176],450,5,35921,4.056578204404292,0.0,0.0
48855,4,8855,[318 427  79 588 216],716,5,35926,4.056684733514002,40.0,0.0
48856,4,8856,[318 427  79 588 216],716,5,35931,4.056791238568364,40.0,0.0
48857,4,8857,[318 427  79 588 216],577,5,35936,4.056897719575525,40.0,0.0
48858,4,8858,[187 546 568 322 405],450,5,35941,4.057004176543628,0.0,0.0
48859,4,8859,[318 427  79 588 216],577,5,35946,4.057110609480812,40.0,0.0
48860,4,8860,[483  28 200 403 597],796,4,35950,4.05710416431554,0.0,0.0
48861,4,8861,[ 96  82 228 187 161],72,3,35953,4.056984879259761,0.0,0.0
48862,4,8862,[318 427  79 588 216],716,5,35958,4.057091278348189,40.0,0.0
48863,4,8863,[125 245  15 216 118],796,4,35962,4.057084837545126,0.0,0.0
48864,4,8864,[ 82 183 228  22 204],577,4,35966,4.0570783981951495,0.0,0.0
48865,4,8865,[275 176  25 211 204],151,4,35970,4.057071960297767,0.0,20.0
48866,4,8866,[318 427  79 588 216],450,5,35975,4.05717830156761,40.0,0.0
48867,4,8867,[318 427  79 588 216],18,5,35980,4.0572846188543075,40.0,0.0
48868,4,8868,[235 200  88 483 180],450,2,35982,4.05705265531627,0.0,0.0
48869,4,8869,[318 427  79 588 216],577,5,35987,4.057158962795941,40.0,0.0
48870,4,8870,[483 176 294   7 181],450,4,35991,4.057152519445384,0.0,0.0
48871,4,8871,[318 427  79 588 216],18,5,35996,4.057258791704238,40.0,0.0
48872,4,8872,[475 174  70 234 276],655,1,35997,4.056914234193621,0.0,0.0
48873,4,8873,[ 97 435 603 269  79],450,5,36002,4.057020509353166,20.0,0.0
48874,4,8874,[237 196 423 182   1],655,1,36003,4.056676056338028,0.0,0.0
48875,4,8875,[318 427  79 588 216],577,5,36008,4.056782334384858,40.0,0.0
48876,4,8876,[222 196 202 301 100],344,5,36013,4.0568885884871015,0.0,20.0
48877,4,8877,[318 427  79 588 216],577,5,36018,4.05699481865285,40.0,0.0
48878,4,8878,[ 12 405  69 181 265],72,3,36021,4.0568757742989074,0.0,0.0
48879,4,8879,[161 197 234 405 121],457,5,36026,4.056981981981982,0.0,0.0
48880,4,8880,[100 202 238 235  25],450,3,36029,4.05686296588222,0.0,20.0
48881,4,8881,[423  22  89 427 204],807,5,36034,4.056969151092097,20.0,0.0
48882,4,8882,[318 427  79 588 216],450,5,36039,4.057075312394462,40.0,0.0
48883,4,8883,[117 202 216  82 180],504,4,36043,4.057068887888339,0.0,0.0
48884,4,8884,[318 427  79 588 216],796,5,36048,4.057175014068655,40.0,0.0
48885,4,8885,[318 427  79 588 216],18,5,36053,4.057281116362818,40.0,0.0
48886,4,8886,[318 427  79 588 216],18,5,36058,4.05738719477889,40.0,0.0
48887,4,8887,[423 202 282 174 195],716,3,36061,4.057268226822682,0.0,0.0
48888,4,8888,[318 427  79 588 216],18,5,36066,4.057374282821465,40.0,0.0
48889,4,8889,[318 427  79 588 216],450,5,36071,4.05748031496063,40.0,0.0
48890,4,8890,[318 427  79 588 216],716,5,36076,4.057586323248229,40.0,0.0
48891,4,8891,[117  50 125 655 546],174,4,36080,4.057579847053531,0.0,20.0
48892,4,8892,[151 196  50 181 161],23,2,36082,4.057348476329698,0.0,20.0
48893,4,8893,[427 118 175 185 153],151,3,36085,4.057229592984034,20.0,0.0
48894,4,8894,[ 89  97  82 194 118],796,3,36088,4.057110736368746,0.0,0.0
48895,4,8895,[655 228 181 174  12],796,4,36092,4.057104316546763,0.0,0.0
48896,4,8896,[318 427  79 588 216],18,5,36097,4.05721029560526,40.0,0.0
48897,4,8897,[318 427  79 588 216],450,5,36102,4.057316250842886,40.0,0.0
48898,4,8898,[318 427  79 588 216],450,5,36107,4.05742218226767,40.0,0.0
48899,4,8899,[ 69 435 196 475 182],655,1,36108,4.057078651685393,0.0,0.0
48900,4,8900,[ 88 200 301 515 183],655,3,36111,4.05695989214695,0.0,0.0
48901,4,8901,[ 70   9  11   4 268],655,0,36111,4.056504156369355,0.0,0.0
48902,4,8902,[471 748 234 111 117],450,4,36115,4.056497809727058,0.0,0.0
48903,4,8903,[318 427  79 588 216],716,5,36120,4.056603773584905,40.0,0.0
48904,4,8904,[238 185 496 121 182],535,4,36124,4.056597417181359,20.0,0.0
48905,4,8905,[ 82  79  64 237 197],655,2,36126,4.056366494498091,20.0,0.0
48906,4,8906,[483 186 286 200 194],796,3,36129,4.0562478949141125,0.0,20.0
48907,4,8907,[496 300   4 294  95],716,4,36133,4.056241580601706,20.0,0.0
48908,4,8908,[294  28 111 257 405],716,5,36138,4.05634751375014,0.0,0.0
48909,4,8909,[318 427  79 588 216],796,5,36143,4.0564534231200895,40.0,0.0
48910,4,8910,[143 151 194  70 603],151,5,36148,4.05655930871956,20.0,0.0
48911,4,8911,[100 328 300 357  82],655,1,36149,4.056216337522442,0.0,20.0
48912,4,8912,[318 427  79 588 216],796,5,36154,4.056322225962078,40.0,0.0
48913,4,8913,[125 174 176 322 143],450,5,36159,4.056428090643931,0.0,0.0
48914,4,8914,[405 222 168 423 211],796,4,36163,4.0564217610768365,0.0,0.0
48915,4,8915,[ 89 176 135 216 125],151,4,36167,4.0564154329295645,0.0,0.0
48916,4,8916,[ 28  22 210 568 183],716,4,36171,4.056409106201637,0.0,0.0
48917,4,8917,[318 427  79 588 216],577,5,36176,4.056514913657771,40.0,0.0
48918,4,8918,[318 427  79 588 216],716,5,36181,4.0566206973876,40.0,0.0
48919,4,8919,[228 180 546 222   9],786,5,36186,4.056726457399103,0.0,0.0
48920,4,8920,[ 64 282 228 194  56],796,5,36191,4.056832193700258,20.0,0.0
48921,4,8921,[546 275 742  12 174],344,3,36194,4.056713741313607,0.0,20.0
48922,4,8922,[318 427  79 588 216],18,5,36199,4.056819455340133,40.0,0.0
48923,4,8923,[  8 210 187 195  79],655,2,36201,4.05658897355446,0.0,0.0
48924,4,8924,[318 427  79 588 216],796,5,36206,4.056694677871149,40.0,0.0
48925,4,8925,[ 56  82 603 483  50],716,5,36211,4.056800358503249,20.0,20.0
48926,4,8926,[318 427  79 588 216],18,5,36216,4.056906015458721,40.0,0.0
48927,4,8927,[ 97 313 143   8 328],796,4,36220,4.056899641577061,0.0,0.0
48928,4,8928,[318 427  79 588 216],450,5,36225,4.05700526374734,40.0,0.0
48929,4,8929,[318 427  79 588 216],450,5,36230,4.057110862262038,40.0,0.0
48930,4,8930,[318 427  79 588 216],716,5,36235,4.057216437129101,40.0,0.0
48931,4,8931,[318 427  79 588 216],796,5,36240,4.057321988356471,40.0,0.0
48932,4,8932,[318 427  79 588 216],577,5,36245,4.057427515952088,40.0,0.0
48933,4,8933,[300 176 275 143 182],655,3,36248,4.057309156033132,0.0,20.0
48934,4,8934,[200 245 202  64 282],796,4,36252,4.057302742025741,20.0,0.0
48935,4,8935,[357 289 183  98 182],655,4,36256,4.057296329453894,0.0,0.0
48936,4,8936,[323 143 597 210 181],20,3,36259,4.057178023945395,0.0,0.0
48937,4,8937,[318 427  79 588 216],796,5,36264,4.057283508614903,40.0,0.0
48938,4,8938,[318 427  79 588 216],18,5,36269,4.05738896968341,40.0,0.0
48939,4,8939,[318 427  79 588 216],796,5,36274,4.057494407158837,40.0,0.0
48940,4,8940,[318 427  79 588 216],577,5,36279,4.0575998210490996,40.0,0.0
48941,4,8941,[210 286 215 168 748],796,3,36282,4.057481547752181,0.0,20.0
48942,4,8942,[210 546 211 237 117],593,3,36285,4.057363300905736,0.0,0.0
48943,4,8943,[435 111  79 286 210],296,3,36288,4.057245080500895,0.0,20.0
48944,4,8944,[318 427  79 588 216],796,5,36293,4.0573504751257685,40.0,0.0
48945,4,8945,[318 427  79 588 216],450,5,36298,4.05745584618824,40.0,0.0
48946,4,8946,[ 56 204  79 211  15],296,4,36302,4.057449424388063,0.0,0.0
48947,4,8947,[ 22 180 151  95 132],450,4,36306,4.057443004023245,0.0,0.0
48948,4,8948,[132 496 117 172 174],450,5,36311,4.057548329422282,20.0,0.0
48949,4,8949,[111 186 151  64 215],151,4,36315,4.057541899441341,20.0,0.0
48950,4,8950,[318 427  79 588 216],18,5,36320,4.057647190258072,40.0,0.0
48951,4,8951,[318 427  79 588 216],18,5,36325,4.057752457551385,40.0,0.0
48952,4,8952,[318 427  79 588 216],18,5,36330,4.057857701329163,40.0,0.0
48953,4,8953,[568 135 655 313 111],280,2,36332,4.057627875809694,0.0,0.0
48954,4,8954,[  7  28 180 471 427],693,2,36334,4.057398101619207,20.0,0.0
48955,4,8955,[333 179 385 195 508],655,1,36335,4.057056721750782,0.0,0.0
48956,4,8956,[322 181  95 568 546],280,3,36338,4.056938707156414,0.0,0.0
48957,4,8957,[ 22 182 216   9 597],796,4,36342,4.0569323509711985,0.0,0.0
48958,4,8958,[318 427  79 588 216],796,5,36347,4.057037615805336,40.0,0.0
48959,4,8959,[228  69 403 143  88],450,5,36352,4.057142857142857,0.0,0.0
48960,4,8960,[  1  50 294  70 125],401,1,36353,4.056801696239259,0.0,20.0
48961,4,8961,[318 427  79 588 216],450,5,36358,4.056906940415086,40.0,0.0
48962,4,8962,[318 427  79 588 216],796,5,36363,4.057012161106773,40.0,0.0
48963,4,8963,[ 15 588 471 427 132],450,4,36367,4.057005800981704,20.0,0.0
48964,4,8964,[318 427  79 588 216],450,5,36372,4.0571109871723365,40.0,0.0
48965,4,8965,[183 191 300 216 174],450,5,36377,4.057216149899621,0.0,0.0
48966,4,8966,[258   4 100 515 228],655,1,36378,4.056875209100033,0.0,20.0
48967,4,8967,[318 427  79 588 216],450,5,36383,4.056980374665478,40.0,0.0
48968,4,8968,[181 357  79 234 603],796,4,36387,4.056974021630059,20.0,0.0
48969,4,8969,[318 427  79 588 216],577,5,36392,4.057079152731327,40.0,0.0
48970,4,8970,[318 427  79 588 216],577,5,36397,4.057184260394605,40.0,0.0
48971,4,8971,[318 427  79 588 216],18,5,36402,4.057289344627731,40.0,0.0
48972,4,8972,[318 427  79 588 216],716,5,36407,4.057394405438538,40.0,0.0
48973,4,8973,[318 427  79 588 216],796,5,36412,4.057499442834856,40.0,0.0
48974,4,8974,[ 82 211 435 234 333],655,0,36412,4.057047353760446,0.0,0.0
48975,4,8975,[318 427  79 588 216],18,5,36417,4.057152406417113,40.0,0.0
48976,4,8976,[427 238 294 196  98],65,4,36421,4.057146039879693,20.0,0.0
48977,4,8977,[318 427  79 588 216],577,5,36426,4.057251058142125,40.0,0.0
48978,4,8978,[483 435  69   7 100],450,4,36430,4.057244682035861,0.0,20.0
48979,4,8979,[318   1 121 181  25],401,2,36432,4.057015590200446,20.0,0.0
48980,4,8980,[318 427  79 588 216],18,5,36437,4.057120587907805,40.0,0.0
48981,4,8981,[318 427  79 588 216],577,5,36442,4.057225562235582,40.0,0.0
48982,4,8982,[181 127 135 179 151],389,4,36446,4.057219191806746,0.0,20.0
48983,4,8983,[318 427  79 588 216],716,5,36451,4.057324131789849,40.0,0.0
48984,4,8984,[301 228 132 273 385],450,4,36455,4.0573177518085695,0.0,0.0
48985,4,8985,[211   1 161 181 127],807,4,36459,4.057311373247273,0.0,20.0
48986,4,8986,[ 71 118 168 211  50],389,4,36463,4.0573049961054855,0.0,20.0
48987,4,8987,[257 258 173 405 135],807,3,36466,4.0571873609256786,0.0,0.0
48988,4,8988,[318 427  79 588 216],18,5,36471,4.05729224607854,40.0,0.0
48989,4,8989,[125 186 435 268  82],655,0,36471,4.0568409343715235,0.0,0.0
48990,4,8990,[318 427  79 588 216],450,5,36476,4.056945834723613,40.0,0.0
48991,4,8991,[200  56  69  25   8],655,1,36477,4.056605871886121,0.0,0.0
48992,4,8992,[318 427  79 588 216],716,5,36482,4.056710775047259,40.0,0.0
48993,4,8993,[318 427  79 588 216],18,5,36487,4.0568156548810315,40.0,0.0
48994,4,8994,[318 427  79 588 216],18,5,36492,4.056920511395219,40.0,0.0
48995,4,8995,[161 435 204 568 180],450,5,36497,4.057025344597599,0.0,0.0
48996,4,8996,[318 427  79 588 216],450,5,36502,4.057130154495943,40.0,0.0
48997,4,8997,[ 11 181 294 597   7],457,3,36505,4.057012669482107,0.0,0.0
48998,4,8998,[238 176 483  79 179],655,3,36508,4.056895210578953,0.0,0.0
48999,4,8999,[ 15 168 403 222   4],796,5,36513,4.057,0.0,0.0
49000,4,9000,[269 121  98 210 237],450,3,36516,4.056882568603489,0.0,0.0
49001,4,9001,[318 427  79 588 216],796,5,36521,4.056987336147523,40.0,0.0
49002,4,9002,[118 300 125 546 153],504,3,36524,4.056869932244807,0.0,0.0
49003,4,9003,[235 257 385 234 173],5,4,36528,4.056863616170591,0.0,0.0
49004,4,9004,[180 200 245 187 172],450,4,36532,4.056857301499167,0.0,0.0
49005,4,9005,[318 427  79 588 216],450,5,36537,4.056962025316456,40.0,0.0
49006,4,9006,[186 301  98 313 117],655,2,36539,4.056733651604308,0.0,0.0
49007,4,9007,[318 427  79 588 216],18,5,36544,4.05683836589698,40.0,0.0
49008,4,9008,[288 271 322  50  12],557,3,36547,4.056721056721057,0.0,20.0
49009,4,9009,[483 151 174  28 153],23,3,36550,4.056603773584905,0.0,0.0
49010,4,9010,[265 181 117 234 222],292,4,36554,4.056597491954278,0.0,0.0
49011,4,9011,[318 427  79 588 216],796,5,36559,4.05670217487794,40.0,0.0
49012,4,9012,[318 427  79 588 216],577,5,36564,4.056806834572284,40.0,0.0
49013,4,9013,[318 427  79 588 216],577,5,36569,4.056911471045041,40.0,0.0
49014,4,9014,[185  56 200   8 234],18,2,36571,4.056683305601775,0.0,0.0
49015,4,9015,[318 427  79 588 216],18,5,36576,4.05678793256433,40.0,0.0
49016,4,9016,[318 427  79 588 216],796,5,36581,4.056892536320284,40.0,0.0
49017,4,9017,[127  95 275  56 195],450,4,36585,4.0568862275449105,0.0,40.0
49018,4,9018,[222  79 100 403 127],655,2,36587,4.056658166093802,0.0,40.0
49019,4,9019,[318 427  79 588 216],450,5,36592,4.056762749445676,40.0,0.0
49020,4,9020,[174 117   7 235 173],457,4,36596,4.056756457155526,0.0,0.0
49021,4,9021,[318 427  79 588 216],796,5,36601,4.05686100642873,40.0,0.0
49022,4,9022,[234 471 181 180  15],72,4,36605,4.056854704643689,0.0,0.0
49023,4,9023,[318 427  79 588 216],716,5,36610,4.056959219858156,40.0,0.0
49024,4,9024,[318 427  79 588 216],18,5,36615,4.057063711911358,40.0,0.0
49025,4,9025,[117 568  22 211 234],796,3,36618,4.056946598714823,0.0,0.0
49026,4,9026,[318 427  79 588 216],577,5,36623,4.057051069015177,40.0,0.0
49027,4,9027,[153 276 546 161 204],504,2,36625,4.056823216659282,0.0,0.0
49028,4,9028,[195 588  71 143  15],330,4,36629,4.056816923247315,0.0,0.0
49029,4,9029,[318 427  79 588 216],18,5,36634,4.056921373200443,40.0,0.0
49030,4,9030,[597  56  98  88 238],11,1,36635,4.056582881187023,0.0,0.0
49031,4,9031,[202 265 234 186 742],450,3,36638,4.056465899025686,0.0,0.0
49032,4,9032,[234 161 568 597 127],269,1,36639,4.056127532381269,0.0,20.0
49033,4,9033,[318 427  79 588 216],577,5,36644,4.056232012397609,40.0,0.0
49034,4,9034,[  1 273 268 276 179],655,3,36647,4.056115107913669,0.0,0.0
49035,4,9035,[318 427  79 588 216],796,5,36652,4.056219566179726,40.0,0.0
49036,4,9036,[ 64 288  15 405 216],450,3,36655,4.056102688945447,20.0,0.0
49037,4,9037,[318 427  79 588 216],450,5,36660,4.0562071254702365,40.0,0.0
49038,4,9038,[195 174   7 568 273],655,1,36661,4.055869012058856,0.0,0.0
49039,4,9039,[118  95 328 302 588],450,3,36664,4.055752212389381,0.0,0.0
49040,4,9040,[318 427  79 588 216],716,5,36669,4.055856653025108,40.0,0.0
49041,4,9041,[ 79  11 200 118 132],716,4,36673,4.055850475558505,0.0,0.0
49042,4,9042,[210 100 357 173 546],786,5,36678,4.055954882229349,0.0,20.0
49043,4,9043,[318 427  79 588 216],450,5,36683,4.056059265811588,40.0,0.0
49044,4,9044,[318 427  79 588 216],18,5,36688,4.05616362631288,40.0,0.0
49045,4,9045,[185 357 403 222  69],693,2,36690,4.055936325447711,0.0,0.0
49046,4,9046,[ 12 257 357 127 234],655,2,36692,4.0557090748314355,0.0,20.0
49047,4,9047,[318 427  79 588 216],450,5,36697,4.055813439434129,40.0,0.0
49048,4,9048,[117 269  28 333 204],796,3,36700,4.055696762073158,0.0,0.0
49049,4,9049,[318 427  79 588 216],450,5,36705,4.0558011049723754,40.0,0.0
49050,4,9050,[318 427  79 588 216],450,5,36710,4.055905424814938,40.0,0.0
49051,4,9051,[318 427  79 588 216],716,5,36715,4.0560097216084845,40.0,0.0
49052,4,9052,[168 276 180 176  82],269,2,36717,4.0557826134982875,0.0,0.0
49053,4,9053,[318 427  79 588 216],716,5,36722,4.055886900817319,40.0,0.0
49054,4,9054,[168  25 197  95  98],716,5,36727,4.055991165102154,0.0,0.0
49055,4,9055,[ 71 405 588 195  50],885,4,36731,4.055984982332156,0.0,20.0
49056,4,9056,[ 89 269 117  88 234],450,4,36735,4.055978800927459,0.0,0.0
49057,4,9057,[187 174 117 151  15],256,4,36739,4.055972620887613,0.0,0.0
49058,4,9058,[183 197 237 204 588],716,4,36743,4.055966442212164,0.0,0.0
49059,4,9059,[318 427  79 588 216],716,5,36748,4.056070640176601,40.0,0.0
49060,4,9060,[742 100  11 117 200],280,4,36752,4.056064452047235,0.0,20.0
49061,4,9061,[313   1 301 385 153],796,3,36755,4.055947914367689,0.0,0.0
49062,4,9062,[313 258 228 427 132],655,2,36757,4.055721063665453,20.0,0.0
49063,4,9063,[211 172   8  96 508],655,1,36758,4.055383936451897,0.0,0.0
49064,4,9064,[168 153 200 385  50],5,3,36761,4.05526751241037,0.0,20.0
49065,4,9065,[318 427  79 588 216],450,5,36766,4.055371718508714,40.0,0.0
49066,4,9066,[318 427  79 588 216],18,5,36771,4.055475901621264,40.0,0.0
49067,4,9067,[215 151 183 200  25],504,4,36775,4.055469783855315,0.0,0.0
49068,4,9068,[318 427  79 588 216],450,5,36780,4.0555739331789615,40.0,0.0
49069,4,9069,[182 216 385  22 174],655,2,36782,4.05534729878721,0.0,0.0
49070,4,9070,[313 603 117 186 265],450,4,36786,4.055341197221916,20.0,0.0
49071,4,9071,[318 427  79 588 216],716,5,36791,4.05544532627866,40.0,0.0
49072,4,9072,[234 294 181  50  64],256,4,36795,4.055439215254051,20.0,20.0
49073,4,9073,[  1 273 153 186 385],655,1,36796,4.055102490632577,0.0,0.0
49074,4,9074,[176  64  50  79 175],716,3,36799,4.054986225895317,20.0,20.0
49075,4,9075,[180 197 288  28  22],457,5,36804,4.055090348171,0.0,0.0
49076,4,9076,[318 427  79 588 216],716,5,36809,4.055194447504682,40.0,0.0
49077,4,9077,[237 151  69   9  50],269,2,36811,4.054968054637586,0.0,20.0
49078,4,9078,[318 427  79 588 216],18,5,36816,4.055072144509307,40.0,0.0
49079,4,9079,[318 427  79 588 216],796,5,36821,4.055176211453745,40.0,0.0
49080,4,9080,[216 196 210  50 161],716,4,36825,4.0551701354476375,0.0,20.0
49081,4,9081,[323 322 180 204 294],796,1,36826,4.054833737062321,0.0,0.0
49082,4,9082,[323 423  96 257 181],504,4,36830,4.054827700099086,0.0,0.0
49083,4,9083,[ 12 276  64 125  11],256,4,36834,4.054821664464994,20.0,0.0
49084,4,9084,[ 97 234 471 288 385],457,5,36839,4.054925701706109,0.0,0.0
49085,4,9085,[318 427  79 588 216],796,5,36844,4.055029716046665,40.0,0.0
49086,4,9086,[100 228 202  28 234],23,2,36846,4.054803565533179,0.0,20.0
49087,4,9087,[318 427  79 588 216],577,5,36851,4.054907570422535,40.0,0.0
49088,4,9088,[258 173 100 288 273],344,4,36855,4.054901529321158,0.0,20.0
49089,4,9089,[655 197 515 153 185],401,3,36858,4.0547854785478545,0.0,0.0
49090,4,9090,[318 427  79 588 216],577,5,36863,4.054889451105489,40.0,0.0
49091,4,9091,[200 588 655  25 204],716,5,36868,4.054993400791905,0.0,0.0
49092,4,9092,[  8 427  98 216 195],796,5,36873,4.055097327614648,20.0,0.0
49093,4,9093,[318 427  79 588 216],796,5,36878,4.055201231581262,40.0,0.0
49094,4,9094,[ 69 483 216  70 271],655,2,36880,4.0549752611324905,0.0,0.0
49095,4,9095,[318 427  79 588 216],18,5,36885,4.055079155672823,40.0,0.0
49096,4,9096,[742 357 423 313 125],796,4,36889,4.055073101022315,0.0,0.0
49097,4,9097,[153 121 174 185 176],504,3,36892,4.05495713343592,0.0,0.0
49098,4,9098,[318 427  79 588 216],716,5,36897,4.055060995713815,40.0,0.0
49099,4,9099,[ 82 195  96 265 423],655,0,36897,4.054615384615385,0.0,0.0
49100,4,9100,[318 427  79 588 216],450,5,36902,4.054719261619602,40.0,0.0
49101,4,9101,[318 427  79 588 216],796,5,36907,4.054823115798725,40.0,0.0
49102,4,9102,[118 318 194  98 100],504,3,36910,4.054707239371636,20.0,20.0
49103,4,9103,[  7 181   1 655 475],655,0,36910,4.054261862917399,0.0,0.0
49104,4,9104,[ 69 313  96  50 483],796,5,36915,4.0543657331136735,0.0,20.0
49105,4,9105,[276 161 333 313 258],655,2,36917,4.054140127388535,0.0,0.0
49106,4,9106,[318 427  79 588 216],796,5,36922,4.054243988140991,40.0,0.0
49107,4,9107,[318 427  79 588 216],796,5,36927,4.054347826086956,40.0,0.0
49108,4,9108,[318 168 144 216 302],450,5,36932,4.054451641233944,20.0,0.0
49109,4,9109,[318 427  79 588 216],450,5,36937,4.054555433589462,40.0,0.0
49110,4,9110,[318 427  79 588 216],577,5,36942,4.054659203161014,40.0,0.0
49111,4,9111,[318 427  79 588 216],18,5,36947,4.0547629499561015,40.0,0.0
49112,4,9112,[ 22  12 187  15 323],796,4,36951,4.054756940634259,0.0,0.0
49113,4,9113,[294  96 181 127 237],655,1,36952,4.054421768707483,0.0,20.0
49114,4,9114,[176  69 322 508 100],280,2,36954,4.054196379594075,0.0,20.0
49115,4,9115,[318 427  79 588 216],716,5,36959,4.0543001316366825,40.0,0.0
49116,4,9116,[318 257 117 197 174],401,3,36962,4.05418449051223,20.0,0.0
49117,4,9117,[210  95 235 121 257],5,4,36966,4.054178547927177,0.0,0.0
49118,4,9118,[118  28  70 173 151],716,4,36970,4.054172606645466,0.0,0.0
49119,4,9119,[318 427  79 588 216],18,5,36975,4.0542763157894735,40.0,0.0
49120,4,9120,[318 427  79 588 216],796,5,36980,4.054380002192742,40.0,0.0
49121,4,9121,[117 301  25 132 191],655,1,36981,4.054045165533874,0.0,0.0
49122,4,9122,[322  88   9 678 603],401,2,36983,4.0538200153458295,20.0,0.0
49123,4,9123,[204 127 471 282 191],716,3,36986,4.053704515563349,0.0,20.0
49124,4,9124,[318 427  79 588 216],450,5,36991,4.053808219178082,40.0,0.0
49125,4,9125,[742 196  12  56 273],655,1,36992,4.053473591935131,0.0,0.0
49126,4,9126,[318 427  79 588 216],796,5,36997,4.053577298126438,40.0,0.0
49127,4,9127,[357  97 742 200 185],457,5,37002,4.053680981595092,0.0,0.0
49128,4,9128,[318 427  79 588 216],796,5,37007,4.0537846423485595,40.0,0.0
49129,4,9129,[275 748 597 202 603],450,5,37012,4.053888280394305,20.0,20.0
49130,4,9130,[318 427  79 588 216],796,5,37017,4.053991895739787,40.0,0.0
49131,4,9131,[357  56 132 568   7],655,1,37018,4.053657468243539,0.0,0.0
49132,4,9132,[322 191 228  28  69],796,3,37021,4.053542100076645,0.0,0.0
49133,4,9133,[194 121 153 234 546],796,4,37025,4.0535362382307865,0.0,0.0
49134,4,9134,[318 427  79 588 216],18,5,37030,4.053639846743295,40.0,0.0
49135,4,9135,[ 98 238 161 135  56],457,5,37035,4.053743432574431,0.0,0.0
49136,4,9136,[143 179 237 275 568],450,5,37040,4.05384699573164,0.0,20.0
49137,4,9137,[318 427  79 588 216],577,5,37045,4.053950536222368,40.0,0.0
49138,4,9138,[ 56 210 127   7 135],450,3,37048,4.0538352117299485,0.0,20.0
49139,4,9139,[161 121 127  25  79],457,5,37053,4.053938730853392,0.0,20.0
49140,4,9140,[313 655 403 191  89],796,4,37057,4.053932830106115,0.0,0.0
49141,4,9141,[318 427  79 588 216],577,5,37062,4.054036315904616,40.0,0.0
49142,4,9142,[ 70  15   4 483 302],151,4,37066,4.05403040577491,0.0,0.0
49143,4,9143,[204  71 496 405 111],796,5,37071,4.054133858267717,20.0,0.0
49144,4,9144,[318 427  79 588 216],577,5,37076,4.054237288135593,40.0,0.0
49145,4,9145,[288 238 195  50 200],450,3,37079,4.054122020555434,0.0,20.0
49146,4,9146,[237  22 515  97 300],535,2,37081,4.053897452716738,0.0,0.0
49147,4,9147,[318 427  79 588 216],18,5,37086,4.054000874508089,40.0,0.0
49148,4,9148,[ 56 294 204 235 111],450,4,37090,4.053994972128101,0.0,0.0
49149,4,9149,[174 357 323 405   1],23,3,37093,4.053879781420765,0.0,0.0
49150,4,9150,[180  56   9 204 210],280,3,37096,4.053764615888974,0.0,0.0
49151,4,9151,[318 427  79 588 216],796,5,37101,4.053868006993007,40.0,0.0
49152,4,9152,[318 427  79 588 216],18,5,37106,4.053971375505299,40.0,0.0
49153,4,9153,[ 96  98 289 258 132],693,4,37110,4.053965479571772,0.0,0.0
49154,4,9154,[ 11 127 197 302  22],269,2,37112,4.053741125068269,0.0,20.0
49155,4,9155,[ 56 265 742 100   1],450,5,37117,4.053844473569244,0.0,20.0
49156,4,9156,[318 427  79 588 216],796,5,37122,4.053947799497652,40.0,0.0
49157,4,9157,[318 427  79 588 216],796,5,37127,4.054051102860886,40.0,0.0
49158,4,9158,[  4 118 234 172  11],577,2,37129,4.053826836990938,0.0,0.0
49159,4,9159,[318 427  79 588 216],796,5,37134,4.053930131004367,40.0,0.0
49160,4,9160,[318 427  79 588 216],450,5,37139,4.054033402466979,40.0,0.0
49161,4,9161,[275 216   7 300 748],450,5,37144,4.05413665138616,0.0,20.0
49162,4,9162,[197 196 603 302 423],450,5,37149,4.054239877769289,20.0,0.0
49163,4,9163,[568  11 328  71 265],450,4,37153,4.054233958969882,0.0,0.0
49164,4,9164,[269 423 132  22 111],655,0,37153,4.05379159847245,0.0,0.0
49165,4,9165,[300 125  98 135  56],11,3,37156,4.053676631027711,0.0,0.0
49166,4,9166,[269 197 357 405 301],796,2,37158,4.053452601723573,0.0,0.0
49167,4,9167,[132 405 234   1  28],292,4,37162,4.053446771378709,0.0,0.0
49168,4,9168,[318   4 172 215   1],655,2,37164,4.05322281601047,20.0,0.0
49169,4,9169,[318 427  79 588 216],450,5,37169,4.053326063249727,40.0,0.0
49170,4,9170,[318 427  79 588 216],796,5,37174,4.053429287972958,40.0,0.0
49171,4,9171,[318 427  79 588 216],577,5,37179,4.053532490187528,40.0,0.0
49172,4,9172,[423 117 603 118 187],655,2,37181,4.053308623133108,20.0,0.0
49173,4,9173,[318 427  79 588 216],18,5,37186,4.053411816001744,40.0,0.0
49174,4,9174,[202   8  82 588 121],330,5,37191,4.053514986376022,0.0,0.0
49175,4,9175,[ 15 111  82 275  56],796,4,37195,4.053509154315606,0.0,20.0
49176,4,9176,[161 168  25 185 588],330,4,37199,4.053503323526207,0.0,0.0
49177,4,9177,[ 89  82 100 200 175],269,3,37202,4.053388537807801,0.0,20.0
49178,4,9178,[125 191 182 385 288],450,4,37206,4.053382721429349,0.0,0.0
49179,4,9179,[ 64 196 300 282  82],716,4,37210,4.053376906318083,20.0,0.0
49180,4,9180,[318 427  79 588 216],716,5,37215,4.053480013070471,40.0,0.0
49181,4,9181,[318 427  79 588 216],18,5,37220,4.053583097364409,40.0,0.0
49182,4,9182,[ 98  22  50 121 125],256,5,37225,4.05368615920723,0.0,20.0
49183,4,9183,[318 427  79 588 216],18,5,37230,4.053789198606272,40.0,0.0
49184,4,9184,[215  96 405 125  79],457,5,37235,4.053892215568863,0.0,0.0
49185,4,9185,[202 176 238 100 195],786,5,37240,4.05399521010233,0.0,20.0
49186,4,9186,[182   1 210  96 318],457,5,37245,4.054098182213998,20.0,0.0
49187,4,9187,[318 427  79 588 216],577,5,37250,4.054201131911189,40.0,0.0
49188,4,9188,[318 427  79 588 216],18,5,37255,4.054304059201219,40.0,0.0
49189,4,9189,[318 427  79 588 216],716,5,37260,4.054406964091403,40.0,0.0
49190,4,9190,[318 427  79 588 216],716,5,37265,4.054509846589054,40.0,0.0
49191,4,9191,[127 215 195 546 187],796,5,37270,4.054612706701479,0.0,20.0
49192,4,9192,[318 427  79 588 216],18,5,37275,4.054715544435984,40.0,0.0
49193,4,9193,[318 427  79 588 216],796,5,37280,4.054818359799869,40.0,0.0
49194,4,9194,[143  70 234 302 301],655,2,37282,4.054594888526373,0.0,0.0
49195,4,9195,[183 483 323  89 204],23,2,37284,4.05437146585472,0.0,0.0
49196,4,9196,[318 427  79 588 216],577,5,37289,4.054474285092965,40.0,0.0
49197,4,9197,[318 427  79 588 216],796,5,37294,4.054577081974342,40.0,0.0
49198,4,9198,[318 427  79 588 216],18,5,37299,4.054679856506142,40.0,0.0
49199,4,9199,[ 71 132 121 215 174],344,2,37301,4.05445652173913,0.0,0.0
49200,4,9200,[318 427  79 588 216],18,5,37306,4.054559287034018,40.0,0.0
49201,4,9201,[215 318 235 216  22],457,4,37310,4.05455335796566,20.0,0.0
49202,4,9202,[403 111 546 153 127],280,4,37314,4.054547430185809,0.0,20.0
49203,4,9203,[258 322  15  50 269],15,3,37317,4.054432855280313,0.0,20.0
49204,4,9204,[318 427  79 588 216],18,5,37322,4.0545355784899515,40.0,0.0
49205,4,9205,[181 275  28 118 215],151,3,37325,4.054421029763198,0.0,20.0
49206,4,9206,[289 186 258  28 515],807,4,37329,4.054415118931248,0.0,0.0
49207,4,9207,[318 427  79 588 216],18,5,37334,4.054517810599479,40.0,0.0
49208,4,9208,[ 79  64   7 161 202],577,4,37338,4.054511890541861,20.0,0.0
49209,4,9209,[318 427  79 588 216],716,5,37343,4.054614549402823,40.0,0.0
49210,4,9210,[ 64  25 191 655  79],716,5,37348,4.054717185973293,20.0,0.0
49211,4,9211,[173 183 125 269   4],344,4,37352,4.054711246200608,0.0,0.0
49212,4,9212,[318 161 275 197 748],796,4,37356,4.054705307717356,20.0,20.0
49213,4,9213,[288 435 174  69 191],655,1,37357,4.054373779031908,0.0,0.0
49214,4,9214,[318 427  79 588 216],18,5,37362,4.054476397178513,40.0,0.0
49215,4,9215,[427 268 211 182 173],269,4,37366,4.054470486111111,20.0,0.0
49216,4,9216,[318 427  79 588 216],18,5,37371,4.054573071498318,40.0,0.0
49217,4,9217,[ 95 121 202 151 423],716,5,37376,4.054675634627902,0.0,0.0
49218,4,9218,[234 197  50   4 191],457,5,37381,4.054778175507105,0.0,20.0
49219,4,9219,[302  69 200 176 427],269,2,37383,4.054555314533623,20.0,0.0
49220,4,9220,[318 427  79 588 216],450,5,37388,4.054657846220583,40.0,0.0
49221,4,9221,[318 427  79 588 216],577,5,37393,4.054760355671221,40.0,0.0
49222,4,9222,[ 98 204   1 174 161],457,5,37398,4.054862842892768,0.0,0.0
49223,4,9223,[318 427  79 588 216],577,5,37403,4.054965307892455,40.0,0.0
49224,4,9224,[318 427  79 588 216],796,5,37408,4.055067750677507,40.0,0.0
49225,4,9225,[318 427  79 588 216],18,5,37413,4.055170171255148,40.0,0.0
49226,4,9226,[194  98 168 318 174],269,4,37417,4.055164192045085,20.0,0.0
49227,4,9227,[318 427  79 588 216],796,5,37422,4.055266579973992,40.0,0.0
49228,4,9228,[ 82 179 172 200 597],450,3,37425,4.05515223751219,0.0,0.0
49229,4,9229,[318 427  79 588 216],716,5,37430,4.055254604550379,40.0,0.0
49230,4,9230,[405 183  50 286 204],835,2,37432,4.055031957534395,0.0,40.0
49231,4,9231,[273 182 168 176 111],450,4,37436,4.055025996533796,0.0,0.0
49232,4,9232,[125 282 427 196 385],796,5,37441,4.0551283439835375,20.0,0.0
49233,4,9233,[186 211 153   8 179],655,1,37442,4.0547974875460255,0.0,0.0
49234,4,9234,[318 427  79 588 216],716,5,37447,4.054899837574445,40.0,0.0
49235,4,9235,[318 427  79 588 216],577,5,37452,4.055002165439584,40.0,0.0
49236,4,9236,[301  82 194  64 546],450,4,37456,4.054996210890982,20.0,0.0
49237,4,9237,[238 286 210 302 268],655,1,37457,4.054665512015588,0.0,20.0
49238,4,9238,[ 50 294  98 187 143],796,4,37461,4.054659595194285,0.0,20.0
49239,4,9239,[132 222 235 496 546],280,4,37465,4.05465367965368,20.0,0.0
49240,4,9240,[748 588 191  12 357],796,5,37470,4.054755978790174,0.0,0.0
49241,4,9241,[318 427  79 588 216],450,5,37475,4.0548582557887904,40.0,0.0
49242,4,9242,[435 176 508   9 655],269,3,37478,4.054744130693498,0.0,0.0
49243,4,9243,[318 427  79 588 216],18,5,37483,4.054846386845521,40.0,0.0
49244,4,9244,[172 238 135  56 282],535,1,37484,4.0545159545700376,0.0,0.0
49245,4,9245,[318 427  79 588 216],796,5,37489,4.054618213281419,40.0,0.0
49246,4,9246,[423 357 597  88 111],269,2,37491,4.054396020330918,0.0,0.0
49247,4,9247,[196 228 197  97  79],796,3,37494,4.054282006920415,0.0,0.0
49248,4,9248,[100 275 427 268 183],655,3,37497,4.054168018164126,20.0,40.0
49249,4,9249,[313 603 265 258 143],655,3,37500,4.054054054054054,20.0,0.0
49250,4,9250,[318 427  79 588 216],18,5,37505,4.054156307426224,40.0,0.0
49251,4,9251,[318 427  79 588 216],450,5,37510,4.054258538694336,40.0,0.0
49252,4,9252,[318 427  79 588 216],18,5,37515,4.054360747865557,40.0,0.0
49253,4,9253,[144 127 286 215 183],280,2,37517,4.05413875081046,0.0,40.0
49254,4,9254,[318 427  79 588 216],18,5,37522,4.054240950837385,40.0,0.0
49255,4,9255,[318 427  79 588 216],577,5,37527,4.054343128781331,40.0,0.0
49256,4,9256,[313 288   4 181 121],593,5,37532,4.0544452846494545,0.0,0.0
49257,4,9257,[318 427  79 588 216],796,5,37537,4.054547418448909,40.0,0.0
49258,4,9258,[ 82 210 228 265   9],151,4,37541,4.054541527162761,0.0,0.0
49259,4,9259,[318 427  79 588 216],796,5,37546,4.054643628509719,40.0,0.0
49260,4,9260,[176 655 313 216 196],655,2,37548,4.054421768707483,0.0,0.0
49261,4,9261,[318 427  79 588 216],450,5,37553,4.054523860937163,40.0,0.0
49262,4,9262,[318 427  79 588 216],796,5,37558,4.054625931123826,40.0,0.0
49263,4,9263,[288 275 111 228 268],655,1,37559,4.054296200345423,0.0,20.0
49264,4,9264,[268 174 271 125 301],655,0,37559,4.053858607663249,0.0,0.0
49265,4,9265,[ 89   8 228   9 174],655,1,37560,4.05352903086553,0.0,0.0
49266,4,9266,[318 427  79 588 216],796,5,37565,4.053631164346606,40.0,0.0
49267,4,9267,[318 427  79 588 216],577,5,37570,4.053733275787656,40.0,0.0
49268,4,9268,[318 427  79 588 216],450,5,37575,4.053835365195814,40.0,0.0
49269,4,9269,[237  89 185   7  25],450,4,37579,4.053829557713053,0.0,0.0
49270,4,9270,[318 427  79 588 216],716,5,37584,4.053931614712544,40.0,0.0
49271,4,9271,[403 655 196  15 121],457,5,37589,4.054033649698016,0.0,0.0
49272,4,9272,[318 427  79 588 216],796,5,37594,4.054135662676588,40.0,0.0
49273,4,9273,[318 427  79 588 216],18,5,37599,4.054237653655381,40.0,0.0
49274,4,9274,[318 427  79 588 216],18,5,37604,4.05433962264151,40.0,0.0
49275,4,9275,[318 427  79 588 216],716,5,37609,4.054441569642087,40.0,0.0
49276,4,9276,[222  70 153 125  82],151,3,37612,4.0543279077287915,0.0,0.0
49277,4,9277,[318 427  79 588 216],577,5,37617,4.054429834015952,40.0,0.0
49278,4,9278,[300 168 215  96 183],796,5,37622,4.054531738333872,0.0,0.0
49279,4,9279,[235  11 179 508 496],269,3,37625,4.054418103448276,20.0,0.0
49280,4,9280,[ 64 275 496 179 234],878,4,37629,4.054412240060338,40.0,20.0
49281,4,9281,[ 69  25 228 427 423],11,2,37631,4.054190907132083,20.0,0.0
49282,4,9282,[318 427  79 588 216],450,5,37636,4.0542927932780355,40.0,0.0
49283,4,9283,[318 427  79 588 216],796,5,37641,4.0543946574752265,40.0,0.0
49284,4,9284,[153 300 302 118 568],389,1,37642,4.054065697361335,0.0,0.0
49285,4,9285,[318 427  79 588 216],450,5,37647,4.054167564074952,40.0,0.0
49286,4,9286,[742 427 183 300  96],693,2,37649,4.05394637665554,20.0,0.0
49287,4,9287,[  8 174  98  50 181],18,4,37653,4.053940568475452,0.0,20.0
49288,4,9288,[405  98 125  96  69],344,2,37655,4.05371945311659,0.0,0.0
49289,4,9289,[318 427  79 588 216],796,5,37660,4.053821313240043,40.0,0.0
49290,4,9290,[318 427  79 588 216],577,5,37665,4.053923151436875,40.0,0.0
49291,4,9291,[257  69   9  79 234],457,4,37669,4.053917348256565,0.0,0.0
49292,4,9292,[318 427  79 588 216],716,5,37674,4.054019154202088,40.0,0.0
49293,4,9293,[181  69 173 275 196],344,3,37677,4.05390574564235,0.0,20.0
49294,4,9294,[ 71 181  70 172  88],18,2,37679,4.0536847767617,0.0,0.0
49295,4,9295,[  4 597  50  11 175],344,3,37682,4.053571428571429,0.0,20.0
49296,4,9296,[318 427  79 588 216],796,5,37687,4.053673227922986,40.0,0.0
49297,4,9297,[  1  89   8 546 195],796,4,37691,4.053667455366745,0.0,0.0
49298,4,9298,[318 427  79 588 216],716,5,37696,4.053769222497043,40.0,0.0
49299,4,9299,[323  56  50 322  22],256,4,37700,4.053763440860215,0.0,20.0
49300,4,9300,[318 427  79 588 216],577,5,37705,4.05386517578755,40.0,0.0
49301,4,9301,[175 111  79 475 204],655,1,37706,4.053536873790582,0.0,0.0
49302,4,9302,[318 427  79 588 216],450,5,37711,4.053638611200688,40.0,0.0
49303,4,9303,[127 179 210 183 546],236,2,37713,4.05341788478074,0.0,20.0
49304,4,9304,[318 427  79 588 216],577,5,37718,4.053519613111231,40.0,0.0
49305,4,9305,[318 427  79 588 216],18,5,37723,4.053621319578767,40.0,0.0
49306,4,9306,[318 427  79 588 216],18,5,37728,4.053723004190394,40.0,0.0
49307,4,9307,[118 183 210   9   4],593,3,37731,4.0536097980232055,0.0,0.0
49308,4,9308,[318 427  79 588 216],450,5,37736,4.053711462025996,40.0,0.0
49309,4,9309,[ 79 181 273  11 245],450,4,37740,4.053705692803437,0.0,0.0
49310,4,9310,[318 427  79 588 216],796,5,37745,4.053807324669745,40.0,0.0
49311,4,9311,[748 222 143 195  15],151,3,37748,4.053694158075602,0.0,0.0
49312,4,9312,[318 427  79 588 216],577,5,37753,4.053795769354665,40.0,0.0
49313,4,9313,[318 427  79 588 216],796,5,37758,4.053897358814687,40.0,0.0
49314,4,9314,[318 427  79 588 216],18,5,37763,4.053998926462695,40.0,0.0
49315,4,9315,[135 183  69 132 228],716,3,37766,4.053885787891799,0.0,0.0
49316,4,9316,[210 273 271 748 117],796,3,37769,4.0537726736073845,0.0,0.0
49317,4,9317,[173 200  97 135 275],716,4,37773,4.053766902768834,0.0,20.0
49318,4,9318,[318 427  79 588 216],450,5,37778,4.053868440819831,40.0,0.0
49319,4,9319,[111 194  64  28 273],236,3,37781,4.053755364806867,20.0,0.0
49320,4,9320,[276 118 271 174 405],655,1,37782,4.0534277438043125,0.0,0.0
49321,4,9321,[ 25  79 181  12  64],18,3,37785,4.053314739326325,20.0,0.0
49322,4,9322,[471 357 181  50 385],786,5,37790,4.05341628231256,0.0,20.0
49323,4,9323,[185 471 435 174 196],655,1,37791,4.053088803088803,0.0,0.0
49324,4,9324,[318 427  79 588 216],577,5,37796,4.053190348525469,40.0,0.0
49325,4,9325,[318 427  79 588 216],716,5,37801,4.053291872185288,40.0,0.0
49326,4,9326,[318 427  79 588 216],796,5,37806,4.053393374075266,40.0,0.0
49327,4,9327,[318 427  79 588 216],18,5,37811,4.053494854202401,40.0,0.0
49328,4,9328,[318 427  79 588 216],450,5,37816,4.053596312573695,40.0,0.0
49329,4,9329,[173 143 153 186 211],450,4,37820,4.053590568060021,0.0,0.0
49330,4,9330,[318 427  79 588 216],450,5,37825,4.0536919944271785,40.0,0.0
49331,4,9331,[196 302  22  89 191],655,3,37828,4.053579082726103,0.0,0.0
49332,4,9332,[318 427  79 588 216],18,5,37833,4.053680488588878,40.0,0.0
49333,4,9333,[318 427  79 588 216],577,5,37838,4.053781872723377,40.0,0.0
49334,4,9334,[268   4 357 216 172],344,4,37842,4.053776111408677,0.0,0.0
49335,4,9335,[ 70 195 405 483 121],269,1,37843,4.053449014567266,0.0,0.0
49336,4,9336,[174 405 200   7   8],577,2,37845,4.053229088572347,0.0,0.0
49337,4,9337,[ 64 357 403 273 185],693,2,37847,4.053009209680874,20.0,0.0
49338,4,9338,[322 496   7 181 200],908,1,37848,4.0526823000321235,20.0,0.0
49339,4,9339,[121 282 288 179 435],655,1,37849,4.052355460385439,0.0,0.0
49340,4,9340,[318 427  79 588 216],450,5,37854,4.0524569103950325,40.0,0.0
49341,4,9341,[191 161  22  88 125],577,4,37858,4.052451295225862,0.0,0.0
49342,4,9342,[172  89   9 301 187],296,5,37863,4.0525527132612655,0.0,0.0
49343,4,9343,[318 427  79 588 216],450,5,37868,4.052654109589041,40.0,0.0
49344,4,9344,[ 25 282 161 234 211],716,3,37871,4.052541466024612,0.0,0.0
49345,4,9345,[318 427  79 588 216],450,5,37876,4.052642841857479,40.0,0.0
49346,4,9346,[216 405 185 588  22],796,5,37881,4.0527441959987165,0.0,0.0
49347,4,9347,[318 427  79 588 216],450,5,37886,4.0528455284552845,40.0,0.0
49348,4,9348,[318 427  79 588 216],577,5,37891,4.052946839234143,40.0,0.0
49349,4,9349,[211 216  56 475  69],389,4,37895,4.052941176470588,0.0,0.0
49350,4,9350,[100 127 258 597 276],463,3,37898,4.052828574484012,0.0,40.0
49351,4,9351,[318 427  79 588 216],716,5,37903,4.052929854576561,40.0,0.0
49352,4,9352,[127 322 174  25  96],504,5,37908,4.053031113011868,0.0,20.0
49353,4,9353,[318 427  79 588 216],716,5,37913,4.053132349796878,40.0,0.0
49354,4,9354,[211 100  25 187  88],450,4,37917,4.053126670229823,0.0,20.0
49355,4,9355,[318 427  79 588 216],18,5,37922,4.053227875160325,40.0,0.0
49356,4,9356,[216 173 121 385 294],716,4,37926,4.053222186598268,0.0,0.0
49357,4,9357,[318 427  79 588 216],18,5,37931,4.053323359692242,40.0,0.0
49358,4,9358,[318 427  79 588 216],18,5,37936,4.053424511165723,40.0,0.0
49359,4,9359,[318 427  79 588 216],577,5,37941,4.053525641025641,40.0,0.0
49360,4,9360,[117 275 257 127 515],401,2,37943,4.053306270697575,0.0,40.0
49361,4,9361,[ 97 313 132 172  82],450,4,37947,4.053300576799829,0.0,0.0
49362,4,9362,[ 50 200 742 181 496],593,5,37952,4.0534016874933245,20.0,20.0
49363,4,9363,[176  15 197 144 238],450,4,37956,4.0533959846219565,0.0,0.0
49364,4,9364,[318 427  79 588 216],796,5,37961,4.0534970635344365,40.0,0.0
49365,4,9365,[ 12   1 265 483 182],280,4,37965,4.053491351697629,0.0,0.0
49366,4,9366,[318 427  79 588 216],18,5,37970,4.053592398847016,40.0,0.0
49367,4,9367,[546 322  96 174 202],450,5,37975,4.053693424423569,0.0,0.0
49368,4,9368,[174 405 228 294 269],23,4,37979,4.053687693457146,0.0,0.0
49369,4,9369,[282 176 742 168 117],450,5,37984,4.053788687299893,0.0,0.0
49370,4,9370,[282 300 427 132 211],693,3,37987,4.053676235193683,20.0,0.0
49371,4,9371,[ 12 117 215 121 185],693,4,37991,4.05367050789586,0.0,0.0
49372,4,9372,[237 181 238 257  96],457,4,37995,4.053664781820122,0.0,0.0
49373,4,9373,[ 15   1 100 328 235],938,2,37997,4.05344570087476,0.0,20.0
49374,4,9374,[333 238 185  96 144],796,4,38001,4.05344,0.0,0.0
49375,4,9375,[118 204 185 143  69],796,5,38006,4.0535409556314,0.0,0.0
49376,4,9376,[125  96 222 588 742],280,3,38009,4.053428601898261,0.0,0.0
49377,4,9377,[121 423  28 174 385],786,4,38013,4.053422904670505,0.0,0.0
49378,4,9378,[318 427  79 588 216],577,5,38018,4.053523829832605,40.0,0.0
49379,4,9379,[117 302 196 282 265],450,5,38023,4.05362473347548,0.0,0.0
49380,4,9380,[405 143 301 118  50],151,3,38026,4.053512418718687,0.0,20.0
49381,4,9381,[318 427  79 588 216],577,5,38031,4.05361330206779,40.0,0.0
49382,4,9382,[318 427  79 588 216],577,5,38036,4.053714163913461,40.0,0.0
49383,4,9383,[175  98 215 194 483],23,4,38040,4.053708439897698,0.0,0.0
49384,4,9384,[742 174 228 357 245],796,3,38043,4.053596164091635,0.0,0.0
49385,4,9385,[318 427  79 588 216],577,5,38048,4.05369699552525,40.0,0.0
49386,4,9386,[222   7 216 151 228],457,5,38053,4.053797805475658,0.0,0.0
49387,4,9387,[318 427  79 588 216],18,5,38058,4.053898593949723,40.0,0.0
49388,4,9388,[318 427  79 588 216],796,5,38063,4.053999360954308,40.0,0.0
49389,4,9389,[318 427  79 588 216],18,5,38068,4.054100106496272,40.0,0.0
49390,4,9390,[318 427  79 588 216],796,5,38073,4.054200830582473,40.0,0.0
49391,4,9391,[318 427  79 588 216],577,5,38078,4.054301533219761,40.0,0.0
49392,4,9392,[174 273  98  69  79],693,3,38081,4.0541892898967316,0.0,0.0
49393,4,9393,[318 427  79 588 216],450,5,38086,4.054289972322759,40.0,0.0
49394,4,9394,[121 234 132 185 423],151,5,38091,4.0543906333155935,0.0,0.0
49395,4,9395,[125 568 197 288 748],280,1,38092,4.0540655598126865,0.0,0.0
49396,4,9396,[318 427  79 588 216],18,5,38097,4.054166223262744,40.0,0.0
49397,4,9397,[289 186 269 286  22],296,3,38100,4.054054054054054,0.0,20.0
49398,4,9398,[515  12 427  15 161],655,2,38102,4.053835514416427,20.0,0.0
49399,4,9399,[318 427  79 588 216],450,5,38107,4.053936170212766,40.0,0.0
49400,4,9400,[318 427  79 588 216],796,5,38112,4.054036804595256,40.0,0.0
49401,4,9401,[515 175 181  70 143],269,2,38114,4.053818336524143,0.0,0.0
49402,4,9402,[ 69 176 496 127 471],716,3,38117,4.053706263958311,20.0,20.0
49403,4,9403,[176  95 423 143 168],450,4,38121,4.0537005529561885,0.0,0.0
49404,4,9404,[195 180 175 257 200],716,2,38123,4.053482190324296,0.0,0.0
49405,4,9405,[318 427  79 588 216],450,5,38128,4.0535828194769294,40.0,0.0
49406,4,9406,[196 121 185 111  28],457,4,38132,4.053577123418731,0.0,0.0
49407,4,9407,[318 427  79 588 216],450,5,38137,4.053677721088436,40.0,0.0
49408,4,9408,[318 427  79 588 216],577,5,38142,4.053778297374854,40.0,0.0
49409,4,9409,[318 427  79 588 216],450,5,38147,4.053878852284804,40.0,0.0
49410,4,9410,[210  25 435  79 135],18,3,38150,4.05376686855807,0.0,0.0
49411,4,9411,[318 427  79 588 216],796,5,38155,4.053867403314917,40.0,0.0
49412,4,9412,[318 427  79 588 216],450,5,38160,4.053967916710931,40.0,0.0
49413,4,9413,[175 237 191  98  97],878,2,38162,4.053749734438071,0.0,0.0
49414,4,9414,[318 427  79 588 216],796,5,38167,4.053850238980351,40.0,0.0
49415,4,9415,[318 427  79 588 216],450,5,38172,4.0539507221750215,40.0,0.0
49416,4,9416,[202 289 258 185 313],655,2,38174,4.0537326112350005,0.0,0.0
49417,4,9417,[ 69 210  25 235  95],716,4,38178,4.053726905924825,0.0,0.0
49418,4,9418,[318 427  79 588 216],450,5,38183,4.053827370209151,40.0,0.0
49419,4,9419,[181 294 183 300 143],716,4,38187,4.053821656050955,0.0,0.0
49420,4,9420,[357 258 153  82 435],450,4,38191,4.053815943105827,0.0,0.0
49421,4,9421,[143 125 153 405 111],401,2,38193,4.05359796221609,0.0,0.0
49422,4,9422,[ 70 211 196 568  97],716,5,38198,4.053698397537939,0.0,0.0
49423,4,9423,[405 228 194 289 222],807,5,38203,4.053798811544992,0.0,0.0
49424,4,9424,[483 144 200 117 153],655,2,38205,4.053580901856764,0.0,0.0
49425,4,9425,[318 427  79 588 216],450,5,38210,4.053681307023128,40.0,0.0
49426,4,9426,[318 427  79 588 216],577,5,38215,4.053781690887876,40.0,0.0
49427,4,9427,[318 427  79 588 216],18,5,38220,4.0538820534577855,40.0,0.0
49428,4,9428,[ 98  89   9  69 302],151,4,38224,4.05387633895429,0.0,0.0
49429,4,9429,[173 172 322  15 234],593,3,38227,4.053764581124072,0.0,0.0
49430,4,9430,[ 98  70 471 546 168],457,4,38231,4.05375888028841,0.0,0.0
49431,4,9431,[318 427  79 588 216],450,5,38236,4.053859202714165,40.0,0.0
49432,4,9432,[ 56 655 180  70 427],450,5,38241,4.053959503869395,20.0,0.0
49433,4,9433,[318 427  79 588 216],450,5,38246,4.054059783760865,40.0,0.0
49434,4,9434,[ 64 546 423 568 294],577,3,38249,4.053948065712771,20.0,0.0
49435,4,9435,[ 97  56 655 245 191],796,2,38251,4.0537303942348455,0.0,0.0
49436,4,9436,[357 276   8 269 403],655,2,38253,4.053512768888418,0.0,0.0
49437,4,9437,[748 655 121  95 125],796,4,38257,4.053507098961645,0.0,0.0
49438,4,9438,[191 161  82 275 143],716,4,38261,4.0535014302362535,0.0,20.0
49439,4,9439,[ 56   4 100  11 546],450,4,38265,4.053495762711864,0.0,20.0
49440,4,9440,[318 427  79 588 216],18,5,38270,4.053596017371041,40.0,0.0
49441,4,9441,[176 215  11 515 546],716,3,38273,4.053484431264563,0.0,0.0
49442,4,9442,[ 88  97 197 276 125],457,5,38278,4.053584665890077,0.0,0.0
49443,4,9443,[318 427  79 588 216],716,5,38283,4.053684879288437,40.0,0.0
49444,4,9444,[318 427  79 588 216],450,5,38288,4.053785071466384,40.0,0.0
49445,4,9445,[125 179 173 234   4],593,4,38292,4.053779377514291,0.0,0.0
49446,4,9446,[318 427  79 588 216],796,5,38297,4.0538795384778235,40.0,0.0
49447,4,9447,[748 194  97 195  22],796,4,38301,4.05387383573243,0.0,0.0
49448,4,9448,[ 97 300 151 185 423],716,5,38306,4.053973965498995,0.0,0.0
49449,4,9449,[181   1  22 143   7],450,5,38311,4.054074074074074,0.0,0.0
49450,4,9450,[143 127 210 597 496],450,4,38315,4.054068352555285,20.0,20.0
49451,4,9451,[318 427  79 588 216],450,5,38320,4.054168429961913,40.0,0.0
49452,4,9452,[194 288 603 186 100],264,5,38325,4.054268486194859,20.0,20.0
49453,4,9453,[238  64 127 234 143],796,3,38328,4.054156970594457,20.0,20.0
49454,4,9454,[185  28 258  97 655],504,5,38333,4.0542570068746695,0.0,0.0
49455,4,9455,[318 427  79 588 216],716,5,38338,4.054357021996616,40.0,0.0
49456,4,9456,[222  95 546 100 153],796,4,38342,4.0543512741884316,0.0,20.0
49457,4,9457,[318 427  79 588 216],450,5,38347,4.054451258194121,40.0,0.0
49458,4,9458,[ 69 282 423 125 175],655,0,38347,4.054022623956021,0.0,0.0
49459,4,9459,[318 427  79 588 216],18,5,38352,4.054122621564482,40.0,0.0
49460,4,9460,[318 427  79 588 216],796,5,38357,4.054222598034034,40.0,0.0
49461,4,9461,[172  50  12 546 143],693,2,38359,4.054005495666878,0.0,20.0
49462,4,9462,[200 742 196 195  50],457,5,38364,4.054105463383705,0.0,20.0
49463,4,9463,[318 427  79 588 216],450,5,38369,4.0542054099746405,40.0,0.0
49464,4,9464,[318 427  79 588 216],18,5,38374,4.054305335446381,40.0,0.0
49465,4,9465,[403 313 111 161 127],655,2,38376,4.054088316078597,0.0,20.0
49466,4,9466,[ 56 173 228 197 423],716,5,38381,4.054188232808704,0.0,0.0
49467,4,9467,[318 427  79 588 216],450,5,38386,4.054288128432615,40.0,0.0
49468,4,9468,[168   1 143 588 423],796,4,38390,4.054282395184286,0.0,0.0
49469,4,9469,[237 132 483 191  88],716,5,38395,4.054382259767688,0.0,0.0
49470,4,9470,[237 405 186 655 127],269,2,38397,4.054165346848274,0.0,20.0
49471,4,9471,[ 15   8 211 423 215],655,0,38397,4.053737331081081,0.0,0.0
49472,4,9472,[186 196 483 211 238],535,5,38402,4.053837221577114,0.0,0.0
49473,4,9473,[  8  82 153 508 257],655,0,38402,4.0534093308000845,0.0,0.0
49474,4,9474,[318 427  79 588 216],18,5,38407,4.053509234828496,40.0,0.0
49475,4,9475,[237 405 210 496  71],796,4,38411,4.05350358801182,20.0,0.0
49476,4,9476,[318 427  79 588 216],450,5,38416,4.053603461010868,40.0,0.0
49477,4,9477,[265 405 125 183 195],280,1,38417,4.053281282971091,0.0,0.0
49478,4,9478,[181  79 194 202 568],457,5,38422,4.053381158350037,0.0,0.0
49479,4,9479,[318 427  79 588 216],577,5,38427,4.053481012658228,40.0,0.0
49480,4,9480,[318 427  79 588 216],716,5,38432,4.053580845902331,40.0,0.0
49481,4,9481,[143 275  98 427   4],450,4,38436,4.053575195106518,20.0,20.0
49482,4,9482,[318 427  79 588 216],796,5,38441,4.053674997363704,40.0,0.0
49483,4,9483,[318 427  79 588 216],450,5,38446,4.053774778574441,40.0,0.0
49484,4,9484,[172 135  98 471 176],655,3,38449,4.053663679493938,0.0,0.0
49485,4,9485,[ 69  97 403 179 483],450,4,38453,4.053658022348724,0.0,0.0
49486,4,9486,[318 427  79 588 216],716,5,38458,4.053757773795721,40.0,0.0
49487,4,9487,[237 222  70 174 294],655,0,38458,4.053330522765599,0.0,0.0
49488,4,9488,[318 427  79 588 216],796,5,38463,4.053430287701549,40.0,0.0
49489,4,9489,[546  56 496 318 187],450,5,38468,4.053530031612223,40.0,0.0
49490,4,9490,[313 238 385 174 135],655,2,38470,4.053313665577916,0.0,0.0
49491,4,9491,[318 427  79 588 216],796,5,38475,4.053413400758534,40.0,0.0
49492,4,9492,[ 69 302 117  97  96],655,1,38476,4.053091751817129,0.0,0.0
49493,4,9493,[318 427  79 588 216],716,5,38481,4.053191489361702,40.0,0.0
49494,4,9494,[143 195  64 196 135],655,3,38484,4.053080568720379,20.0,0.0
49495,4,9495,[ 15 121 546  71 597],450,2,38486,4.052864363942713,0.0,0.0
49496,4,9496,[ 98  70 333 186  79],655,2,38488,4.05264820469622,0.0,0.0
49497,4,9497,[318 427  79 588 216],450,5,38493,4.052747946936197,40.0,0.0
49498,4,9498,[318 427  79 588 216],450,5,38498,4.052847668175597,40.0,0.0
49499,4,9499,[318 427  79 588 216],450,5,38503,4.052947368421052,40.0,0.0
49500,4,9500,[318 427  79 588 216],716,5,38508,4.0530470476791916,40.0,0.0
49501,4,9501,[435   7  64 300 197],535,4,38512,4.053041464954746,20.0,0.0
49502,4,9502,[427 175 546  89 357],23,3,38515,4.0529306534778495,20.0,0.0
49503,4,9503,[181 182 185 176 258],796,5,38520,4.053030303030303,0.0,0.0
49504,4,9504,[318 427  79 588 216],577,5,38525,4.053129931614939,40.0,0.0
49505,4,9505,[ 79 186 194  69 202],18,2,38527,4.052913949084789,0.0,0.0
49506,4,9506,[125 182  56 275 143],450,5,38532,4.053013568949195,0.0,20.0
49507,4,9507,[496 143  70 194 195],716,4,38536,4.053007993268826,20.0,0.0
49508,4,9508,[ 79  64 174 237 427],535,4,38540,4.0530024187611735,40.0,0.0
49509,4,9509,[ 96 172 100  28 427],72,4,38544,4.052996845425867,20.0,20.0
49510,4,9510,[318 427  79 588 216],18,5,38549,4.053096414677742,40.0,0.0
49511,4,9511,[ 11 191 568 197 222],655,1,38550,4.052775441547519,0.0,0.0
49512,4,9512,[197 300  22 195 161],796,4,38554,4.052769893829496,0.0,0.0
49513,4,9513,[318 427  79 588 216],577,5,38559,4.052869455539206,40.0,0.0
49514,4,9514,[318 427  79 588 216],796,5,38564,4.052968996321598,40.0,0.0
49515,4,9515,[135  98 515  70 275],18,4,38568,4.0529634300126105,0.0,20.0
49516,4,9516,[318 427  79 588 216],716,5,38573,4.053062940002102,40.0,0.0
49517,4,9517,[185 127 194 228   8],796,5,38578,4.05316242908174,0.0,20.0
49518,4,9518,[ 82  69 161 135 143],269,1,38579,4.052841685050951,0.0,0.0
49519,4,9519,[185 186 357 161 183],693,2,38581,4.052626050420168,0.0,0.0
49520,4,9520,[318 427  79 588 216],716,5,38586,4.0527255540384415,40.0,0.0
49521,4,9521,[286 125 216 238 143],655,2,38588,4.05250997689561,0.0,20.0
49522,4,9522,[318 427  79 588 216],716,5,38593,4.052609471805104,40.0,0.0
49523,4,9523,[132 748  11 588 197],450,5,38598,4.052708945821084,0.0,0.0
49524,4,9524,[318 427  79 588 216],716,5,38603,4.052808398950131,40.0,0.0
49525,4,9525,[318 427  79 588 216],450,5,38608,4.052907831198825,40.0,0.0
49526,4,9526,[300 228 196 187 143],796,5,38613,4.053007242573738,0.0,0.0
49527,4,9527,[318 427  79 588 216],577,5,38618,4.053106633081444,40.0,0.0
49528,4,9528,[143 153 174 185 302],401,3,38621,4.052996117116171,0.0,0.0
49529,4,9529,[318 427  79 588 216],796,5,38626,4.053095487932843,40.0,0.0
49530,4,9530,[655 200 435 228 168],151,4,38630,4.05308991711258,0.0,0.0
49531,4,9531,[318 427  79 588 216],450,5,38635,4.053189257238775,40.0,0.0
49532,4,9532,[318 427  79 588 216],716,5,38640,4.053288576523655,40.0,0.0
49533,4,9533,[655 568   9 318 228],72,4,38644,4.053282987203692,20.0,0.0
49534,4,9534,[318 427  79 588 216],577,5,38649,4.053382275825904,40.0,0.0
49535,4,9535,[276 153 168  22  11],535,3,38652,4.053271812080537,0.0,0.0
49536,4,9536,[ 15 180 222 271 403],796,4,38656,4.053266226276607,0.0,0.0
49537,4,9537,[238  70 235 204 215],450,4,38660,4.05326064164395,0.0,0.0
49538,4,9538,[175 228 238 234 265],716,4,38664,4.0532550581821996,0.0,0.0
49539,4,9539,[  1 302 176 200 173],450,4,38668,4.053249475890985,0.0,0.0
49540,4,9540,[318 427  79 588 216],577,5,38673,4.053348705586417,40.0,0.0
49541,4,9541,[275 238   7 471  56],457,5,38678,4.053447914483336,0.0,20.0
49542,4,9542,[176 235 151  56   4],450,3,38681,4.053337524887352,0.0,0.0
49543,4,9543,[237 125 276 100 174],786,4,38685,4.053331936295055,0.0,20.0
49544,4,9544,[294 210 151 172 234],577,3,38688,4.053221581980094,0.0,0.0
49545,4,9545,[195 655 275   1 153],535,4,38692,4.053216006704379,0.0,20.0
49546,4,9546,[318 427  79 588 216],18,5,38697,4.053315177542683,40.0,0.0
49547,4,9547,[318 427  79 588 216],450,5,38702,4.053414327607876,40.0,0.0
49548,4,9548,[135  97  79 588 191],457,5,38707,4.053513456906482,0.0,0.0
49549,4,9549,[318 427  79 588 216],18,5,38712,4.053612565445026,40.0,0.0
49550,4,9550,[  7 286 328  89  50],450,5,38717,4.053711653230028,0.0,40.0
49551,4,9551,[151 127  11  95 153],450,4,38721,4.053706030150754,0.0,20.0
49552,4,9552,[318 427  79 588 216],577,5,38726,4.053805087407097,40.0,0.0
49553,4,9553,[200  88 282 275 180],457,5,38731,4.0539041239271505,0.0,20.0
49554,4,9554,[318 427  79 588 216],796,5,38736,4.054003139717426,40.0,0.0
49555,4,9555,[210   4   9 181 202],796,3,38739,4.053892842193386,0.0,0.0
49556,4,9556,[  4 546 121 275 196],786,4,38743,4.053887203097206,0.0,20.0
49557,4,9557,[216 121  70 176 179],655,2,38745,4.053672316384181,0.0,0.0
49558,4,9558,[588  25 237 118 471],577,3,38748,4.053562088084528,0.0,0.0
49559,4,9559,[318 427  79 588 216],450,5,38753,4.053661087866109,40.0,0.0
49560,4,9560,[118 216 183 234  15],796,4,38757,4.053655475368685,0.0,0.0
49561,4,9561,[237 182 174 483 183],269,2,38759,4.053440702781844,0.0,0.0
49562,4,9562,[174  22 168 265  50],457,5,38764,4.053539684199519,0.0,20.0
49563,4,9563,[127 194  97 176  79],450,5,38769,4.053638644918444,0.0,20.0
49564,4,9564,[175 204 300 210  70],655,0,38769,4.05321484579195,0.0,0.0
49565,4,9565,[318 427  79 588 216],450,5,38774,4.053313819778381,40.0,0.0
49566,4,9566,[318 427  79 588 216],450,5,38779,4.0534127730741085,40.0,0.0
49567,4,9567,[269 275 200 318 603],450,4,38783,4.053407190635451,40.0,20.0
49568,4,9568,[275 111  71 515 405],401,3,38786,4.053297105235657,0.0,20.0
49569,4,9569,[678 742 269 125   1],15,2,38788,4.053082549634274,0.0,0.0
49570,4,9570,[144 435 403 302 258],450,5,38793,4.053181485738167,0.0,0.0
49571,4,9571,[269 181 257 238 515],655,1,38794,4.052862515670706,0.0,0.0
49572,4,9572,[318 427  79 588 216],796,5,38799,4.052961454089627,40.0,0.0
49573,4,9573,[121  12 257 211 228],796,4,38803,4.052955922289534,0.0,0.0
49574,4,9574,[546 181   4 194  15],577,3,38806,4.052845953002611,0.0,0.0
49575,4,9575,[265 328 168 153 245],450,5,38811,4.052944862155388,0.0,0.0
49576,4,9576,[318 427  79 588 216],18,5,38816,4.053043750652606,40.0,0.0
49577,4,9577,[318 427  79 588 216],577,5,38821,4.053142618500731,40.0,0.0
49578,4,9578,[318 427  79 588 216],716,5,38826,4.053241465706233,40.0,0.0
49579,4,9579,[318 427  79 588 216],796,5,38831,4.053340292275574,40.0,0.0
49580,4,9580,[174 742 237 302  79],655,2,38833,4.0531259784991125,0.0,0.0
49581,4,9581,[318 427  79 588 216],18,5,38838,4.053224796493425,40.0,0.0
49582,4,9582,[318 427  79 588 216],577,5,38843,4.0533235938641345,40.0,0.0
49583,4,9583,[318 427  79 588 216],796,5,38848,4.053422370617696,40.0,0.0
49584,4,9584,[196 222 471 275 234],457,5,38853,4.053521126760564,0.0,20.0
49585,4,9585,[118  56  69  97 471],716,3,38856,4.053411224702692,0.0,0.0
49586,4,9586,[ 28 313 215 655 111],655,1,38857,4.053092729738188,0.0,0.0
49587,4,9587,[318 427  79 588 216],577,5,38862,4.053191489361702,40.0,0.0
49588,4,9588,[318 427  79 588 216],796,5,38867,4.053290228386693,40.0,0.0
49589,4,9589,[176 483 546 191  96],457,4,38871,4.053284671532847,0.0,0.0
49590,4,9590,[597 234   9 151 588],796,3,38874,4.0531748514232095,0.0,0.0
49591,4,9591,[318 427  79 588 216],577,5,38879,4.053273561301085,40.0,0.0
49592,4,9592,[318 427  79 588 216],716,5,38884,4.053372250599395,40.0,0.0
49593,4,9593,[318 427  79 588 216],18,5,38889,4.053470919324578,40.0,0.0
49594,4,9594,[ 69 588 117  50 196],450,5,38894,4.0535695674830645,0.0,20.0
49595,4,9595,[318 427  79 588 216],18,5,38899,4.053668195081284,40.0,0.0
49596,4,9596,[318 427  79 588 216],577,5,38904,4.053766802125664,40.0,0.0
49597,4,9597,[603  71 435 179  88],389,4,38908,4.053761200250052,20.0,0.0
49598,4,9598,[318 427  79 588 216],796,5,38913,4.053859777060111,40.0,0.0
49599,4,9599,[318 427  79 588 216],716,5,38918,4.053958333333333,40.0,0.0
49600,4,9600,[ 79 597 186 172 235],450,3,38921,4.053848557441933,0.0,0.0
49601,4,9601,[ 15 132 655 403 121],796,4,38925,4.053842949385545,0.0,0.0
49602,4,9602,[318 427  79 588 216],796,5,38930,4.053941476621889,40.0,0.0
49603,4,9603,[318 427  79 588 216],716,5,38935,4.0540399833402745,40.0,0.0
49604,4,9604,[204   8 483 318  95],796,5,38940,4.0541384695471105,20.0,0.0
49605,4,9605,[423 121 151 268 238],535,4,38944,4.054132833645638,0.0,0.0
49606,4,9606,[ 71 176   9 603 234],756,2,38946,4.0539190173831585,20.0,0.0
49607,4,9607,[318 427  79 588 216],796,5,38951,4.054017485428809,40.0,0.0
49608,4,9608,[427 194 211 302 216],269,3,38954,4.053907794775731,20.0,0.0
49609,4,9609,[ 12 118  69  79 181],655,1,38955,4.053590010405827,0.0,0.0
49610,4,9610,[318 427  79 588 216],577,5,38960,4.053688481947768,40.0,0.0
49611,4,9611,[318 427  79 588 216],716,5,38965,4.053786933000416,40.0,0.0
49612,4,9612,[222 195  82 748 100],796,3,38968,4.053677311973369,0.0,20.0
49613,4,9613,[318 427  79 588 216],716,5,38973,4.053775743707094,40.0,0.0
49614,4,9614,[216  79  64 181 294],716,5,38978,4.0538741549661985,20.0,0.0
49615,4,9615,[228 151 195 216  12],457,5,38983,4.053972545757071,0.0,0.0
49616,4,9616,[318 427  79 588 216],716,5,38988,4.054070916086098,40.0,0.0
49617,4,9617,[403 302 204 132 237],269,1,38989,4.05375337908089,0.0,0.0
49618,4,9618,[216 546  71  98 568],280,4,38993,4.053747790830648,0.0,0.0
49619,4,9619,[265 588  82 172 197],786,4,38997,4.053742203742204,0.0,0.0
49620,4,9620,[286 168 483 427 200],18,3,39000,4.053632678515747,20.0,20.0
49621,4,9621,[496  11 168 603 258],450,5,39005,4.053731033049262,40.0,0.0
49622,4,9622,[313 508  88 181  11],693,2,39007,4.053517614049673,0.0,0.0
49623,4,9623,[196  50 357 235 161],716,3,39010,4.053408146300915,0.0,20.0
49624,4,9624,[172 333 180 186 546],796,3,39013,4.053298701298702,0.0,0.0
49625,4,9625,[174 186  56 182  98],796,4,39017,4.053293164346561,0.0,0.0
49626,4,9626,[318 427  79 588 216],450,5,39022,4.053391503064298,40.0,0.0
49627,4,9627,[318 427  79 588 216],18,5,39027,4.053489821354383,40.0,0.0
49628,4,9628,[588  12 286 748  69],450,5,39032,4.05358811922318,0.0,20.0
49629,4,9629,[153  89 222 257 173],23,4,39036,4.053582554517134,0.0,0.0
49630,4,9630,[318 427  79 588 216],450,5,39041,4.053680822344512,40.0,0.0
49631,4,9631,[  4 423  28 294  88],796,3,39044,4.053571428571429,0.0,0.0
49632,4,9632,[ 64  97 151 245  98],256,5,39049,4.053669677151459,20.0,0.0
49633,4,9633,[588 121 245  88 181],344,1,39050,4.053352709155075,0.0,0.0
49634,4,9634,[318 427  79 588 216],18,5,39055,4.053450960041515,40.0,0.0
49635,4,9635,[318 427  79 588 216],450,5,39060,4.053549190535492,40.0,0.0
49636,4,9636,[172 357 125  89 185],457,5,39065,4.053647400643354,0.0,0.0
49637,4,9637,[318 427  79 588 216],716,5,39070,4.053745590371446,40.0,0.0
49638,4,9638,[  9 427 174 300  96],796,4,39074,4.053740014524328,20.0,0.0
49639,4,9639,[234  71 235 100 173],450,2,39076,4.053526970954357,0.0,20.0
49640,4,9640,[546 471  25 276  79],593,1,39077,4.053210247899595,0.0,0.0
49641,4,9641,[427 357 300 195 174],908,2,39079,4.052997303464012,20.0,0.0
49642,4,9642,[318 427  79 588 216],577,5,39084,4.053095509696153,40.0,0.0
49643,4,9643,[288 286 121  71  79],593,5,39089,4.053193695562007,0.0,20.0
49644,4,9644,[318 427  79 588 216],796,5,39094,4.053291861067911,40.0,0.0
49645,4,9645,[483 357 172 127   9],296,5,39099,4.053390006220195,0.0,20.0
49646,4,9646,[125 655  82 322 191],796,2,39101,4.053177153519229,0.0,0.0
49647,4,9647,[ 64 234  71  56 471],450,3,39104,4.053067993366501,20.0,0.0
49648,4,9648,[235 276  15 202  79],256,2,39106,4.052855218157322,0.0,0.0
49649,4,9649,[301 176  56 125 204],151,4,39110,4.0528497409326425,0.0,0.0
49650,4,9650,[318 427  79 588 216],716,5,39115,4.052947881048596,40.0,0.0
49651,4,9651,[318 427  79 588 216],577,5,39120,4.053046000828844,40.0,0.0
49652,4,9652,[269 294 318 423 515],655,2,39122,4.052833316067543,20.0,0.0
49653,4,9653,[318 427  79 588 216],450,5,39127,4.052931427387612,40.0,0.0
49654,4,9654,[118 151  95 286 172],344,3,39130,4.052822371828069,0.0,20.0
49655,4,9655,[185  50 202 423 179],18,3,39133,4.05271333885667,0.0,20.0
49656,4,9656,[186 423 471 568 202],457,5,39138,4.052811432121777,0.0,0.0
49657,4,9657,[288 322 172 435 185],450,4,39142,4.052805963967695,0.0,0.0
49658,4,9658,[194 121  15 181 568],577,3,39145,4.052696966559686,0.0,0.0
49659,4,9659,[228 117 333 181 172],693,1,39146,4.052380952380952,0.0,0.0
49660,4,9660,[318 427  79 588 216],796,5,39151,4.0524790394369115,40.0,0.0
49661,4,9661,[318 427  79 588 216],796,5,39156,4.052577106189195,40.0,0.0
49662,4,9662,[ 69 597 568 121 172],796,5,39161,4.052675152644106,0.0,0.0
49663,4,9663,[318 427  79 588 216],796,5,39166,4.052773178807947,40.0,0.0
49664,4,9664,[318 427  79 588 216],716,5,39171,4.052871184687015,40.0,0.0
49665,4,9665,[ 70  28 100 403  69],330,5,39176,4.052969170287606,0.0,20.0
49666,4,9666,[  1   4 161 322 276],280,4,39180,4.05296369090721,0.0,0.0
49667,4,9667,[237 215  96  69 405],344,1,39181,4.052647910633016,0.0,0.0
49668,4,9668,[300 183   7 185 655],151,4,39185,4.052642465611749,0.0,0.0
49669,4,9669,[318 427  79 588 216],18,5,39190,4.052740434332988,40.0,0.0
49670,4,9670,[471 301 245 288 174],450,4,39194,4.052734980870644,0.0,0.0
49671,4,9671,[385 144 222 257  89],5,4,39198,4.052729528535981,0.0,0.0
49672,4,9672,[194 204 135 191 313],236,2,39200,4.052517316241083,0.0,0.0
49673,4,9673,[318 427  79 588 216],716,5,39205,4.052615257390944,40.0,0.0
49674,4,9674,[286 275 191 271  56],629,4,39209,4.0526098191214475,0.0,40.0
49675,4,9675,[318 427  79 588 216],450,5,39214,4.0527077304671355,40.0,0.0
49676,4,9676,[318 427  79 588 216],577,5,39219,4.052805621576935,40.0,0.0
49677,4,9677,[ 50 100 385  22   4],450,4,39223,4.052800165323414,0.0,40.0
49678,4,9678,[318 427  79 588 216],796,5,39228,4.0528980266556465,40.0,0.0
49679,4,9679,[318 427  79 588 216],716,5,39233,4.052995867768595,40.0,0.0
49680,4,9680,[742  69 153 191   8],655,1,39234,4.052680508211962,0.0,0.0
49681,4,9681,[318 427  79 588 216],577,5,39239,4.052778351580252,40.0,0.0
49682,4,9682,[318 427  79 588 216],577,5,39244,4.052876174739234,40.0,0.0
49683,4,9683,[202 258 742 194  89],796,4,39248,4.052870714580751,0.0,0.0
49684,4,9684,[318 427  79 588 216],450,5,39253,4.052968508002065,40.0,0.0
49685,4,9685,[318 427  79 588 216],450,5,39258,4.053066281230642,40.0,0.0
49686,4,9686,[318 427  79 588 216],577,5,39263,4.053164034272736,40.0,0.0
49687,4,9687,[ 64 228  95  88 508],344,4,39267,4.053158546655657,20.0,0.0
49688,4,9688,[127 195 191  22 200],269,3,39270,4.053049850345753,0.0,20.0
49689,4,9689,[496 196 483 168  98],535,4,39274,4.053044375644995,20.0,0.0
49690,4,9690,[333  79 655 508  25],693,2,39276,4.052832525023217,0.0,0.0
49691,4,9691,[ 50 210  71 118  96],756,3,39279,4.0527238959966985,0.0,20.0
49692,4,9692,[202 186  79 118 403],457,5,39284,4.052821623852265,0.0,0.0
49693,4,9693,[318 427  79 588 216],450,5,39289,4.052919331545286,40.0,0.0
49694,4,9694,[ 79 196 143  89 471],450,5,39294,4.053017019082001,0.0,0.0
49695,4,9695,[318 427  79 588 216],577,5,39299,4.053114686468647,40.0,0.0
49696,4,9696,[427 742   1 322 282],796,2,39301,4.052902959678251,20.0,0.0
49697,4,9697,[180  64  11 181 111],269,1,39302,4.052588162507734,20.0,0.0
49698,4,9698,[ 79 471 301  11   9],655,1,39303,4.052273430250541,0.0,0.0
49699,4,9699,[  1 132 655 228 496],577,4,39307,4.052268041237113,20.0,0.0
49700,4,9700,[546 181 125  12 117],256,5,39312,4.052365735491186,0.0,0.0
49701,4,9701,[216 405 118 288 269],344,3,39315,4.052257266542981,0.0,0.0
49702,4,9702,[ 64 275  95 313 200],450,3,39318,4.052148819952592,20.0,20.0
49703,4,9703,[269 275 301 153 288],450,4,39322,4.052143446001649,0.0,20.0
49704,4,9704,[427 181 483 603 186],535,5,39327,4.052241112828439,40.0,0.0
49705,4,9705,[216  95  71 179 191],786,5,39332,4.052338759530188,0.0,0.0
49706,4,9706,[318 427  79 588 216],18,5,39337,4.052436386113114,40.0,0.0
49707,4,9707,[318 427  79 588 216],577,5,39342,4.052533992583436,40.0,0.0
49708,4,9708,[ 28 237 603 211  56],655,1,39343,4.0522195900710685,20.0,0.0
49709,4,9709,[ 50 301 288   7 222],79,3,39346,4.0521112255406795,0.0,20.0
49710,4,9710,[318 427  79 588 216],577,5,39351,4.052208835341365,40.0,0.0
49711,4,9711,[  9 423  12 405  50],655,1,39352,4.051894563426688,0.0,20.0
49712,4,9712,[265 196   1 245 125],450,5,39357,4.051992175434984,0.0,0.0
49713,4,9713,[515 222 187 191 228],655,3,39360,4.051883878937616,0.0,0.0
49714,4,9714,[318 427  79 588 216],716,5,39365,4.051981471950592,40.0,0.0
49715,4,9715,[ 64 100  12  50 237],450,5,39370,4.052079044874434,20.0,40.0
49716,4,9716,[318 427  79 588 216],577,5,39375,4.052176597715344,40.0,0.0
49717,4,9717,[508 144 496 215 100],535,4,39379,4.05217122864787,20.0,20.0
49718,4,9718,[181 286 318 180 655],535,4,39383,4.052165860685256,20.0,20.0
49719,4,9719,[ 70 202 678 471 215],344,1,39384,4.051851851851852,0.0,0.0
49720,4,9720,[318 427  79 588 216],18,5,39389,4.051949387923053,40.0,0.0
49721,4,9721,[ 12 222 294 176  89],457,4,39393,4.051944044435301,0.0,0.0
49722,4,9722,[228 196 185 195 655],796,4,39397,4.0519387020466935,0.0,0.0
49723,4,9723,[318 427  79 588 216],577,5,39402,4.052036199095022,40.0,0.0
49724,4,9724,[318 427  79 588 216],577,5,39407,4.052133676092545,40.0,0.0
49725,4,9725,[ 69  71 200 143 423],330,5,39412,4.052231133045445,0.0,0.0
49726,4,9726,[117 197 174  96 568],796,4,39416,4.052225763339159,0.0,0.0
49727,4,9727,[318 427  79 588 216],450,5,39421,4.0523231907894735,40.0,0.0
49728,4,9728,[318 427  79 588 216],716,5,39426,4.052420598211532,40.0,0.0
49729,4,9729,[423   4  25  98 173],535,3,39429,4.052312435765673,0.0,0.0
49730,4,9730,[318 427  79 588 216],18,5,39434,4.052409824272942,40.0,0.0
49731,4,9731,[423 194 328  64 211],236,3,39437,4.052301685162351,20.0,0.0
49732,4,9732,[568 186 182  11  69],457,5,39442,4.05239905476215,0.0,0.0
49733,4,9733,[202 121 423 100  25],330,5,39447,4.052496404355866,0.0,20.0
49734,4,9734,[318 427  79 588 216],577,5,39452,4.052593733949666,40.0,0.0
49735,4,9735,[318 427  79 588 216],577,5,39457,4.0526910435497125,40.0,0.0
49736,4,9736,[318 427  79 588 216],450,5,39462,4.052788333162165,40.0,0.0
49737,4,9737,[ 97  82  79 196 185],151,4,39466,4.0527829123023205,0.0,0.0
49738,4,9738,[318 427  79 588 216],716,5,39471,4.05288017250231,40.0,0.0
49739,4,9739,[ 98  56 385 276 300],504,3,39474,4.052772073921972,0.0,0.0
49740,4,9740,[ 69 173 483 118 515],716,4,39478,4.05276665640078,0.0,0.0
49741,4,9741,[318 427  79 588 216],450,5,39483,4.052863888318621,40.0,0.0
49742,4,9742,[318 427  79 588 216],577,5,39488,4.052961100277122,40.0,0.0
49743,4,9743,[204 269 211  56  28],655,0,39488,4.052545155993432,0.0,0.0
49744,4,9744,[423 180 202 191   7],269,2,39490,4.052334530528476,0.0,0.0
49745,4,9745,[318 427  79 588 216],18,5,39495,4.052431766878719,40.0,0.0
49746,4,9746,[222  50 238  69 183],450,4,39499,4.052426387606443,0.0,20.0
49747,4,9747,[282 238 187  97 265],450,5,39504,4.052523594583504,0.0,0.0
49748,4,9748,[182 161 546  56 603],796,5,39509,4.052620781618628,20.0,0.0
49749,4,9749,[318 427  79 588 216],577,5,39514,4.052717948717949,40.0,0.0
49750,4,9750,[318 427  79 588 216],796,5,39519,4.052815095887602,40.0,0.0
49751,4,9751,[318 427  79 588 216],716,5,39524,4.052912223133716,40.0,0.0
49752,4,9752,[318 427  79 588 216],450,5,39529,4.053009330462422,40.0,0.0
49753,4,9753,[357 257 125 655 234],504,4,39533,4.053003895837605,0.0,0.0
49754,4,9754,[475   8 403 144 200],655,1,39534,4.05269092772937,0.0,0.0
49755,4,9755,[302 185 210 143   7],151,4,39538,4.052685526855268,0.0,0.0
49756,4,9756,[294  95 118 187 483],450,2,39540,4.05247514604899,0.0,0.0
49757,4,9757,[168 508 195 174 197],269,3,39543,4.0523672883787665,0.0,0.0
49758,4,9758,[318 427  79 588 216],577,5,39548,4.052464391843427,40.0,0.0
49759,4,9759,[318 427  79 588 216],450,5,39553,4.052561475409836,40.0,0.0
49760,4,9760,[117 238 144 301 427],796,3,39556,4.052453642044872,20.0,0.0
49761,4,9761,[318 427  79 588 216],796,5,39561,4.052550706822372,40.0,0.0
49762,4,9762,[174 546 179 301 742],450,5,39566,4.052647751715662,0.0,0.0
49763,4,9763,[318 427  79 588 216],796,5,39571,4.052744776730848,40.0,0.0
49764,4,9764,[318 427  79 588 216],450,5,39576,4.05284178187404,40.0,0.0
49765,4,9765,[318 427  79 588 216],716,5,39581,4.052938767151342,40.0,0.0
49766,4,9766,[318 427  79 588 216],796,5,39586,4.053035732568854,40.0,0.0
49767,4,9767,[318 427  79 588 216],577,5,39591,4.053132678132678,40.0,0.0
49768,4,9768,[ 79  88 186  22 238],450,4,39595,4.053127239226123,0.0,0.0
49769,4,9769,[318 427  79 588 216],716,5,39600,4.053224155578301,40.0,0.0
49770,4,9770,[508 268 222  25 204],11,2,39602,4.053014021082796,0.0,0.0
49771,4,9771,[318 427  79 588 216],796,5,39607,4.0531109291854275,40.0,0.0
49772,4,9772,[202 121 318 215  89],655,2,39609,4.0529008492786245,20.0,0.0
49773,4,9773,[121 435 742 181  96],756,2,39611,4.05269081235932,0.0,0.0
49774,4,9774,[322 172 186 176 546],450,4,39615,4.052685421994885,0.0,0.0
49775,4,9775,[496 151  95  97  70],344,3,39618,4.052577741407529,20.0,0.0
49776,4,9776,[235  89   7 313  98],344,3,39621,4.052470082847499,0.0,0.0
49777,4,9777,[318 427  79 588 216],577,5,39626,4.052566987113929,40.0,0.0
49778,4,9778,[175  11 403 423 405],655,0,39626,4.0521525718376115,0.0,0.0
49779,4,9779,[318 427  79 588 216],577,5,39631,4.052249488752556,40.0,0.0
49780,4,9780,[318 427  79 588 216],796,5,39636,4.052346385850117,40.0,0.0
49781,4,9781,[237 678 172  89  56],256,3,39639,4.052238805970149,0.0,0.0
49782,4,9782,[181 237   1  25 313],593,3,39642,4.05213124808341,0.0,0.0
49783,4,9783,[ 15  97   1 275 118],798,4,39646,4.052125919869174,0.0,20.0
49784,4,9784,[181 234 216 238   4],786,4,39650,4.052120592743996,0.0,0.0
49785,4,9785,[ 89 121  22 153  25],450,3,39653,4.0520130799100755,0.0,0.0
49786,4,9786,[318 427  79 588 216],18,5,39658,4.052109941759477,40.0,0.0
49787,4,9787,[405 111 168  12 288],450,4,39662,4.052104617899468,0.0,0.0
49788,4,9788,[318 427  79 588 216],18,5,39667,4.052201450607825,40.0,0.0
49789,4,9789,[238  70 204 288 568],593,5,39672,4.052298263534219,0.0,0.0
49790,4,9790,[234  56 135 118 111],457,4,39676,4.05229292207129,0.0,0.0
49791,4,9791,[318 427  79 588 216],450,5,39681,4.052389705882353,40.0,0.0
49792,4,9792,[143 204 161 173 237],593,5,39686,4.0524864699275,0.0,0.0
49793,4,9793,[318 427  79 588 216],716,5,39691,4.052583214212784,40.0,0.0
49794,4,9794,[318 427  79 588 216],450,5,39696,4.052679938744257,40.0,0.0
49795,4,9795,[ 69 237 294 423  15],224,4,39700,4.0526745610453245,0.0,0.0
49796,4,9796,[318 427  79 588 216],450,5,39705,4.052771256507094,40.0,0.0
49797,4,9797,[318 427  79 588 216],577,5,39710,4.0528679322310674,40.0,0.0
49798,4,9798,[196 546  15 202 176],577,3,39713,4.052760485763853,0.0,0.0
49799,4,9799,[318 427  79 588 216],577,5,39718,4.0528571428571425,40.0,0.0
49800,4,9800,[301 275 603 318 245],450,5,39723,4.052953780226508,40.0,20.0
49801,4,9801,[318 427  79 588 216],18,5,39728,4.053050397877984,40.0,0.0
49802,4,9802,[318 427  79 588 216],716,5,39733,4.053146995817607,40.0,0.0
49803,4,9803,[176 197 546 282 183],693,1,39734,4.052835577315381,0.0,0.0
49804,4,9804,[258 294  82 100 180],450,4,39738,4.052830188679246,0.0,20.0
49805,4,9805,[144 546 210  96 333],796,4,39742,4.052824801142158,0.0,0.0
49806,4,9806,[187  69 185  12  25],503,4,39746,4.052819414703783,0.0,0.0
49807,4,9807,[318 427  79 588 216],18,5,39751,4.052915986949429,40.0,0.0
49808,4,9808,[  1 286 588 234  28],450,4,39755,4.052910592313181,0.0,20.0
49809,4,9809,[318 427  79 588 216],450,5,39760,4.0530071355759425,40.0,0.0
49810,4,9810,[258 191 186 118 427],151,3,39763,4.0528998063398225,20.0,0.0
49811,4,9811,[174 273  96 161 405],796,4,39767,4.052894415002038,0.0,0.0
49812,4,9812,[318 427  79 588 216],577,5,39772,4.052990930398451,40.0,0.0
49813,4,9813,[318 427  79 588 216],18,5,39777,4.053087426125942,40.0,0.0
49814,4,9814,[ 96 301  98 191 508],344,5,39782,4.053183902190525,0.0,0.0
49815,4,9815,[216 427 748  69 742],450,5,39787,4.053280358598207,20.0,0.0
49816,4,9816,[357 211 125 655   1],593,3,39790,4.0531730671284505,0.0,0.0
49817,4,9817,[318 427  79 588 216],450,5,39795,4.053269504990833,40.0,0.0
49818,4,9818,[187 435 121  79   1],450,4,39799,4.053264079845198,0.0,0.0
49819,4,9819,[318 194 748 423 546],450,5,39804,4.05336048879837,20.0,0.0
49820,4,9820,[318 427  79 588 216],18,5,39809,4.053456878118318,40.0,0.0
49821,4,9821,[ 96   8 127 496 276],269,3,39812,4.053349623294645,20.0,20.0
49822,4,9822,[655 125 568 172 313],450,5,39817,4.05344599409549,0.0,0.0
49823,4,9823,[318 427  79 588 216],450,5,39822,4.053542345276873,40.0,0.0
49824,4,9824,[ 56 194 127 496  12],450,5,39827,4.053638676844784,20.0,20.0
49825,4,9825,[111  56 655   7 153],629,4,39831,4.053633217993079,0.0,0.0
49826,4,9826,[125 202 275 204 118],344,3,39834,4.053525999796479,0.0,20.0
49827,4,9827,[183 265 181 742 258],457,5,39839,4.053622303622304,0.0,0.0
49828,4,9828,[200 238 483 143 435],655,3,39842,4.053515108352833,0.0,0.0
49829,4,9829,[195 210 127  98 427],450,4,39846,4.053509664292981,20.0,20.0
49830,4,9830,[289 269 748 300 328],410,1,39847,4.053199064184722,0.0,0.0
49831,4,9831,[318 427  79 588 216],18,5,39852,4.053295362082994,40.0,0.0
49832,4,9832,[ 70 185  69  11 276],655,2,39854,4.053086545306621,0.0,0.0
49833,4,9833,[168 268 603 151 172],535,3,39857,4.052979459019728,20.0,0.0
49834,4,9834,[483 191 294 211 210],236,2,39859,4.0527707168276565,0.0,0.0
49835,4,9835,[117 302 508 748 237],277,4,39863,4.052765351769012,0.0,0.0
49836,4,9836,[132 385 257  64 265],716,4,39867,4.052759987801159,20.0,0.0
49837,4,9837,[288 427  22  82  88],450,3,39870,4.052652978247611,20.0,0.0
49838,4,9838,[204  50 483  96 151],269,2,39872,4.052444354101026,0.0,20.0
49839,4,9839,[318 427  79 588 216],796,5,39877,4.052540650406504,40.0,0.0
49840,4,9840,[483 185 174 180 175],18,4,39881,4.052535311452088,0.0,0.0
49841,4,9841,[318 427  79 588 216],716,5,39886,4.052631578947368,40.0,0.0
49842,4,9842,[318 427  79 588 216],577,5,39891,4.052727826882048,40.0,0.0
49843,4,9843,[ 98  64 257 127 265],655,3,39894,4.052620885818773,20.0,20.0
49844,4,9844,[ 97 405  50 742 508],344,2,39896,4.052412392077197,0.0,20.0
49845,4,9845,[318 427  79 588 216],577,5,39901,4.05250863294739,40.0,0.0
49846,4,9846,[183  88   9  79 427],796,4,39905,4.052503300497613,20.0,0.0
49847,4,9847,[318 427  79 588 216],796,5,39910,4.052599512591389,40.0,0.0
49848,4,9848,[318 427  79 588 216],716,5,39915,4.05269570514773,40.0,0.0
49849,4,9849,[318 427  79 588 216],450,5,39920,4.052791878172589,40.0,0.0
49850,4,9850,[318 427  79 588 216],716,5,39925,4.052888031671912,40.0,0.0
49851,4,9851,[318 427  79 588 216],716,5,39930,4.052984165651645,40.0,0.0
49852,4,9852,[318 427  79 588 216],796,5,39935,4.05308028011773,40.0,0.0
49853,4,9853,[  9 427 182 271 237],655,2,39937,4.052871930180637,20.0,0.0
49854,4,9854,[318 427  79 588 216],796,5,39942,4.0529680365296805,40.0,0.0
49855,4,9855,[216 405 323  11  82],256,5,39947,4.053064123376624,0.0,0.0
49856,4,9856,[403  15 121 228 323],796,4,39951,4.053058739981739,0.0,0.0
49857,4,9857,[318 427  79 588 216],716,5,39956,4.053154798133495,40.0,0.0
49858,4,9858,[ 88 174  95 427  79],18,4,39960,4.0531494066335325,20.0,0.0
49859,4,9859,[151 427  15 403 515],269,3,39963,4.0530425963488845,20.0,0.0
49860,4,9860,[318 427  79 588 216],577,5,39968,4.053138626914106,40.0,0.0
49861,4,9861,[235 357 211 204 238],450,4,39972,4.0531332386939765,0.0,0.0
49862,4,9862,[245 234  22   4 127],256,5,39977,4.053229240596168,0.0,20.0
49863,4,9863,[ 64 222 235  88  50],344,3,39980,4.053122465531224,20.0,20.0
49864,4,9864,[318 427  79 588 216],18,5,39985,4.053218449062341,40.0,0.0
49865,4,9865,[318 427  79 588 216],577,5,39990,4.053314413136023,40.0,0.0
49866,4,9866,[471  28 328 275 475],655,1,39991,4.053004966048444,0.0,20.0
49867,4,9867,[234 172 276 286  70],593,3,39994,4.052898256992298,0.0,20.0
49868,4,9868,[318 427  79 588 216],577,5,39999,4.052994224338839,40.0,0.0
49869,4,9869,[318 427  79 588 216],716,5,40004,4.053090172239108,40.0,0.0
49870,4,9870,[235  98 228 282 173],457,4,40008,4.053084793840543,0.0,0.0
49871,4,9871,[204  56 196  96  28],796,4,40012,4.053079416531604,0.0,0.0
49872,4,9872,[318 427  79 588 216],577,5,40017,4.053175326648435,40.0,0.0
49873,4,9873,[318 427  79 588 216],18,5,40022,4.053271217338465,40.0,0.0
49874,4,9874,[161 483  97   9 403],655,1,40023,4.0529620253164556,0.0,0.0
49875,4,9875,[318 427  79 588 216],18,5,40028,4.0530579181855,40.0,0.0
49876,4,9876,[ 96 742 294 135  69],450,4,40032,4.053052546319733,0.0,0.0
49877,4,9877,[ 82  12  79 185 215],450,4,40036,4.053047175541607,0.0,0.0
49878,4,9878,[318 427  79 588 216],18,5,40041,4.05314303067112,40.0,0.0
49879,4,9879,[318 427  79 588 216],18,5,40046,4.053238866396761,40.0,0.0
49880,4,9880,[423 176 143 111 282],457,4,40050,4.053233478392875,0.0,0.0
49881,4,9881,[318 427  79 588 216],716,5,40055,4.053329285569723,40.0,0.0
49882,4,9882,[  1 174  98 427 204],835,3,40058,4.053222705656177,20.0,0.0
49883,4,9883,[318 427  79 588 216],18,5,40063,4.053318494536625,40.0,0.0
49884,4,9884,[318 427  79 588 216],577,5,40068,4.053414264036419,40.0,0.0
49885,4,9885,[127 182 286  98  97],503,3,40071,4.053307707869715,0.0,40.0
49886,4,9886,[318 427  79 588 216],716,5,40076,4.053403459087691,40.0,0.0
49887,4,9887,[318 427  79 588 216],577,5,40081,4.053499190938512,40.0,0.0
49888,4,9888,[ 11  56 210   8 127],280,4,40085,4.053493780968753,0.0,20.0
49889,4,9889,[318 427  79 588 216],18,5,40090,4.0535894843276035,40.0,0.0
49890,4,9890,[508   9   7 100 603],655,1,40091,4.05328076028713,20.0,20.0
49891,4,9891,[318 427  79 588 216],716,5,40096,4.053376465830975,40.0,0.0
49892,4,9892,[183  98 211 161 125],504,4,40100,4.053371070453856,0.0,0.0
49893,4,9893,[318 427  79 588 216],450,5,40105,4.053466747523752,40.0,0.0
49894,4,9894,[318 427  79 588 216],450,5,40110,4.053562405255179,40.0,0.0
49895,4,9895,[318 427  79 588 216],577,5,40115,4.053658043654002,40.0,0.0
49896,4,9896,[318 427  79 588 216],577,5,40120,4.053753662726079,40.0,0.0
49897,4,9897,[318 427  79 588 216],18,5,40125,4.053849262477268,40.0,0.0
49898,4,9898,[318 427  79 588 216],450,5,40130,4.053944842913426,40.0,0.0
49899,4,9899,[318 427  79 588 216],577,5,40135,4.054040404040404,40.0,0.0
49900,4,9900,[318 427  79 588 216],796,5,40140,4.054135945864054,40.0,0.0
49901,4,9901,[ 96  56 257 174 132],655,0,40140,4.053726519894971,0.0,0.0
49902,4,9902,[191 100 597 174 546],450,5,40145,4.053822074118954,0.0,20.0
49903,4,9903,[161 183 568 176 117],716,2,40147,4.053614701130856,0.0,0.0
49904,4,9904,[597  12 195 144 275],796,5,40152,4.053710247349823,0.0,20.0
49905,4,9905,[172 483  28 185  98],389,5,40157,4.053805774278215,0.0,0.0
49906,4,9906,[ 96 176  64 111   8],344,5,40162,4.053901281921873,20.0,0.0
49907,4,9907,[318 427  79 588 216],577,5,40167,4.053996770286637,40.0,0.0
49908,4,9908,[318 427  79 588 216],796,5,40172,4.054092239378343,40.0,0.0
49909,4,9909,[318 427  79 588 216],796,5,40177,4.054187689202825,40.0,0.0
49910,4,9910,[289 269 200 196 257],655,1,40178,4.053879527797397,0.0,0.0
49911,4,9911,[204  50  25 181  98],577,5,40183,4.053974979822438,0.0,20.0
49912,4,9912,[483 234 125  82  88],151,4,40187,4.053969534954101,0.0,0.0
49913,4,9913,[318 427  79 588 216],577,5,40192,4.054064958644341,40.0,0.0
49914,4,9914,[318 427  79 588 216],577,5,40197,4.054160363086233,40.0,0.0
49915,4,9915,[318 427  79 588 216],716,5,40202,4.054255748285599,40.0,0.0
49916,4,9916,[172 471 289 496   7],786,5,40207,4.05435111424826,20.0,0.0
49917,4,9917,[318 427  79 588 216],796,5,40212,4.054446460980036,40.0,0.0
49918,4,9918,[318 427  79 588 216],796,5,40217,4.054541788486743,40.0,0.0
49919,4,9919,[318 427  79 588 216],18,5,40222,4.054637096774194,40.0,0.0
49920,4,9920,[ 11  82 268 197 603],269,3,40225,4.0545307932668075,20.0,0.0
49921,4,9921,[318 427  79 588 216],716,5,40230,4.054626083450917,40.0,0.0
49922,4,9922,[318 427  79 588 216],577,5,40235,4.0547213544291045,40.0,0.0
49923,4,9923,[185  64 216 168   7],269,3,40238,4.054615074566707,20.0,0.0
49924,4,9924,[117 234 357 257 210],716,5,40243,4.054710327455919,0.0,0.0
49925,4,9925,[318 427  79 588 216],716,5,40248,4.054805561152529,40.0,0.0
49926,4,9926,[168 186 435 100 508],269,3,40251,4.054699304925959,0.0,20.0
49927,4,9927,[318 427  79 588 216],18,5,40256,4.054794520547945,40.0,0.0
49928,4,9928,[318 427  79 588 216],716,5,40261,4.054889716990633,40.0,0.0
49929,4,9929,[318 427  79 588 216],18,5,40266,4.054984894259818,40.0,0.0
49930,4,9930,[176 322 385 191 496],450,5,40271,4.055080052361293,20.0,0.0
49931,4,9931,[318 427  79 588 216],716,5,40276,4.055175191300846,40.0,0.0
49932,4,9932,[318 427  79 588 216],450,5,40281,4.055270311084264,40.0,0.0
49933,4,9933,[183 273  98  95 403],796,4,40285,4.0552647473323935,0.0,0.0
49934,4,9934,[ 96  69 655 211  15],655,0,40285,4.054856567689985,0.0,0.0
49935,4,9935,[318 427  79 588 216],18,5,40290,4.054951690821256,40.0,0.0
49936,4,9936,[318 427  79 588 216],716,5,40295,4.055046794807286,40.0,0.0
49937,4,9937,[318 427  79 588 216],577,5,40300,4.055141879653854,40.0,0.0
49938,4,9938,[ 50  98  70 174 200],269,2,40302,4.054935104135225,0.0,20.0
49939,4,9939,[318 427  79 588 216],577,5,40307,4.0550301810865195,40.0,0.0
49940,4,9940,[191 153  71 127 168],878,5,40312,4.055125238909566,0.0,20.0
49941,4,9941,[275 603 257 197 357],401,4,40316,4.055119694226514,20.0,20.0
49942,4,9942,[196  64  28  22   1],18,3,40319,4.055013577391129,20.0,0.0
49943,4,9943,[318 186 204 151 300],504,3,40322,4.054907481898632,20.0,0.0
49944,4,9944,[318 427  79 588 216],796,5,40327,4.055002513826043,40.0,0.0
49945,4,9945,[269 435 135 121  69],450,3,40330,4.0548964407802135,0.0,0.0
49946,4,9946,[ 22 483  15 475 427],269,3,40333,4.0547903890620285,20.0,0.0
49947,4,9947,[318 427  79 588 216],18,5,40338,4.054885404101327,40.0,0.0
49948,4,9948,[173   4 172 385 357],593,5,40343,4.054980400040205,0.0,0.0
49949,4,9949,[273  79 215 179 235],450,3,40346,4.054874371859296,0.0,0.0
49950,4,9950,[111 191 196  71 161],798,1,40347,4.054567380162798,0.0,0.0
49951,4,9951,[318 427  79 588 216],796,5,40352,4.054662379421222,40.0,0.0
49952,4,9952,[175 269 100 405 245],344,3,40355,4.054556415151211,0.0,20.0
49953,4,9953,[318 427  79 588 216],577,5,40360,4.054651396423548,40.0,0.0
49954,4,9954,[194 742 300 302  88],450,5,40365,4.0547463586137615,0.0,0.0
49955,4,9955,[ 98  69  56 275 200],151,4,40369,4.054740859783045,0.0,20.0
49956,4,9956,[ 50   4  97 228 172],716,4,40373,4.054735362056844,0.0,20.0
49957,4,9957,[ 28 234 496 405 427],807,4,40377,4.054729865434826,40.0,0.0
49958,4,9958,[204 403 268  88  89],269,1,40378,4.054423134852897,0.0,0.0
49959,4,9959,[471 245 197 185  12],450,5,40383,4.054518072289157,0.0,0.0
49960,4,9960,[318 427  79 588 216],716,5,40388,4.054612990663588,40.0,0.0
49961,4,9961,[318 427  79 588 216],450,5,40393,4.054707889981931,40.0,0.0
49962,4,9962,[318 427  79 588 216],450,5,40398,4.054802770249925,40.0,0.0
49963,4,9963,[181 135 191 405 546],151,2,40400,4.054596547571257,0.0,0.0
49964,4,9964,[318  82 546 288 210],504,5,40405,4.0546914199698945,20.0,0.0
49965,4,9965,[318 427  79 588 216],577,5,40410,4.05478627332932,40.0,0.0
49966,4,9966,[257  97 194 234 245],796,2,40412,4.054580114377446,0.0,0.0
49967,4,9967,[318 427  79 588 216],577,5,40417,4.054674959871589,40.0,0.0
49968,4,9968,[276 357  22  97  15],18,5,40422,4.054769786337647,0.0,0.0
49969,4,9969,[286 269  71  22 282],535,2,40424,4.05456369107322,0.0,20.0
49970,4,9970,[144 195   8 333 210],796,4,40428,4.054558218834621,0.0,0.0
49971,4,9971,[546 168  28 176 202],450,5,40433,4.054653028479743,0.0,0.0
49972,4,9972,[117 210  12 180  69],693,2,40435,4.05444700691868,0.0,0.0
49973,4,9973,[216   1   7 204 202],450,5,40440,4.054541808702627,0.0,0.0
49974,4,9974,[196  25 151 210 118],389,1,40441,4.054235588972431,0.0,0.0
49975,4,9975,[385 265 172 215 258],457,5,40446,4.054330392943063,0.0,0.0
49976,4,9976,[195  98 508 127 202],269,3,40449,4.054224716848752,0.0,20.0
49977,4,9977,[318 427  79 588 216],18,5,40454,4.054319502906394,40.0,0.0
49978,4,9978,[161 237  11 117 258],457,5,40459,4.054414269966931,0.0,0.0
49979,4,9979,[195 228 265 258 257],807,3,40462,4.054308617234469,0.0,0.0
49980,4,9980,[ 88 143 385  25  15],151,4,40466,4.054303176034465,0.0,0.0
49981,4,9981,[655 211 144   9 318],401,3,40469,4.05419755560008,20.0,0.0
49982,4,9982,[318 427  79 588 216],450,5,40474,4.054292296904738,40.0,0.0
49983,4,9983,[318 427  79 588 216],577,5,40479,4.054387019230769,40.0,0.0
49984,4,9984,[318 427  79 588 216],450,5,40484,4.054481722583875,40.0,0.0
49985,4,9985,[318 427  79 588 216],450,5,40489,4.054576406969757,40.0,0.0
49986,4,9986,[318 427  79 588 216],18,5,40494,4.054671072394112,40.0,0.0
49987,4,9987,[318 427  79 588 216],716,5,40499,4.054765718862635,40.0,0.0
49988,4,9988,[318 427  79 588 216],18,5,40504,4.0548603463810196,40.0,0.0
49989,4,9989,[318 427  79 588 216],18,5,40509,4.054954954954955,40.0,0.0
49990,4,9990,[318 427  79 588 216],18,5,40514,4.055049544590132,40.0,0.0
49991,4,9991,[  7  98 200 405  11],269,2,40516,4.05484387510008,0.0,0.0
49992,4,9992,[318 427  79 588 216],18,5,40521,4.054938456919844,40.0,0.0
49993,4,9993,[222  25 423 200 185],450,2,40523,4.0547328397038225,0.0,0.0
49994,4,9994,[118 286  88 187 151],796,4,40527,4.054727363681841,0.0,20.0
49995,4,9995,[118  82 196 318   7],72,2,40529,4.054521808723489,20.0,0.0
49996,4,9996,[182 132 211   1 135],535,2,40531,4.054316294888467,0.0,0.0
49997,4,9997,[318 427  79 588 216],450,5,40536,4.054410882176435,40.0,0.0
49998,4,9998,[125 318 172 200 204],655,3,40539,4.054305430543054,20.0,0.0
49999,4,9999,[318 427  79 588 216],18,5,40544,4.0544,40.0,0.0
