,iteration,visit,item_id_list,visitor_id,reward,total_reward,fraction_relevant,percentage_overlap_rating,percentage_overlap_like
0,0,0,[ 69 135 191  25 435],373,4,4,4.0,0.0,0.0
1,0,1,[435  25 191  69 300],297,1,5,2.5,0.0,0.0
2,0,2,[ 25 435 191  69 300],297,1,6,2.0,0.0,0.0
3,0,3,[313   8  96 471 288],907,4,10,2.5,20.0,40.0
4,0,4,[ 25 313 288 471  96],416,5,15,3.0,20.0,40.0
5,0,5,[ 25 313 288 471  96],907,5,20,3.3333333333333335,20.0,40.0
6,0,6,[ 25 313 288 471  96],907,5,25,3.5714285714285716,20.0,40.0
7,0,7,[ 25 313 288 471  96],921,2,27,3.375,20.0,40.0
8,0,8,[313  96  25 288 471],618,1,28,3.111111111111111,20.0,40.0
9,0,9,[235 181 742 143 202],805,0,28,2.8,0.0,20.0
10,0,10,[496   7 151 269 174],43,5,33,3.0,0.0,0.0
11,0,11,[111 182  28 183 568],618,4,37,3.0833333333333335,0.0,0.0
12,0,12,[  7 568 174 182 151],214,5,42,3.230769230769231,0.0,0.0
13,0,13,[  7 568 174 182 151],198,4,46,3.2857142857142856,0.0,0.0
14,0,14,[  7 496 174 182 151],417,2,48,3.2,0.0,0.0
15,0,15,[ 28 269 182 183 151],416,4,52,3.25,0.0,0.0
16,0,16,[144  98 237 471 435],505,2,54,3.176470588235294,0.0,20.0
17,0,17,[237 268 200 173  25],854,2,56,3.111111111111111,0.0,0.0
18,0,18,[151 268 323 286 313],345,3,59,3.1052631578947367,20.0,20.0
19,0,19,[ 28 200 269 183 313],416,5,64,3.2,20.0,20.0
20,0,20,[333 183  28 216 117],416,5,69,3.2857142857142856,0.0,0.0
21,0,21,[313  98 216  28 269],43,5,74,3.3636363636363638,20.0,40.0
22,0,22,[313  98 216  28 269],43,5,79,3.4347826086956523,20.0,40.0
23,0,23,[313  98 216  28 269],654,5,84,3.5,20.0,40.0
24,0,24,[151 435  71 271 144],505,2,86,3.44,0.0,0.0
25,0,25,[435 195 228   8 100],230,3,89,3.423076923076923,0.0,0.0
26,0,26,[405 237  28 179 245],62,1,90,3.3333333333333335,0.0,0.0
27,0,27,[ 96 182 238 117 204],198,3,93,3.3214285714285716,0.0,0.0
28,0,28,[546 568 186 100   9],43,4,97,3.3448275862068964,0.0,0.0
29,0,29,[313 179 238   9  71],416,4,101,3.3666666666666667,20.0,20.0
30,0,30,[313 173 238   9  71],345,4,105,3.3870967741935485,20.0,20.0
31,0,31,[588 403  22 127 385],922,2,107,3.34375,0.0,0.0
32,0,32,[173   9 265  96  11],618,2,109,3.303030303030303,0.0,0.0
33,0,33,[204 196 215 603  95],405,2,111,3.264705882352941,0.0,0.0
34,0,34,[333 100 200 546  98],416,4,115,3.2857142857142856,0.0,20.0
35,0,35,[333 100 200  98 182],253,3,118,3.2777777777777777,0.0,20.0
36,0,36,[  8 271 143 471 144],297,2,120,3.2432432432432434,0.0,0.0
37,0,37,[215   7 121 678 471],416,4,124,3.263157894736842,0.0,0.0
38,0,38,[ 22 588 216 121 269],654,5,129,3.3076923076923075,0.0,0.0
39,0,39,[ 22 588 216 121 269],805,1,130,3.25,0.0,0.0
40,0,40,[ 25  82 118 168  98],417,4,134,3.268292682926829,0.0,20.0
41,0,41,[118  98 200 168 215],437,2,136,3.238095238095238,0.0,20.0
42,0,42,[257  50 135 175 168],698,1,137,3.186046511627907,0.0,20.0
43,0,43,[234 333 742 318 210],253,4,141,3.2045454545454546,20.0,0.0
44,0,44,[546   7 118 238 179],805,3,144,3.2,0.0,0.0
45,0,45,[121 228  79  50 144],417,0,144,3.130434782608696,0.0,20.0
46,0,46,[313  98 318 200  82],405,4,148,3.148936170212766,40.0,40.0
47,0,47,[313 265 318  82 234],405,4,152,3.1666666666666665,40.0,20.0
48,0,48,[313  98 318  82 234],618,5,157,3.204081632653061,40.0,40.0
49,0,49,[313  98 318  82 234],416,5,162,3.24,40.0,40.0
50,0,50,[313  98 318  82 234],405,5,167,3.2745098039215685,40.0,40.0
51,0,51,[313  98 318  82 234],588,4,171,3.2884615384615383,40.0,40.0
52,0,52,[ 28 471  88  64 385],43,4,175,3.30188679245283,20.0,0.0
53,0,53,[ 88 318 313  64 238],416,4,179,3.314814814814815,60.0,20.0
54,0,54,[ 97 143 588 655   9],618,4,183,3.327272727272727,0.0,0.0
55,0,55,[179 228 385 191  50],417,3,186,3.3214285714285716,0.0,20.0
56,0,56,[183  97 271 515 176],297,4,190,3.3333333333333335,0.0,0.0
57,0,57,[ 69  15 423 318  25],618,3,193,3.3275862068965516,20.0,0.0
58,0,58,[216 222 273 742 271],297,3,196,3.3220338983050848,0.0,0.0
59,0,59,[ 97  64 423 238 318],416,5,201,3.35,40.0,0.0
60,0,60,[ 97  64 423 238 318],416,5,206,3.377049180327869,40.0,0.0
61,0,61,[ 97  64 423 238 318],618,4,210,3.3870967741935485,40.0,0.0
62,0,62,[ 97  64 423 318  82],198,2,212,3.365079365079365,40.0,0.0
63,0,63,[117 200 237 603  15],416,4,216,3.375,0.0,0.0
64,0,64,[176 313 273  11  64],618,5,221,3.4,40.0,20.0
65,0,65,[176 313 273  11  64],618,5,226,3.4242424242424243,40.0,20.0
66,0,66,[176 313 273  11  64],416,5,231,3.4477611940298507,40.0,20.0
67,0,67,[435 175 235 111 183],297,2,233,3.426470588235294,0.0,0.0
68,0,68,[174 323 172 222 143],43,4,237,3.4347826086956523,0.0,0.0
69,0,69,[568 191 185 135 385],618,5,242,3.4571428571428573,0.0,0.0
70,0,70,[515  11 176 318 269],416,5,247,3.4788732394366195,20.0,0.0
71,0,71,[515  11 176 318 269],416,5,252,3.5,20.0,0.0
72,0,72,[515  11 176 318 269],416,5,257,3.5205479452054793,20.0,0.0
73,0,73,[ 56 245 211 228  95],417,4,261,3.527027027027027,0.0,0.0
74,0,74,[655 234 313 185 172],405,5,266,3.546666666666667,20.0,20.0
75,0,75,[655 234 313 185 172],618,5,271,3.5657894736842106,20.0,20.0
76,0,76,[655 234 313 185 172],416,5,276,3.5844155844155843,20.0,20.0
77,0,77,[202 125 328 187  56],416,5,281,3.6025641025641026,0.0,0.0
78,0,78,[568 211   4 196 286],373,4,285,3.607594936708861,0.0,0.0
79,0,79,[302 435 603 655 265],405,2,287,3.5875,0.0,0.0
80,0,80,[275 238  69 603 181],437,4,291,3.5925925925925926,0.0,20.0
81,0,81,[515 275 273 328  64],416,5,296,3.6097560975609757,20.0,0.0
82,0,82,[515 275 273 328  64],416,5,301,3.6265060240963853,20.0,0.0
83,0,83,[471 127 289 197 269],721,4,305,3.630952380952381,0.0,0.0
84,0,84,[313 302 328 273  56],416,5,310,3.6470588235294117,20.0,20.0
85,0,85,[238 215 237 318  69],618,4,314,3.6511627906976742,20.0,0.0
86,0,86,[135 196 195 143 515],297,4,318,3.6551724137931036,0.0,0.0
87,0,87,[423 185  15  96 508],417,2,320,3.6363636363636362,0.0,0.0
88,0,88,[100 318 222 125 172],588,2,322,3.6179775280898876,20.0,0.0
89,0,89,[318 328 211 302  11],416,5,327,3.6333333333333333,20.0,0.0
90,0,90,[318 328 211 302  11],43,5,332,3.6483516483516483,20.0,0.0
91,0,91,[196 678 302 496 215],416,4,336,3.652173913043478,0.0,0.0
92,0,92,[111 118 323 546  11],416,2,338,3.6344086021505375,0.0,0.0
93,0,93,[234 275 172  64 655],618,4,342,3.6382978723404253,20.0,0.0
94,0,94,[234 302  64 655 211],405,4,346,3.642105263157895,20.0,0.0
95,0,95,[234 302  64 655 313],416,5,351,3.65625,40.0,20.0
96,0,96,[234 302  64 655 313],416,5,356,3.670103092783505,40.0,20.0
97,0,97,[568 300  89 385 194],698,4,360,3.673469387755102,0.0,0.0
98,0,98,[ 64   4  89 273 328],854,3,363,3.6666666666666665,20.0,0.0
99,0,99,[179 568 210 427  50],405,4,367,3.67,0.0,20.0
100,0,100,[210 318 176  64  11],405,4,371,3.6732673267326734,40.0,0.0
101,0,101,[161   1 273 237  11],416,4,375,3.676470588235294,0.0,0.0
102,0,102,[742 195  89 427  64],642,2,377,3.6601941747572817,20.0,0.0
103,0,103,[161 183 313 172  11],618,5,382,3.673076923076923,20.0,20.0
104,0,104,[161 183 313 172  11],618,5,387,3.6857142857142855,20.0,20.0
105,0,105,[161 183 313 172  11],416,5,392,3.69811320754717,20.0,20.0
106,0,106,[ 50   4  97  98 273],62,4,396,3.7009345794392523,0.0,40.0
107,0,107,[ 69   7 204 655  64],198,4,400,3.7037037037037037,20.0,0.0
108,0,108,[273 183 515 172 302],416,5,405,3.7155963302752295,0.0,0.0
109,0,109,[273 183 515 172 302],417,2,407,3.7,0.0,0.0
110,0,110,[173  71   9 174  56],805,2,409,3.684684684684685,0.0,0.0
111,0,111,[273 405 276   4 275],764,2,411,3.669642857142857,0.0,0.0
112,0,112,[ 64  56 194 318 269],854,4,415,3.672566371681416,40.0,0.0
113,0,113,[282 742 181 121 183],270,3,418,3.6666666666666665,0.0,20.0
114,0,114,[210  56 161 318 269],43,5,423,3.6782608695652175,20.0,0.0
115,0,115,[210  56 161 318 269],43,5,428,3.689655172413793,20.0,0.0
116,0,116,[210  56 161 318 269],345,4,432,3.6923076923076925,20.0,0.0
117,0,117,[ 89 181 211 385 210],373,4,436,3.694915254237288,0.0,20.0
118,0,118,[210  56 318 313 269],345,5,441,3.7058823529411766,40.0,20.0
119,0,119,[210  56 318 313 269],43,5,446,3.716666666666667,40.0,20.0
120,0,120,[ 70   9 117 323 143],43,4,450,3.71900826446281,0.0,0.0
121,0,121,[183 197  56  11 515],405,3,453,3.7131147540983607,0.0,0.0
122,0,122,[313 210  56 269  11],654,5,458,3.7235772357723578,20.0,20.0
123,0,123,[313 210  56 269  11],654,5,463,3.7338709677419355,20.0,20.0
124,0,124,[117 111 179 273 180],62,4,467,3.736,0.0,0.0
125,0,125,[210 197  64 318 313],345,5,472,3.746031746031746,60.0,20.0
126,0,126,[210 197  64 318 313],416,5,477,3.7559055118110236,60.0,20.0
127,0,127,[496 215  82 588  69],654,5,482,3.765625,0.0,0.0
128,0,128,[294 204 471 210 655],922,1,483,3.744186046511628,0.0,0.0
129,0,129,[196 173 216 118  22],416,4,487,3.746153846153846,0.0,0.0
130,0,130,[405 471 265 151 117],128,4,491,3.7480916030534353,0.0,0.0
131,0,131,[180 187  11 294 318],214,4,495,3.75,20.0,0.0
132,0,132,[ 70  64 180 234  11],417,5,500,3.7593984962406015,20.0,0.0
133,0,133,[151 183 238 234  89],805,5,505,3.7686567164179103,0.0,0.0
134,0,134,[ 70  64 180 234  11],198,2,507,3.7555555555555555,20.0,0.0
135,0,135,[318  64  56 269 313],214,4,511,3.7573529411764706,60.0,20.0
136,0,136,[318  64  56 313   1],642,4,515,3.759124087591241,60.0,20.0
137,0,137,[ 64  56 313   1  11],618,5,520,3.7681159420289854,40.0,20.0
138,0,138,[ 64  56 313   1  11],618,5,525,3.776978417266187,40.0,20.0
139,0,139,[603 405  22 168  25],805,3,528,3.7714285714285714,0.0,0.0
140,0,140,[313  64  11  56   1],416,5,533,3.780141843971631,40.0,20.0
141,0,141,[313  64  11  56   1],345,4,537,3.7816901408450705,40.0,20.0
142,0,142,[313 187  64  11  56],416,5,542,3.7902097902097904,40.0,20.0
143,0,143,[313 187  64  11  56],416,5,547,3.798611111111111,40.0,20.0
144,0,144,[313 187  64  11  56],416,5,552,3.806896551724138,40.0,20.0
145,0,145,[313 187  64  11  56],405,5,557,3.815068493150685,40.0,20.0
146,0,146,[313 187  64  11  56],618,5,562,3.82312925170068,40.0,20.0
147,0,147,[211 423  98 151 508],354,1,563,3.804054054054054,0.0,20.0
148,0,148,[ 56 294   4  89  11],342,3,566,3.7986577181208054,0.0,0.0
149,0,149,[ 11  64  56 313 187],405,5,571,3.8066666666666666,40.0,20.0
150,0,150,[ 11  64  56 313 187],618,5,576,3.814569536423841,40.0,20.0
151,0,151,[ 11  64  56 313 187],214,5,581,3.8223684210526314,40.0,20.0
152,0,152,[603 216 748  70 273],416,5,586,3.8300653594771243,0.0,0.0
153,0,153,[313  56  11  64 187],618,5,591,3.8376623376623376,40.0,20.0
154,0,154,[ 64 215 273 568  97],62,2,593,3.825806451612903,20.0,0.0
155,0,155,[282   9 333 183  88],416,4,597,3.826923076923077,0.0,0.0
156,0,156,[313  64  11  56 187],214,5,602,3.8343949044585988,40.0,20.0
157,0,157,[313  64  11  56 187],214,5,607,3.8417721518987342,40.0,20.0
158,0,158,[313  64  11  56 187],405,5,612,3.849056603773585,40.0,20.0
159,0,159,[234 357 258  56  71],601,2,614,3.8375,0.0,0.0
160,0,160,[117  56  11 143 125],618,4,618,3.8385093167701863,0.0,0.0
161,0,161,[301 245 172 161 508],345,3,621,3.8333333333333335,0.0,0.0
162,0,162,[ 50  56   7 568 204],505,1,622,3.815950920245399,0.0,20.0
163,0,163,[258 187  11 357  64],416,5,627,3.823170731707317,20.0,0.0
164,0,164,[258 187  11 357  64],416,5,632,3.83030303030303,20.0,0.0
165,0,165,[258 187  11 357  64],198,5,637,3.8373493975903616,20.0,0.0
166,0,166,[235 322 117 265 182],417,2,639,3.8263473053892216,0.0,0.0
167,0,167,[195 172 357 121  25],630,2,641,3.8154761904761907,0.0,0.0
168,0,168,[ 95 182 238 228 195],297,1,642,3.798816568047337,0.0,0.0
169,0,169,[258  11 313  64 748],345,4,646,3.8,40.0,20.0
170,0,170,[655 748 176 496 185],416,5,651,3.807017543859649,0.0,0.0
171,0,171,[301  98 258 173 181],49,1,652,3.7906976744186047,0.0,40.0
172,0,172,[ 11 187 197 313  64],416,5,657,3.7976878612716765,40.0,20.0
173,0,173,[ 11 187 197 313  64],416,5,662,3.8045977011494254,40.0,20.0
174,0,174,[265 196 234 333 313],416,5,667,3.8114285714285714,20.0,20.0
175,0,175,[ 22 144 111  79 222],711,2,669,3.8011363636363638,0.0,0.0
176,0,176,[ 88 234 215 117  25],416,4,673,3.8022598870056497,0.0,0.0
177,0,177,[ 64 187 313 197  11],405,5,678,3.808988764044944,40.0,20.0
178,0,178,[ 64 187 313 197  11],618,4,682,3.810055865921788,40.0,20.0
179,0,179,[ 64 187 313  11 318],405,5,687,3.816666666666667,60.0,20.0
180,0,180,[ 64 187 313  11 318],416,5,692,3.8232044198895028,60.0,20.0
181,0,181,[ 64 187 313  11 318],416,5,697,3.82967032967033,60.0,20.0
182,0,182,[ 64 187 313  11 318],416,5,702,3.8360655737704916,60.0,20.0
183,0,183,[ 64 187 313  11 318],405,5,707,3.842391304347826,60.0,20.0
184,0,184,[ 64 187 313  11 318],416,5,712,3.848648648648649,60.0,20.0
185,0,185,[265 546 132 286 151],416,3,715,3.8440860215053765,0.0,0.0
186,0,186,[ 95  28 185 179 202],405,3,718,3.839572192513369,0.0,0.0
187,0,187,[ 11  22 191 588 180],405,3,721,3.8351063829787235,0.0,0.0
188,0,188,[180 195 289 597 483],854,2,723,3.8253968253968256,20.0,0.0
189,0,189,[182 216 655 496  97],253,4,727,3.8263157894736843,0.0,0.0
190,0,190,[132 187  64 313  11],416,5,732,3.832460732984293,40.0,20.0
191,0,191,[ 69 135 175  79 176],198,3,735,3.828125,0.0,0.0
192,0,192,[132 187  64 313  11],416,5,740,3.8341968911917097,40.0,20.0
193,0,193,[  9 678   4  88 216],416,3,743,3.829896907216495,0.0,0.0
194,0,194,[132 187  64 313  11],214,5,748,3.835897435897436,40.0,20.0
195,0,195,[269 471 273 322 211],416,4,752,3.836734693877551,0.0,0.0
196,0,196,[318   7 127  97  50],198,4,756,3.8375634517766497,20.0,20.0
197,0,197,[ 64 117 173 125 405],764,4,760,3.8383838383838382,20.0,0.0
198,0,198,[132 187  64 313  11],416,5,765,3.8442211055276383,40.0,20.0
199,0,199,[132 187  64 313  11],405,5,770,3.85,40.0,20.0
200,0,200,[132 187  64 313  11],618,5,775,3.855721393034826,40.0,20.0
201,0,201,[132 187  64 313  11],405,5,780,3.8613861386138613,40.0,20.0
202,0,202,[132 187  64 313  11],214,5,785,3.8669950738916254,40.0,20.0
203,0,203,[132 187  64 313  11],405,5,790,3.872549019607843,40.0,20.0
204,0,204,[132 187  64 313  11],214,5,795,3.8780487804878048,40.0,20.0
205,0,205,[132 187  64 313  11],214,5,800,3.883495145631068,40.0,20.0
206,0,206,[132 187  64 313  11],618,5,805,3.888888888888889,40.0,20.0
207,0,207,[405 210 127 245 100],417,2,807,3.8798076923076925,0.0,0.0
208,0,208,[483 187  64 313  11],214,5,812,3.8851674641148324,60.0,20.0
209,0,209,[483 187  64 313  11],214,5,817,3.8904761904761904,60.0,20.0
210,0,210,[ 12 258 100  89 211],417,4,821,3.890995260663507,20.0,0.0
211,0,211,[ 11 132  12  64 187],405,5,826,3.8962264150943398,40.0,0.0
212,0,212,[ 11 132  12  64 187],405,5,831,3.9014084507042255,40.0,0.0
213,0,213,[ 11 132  12  64 187],214,5,836,3.9065420560747666,40.0,0.0
214,0,214,[ 11 132  12  64 187],416,5,841,3.911627906976744,40.0,0.0
215,0,215,[ 11 132  12  64 187],618,5,846,3.9166666666666665,40.0,0.0
216,0,216,[597 237   4 151  82],642,3,849,3.912442396313364,0.0,0.0
217,0,217,[ 64 187 483 132 313],214,5,854,3.9174311926605503,60.0,20.0
218,0,218,[289  95 357 385  50],416,3,857,3.91324200913242,0.0,20.0
219,0,219,[100 204 238 121 435],437,3,860,3.909090909090909,0.0,0.0
220,0,220,[286 100 546 216 496],416,4,864,3.909502262443439,0.0,0.0
221,0,221,[405 286 125 742 100],854,2,866,3.900900900900901,0.0,0.0
222,0,222,[ 11  64 187 313 132],214,5,871,3.905829596412556,40.0,20.0
223,0,223,[ 11  64 187 313 132],416,5,876,3.9107142857142856,40.0,20.0
224,0,224,[ 11 194 302 185 313],416,5,881,3.9155555555555557,20.0,20.0
225,0,225,[ 11  64 187 313 132],416,5,886,3.920353982300885,40.0,20.0
226,0,226,[135 508 289 322 186],854,2,888,3.9118942731277535,0.0,0.0
227,0,227,[ 11  64 187 313 132],405,5,893,3.9166666666666665,40.0,20.0
228,0,228,[180  95  11 265 202],417,4,897,3.9170305676855897,0.0,0.0
229,0,229,[ 11 385 121  82  98],751,4,901,3.917391304347826,0.0,20.0
230,0,230,[328 318 333 258 200],854,3,904,3.9134199134199132,20.0,0.0
231,0,231,[ 12 132  64 187 313],416,5,909,3.918103448275862,60.0,20.0
232,0,232,[ 12 132  64 187 313],618,5,914,3.92274678111588,60.0,20.0
233,0,233,[ 12 132  64 187 313],618,5,919,3.927350427350427,60.0,20.0
234,0,234,[144  71  69 405 172],705,2,921,3.9191489361702128,0.0,0.0
235,0,235,[ 82 185 168 427 269],711,4,925,3.919491525423729,0.0,0.0
236,0,236,[423 238 235 271  69],297,1,926,3.9071729957805905,0.0,0.0
237,0,237,[ 12 187 313 483 132],618,5,931,3.911764705882353,60.0,20.0
238,0,238,[ 12 508 204 568  71],345,4,935,3.912133891213389,20.0,0.0
239,0,239,[ 12 187 313 483 132],618,5,940,3.9166666666666665,60.0,20.0
240,0,240,[318 118 403 301  69],416,4,944,3.91701244813278,20.0,0.0
241,0,241,[ 64  12 187 313 132],214,5,949,3.9214876033057853,60.0,20.0
242,0,242,[ 64  12 187 313 132],405,5,954,3.925925925925926,60.0,20.0
243,0,243,[ 64  12 187 313 132],416,5,959,3.930327868852459,60.0,20.0
244,0,244,[ 64  12 187 313 132],416,5,964,3.9346938775510205,60.0,20.0
245,0,245,[ 64  12 187 313 132],416,5,969,3.9390243902439024,60.0,20.0
246,0,246,[143 328  15 191  25],416,5,974,3.9433198380566803,0.0,0.0
247,0,247,[187 313  64  12 132],618,5,979,3.9475806451612905,60.0,20.0
248,0,248,[187 313  64  12 132],416,5,984,3.9518072289156625,60.0,20.0
249,0,249,[187 313  64  12 132],416,5,989,3.956,60.0,20.0
250,0,250,[187 313  64  12 132],618,5,994,3.960159362549801,60.0,20.0
251,0,251,[187 313  64  12 132],618,5,999,3.9642857142857144,60.0,20.0
252,0,252,[187 313  64  12 132],416,5,1004,3.9683794466403164,60.0,20.0
253,0,253,[282 318  22  95 210],618,2,1006,3.9606299212598426,20.0,0.0
254,0,254,[187 483  64  12 132],618,5,1011,3.9647058823529413,60.0,0.0
255,0,255,[187 483  64  12 132],214,5,1016,3.96875,60.0,0.0
256,0,256,[187 483  64  12 132],618,5,1021,3.972762645914397,60.0,0.0
257,0,257,[187 483  64  12 132],618,5,1026,3.9767441860465116,60.0,0.0
258,0,258,[187 483  64  12 132],618,5,1031,3.9806949806949805,60.0,0.0
259,0,259,[187 483  64  12 132],214,5,1036,3.9846153846153847,60.0,0.0
260,0,260,[187 483  64  12 132],214,5,1041,3.9885057471264367,60.0,0.0
261,0,261,[204  95 172 173 216],416,4,1045,3.9885496183206106,0.0,0.0
262,0,262,[301 294 588 197 265],416,5,1050,3.9923954372623576,0.0,0.0
263,0,263,[ 12 313 132  64 483],214,5,1055,3.996212121212121,80.0,20.0
264,0,264,[ 12 313 132  64 483],618,5,1060,4.0,80.0,20.0
265,0,265,[143 168 153 173 302],416,5,1065,4.003759398496241,0.0,0.0
266,0,266,[403  95 161  64 153],43,5,1070,4.007490636704119,20.0,0.0
267,0,267,[483  12 132 313 187],214,5,1075,4.0111940298507465,60.0,20.0
268,0,268,[483  12 132 313 187],214,5,1080,4.014869888475836,60.0,20.0
269,0,269,[483  12 132 313 187],618,5,1085,4.018518518518518,60.0,20.0
270,0,270,[ 12 286  22 111 182],62,3,1088,4.014760147601476,20.0,0.0
271,0,271,[483  12 132 313 187],618,5,1093,4.018382352941177,60.0,20.0
272,0,272,[  1 588   7 742 678],297,2,1095,4.010989010989011,0.0,0.0
273,0,273,[118 196   8 282 276],416,3,1098,4.007299270072993,0.0,0.0
274,0,274,[597 282 237 318 172],416,3,1101,4.003636363636364,20.0,0.0
275,0,275,[ 22 258  97 127 423],416,5,1106,4.007246376811594,0.0,0.0
276,0,276,[  4   1 496 183 168],417,3,1109,4.003610108303249,0.0,0.0
277,0,277,[210  79 185 197 204],618,2,1111,3.9964028776978417,0.0,0.0
278,0,278,[328 100 597 200 174],416,4,1115,3.996415770609319,0.0,0.0
279,0,279,[ 12 313 132  64 187],405,5,1120,4.0,60.0,20.0
280,0,280,[ 12 313 132  64 187],405,5,1125,4.00355871886121,60.0,20.0
281,0,281,[268   8 143  56 748],679,3,1128,4.0,0.0,0.0
282,0,282,[273 427 187 151 323],416,3,1131,3.9964664310954063,0.0,0.0
283,0,283,[132  12 313  64 187],416,5,1136,4.0,60.0,20.0
284,0,284,[132  12 313  64 187],214,5,1141,4.003508771929824,60.0,20.0
285,0,285,[132  12 313  64 187],416,5,1146,4.006993006993007,60.0,20.0
286,0,286,[132 237  97 286 597],416,3,1149,4.003484320557491,0.0,0.0
287,0,287,[144 161  96 118 235],417,1,1150,3.9930555555555554,0.0,0.0
288,0,288,[144  28 174 475 132],62,3,1153,3.98961937716263,0.0,0.0
289,0,289,[748 265 187 191 176],505,2,1155,3.9827586206896552,0.0,0.0
290,0,290,[ 12 475 483 132 313],588,4,1159,3.9828178694158076,60.0,20.0
291,0,291,[288 200 173 181  50],416,5,1164,3.9863013698630136,0.0,60.0
292,0,292,[237 471 289 678 273],159,3,1167,3.9829351535836177,0.0,0.0
293,0,293,[ 12 313 132  64 153],416,5,1172,3.9863945578231292,60.0,20.0
294,0,294,[ 12 313 132  64 153],416,5,1177,3.989830508474576,60.0,20.0
295,0,295,[742 238 603   8  89],297,4,1181,3.989864864864865,0.0,0.0
296,0,296,[ 64 483  12 153 132],854,5,1186,3.993265993265993,60.0,0.0
297,0,297,[ 64 483  12 153 132],62,5,1191,3.9966442953020134,60.0,0.0
298,0,298,[ 64 483  12 153 132],417,5,1196,4.0,60.0,0.0
299,0,299,[ 64 483  12 153 132],62,5,1201,4.003333333333333,60.0,0.0
300,0,300,[ 64 483  12 153 132],854,5,1206,4.0066445182724255,60.0,0.0
301,0,301,[ 64 483  12 153 132],417,5,1211,4.009933774834437,60.0,0.0
302,0,302,[ 64 483  12 153 132],601,4,1215,4.00990099009901,60.0,0.0
303,0,303,[318 269 237 210 204],43,5,1220,4.0131578947368425,20.0,0.0
304,0,304,[127 132 210   1 125],62,4,1224,4.0131147540983605,0.0,0.0
305,0,305,[  9 257 127 211 151],416,3,1227,4.009803921568627,0.0,0.0
306,0,306,[  8 294 200   4 302],49,1,1228,4.0,0.0,0.0
307,0,307,[496 132 117 202  50],764,4,1232,4.0,0.0,20.0
308,0,308,[118 181 742  69 111],274,5,1237,4.003236245954692,0.0,20.0
309,0,309,[216 300   4 143 204],12,5,1242,4.006451612903226,0.0,0.0
310,0,310,[204   1 235 568 237],262,0,1242,3.9935691318327975,0.0,0.0
311,0,311,[546  70 655 300  15],416,4,1246,3.9935897435897436,0.0,0.0
312,0,312,[  7 182 197 275  69],416,5,1251,3.9968051118210863,0.0,0.0
313,0,313,[ 12 121 117 471 603],854,2,1253,3.9904458598726116,20.0,0.0
314,0,314,[153 357   7 288 234],416,5,1258,3.9936507936507937,0.0,20.0
315,0,315,[403 161 588 228  22],805,1,1259,3.9841772151898733,0.0,0.0
316,0,316,[  4 357 568 603 238],405,4,1263,3.9842271293375395,0.0,0.0
317,0,317,[ 22  79 197  28 228],297,2,1265,3.9779874213836477,0.0,0.0
318,0,318,[  4  98 135 185 568],405,5,1270,3.981191222570533,0.0,20.0
319,0,319,[211 153 496 117 288],416,5,1275,3.984375,0.0,20.0
320,0,320,[144 546  22 235 423],297,1,1276,3.9750778816199377,0.0,0.0
321,0,321,[588  71 204 286  97],588,4,1280,3.9751552795031055,0.0,0.0
322,0,322,[ 95  98 211 496   1],230,5,1285,3.978328173374613,0.0,20.0
323,0,323,[475 245 742 568 216],62,2,1287,3.9722222222222223,0.0,0.0
324,0,324,[288 100  79 185 385],618,4,1291,3.9723076923076923,0.0,20.0
325,0,325,[121 194  79  50 215],751,5,1296,3.9754601226993866,0.0,20.0
326,0,326,[323 215 403 173 748],721,3,1299,3.9724770642201834,0.0,0.0
327,0,327,[194 423 135 655   1],721,3,1302,3.9695121951219514,0.0,0.0
328,0,328,[238 194 191 588  22],297,3,1305,3.966565349544073,0.0,0.0
329,0,329,[175 313 515  88 187],405,2,1307,3.9606060606060605,20.0,20.0
330,0,330,[357  15 151 288 172],601,2,1309,3.9546827794561934,0.0,20.0
331,0,331,[  1 196 238 748  98],417,5,1314,3.9578313253012047,0.0,20.0
332,0,332,[496  88 196 328 546],314,4,1318,3.957957957957958,0.0,0.0
333,0,333,[496 210 427 234 197],618,3,1321,3.9550898203592815,0.0,0.0
334,0,334,[ 50 183 182  12   7],618,5,1326,3.9582089552238804,20.0,20.0
335,0,335,[168 135  69 144 204],62,3,1329,3.955357142857143,0.0,0.0
336,0,336,[357 245 111 196 135],721,3,1332,3.9525222551928785,0.0,0.0
337,0,337,[ 96 245 258 151 313],907,5,1337,3.955621301775148,20.0,20.0
338,0,338,[216 427  95 127   7],198,4,1341,3.9557522123893807,0.0,0.0
339,0,339,[144  96  56 357  88],416,4,1345,3.9558823529411766,0.0,0.0
340,0,340,[ 98 200  97 258  89],711,5,1350,3.9589442815249267,0.0,20.0
341,0,341,[144 211 405  71 172],230,4,1354,3.9590643274853803,0.0,0.0
342,0,342,[168 100 546 742   1],43,5,1359,3.9620991253644315,0.0,0.0
343,0,343,[216 245  50 168  25],417,2,1361,3.9563953488372094,0.0,20.0
344,0,344,[234 200 357 117 143],416,5,1366,3.9594202898550726,0.0,0.0
345,0,345,[196 175 172 222 216],805,3,1369,3.9566473988439306,0.0,0.0
346,0,346,[215 357 181 546 268],416,4,1373,3.956772334293948,0.0,20.0
347,0,347,[185 151 403 181 288],416,4,1377,3.956896551724138,0.0,40.0
348,0,348,[ 11 597 423 288 118],805,0,1377,3.945558739255014,0.0,20.0
349,0,349,[195  50 197 282 235],297,1,1378,3.9371428571428573,0.0,20.0
350,0,350,[742  79 216 423  96],854,2,1380,3.9316239316239314,0.0,0.0
351,0,351,[196  70 202 508 275],297,4,1384,3.9318181818181817,0.0,0.0
352,0,352,[385 357 300  89 435],698,4,1388,3.9320113314447593,0.0,0.0
353,0,353,[118  97 597  82  22],642,4,1392,3.9322033898305087,0.0,0.0
354,0,354,[191 328   1 275 186],43,4,1396,3.932394366197183,0.0,0.0
355,0,355,[483 475 357 568  71],62,4,1400,3.932584269662921,20.0,0.0
356,0,356,[ 79 238  22 275 144],654,5,1405,3.9355742296918765,0.0,0.0
357,0,357,[ 82  70 175 161 427],405,2,1407,3.930167597765363,0.0,0.0
358,0,358,[200 258 216 318 271],854,4,1411,3.9303621169916436,20.0,0.0
359,0,359,[118  88 294 117   1],642,4,1415,3.9305555555555554,0.0,0.0
360,0,360,[185 323 132 143 127],416,4,1419,3.930747922437673,0.0,0.0
361,0,361,[655   4 215 323 153],198,3,1422,3.9281767955801103,0.0,0.0
362,0,362,[168 117 286  28 211],297,5,1427,3.931129476584022,0.0,0.0
363,0,363,[195 323 423 258 196],198,1,1428,3.923076923076923,0.0,0.0
364,0,364,[ 88 181 568 151 385],588,4,1432,3.9232876712328766,0.0,20.0
365,0,365,[172 144 483  96 174],62,4,1436,3.9234972677595628,20.0,0.0
366,0,366,[ 64 357 185 302 268],875,5,1441,3.9264305177111716,20.0,0.0
367,0,367,[135 210 202 195  98],437,3,1444,3.9239130434782608,0.0,20.0
368,0,368,[273 185  79 269 471],854,4,1448,3.924119241192412,0.0,0.0
369,0,369,[ 69   9 210 117  28],62,4,1452,3.924324324324324,0.0,0.0
370,0,370,[ 95 173 288  79 403],405,4,1456,3.9245283018867925,0.0,20.0
371,0,371,[121  15 546  12 111],630,3,1459,3.922043010752688,20.0,0.0
372,0,372,[  8  56 181 222  97],654,3,1462,3.9195710455764075,0.0,20.0
373,0,373,[121  25 496 161  70],711,4,1466,3.9197860962566846,0.0,0.0
374,0,374,[118 153   7 286 173],417,4,1470,3.92,0.0,0.0
375,0,375,[172  88 216 483 423],128,4,1474,3.9202127659574466,20.0,0.0
376,0,376,[ 25   9 202 132   4],416,5,1479,3.923076923076923,0.0,0.0
377,0,377,[475 180 179 357 655],805,3,1482,3.9206349206349205,0.0,0.0
378,0,378,[568 127 294 323 234],417,3,1485,3.9182058047493404,0.0,0.0
379,0,379,[183 471 597 210 174],416,4,1489,3.918421052631579,0.0,0.0
380,0,380,[ 12 174 228  69 132],417,2,1491,3.9133858267716537,20.0,0.0
381,0,381,[235  28 294 111 181],297,2,1493,3.9083769633507854,0.0,20.0
382,0,382,[  1 234   8 174  88],805,2,1495,3.9033942558746735,0.0,0.0
383,0,383,[ 89 546  71 235 273],805,1,1496,3.8958333333333335,0.0,0.0
384,0,384,[172 496 222  97 603],734,4,1500,3.896103896103896,0.0,0.0
385,0,385,[748 211 174 111 172],437,4,1504,3.8963730569948187,0.0,0.0
386,0,386,[286 238 235 302 273],416,4,1508,3.896640826873385,0.0,0.0
387,0,387,[64 56 70 22 95],405,3,1511,3.8943298969072164,20.0,0.0
388,0,388,[ 96 210 288 333 172],416,5,1516,3.897172236503856,0.0,20.0
389,0,389,[ 22  56  88 588 174],618,5,1521,3.9,0.0,0.0
390,0,390,[210 357 195 216  70],297,4,1525,3.9002557544757033,0.0,0.0
391,0,391,[597  79 168 118 100],618,4,1529,3.9005102040816326,0.0,0.0
392,0,392,[168   1 100 742  97],416,5,1534,3.9033078880407124,0.0,0.0
393,0,393,[742  89 179 127 121],62,4,1538,3.9035532994923856,0.0,0.0
394,0,394,[483 333  56 204 151],496,2,1540,3.8987341772151898,20.0,0.0
395,0,395,[313 423 151 111 258],43,5,1545,3.9015151515151514,20.0,20.0
396,0,396,[235 168 234  71 181],541,4,1549,3.90176322418136,0.0,20.0
397,0,397,[143 111 186 172 191],437,3,1552,3.899497487437186,0.0,0.0
398,0,398,[143 222   4 174 121],198,1,1553,3.892230576441103,0.0,0.0
399,0,399,[153 237 111   8 125],62,3,1556,3.89,0.0,0.0
400,0,400,[185 125 276 508  64],601,4,1560,3.890274314214464,20.0,0.0
401,0,401,[273 174 185  98 135],805,3,1563,3.888059701492537,0.0,20.0
402,0,402,[273 176 215 181 185],618,5,1568,3.890818858560794,0.0,20.0
403,0,403,[118 357 322 153 185],805,3,1571,3.8886138613861387,0.0,0.0
404,0,404,[ 15 403  71   4 118],345,2,1573,3.8839506172839506,0.0,0.0
405,0,405,[216 196 228 172 179],198,3,1576,3.8817733990147785,0.0,0.0
406,0,406,[282 132   7 100 179],342,4,1580,3.882063882063882,0.0,0.0
407,0,407,[ 22 405 318 144 655],314,4,1584,3.8823529411764706,20.0,0.0
408,0,408,[597 742  22 237  70],62,1,1585,3.8753056234718826,0.0,0.0
409,0,409,[191 496  15  69  82],417,3,1588,3.873170731707317,0.0,0.0
410,0,410,[153 151 168 191 173],642,3,1591,3.8710462287104623,0.0,0.0
411,0,411,[194 202 276 111  22],416,4,1595,3.871359223300971,0.0,0.0
412,0,412,[313  64 132 483 187],618,5,1600,3.87409200968523,60.0,20.0
413,0,413,[313   1   8 742 258],416,5,1605,3.8768115942028984,20.0,20.0
414,0,414,[313  64 132 483 187],214,5,1610,3.8795180722891565,60.0,20.0
415,0,415,[313  64 132 483 187],618,5,1615,3.8822115384615383,60.0,20.0
416,0,416,[121 153 117 546 245],62,4,1619,3.882494004796163,0.0,0.0
417,0,417,[313  64 483 132 187],618,5,1624,3.8851674641148324,60.0,20.0
418,0,418,[181 174 286 151 546],297,3,1627,3.883054892601432,0.0,20.0
419,0,419,[175 435 186 194 174],405,2,1629,3.8785714285714286,0.0,0.0
420,0,420,[748 300 742 100 135],297,2,1631,3.874109263657957,0.0,0.0
421,0,421,[483 132  64 313 187],214,5,1636,3.876777251184834,60.0,20.0
422,0,422,[483 132  64 313 187],618,5,1641,3.879432624113475,60.0,20.0
423,0,423,[ 82 427 194 496 471],373,3,1644,3.8773584905660377,0.0,0.0
424,0,424,[322 132 210 125 323],416,3,1647,3.875294117647059,0.0,0.0
425,0,425,[483 132  64 313 187],214,5,1652,3.8779342723004695,60.0,20.0
426,0,426,[483 132  64 313 187],214,5,1657,3.88056206088993,60.0,20.0
427,0,427,[471 210 423 508 191],297,2,1659,3.8761682242990654,0.0,0.0
428,0,428,[483 132  64 313 187],618,5,1664,3.878787878787879,60.0,20.0
429,0,429,[216 742 385 234 174],642,3,1667,3.8767441860465115,0.0,0.0
430,0,430,[144 111 118 100  56],437,2,1669,3.8723897911832945,0.0,0.0
431,0,431,[546 238 603  95   7],416,3,1672,3.8703703703703702,0.0,0.0
432,0,432,[151 568 180  96  70],62,3,1675,3.868360277136259,0.0,0.0
433,0,433,[ 64 483 313 132 187],214,5,1680,3.870967741935484,60.0,20.0
434,0,434,[197 273 143 405 286],416,5,1685,3.8735632183908044,0.0,0.0
435,0,435,[ 64 313 483 132 187],618,5,1690,3.876146788990826,60.0,20.0
436,0,436,[ 64 313 483 132 187],214,5,1695,3.8787185354691074,60.0,20.0
437,0,437,[475 302  95 496  98],416,3,1698,3.8767123287671232,0.0,20.0
438,0,438,[132 313  64 483 187],214,5,1703,3.879271070615034,60.0,20.0
439,0,439,[238  11 276  50 234],437,4,1707,3.8795454545454544,0.0,20.0
440,0,440,[172 333 234 183 286],416,5,1712,3.8820861678004537,0.0,0.0
441,0,441,[655 132  12 216 153],24,4,1716,3.8823529411764706,20.0,0.0
442,0,442,[125 175 508 301 286],342,3,1719,3.880361173814898,0.0,0.0
443,0,443,[322 196 161 301 245],416,3,1722,3.8783783783783785,0.0,0.0
444,0,444,[748 173 568 318 423],373,4,1726,3.878651685393258,20.0,0.0
445,0,445,[195  25 202 191 118],416,4,1730,3.8789237668161434,0.0,0.0
446,0,446,[313 483  64 187 132],618,5,1735,3.8814317673378076,60.0,20.0
447,0,447,[  1 318 258  56 100],654,4,1739,3.8816964285714284,20.0,0.0
448,0,448,[313 483  64 187 132],214,5,1744,3.884187082405345,60.0,20.0
449,0,449,[313 483  64 187 132],618,5,1749,3.8866666666666667,60.0,20.0
450,0,450,[238 200 125 127 234],417,5,1754,3.8891352549889135,0.0,0.0
451,0,451,[ 69 181 603 151 742],416,4,1758,3.8893805309734515,0.0,20.0
452,0,452,[313  64 483 187 132],214,5,1763,3.891832229580574,60.0,20.0
453,0,453,[228  15 222 318  50],601,4,1767,3.892070484581498,20.0,20.0
454,0,454,[ 64 483 313 187 132],214,5,1772,3.8945054945054944,60.0,20.0
455,0,455,[183 742 475 357 508],62,4,1776,3.8947368421052633,0.0,0.0
456,0,456,[597 151 132 318 427],887,5,1781,3.8971553610503284,20.0,0.0
457,0,457,[ 82 135 173 174  97],721,4,1785,3.8973799126637556,0.0,0.0
458,0,458,[483 313  64 187 132],214,5,1790,3.899782135076253,60.0,20.0
459,0,459,[483 313  64 187 132],618,5,1795,3.902173913043478,60.0,20.0
460,0,460,[496 357 588  96 196],230,4,1799,3.9023861171366594,0.0,0.0
461,0,461,[300 301  50  88 191],345,4,1803,3.9025974025974026,0.0,20.0
462,0,462,[403 153 118 132 294],642,2,1805,3.898488120950324,0.0,0.0
463,0,463,[ 95 200   9 127  97],416,4,1809,3.898706896551724,0.0,0.0
464,0,464,[ 70 180 211 168 186],405,1,1810,3.89247311827957,0.0,0.0
465,0,465,[168 273 568 121 483],253,3,1813,3.890557939914163,20.0,0.0
466,0,466,[ 56 385 168  82 215],654,5,1818,3.892933618843683,0.0,0.0
467,0,467,[ 64 483 313 187  12],618,5,1823,3.8952991452991452,80.0,20.0
468,0,468,[603 588 172 174  88],416,4,1827,3.8955223880597014,0.0,0.0
469,0,469,[ 64 483 313 187  12],214,5,1832,3.8978723404255318,80.0,20.0
470,0,470,[ 64 483 313 187  12],214,5,1837,3.900212314225053,80.0,20.0
471,0,471,[ 64 483 313 187  12],618,5,1842,3.902542372881356,80.0,20.0
472,0,472,[588  89 546  56 197],297,3,1845,3.9006342494714588,0.0,0.0
473,0,473,[268  11 282 135 174],297,4,1849,3.9008438818565403,0.0,0.0
474,0,474,[118 288 161  28 153],805,1,1850,3.8947368421052633,0.0,20.0
475,0,475,[  8  96 135 185 121],601,2,1852,3.8907563025210083,0.0,0.0
476,0,476,[483 313  64 187  12],214,5,1857,3.893081761006289,80.0,20.0
477,0,477,[ 89 237  56 176 153],922,3,1860,3.8912133891213387,0.0,0.0
478,0,478,[483 313  64 187  12],214,5,1865,3.893528183716075,80.0,20.0
479,0,479,[301 568 127 323 385],416,4,1869,3.89375,0.0,0.0
480,0,480,[ 15 475 186 300 276],198,2,1871,3.8898128898128896,0.0,0.0
481,0,481,[181 678   1 237  12],416,3,1874,3.887966804979253,20.0,20.0
482,0,482,[ 64 313 483 187  12],618,5,1879,3.890269151138716,80.0,20.0
483,0,483,[ 64 313 483 187  12],618,5,1884,3.8925619834710745,80.0,20.0
484,0,484,[181  28 215 191 174],416,5,1889,3.894845360824742,0.0,20.0
485,0,485,[483  64 313 187  12],618,5,1894,3.897119341563786,80.0,20.0
486,0,486,[176 183 210   8  79],297,4,1898,3.897330595482546,0.0,0.0
487,0,487,[191  89 568  82 173],642,4,1902,3.8975409836065573,0.0,0.0
488,0,488,[ 64 313 483 187  12],214,5,1907,3.8997955010224947,80.0,20.0
489,0,489,[282 286 289 181 655],345,2,1909,3.8959183673469386,0.0,20.0
490,0,490,[257 125  69 258 185],854,3,1912,3.894093686354379,0.0,0.0
491,0,491,[597 172  95   4   1],805,2,1914,3.8902439024390243,0.0,0.0
492,0,492,[313 483  64 187  12],618,5,1919,3.892494929006085,80.0,20.0
493,0,493,[313 483  64 187  12],618,5,1924,3.8947368421052633,80.0,20.0
494,0,494,[313 483  64 187  12],618,5,1929,3.896969696969697,80.0,20.0
495,0,495,[496 328 427  70 144],416,5,1934,3.899193548387097,0.0,0.0
496,0,496,[546   4 180 161 183],805,1,1935,3.893360160965795,0.0,0.0
497,0,497,[313 483  64 187  12],618,5,1940,3.895582329317269,80.0,20.0
498,0,498,[313 483  64 187  12],618,5,1945,3.8977955911823647,80.0,20.0
499,0,499,[ 12 173 185 100 216],618,3,1948,3.896,20.0,0.0
500,0,500,[161 153 183  96 216],198,4,1952,3.8962075848303392,0.0,0.0
501,0,501,[313 483  64 187  12],618,5,1957,3.898406374501992,80.0,20.0
502,0,502,[313 483  64 187  12],618,5,1962,3.900596421471173,80.0,20.0
503,0,503,[ 98 655 588 234 222],588,2,1964,3.8968253968253967,0.0,20.0
504,0,504,[161 496 175 117  69],373,4,1968,3.897029702970297,0.0,0.0
505,0,505,[ 64 483 313 187  12],214,5,1973,3.899209486166008,80.0,20.0
506,0,506,[  1 175 275  11  15],854,3,1976,3.8974358974358974,0.0,0.0
507,0,507,[ 64 483 313 187  12],618,5,1981,3.8996062992125986,80.0,20.0
508,0,508,[ 82 179 180  22 655],62,4,1985,3.899803536345776,0.0,0.0
509,0,509,[200 515  28 132  97],405,2,1987,3.896078431372549,0.0,0.0
510,0,510,[ 64 313 483 187  12],214,5,1992,3.898238747553816,80.0,20.0
511,0,511,[ 64 313 483 187  12],618,5,1997,3.900390625,80.0,20.0
512,0,512,[118 588 435  50   1],297,2,1999,3.8966861598440548,0.0,20.0
513,0,513,[ 64 313 483 187  12],618,5,2004,3.8988326848249026,80.0,20.0
514,0,514,[ 25  12  22 357 118],416,4,2008,3.899029126213592,20.0,0.0
515,0,515,[328  50 289 423  71],43,5,2013,3.9011627906976742,0.0,20.0
516,0,516,[313 483  64 187  12],618,5,2018,3.9032882011605414,80.0,20.0
517,0,517,[  1 318 405 144 174],654,5,2023,3.9054054054054053,20.0,0.0
518,0,518,[ 64 313 483 187  12],618,5,2028,3.907514450867052,80.0,20.0
519,0,519,[333 282 238 597 111],854,1,2029,3.901923076923077,0.0,0.0
520,0,520,[176  82 423 238 235],416,4,2033,3.9021113243762,0.0,0.0
521,0,521,[ 64 313 483 187  12],214,5,2038,3.9042145593869733,80.0,20.0
522,0,522,[197 496 182 174 144],342,4,2042,3.904397705544933,0.0,0.0
523,0,523,[271 275 117 238 257],62,3,2045,3.9026717557251906,0.0,0.0
524,0,524,[268  50 204 245 100],297,3,2048,3.900952380952381,0.0,20.0
525,0,525,[405 288 403  50  79],345,3,2051,3.8992395437262357,0.0,40.0
526,0,526,[ 64 313 483 187  12],214,5,2056,3.901328273244782,80.0,20.0
527,0,527,[173  12  88 655 282],588,4,2060,3.9015151515151514,20.0,0.0
528,0,528,[161 173 288 238  97],618,2,2062,3.8979206049149338,0.0,20.0
529,0,529,[181 258 118 187  15],198,3,2065,3.8962264150943398,0.0,20.0
530,0,530,[475 179 323 117 211],416,2,2067,3.8926553672316384,0.0,0.0
531,0,531,[168 655 323  70 182],198,3,2070,3.8909774436090228,0.0,0.0
532,0,532,[265 258 294 237 603],416,4,2074,3.8911819887429644,0.0,0.0
533,0,533,[ 64 313 483 187  12],618,5,2079,3.893258426966292,80.0,20.0
534,0,534,[ 64 313 483 187  12],214,5,2084,3.8953271028037384,80.0,20.0
535,0,535,[282 496  11 125  88],342,2,2086,3.8917910447761193,0.0,0.0
536,0,536,[ 69 204 318  97 173],416,5,2091,3.893854748603352,20.0,0.0
537,0,537,[132  12 427 168 288],618,4,2095,3.8940520446096656,20.0,20.0
538,0,538,[237  22 204 100 118],618,3,2098,3.8923933209647497,0.0,0.0
539,0,539,[ 56 282 496 182 313],416,5,2103,3.8944444444444444,20.0,20.0
540,0,540,[588 237 216 475 748],297,4,2107,3.8946395563770797,0.0,0.0
541,0,541,[258 118 174 168 508],62,4,2111,3.8948339483394836,0.0,0.0
542,0,542,[655  96  82 194 196],373,4,2115,3.8950276243093924,0.0,0.0
543,0,543,[ 64 313 483 187  12],214,5,2120,3.8970588235294117,80.0,20.0
544,0,544,[ 64 313 483 187  12],214,5,2125,3.8990825688073394,80.0,20.0
545,0,545,[268  50 196 202  28],345,3,2128,3.8974358974358974,0.0,20.0
546,0,546,[ 64 313 483 187  12],618,5,2133,3.8994515539305303,80.0,20.0
547,0,547,[237 289 275 748  69],416,3,2136,3.897810218978102,0.0,0.0
548,0,548,[ 64 313 483 187  12],214,5,2141,3.8998178506375227,80.0,20.0
549,0,549,[ 64 313 483 187  12],618,5,2146,3.901818181818182,80.0,20.0
550,0,550,[ 64 313 483 187  12],214,5,2151,3.9038112522686026,80.0,20.0
551,0,551,[ 64 313 483 187  12],214,5,2156,3.9057971014492754,80.0,20.0
552,0,552,[471 176  95 125 245],416,3,2159,3.904159132007233,0.0,0.0
553,0,553,[286  88  79 237  25],416,3,2162,3.9025270758122743,0.0,0.0
554,0,554,[ 64 313 483 187  12],214,5,2167,3.9045045045045046,80.0,20.0
555,0,555,[191 161  11   7 655],618,5,2172,3.906474820143885,0.0,0.0
556,0,556,[ 64 313 483 187  12],214,5,2177,3.9084380610412928,80.0,20.0
557,0,557,[ 64 313 483 187  12],214,5,2182,3.910394265232975,80.0,20.0
558,0,558,[238 275 172 302 180],62,4,2186,3.9105545617173525,0.0,0.0
559,0,559,[313  64 483 187  12],618,5,2191,3.9125,80.0,20.0
560,0,560,[258 173 302  50 216],654,5,2196,3.914438502673797,0.0,20.0
561,0,561,[294   4 508 173  70],417,3,2199,3.912811387900356,0.0,0.0
562,0,562,[313  64 483 187  12],214,5,2204,3.9147424511545292,80.0,20.0
563,0,563,[235 273   8  98 318],416,4,2208,3.9148936170212765,20.0,20.0
564,0,564,[313  64 483 187  12],618,5,2213,3.9168141592920356,80.0,20.0
565,0,565,[181 238 265   8 173],437,4,2217,3.9169611307420493,0.0,20.0
566,0,566,[  9 427 127  71 300],24,5,2222,3.9188712522045854,0.0,0.0
567,0,567,[313  64 483 187  12],214,5,2227,3.920774647887324,80.0,20.0
568,0,568,[313  64 483 187  12],618,5,2232,3.922671353251318,80.0,20.0
569,0,569,[181 151  12 210   8],601,2,2234,3.9192982456140353,20.0,20.0
570,0,570,[187 655 132  96 168],198,5,2239,3.9211908931698773,0.0,0.0
571,0,571,[200 132 172 546 191],262,1,2240,3.9160839160839163,0.0,0.0
572,0,572,[313  64 483 187  12],214,5,2245,3.917975567190227,80.0,20.0
573,0,573,[313  64 483 187  12],618,5,2250,3.9198606271777003,80.0,20.0
574,0,574,[ 56 546  28 678 300],416,3,2253,3.9182608695652172,0.0,0.0
575,0,575,[427 172 276 151  98],198,4,2257,3.9184027777777777,0.0,20.0
576,0,576,[313  64 483 187  12],618,5,2262,3.920277296360485,80.0,20.0
577,0,577,[ 82 151  88  50 161],437,2,2264,3.916955017301038,0.0,20.0
578,0,578,[313  64 483 187  12],618,5,2269,3.918825561312608,80.0,20.0
579,0,579,[275   4 182  12 200],297,2,2271,3.9155172413793102,20.0,0.0
580,0,580,[357 179 222 197  96],198,4,2275,3.9156626506024095,0.0,0.0
581,0,581,[294 216 300 211 151],43,5,2280,3.917525773195876,0.0,0.0
582,0,582,[182 173 271 222 275],297,3,2283,3.9159519725557463,0.0,0.0
583,0,583,[313  64 483 187  12],618,5,2288,3.9178082191780823,80.0,20.0
584,0,584,[313  64 483 187  12],618,5,2293,3.9196581196581195,80.0,20.0
585,0,585,[313  64 483 187  12],618,5,2298,3.9215017064846416,80.0,20.0
586,0,586,[258  98 197 403  64],198,5,2303,3.9233390119250426,20.0,20.0
587,0,587,[313  64 483 187  12],214,5,2308,3.925170068027211,80.0,20.0
588,0,588,[216 228  98  70  50],417,2,2310,3.9219015280135823,0.0,40.0
589,0,589,[258 275  56  12  82],654,5,2315,3.9237288135593222,20.0,0.0
590,0,590,[183 179 265  28  11],405,2,2317,3.9204737732656514,0.0,0.0
591,0,591,[313  64 483 187  12],214,5,2322,3.9222972972972974,80.0,20.0
592,0,592,[313  64 483 187  12],618,5,2327,3.9241146711635753,80.0,20.0
593,0,593,[405 183  28 222 173],705,3,2330,3.9225589225589226,0.0,0.0
594,0,594,[313  64 483 187  12],214,5,2335,3.9243697478991595,80.0,20.0
595,0,595,[204  11 187 234 172],416,5,2340,3.9261744966442955,0.0,0.0
596,0,596,[403  64 197 269  88],345,4,2344,3.926298157453936,20.0,0.0
597,0,597,[ 64 313 483 187  12],618,5,2349,3.92809364548495,80.0,20.0
598,0,598,[ 64 313 483 187  12],618,5,2354,3.9298831385642736,80.0,20.0
599,0,599,[ 95 181 127 403 173],618,3,2357,3.9283333333333332,0.0,20.0
600,0,600,[323  82  25   9 183],805,3,2360,3.9267886855241265,0.0,0.0
601,0,601,[588 173  50 328 288],416,5,2365,3.9285714285714284,0.0,40.0
602,0,602,[748 125 100 211 515],416,5,2370,3.9303482587064678,0.0,0.0
603,0,603,[603  11 180 210 179],437,3,2373,3.9288079470198674,0.0,0.0
604,0,604,[ 64 313 483 187  12],214,5,2378,3.930578512396694,80.0,20.0
605,0,605,[ 64 313 483 187  12],214,5,2383,3.932343234323432,80.0,20.0
606,0,606,[322 200 125 235  12],854,2,2385,3.929159802306425,20.0,0.0
607,0,607,[289 275 181 194  12],416,4,2389,3.929276315789474,20.0,20.0
608,0,608,[168  25 111 405  15],128,3,2392,3.9277504105090313,0.0,0.0
609,0,609,[ 64 313 483 187  12],214,5,2397,3.9295081967213115,80.0,20.0
610,0,610,[ 64 313 483 187  12],618,5,2402,3.9312602291325693,80.0,20.0
611,0,611,[ 64 313 483 187  12],214,5,2407,3.933006535947712,80.0,20.0
612,0,612,[423 181 483 204 173],711,2,2409,3.929853181076672,20.0,20.0
613,0,613,[ 64 313 483 187  12],214,5,2414,3.9315960912052117,80.0,20.0
614,0,614,[ 64 313 483 187  12],618,5,2419,3.933333333333333,80.0,20.0
615,0,615,[268 200 405  15  25],854,2,2421,3.9301948051948052,0.0,0.0
616,0,616,[ 70 234 302 265 282],297,2,2423,3.927066450567261,0.0,0.0
617,0,617,[ 64 313 483 187  12],618,5,2428,3.928802588996764,80.0,20.0
618,0,618,[ 96 216 197 238 258],198,5,2433,3.9305331179321485,0.0,0.0
619,0,619,[ 64 313 483 187  12],618,5,2438,3.932258064516129,80.0,20.0
620,0,620,[215 173  15 153 143],373,4,2442,3.9323671497584543,0.0,0.0
621,0,621,[ 64 313 483 187  12],214,5,2447,3.9340836012861735,80.0,20.0
622,0,622,[121 385 300 237 322],416,3,2450,3.932584269662921,0.0,0.0
623,0,623,[288 235 273 180 271],854,4,2454,3.9326923076923075,0.0,20.0
624,0,624,[ 64 313 483 187  12],214,5,2459,3.9344,80.0,20.0
625,0,625,[197 234  97 282  82],416,5,2464,3.9361022364217253,0.0,0.0
626,0,626,[143 144 100 275 196],43,5,2469,3.937799043062201,0.0,0.0
627,0,627,[202 515 258 678 302],416,4,2473,3.9378980891719744,0.0,0.0
628,0,628,[ 96 385 195 568 196],373,4,2477,3.9379968203497615,0.0,0.0
629,0,629,[ 82 151 271  12 204],62,3,2480,3.9365079365079363,20.0,0.0
630,0,630,[ 64 313 483 187  12],618,5,2485,3.9381933438985737,80.0,20.0
631,0,631,[  1  69 597 172  15],618,4,2489,3.9382911392405062,0.0,0.0
632,0,632,[ 64 313 483 187  12],618,5,2494,3.939968404423381,80.0,20.0
633,0,633,[ 64 313 483 187  12],618,5,2499,3.941640378548896,80.0,20.0
634,0,634,[ 64 313 483 187  12],214,5,2504,3.943307086614173,80.0,20.0
635,0,635,[ 79  82 176 216 125],618,3,2507,3.941823899371069,0.0,0.0
636,0,636,[168 568 427 288 183],922,1,2508,3.937205651491366,0.0,20.0
637,0,637,[ 71 265 245  97 258],505,4,2512,3.93730407523511,0.0,0.0
638,0,638,[183  97 216 210 357],405,2,2514,3.9342723004694835,0.0,0.0
639,0,639,[318 385 121 258 200],345,3,2517,3.9328125,20.0,0.0
640,0,640,[313  64 483 187  12],214,5,2522,3.934477379095164,80.0,20.0
641,0,641,[ 95 288 568 228 176],417,2,2524,3.931464174454829,0.0,20.0
642,0,642,[313  64 483 187  12],618,5,2529,3.933125972006221,80.0,20.0
643,0,643,[302 265 176 257 182],417,2,2531,3.9301242236024843,0.0,0.0
644,0,644,[183 127 603 187 301],416,5,2536,3.931782945736434,0.0,0.0
645,0,645,[313  64 483 187  12],214,5,2541,3.93343653250774,80.0,20.0
646,0,646,[313  64 483 187  12],214,5,2546,3.935085007727975,80.0,20.0
647,0,647,[288 191 196 153   1],297,2,2548,3.932098765432099,0.0,20.0
648,0,648,[258  11 238 269 144],854,4,2552,3.9322033898305087,0.0,0.0
649,0,649,[313  64 483 187  12],214,5,2557,3.933846153846154,80.0,20.0
650,0,650,[313  64 483 187  12],618,5,2562,3.935483870967742,80.0,20.0
651,0,651,[121 195 100 237 111],618,3,2565,3.934049079754601,0.0,0.0
652,0,652,[211 333 195 257  97],416,4,2569,3.9341500765696784,0.0,0.0
653,0,653,[742   8 216 269 294],805,1,2570,3.929663608562691,0.0,0.0
654,0,654,[302 181 269  28 197],297,4,2574,3.929770992366412,0.0,20.0
655,0,655,[313 483  64 187  12],618,5,2579,3.9314024390243905,80.0,20.0
656,0,656,[568 294 405 286 546],416,4,2583,3.9315068493150687,0.0,0.0
657,0,657,[132  12 275 496  71],437,4,2587,3.93161094224924,20.0,0.0
658,0,658,[313 483  64 187  12],618,5,2592,3.9332321699544766,80.0,20.0
659,0,659,[313 483  64 187  12],618,5,2597,3.934848484848485,80.0,20.0
660,0,660,[  1 423 210 301 258],43,5,2602,3.9364599092284416,0.0,0.0
661,0,661,[655 216 191  15 245],345,4,2606,3.9365558912386707,0.0,0.0
662,0,662,[313  64 483 187  12],214,5,2611,3.93815987933635,80.0,20.0
663,0,663,[144 289 173  50 127],854,3,2614,3.9367469879518073,0.0,20.0
664,0,664,[185 132 186 143 385],230,4,2618,3.9368421052631577,0.0,0.0
665,0,665,[ 64 313 483 187  12],618,5,2623,3.9384384384384385,80.0,20.0
666,0,666,[ 64 313 483 187  12],214,5,2628,3.9400299850074965,80.0,20.0
667,0,667,[210  79 202 357 216],230,5,2633,3.941616766467066,0.0,0.0
668,0,668,[269 471  25 603 153],297,4,2637,3.9417040358744395,0.0,0.0
669,0,669,[172  50 125 748 294],907,5,2642,3.943283582089552,0.0,20.0
670,0,670,[216 597 173 211 258],416,4,2646,3.9433681073025335,0.0,0.0
671,0,671,[313  64 483 187  12],214,5,2651,3.9449404761904763,80.0,20.0
672,0,672,[ 95 235 185 427 318],416,3,2654,3.9435364041604757,20.0,0.0
673,0,673,[ 28  22 222 403 318],588,3,2657,3.9421364985163203,20.0,0.0
674,0,674,[175 357 603  28 655],373,3,2660,3.9407407407407407,0.0,0.0
675,0,675,[313  64 483 187  12],214,5,2665,3.9423076923076925,80.0,20.0
676,0,676,[313  64 483 187  12],618,5,2670,3.943870014771049,80.0,20.0
677,0,677,[ 12 238  50 143 172],601,2,2672,3.9410029498525074,20.0,20.0
678,0,678,[483  64 313 187 318],618,5,2677,3.9425625920471283,80.0,20.0
679,0,679,[125 423 318 742 202],314,5,2682,3.9441176470588237,20.0,0.0
680,0,680,[483  64 313 187 318],618,5,2687,3.9456681350954477,80.0,20.0
681,0,681,[568  82 423 273 179],805,1,2688,3.941348973607038,0.0,0.0
682,0,682,[ 64 313 483 187 318],618,5,2693,3.94289897510981,80.0,20.0
683,0,683,[ 64 313 483 187 318],214,5,2698,3.9444444444444446,80.0,20.0
684,0,684,[ 64 313 483 187 318],214,5,2703,3.945985401459854,80.0,20.0
685,0,685,[275  12  11 546 265],297,3,2706,3.944606413994169,20.0,0.0
686,0,686,[ 64 313 483 187 318],214,5,2711,3.946142649199418,80.0,20.0
687,0,687,[286   8 200 216 269],416,5,2716,3.947674418604651,0.0,0.0
688,0,688,[ 64 313 483 187 318],618,5,2721,3.949201741654572,80.0,20.0
689,0,689,[ 64 313 483 187 318],214,5,2726,3.9507246376811596,80.0,20.0
690,0,690,[  7 143 197 742 588],297,3,2729,3.9493487698986973,0.0,0.0
691,0,691,[ 64 313 483 187 318],618,5,2734,3.9508670520231215,80.0,20.0
692,0,692,[ 64 313 483 187 318],214,5,2739,3.9523809523809526,80.0,20.0
693,0,693,[202 238 318  82  25],373,3,2742,3.951008645533141,20.0,0.0
694,0,694,[ 64 313 483 187 318],214,5,2747,3.952517985611511,80.0,20.0
695,0,695,[ 79 135 603 117 100],854,4,2751,3.9525862068965516,0.0,0.0
696,0,696,[333  25 318  12 175],854,3,2754,3.951219512195122,40.0,0.0
697,0,697,[235 127 286 271  71],43,3,2757,3.9498567335243555,0.0,0.0
698,0,698,[313 237 216 191 195],416,4,2761,3.9499284692417738,20.0,20.0
699,0,699,[313  64 483 187 318],618,5,2766,3.9514285714285715,80.0,20.0
700,0,700,[228 294 100 245 302],417,2,2768,3.948644793152639,0.0,0.0
701,0,701,[313  64 483 187 318],214,5,2773,3.95014245014245,80.0,20.0
702,0,702,[181 121 405  25 655],128,3,2776,3.948790896159317,0.0,20.0
703,0,703,[496 257 678 181   4],416,3,2779,3.9474431818181817,0.0,20.0
704,0,704,[313  64 483 187 318],618,5,2784,3.948936170212766,80.0,20.0
705,0,705,[210 200 238 111 655],416,5,2789,3.95042492917847,0.0,0.0
706,0,706,[313  64 483 187 318],214,5,2794,3.951909476661952,80.0,20.0
707,0,707,[172 127 742  22 191],505,2,2796,3.9491525423728815,0.0,0.0
708,0,708,[ 82 182 215 194 200],405,2,2798,3.9464033850493654,0.0,0.0
709,0,709,[197 588 282 216  70],345,3,2801,3.945070422535211,0.0,0.0
710,0,710,[  9 197 403 191 276],618,2,2803,3.942334739803094,0.0,0.0
711,0,711,[ 64 483 313 187 318],618,5,2808,3.943820224719101,80.0,20.0
712,0,712,[ 64 483 313 187 318],618,5,2813,3.9453015427769986,80.0,20.0
713,0,713,[ 64 483 313 187 318],618,5,2818,3.946778711484594,80.0,20.0
714,0,714,[294 121 238  25 204],654,3,2821,3.9454545454545453,0.0,0.0
715,0,715,[ 64 483 313 187 318],618,5,2826,3.946927374301676,80.0,20.0
716,0,716,[ 64 483 313 187 318],214,5,2831,3.9483960948396093,80.0,20.0
717,0,717,[ 64 483 313 187 318],214,5,2836,3.949860724233983,80.0,20.0
718,0,718,[ 64 483 313 187 318],214,5,2841,3.9513212795549375,80.0,20.0
719,0,719,[ 64 483 313 187 318],618,5,2846,3.952777777777778,80.0,20.0
720,0,720,[132 302  56   8   4],416,5,2851,3.954230235783634,0.0,0.0
721,0,721,[111 216 515 269   7],416,5,2856,3.955678670360111,0.0,0.0
722,0,722,[ 64 483 313 187 318],214,5,2861,3.9571230982019365,80.0,20.0
723,0,723,[ 64 483 313 187 318],618,5,2866,3.958563535911602,80.0,20.0
724,0,724,[172 215 121 286  79],711,3,2869,3.9572413793103447,0.0,0.0
725,0,725,[423 294 135 357 111],417,3,2872,3.955922865013774,0.0,0.0
726,0,726,[483 313  64 187 318],618,5,2877,3.9573590096286106,80.0,20.0
727,0,727,[175 202 117   9 111],43,4,2881,3.9574175824175826,0.0,0.0
728,0,728,[483  64 313 187 318],618,5,2886,3.9588477366255144,80.0,20.0
729,0,729,[483  64 313 187 318],618,5,2891,3.9602739726027396,80.0,20.0
730,0,730,[118 179 176   7 200],416,3,2894,3.9589603283173735,0.0,0.0
731,0,731,[  8 568 181  22 173],654,4,2898,3.959016393442623,0.0,20.0
732,0,732,[ 64 313 483 187 318],618,5,2903,3.96043656207367,80.0,20.0
733,0,733,[ 64 313 483 187 318],214,5,2908,3.9618528610354224,80.0,20.0
734,0,734,[204  71 496 475 234],601,2,2910,3.9591836734693877,0.0,0.0
735,0,735,[385   1 211  88  11],43,5,2915,3.9605978260869565,0.0,0.0
736,0,736,[483  64 313 187 318],214,5,2920,3.962008141112619,80.0,20.0
737,0,737,[483  64 313 187 318],214,5,2925,3.9634146341463414,80.0,20.0
738,0,738,[475 185 187 302  56],416,4,2929,3.9634641407307174,0.0,0.0
739,0,739,[ 64 313 483 187 318],214,5,2934,3.964864864864865,80.0,20.0
740,0,740,[385 237 302 597 181],43,4,2938,3.9649122807017543,0.0,20.0
741,0,741,[ 64 313 483 187 318],618,5,2943,3.966307277628032,80.0,20.0
742,0,742,[ 64 313 483 187 318],214,5,2948,3.9676985195154777,80.0,20.0
743,0,743,[ 64 313 483 187 318],618,5,2953,3.9690860215053765,80.0,20.0
744,0,744,[385  98  50 403 202],805,3,2956,3.967785234899329,0.0,40.0
745,0,745,[742 215 269 111 300],297,1,2957,3.9638069705093835,0.0,0.0
746,0,746,[ 64 313 483 187 318],618,5,2962,3.965194109772423,80.0,20.0
747,0,747,[ 64 313 483 187 318],618,5,2967,3.966577540106952,80.0,20.0
748,0,748,[132 276 294  71  98],24,3,2970,3.965287049399199,0.0,20.0
749,0,749,[ 64 313 483 187 318],214,5,2975,3.966666666666667,80.0,20.0
750,0,750,[ 71 204  28 423  12],62,2,2977,3.96404793608522,20.0,0.0
751,0,751,[ 64 313 483 187 318],214,5,2982,3.9654255319148937,80.0,20.0
752,0,752,[210   4  95 588 257],642,4,2986,3.9654714475431607,0.0,0.0
753,0,753,[  1 748 385  28 235],805,1,2987,3.9615384615384617,0.0,0.0
754,0,754,[483  64 313 187 318],618,5,2992,3.962913907284768,80.0,20.0
755,0,755,[275 179 216 294 483],214,3,2995,3.9616402116402116,20.0,0.0
756,0,756,[483  64 313 187 318],618,5,3000,3.963011889035667,80.0,20.0
757,0,757,[435 191 210  22 143],405,4,3004,3.9630606860158313,0.0,0.0
758,0,758,[483  64 313 187 318],214,5,3009,3.964426877470356,80.0,20.0
759,0,759,[ 56  28 597  88 100],618,5,3014,3.9657894736842105,0.0,0.0
760,0,760,[ 64 313 483 187 318],214,5,3019,3.967148488830486,80.0,20.0
761,0,761,[111 100  12 238 182],49,3,3022,3.9658792650918637,20.0,0.0
762,0,762,[ 64 313 483 187 318],618,5,3027,3.967234600262123,80.0,20.0
763,0,763,[ 64 313 483 187 318],214,5,3032,3.968586387434555,80.0,20.0
764,0,764,[ 82 151 161 238 204],711,3,3035,3.9673202614379086,0.0,0.0
765,0,765,[ 64 313 483 187 318],214,5,3040,3.968668407310705,80.0,20.0
766,0,766,[ 69 117 161 257  64],705,4,3044,3.96870925684485,20.0,0.0
767,0,767,[483 313  64 187 318],214,5,3049,3.9700520833333335,80.0,20.0
768,0,768,[ 70 174 187 405 151],198,3,3052,3.9687906371911574,0.0,0.0
769,0,769,[173 257 276  70  69],43,5,3057,3.97012987012987,0.0,0.0
770,0,770,[483 313  64 187 318],214,5,3062,3.971465629053178,80.0,20.0
771,0,771,[180 111 275 100 568],62,3,3065,3.9702072538860103,0.0,0.0
772,0,772,[ 79 216 300 235 196],345,3,3068,3.9689521345407504,0.0,0.0
773,0,773,[313 483  64 187 318],618,5,3073,3.9702842377260983,80.0,20.0
774,0,774,[313 483  64 187 318],214,5,3078,3.9716129032258065,80.0,20.0
775,0,775,[ 15 603   1 508 228],128,4,3082,3.9716494845360826,0.0,0.0
776,0,776,[ 56  50 265 204 186],437,3,3085,3.9703989703989704,0.0,20.0
777,0,777,[313 483  64 187 318],618,5,3090,3.9717223650385605,80.0,20.0
778,0,778,[546 276 269 588 172],654,4,3094,3.9717586649550705,0.0,0.0
779,0,779,[678   1 333  28  56],416,4,3098,3.971794871794872,0.0,0.0
780,0,780,[132 100 742 183 235],62,4,3102,3.971830985915493,0.0,0.0
781,0,781,[588 187 135 237  22],618,5,3107,3.973145780051151,0.0,0.0
782,0,782,[302  56 655 273 603],416,5,3112,3.974457215836526,0.0,0.0
783,0,783,[313 483  64 187 318],214,5,3117,3.975765306122449,80.0,20.0
784,0,784,[385  64  71 322 515],416,4,3121,3.975796178343949,20.0,0.0
785,0,785,[ 12  98 195 161 423],417,4,3125,3.975826972010178,20.0,20.0
786,0,786,[238 568 427 302 286],416,5,3130,3.9771283354510802,0.0,0.0
787,0,787,[496 216 546 204 237],654,5,3135,3.978426395939086,0.0,0.0
788,0,788,[276 423  97 275 742],416,4,3139,3.9784537389100127,0.0,0.0
789,0,789,[ 69  89 588 151 568],417,2,3141,3.9759493670886075,0.0,0.0
790,0,790,[313 483  64 187 318],214,5,3146,3.97724399494311,80.0,20.0
791,0,791,[313 483  64 187 318],214,5,3151,3.9785353535353534,80.0,20.0
792,0,792,[121 125 181  28 182],230,4,3155,3.978562421185372,0.0,20.0
793,0,793,[427 127  12 204 288],405,5,3160,3.9798488664987404,20.0,20.0
794,0,794,[313 483  64 187 318],214,5,3165,3.981132075471698,80.0,20.0
795,0,795,[313 483  64 187 318],214,5,3170,3.9824120603015074,80.0,20.0
796,0,796,[313 483  64 187 318],214,5,3175,3.9836888331242157,80.0,20.0
797,0,797,[313 483  64 187 318],618,5,3180,3.9849624060150375,80.0,20.0
798,0,798,[313 483  64 187 318],214,5,3185,3.986232790988736,80.0,20.0
799,0,799,[302 174 161 245 275],416,4,3189,3.98625,0.0,0.0
800,0,800,[ 64 172 301 276 294],43,5,3194,3.9875156054931336,20.0,0.0
801,0,801,[313 483  64 187 318],618,5,3199,3.988778054862843,80.0,20.0
802,0,802,[313 483  64 187 318],214,5,3204,3.9900373599003736,80.0,20.0
803,0,803,[313 483  64 187 318],214,5,3209,3.9912935323383083,80.0,20.0
804,0,804,[258  25  71 144 111],711,2,3211,3.9888198757763975,0.0,0.0
805,0,805,[118  12 174 179  95],416,2,3213,3.9863523573200994,20.0,0.0
806,0,806,[127 180 286 161 186],417,4,3217,3.98636926889715,0.0,0.0
807,0,807,[269  25 111  88  50],805,3,3220,3.985148514851485,0.0,20.0
808,0,808,[216 196  28 168 172],805,2,3222,3.9826946847960447,0.0,0.0
809,0,809,[125 276 427 197  28],618,2,3224,3.9802469135802467,0.0,0.0
810,0,810,[ 64 313 483 187 318],214,5,3229,3.9815043156596794,80.0,20.0
811,0,811,[ 64 313 483 187 318],618,5,3234,3.9827586206896552,80.0,20.0
812,0,812,[ 64 111 273 423 186],854,3,3237,3.981549815498155,20.0,0.0
813,0,813,[132  71  97 191  56],405,3,3240,3.98034398034398,0.0,0.0
814,0,814,[ 25 172 194  15 174],921,3,3243,3.9791411042944786,0.0,0.0
815,0,815,[742 174 286 100 168],854,2,3245,3.9767156862745097,0.0,0.0
816,0,816,[200 118 168   1 405],887,4,3249,3.9767441860465116,0.0,0.0
817,0,817,[191 471 111 202  28],618,2,3251,3.9743276283618583,0.0,0.0
818,0,818,[ 64 588 197  25  12],416,5,3256,3.9755799755799757,40.0,0.0
819,0,819,[ 64 313 483 187 318],618,5,3261,3.976829268292683,80.0,20.0
820,0,820,[196 294 210 135 121],601,2,3263,3.97442143727162,0.0,0.0
821,0,821,[313  64 483 187 318],214,5,3268,3.975669099756691,80.0,20.0
822,0,822,[313  64 483 187 318],214,5,3273,3.976913730255164,80.0,20.0
823,0,823,[151 100 182 168 423],62,4,3277,3.9769417475728157,0.0,0.0
824,0,824,[183 471 435  22  82],505,3,3280,3.9757575757575756,0.0,0.0
825,0,825,[313  64 483 187 318],214,5,3285,3.976997578692494,80.0,20.0
826,0,826,[ 50 597  11 121 742],43,4,3289,3.977025392986699,0.0,20.0
827,0,827,[313  64 483 187 318],618,5,3294,3.9782608695652173,80.0,20.0
828,0,828,[313  64 483 187 318],618,5,3299,3.9794933655006033,80.0,20.0
829,0,829,[ 70 197 161 222 385],198,1,3300,3.9759036144578315,0.0,0.0
830,0,830,[265 216 210   9 313],416,5,3305,3.977135980746089,20.0,20.0
831,0,831,[ 64 313 483 187 318],618,5,3310,3.9783653846153846,80.0,20.0
832,0,832,[ 64 313 483 187 318],214,5,3315,3.979591836734694,80.0,20.0
833,0,833,[ 64 313 483 187 318],214,5,3320,3.9808153477218227,80.0,20.0
834,0,834,[ 64 313 483 187 318],214,5,3325,3.9820359281437128,80.0,20.0
835,0,835,[ 82  56 568 423  50],642,4,3329,3.9820574162679425,0.0,20.0
836,0,836,[ 98  15 257 748 127],417,4,3333,3.982078853046595,0.0,20.0
837,0,837,[328 313 174 216 357],416,5,3338,3.983293556085919,20.0,20.0
838,0,838,[588   9 282 125  70],764,5,3343,3.9845053635280094,0.0,0.0
839,0,839,[ 64 313 483 187 318],618,5,3348,3.9857142857142858,80.0,20.0
840,0,840,[ 64 100 423 204  15],62,2,3350,3.9833531510107014,20.0,0.0
841,0,841,[ 96 197 234 135 175],405,3,3353,3.982185273159145,0.0,0.0
842,0,842,[483  64 313 187 318],214,5,3358,3.9833926453143533,80.0,20.0
843,0,843,[288 483  98 318 172],496,4,3362,3.9834123222748814,40.0,40.0
844,0,844,[483  64 313 187 318],214,5,3367,3.9846153846153847,80.0,20.0
845,0,845,[222 286 357 275 508],297,5,3372,3.9858156028368796,0.0,0.0
846,0,846,[357 143  70 234  79],230,5,3377,3.987012987012987,0.0,0.0
847,0,847,[483  64 313 187 318],214,5,3382,3.9882075471698113,80.0,20.0
848,0,848,[483  64 313 187 318],214,5,3387,3.989399293286219,80.0,20.0
849,0,849,[483  64 313 187 318],618,5,3392,3.9905882352941178,80.0,20.0
850,0,850,[483  64 313 187 318],214,5,3397,3.991774383078731,80.0,20.0
851,0,851,[483  64 313 187 318],618,5,3402,3.992957746478873,80.0,20.0
852,0,852,[187 127  95 435  89],698,2,3404,3.9906213364595544,0.0,0.0
853,0,853,[483 313  64 318 187],214,5,3409,3.9918032786885247,80.0,20.0
854,0,854,[289  22  56   9   4],764,4,3413,3.991812865497076,0.0,0.0
855,0,855,[313 483  64 318 187],618,5,3418,3.9929906542056073,80.0,20.0
856,0,856,[173 318 237  64 182],618,4,3422,3.9929988331388566,40.0,0.0
857,0,857,[475 111 471 318 117],416,4,3426,3.993006993006993,20.0,0.0
858,0,858,[313 483  64 318 187],618,5,3431,3.994179278230501,80.0,20.0
859,0,859,[546 597 100 235 300],416,2,3433,3.9918604651162792,0.0,0.0
860,0,860,[313 483  64 318 187],214,5,3438,3.9930313588850175,80.0,20.0
861,0,861,[313 483  64 318 187],214,5,3443,3.9941995359628772,80.0,20.0
862,0,862,[ 70 173 181   1  50],43,5,3448,3.995365005793743,0.0,40.0
863,0,863,[  8 151  11 273  28],297,4,3452,3.9953703703703702,0.0,0.0
864,0,864,[313 483  64 318 187],618,5,3457,3.9965317919075143,80.0,20.0
865,0,865,[313 483  64 318 187],618,5,3462,3.9976905311778292,80.0,20.0
866,0,866,[268 427 273  15 286],416,5,3467,3.9988465974625145,0.0,0.0
867,0,867,[ 12  79 323 117 127],417,3,3470,3.9976958525345623,20.0,0.0
868,0,868,[603  79 127 118 323],805,3,3473,3.996547756041427,0.0,0.0
869,0,869,[313 483  64 318 187],214,5,3478,3.9977011494252874,80.0,20.0
870,0,870,[288 216 125 289 258],721,1,3479,3.994259471871412,0.0,20.0
871,0,871,[435 187  79 200 515],405,2,3481,3.99197247706422,0.0,0.0
872,0,872,[161 496 357 235 181],417,1,3482,3.988545246277205,0.0,20.0
873,0,873,[161  79 215  56 318],416,5,3487,3.9897025171624714,20.0,0.0
874,0,874,[210 234 294 742 143],230,5,3492,3.9908571428571427,0.0,0.0
875,0,875,[483  64 313 318 187],618,5,3497,3.9920091324200913,80.0,20.0
876,0,876,[483  64 313 318 187],214,5,3502,3.993158494868871,80.0,20.0
877,0,877,[191 655 228  98 117],198,3,3505,3.992027334851936,0.0,20.0
878,0,878,[172   1 216 385 168],922,2,3507,3.9897610921501707,0.0,0.0
879,0,879,[176 200 357 515 125],416,5,3512,3.9909090909090907,0.0,0.0
880,0,880,[210   8 234  28 144],297,3,3515,3.989784335981839,0.0,0.0
881,0,881,[ 50 265  96 237 403],198,3,3518,3.9886621315192743,0.0,20.0
882,0,882,[313  64 483 318 187],618,5,3523,3.9898074745186864,80.0,20.0
883,0,883,[ 11 276 194 100 234],416,4,3527,3.989819004524887,0.0,0.0
884,0,884,[151 181 245  15 475],416,2,3529,3.9875706214689264,0.0,20.0
885,0,885,[161 125 273 181 405],417,1,3530,3.984198645598194,0.0,20.0
886,0,886,[313  64 483 318 187],214,5,3535,3.9853438556933485,80.0,20.0
887,0,887,[187  97 300 174 385],505,4,3539,3.9853603603603602,0.0,0.0
888,0,888,[313 483  64 318 187],214,5,3544,3.986501687289089,80.0,20.0
889,0,889,[313 483  64 318 187],618,5,3549,3.987640449438202,80.0,20.0
890,0,890,[ 64  22 143 282 238],416,5,3554,3.988776655443322,20.0,0.0
891,0,891,[ 97 275 678 603 655],416,4,3558,3.9887892376681613,0.0,0.0
892,0,892,[313  64 483 318 187],618,5,3563,3.9899216125419934,80.0,20.0
893,0,893,[313  64 483 318 187],214,5,3568,3.9910514541387023,80.0,20.0
894,0,894,[132  71   4 385 200],416,5,3573,3.9921787709497205,0.0,0.0
895,0,895,[313  64 483 318 187],618,5,3578,3.9933035714285716,80.0,20.0
896,0,896,[222  97 172  50 215],62,3,3581,3.992196209587514,0.0,20.0
897,0,897,[313  64 483 318 187],618,5,3586,3.9933184855233854,80.0,20.0
898,0,898,[179 181 215 222 483],128,2,3588,3.9911012235817576,20.0,20.0
899,0,899,[ 64 313 483 318 187],214,5,3593,3.9922222222222223,80.0,20.0
900,0,900,[180   4 216  79 173],373,4,3597,3.9922308546059933,0.0,0.0
901,0,901,[483  64 313 318 187],214,5,3602,3.9933481152993346,80.0,20.0
902,0,902,[483  64 313 318 187],214,5,3607,3.9944629014396456,80.0,20.0
903,0,903,[483  64 313 318 187],618,5,3612,3.995575221238938,80.0,20.0
904,0,904,[483  64 313 318 187],618,5,3617,3.9966850828729283,80.0,20.0
905,0,905,[245 318 174 294 222],764,4,3621,3.9966887417218544,20.0,0.0
906,0,906,[483  64 313 318 187],618,5,3626,3.997794928335171,80.0,20.0
907,0,907,[  9 294 117  25 121],854,1,3627,3.9944933920704844,0.0,0.0
908,0,908,[168 185 181   4 435],297,3,3630,3.9933993399339935,0.0,20.0
909,0,909,[483  64 313 318 187],618,5,3635,3.9945054945054945,80.0,20.0
910,0,910,[475 117 245 197 265],297,2,3637,3.99231613611416,0.0,0.0
911,0,911,[204 100 235 181  25],805,2,3639,3.9901315789473686,0.0,20.0
912,0,912,[483  64 313 318 187],214,5,3644,3.991237677984666,80.0,20.0
913,0,913,[483  64 313 318 187],618,5,3649,3.9923413566739607,80.0,20.0
914,0,914,[196  12 235 318 215],345,4,3653,3.9923497267759562,40.0,0.0
915,0,915,[161 186 385 197 228],373,3,3656,3.9912663755458517,0.0,0.0
916,0,916,[483  64 313 318 187],618,5,3661,3.9923664122137406,80.0,20.0
917,0,917,[483  64 313 318 187],618,5,3666,3.9934640522875817,80.0,20.0
918,0,918,[483  64 313 318 187],618,5,3671,3.9945593035908598,80.0,20.0
919,0,919,[483  64 313 318 187],214,5,3676,3.9956521739130433,80.0,20.0
920,0,920,[483  64 313 318 187],214,5,3681,3.996742671009772,80.0,20.0
921,0,921,[483  64 313 318 187],618,5,3686,3.997830802603037,80.0,20.0
922,0,922,[135 597 483 144   4],62,3,3689,3.996749729144095,20.0,0.0
923,0,923,[161 179 196  11 144],751,3,3692,3.9956709956709955,0.0,0.0
924,0,924,[483  64 313 318 187],618,5,3697,3.996756756756757,80.0,20.0
925,0,925,[228 222 117 197  96],805,3,3700,3.9956803455723544,0.0,0.0
926,0,926,[483  64 313 318 187],214,5,3705,3.9967637540453076,80.0,20.0
927,0,927,[483  64 313 318 187],214,5,3710,3.997844827586207,80.0,20.0
928,0,928,[ 50 301 143 151 234],437,4,3714,3.9978471474703983,0.0,20.0
929,0,929,[ 64 313 483 318 187],618,5,3719,3.998924731182796,80.0,20.0
930,0,930,[ 64 313 483 318 187],618,5,3724,4.0,80.0,20.0
931,0,931,[ 64 313 483 318 187],618,5,3729,4.00107296137339,80.0,20.0
932,0,932,[ 64 313 483 318 187],214,5,3734,4.002143622722401,80.0,20.0
933,0,933,[ 64 313 483 318 187],618,5,3739,4.003211991434689,80.0,20.0
934,0,934,[ 11 300 153 196 172],751,3,3742,4.002139037433155,0.0,0.0
935,0,935,[ 12 151 286 273 196],416,4,3746,4.002136752136752,20.0,0.0
936,0,936,[288  64 195 216 475],214,4,3750,4.00213447171825,20.0,20.0
937,0,937,[211 496  28 172 742],230,5,3755,4.00319829424307,0.0,0.0
938,0,938,[ 64 313 483 318 187],214,5,3760,4.0042598509052185,80.0,20.0
939,0,939,[ 64 313 483 318 187],618,5,3765,4.00531914893617,80.0,20.0
940,0,940,[ 64 313 483 318 187],214,5,3770,4.006376195536663,80.0,20.0
941,0,941,[328 191  15 215 742],43,5,3775,4.007430997876858,0.0,0.0
942,0,942,[118 655  79 172 238],618,3,3778,4.006362672322376,0.0,0.0
943,0,943,[132 117  28 100 202],437,3,3781,4.005296610169491,0.0,0.0
944,0,944,[191 318 273  98  11],854,5,3786,4.006349206349206,20.0,20.0
945,0,945,[ 89 204  97 238 427],198,3,3789,4.005285412262157,0.0,0.0
946,0,946,[132 568  89   4 300],198,2,3791,4.003167898627244,0.0,0.0
947,0,947,[483  64 313 318 187],214,5,3796,4.0042194092827,80.0,20.0
948,0,948,[228 471 144 496 215],373,3,3799,4.003161222339305,0.0,0.0
949,0,949,[121 200 235 294 357],805,2,3801,4.001052631578947,0.0,0.0
950,0,950,[ 11 180 546 202 135],417,3,3804,4.0,0.0,0.0
951,0,951,[568 238 204 294 143],43,4,3808,4.0,0.0,0.0
952,0,952,[ 28 300 385  25 121],698,2,3810,3.9979013641133263,0.0,0.0
953,0,953,[ 64 483 313 318 187],214,5,3815,3.99895178197065,80.0,20.0
954,0,954,[ 64 483 313 318 187],618,5,3820,4.0,80.0,20.0
955,0,955,[127 276 172 202 151],618,2,3822,3.997907949790795,0.0,0.0
956,0,956,[ 98 328 174 182 237],505,3,3825,3.9968652037617556,0.0,20.0
957,0,957,[ 64 483 313 318 187],214,5,3830,3.997912317327766,80.0,20.0
958,0,958,[ 64 483 313 318 187],214,5,3835,3.9989572471324295,80.0,20.0
959,0,959,[ 64 483 313 318 187],618,5,3840,4.0,80.0,20.0
960,0,960,[161 168 196 121 301],43,5,3845,4.0010405827263265,0.0,0.0
961,0,961,[ 64 483 313 318 187],618,5,3850,4.002079002079002,80.0,20.0
962,0,962,[ 64 483 313 318 187],214,5,3855,4.003115264797508,80.0,20.0
963,0,963,[ 25 475 301 237 427],907,4,3859,4.003112033195021,0.0,0.0
964,0,964,[185  98 546  82 181],416,4,3863,4.003108808290156,0.0,40.0
965,0,965,[125 357 132 200 161],417,4,3867,4.003105590062112,0.0,0.0
966,0,966,[403 117  70  12 302],345,4,3871,4.003102378490175,20.0,0.0
967,0,967,[483  64 313 318 187],618,5,3876,4.0041322314049586,80.0,20.0
968,0,968,[ 12  50  64 322  22],416,4,3880,4.004127966976264,40.0,20.0
969,0,969,[ 64 228 238 427  22],601,4,3884,4.004123711340206,20.0,0.0
970,0,970,[153 117 568  28  82],62,3,3887,4.003089598352214,0.0,0.0
971,0,971,[ 64 483 313 318 187],214,5,3892,4.004115226337449,80.0,20.0
972,0,972,[ 56 132 496 173 135],601,4,3896,4.0041109969167525,0.0,0.0
973,0,973,[172 423 546 302 200],416,4,3900,4.0041067761806985,0.0,0.0
974,0,974,[ 64 483 313 318 187],214,5,3905,4.005128205128205,80.0,20.0
975,0,975,[ 64 483 313 318 187],618,5,3910,4.006147540983607,80.0,20.0
976,0,976,[322 275  88  70  71],128,3,3913,4.005117707267145,0.0,0.0
977,0,977,[ 64 483 313 318 187],618,5,3918,4.006134969325154,80.0,20.0
978,0,978,[204  50 176 234 423],297,2,3920,4.0040858018386105,0.0,20.0
979,0,979,[  8 202 215 294 475],588,3,3923,4.003061224489796,0.0,0.0
980,0,980,[194  15 301 508  88],342,1,3924,4.0,0.0,0.0
981,0,981,[423 161 496  70   1],128,4,3928,4.0,0.0,0.0
982,0,982,[ 70  69 228 196 328],62,2,3930,3.9979654120040693,0.0,0.0
983,0,983,[313 483  64 318 187],618,5,3935,3.9989837398373984,80.0,20.0
984,0,984,[471 172 202 111 318],43,4,3939,3.998984771573604,20.0,0.0
985,0,985,[185 275 216  98  56],214,4,3943,3.9989858012170387,0.0,20.0
986,0,986,[ 25 655 742   7  50],751,2,3945,3.9969604863221884,0.0,20.0
987,0,987,[313 483  64 318 187],618,5,3950,3.9979757085020244,80.0,20.0
988,0,988,[313 483  64 318 187],214,5,3955,3.998988877654196,80.0,20.0
989,0,989,[313 483  64 318 187],214,5,3960,4.0,80.0,20.0
990,0,990,[313 483  64 318 187],618,5,3965,4.001009081735621,80.0,20.0
991,0,991,[313 483  64 318 187],618,5,3970,4.002016129032258,80.0,20.0
992,0,992,[313 483  64 318 187],618,5,3975,4.003021148036254,80.0,20.0
993,0,993,[313 483  64 318 187],618,5,3980,4.0040241448692155,80.0,20.0
994,0,994,[197 405  95 228 427],198,2,3982,4.002010050251256,0.0,0.0
995,0,995,[313 483  64 318 187],214,5,3987,4.003012048192771,80.0,20.0
996,0,996,[313 483  64 318 187],618,5,3992,4.004012036108325,80.0,20.0
997,0,997,[286 423 273 173 483],62,3,3995,4.0030060120240485,20.0,0.0
998,0,998,[127 161 176 132 181],198,4,3999,4.003003003003003,0.0,20.0
999,0,999,[179 175 135 168  95],373,2,4001,4.001,0.0,0.0
1000,0,1000,[151 179 475 127 117],805,3,4004,4.0,0.0,0.0
1001,0,1001,[313 483  64 318 187],214,5,4009,4.000998003992016,80.0,20.0
1002,0,1002,[568 200 168  79 215],198,3,4012,4.0,0.0,0.0
1003,0,1003,[483  64 313 318 187],618,5,4017,4.000996015936255,80.0,20.0
1004,0,1004,[655 196   1 204 237],345,4,4021,4.000995024875622,0.0,0.0
1005,0,1005,[423 180 271  69 200],854,5,4026,4.001988071570577,0.0,0.0
1006,0,1006,[191 318 302  98 215],345,5,4031,4.002979145978153,20.0,20.0
1007,0,1007,[483  64 313 318 187],618,5,4036,4.003968253968254,80.0,20.0
1008,0,1008,[ 15 143 294 678  96],416,4,4040,4.0039643211100095,0.0,0.0
1009,0,1009,[ 12 603 174 161  97],373,4,4044,4.003960396039604,20.0,0.0
1010,0,1010,[216 238  95  89 215],198,4,4048,4.003956478733927,0.0,0.0
1011,0,1011,[318  22 191  15 144],854,2,4050,4.0019762845849804,20.0,0.0
1012,0,1012,[216 228 427 196 117],230,4,4054,4.001974333662389,0.0,0.0
1013,0,1013,[222  79 588 271 174],805,2,4056,4.0,0.0,0.0
1014,0,1014,[483  64 313 318 187],214,5,4061,4.000985221674877,80.0,20.0
1015,0,1015,[483  64 313 318 187],214,5,4066,4.001968503937008,80.0,20.0
1016,0,1016,[483  64 313 318 187],214,5,4071,4.002949852507375,80.0,20.0
1017,0,1017,[  8 423  28 173 301],43,5,4076,4.00392927308448,0.0,0.0
1018,0,1018,[117 191 202 204 135],297,2,4078,4.001962708537782,0.0,0.0
1019,0,1019,[ 64  89 144 471 194],373,3,4081,4.000980392156863,20.0,0.0
1020,0,1020,[ 64 483 313 318 187],214,5,4086,4.001958863858961,80.0,20.0
1021,0,1021,[ 64 483 313 318 187],618,5,4091,4.00293542074364,80.0,20.0
1022,0,1022,[423 294 405 181 286],416,5,4096,4.0039100684261975,0.0,20.0
1023,0,1023,[111 302 135   1 117],417,2,4098,4.001953125,0.0,0.0
1024,0,1024,[144 294 546 187  88],416,3,4101,4.000975609756098,0.0,0.0
1025,0,1025,[275 300 151 195  69],705,2,4103,3.9990253411306043,0.0,0.0
1026,0,1026,[427 234 742 179 546],416,3,4106,3.9980525803310614,0.0,0.0
1027,0,1027,[118 294 597 181   1],630,4,4110,3.998054474708171,0.0,20.0
1028,0,1028,[ 97  95 135  22  28],297,4,4114,3.998056365403304,0.0,0.0
1029,0,1029,[483  64 313 318 187],214,5,4119,3.999029126213592,80.0,20.0
1030,0,1030,[222 265 153 197 234],198,2,4121,3.997090203685742,0.0,0.0
1031,0,1031,[ 71 132 204  28 216],62,3,4124,3.996124031007752,0.0,0.0
1032,0,1032,[483  64 313 318 187],214,5,4129,3.9970958373668926,80.0,20.0
1033,0,1033,[135 132 423  88 318],711,4,4133,3.997098646034816,20.0,0.0
1034,0,1034,[181 655 222  50 742],588,3,4136,3.996135265700483,0.0,40.0
1035,0,1035,[483  64 313 318 187],618,5,4141,3.997104247104247,80.0,20.0
1036,0,1036,[483  64 313 318 187],618,5,4146,3.9980713596914175,80.0,20.0
1037,0,1037,[483  64 313 318 187],618,5,4151,3.9990366088631983,80.0,20.0
1038,0,1038,[483  64 313 318 187],618,5,4156,4.0,80.0,20.0
1039,0,1039,[100 118 748 173 197],437,4,4160,4.0,0.0,0.0
1040,0,1040,[ 22 168 204 313 328],416,5,4165,4.000960614793468,20.0,20.0
1041,0,1041,[483  64 313 318 187],214,5,4170,4.001919385796545,80.0,20.0
1042,0,1042,[483  64 313 318 187],214,5,4175,4.00287631831256,80.0,20.0
1043,0,1043,[483  64 313 318 187],214,5,4180,4.003831417624521,80.0,20.0
1044,0,1044,[322 286  98 191 403],416,4,4184,4.003827751196172,0.0,20.0
1045,0,1045,[483  64 313 318 187],618,5,4189,4.004780114722753,80.0,20.0
1046,0,1046,[173 118 275  28  69],43,5,4194,4.005730659025788,0.0,0.0
1047,0,1047,[313 483  64 318 187],214,5,4199,4.0066793893129775,80.0,20.0
1048,0,1048,[ 11 179 182  88 257],342,3,4202,4.005719733079123,0.0,0.0
1049,0,1049,[313 483  64 318 187],618,5,4207,4.006666666666667,80.0,20.0
1050,0,1050,[313 483  64 318 187],214,5,4212,4.007611798287345,80.0,20.0
1051,0,1051,[257 183 748 100 385],416,4,4216,4.007604562737643,0.0,0.0
1052,0,1052,[313 483  64 318 187],618,5,4221,4.0085470085470085,80.0,20.0
1053,0,1053,[313 483  64 318 187],214,5,4226,4.009487666034156,80.0,20.0
1054,0,1054,[313 483  64 318 187],618,5,4231,4.01042654028436,80.0,20.0
1055,0,1055,[313 483  64 318 187],214,5,4236,4.011363636363637,80.0,20.0
1056,0,1056,[211   9 288 496 276],416,4,4240,4.011352885525071,0.0,20.0
1057,0,1057,[313 483  64 318 187],618,5,4245,4.012287334593573,80.0,20.0
1058,0,1058,[135  11 742 151 275],297,3,4248,4.0113314447592066,0.0,0.0
1059,0,1059,[313 483  64 318 187],618,5,4253,4.0122641509433965,80.0,20.0
1060,0,1060,[313 483  64 318 187],618,5,4258,4.013195098963243,80.0,20.0
1061,0,1061,[313 483  64 318 187],214,5,4263,4.0141242937853105,80.0,20.0
1062,0,1062,[313 483  64 318 187],214,5,4268,4.015051740357479,80.0,20.0
1063,0,1063,[ 12 678 118 435  22],297,2,4270,4.0131578947368425,20.0,0.0
1064,0,1064,[215  64 258  50 403],711,4,4274,4.013145539906104,20.0,20.0
1065,0,1065,[173  64  79 568 181],345,5,4279,4.014071294559099,20.0,20.0
1066,0,1066,[313 483  64 318 187],618,5,4284,4.014995313964386,80.0,20.0
1067,0,1067,[313 483  64 318 187],618,5,4289,4.015917602996255,80.0,20.0
1068,0,1068,[ 97 403 216 197 265],373,2,4291,4.014031805425631,0.0,0.0
1069,0,1069,[333 475 318 603  25],854,3,4294,4.013084112149532,20.0,0.0
1070,0,1070,[238 302 173 288 427],416,5,4299,4.014005602240896,0.0,20.0
1071,0,1071,[ 98 435  69  97 603],405,2,4301,4.012126865671642,0.0,20.0
1072,0,1072,[313  64 483 318 187],618,5,4306,4.01304753028891,80.0,20.0
1073,0,1073,[313  64 483 318 187],214,5,4311,4.0139664804469275,80.0,20.0
1074,0,1074,[185 197   1 475 127],805,4,4315,4.013953488372093,0.0,0.0
1075,0,1075,[288  22 546 185 176],297,3,4318,4.0130111524163565,0.0,20.0
1076,0,1076,[ 70 127 245 588 179],416,3,4321,4.0120705663881155,0.0,0.0
1077,0,1077,[678 132  69 173  15],588,3,4324,4.01113172541744,0.0,0.0
1078,0,1078,[257 191 176 196 172],416,4,4328,4.01112140871177,0.0,0.0
1079,0,1079,[313  64 483 318 187],214,5,4333,4.012037037037037,80.0,20.0
1080,0,1080,[301 144  79 151  95],711,4,4337,4.012025901942645,0.0,0.0
1081,0,1081,[172 173  98 258 237],345,5,4342,4.012939001848429,0.0,20.0
1082,0,1082,[483 186 118 194 508],854,2,4344,4.011080332409972,20.0,0.0
1083,0,1083,[313  64 483 318 187],618,5,4349,4.0119926199261995,80.0,20.0
1084,0,1084,[269  70  79 196 385],416,5,4354,4.012903225806451,0.0,0.0
1085,0,1085,[151 121   8 258 195],654,5,4359,4.013812154696133,0.0,0.0
1086,0,1086,[603  95 174 173 204],416,4,4363,4.0137994480220796,0.0,0.0
1087,0,1087,[265 655  15 423  88],437,3,4366,4.012867647058823,0.0,0.0
1088,0,1088,[597 235   1 174  98],417,2,4368,4.011019283746556,0.0,20.0
1089,0,1089,[313  64 483 318 187],214,5,4373,4.011926605504587,80.0,20.0
1090,0,1090,[ 97  50 151 153 179],417,4,4377,4.011915673693859,0.0,20.0
1091,0,1091,[313  64 483 318 187],214,5,4382,4.012820512820513,80.0,20.0
1092,0,1092,[313  64 483 318 187],618,5,4387,4.0137236962488565,80.0,20.0
1093,0,1093,[313  64 483 318 187],214,5,4392,4.014625228519195,80.0,20.0
1094,0,1094,[313  64 483 318 187],214,5,4397,4.015525114155251,80.0,20.0
1095,0,1095,[313  64 483 318 187],214,5,4402,4.016423357664234,80.0,20.0
1096,0,1096,[ 97 423 302   9 196],416,5,4407,4.017319963536919,0.0,0.0
1097,0,1097,[313  64 483 318 187],214,5,4412,4.018214936247723,80.0,20.0
1098,0,1098,[313  64 483 318 187],214,5,4417,4.019108280254777,80.0,20.0
1099,0,1099,[597 655 127 483 182],618,5,4422,4.02,20.0,0.0
1100,0,1100,[313  64 483 318 187],618,5,4427,4.020890099909174,80.0,20.0
1101,0,1101,[403  50 132  25 238],373,3,4430,4.019963702359346,0.0,20.0
1102,0,1102,[313  64 483 318 187],618,5,4435,4.020852221214868,80.0,20.0
1103,0,1103,[471 161 179 127 191],416,4,4439,4.020833333333333,0.0,0.0
1104,0,1104,[173   8  79 168 127],416,5,4444,4.021719457013575,0.0,0.0
1105,0,1105,[333 258 286 496  64],416,5,4449,4.022603978300181,20.0,0.0
1106,0,1106,[313 483  64 318 187],214,5,4454,4.023486901535682,80.0,20.0
1107,0,1107,[100 173   8 143 121],416,5,4459,4.024368231046932,0.0,0.0
1108,0,1108,[313 483  64 318 187],618,5,4464,4.025247971145176,80.0,20.0
1109,0,1109,[  8 276 168  50   7],354,4,4468,4.025225225225225,0.0,20.0
1110,0,1110,[313 483  64 318 187],618,5,4473,4.0261026102610264,80.0,20.0
1111,0,1111,[313 483  64 318 187],214,5,4478,4.026978417266187,80.0,20.0
1112,0,1112,[313 483  64 318 187],214,5,4483,4.02785265049416,80.0,20.0
1113,0,1113,[313 483  64 318 187],214,5,4488,4.028725314183124,80.0,20.0
1114,0,1114,[313 483  64 318 187],618,5,4493,4.029596412556054,80.0,20.0
1115,0,1115,[183 515 211 168  97],230,4,4497,4.029569892473118,0.0,0.0
1116,0,1116,[313 483  64 318 187],618,5,4502,4.030438675022381,80.0,20.0
1117,0,1117,[313 483  64 318 187],214,5,4507,4.031305903398927,80.0,20.0
1118,0,1118,[313 483  64 318 187],618,5,4512,4.032171581769437,80.0,20.0
1119,0,1119,[181 496 508 294 245],417,2,4514,4.0303571428571425,0.0,20.0
1120,0,1120,[ 64 191 294 678 111],345,3,4517,4.029438001784121,20.0,0.0
1121,0,1121,[313 483  64 318 187],214,5,4522,4.03030303030303,80.0,20.0
1122,0,1122,[135  96 742 294 275],854,2,4524,4.028495102404274,0.0,0.0
1123,0,1123,[313 483  64 318 187],214,5,4529,4.029359430604982,80.0,20.0
1124,0,1124,[313 483  64 318 187],618,5,4534,4.030222222222222,80.0,20.0
1125,0,1125,[313 483  64 318 187],618,5,4539,4.031083481349911,80.0,20.0
1126,0,1126,[313 483  64 318 187],214,5,4544,4.031943212067436,80.0,20.0
1127,0,1127,[313 483  64 318 187],618,5,4549,4.032801418439717,80.0,20.0
1128,0,1128,[313 483  64 318 187],618,5,4554,4.033658104517272,80.0,20.0
1129,0,1129,[161   8 153 125  64],416,5,4559,4.034513274336283,20.0,0.0
1130,0,1130,[181 117  96 568 161],230,3,4562,4.033598585322723,0.0,20.0
1131,0,1131,[313 483  64 318 187],214,5,4567,4.034452296819788,80.0,20.0
1132,0,1132,[313 483  64 318 187],214,5,4572,4.035304501323918,80.0,20.0
1133,0,1133,[313 483  64 318 187],618,5,4577,4.0361552028218695,80.0,20.0
1134,0,1134,[313 483  64 318 187],618,5,4582,4.037004405286344,80.0,20.0
1135,0,1135,[313 483  64 318 187],214,5,4587,4.037852112676056,80.0,20.0
1136,0,1136,[ 25 301 204 153 222],297,4,4591,4.037818821459982,0.0,0.0
1137,0,1137,[286 235 216  97 318],43,4,4595,4.037785588752197,20.0,0.0
1138,0,1138,[200 288 235  64 118],345,2,4597,4.0359964881474975,20.0,20.0
1139,0,1139,[313 483  64 318 187],214,5,4602,4.036842105263158,80.0,20.0
1140,0,1140,[100 588 215  71  88],43,5,4607,4.037686240140228,0.0,0.0
1141,0,1141,[ 96  56 161  71 588],618,4,4611,4.037653239929948,0.0,0.0
1142,0,1142,[313 483  64 318 187],618,5,4616,4.038495188101487,80.0,20.0
1143,0,1143,[183 191 475  70   4],62,4,4620,4.038461538461538,0.0,0.0
1144,0,1144,[ 95 215 313 318  97],588,4,4624,4.038427947598254,40.0,20.0
1145,0,1145,[313 483  64 318 187],618,5,4629,4.039267015706806,80.0,20.0
1146,0,1146,[  7 286 174 187  88],416,4,4633,4.039232781168265,0.0,0.0
1147,0,1147,[238  12 211 210 111],417,3,4636,4.038327526132404,20.0,0.0
1148,0,1148,[176 132 127 238  71],618,4,4640,4.038294168842472,0.0,0.0
1149,0,1149,[ 96 196 202 182 117],618,3,4643,4.0373913043478264,0.0,0.0
1150,0,1150,[  8 496 222 271 181],43,4,4647,4.037358818418766,0.0,20.0
1151,0,1151,[228 269 222  11  50],805,3,4650,4.036458333333333,0.0,20.0
1152,0,1152,[ 11 183  69  15 111],417,3,4653,4.035559410234172,0.0,0.0
1153,0,1153,[313 483  64 318 187],214,5,4658,4.036395147313692,80.0,20.0
1154,0,1154,[288 269 176 127 118],805,2,4660,4.034632034632034,0.0,20.0
1155,0,1155,[258 294 288  79 245],416,4,4664,4.034602076124568,0.0,20.0
1156,0,1156,[313  64 483 318 187],214,5,4669,4.035436473638721,80.0,20.0
1157,0,1157,[313  64 483 318 187],214,5,4674,4.036269430051814,80.0,20.0
1158,0,1158,[313  64 483 318 187],618,5,4679,4.037100949094047,80.0,20.0
1159,0,1159,[191 405 211 196 496],416,5,4684,4.037931034482758,0.0,0.0
1160,0,1160,[ 22 475  96 176 742],805,3,4687,4.037037037037037,0.0,0.0
1161,0,1161,[748 176 125   4 405],417,3,4690,4.036144578313253,0.0,0.0
1162,0,1162,[313  64 483 318 187],214,5,4695,4.036973344797937,80.0,20.0
1163,0,1163,[173 288 237 135 475],62,3,4698,4.036082474226804,0.0,20.0
1164,0,1164,[276  71 265 546 202],416,3,4701,4.03519313304721,0.0,0.0
1165,0,1165,[ 64 483 313 318 187],214,5,4706,4.036020583190394,80.0,20.0
1166,0,1166,[471 191 257 210 271],297,1,4707,4.033419023136247,0.0,0.0
1167,0,1167,[ 64 483 313 318 187],618,5,4712,4.034246575342466,80.0,20.0
1168,0,1168,[238 173 515 187 333],416,5,4717,4.035072711719418,0.0,0.0
1169,0,1169,[215 181 191  79 200],405,4,4721,4.035042735042735,0.0,20.0
1170,0,1170,[127 288 245 496  82],417,3,4724,4.034158838599487,0.0,20.0
1171,0,1171,[475 127 180 238 275],62,5,4729,4.034982935153583,0.0,0.0
1172,0,1172,[313 483  64 318 187],214,5,4734,4.035805626598465,80.0,20.0
1173,0,1173,[313 483  64 318 187],214,5,4739,4.0366269165247015,80.0,20.0
1174,0,1174,[196  88  50  70 286],345,4,4743,4.036595744680851,0.0,20.0
1175,0,1175,[294 100 196 216 111],345,4,4747,4.03656462585034,0.0,0.0
1176,0,1176,[294 742  82 204 111],128,3,4750,4.035683942225998,0.0,0.0
1177,0,1177,[313 483  64 318 187],618,5,4755,4.036502546689304,80.0,20.0
1178,0,1178,[313 483  64 318 187],618,5,4760,4.037319762510602,80.0,20.0
1179,0,1179,[ 97 161 655 168 194],373,4,4764,4.03728813559322,0.0,0.0
1180,0,1180,[185 300 121 268 125],416,5,4769,4.038103302286198,0.0,0.0
1181,0,1181,[678 234 333 181 111],416,4,4773,4.038071065989848,0.0,20.0
1182,0,1182,[174 294   7 176 187],416,5,4778,4.038884192730347,0.0,0.0
1183,0,1183,[313 483  64 318 187],618,5,4783,4.039695945945946,80.0,20.0
1184,0,1184,[313 483  64 318 187],214,5,4788,4.040506329113924,80.0,20.0
1185,0,1185,[313 483  64 318 187],214,5,4793,4.041315345699831,80.0,20.0
1186,0,1186,[313 483  64 318 187],214,5,4798,4.04212299915754,80.0,20.0
1187,0,1187,[273 508 100 215  50],297,4,4802,4.042087542087542,0.0,20.0
1188,0,1188,[313 483  64 318 187],214,5,4807,4.042893187552565,80.0,20.0
1189,0,1189,[ 70 215 191   8 238],62,3,4810,4.042016806722689,0.0,0.0
1190,0,1190,[313 483  64 318 187],214,5,4815,4.0428211586901766,80.0,20.0
1191,0,1191,[ 12 294  95 185 427],416,4,4819,4.042785234899329,20.0,0.0
1192,0,1192,[ 50 222 118 273  89],805,3,4822,4.0419111483654655,0.0,20.0
1193,0,1193,[483 313  64 318 187],214,5,4827,4.042713567839196,80.0,20.0
1194,0,1194,[483 313  64 318 187],618,5,4832,4.043514644351465,80.0,20.0
1195,0,1195,[111  70 121 135  69],437,1,4833,4.040969899665551,0.0,0.0
1196,0,1196,[483 313  64 318 187],214,5,4838,4.041771094402673,80.0,20.0
1197,0,1197,[ 98 313  12  15 194],416,5,4843,4.042570951585977,40.0,40.0
1198,0,1198,[313 483  64 318 187],618,5,4848,4.043369474562135,80.0,20.0
1199,0,1199,[ 56 568  12  11 313],345,5,4853,4.0441666666666665,40.0,20.0
1200,0,1200,[313 483  64 318 187],618,5,4858,4.04496253122398,80.0,20.0
1201,0,1201,[180  95 273 197 235],805,1,4859,4.042429284525791,0.0,0.0
1202,0,1202,[168 132  96  79 302],405,3,4862,4.041562759767248,0.0,0.0
1203,0,1203,[ 64 483 313 318 187],618,5,4867,4.042358803986711,80.0,20.0
1204,0,1204,[197  79 496 185 121],711,4,4871,4.042323651452282,0.0,0.0
1205,0,1205,[185 191 403 204 238],618,3,4874,4.041459369817579,0.0,0.0
1206,0,1206,[ 64 483 313 318 187],618,5,4879,4.042253521126761,80.0,20.0
1207,0,1207,[195 100 175 748  11],198,1,4880,4.039735099337748,0.0,0.0
1208,0,1208,[313 483  64 318 187],618,5,4885,4.040529363110008,80.0,20.0
1209,0,1209,[313 483  64 318 187],214,5,4890,4.041322314049586,80.0,20.0
1210,0,1210,[568 153  88 603 181],373,5,4895,4.0421139554087535,0.0,20.0
1211,0,1211,[313 483  64 318 187],214,5,4900,4.042904290429043,80.0,20.0
1212,0,1212,[186  12  56 135 185],437,4,4904,4.042868920032976,20.0,0.0
1213,0,1213,[273  64 183  70  15],618,3,4907,4.042009884678748,20.0,0.0
1214,0,1214,[ 95 194 269 216 234],297,2,4909,4.040329218106996,0.0,0.0
1215,0,1215,[144  70 151 238 173],417,4,4913,4.040296052631579,0.0,0.0
1216,0,1216,[313 483  64 318 187],214,5,4918,4.041084634346754,80.0,20.0
1217,0,1217,[144   8 121 288 197],437,2,4920,4.039408866995074,0.0,20.0
1218,0,1218,[100 183 117 179 194],416,4,4924,4.039376538146021,0.0,0.0
1219,0,1219,[313 483  64 318 187],618,5,4929,4.0401639344262295,80.0,20.0
1220,0,1220,[313 483  64 318 187],214,5,4934,4.040950040950041,80.0,20.0
1221,0,1221,[313 483  64 318 187],214,5,4939,4.041734860883797,80.0,20.0
1222,0,1222,[313 483  64 318 187],214,5,4944,4.042518397383483,80.0,20.0
1223,0,1223,[403  71 568 748 405],345,2,4946,4.040849673202614,0.0,0.0
1224,0,1224,[328 215 496  15 288],416,5,4951,4.0416326530612245,0.0,20.0
1225,0,1225,[483 313  64 318 187],214,5,4956,4.0424143556280585,80.0,20.0
1226,0,1226,[117  98 204 111  11],618,3,4959,4.041564792176039,0.0,20.0
1227,0,1227,[258 111 204   1   4],43,5,4964,4.042345276872964,0.0,0.0
1228,0,1228,[483 313  64 318 187],214,5,4969,4.043124491456469,80.0,20.0
1229,0,1229,[174 357 179 588 235],417,2,4971,4.041463414634146,0.0,0.0
1230,0,1230,[483 313  64 318 187],618,5,4976,4.042242079610073,80.0,20.0
1231,0,1231,[ 50 111  22 471 204],721,5,4981,4.04301948051948,0.0,20.0
1232,0,1232,[483 313  64 318 187],214,5,4986,4.043795620437956,80.0,20.0
1233,0,1233,[483 313  64 318 187],214,5,4991,4.044570502431118,80.0,20.0
1234,0,1234,[483 313  64 318 187],618,5,4996,4.045344129554656,80.0,20.0
1235,0,1235,[483 313  64 318 187],618,5,5001,4.046116504854369,80.0,20.0
1236,0,1236,[483 313  64 318 187],618,5,5006,4.046887631366209,80.0,20.0
1237,0,1237,[483 313  64 318 187],618,5,5011,4.0476575121163165,80.0,20.0
1238,0,1238,[385 172  97 568 204],198,1,5012,4.045197740112994,0.0,0.0
1239,0,1239,[ 96 515 195   9 294],416,5,5017,4.045967741935484,0.0,0.0
1240,0,1240,[300  11  89 655 100],751,1,5018,4.043513295729251,0.0,0.0
1241,0,1241,[195  64 200  25 151],416,4,5022,4.043478260869565,20.0,0.0
1242,0,1242,[483  64 313 318 187],214,5,5027,4.04424778761062,80.0,20.0
1243,0,1243,[483  64 313 318 187],618,5,5032,4.045016077170418,80.0,20.0
1244,0,1244,[483  64 313 318 187],618,5,5037,4.04578313253012,80.0,20.0
1245,0,1245,[ 71 603 655 323 597],805,2,5039,4.044141252006421,0.0,0.0
1246,0,1246,[483  64 313 318 187],214,5,5044,4.044907778668805,80.0,20.0
1247,0,1247,[483  64 313 318 187],214,5,5049,4.045673076923077,80.0,20.0
1248,0,1248,[ 79 151  98 235 181],345,4,5053,4.045636509207366,0.0,40.0
1249,0,1249,[328 238 216 151 275],43,4,5057,4.0456,0.0,0.0
1250,0,1250,[483  64 313 318 187],618,5,5062,4.046362909672262,80.0,20.0
1251,0,1251,[483  64 313 318 187],214,5,5067,4.047124600638978,80.0,20.0
1252,0,1252,[483  64 313 318 187],214,5,5072,4.047885075818037,80.0,20.0
1253,0,1253,[195 174 748 276  79],416,4,5076,4.047846889952153,0.0,0.0
1254,0,1254,[200  97 204 100 276],437,4,5080,4.047808764940239,0.0,0.0
1255,0,1255,[174  88 302  15  50],345,5,5085,4.048566878980892,0.0,20.0
1256,0,1256,[ 64 313 483 318 187],214,5,5090,4.049323786793954,80.0,20.0
1257,0,1257,[ 64 313 483 318 187],214,5,5095,4.0500794912559615,80.0,20.0
1258,0,1258,[228  79  15 151 275],921,2,5097,4.048451151707704,0.0,0.0
1259,0,1259,[ 64 313 483 318 187],214,5,5102,4.049206349206349,80.0,20.0
1260,0,1260,[ 95 318 237 118 265],588,3,5105,4.048374306106265,20.0,0.0
1261,0,1261,[ 64 313 483 318 187],618,5,5110,4.049128367670365,80.0,20.0
1262,0,1262,[235 179 269 471 194],416,3,5113,4.048297703879651,0.0,0.0
1263,0,1263,[ 64 313 483 318 187],618,5,5118,4.049050632911392,80.0,20.0
1264,0,1264,[ 64 313 483 318 187],214,5,5123,4.049802371541502,80.0,20.0
1265,0,1265,[ 64 313 483 318 187],618,5,5128,4.050552922590837,80.0,20.0
1266,0,1266,[289 172  64 176  50],416,4,5132,4.050513022888714,20.0,20.0
1267,0,1267,[ 64 313 483 318 187],214,5,5137,4.051261829652997,80.0,20.0
1268,0,1268,[ 64 313 483 318 187],214,5,5142,4.052009456264775,80.0,20.0
1269,0,1269,[ 64 313 483 318 187],618,5,5147,4.052755905511811,80.0,20.0
1270,0,1270,[ 64 313 483 318 187],618,5,5152,4.053501180173092,80.0,20.0
1271,0,1271,[ 64 313 483 318 187],618,5,5157,4.054245283018868,80.0,20.0
1272,0,1272,[ 64 313 483 318 187],214,5,5162,4.054988216810683,80.0,20.0
1273,0,1273,[174 135 215 161  69],922,1,5163,4.052590266875981,0.0,0.0
1274,0,1274,[ 64 313 483 318 187],618,5,5168,4.053333333333334,80.0,20.0
1275,0,1275,[ 64 313 483 318 187],618,5,5173,4.054075235109718,80.0,20.0
1276,0,1276,[118   1 168 268   4],417,4,5177,4.054032889584965,0.0,0.0
1277,0,1277,[483 313  64 318 187],618,5,5182,4.054773082942097,80.0,20.0
1278,0,1278,[483 313  64 318 187],214,5,5187,4.055512118842846,80.0,20.0
1279,0,1279,[275 318 173 483 286],711,4,5191,4.05546875,40.0,0.0
1280,0,1280,[245  64 237 210 288],642,4,5195,4.055425448868072,20.0,20.0
1281,0,1281,[235  56 588 118 127],417,3,5198,4.054602184087363,0.0,0.0
1282,0,1282,[ 64 483 313 318 187],618,5,5203,4.055339049103663,80.0,20.0
1283,0,1283,[ 64 483 313 318 187],214,5,5208,4.05607476635514,80.0,20.0
1284,0,1284,[300 191 215  69 268],416,5,5213,4.056809338521401,0.0,0.0
1285,0,1285,[515 294  69 185  50],416,5,5218,4.057542768273717,0.0,20.0
1286,0,1286,[172  50 215  56 568],345,5,5223,4.058275058275059,0.0,20.0
1287,0,1287,[483  64 313 318 187],214,5,5228,4.059006211180124,80.0,20.0
1288,0,1288,[196 235 228 258  71],805,0,5228,4.055857253685027,0.0,0.0
1289,0,1289,[111 216 423 196 588],654,5,5233,4.056589147286822,0.0,0.0
1290,0,1290,[202 423 196 403 435],405,3,5236,4.055770720371805,0.0,0.0
1291,0,1291,[  4  12 275 328 302],43,5,5241,4.056501547987616,20.0,0.0
1292,0,1292,[ 11 323 197 286 161],345,2,5243,4.054911059551431,0.0,0.0
1293,0,1293,[204 202 275 161 483],588,3,5246,4.054095826893354,20.0,0.0
1294,0,1294,[313  64 483 318 187],214,5,5251,4.054826254826255,80.0,20.0
1295,0,1295,[313  64 483 318 187],618,5,5256,4.055555555555555,80.0,20.0
1296,0,1296,[313  64 483 318 187],618,5,5261,4.056283731688512,80.0,20.0
1297,0,1297,[322  25 125 323  64],417,2,5263,4.054699537750385,20.0,0.0
1298,0,1298,[301 173 515 215  22],416,5,5268,4.055427251732102,0.0,0.0
1299,0,1299,[313  64 483 318 187],618,5,5273,4.056153846153846,80.0,20.0
1300,0,1300,[  4 294 118 403 210],62,3,5276,4.055342044581091,0.0,0.0
1301,0,1301,[172 174 181  15  22],588,4,5280,4.055299539170507,0.0,20.0
1302,0,1302,[ 79 245 143 195   7],297,2,5282,4.053722179585572,0.0,0.0
1303,0,1303,[313  64 483 318 187],618,5,5287,4.054447852760736,80.0,20.0
1304,0,1304,[111 144 286 197 748],437,2,5289,4.052873563218391,0.0,0.0
1305,0,1305,[174 289 245 471 179],721,3,5292,4.0520673813169985,0.0,0.0
1306,0,1306,[  7 121 222 546 127],417,1,5293,4.049732211170619,0.0,0.0
1307,0,1307,[185 121 197 678 211],416,4,5297,4.049694189602446,0.0,0.0
1308,0,1308,[238  15  79 508 588],654,3,5300,4.048892284186402,0.0,0.0
1309,0,1309,[ 64 313 483 318 187],214,5,5305,4.049618320610687,80.0,20.0
1310,0,1310,[496 257  82   7 357],416,4,5309,4.049580472921434,0.0,0.0
1311,0,1311,[ 96 185 515 196 588],230,4,5313,4.0495426829268295,0.0,0.0
1312,0,1312,[144 515 222  89 427],698,3,5316,4.048743335872048,0.0,0.0
1313,0,1313,[ 64 313 483 318 187],214,5,5321,4.049467275494672,80.0,20.0
1314,0,1314,[ 64 313 483 318 187],214,5,5326,4.050190114068441,80.0,20.0
1315,0,1315,[385 174  98  69 100],43,5,5331,4.050911854103344,0.0,20.0
1316,0,1316,[ 64 313 483 318 187],214,5,5336,4.051632498101746,80.0,20.0
1317,0,1317,[ 64 313 483 318 187],618,5,5341,4.052352048558422,80.0,20.0
1318,0,1318,[ 64 313 483 318 187],618,5,5346,4.053070507960576,80.0,20.0
1319,0,1319,[ 64 313 483 318 187],618,5,5351,4.053787878787879,80.0,20.0
1320,0,1320,[ 64 313 483 318 187],618,5,5356,4.05450416351249,80.0,20.0
1321,0,1321,[ 64 313 483 318 187],214,5,5361,4.055219364599092,80.0,20.0
1322,0,1322,[258 173  56 204  71],922,3,5364,4.054421768707483,0.0,0.0
1323,0,1323,[ 64 313 483 318 187],618,5,5369,4.055135951661631,80.0,20.0
1324,0,1324,[546  28   8 195 176],62,4,5373,4.0550943396226415,0.0,0.0
1325,0,1325,[173  88 423 313 588],618,4,5377,4.055052790346908,20.0,20.0
1326,0,1326,[ 64 313 483 318 187],214,5,5382,4.055764883195177,80.0,20.0
1327,0,1327,[ 64 313 483 318 187],214,5,5387,4.056475903614458,80.0,20.0
1328,0,1328,[258 174 273  89 597],417,2,5389,4.054928517682468,0.0,0.0
1329,0,1329,[ 64 313 483 318 187],618,5,5394,4.055639097744361,80.0,20.0
1330,0,1330,[ 64 313 483 318 187],618,5,5399,4.0563486100676185,80.0,20.0
1331,0,1331,[ 64 313 483 318 187],618,5,5404,4.057057057057057,80.0,20.0
1332,0,1332,[ 64 313 483 318 187],618,5,5409,4.057764441110278,80.0,20.0
1333,0,1333,[181 132  69 174   8],230,5,5414,4.058470764617691,0.0,20.0
1334,0,1334,[ 64 313 483 318 187],618,5,5419,4.059176029962547,80.0,20.0
1335,0,1335,[238  12 588 276 215],437,3,5422,4.058383233532934,20.0,0.0
1336,0,1336,[ 56 276 245  28 117],128,3,5425,4.057591623036649,0.0,0.0
1337,0,1337,[302 216 275 153 143],43,5,5430,4.058295964125561,0.0,0.0
1338,0,1338,[ 64 313 483 318 187],618,5,5435,4.058999253174011,80.0,20.0
1339,0,1339,[ 64 313 483 318 187],214,5,5440,4.059701492537314,80.0,20.0
1340,0,1340,[ 79  97 132   8 294],230,5,5445,4.060402684563758,0.0,0.0
1341,0,1341,[ 64 313 483 318 187],618,5,5450,4.061102831594635,80.0,20.0
1342,0,1342,[ 64 313 483 318 187],618,5,5455,4.061801935964259,80.0,20.0
1343,0,1343,[168 357 111 238 286],297,4,5459,4.0617559523809526,0.0,0.0
1344,0,1344,[313  64 483 318 187],618,5,5464,4.062453531598513,80.0,20.0
1345,0,1345,[ 11 405 257 748 204],416,4,5468,4.062407132243685,0.0,0.0
1346,0,1346,[173  97 235 427  95],416,3,5471,4.061618411284336,0.0,0.0
1347,0,1347,[597 127  25 475  79],416,3,5474,4.060830860534125,0.0,0.0
1348,0,1348,[ 64 313 483 318 187],214,5,5479,4.061527057079318,80.0,20.0
1349,0,1349,[301 678   1 194 357],721,4,5483,4.061481481481482,0.0,0.0
1350,0,1350,[ 64 313 483 318 187],618,5,5488,4.062176165803109,80.0,20.0
1351,0,1351,[216 313 289 471  82],416,4,5492,4.062130177514793,20.0,20.0
1352,0,1352,[ 64 313 483 318 187],214,5,5497,4.062823355506282,80.0,20.0
1353,0,1353,[265 275 237  25 211],297,4,5501,4.062776957163958,0.0,0.0
1354,0,1354,[ 64 313 483 318 187],618,5,5506,4.0634686346863464,80.0,20.0
1355,0,1355,[286 111 258 515  96],416,5,5511,4.064159292035399,0.0,0.0
1356,0,1356,[313  64 483 318 187],618,5,5516,4.06484893146647,80.0,20.0
1357,0,1357,[313  64 483 318 187],214,5,5521,4.065537555228277,80.0,20.0
1358,0,1358,[313  64 483 318 187],214,5,5526,4.066225165562914,80.0,20.0
1359,0,1359,[  9 204 508 238  28],342,3,5529,4.065441176470588,0.0,0.0
1360,0,1360,[313  64 483 318 187],214,5,5534,4.066127847171198,80.0,20.0
1361,0,1361,[313  64 483 318 187],214,5,5539,4.0668135095447875,80.0,20.0
1362,0,1362,[313  64 483 318 187],214,5,5544,4.067498165810711,80.0,20.0
1363,0,1363,[ 25 172 288 200 257],417,1,5545,4.06524926686217,0.0,20.0
1364,0,1364,[313  64 483 318 187],214,5,5550,4.065934065934066,80.0,20.0
1365,0,1365,[313  64 483 318 187],214,5,5555,4.0666178623718885,80.0,20.0
1366,0,1366,[195 427 357 215 471],373,4,5559,4.066569129480614,0.0,0.0
1367,0,1367,[313  64 483 318 187],214,5,5564,4.067251461988304,80.0,20.0
1368,0,1368,[313  64 483 318 187],618,5,5569,4.067932797662527,80.0,20.0
1369,0,1369,[  4 423 405   7 111],854,3,5572,4.067153284671533,0.0,0.0
1370,0,1370,[ 64 313 483 318 187],618,5,5577,4.067833698030634,80.0,20.0
1371,0,1371,[ 64 313 483 318 187],618,5,5582,4.068513119533527,80.0,20.0
1372,0,1372,[ 64 313 483 318 187],214,5,5587,4.069191551347415,80.0,20.0
1373,0,1373,[ 64 313 483 318 187],214,5,5592,4.069868995633188,80.0,20.0
1374,0,1374,[ 64 313 483 318 187],214,5,5597,4.070545454545455,80.0,20.0
1375,0,1375,[ 64 313 483 318 187],618,5,5602,4.071220930232558,80.0,20.0
1376,0,1376,[ 64 313 483 318 187],618,5,5607,4.071895424836601,80.0,20.0
1377,0,1377,[100 508 257 135  98],342,1,5608,4.06966618287373,0.0,20.0
1378,0,1378,[ 64 313 483 318 187],214,5,5613,4.070340826686004,80.0,20.0
1379,0,1379,[403 168 151 186 179],373,3,5616,4.069565217391304,0.0,0.0
1380,0,1380,[ 64 313 483 318 187],214,5,5621,4.070238957277335,80.0,20.0
1381,0,1381,[ 98 187 515  25  97],416,5,5626,4.070911722141823,0.0,20.0
1382,0,1382,[ 64 313 483 318 187],618,5,5631,4.071583514099783,80.0,20.0
1383,0,1383,[ 64 313 483 318 187],214,5,5636,4.072254335260116,80.0,20.0
1384,0,1384,[117 588 204 181  15],416,5,5641,4.072924187725632,0.0,20.0
1385,0,1385,[211 357 175 496 168],373,4,5645,4.0728715728715725,0.0,0.0
1386,0,1386,[ 25 748 196 588 568],805,1,5646,4.070656092285509,0.0,0.0
1387,0,1387,[313 496 323 215 179],416,3,5649,4.0698847262247835,20.0,20.0
1388,0,1388,[ 25 471 204  70  50],345,3,5652,4.069114470842333,0.0,20.0
1389,0,1389,[ 64 313 483 318 187],618,5,5657,4.069784172661871,80.0,20.0
1390,0,1390,[ 64 313 483 318 187],618,5,5662,4.070452911574407,80.0,20.0
1391,0,1391,[245  50 546 288 271],297,1,5663,4.068247126436781,0.0,40.0
1392,0,1392,[168 234  98 161 313],618,5,5668,4.068916008614501,20.0,40.0
1393,0,1393,[186 288 265 286 174],588,4,5672,4.068866571018652,0.0,20.0
1394,0,1394,[603 185 275   1 181],297,4,5676,4.068817204301075,0.0,20.0
1395,0,1395,[313  64 483 318 187],618,5,5681,4.069484240687679,80.0,20.0
1396,0,1396,[211 153 294   1 172],416,5,5686,4.070150322118826,0.0,0.0
1397,0,1397,[313  64 483 318 187],214,5,5691,4.070815450643777,80.0,20.0
1398,0,1398,[313  64 483 318 187],214,5,5696,4.071479628305933,80.0,20.0
1399,0,1399,[204   7  82  15 100],62,3,5699,4.070714285714286,0.0,0.0
1400,0,1400,[269 323 748 174 265],416,4,5703,4.070663811563169,0.0,0.0
1401,0,1401,[276 423 496 132  79],618,4,5707,4.070613409415121,0.0,0.0
1402,0,1402,[313  64 483 318 187],214,5,5712,4.071275837491091,80.0,20.0
1403,0,1403,[183  25 121 187 322],416,4,5716,4.071225071225071,0.0,0.0
1404,0,1404,[313  64 483 318 187],214,5,5721,4.071886120996441,80.0,20.0
1405,0,1405,[195 186 153  98 127],198,4,5725,4.0718349928876245,0.0,20.0
1406,0,1406,[174 294 678  22 153],654,4,5729,4.071783937455579,0.0,0.0
1407,0,1407,[655 282 322   8 357],416,4,5733,4.071732954545454,0.0,0.0
1408,0,1408,[196 179 174 588 286],373,2,5735,4.070262597586941,0.0,0.0
1409,0,1409,[483  64 313 318 187],618,5,5740,4.070921985815603,80.0,20.0
1410,0,1410,[423 273 111 121  82],618,4,5744,4.070871722182849,0.0,0.0
1411,0,1411,[  1 183 405 289  64],416,4,5748,4.070821529745042,20.0,0.0
1412,0,1412,[ 64 313 483 318 187],214,5,5753,4.071479122434536,80.0,20.0
1413,0,1413,[ 12 301  88 117 196],416,4,5757,4.071428571428571,20.0,0.0
1414,0,1414,[ 64 313 483 318 187],618,5,5762,4.07208480565371,80.0,20.0
1415,0,1415,[ 98 132 294 204 117],416,5,5767,4.07274011299435,0.0,20.0
1416,0,1416,[210 269 197 195 153],373,4,5771,4.0726887791107975,0.0,0.0
1417,0,1417,[597 168 235 245  89],417,3,5774,4.071932299012694,0.0,0.0
1418,0,1418,[ 64 313 483 318 187],214,5,5779,4.0725863284002815,80.0,20.0
1419,0,1419,[ 64 313 483 318 187],214,5,5784,4.073239436619718,80.0,20.0
1420,0,1420,[289   4 161 301  50],345,3,5787,4.072484166080225,0.0,20.0
1421,0,1421,[286 568 172  69 180],417,2,5789,4.071026722925457,0.0,0.0
1422,0,1422,[ 64 313 483 318 187],618,5,5794,4.0716795502459595,80.0,20.0
1423,0,1423,[300 588 269 210 204],345,3,5797,4.070926966292135,0.0,0.0
1424,0,1424,[ 64 313 483 318 187],618,5,5802,4.071578947368421,80.0,20.0
1425,0,1425,[ 64 313 483 318 187],214,5,5807,4.072230014025245,80.0,20.0
1426,0,1426,[216 357 174  50 588],373,4,5811,4.072179397337071,0.0,20.0
1427,0,1427,[ 64 313 483 318 187],214,5,5816,4.072829131652661,80.0,20.0
1428,0,1428,[ 64 313 483 318 187],214,5,5821,4.073477956613016,80.0,20.0
1429,0,1429,[ 64 313 483 318 187],618,5,5826,4.074125874125874,80.0,20.0
1430,0,1430,[ 64 313 483 318 187],618,5,5831,4.0747728860936405,80.0,20.0
1431,0,1431,[ 64 313 483 318 187],618,5,5836,4.075418994413408,80.0,20.0
1432,0,1432,[258 118 175 323 117],43,3,5839,4.07466852756455,0.0,0.0
1433,0,1433,[313 483  64 318 187],618,5,5844,4.075313807531381,80.0,20.0
1434,0,1434,[125 111 568 237 143],314,5,5849,4.07595818815331,0.0,0.0
1435,0,1435,[216 276 202 197  70],128,3,5852,4.075208913649025,0.0,0.0
1436,0,1436,[ 64 483 313 318 187],618,5,5857,4.075852470424495,80.0,20.0
1437,0,1437,[186 117  97 748  96],642,5,5862,4.076495132127955,0.0,0.0
1438,0,1438,[257 471  89 202  22],297,2,5864,4.07505211952745,0.0,0.0
1439,0,1439,[ 64 313 483 318 187],214,5,5869,4.075694444444444,80.0,20.0
1440,0,1440,[ 64 313 483 318 187],618,5,5874,4.076335877862595,80.0,20.0
1441,0,1441,[ 64 313 483 318 187],618,5,5879,4.0769764216366156,80.0,20.0
1442,0,1442,[655  82 234  28 143],437,3,5882,4.076230076230076,0.0,0.0
1443,0,1443,[  1 195  70 144   9],618,2,5884,4.074792243767313,0.0,0.0
1444,0,1444,[483  64 313 318 187],214,5,5889,4.075432525951557,80.0,20.0
1445,0,1445,[173 286  50 200 153],297,4,5893,4.0753803596127245,0.0,20.0
1446,0,1446,[ 64 313 483 318 187],618,5,5898,4.076019350380097,80.0,20.0
1447,0,1447,[ 64 313 483 318 187],214,5,5903,4.076657458563536,80.0,20.0
1448,0,1448,[268 276 405 151 427],416,3,5906,4.07591442374051,0.0,0.0
1449,0,1449,[ 64 313 483 318 187],618,5,5911,4.076551724137931,80.0,20.0
1450,0,1450,[ 64 313 483 318 187],214,5,5916,4.077188146106134,80.0,20.0
1451,0,1451,[143  79 135 403 200],405,4,5920,4.077134986225896,0.0,0.0
1452,0,1452,[ 69 182 427  98 588],416,5,5925,4.077770130763937,0.0,20.0
1453,0,1453,[ 50 151 655 143 300],128,3,5928,4.0770288858321875,0.0,20.0
1454,0,1454,[121 222 237 742 269],43,5,5933,4.0776632302405496,0.0,0.0
1455,0,1455,[  7 151 111 168 403],588,2,5935,4.076236263736264,0.0,0.0
1456,0,1456,[483  64 313 318 187],618,5,5940,4.076870281400137,80.0,20.0
1457,0,1457,[483  64 313 318 187],618,5,5945,4.077503429355281,80.0,20.0
1458,0,1458,[483  64 313 318 187],618,5,5950,4.0781357093899935,80.0,20.0
1459,0,1459,[483  64 313 318 187],214,5,5955,4.078767123287672,80.0,20.0
1460,0,1460,[483  64 313 318 187],214,5,5960,4.079397672826831,80.0,20.0
1461,0,1461,[475 187   7  11 121],416,4,5964,4.079343365253078,0.0,0.0
1462,0,1462,[483  64 313 318 187],618,5,5969,4.079972658920028,80.0,20.0
1463,0,1463,[483  64 313 318 187],214,5,5974,4.080601092896175,80.0,20.0
1464,0,1464,[483  64 313 318 187],214,5,5979,4.081228668941979,80.0,20.0
1465,0,1465,[515 185 181  82  64],405,4,5983,4.081173260572988,20.0,20.0
1466,0,1466,[515 475  95 200 127],417,5,5988,4.081799591002045,0.0,0.0
1467,0,1467,[175 197  89 132 194],854,4,5992,4.081743869209809,0.0,0.0
1468,0,1468,[191  69   4 435 228],297,0,5992,4.078965282505106,0.0,0.0
1469,0,1469,[313  64 483 318 187],214,5,5997,4.079591836734694,80.0,20.0
1470,0,1470,[211 196 194   1 405],416,5,6002,4.080217539089055,0.0,0.0
1471,0,1471,[313  64 483 318 187],214,5,6007,4.080842391304348,80.0,20.0
1472,0,1472,[174 286 475  12 153],62,4,6011,4.0807875084860825,20.0,0.0
1473,0,1473,[ 64 313 483 318 187],618,5,6016,4.081411126187246,80.0,20.0
1474,0,1474,[ 64 313 483 318 187],618,5,6021,4.082033898305085,80.0,20.0
1475,0,1475,[ 71 313  89 427 286],711,4,6025,4.081978319783198,20.0,20.0
1476,0,1476,[ 15 127   4 235 161],417,2,6027,4.080568720379147,0.0,0.0
1477,0,1477,[ 64 313 483 318 187],618,5,6032,4.081190798376184,80.0,20.0
1478,0,1478,[ 64 313 483 318 187],618,5,6037,4.081812035158891,80.0,20.0
1479,0,1479,[135 568 238  88 191],618,4,6041,4.081756756756757,0.0,0.0
1480,0,1480,[100 678 748  70 135],297,3,6044,4.081026333558406,0.0,0.0
1481,0,1481,[471 322 742 202   8],907,4,6048,4.080971659919029,0.0,0.0
1482,0,1482,[175 271 174 742  12],297,3,6051,4.08024275118004,20.0,0.0
1483,0,1483,[ 64 313 483 318 187],214,5,6056,4.080862533692723,80.0,20.0
1484,0,1484,[ 82 182  71 496 179],128,4,6060,4.08080808080808,0.0,0.0
1485,0,1485,[ 64 313 483 318 187],214,5,6065,4.0814266487214,80.0,20.0
1486,0,1486,[ 25 318   8 173  11],43,5,6070,4.082044384667115,20.0,0.0
1487,0,1487,[483  64 313 318 187],214,5,6075,4.082661290322581,80.0,20.0
1488,0,1488,[197  96 117 121 742],854,1,6076,4.080591000671592,0.0,0.0
1489,0,1489,[  9 286  70 151 125],345,3,6079,4.079865771812081,0.0,0.0
1490,0,1490,[ 64 313 483 318 187],618,5,6084,4.0804828973843055,80.0,20.0
1491,0,1491,[ 64 313 483 318 187],618,5,6089,4.081099195710456,80.0,20.0
1492,0,1492,[748  82 222 210 172],805,2,6091,4.079705291359678,0.0,0.0
1493,0,1493,[ 64 313 483 318 187],214,5,6096,4.080321285140562,80.0,20.0
1494,0,1494,[ 64 313 483 318 187],618,5,6101,4.080936454849498,80.0,20.0
1495,0,1495,[ 64 313 483 318 187],618,5,6106,4.081550802139038,80.0,20.0
1496,0,1496,[275 210 204  15 313],43,5,6111,4.082164328657314,20.0,20.0
1497,0,1497,[ 25 265  70  22 258],297,4,6115,4.082109479305741,0.0,0.0
1498,0,1498,[286 258 678 173 568],345,3,6118,4.081387591727818,0.0,0.0
1499,0,1499,[313  64 483 318 187],618,5,6123,4.082,80.0,20.0
1500,0,1500,[268 318 215  71  28],314,5,6128,4.082611592271819,20.0,0.0
1501,0,1501,[313  64 483 318 187],618,5,6133,4.083222370173103,80.0,20.0
1502,0,1502,[301  15 127 318  64],43,5,6138,4.083832335329341,40.0,0.0
1503,0,1503,[313  64 483 318 187],618,5,6143,4.084441489361702,80.0,20.0
1504,0,1504,[313  64 483 318 187],214,5,6148,4.085049833887044,80.0,20.0
1505,0,1505,[ 25 483 100 185 403],618,4,6152,4.084993359893758,20.0,0.0
1506,0,1506,[483 313  64 318 187],618,5,6157,4.085600530856006,80.0,20.0
1507,0,1507,[483 313  64 318 187],618,5,6162,4.086206896551724,80.0,20.0
1508,0,1508,[182  98   7 228 174],505,2,6164,4.084824387011266,0.0,20.0
1509,0,1509,[483 313  64 318 187],618,5,6169,4.085430463576159,80.0,20.0
1510,0,1510,[483 313  64 318 187],214,5,6174,4.086035737921906,80.0,20.0
1511,0,1511,[181  69 273 194   7],297,3,6177,4.0853174603174605,0.0,20.0
1512,0,1512,[483 313  64 318 187],618,5,6182,4.08592200925314,80.0,20.0
1513,0,1513,[ 50 143 265 161 403],922,3,6185,4.085204755614267,0.0,20.0
1514,0,1514,[ 64  69 200 323 174],416,4,6189,4.085148514851485,20.0,0.0
1515,0,1515,[313  64 483 318 187],618,5,6194,4.08575197889182,80.0,20.0
1516,0,1516,[300 100 238  70 143],297,4,6198,4.08569545154911,0.0,0.0
1517,0,1517,[ 56 216 210 288  50],588,5,6203,4.086297760210804,0.0,40.0
1518,0,1518,[313  64 483 318 187],214,5,6208,4.086899275839368,80.0,20.0
1519,0,1519,[117 294 235   4  11],416,4,6212,4.086842105263158,0.0,0.0
1520,0,1520,[313  64 483 318 187],214,5,6217,4.087442472057857,80.0,20.0
1521,0,1521,[  1 211  82  50 496],230,5,6222,4.088042049934297,0.0,20.0
1522,0,1522,[181 168  11 183 179],805,3,6225,4.0873276428102425,0.0,20.0
1523,0,1523,[313  64 483 318 187],618,5,6230,4.087926509186352,80.0,20.0
1524,0,1524,[127 357  79 117 288],854,4,6234,4.0878688524590165,0.0,20.0
1525,0,1525,[258 172 135  82 191],417,3,6237,4.087155963302752,0.0,0.0
1526,0,1526,[276  28  82 423 183],416,4,6241,4.087098886705959,0.0,0.0
1527,0,1527,[  4 216 423  11  28],405,4,6245,4.087041884816754,0.0,0.0
1528,0,1528,[483  64 313 318 187],214,5,6250,4.087638979725311,80.0,20.0
1529,0,1529,[496 228  15 186 742],417,2,6252,4.086274509803921,0.0,0.0
1530,0,1530,[483  64 313 318 187],214,5,6257,4.0868713259307645,80.0,20.0
1531,0,1531,[ 96 121 125  98 234],417,3,6260,4.0861618798955615,0.0,20.0
1532,0,1532,[322 143 546  12 269],805,2,6262,4.084801043705153,20.0,0.0
1533,0,1533,[483  64 313 318 187],214,5,6267,4.0853976531942635,80.0,20.0
1534,0,1534,[ 11  96  69  98 273],630,4,6271,4.085342019543974,0.0,20.0
1535,0,1535,[153 271 216 288 258],297,3,6274,4.084635416666667,0.0,20.0
1536,0,1536,[132 151 161 125 597],417,3,6277,4.083929733246584,0.0,0.0
1537,0,1537,[132  71 222 405 568],887,3,6280,4.083224967490247,0.0,0.0
1538,0,1538,[ 64 313 483 318 187],618,5,6285,4.083820662768031,80.0,20.0
1539,0,1539,[ 64 313 483 318 187],618,5,6290,4.084415584415584,80.0,20.0
1540,0,1540,[ 64 313 483 318 187],214,5,6295,4.085009733939001,80.0,20.0
1541,0,1541,[ 64 313 483 318 187],618,5,6300,4.085603112840467,80.0,20.0
1542,0,1542,[ 64 313 483 318 187],214,5,6305,4.086195722618276,80.0,20.0
1543,0,1543,[ 97  28 172  11 197],437,2,6307,4.084844559585492,0.0,0.0
1544,0,1544,[313  64 483 318 187],618,5,6312,4.085436893203884,80.0,20.0
1545,0,1545,[ 79   1 403   4 210],417,2,6314,4.084087968952135,0.0,0.0
1546,0,1546,[483  64 313 318 187],214,5,6319,4.084680025856496,80.0,20.0
1547,0,1547,[483  64 313 318 187],618,5,6324,4.0852713178294575,80.0,20.0
1548,0,1548,[483  64 313 318 187],214,5,6329,4.085861846352485,80.0,20.0
1549,0,1549,[483  64 313 318 187],618,5,6334,4.086451612903226,80.0,20.0
1550,0,1550,[ 11 238 235 211 179],416,3,6337,4.08575112830432,0.0,0.0
1551,0,1551,[483  64 313 318 187],618,5,6342,4.086340206185567,80.0,20.0
1552,0,1552,[125 742   1  82 496],230,5,6347,4.086928525434643,0.0,0.0
1553,0,1553,[483  64 313 318 187],618,5,6352,4.087516087516088,80.0,20.0
1554,0,1554,[151 603  15 258  56],854,4,6356,4.087459807073955,0.0,0.0
1555,0,1555,[475 175 423 265 215],297,2,6358,4.086118251928021,0.0,0.0
1556,0,1556,[ 50 196  96 286 179],416,4,6362,4.086062941554271,0.0,20.0
1557,0,1557,[194   9 135  25   8],854,3,6365,4.085365853658536,0.0,0.0
1558,0,1558,[294 423 175 117 273],854,3,6368,4.084669660038486,0.0,0.0
1559,0,1559,[ 64 483 313 318 187],618,5,6373,4.08525641025641,80.0,20.0
1560,0,1560,[ 64 483 313 318 187],214,5,6378,4.085842408712364,80.0,20.0
1561,0,1561,[153 257 385 323  98],751,4,6382,4.085787451984635,0.0,20.0
1562,0,1562,[ 64 483 313 318 187],618,5,6387,4.08637236084453,80.0,20.0
1563,0,1563,[222  56  79 238 132],198,3,6390,4.085677749360614,0.0,0.0
1564,0,1564,[215  11  50 176 275],618,4,6394,4.085623003194888,0.0,20.0
1565,0,1565,[302 181 117 258 286],345,4,6398,4.085568326947637,0.0,20.0
1566,0,1566,[168 183 195 173 181],416,5,6403,4.086151882578175,0.0,20.0
1567,0,1567,[191 568  25 194 151],373,5,6408,4.086734693877551,0.0,0.0
1568,0,1568,[174 245 403 196 197],416,4,6412,4.086679413639261,0.0,0.0
1569,0,1569,[302 127 117   4 276],416,4,6416,4.086624203821656,0.0,0.0
1570,0,1570,[ 64 483 313 318 187],618,5,6421,4.087205601527689,80.0,20.0
1571,0,1571,[ 12 176 111   1 282],618,3,6424,4.086513994910941,20.0,0.0
1572,0,1572,[202 173 168 435 132],437,3,6427,4.08582326764145,0.0,0.0
1573,0,1573,[ 28 427  79  12 127],618,5,6432,4.0864040660736975,20.0,0.0
1574,0,1574,[423 127 196 211 168],417,5,6437,4.086984126984127,0.0,0.0
1575,0,1575,[ 64 483 313 318 187],214,5,6442,4.08756345177665,80.0,20.0
1576,0,1576,[ 64 483 313 318 187],214,5,6447,4.088142041851617,80.0,20.0
1577,0,1577,[ 64 483 313 318 187],214,5,6452,4.08871989860583,80.0,20.0
1578,0,1578,[ 28  95   8 117 200],297,3,6455,4.0880303989867,0.0,0.0
1579,0,1579,[ 64 483 313 318 187],214,5,6460,4.0886075949367084,80.0,20.0
1580,0,1580,[302 597 121 151 496],654,5,6465,4.089184060721062,0.0,0.0
1581,0,1581,[385  82  70  56 300],654,5,6470,4.089759797724399,0.0,0.0
1582,0,1582,[483 168  28 222 186],496,2,6472,4.088439671509792,20.0,0.0
1583,0,1583,[483  64 313 318 187],618,5,6477,4.089015151515151,80.0,20.0
1584,0,1584,[515  82 237 234  56],416,4,6481,4.088958990536278,0.0,0.0
1585,0,1585,[286 655   8  50  82],721,4,6485,4.088902900378311,0.0,20.0
1586,0,1586,[483  64 313 318 187],214,5,6490,4.0894770006301195,80.0,20.0
1587,0,1587,[597 423  69 144 655],417,2,6492,4.08816120906801,0.0,0.0
1588,0,1588,[483  64 313 318 187],214,5,6497,4.088735053492763,80.0,20.0
1589,0,1589,[483  64 313 318 187],618,5,6502,4.089308176100629,80.0,20.0
1590,0,1590,[483  64 313 318 187],618,5,6507,4.0898805782526715,80.0,20.0
1591,0,1591,[216  79 195 301  69],416,5,6512,4.090452261306533,0.0,0.0
1592,0,1592,[483  64 313 318 187],618,5,6517,4.091023226616447,80.0,20.0
1593,0,1593,[483  64 313 318 187],214,5,6522,4.09159347553325,80.0,20.0
1594,0,1594,[483  64 313 318 187],214,5,6527,4.092163009404389,80.0,20.0
1595,0,1595,[210 183 172 275 655],416,5,6532,4.0927318295739346,0.0,0.0
1596,0,1596,[132  22   1 111 238],262,3,6535,4.092047589229806,0.0,0.0
1597,0,1597,[483  64 313 318 187],618,5,6540,4.092615769712141,80.0,20.0
1598,0,1598,[144 403  70 357 508],417,3,6543,4.0919324577861165,0.0,0.0
1599,0,1599,[483  64 313 318 187],214,5,6548,4.0925,80.0,20.0
1600,0,1600,[ 70 286 423 185 515],354,2,6550,4.0911930043722675,0.0,0.0
1601,0,1601,[153 195 173 302 200],417,4,6554,4.091136079900124,0.0,0.0
1602,0,1602,[238 322 294  69 268],417,3,6557,4.090455396132252,0.0,0.0
1603,0,1603,[216 168 265 405 276],654,4,6561,4.090399002493766,0.0,0.0
1604,0,1604,[313  64 483 318 187],618,5,6566,4.090965732087227,80.0,20.0
1605,0,1605,[268 475 132 328 121],854,2,6568,4.089663760896638,0.0,0.0
1606,0,1606,[405   8  82  97  71],705,3,6571,4.0889856876166775,0.0,0.0
1607,0,1607,[471 117 427  79 127],373,3,6574,4.088308457711443,0.0,0.0
1608,0,1608,[216  71 172 204 276],416,4,6578,4.088253573648228,0.0,0.0
1609,0,1609,[ 96 153 183 496 151],601,3,6581,4.087577639751553,0.0,0.0
1610,0,1610,[313  64 483 318 187],618,5,6586,4.088144009931719,80.0,20.0
1611,0,1611,[288  89 238 655  88],805,2,6588,4.086848635235732,0.0,20.0
1612,0,1612,[161 216 678 333 144],588,3,6591,4.086174829510229,0.0,0.0
1613,0,1613,[174 151 100  64 323],198,3,6594,4.08550185873606,20.0,0.0
1614,0,1614,[ 71  64 187 180 100],198,2,6596,4.08421052631579,20.0,0.0
1615,0,1615,[313  64 483 318 187],618,5,6601,4.084777227722772,80.0,20.0
1616,0,1616,[313  64 483 318 187],618,5,6606,4.085343228200371,80.0,20.0
1617,0,1617,[  8 196 318 423 195],654,5,6611,4.085908529048208,20.0,0.0
1618,0,1618,[173 294  70 588 100],416,5,6616,4.086473131562693,0.0,0.0
1619,0,1619,[174  11 288  25  28],618,3,6619,4.085802469135802,0.0,20.0
1620,0,1620,[161 678 302  79 100],416,4,6623,4.0857495373226405,0.0,0.0
1621,0,1621,[597 333 273 117 318],416,4,6627,4.0856966707768185,20.0,0.0
1622,0,1622,[ 64 313 483 318 187],618,5,6632,4.0862600123228585,80.0,20.0
1623,0,1623,[ 64 313 483 318 187],214,5,6637,4.086822660098522,80.0,20.0
1624,0,1624,[515   1 237 111 196],416,4,6641,4.086769230769231,0.0,0.0
1625,0,1625,[271 237 273 294 191],854,3,6644,4.08610086100861,0.0,0.0
1626,0,1626,[ 64 313 483 318 187],214,5,6649,4.086662569145667,80.0,20.0
1627,0,1627,[258   4 173 151 143],642,2,6651,4.085380835380835,0.0,0.0
1628,0,1628,[196 182 176 210 748],417,4,6655,4.085328422344997,0.0,0.0
1629,0,1629,[ 64 313 483 318 187],214,5,6660,4.085889570552148,80.0,20.0
1630,0,1630,[ 71  96  98 151 588],805,3,6663,4.0852237890864505,0.0,20.0
1631,0,1631,[483   4 176   1   9],62,4,6667,4.085171568627451,20.0,0.0
1632,0,1632,[328 174 475 197 275],854,3,6670,4.084507042253521,0.0,0.0
1633,0,1633,[313  64 483 318 187],214,5,6675,4.085067319461444,80.0,20.0
1634,0,1634,[385 286  50 210 271],43,4,6679,4.085015290519878,0.0,20.0
1635,0,1635,[ 64 313 483 318 187],214,5,6684,4.08557457212714,80.0,20.0
1636,0,1636,[ 82 216 568  11   4],405,4,6688,4.085522296884545,0.0,0.0
1637,0,1637,[191   8 496 215 257],43,5,6693,4.086080586080586,0.0,0.0
1638,0,1638,[483  64 313 318 187],214,5,6698,4.086638194020744,80.0,20.0
1639,0,1639,[427 143 144 748 568],416,5,6703,4.087195121951219,0.0,0.0
1640,0,1640,[ 64 313 483 318 187],214,5,6708,4.087751371115174,80.0,20.0
1641,0,1641,[568 210 238 153  98],198,4,6712,4.087697929354446,0.0,20.0
1642,0,1642,[ 64 313 483 318 187],618,5,6717,4.088253195374315,80.0,20.0
1643,0,1643,[151  12  15  28 125],588,4,6721,4.088199513381995,20.0,0.0
1644,0,1644,[185 161 423 475 202],417,3,6724,4.087537993920972,0.0,0.0
1645,0,1645,[  4 237 357 143 127],198,2,6726,4.086269744835966,0.0,0.0
1646,0,1646,[483  64 313 318 187],214,5,6731,4.0868245294474805,80.0,20.0
1647,0,1647,[483  64 313 318 187],618,5,6736,4.087378640776699,80.0,20.0
1648,0,1648,[385 216 127  96 357],416,5,6741,4.087932080048514,0.0,0.0
1649,0,1649,[181 100 269 273 294],297,4,6745,4.087878787878788,0.0,20.0
1650,0,1650,[257 276 235   1 427],416,2,6747,4.086614173228346,0.0,0.0
1651,0,1651,[483  64 313 318 187],618,5,6752,4.087167070217918,80.0,20.0
1652,0,1652,[483  64 313 318 187],618,5,6757,4.087719298245614,80.0,20.0
1653,0,1653,[187  22 471 195 183],416,5,6762,4.088270858524789,0.0,0.0
1654,0,1654,[202 258 111 144  97],711,3,6765,4.087613293051359,0.0,0.0
1655,0,1655,[655 180 294 288 403],417,4,6769,4.08756038647343,0.0,20.0
1656,0,1656,[483  64 313 318 187],214,5,6774,4.088111044055522,80.0,20.0
1657,0,1657,[748 273 216 132 127],417,3,6777,4.087454764776839,0.0,0.0
1658,0,1658,[483 427 313 405 111],907,5,6782,4.088004822182038,40.0,20.0
1659,0,1659,[483  64 313 318 187],618,5,6787,4.08855421686747,80.0,20.0
1660,0,1660,[483  64 313 318 187],214,5,6792,4.089102950030102,80.0,20.0
1661,0,1661,[483  64 313 318 187],214,5,6797,4.089651022864019,80.0,20.0
1662,0,1662,[ 98  82 183 294 508],417,4,6801,4.08959711365003,0.0,20.0
1663,0,1663,[483  64 313 318 187],618,5,6806,4.090144230769231,80.0,20.0
1664,0,1664,[423 403   1 323   9],43,4,6810,4.09009009009009,0.0,0.0
1665,0,1665,[ 11 168  56 318  22],854,4,6814,4.090036014405762,20.0,0.0
1666,0,1666,[568 179  69 294  12],214,3,6817,4.089382123575285,20.0,0.0
1667,0,1667,[483  64 313 318 187],214,5,6822,4.089928057553957,80.0,20.0
1668,0,1668,[483  64 313 318 187],214,5,6827,4.090473337327741,80.0,20.0
1669,0,1669,[483  64 313 318 187],214,5,6832,4.091017964071856,80.0,20.0
1670,0,1670,[ 97  98  69  70 496],417,3,6835,4.090365050867744,0.0,20.0
1671,0,1671,[ 12   7  98 182 403],618,5,6840,4.090909090909091,20.0,20.0
1672,0,1672,[483  64 313 318 187],618,5,6845,4.091452480573819,80.0,20.0
1673,0,1673,[483  64 313 318 187],618,5,6850,4.091995221027479,80.0,20.0
1674,0,1674,[ 69 200  79 237  15],618,4,6854,4.091940298507462,0.0,0.0
1675,0,1675,[742 258 234  25  88],270,3,6857,4.091288782816229,0.0,0.0
1676,0,1676,[174 238 204  98  96],49,2,6859,4.090041741204532,0.0,20.0
1677,0,1677,[313 483  64 318 187],214,5,6864,4.090584028605483,80.0,20.0
1678,0,1678,[313 483  64 318 187],618,5,6869,4.091125670041691,80.0,20.0
1679,0,1679,[313 483  64 318 187],214,5,6874,4.091666666666667,80.0,20.0
1680,0,1680,[117 132   1  50 385],230,4,6878,4.091612135633551,0.0,20.0
1681,0,1681,[294 271   8 273  96],805,1,6879,4.089774078478002,0.0,0.0
1682,0,1682,[ 70 245 268 357 403],721,3,6882,4.089126559714795,0.0,0.0
1683,0,1683,[483  64 313 318 187],214,5,6887,4.089667458432304,80.0,20.0
1684,0,1684,[483  64 313 318 187],618,5,6892,4.090207715133531,80.0,20.0
1685,0,1685,[483  64 313 318 187],214,5,6897,4.090747330960854,80.0,20.0
1686,0,1686,[238 748 100  89 180],417,4,6901,4.090693538826319,0.0,0.0
1687,0,1687,[483  64 313 318 187],618,5,6906,4.091232227488152,80.0,20.0
1688,0,1688,[322 273 216   4  70],417,1,6907,4.089402013025459,0.0,0.0
1689,0,1689,[483  64 313 318 187],214,5,6912,4.089940828402367,80.0,20.0
1690,0,1690,[568 174  82 333 202],588,3,6915,4.08929627439385,0.0,0.0
1691,0,1691,[483  64 313 318 187],214,5,6920,4.08983451536643,80.0,20.0
1692,0,1692,[483  64 313 318 187],214,5,6925,4.090372120496161,80.0,20.0
1693,0,1693,[483  64 313 318 187],618,5,6930,4.090909090909091,80.0,20.0
1694,0,1694,[117 174 215  79 144],43,5,6935,4.091445427728614,0.0,0.0
1695,0,1695,[483  64 313 318 187],214,5,6940,4.091981132075472,80.0,20.0
1696,0,1696,[403 204 202  82 271],805,1,6941,4.0901591043017085,0.0,0.0
1697,0,1697,[483 313  64 318 187],214,5,6946,4.090694935217903,80.0,20.0
1698,0,1698,[313 197 385 194 655],405,3,6949,4.090052972336669,20.0,20.0
1699,0,1699,[294 742 323  96 181],416,4,6953,4.09,0.0,20.0
1700,0,1700,[215 222 385  79 282],588,3,6956,4.089359200470311,0.0,0.0
1701,0,1701,[ 25 265 222  79 288],417,0,6956,4.086956521739131,0.0,20.0
1702,0,1702,[294 151 185 202  50],921,3,6959,4.086318261890781,0.0,20.0
1703,0,1703,[ 64 313 483 318 187],214,5,6964,4.086854460093897,80.0,20.0
1704,0,1704,[216 161 294  82  96],417,2,6966,4.085630498533725,0.0,0.0
1705,0,1705,[174 228 475   9 191],805,2,6968,4.084407971864009,0.0,0.0
1706,0,1706,[568 288 423  15 144],62,0,6968,4.082015231400117,0.0,20.0
1707,0,1707,[181 204 168 173 196],711,3,6971,4.081381733021077,0.0,20.0
1708,0,1708,[ 64 313 483 318 187],214,5,6976,4.081919251023991,80.0,20.0
1709,0,1709,[ 64 313 483 318 187],214,5,6981,4.082456140350877,80.0,20.0
1710,0,1710,[210 215 357 435  69],373,5,6986,4.082992402104033,0.0,0.0
1711,0,1711,[ 64 313 483 318 187],618,5,6991,4.083528037383178,80.0,20.0
1712,0,1712,[ 64 313 483 318 187],214,5,6996,4.084063047285464,80.0,20.0
1713,0,1713,[ 64 313 483 318 187],214,5,7001,4.084597432905484,80.0,20.0
1714,0,1714,[187  11 318 100   1],198,4,7005,4.084548104956268,20.0,0.0
1715,0,1715,[ 64 313 483 318 187],618,5,7010,4.085081585081585,80.0,20.0
1716,0,1716,[ 64 313 483 318 187],214,5,7015,4.085614443797321,80.0,20.0
1717,0,1717,[ 64 313 483 318 187],618,5,7020,4.086146682188591,80.0,20.0
1718,0,1718,[ 64 313 483 318 187],214,5,7025,4.0866783013379875,80.0,20.0
1719,0,1719,[ 64 313 483 318 187],618,5,7030,4.087209302325581,80.0,20.0
1720,0,1720,[173 294 546 357   8],805,2,7032,4.085996513654852,0.0,0.0
1721,0,1721,[ 64 313 483 318 187],214,5,7037,4.086527293844367,80.0,20.0
1722,0,1722,[228 568 200 288 269],711,2,7039,4.085316308763784,0.0,20.0
1723,0,1723,[ 64 313 483 318 187],214,5,7044,4.08584686774942,80.0,20.0
1724,0,1724,[ 64 313 483 318 187],214,5,7049,4.086376811594203,80.0,20.0
1725,0,1725,[216 215 174 294 742],588,4,7053,4.086326767091541,0.0,0.0
1726,0,1726,[176 216 153 127 183],922,1,7054,4.084539664157498,0.0,0.0
1727,0,1727,[ 64 313 483 318 187],618,5,7059,4.085069444444445,80.0,20.0
1728,0,1728,[210 313 179  98  95],416,3,7062,4.084441873915558,20.0,40.0
1729,0,1729,[ 64 313 483 318 187],214,5,7067,4.084971098265896,80.0,20.0
1730,0,1730,[195 301 182 302 300],297,2,7069,4.083766608896592,0.0,0.0
1731,0,1731,[742 568 302  70 748],417,2,7071,4.0825635103926095,0.0,0.0
1732,0,1732,[ 64 313 483 318 187],618,5,7076,4.083092902481247,80.0,20.0
1733,0,1733,[655 471 568 191  70],345,4,7080,4.083044982698962,0.0,0.0
1734,0,1734,[588  12 196 153 121],43,5,7085,4.083573487031701,20.0,0.0
1735,0,1735,[483  64 313 318 187],618,5,7090,4.0841013824884795,80.0,20.0
1736,0,1736,[144 143  64 174 135],618,5,7095,4.084628670120898,20.0,0.0
1737,0,1737,[ 97 302  70 183 175],405,1,7096,4.082853855005753,0.0,0.0
1738,0,1738,[313  64 483 318 187],214,5,7101,4.08338125359402,80.0,20.0
1739,0,1739,[597 204   9 222 289],43,4,7105,4.083333333333333,0.0,0.0
1740,0,1740,[313  64 483 318 187],618,5,7110,4.08385985066054,80.0,20.0
1741,0,1741,[313  64 483 318 187],618,5,7115,4.084385763490241,80.0,20.0
1742,0,1742,[271 175 748 515 151],297,2,7117,4.083189902467011,0.0,0.0
1743,0,1743,[313  64 483 318 187],618,5,7122,4.083715596330276,80.0,20.0
1744,0,1744,[121  71 118 100  98],416,4,7126,4.083667621776504,0.0,20.0
1745,0,1745,[313  64 483 318 187],618,5,7131,4.084192439862543,80.0,20.0
1746,0,1746,[597 132 153 313  88],416,3,7134,4.083571837435604,20.0,20.0
1747,0,1747,[313  64 483 318 187],214,5,7139,4.084096109839817,80.0,20.0
1748,0,1748,[ 22  28  71 143   7],314,5,7144,4.08461978273299,0.0,0.0
1749,0,1749,[313  64 483 318 187],214,5,7149,4.085142857142857,80.0,20.0
1750,0,1750,[405  96  28 237 427],416,4,7153,4.0850942318675045,0.0,0.0
1751,0,1751,[313  64 483 318 187],214,5,7158,4.085616438356165,80.0,20.0
1752,0,1752,[313  64 483 318 187],214,5,7163,4.086138049058756,80.0,20.0
1753,0,1753,[313  64 483 318 187],618,5,7168,4.086659064994299,80.0,20.0
1754,0,1754,[357   4 127  25  12],417,3,7171,4.086039886039886,20.0,0.0
1755,0,1755,[237 143 282 603  82],128,4,7175,4.085990888382688,0.0,0.0
1756,0,1756,[151 100 143 435 275],297,3,7178,4.085372794536141,0.0,0.0
1757,0,1757,[313  64 483 318 187],214,5,7183,4.085893060295791,80.0,20.0
1758,0,1758,[175 245 269 197 273],297,3,7186,4.085275724843661,0.0,0.0
1759,0,1759,[ 82 143 182 215 176],198,3,7189,4.084659090909091,0.0,0.0
1760,0,1760,[210  70 173  98  50],416,5,7194,4.085178875638841,0.0,40.0
1761,0,1761,[302 176 588 168 238],405,2,7196,4.083995459704881,0.0,0.0
1762,0,1762,[216 196 179  56   9],62,5,7201,4.0845150311968235,0.0,0.0
1763,0,1763,[ 97 202  64 357 179],417,5,7206,4.085034013605442,20.0,0.0
1764,0,1764,[174  50 385 185 204],49,1,7207,4.08328611898017,0.0,20.0
1765,0,1765,[ 71  28 302 204 176],405,3,7210,4.082672706681767,0.0,0.0
1766,0,1766,[ 64 313 483 318 187],618,5,7215,4.083191850594227,80.0,20.0
1767,0,1767,[ 64 313 483 318 187],214,5,7220,4.083710407239819,80.0,20.0
1768,0,1768,[ 64 313 483 318 187],214,5,7225,4.084228377614472,80.0,20.0
1769,0,1769,[ 64 313 483 318 187],214,5,7230,4.084745762711864,80.0,20.0
1770,0,1770,[ 64 313 483 318 187],618,5,7235,4.085262563523433,80.0,20.0
1771,0,1771,[385 257  71 196 202],43,5,7240,4.085778781038375,0.0,0.0
1772,0,1772,[288 322 655 508 588],314,4,7244,4.0857304004512125,0.0,20.0
1773,0,1773,[483  64 313 318 187],618,5,7249,4.086245772266065,80.0,20.0
1774,0,1774,[194 191 294 273 204],416,5,7254,4.086760563380282,0.0,0.0
1775,0,1775,[483  64 313 318 187],214,5,7259,4.087274774774775,80.0,20.0
1776,0,1776,[204  22  64 127 301],721,5,7264,4.08778840742825,20.0,0.0
1777,0,1777,[181 357 475 172  82],417,3,7267,4.087176602924634,0.0,20.0
1778,0,1778,[483  64 313 318 187],214,5,7272,4.087689713322091,80.0,20.0
1779,0,1779,[204 748 200  89 273],297,2,7274,4.086516853932585,0.0,0.0
1780,0,1780,[483  64 313 318 187],214,5,7279,4.087029758562605,80.0,20.0
1781,0,1781,[ 28  98 215 405 174],416,5,7284,4.087542087542087,0.0,20.0
1782,0,1782,[483  64 313 318 187],214,5,7289,4.088053841839596,80.0,20.0
1783,0,1783,[483  64 313 318 187],618,5,7294,4.088565022421525,80.0,20.0
1784,0,1784,[ 50 210 294  82   4],417,2,7296,4.087394957983193,0.0,20.0
1785,0,1785,[ 64 483 313 318 187],214,5,7301,4.087905935050392,80.0,20.0
1786,0,1786,[357 228 294 238 179],601,3,7304,4.087297146054841,0.0,0.0
1787,0,1787,[ 64 483 313 318 187],618,5,7309,4.087807606263982,80.0,20.0
1788,0,1788,[111 568 127 194 742],416,5,7314,4.088317495807714,0.0,0.0
1789,0,1789,[202  25 197  88 258],711,5,7319,4.0888268156424585,0.0,0.0
1790,0,1790,[546  12 276 179  88],416,1,7320,4.0871021775544385,20.0,0.0
1791,0,1791,[ 64 483 313 318 187],214,5,7325,4.087611607142857,80.0,20.0
1792,0,1792,[ 64 483 313 318 187],618,5,7330,4.088120468488567,80.0,20.0
1793,0,1793,[ 97 323 313 132 301],416,4,7334,4.088071348940914,20.0,20.0
1794,0,1794,[ 64 483 313 318 187],618,5,7339,4.08857938718663,80.0,20.0
1795,0,1795,[ 64 483 313 318 187],214,5,7344,4.089086859688196,80.0,20.0
1796,0,1796,[ 64 483 313 318 187],618,5,7349,4.089593767390094,80.0,20.0
1797,0,1797,[215 235 118  56 323],43,3,7352,4.088987764182425,0.0,0.0
1798,0,1798,[ 64 483 313 318 187],618,5,7357,4.089494163424124,80.0,20.0
1799,0,1799,[ 64 257  89  95 179],417,4,7361,4.089444444444444,20.0,0.0
1800,0,1800,[302 210 161 508 191],417,1,7362,4.087729039422543,0.0,0.0
1801,0,1801,[ 97 385 174 215 168],588,2,7364,4.086570477247503,0.0,0.0
1802,0,1802,[288 678   4 403 286],416,4,7368,4.086522462562396,0.0,20.0
1803,0,1803,[483 313  64 318 187],214,5,7373,4.087028824833703,80.0,20.0
1804,0,1804,[143 405  95 117 215],705,3,7376,4.086426592797784,0.0,0.0
1805,0,1805,[268 588 322 143   1],128,3,7379,4.085825027685493,0.0,0.0
1806,0,1806,[ 88  97  15 179 318],373,3,7382,4.085224128389596,20.0,0.0
1807,0,1807,[313 483  64 318 187],618,5,7387,4.085730088495575,80.0,20.0
1808,0,1808,[313 483  64 318 187],214,5,7392,4.086235489220564,80.0,20.0
1809,0,1809,[151 179 196   1 475],198,4,7396,4.086187845303868,0.0,0.0
1810,0,1810,[483  64 313 318 187],618,5,7401,4.086692435118719,80.0,20.0
1811,0,1811,[483  64 313 318 187],618,5,7406,4.08719646799117,80.0,20.0
1812,0,1812,[483  64 313 318 187],618,5,7411,4.087699944842802,80.0,20.0
1813,0,1813,[483  64 313 318 187],214,5,7416,4.088202866593164,80.0,20.0
1814,0,1814,[568   4  12 151  11],345,5,7421,4.08870523415978,20.0,0.0
1815,0,1815,[405  28  95  25 286],416,4,7425,4.088656387665198,0.0,0.0
1816,0,1816,[678 186   1  56 385],588,3,7428,4.088057237204183,0.0,0.0
1817,0,1817,[313  64 483 318 187],618,5,7433,4.088558855885589,80.0,20.0
1818,0,1818,[385 546 144 191 111],705,2,7435,4.08741066520066,0.0,0.0
1819,0,1819,[216 144 111 300  97],416,5,7440,4.087912087912088,0.0,0.0
1820,0,1820,[ 79 269 275 228  25],711,4,7444,4.087863811092806,0.0,0.0
1821,0,1821,[313  64 483 318 187],618,5,7449,4.088364434687157,80.0,20.0
1822,0,1822,[117 258 175  79 269],43,4,7453,4.088315962698848,0.0,0.0
1823,0,1823,[187 210   8 118  12],416,4,7457,4.088267543859649,20.0,0.0
1824,0,1824,[313 483  64 318 187],214,5,7462,4.0887671232876714,80.0,20.0
1825,0,1825,[313 483  64 318 187],618,5,7467,4.089266155531216,80.0,20.0
1826,0,1826,[301 161 228 357 196],721,5,7472,4.089764641488779,0.0,0.0
1827,0,1827,[313 483  64 318 187],618,5,7477,4.0902625820568925,80.0,20.0
1828,0,1828,[ 97 235 515   4 176],416,4,7481,4.09021323127392,0.0,0.0
1829,0,1829,[483  64 313 318 187],214,5,7486,4.090710382513661,80.0,20.0
1830,0,1830,[483  64 313 318 187],214,5,7491,4.091206990715456,80.0,20.0
1831,0,1831,[483  64 313 318 187],214,5,7496,4.091703056768559,80.0,20.0
1832,0,1832,[483  64 313 318 187],214,5,7501,4.092198581560283,80.0,20.0
1833,0,1833,[483  64 313 318 187],214,5,7506,4.092693565976009,80.0,20.0
1834,0,1834,[235 143 385  28 333],345,1,7507,4.091008174386921,0.0,0.0
1835,0,1835,[275  96 144 258 195],854,2,7509,4.089869281045751,0.0,0.0
1836,0,1836,[117  71  79 269 100],805,3,7512,4.08927599346761,0.0,0.0
1837,0,1837,[483  64 313 318 187],214,5,7517,4.089771490750816,80.0,20.0
1838,0,1838,[385  88 118 403 117],805,1,7518,4.088091353996737,0.0,0.0
1839,0,1839,[275 475  69 174 210],588,1,7519,4.086413043478261,0.0,0.0
1840,0,1840,[483  64 313 318 187],618,5,7524,4.086909288430201,80.0,20.0
1841,0,1841,[483  64 313 318 187],214,5,7529,4.087404994571118,80.0,20.0
1842,0,1842,[483  64 313 318 187],618,5,7534,4.087900162778079,80.0,20.0
1843,0,1843,[483  64 313 318 187],618,5,7539,4.0883947939262475,80.0,20.0
1844,0,1844,[603 276 238 655 117],416,4,7543,4.088346883468835,0.0,0.0
1845,0,1845,[313 483  64 318 187],214,5,7548,4.088840736728061,80.0,20.0
1846,0,1846,[385 427 357 168  50],642,3,7551,4.088251218191663,0.0,20.0
1847,0,1847,[234 273  56  22 173],805,3,7554,4.087662337662338,0.0,0.0
1848,0,1848,[161  28 153 196  69],721,5,7559,4.0881557598702,0.0,0.0
1849,0,1849,[ 64 483 313 318 187],214,5,7564,4.088648648648649,80.0,20.0
1850,0,1850,[ 15   8   9 655  97],618,2,7566,4.0875202593192865,0.0,0.0
1851,0,1851,[ 64 483 313 318 187],214,5,7571,4.088012958963283,80.0,20.0
1852,0,1852,[153  25 194  89 282],342,1,7572,4.086346465191581,0.0,0.0
1853,0,1853,[483  64 313 318 187],618,5,7577,4.086839266450917,80.0,20.0
1854,0,1854,[483  64 313 318 187],214,5,7582,4.08733153638814,80.0,20.0
1855,0,1855,[215  96 181 121 118],198,3,7585,4.086745689655173,0.0,20.0
1856,0,1856,[423 597 215 588  97],705,1,7586,4.085083467959074,0.0,0.0
1857,0,1857,[483  64 313 318 187],214,5,7591,4.085575888051668,80.0,20.0
1858,0,1858,[222 357 151  64 302],417,3,7594,4.084991931145777,20.0,0.0
1859,0,1859,[135 234  89  11 265],417,3,7597,4.084408602150537,0.0,0.0
1860,0,1860,[483  64 313 318 187],214,5,7602,4.084900591080064,80.0,20.0
1861,0,1861,[235 475 195 275 405],416,3,7605,4.084317937701396,0.0,0.0
1862,0,1862,[ 64 313 483 318 187],214,5,7610,4.084809447128288,80.0,20.0
1863,0,1863,[161 168 269 204 144],711,3,7613,4.084227467811159,0.0,0.0
1864,0,1864,[ 64 313 483 318 187],214,5,7618,4.084718498659518,80.0,20.0
1865,0,1865,[ 64 313 483 318 187],214,5,7623,4.085209003215434,80.0,20.0
1866,0,1866,[ 64 313 483 318 187],618,5,7628,4.085698982324585,80.0,20.0
1867,0,1867,[183  64 471 568 237],618,4,7632,4.085653104925053,20.0,0.0
1868,0,1868,[ 64 313 483 318 187],618,5,7637,4.086142322097379,80.0,20.0
1869,0,1869,[215 423  70 172  79],654,5,7642,4.086631016042781,0.0,0.0
1870,0,1870,[ 64 313 483 318 187],214,5,7647,4.087119187600214,80.0,20.0
1871,0,1871,[144 197  98  70 385],416,5,7652,4.087606837606837,0.0,20.0
1872,0,1872,[181 655 202  12   9],345,4,7656,4.08756006406834,20.0,20.0
1873,0,1873,[435 294 423 288 357],721,3,7659,4.086979722518676,0.0,20.0
1874,0,1874,[483 313  64 318 187],618,5,7664,4.087466666666667,80.0,20.0
1875,0,1875,[173 191 257   1  25],416,4,7668,4.087420042643923,0.0,0.0
1876,0,1876,[475 483 238 275   9],62,5,7673,4.0879062333510925,20.0,0.0
1877,0,1877,[483  64 313 318 187],214,5,7678,4.08839190628328,80.0,20.0
1878,0,1878,[655 423 288 257 191],711,2,7680,4.08728046833422,0.0,20.0
1879,0,1879,[301  97 546  22  12],297,4,7684,4.087234042553192,20.0,0.0
1880,0,1880,[483  64 313 318 187],618,5,7689,4.087719298245614,80.0,20.0
1881,0,1881,[483  64 313 318 187],618,5,7694,4.088204038257174,80.0,20.0
1882,0,1882,[483  64 313 318 187],618,5,7699,4.088688263409453,80.0,20.0
1883,0,1883,[483  64 313 318 187],618,5,7704,4.089171974522293,80.0,20.0
1884,0,1884,[483  64 313 318 187],618,5,7709,4.089655172413793,80.0,20.0
1885,0,1885,[483  64 313 318 187],214,5,7714,4.090137857900318,80.0,20.0
1886,0,1886,[ 97  28 423  98 405],128,4,7718,4.09009009009009,0.0,20.0
1887,0,1887,[483  64 313 318 187],214,5,7723,4.090572033898305,80.0,20.0
1888,0,1888,[301 144 181  82   7],588,3,7726,4.089994706193753,0.0,20.0
1889,0,1889,[483  64 313 318 187],618,5,7731,4.09047619047619,80.0,20.0
1890,0,1890,[176  25 257   8 125],416,4,7735,4.090428344791116,0.0,0.0
1891,0,1891,[258  98 515  11 742],297,4,7739,4.090380549682875,0.0,20.0
1892,0,1892,[301  25 286 195 333],416,5,7744,4.090861067089277,0.0,0.0
1893,0,1893,[313  64 483 318 187],618,5,7749,4.091341077085533,80.0,20.0
1894,0,1894,[191 742 275 603 176],854,3,7752,4.090765171503958,0.0,0.0
1895,0,1895,[194 191 302 403 161],721,3,7755,4.090189873417722,0.0,0.0
1896,0,1896,[302  56  79 161  96],405,3,7758,4.089615181866105,0.0,0.0
1897,0,1897,[153  96  69  71  56],642,4,7762,4.089567966280295,0.0,0.0
1898,0,1898,[275  50 265  64 173],128,5,7767,4.090047393364929,20.0,20.0
1899,0,1899,[ 82 273 191 216 271],805,1,7768,4.0884210526315785,0.0,0.0
1900,0,1900,[288   1 496 153 194],416,5,7773,4.08890057864282,0.0,20.0
1901,0,1901,[ 64 655   8 597 237],62,2,7775,4.087802313354364,20.0,0.0
1902,0,1902,[313 483  64 318 187],618,5,7780,4.088281660535996,80.0,20.0
1903,0,1903,[202 300 568 258 405],43,5,7785,4.088760504201681,0.0,0.0
1904,0,1904,[187 172 568 471   4],618,3,7788,4.088188976377952,0.0,0.0
1905,0,1905,[ 64 313 483 318 187],618,5,7793,4.088667366211962,80.0,20.0
1906,0,1906,[ 64 313 483 318 187],214,5,7798,4.089145254326167,80.0,20.0
1907,0,1907,[294  79 268 222 515],297,3,7801,4.088574423480084,0.0,0.0
1908,0,1908,[ 64 313 483 318 187],214,5,7806,4.089051859612362,80.0,20.0
1909,0,1909,[ 64 313 483 318 187],214,5,7811,4.0895287958115185,80.0,20.0
1910,0,1910,[ 64 313 483 318 187],214,5,7816,4.090005232862376,80.0,20.0
1911,0,1911,[176  82 496 210 288],417,2,7818,4.088912133891213,0.0,20.0
1912,0,1912,[204 483  71 181 144],618,4,7822,4.088865656037637,20.0,20.0
1913,0,1913,[ 64 313 483 318 187],618,5,7827,4.089341692789969,80.0,20.0
1914,0,1914,[  1 174 403 143 182],416,5,7832,4.089817232375979,0.0,0.0
1915,0,1915,[235  50 127 313 322],416,3,7835,4.089248434237996,20.0,40.0
1916,0,1916,[ 64 313 483 318 187],618,5,7840,4.089723526343245,80.0,20.0
1917,0,1917,[ 64 313 483 318 187],214,5,7845,4.090198123044838,80.0,20.0
1918,0,1918,[237 742 748 322 294],907,5,7850,4.090672225117249,0.0,0.0
1919,0,1919,[144  50 100  98 258],417,2,7852,4.089583333333334,0.0,40.0
1920,0,1920,[313  64 483 318 187],618,5,7857,4.09005726184279,80.0,20.0
1921,0,1921,[143  98 200 496 174],618,5,7862,4.0905306971904265,0.0,20.0
1922,0,1922,[313  64 483 318 187],618,5,7867,4.091003640145606,80.0,20.0
1923,0,1923,[ 89 135 118 186 216],854,2,7869,4.08991683991684,0.0,0.0
1924,0,1924,[182 423 204  56 173],62,3,7872,4.089350649350649,0.0,0.0
1925,0,1925,[ 64 483 313 318 187],618,5,7877,4.089823468328142,80.0,20.0
1926,0,1926,[ 64 483 313 318 187],214,5,7882,4.090295796574987,80.0,20.0
1927,0,1927,[ 98 117  69 168 151],588,3,7885,4.089730290456432,0.0,20.0
1928,0,1928,[186 143 471 173 144],588,4,7889,4.089683773976153,0.0,0.0
1929,0,1929,[ 64 483 313 318 187],214,5,7894,4.090155440414508,80.0,20.0
1930,0,1930,[153 196 546  12 143],416,4,7898,4.090108751941999,20.0,0.0
1931,0,1931,[ 64 483 313 318 187],618,5,7903,4.090579710144928,80.0,20.0
1932,0,1932,[234 183 427 179 175],405,2,7905,4.08949818934299,0.0,0.0
1933,0,1933,[655  89 216   7 197],751,1,7906,4.087900723888314,0.0,0.0
1934,0,1934,[ 64 483 313 318 187],618,5,7911,4.088372093023255,80.0,20.0
1935,0,1935,[ 64 483 313 318 187],214,5,7916,4.088842975206612,80.0,20.0
1936,0,1936,[ 64 483 313 318 187],618,5,7921,4.089313371192566,80.0,20.0
1937,0,1937,[135 294 180  28  88],805,1,7922,4.087719298245614,0.0,0.0
1938,0,1938,[269  56 302  25 204],297,4,7926,4.087674058793192,0.0,0.0
1939,0,1939,[237 222 357 289 294],721,2,7928,4.08659793814433,0.0,0.0
1940,0,1940,[483  64 313 318 187],214,5,7933,4.087068521380732,80.0,20.0
1941,0,1941,[483  64 313 318 187],214,5,7938,4.087538619979402,80.0,20.0
1942,0,1942,[483  64 313 318 187],618,5,7943,4.088008234688626,80.0,20.0
1943,0,1943,[483  64 313 318 187],618,5,7948,4.088477366255144,80.0,20.0
1944,0,1944,[483  64 313 318 187],214,5,7953,4.088946015424164,80.0,20.0
1945,0,1945,[211 588 180 181 196],417,3,7956,4.088386433710174,0.0,20.0
1946,0,1946,[313 483  64 318 187],618,5,7961,4.088854648176682,80.0,20.0
1947,0,1947,[258  22 173 597 234],805,2,7963,4.087782340862423,0.0,0.0
1948,0,1948,[275  15 204 132 328],128,3,7966,4.08722421754746,0.0,0.0
1949,0,1949,[313 483  64 318 187],214,5,7971,4.087692307692308,80.0,20.0
1950,0,1950,[403  70  64 179  79],405,3,7974,4.0871348026653,20.0,0.0
1951,0,1951,[294 235 121 111   1],262,1,7975,4.085553278688525,0.0,0.0
1952,0,1952,[313 483  64 318 187],214,5,7980,4.086021505376344,80.0,20.0
1953,0,1953,[313 483  64 318 187],214,5,7985,4.086489252814739,80.0,20.0
1954,0,1954,[496  28 127  98  56],887,3,7988,4.085933503836317,0.0,20.0
1955,0,1955,[173 268   9  22 568],314,4,7992,4.085889570552148,0.0,0.0
1956,0,1956,[ 64 313 483 318 187],618,5,7997,4.086356668369954,80.0,20.0
1957,0,1957,[742 471  69 194   7],854,2,7999,4.085291113381001,0.0,0.0
1958,0,1958,[313  64 483 318 187],618,5,8004,4.085758039816233,80.0,20.0
1959,0,1959,[313  64 483 318 187],618,5,8009,4.086224489795918,80.0,20.0
1960,0,1960,[313  64 483 318 187],618,5,8014,4.086690464048955,80.0,20.0
1961,0,1961,[180 222 100  28 117],805,2,8016,4.085626911314985,0.0,0.0
1962,0,1962,[313  64 483 318 187],618,5,8021,4.086092715231788,80.0,20.0
1963,0,1963,[215  69  11 269 195],416,5,8026,4.086558044806518,0.0,0.0
1964,0,1964,[121 483  50 196 238],711,4,8030,4.086513994910941,20.0,20.0
1965,0,1965,[313  64 483 318 187],618,5,8035,4.086978636826043,80.0,20.0
1966,0,1966,[313  64 483 318 187],214,5,8040,4.087442806304017,80.0,20.0
1967,0,1967,[ 64 183 257 234 197],416,4,8044,4.087398373983739,20.0,0.0
1968,0,1968,[483 313  64 318 187],214,5,8049,4.087861858811579,80.0,20.0
1969,0,1969,[483 313  64 318 187],214,5,8054,4.088324873096447,80.0,20.0
1970,0,1970,[483 313  64 318 187],618,5,8059,4.088787417554541,80.0,20.0
1971,0,1971,[483 313  64 318 187],618,5,8064,4.089249492900609,80.0,20.0
1972,0,1972,[ 69 174   7 294 258],630,2,8066,4.088190572731881,0.0,0.0
1973,0,1973,[483 313  64 318 187],214,5,8071,4.088652482269503,80.0,20.0
1974,0,1974,[216 118 483 117  15],62,3,8074,4.088101265822785,20.0,0.0
1975,0,1975,[483 313  64 318 187],618,5,8079,4.088562753036437,80.0,20.0
1976,0,1976,[483 313  64 318 187],618,5,8084,4.089023773394032,80.0,20.0
1977,0,1977,[269 475 172 228 288],711,3,8087,4.088473205257836,0.0,20.0
1978,0,1978,[588 301 135  79 132],437,3,8090,4.087923193532087,0.0,0.0
1979,0,1979,[483 313  64 318 187],618,5,8095,4.088383838383838,80.0,20.0
1980,0,1980,[471 275 180 121 181],128,5,8100,4.08884401817264,0.0,20.0
1981,0,1981,[483 313  64 318 187],214,5,8105,4.089303733602422,80.0,20.0
1982,0,1982,[215 597 423 257 111],705,3,8108,4.088754412506304,0.0,0.0
1983,0,1983,[483 313  64 318 187],214,5,8113,4.089213709677419,80.0,20.0
1984,0,1984,[483 313  64 318 187],618,5,8118,4.089672544080605,80.0,20.0
1985,0,1985,[265 748 174 288   4],654,4,8122,4.089627391742195,0.0,20.0
1986,0,1986,[135 132 117 204  25],373,3,8125,4.089079013588324,0.0,0.0
1987,0,1987,[483 313  64 318 187],618,5,8130,4.089537223340041,80.0,20.0
1988,0,1988,[483 313  64 318 187],214,5,8135,4.089994972347913,80.0,20.0
1989,0,1989,[210  82 235 301   9],416,4,8139,4.089949748743718,0.0,0.0
1990,0,1990,[181 435 187 483 258],698,0,8139,4.08789552988448,20.0,20.0
1991,0,1991,[483 176 568  97 204],618,4,8143,4.08785140562249,20.0,0.0
1992,0,1992,[ 28  79  98 180 475],437,3,8146,4.0873055694932265,0.0,20.0
1993,0,1993,[ 64 313 483 318 187],618,5,8151,4.087763289869609,80.0,20.0
1994,0,1994,[117 286 215 186 202],437,1,8152,4.086215538847118,0.0,0.0
1995,0,1995,[ 95  64 121 125  11],416,4,8156,4.086172344689379,20.0,0.0
1996,0,1996,[179 195 127 204 173],416,4,8160,4.086129193790686,0.0,0.0
1997,0,1997,[313  64 483 318 187],214,5,8165,4.086586586586587,80.0,20.0
1998,0,1998,[313  64 483 318 187],214,5,8170,4.08704352176088,80.0,20.0
1999,0,1999,[ 95   9 143 176 318],764,5,8175,4.0875,20.0,0.0
2000,0,2000,[475 333 302   4 117],854,1,8176,4.085957021489255,0.0,0.0
2001,0,2001,[ 22 508 210 276  96],601,4,8180,4.085914085914086,0.0,0.0
2002,0,2002,[161 328 257  88 196],43,5,8185,4.086370444333499,0.0,0.0
2003,0,2003,[ 12 496 185 161 655],618,5,8190,4.086826347305389,20.0,0.0
2004,0,2004,[118 301 275  89  71],437,1,8191,4.0852867830423945,0.0,0.0
2005,0,2005,[ 25 357 194 318 118],854,2,8193,4.084247258225324,20.0,0.0
2006,0,2006,[313  64 483 318 187],214,5,8198,4.084703537618336,80.0,20.0
2007,0,2007,[313  64 483 318 187],618,5,8203,4.085159362549801,80.0,20.0
2008,0,2008,[678 423  70 191 328],721,2,8205,4.084121453459432,0.0,0.0
2009,0,2009,[313  64 483 318 187],618,5,8210,4.08457711442786,80.0,20.0
2010,0,2010,[235  82  25  64 405],43,4,8214,4.08453505718548,20.0,0.0
2011,0,2011,[313  64 483 318 187],618,5,8219,4.084990059642147,80.0,20.0
2012,0,2012,[313  64 483 318 187],214,5,8224,4.085444610034774,80.0,20.0
2013,0,2013,[313  64 483 318 187],214,5,8229,4.0858987090367425,80.0,20.0
2014,0,2014,[313  64 483 318 187],618,5,8234,4.0863523573200995,80.0,20.0
2015,0,2015,[313  64 483 318 187],618,5,8239,4.086805555555555,80.0,20.0
2016,0,2016,[313  64 483 318 187],214,5,8244,4.087258304412494,80.0,20.0
2017,0,2017,[313  64 483 318 187],618,5,8249,4.0877106045589695,80.0,20.0
2018,0,2018,[172  89 179 385 603],751,4,8253,4.087667161961367,0.0,0.0
2019,0,2019,[748   8   9 132 235],416,4,8257,4.0876237623762375,0.0,0.0
2020,0,2020,[ 82  70 276 195 215],437,1,8258,4.086095992083127,0.0,0.0
2021,0,2021,[118 423 181  70  69],654,3,8261,4.085558852621167,0.0,20.0
2022,0,2022,[245 168 180 546 515],417,4,8265,4.0855165595650025,0.0,0.0
2023,0,2023,[237 318 118  97 144],62,1,8266,4.08399209486166,20.0,0.0
2024,0,2024,[135 174 100  50 357],198,4,8270,4.083950617283951,0.0,20.0
2025,0,2025,[405 328 118 195   7],159,3,8273,4.083415597235933,0.0,0.0
2026,0,2026,[313  64 483 318 187],618,5,8278,4.0838677849037985,80.0,20.0
2027,0,2027,[191 151 271 216 403],922,1,8279,4.082347140039448,0.0,0.0
2028,0,2028,[ 64 313 483 318 187],214,5,8284,4.082799408575653,80.0,20.0
2029,0,2029,[ 64 313 483 318 187],214,5,8289,4.083251231527093,80.0,20.0
2030,0,2030,[ 70 100 257 210 194],751,5,8294,4.083702609551945,0.0,0.0
2031,0,2031,[  8 269 118 678 318],416,3,8297,4.083169291338582,20.0,0.0
2032,0,2032,[ 64 313 483 318 187],618,5,8302,4.083620265617315,80.0,20.0
2033,0,2033,[ 64 313 483 318 187],214,5,8307,4.084070796460177,80.0,20.0
2034,0,2034,[ 64 313 483 318 187],618,5,8312,4.0845208845208845,80.0,20.0
2035,0,2035,[118 322 288  56 258],805,1,8313,4.083005893909626,0.0,20.0
2036,0,2036,[125 273 200 191  71],618,4,8317,4.082965144820815,0.0,0.0
2037,0,2037,[ 11  25 127 111  15],416,5,8322,4.083415112855741,0.0,0.0
2038,0,2038,[  9 588 655 215 405],345,4,8326,4.083374203040706,0.0,0.0
2039,0,2039,[ 64 313 483 318 187],214,5,8331,4.083823529411765,80.0,20.0
2040,0,2040,[200  12 183 288 427],416,5,8336,4.084272415482607,20.0,20.0
2041,0,2041,[191  71 234  28 300],416,5,8341,4.084720861900098,0.0,0.0
2042,0,2042,[ 64 313 483 318 187],618,5,8346,4.085168869309839,80.0,20.0
2043,0,2043,[ 64 313 483 318 187],618,5,8351,4.085616438356165,80.0,20.0
2044,0,2044,[168 742 475  88 546],416,2,8353,4.084596577017115,0.0,0.0
2045,0,2045,[161 288 176 302 216],405,2,8355,4.083577712609971,0.0,20.0
2046,0,2046,[ 64 313 483 318 187],214,5,8360,4.084025403028822,80.0,20.0
2047,0,2047,[ 82  12 168 435 288],405,3,8363,4.08349609375,20.0,20.0
2048,0,2048,[258 301  56 597  22],588,5,8368,4.083943387018057,0.0,0.0
2049,0,2049,[313  64 483 318 187],214,5,8373,4.084390243902439,80.0,20.0
2050,0,2050,[385 265 172  96 282],416,5,8378,4.084836665041443,0.0,0.0
2051,0,2051,[ 11 125 322 273 515],416,4,8382,4.084795321637427,0.0,0.0
2052,0,2052,[313  64 483 318 187],214,5,8387,4.085241110569898,80.0,20.0
2053,0,2053,[313  64 483 318 187],214,5,8392,4.085686465433301,80.0,20.0
2054,0,2054,[276 323  98 210 179],198,3,8395,4.085158150851582,0.0,20.0
2055,0,2055,[405 202   1   7 568],417,2,8397,4.0841439688715955,0.0,0.0
2056,0,2056,[546 175 273 168 271],297,3,8400,4.083616917841517,0.0,0.0
2057,0,2057,[151 588 204 168  22],711,4,8404,4.0835762876579205,0.0,0.0
2058,0,2058,[483  12  69 234  89],417,4,8408,4.083535696940262,40.0,0.0
2059,0,2059,[ 64 313 483 318 187],214,5,8413,4.083980582524272,80.0,20.0
2060,0,2060,[168 257 427 172 265],416,4,8417,4.083939835031538,0.0,0.0
2061,0,2061,[313  64 483 318 187],214,5,8422,4.084384093113482,80.0,20.0
2062,0,2062,[ 50 273 191   9 483],62,5,8427,4.08482792050412,20.0,20.0
2063,0,2063,[302 235 275 216 301],416,4,8431,4.084786821705427,0.0,0.0
2064,0,2064,[313  64 483 318 187],214,5,8436,4.085230024213075,80.0,20.0
2065,0,2065,[313  64 483 318 187],618,5,8441,4.08567279767667,80.0,20.0
2066,0,2066,[135 194  28  64 144],373,2,8443,4.084663763909047,20.0,0.0
2067,0,2067,[313  64 483 318 187],618,5,8448,4.085106382978723,80.0,20.0
2068,0,2068,[313  64 483 318 187],214,5,8453,4.0855485741904305,80.0,20.0
2069,0,2069,[179 216 471 182 121],416,4,8457,4.085507246376811,0.0,0.0
2070,0,2070,[313  64 483 318 187],618,5,8462,4.08594881699662,80.0,20.0
2071,0,2071,[313  64 483 318 187],618,5,8467,4.086389961389961,80.0,20.0
2072,0,2072,[135  89 117 181 202],417,3,8470,4.085865894838398,0.0,20.0
2073,0,2073,[313  64 483 318 187],214,5,8475,4.086306653809064,80.0,20.0
2074,0,2074,[313  64 483 318 187],214,5,8480,4.086746987951807,80.0,20.0
2075,0,2075,[313  64 483 318 187],618,5,8485,4.08718689788054,80.0,20.0
2076,0,2076,[483 174 222 318  64],496,3,8488,4.086663456909004,60.0,0.0
2077,0,2077,[313  64 483 318 187],618,5,8493,4.087102983638114,80.0,20.0
2078,0,2078,[111 568  25  70 179],751,3,8496,4.086580086580087,0.0,0.0
2079,0,2079,[588 515  71 282 173],416,5,8501,4.087019230769231,0.0,0.0
2080,0,2080,[475 196 191 144 302],417,3,8504,4.086496876501682,0.0,0.0
2081,0,2081,[265  12  56 211 176],416,5,8509,4.086935638808837,20.0,0.0
2082,0,2082,[313  64 483 318 187],214,5,8514,4.087373979836774,80.0,20.0
2083,0,2083,[313  64 483 318 187],214,5,8519,4.087811900191938,80.0,20.0
2084,0,2084,[313  64 483 318 187],214,5,8524,4.088249400479616,80.0,20.0
2085,0,2085,[ 50 151 276  64 405],62,4,8528,4.088207094918505,20.0,20.0
2086,0,2086,[313  64 483 318 187],214,5,8533,4.088643986583613,80.0,20.0
2087,0,2087,[323 100 151 194 742],416,3,8536,4.088122605363985,0.0,0.0
2088,0,2088,[215 271   4 597 275],62,2,8538,4.087123025370991,0.0,0.0
2089,0,2089,[168 181 228 204 237],922,3,8541,4.0866028708133975,0.0,20.0
2090,0,2090,[313  64 483 318 187],618,5,8546,4.087039693926351,80.0,20.0
2091,0,2091,[313  64 483 318 187],214,5,8551,4.087476099426386,80.0,20.0
2092,0,2092,[234 121 588 313   7],588,4,8555,4.087434304825609,20.0,20.0
2093,0,2093,[313  64 483 318 187],214,5,8560,4.087870105062082,80.0,20.0
2094,0,2094,[313  64 483 318 187],214,5,8565,4.088305489260144,80.0,20.0
2095,0,2095,[313  64 483 318 187],618,5,8570,4.088740458015267,80.0,20.0
2096,0,2096,[313  64 483 318 187],214,5,8575,4.089175011921793,80.0,20.0
2097,0,2097,[742   7 153 265 161],417,1,8576,4.087702573879886,0.0,0.0
2098,0,2098,[111 245 313 174 748],345,3,8579,4.087184373511196,20.0,20.0
2099,0,2099,[313  64 483 318 187],214,5,8584,4.0876190476190475,80.0,20.0
2100,0,2100,[313  64 483 318 187],214,5,8589,4.088053307948596,80.0,20.0
2101,0,2101,[186 121 302   9 238],854,2,8591,4.087059942911512,0.0,0.0
2102,0,2102,[204 385 175 269 202],373,2,8593,4.086067522586781,0.0,0.0
2103,0,2103,[ 28 185 151 471 286],297,3,8596,4.085551330798479,0.0,0.0
2104,0,2104,[268 173 294 318 748],721,3,8599,4.085035629453682,20.0,0.0
2105,0,2105,[313  64 483 318 187],214,5,8604,4.085470085470085,80.0,20.0
2106,0,2106,[ 28 603  98 288 181],805,2,8606,4.084480303749407,0.0,60.0
2107,0,2107,[313  64 483 318 187],214,5,8611,4.084914611005693,80.0,20.0
2108,0,2108,[185 597 117 127 678],805,2,8613,4.083926031294452,0.0,0.0
2109,0,2109,[313  64 483 318 187],214,5,8618,4.084360189573459,80.0,20.0
2110,0,2110,[313  64 483 318 187],618,5,8623,4.084793936522975,80.0,20.0
2111,0,2111,[313  64 483 318 187],618,5,8628,4.0852272727272725,80.0,20.0
2112,0,2112,[288 318 195 483  89],437,2,8630,4.084240416469474,40.0,20.0
2113,0,2113,[655 318 588  15 210],705,2,8632,4.083254493850521,20.0,0.0
2114,0,2114,[222 238 286 211 603],354,3,8635,4.08274231678487,0.0,0.0
2115,0,2115,[313  64 483 318 187],618,5,8640,4.083175803402646,80.0,20.0
2116,0,2116,[ 69 202 174 186 328],43,4,8644,4.0831365139348135,0.0,0.0
2117,0,2117,[313  64 483 318 187],618,5,8649,4.0835694050991505,80.0,20.0
2118,0,2118,[235 215   8  25 313],416,4,8653,4.08352996696555,20.0,20.0
2119,0,2119,[313  64 483 318 187],214,5,8658,4.083962264150943,80.0,20.0
2120,0,2120,[313  64 483 318 187],618,5,8663,4.084394153701084,80.0,20.0
2121,0,2121,[313  64 483 318 187],618,5,8668,4.084825636192272,80.0,20.0
2122,0,2122,[185 403 216 471 202],618,2,8670,4.083843617522374,0.0,0.0
2123,0,2123,[313  64 483 318 187],214,5,8675,4.084274952919021,80.0,20.0
2124,0,2124,[313  64 483 318 187],618,5,8680,4.084705882352941,80.0,20.0
2125,0,2125,[175  98 273 174 333],854,3,8683,4.084195672624647,0.0,20.0
2126,0,2126,[ 82  96 483 273  95],253,3,8686,4.083685942642219,20.0,0.0
2127,0,2127,[ 95  12  15 300   4],253,5,8691,4.084116541353383,20.0,0.0
2128,0,2128,[186  28 238  12 655],437,3,8694,4.083607327383748,20.0,0.0
2129,0,2129,[196 172   8  56 143],618,4,8698,4.083568075117371,0.0,0.0
2130,0,2130,[313  64 483 318 187],618,5,8703,4.083998122946973,80.0,20.0
2131,0,2131,[313  64 483 318 187],214,5,8708,4.084427767354597,80.0,20.0
2132,0,2132,[496 471 196 257 187],416,4,8712,4.084388185654008,0.0,0.0
2133,0,2133,[483 742  56 181 385],588,4,8716,4.084348641049672,20.0,20.0
2134,0,2134,[313  64 483 318 187],214,5,8721,4.084777517564403,80.0,20.0
2135,0,2135,[313  64 483 318 187],618,5,8726,4.085205992509363,80.0,20.0
2136,0,2136,[313  64 483 318 187],618,5,8731,4.085634066448292,80.0,20.0
2137,0,2137,[313  64 483 318 187],618,5,8736,4.086061739943872,80.0,20.0
2138,0,2138,[546 179 322 323 238],805,3,8739,4.085553997194951,0.0,0.0
2139,0,2139,[313  64 483 318 187],214,5,8744,4.085981308411215,80.0,20.0
2140,0,2140,[135 603 173 475  89],214,4,8748,4.085941148995796,0.0,0.0
2141,0,2141,[313  64 483 318 187],214,5,8753,4.086367880485527,80.0,20.0
2142,0,2142,[215  11  69  79 176],198,4,8757,4.086327578161456,0.0,0.0
2143,0,2143,[313  64 483 318 187],618,5,8762,4.086753731343284,80.0,20.0
2144,0,2144,[313  64 483 318 187],618,5,8767,4.087179487179487,80.0,20.0
2145,0,2145,[313  64 483 318 187],618,5,8772,4.087604846225536,80.0,20.0
2146,0,2146,[313  64 483 318 187],618,5,8777,4.088029809035864,80.0,20.0
2147,0,2147,[313  64 483 318 187],618,5,8782,4.088454376163873,80.0,20.0
2148,0,2148,[405 302 117 275  56],62,3,8785,4.087947882736156,0.0,0.0
2149,0,2149,[313  64 483 318 187],618,5,8790,4.088372093023255,80.0,20.0
2150,0,2150,[313  64 483 318 187],618,5,8795,4.088795908879591,80.0,20.0
2151,0,2151,[  4 588   9 742 603],416,5,8800,4.089219330855019,0.0,0.0
2152,0,2152,[313  64 483 318 187],618,5,8805,4.089642359498375,80.0,20.0
2153,0,2153,[313  64 483 318 187],214,5,8810,4.090064995357475,80.0,20.0
2154,0,2154,[151 196 357 742  82],417,4,8814,4.090023201856148,0.0,0.0
2155,0,2155,[313  64 483 318 187],214,5,8819,4.090445269016698,80.0,20.0
2156,0,2156,[313  64 483 318 187],214,5,8824,4.0908669448307835,80.0,20.0
2157,0,2157,[301 173 216  50  64],416,5,8829,4.091288229842447,20.0,20.0
2158,0,2158,[301 269  95  11 268],416,4,8833,4.091245947197777,0.0,0.0
2159,0,2159,[313  64 483 318 187],214,5,8838,4.091666666666667,80.0,20.0
2160,0,2160,[313  64 483 318 187],214,5,8843,4.0920869967607585,80.0,20.0
2161,0,2161,[  8 174  11 185 268],416,5,8848,4.092506938020351,0.0,0.0
2162,0,2162,[  7 313 237 125 111],416,4,8852,4.092464170134073,20.0,20.0
2163,0,2163,[313  64 483 318 187],618,5,8857,4.092883548983364,80.0,20.0
2164,0,2164,[234 174 200 117 475],805,3,8860,4.092378752886836,0.0,0.0
2165,0,2165,[313  64 483 318 187],214,5,8865,4.092797783933518,80.0,20.0
2166,0,2166,[ 25  88 275  70 144],416,4,8869,4.092754960775265,0.0,0.0
2167,0,2167,[186  71 423 210 143],230,5,8874,4.093173431734317,0.0,0.0
2168,0,2168,[282  70 276 181 238],416,4,8878,4.093130474873213,0.0,20.0
2169,0,2169,[  1 135 483  64 100],854,4,8882,4.0930875576036865,40.0,0.0
2170,0,2170,[216 435 515 588 118],297,3,8885,4.092584062643943,0.0,0.0
2171,0,2171,[257  22 127  56 180],887,4,8889,4.092541436464089,0.0,0.0
2172,0,2172,[ 95   1 483 183 173],253,5,8894,4.092959042797975,20.0,0.0
2173,0,2173,[313  64 483 318 187],618,5,8899,4.093376264949402,80.0,20.0
2174,0,2174,[ 95 228  22 121 181],698,0,8899,4.091494252873563,0.0,20.0
2175,0,2175,[313  64 483 318 187],618,5,8904,4.091911764705882,80.0,20.0
2176,0,2176,[245 153 288 742 269],297,2,8906,4.090950849793294,0.0,20.0
2177,0,2177,[ 22 144 185 258 216],297,4,8910,4.090909090909091,0.0,0.0
2178,0,2178,[655 100 210 265  69],618,4,8914,4.090867370353373,0.0,0.0
2179,0,2179,[313  64 483 318 187],214,5,8919,4.091284403669725,80.0,20.0
2180,0,2180,[288 195  12 161 204],618,2,8921,4.090325538743696,20.0,20.0
2181,0,2181,[313  64 483 318 187],214,5,8926,4.090742438130156,80.0,20.0
2182,0,2182,[313  64 483 318 187],214,5,8931,4.091158955565735,80.0,20.0
2183,0,2183,[176 302  22 111  25],854,0,8931,4.089285714285714,0.0,0.0
2184,0,2184,[127 144 132 161  11],505,2,8933,4.0883295194508005,0.0,0.0
2185,0,2185,[186 597 742 172 100],588,4,8937,4.0882891125343095,0.0,0.0
2186,0,2186,[313  64 483 318 187],618,5,8942,4.088705989940558,80.0,20.0
2187,0,2187,[222 215 121 258  69],128,2,8944,4.087751371115174,0.0,0.0
2188,0,2188,[269 276  12   4  15],654,3,8947,4.087254454088625,20.0,0.0
2189,0,2189,[313  64 483 318 187],214,5,8952,4.087671232876712,80.0,20.0
2190,0,2190,[168 127  79 403 210],805,3,8955,4.087174806024646,0.0,0.0
2191,0,2191,[ 12 100  56 186 238],417,4,8959,4.087135036496351,20.0,0.0
2192,0,2192,[313 176  70 496 204],618,3,8962,4.086639306885545,20.0,20.0
2193,0,2193,[322 385  82 176 427],416,4,8966,4.086599817684594,0.0,0.0
2194,0,2194,[313  64 483 318 187],618,5,8971,4.087015945330296,80.0,20.0
2195,0,2195,[313  64 483 318 187],618,5,8976,4.087431693989071,80.0,20.0
2196,0,2196,[ 11   7 132 597 172],416,4,8980,4.087391898042785,0.0,0.0
2197,0,2197,[ 22 273 185 173  12],854,4,8984,4.087352138307552,20.0,0.0
2198,0,2198,[405 475  12 328 286],62,2,8986,4.086402910413825,20.0,0.0
2199,0,2199,[144 181   8 405 238],416,5,8991,4.086818181818182,0.0,20.0
2200,0,2200,[515 127  56 121 196],416,5,8996,4.087233075874602,0.0,0.0
2201,0,2201,[323 215 515 588 427],416,4,9000,4.087193460490464,0.0,0.0
2202,0,2202,[269 174 546 197  98],805,3,9003,4.0866999546073535,0.0,20.0
2203,0,2203,[182 100  70 179 385],417,4,9007,4.086660617059891,0.0,0.0
2204,0,2204,[151  12 508  70  64],314,3,9010,4.086167800453515,40.0,0.0
2205,0,2205,[238 181 234 121 678],416,4,9014,4.086128739800544,0.0,20.0
2206,0,2206,[269 405 546 181 172],654,4,9018,4.086089714544631,0.0,20.0
2207,0,2207,[313  64 483 318 187],618,5,9023,4.086503623188406,80.0,20.0
2208,0,2208,[403  11 174 496 282],618,4,9027,4.086464463558171,0.0,0.0
2209,0,2209,[286 191 173  11 313],416,5,9032,4.086877828054298,20.0,20.0
2210,0,2210,[313  64 483 318 187],214,5,9037,4.087290818634102,80.0,20.0
2211,0,2211,[313  64 483 318 187],214,5,9042,4.087703435804702,80.0,20.0
2212,0,2212,[313  64 483 318 187],618,5,9047,4.0881156800723,80.0,20.0
2213,0,2213,[ 79 228 238 197 265],405,3,9050,4.087624209575429,0.0,0.0
2214,0,2214,[313  64 483 318 187],214,5,9055,4.08803611738149,80.0,20.0
2215,0,2215,[313  64 483 318 187],618,5,9060,4.088447653429603,80.0,20.0
2216,0,2216,[125 275 748   1 202],416,5,9065,4.088858818222824,0.0,0.0
2217,0,2217,[313  64 483 318 187],214,5,9070,4.0892696122633,80.0,20.0
2218,0,2218,[313  64 483 318 187],214,5,9075,4.089680036052275,80.0,20.0
2219,0,2219,[100 215 235 237 172],62,3,9078,4.089189189189189,0.0,0.0
2220,0,2220,[313  64 483 318 187],618,5,9083,4.089599279603782,80.0,20.0
2221,0,2221,[196 515  50 268 568],417,3,9086,4.089108910891089,0.0,20.0
2222,0,2222,[313  64 483 318 187],618,5,9091,4.089518668466037,80.0,20.0
2223,0,2223,[313  64 483 318 187],618,5,9096,4.089928057553957,80.0,20.0
2224,0,2224,[328 211 215 265   4],416,5,9101,4.090337078651685,0.0,0.0
2225,0,2225,[313  64 483 318 187],618,5,9106,4.090745732255166,80.0,20.0
2226,0,2226,[313  64 483 318 187],214,5,9111,4.091154018859452,80.0,20.0
2227,0,2227,[172   4 385 427 234],642,2,9113,4.090215439856373,0.0,0.0
2228,0,2228,[ 64  88 215  70 276],416,3,9116,4.089726334679228,20.0,0.0
2229,0,2229,[313  64 483 318 187],618,5,9121,4.090134529147982,80.0,20.0
2230,0,2230,[313  64 483 318 187],214,5,9126,4.090542357687136,80.0,20.0
2231,0,2231,[313  64 483 318 187],214,5,9131,4.090949820788531,80.0,20.0
2232,0,2232,[ 22 588 483 228  71],601,3,9134,4.090461262875056,20.0,0.0
2233,0,2233,[ 15 180 151 173  56],417,5,9139,4.090868397493286,0.0,0.0
2234,0,2234,[323  11 216  82  89],198,3,9142,4.0903803131991054,0.0,0.0
2235,0,2235,[183 168  11 238 333],416,5,9147,4.090787119856888,0.0,0.0
2236,0,2236,[405 301  70 111 318],43,5,9152,4.091193562807331,20.0,0.0
2237,0,2237,[282  12 294 117 153],253,4,9156,4.091152815013404,20.0,0.0
2238,0,2238,[175 187 294 427 168],698,1,9157,4.089772219740956,0.0,0.0
2239,0,2239,[313  64 483 318 187],214,5,9162,4.090178571428571,80.0,20.0
2240,0,2240,[313  64 483 318 187],618,5,9167,4.0905845604640785,80.0,20.0
2241,0,2241,[313  64 483 318 187],214,5,9172,4.090990187332738,80.0,20.0
2242,0,2242,[313  64 483 318 187],214,5,9177,4.091395452518948,80.0,20.0
2243,0,2243,[313  64 483 318 187],618,5,9182,4.091800356506239,80.0,20.0
2244,0,2244,[313  64 483 318 187],618,5,9187,4.092204899777283,80.0,20.0
2245,0,2245,[222 282 294   1 258],203,1,9188,4.090828138913624,0.0,0.0
2246,0,2246,[313  64 483 318 187],214,5,9193,4.091232754784157,80.0,20.0
2247,0,2247,[597  79  11 168 216],805,2,9195,4.090302491103203,0.0,0.0
2248,0,2248,[313  64 483 318 187],618,5,9200,4.090706980880391,80.0,20.0
2249,0,2249,[313  64 483 318 187],618,5,9205,4.091111111111111,80.0,20.0
2250,0,2250,[275 172   8 423 181],654,4,9209,4.091070635273212,0.0,20.0
2251,0,2251,[313  64 483 318 187],214,5,9214,4.091474245115453,80.0,20.0
2252,0,2252,[313  64 483 318 187],618,5,9219,4.091877496671105,80.0,20.0
2253,0,2253,[ 25  64 300 143 191],416,5,9224,4.092280390417036,20.0,0.0
2254,0,2254,[151 475  71 172 202],588,3,9227,4.09179600886918,0.0,0.0
2255,0,2255,[100 144 588 435 655],437,2,9229,4.090868794326241,0.0,0.0
2256,0,2256,[ 22 245 125 385 435],505,3,9232,4.090385467434648,0.0,0.0
2257,0,2257,[196 183 515 121 195],417,4,9236,4.090345438441099,0.0,0.0
2258,0,2258,[111 151   8   1 273],805,2,9238,4.089420097388225,0.0,0.0
2259,0,2259,[313  64 483 318 187],214,5,9243,4.0898230088495575,80.0,20.0
2260,0,2260,[313  64 483 318 187],214,5,9248,4.090225563909774,80.0,20.0
2261,0,2261,[313 475 117 288 173],214,4,9252,4.090185676392573,20.0,40.0
2262,0,2262,[313  64 483 318 187],618,5,9257,4.090587715422006,80.0,20.0
2263,0,2263,[111 215 515 161 125],416,5,9262,4.090989399293286,0.0,0.0
2264,0,2264,[125 161 546   8  28],416,4,9266,4.090949227373068,0.0,0.0
2265,0,2265,[ 56 153 300 313  50],654,5,9271,4.09135039717564,20.0,40.0
2266,0,2266,[265  95 357 191 655],405,3,9274,4.0908689898544335,0.0,0.0
2267,0,2267,[ 69  96 175 117 237],198,2,9276,4.08994708994709,0.0,0.0
2268,0,2268,[313  64 483 318 187],618,5,9281,4.090348171000441,80.0,20.0
2269,0,2269,[496 179  71 100 144],373,2,9283,4.089427312775331,0.0,0.0
2270,0,2270,[ 64 403 181  98 269],416,5,9288,4.0898282694848085,20.0,40.0
2271,0,2271,[313  64 483 318 187],214,5,9293,4.090228873239437,80.0,20.0
2272,0,2272,[276 181 515 313 265],416,4,9297,4.090189177298724,20.0,40.0
2273,0,2273,[181   1 423 245  22],62,2,9299,4.089270008795075,0.0,20.0
2274,0,2274,[143 273  82 151  56],805,2,9301,4.088351648351648,0.0,0.0
2275,0,2275,[405 568 215  98  11],198,3,9304,4.087873462214411,0.0,20.0
2276,0,2276,[ 56 268   9 294 144],314,3,9307,4.087395696091348,0.0,0.0
2277,0,2277,[597 216 143  11  71],805,0,9307,4.085601404741001,0.0,0.0
2278,0,2278,[313  64 483 318 187],214,5,9312,4.086002632733655,80.0,20.0
2279,0,2279,[313  64 483 318 187],214,5,9317,4.08640350877193,80.0,20.0
2280,0,2280,[179 748 195  88 427],373,4,9321,4.086365629110039,0.0,0.0
2281,0,2281,[118 597  12 127 211],417,4,9325,4.086327782646801,20.0,0.0
2282,0,2282,[313  64 483 318 187],618,5,9330,4.086727989487517,80.0,20.0
2283,0,2283,[313  64 483 318 187],214,5,9335,4.087127845884413,80.0,20.0
2284,0,2284,[313  64 483 318 187],618,5,9340,4.087527352297593,80.0,20.0
2285,0,2285,[313  64 483 318 187],214,5,9345,4.087926509186352,80.0,20.0
2286,0,2286,[172 183  69 568 191],62,4,9349,4.087888062964582,0.0,0.0
2287,0,2287,[179 748  95 183 181],416,3,9352,4.0874125874125875,0.0,20.0
2288,0,2288,[313  64 483 318 187],214,5,9357,4.08781127129751,80.0,20.0
2289,0,2289,[ 98 173 276 210 215],43,5,9362,4.0882096069869,0.0,20.0
2290,0,2290,[300 302 257  56  25],654,4,9366,4.088171104321257,0.0,0.0
2291,0,2291,[323 234 168 222 121],198,1,9367,4.086823734729494,0.0,0.0
2292,0,2292,[313  64 483 318 187],214,5,9372,4.087221979938945,80.0,20.0
2293,0,2293,[313  64 483 318 187],618,5,9377,4.087619877942458,80.0,20.0
2294,0,2294,[313  64 483 318 187],214,5,9382,4.0880174291939,80.0,20.0
2295,0,2295,[655  15 405  64  25],416,5,9387,4.088414634146342,20.0,0.0
2296,0,2296,[ 25  71 100 175 204],805,3,9390,4.087940792337832,0.0,0.0
2297,0,2297,[313  64 483 318 187],618,5,9395,4.088337684943429,80.0,20.0
2298,0,2298,[313  64 483 318 187],618,5,9400,4.088734232274902,80.0,20.0
2299,0,2299,[ 97 302 318 546 117],654,4,9404,4.088695652173913,20.0,0.0
2300,0,2300,[ 95  70 153  56  22],654,5,9409,4.089091699261191,0.0,0.0
2301,0,2301,[313  64 483 318 187],618,5,9414,4.089487402258905,80.0,20.0
2302,0,2302,[588  89 186  15 187],373,3,9417,4.089014329135909,0.0,0.0
2303,0,2303,[151 121 200 111 168],711,3,9420,4.088541666666667,0.0,0.0
2304,0,2304,[151 313 215  97 143],921,3,9423,4.088069414316703,20.0,20.0
2305,0,2305,[ 79 151 176 313 237],618,4,9427,4.088031222896791,20.0,20.0
2306,0,2306,[515 235  79 655 423],416,4,9431,4.087993064586042,0.0,0.0
2307,0,2307,[ 22  69 135 185 216],618,4,9435,4.087954939341421,0.0,0.0
2308,0,2308,[302 301 288  11 197],297,3,9438,4.087483759203118,0.0,20.0
2309,0,2309,[313  64 483 318 187],214,5,9443,4.087878787878788,80.0,20.0
2310,0,2310,[313  64 483 318 187],618,5,9448,4.088273474686283,80.0,20.0
2311,0,2311,[318 118 471  96 125],416,4,9452,4.088235294117647,20.0,0.0
2312,0,2312,[313  64 483 318 187],618,5,9457,4.088629485516645,80.0,20.0
2313,0,2313,[597  98   8 191 118],416,3,9460,4.088159031979257,0.0,20.0
2314,0,2314,[313  64 483 318 187],214,5,9465,4.088552915766739,80.0,20.0
2315,0,2315,[313  64 483 318 187],214,5,9470,4.088946459412781,80.0,20.0
2316,0,2316,[195 258 257 172 215],62,3,9473,4.088476478204575,0.0,0.0
2317,0,2317,[174 742 172  69 423],588,2,9475,4.087575496117343,0.0,0.0
2318,0,2318,[313  64 483 318 187],618,5,9480,4.087968952134541,80.0,20.0
2319,0,2319,[313  64 483 318 187],618,5,9485,4.088362068965517,80.0,20.0
2320,0,2320,[179 194 173  11 168],405,2,9487,4.087462300732443,0.0,0.0
2321,0,2321,[313  64 483 318 187],618,5,9492,4.087855297157622,80.0,20.0
2322,0,2322,[313  64 483 318 187],618,5,9497,4.0882479552303055,80.0,20.0
2323,0,2323,[181 202 197  50  56],751,4,9501,4.088209982788296,0.0,40.0
2324,0,2324,[385 269 405 289 403],345,2,9503,4.087311827956989,0.0,0.0
2325,0,2325,[161 204  82 300 179],49,1,9504,4.085984522785899,0.0,0.0
2326,0,2326,[125  22   9 286 185],416,5,9509,4.086377309840997,0.0,0.0
2327,0,2327,[313  64 483 318 187],214,5,9514,4.0867697594501715,80.0,20.0
2328,0,2328,[ 95 216 483 568 748],751,3,9517,4.086303134392443,20.0,0.0
2329,0,2329,[496 202 742 143   9],43,5,9522,4.086695278969957,0.0,0.0
2330,0,2330,[ 11 237 222 210 235],297,4,9526,4.086658086658087,0.0,0.0
2331,0,2331,[496 237 186 118 234],437,3,9529,4.0861921097770155,0.0,0.0
2332,0,2332,[ 98  56 282 172 186],588,4,9533,4.086155165023575,0.0,20.0
2333,0,2333,[313  64 483 318 187],618,5,9538,4.086546700942588,80.0,20.0
2334,0,2334,[742 168  11 196 294],417,4,9542,4.086509635974304,0.0,0.0
2335,0,2335,[  8 313 194 234 210],405,4,9546,4.086472602739726,20.0,20.0
2336,0,2336,[ 95 288 202 245  88],642,3,9549,4.086007702182285,0.0,20.0
2337,0,2337,[ 82 435 191 275 172],373,4,9553,4.085970915312233,0.0,0.0
2338,0,2338,[322  25 357 237  28],416,3,9556,4.085506626763574,0.0,0.0
2339,0,2339,[268 235 273 288 276],416,3,9559,4.085042735042735,0.0,20.0
2340,0,2340,[313  64 483 318 187],618,5,9564,4.08543357539513,80.0,20.0
2341,0,2341,[313  64 483 318 187],214,5,9569,4.085824081981213,80.0,20.0
2342,0,2342,[313  64 483 318 187],618,5,9574,4.08621425522834,80.0,20.0
2343,0,2343,[ 70 197 161 185 196],618,3,9577,4.085750853242321,0.0,0.0
2344,0,2344,[191  96 200 508 172],417,2,9579,4.084861407249467,0.0,0.0
2345,0,2345,[313  64 483 318 187],214,5,9584,4.085251491901109,80.0,20.0
2346,0,2346,[269  71 195 210 196],373,5,9589,4.085641244141457,0.0,0.0
2347,0,2347,[234 427 185 289 111],416,4,9593,4.085604770017036,0.0,0.0
2348,0,2348,[ 82 176 234 168 186],230,5,9598,4.085994040017028,0.0,0.0
2349,0,2349,[313  64 483 318 187],214,5,9603,4.086382978723404,80.0,20.0
2350,0,2350,[313  64 483 318 187],214,5,9608,4.086771586558911,80.0,20.0
2351,0,2351,[423 195   9 597 100],416,4,9612,4.086734693877551,0.0,0.0
2352,0,2352,[313  64 483 318 187],214,5,9617,4.0871228219294515,80.0,20.0
2353,0,2353,[  1 181 275 333 496],588,3,9620,4.086661002548853,0.0,20.0
2354,0,2354,[ 11 143 173 403 271],805,2,9622,4.085774946921444,0.0,0.0
2355,0,2355,[  4 180 748 196 176],805,1,9623,4.08446519524618,0.0,0.0
2356,0,2356,[313  64 483 318 187],618,5,9628,4.084853627492575,80.0,20.0
2357,0,2357,[313  64 483 318 187],618,5,9633,4.085241730279898,80.0,20.0
2358,0,2358,[313  64 483 318 187],618,5,9638,4.08562950402713,80.0,20.0
2359,0,2359,[313  64 483 318 187],618,5,9643,4.086016949152542,80.0,20.0
2360,0,2360,[313  64 483 318 187],618,5,9648,4.0864040660736975,80.0,20.0
2361,0,2361,[313  64 483 318 187],618,5,9653,4.086790855207451,80.0,20.0
2362,0,2362,[313  64 483 318 187],618,5,9658,4.087177316969953,80.0,20.0
2363,0,2363,[313  64 483 318 187],214,5,9663,4.08756345177665,80.0,20.0
2364,0,2364,[313  64 483 318 187],618,5,9668,4.087949260042283,80.0,20.0
2365,0,2365,[313  64 483 318 187],618,5,9673,4.088334742180896,80.0,20.0
2366,0,2366,[313  64 483 318 187],214,5,9678,4.08871989860583,80.0,20.0
2367,0,2367,[228 182 357  28 100],62,3,9681,4.088260135135135,0.0,0.0
2368,0,2368,[174 151 202 173 182],297,2,9683,4.087378640776699,0.0,0.0
2369,0,2369,[ 25  89 603 174   4],297,4,9687,4.087341772151898,0.0,0.0
2370,0,2370,[313  64 483 318 187],618,5,9692,4.087726697595951,80.0,20.0
2371,0,2371,[173  25  12 200 235],805,4,9696,4.087689713322091,20.0,0.0
2372,0,2372,[313  64 483 318 187],214,5,9701,4.088074167720185,80.0,20.0
2373,0,2373,[313  64 483 318 187],618,5,9706,4.088458298230834,80.0,20.0
2374,0,2374,[182 234 117 403 210],198,3,9709,4.088,0.0,0.0
2375,0,2375,[313  64 483 318 187],214,5,9714,4.088383838383838,80.0,20.0
2376,0,2376,[196 475 235 282  22],416,3,9717,4.087925957088768,0.0,0.0
2377,0,2377,[313  64 483 318 187],618,5,9722,4.088309503784693,80.0,20.0
2378,0,2378,[ 25  95 423 238 143],49,1,9723,4.087011349306431,0.0,0.0
2379,0,2379,[313  64 483 318 187],214,5,9728,4.087394957983193,80.0,20.0
2380,0,2380,[313  64 483 318 187],618,5,9733,4.087778244435111,80.0,20.0
2381,0,2381,[323  97 118 181 405],198,1,9734,4.0864819479429055,0.0,20.0
2382,0,2382,[313  64 483 318 187],618,5,9739,4.0868652958455725,80.0,20.0
2383,0,2383,[195 275  15 135 318],373,4,9743,4.086828859060403,20.0,0.0
2384,0,2384,[313  64 483 318 187],618,5,9748,4.087211740041929,80.0,20.0
2385,0,2385,[313  64 483 318 187],618,5,9753,4.087594300083822,80.0,20.0
2386,0,2386,[  1  64 100 323 276],416,3,9756,4.0871386677838295,20.0,0.0
2387,0,2387,[196 121 288 117 655],618,4,9760,4.0871021775544385,0.0,20.0
2388,0,2388,[313  64 483 318 187],214,5,9765,4.087484303055672,80.0,20.0
2389,0,2389,[313  64 483 318 187],618,5,9770,4.087866108786611,80.0,20.0
2390,0,2390,[132 200  69 153  11],198,5,9775,4.088247595148474,0.0,0.0
2391,0,2391,[313  64 483 318 187],618,5,9780,4.088628762541806,80.0,20.0
2392,0,2392,[273 172 276 546   7],416,3,9783,4.088173840367739,0.0,0.0
2393,0,2393,[313  64 483 318 187],214,5,9788,4.088554720133668,80.0,20.0
2394,0,2394,[313  64 483 318 187],214,5,9793,4.088935281837161,80.0,20.0
2395,0,2395,[118 175 179   7 173],198,3,9796,4.088480801335559,0.0,0.0
2396,0,2396,[300 268 289 588 269],416,4,9800,4.088443888193575,0.0,0.0
2397,0,2397,[313  64 483 318 187],214,5,9805,4.0888240200166805,80.0,20.0
2398,0,2398,[ 11 153 210  82 237],198,3,9808,4.08837015423093,0.0,0.0
2399,0,2399,[313  64 483 318 187],214,5,9813,4.08875,80.0,20.0
2400,0,2400,[313  64 483 318 187],618,5,9818,4.089129529362766,80.0,20.0
2401,0,2401,[655 185 403 183 282],618,4,9822,4.089092422980849,0.0,0.0
2402,0,2402,[180  11 216   8 318],437,4,9826,4.089055347482314,20.0,0.0
2403,0,2403,[597 210 588 117 168],588,5,9831,4.0894342762063225,0.0,0.0
2404,0,2404,[313  64 483 318 187],214,5,9836,4.089812889812889,80.0,20.0
2405,0,2405,[313  64 483 318 187],214,5,9841,4.090191188694929,80.0,20.0
2406,0,2406,[275 288 187 176 405],416,5,9846,4.090569173244703,0.0,20.0
2407,0,2407,[496  96  82 318 597],416,4,9850,4.090531561461794,20.0,0.0
2408,0,2408,[313  64 483 318 187],618,5,9855,4.090909090909091,80.0,20.0
2409,0,2409,[153  79   8 748 118],654,4,9859,4.0908713692946055,0.0,0.0
2410,0,2410,[186 245 179 423  11],417,5,9864,4.091248444628785,0.0,0.0
2411,0,2411,[ 98 191 187  56 185],618,5,9869,4.0916252072968495,0.0,20.0
2412,0,2412,[515 118 185 144 288],297,2,9871,4.090758392043099,0.0,20.0
2413,0,2413,[313  64 483 318 187],214,5,9876,4.091135045567523,80.0,20.0
2414,0,2414,[313  64 483 318 187],618,5,9881,4.091511387163561,80.0,20.0
2415,0,2415,[313  64 483 318 187],618,5,9886,4.091887417218543,80.0,20.0
2416,0,2416,[185 333 187 302  88],416,4,9890,4.091849400082747,0.0,0.0
2417,0,2417,[ 98 258 222 238  96],417,3,9893,4.091397849462366,0.0,20.0
2418,0,2418,[313  64 483 318 187],618,5,9898,4.091773460107483,80.0,20.0
2419,0,2419,[273 197 210 204 173],416,5,9903,4.092148760330579,0.0,0.0
2420,0,2420,[313  64 483 318 187],214,5,9908,4.092523750516316,80.0,20.0
2421,0,2421,[181 182 183 313 216],416,5,9913,4.09289843104872,20.0,40.0
2422,0,2422,[ 15 125 182  11 200],618,3,9916,4.092447379281882,0.0,0.0
2423,0,2423,[ 69 597 111   4 176],764,4,9920,4.092409240924092,0.0,0.0
2424,0,2424,[313  64 483 318 187],618,5,9925,4.092783505154639,80.0,20.0
2425,0,2425,[196 125  79 435 568],230,4,9929,4.092745259686727,0.0,0.0
2426,0,2426,[313  64 483 318 187],618,5,9934,4.093119077049856,80.0,20.0
2427,0,2427,[313  64 483 318 187],214,5,9939,4.093492586490939,80.0,20.0
2428,0,2428,[313  64 483 318 187],214,5,9944,4.093865788390284,80.0,20.0
2429,0,2429,[313  64 483 318 187],618,5,9949,4.094238683127572,80.0,20.0
2430,0,2430,[179 276 748  95 385],416,2,9951,4.093377211024269,0.0,0.0
2431,0,2431,[174 204  88  11 286],437,2,9953,4.092516447368421,0.0,0.0
2432,0,2432,[187 144  28  64 127],618,5,9958,4.092889436909165,20.0,0.0
2433,0,2433,[313  64 483 318 187],214,5,9963,4.093262119967132,80.0,20.0
2434,0,2434,[117 568  71  50  95],588,5,9968,4.093634496919917,0.0,20.0
2435,0,2435,[275 181  97   4 678],297,3,9971,4.093185550082102,0.0,20.0
2436,0,2436,[313  64 483 318 187],618,5,9976,4.093557652851867,80.0,20.0
2437,0,2437,[313  64 483 318 187],618,5,9981,4.0939294503691555,80.0,20.0
2438,0,2438,[257  22  79 222  89],854,3,9984,4.093480934809348,0.0,0.0
2439,0,2439,[546  11 294 211  64],43,5,9989,4.093852459016394,20.0,0.0
2440,0,2440,[265 313 588  88 204],405,2,9991,4.092994674313806,20.0,20.0
2441,0,2441,[313  64 483 318 187],618,5,9996,4.093366093366093,80.0,20.0
2442,0,2442,[475   9 423 508 276],62,4,10000,4.093327875562832,0.0,0.0
2443,0,2443,[496 318 323 275  69],764,4,10004,4.0932896890343695,20.0,0.0
2444,0,2444,[143 568 179 546 245],416,2,10006,4.092433537832311,0.0,0.0
2445,0,2445,[144 282 197 196 211],297,2,10008,4.091578086672118,0.0,0.0
2446,0,2446,[294  11 655 222 121],417,3,10011,4.091131998365345,0.0,0.0
2447,0,2447,[313  64 483 318 187],618,5,10016,4.091503267973856,80.0,20.0
2448,0,2448,[ 79 180 300  82  64],198,1,10017,4.090240914659044,20.0,0.0
2449,0,2449,[ 95 318 300 196 151],198,2,10019,4.089387755102041,20.0,0.0
2450,0,2450,[ 64 471 127 194 302],721,4,10023,4.089351285189719,20.0,0.0
2451,0,2451,[313  64 483 318 187],214,5,10028,4.089722675367048,80.0,20.0
2452,0,2452,[313  64 483 318 187],618,5,10033,4.090093762739503,80.0,20.0
2453,0,2453,[655 385 328 191   4],416,5,10038,4.090464547677262,0.0,0.0
2454,0,2454,[200 265 748 143 603],437,4,10042,4.090427698574338,0.0,0.0
2455,0,2455,[  8  28 748 483 132],437,4,10046,4.090390879478828,20.0,0.0
2456,0,2456,[313  64 483 318 187],618,5,10051,4.090761090761091,80.0,20.0
2457,0,2457,[313  64 483 318 187],214,5,10056,4.09113100081367,80.0,20.0
2458,0,2458,[202   7 294 568  97],588,2,10058,4.090280601870679,0.0,0.0
2459,0,2459,[237 197 200 742 132],854,3,10061,4.089837398373984,0.0,0.0
2460,0,2460,[313  64 483 318 187],618,5,10066,4.090207232832182,80.0,20.0
2461,0,2461,[313  64 483 318 187],618,5,10071,4.0905767668562145,80.0,20.0
2462,0,2462,[313  64 483 318 187],214,5,10076,4.090946000812018,80.0,20.0
2463,0,2463,[185 117  22 300 302],297,4,10080,4.090909090909091,0.0,0.0
2464,0,2464,[313  64 483 318 187],618,5,10085,4.0912778904665315,80.0,20.0
2465,0,2465,[313  64 483 318 187],214,5,10090,4.0916463909164635,80.0,20.0
2466,0,2466,[313  64 483 318 187],214,5,10095,4.092014592622618,80.0,20.0
2467,0,2467,[496   1  64 245 204],416,4,10099,4.091977309562399,20.0,0.0
2468,0,2468,[237 235  15 333 328],416,3,10102,4.091535034426894,0.0,0.0
2469,0,2469,[  7 151 258 173 186],354,3,10105,4.0910931174089065,0.0,0.0
2470,0,2470,[ 15  79 143 153 294],43,5,10110,4.091460946985026,0.0,0.0
2471,0,2471,[269 186  88 323  69],43,3,10113,4.091019417475728,0.0,0.0
2472,0,2472,[313  64 483 318 187],214,5,10118,4.091386979377274,80.0,20.0
2473,0,2473,[237 282 175 300 275],297,3,10121,4.090945836701698,0.0,0.0
2474,0,2474,[313  64 483 318 187],214,5,10126,4.0913131313131315,80.0,20.0
2475,0,2475,[313  64 483 318 187],618,5,10131,4.091680129240711,80.0,20.0
2476,0,2476,[313  64 483 318 187],618,5,10136,4.0920468308437625,80.0,20.0
2477,0,2477,[ 11   9 195 132  79],854,4,10140,4.092009685230024,0.0,0.0
2478,0,2478,[313  64 483 318 187],214,5,10145,4.0923759580476,80.0,20.0
2479,0,2479,[313  64 483 318 187],214,5,10150,4.092741935483871,80.0,20.0
2480,0,2480,[ 97  79 202 183 435],505,1,10151,4.091495364772269,0.0,0.0
2481,0,2481,[234 403 471 475 118],416,3,10154,4.091055600322321,0.0,0.0
2482,0,2482,[313  64 483 318 187],618,5,10159,4.091421667337897,80.0,20.0
2483,0,2483,[234 323 168 294 200],416,4,10163,4.091384863123993,0.0,0.0
2484,0,2484,[313  64 483 318 187],618,5,10168,4.091750503018108,80.0,20.0
2485,0,2485,[313  64 483 318 187],618,5,10173,4.092115848753017,80.0,20.0
2486,0,2486,[  7 185 276 174 204],618,3,10176,4.09167671893848,0.0,0.0
2487,0,2487,[289 237  56 294 238],24,3,10179,4.091237942122186,0.0,0.0
2488,0,2488,[313  64 483 318 187],618,5,10184,4.091603053435114,80.0,20.0
2489,0,2489,[313  64 483 318 187],214,5,10189,4.091967871485944,80.0,20.0
2490,0,2490,[313  64 483 318 187],618,5,10194,4.09233239662786,80.0,20.0
2491,0,2491,[257  50 275  22 294],62,3,10197,4.091894060995185,0.0,20.0
2492,0,2492,[215 276 427 135 403],198,4,10201,4.091857200160449,0.0,0.0
2493,0,2493,[183 191 475 302 435],297,3,10204,4.091419406575782,0.0,0.0
2494,0,2494,[183 211 313 187 175],405,2,10206,4.090581162324649,20.0,20.0
2495,0,2495,[228 204 111 742 180],128,2,10208,4.089743589743589,0.0,0.0
2496,0,2496,[588 127 181 288  28],405,4,10212,4.089707649179015,0.0,40.0
2497,0,2497,[ 89 288 216 161 423],805,1,10213,4.088470776621297,0.0,20.0
2498,0,2498,[313  64 483 318 187],618,5,10218,4.088835534213685,80.0,20.0
2499,0,2499,[313  64 483 318 187],214,5,10223,4.0892,80.0,20.0
2500,0,2500,[ 56  89 294 186 333],854,2,10225,4.088364654138345,0.0,0.0
2501,0,2501,[313  64 483 318 187],618,5,10230,4.088729016786571,80.0,20.0
2502,0,2502,[172  28 271 273  69],62,3,10233,4.088294047143428,0.0,0.0
2503,0,2503,[186  50  11 265 748],417,3,10236,4.087859424920127,0.0,20.0
2504,0,2504,[313  64 483 318 187],618,5,10241,4.0882235528942115,80.0,20.0
2505,0,2505,[313  64 483 318 187],618,5,10246,4.088587390263368,80.0,20.0
2506,0,2506,[313  64 483 318 187],618,5,10251,4.088950937375349,80.0,20.0
2507,0,2507,[265 294 172 237 161],505,1,10252,4.087719298245614,0.0,0.0
2508,0,2508,[313  64 483 318 187],618,5,10257,4.0880829015544045,80.0,20.0
2509,0,2509,[322 471 257 222 318],854,2,10259,4.087250996015936,20.0,0.0
2510,0,2510,[313  64 483 318 187],214,5,10264,4.087614496216647,80.0,20.0
2511,0,2511,[288 181 168 179 385],805,2,10266,4.086783439490445,0.0,40.0
2512,0,2512,[313  64 483 318 187],618,5,10271,4.087146836450458,80.0,20.0
2513,0,2513,[313  64 483 318 187],618,5,10276,4.087509944311853,80.0,20.0
2514,0,2514,[323 302 471 257   7],43,3,10279,4.087077534791253,0.0,0.0
2515,0,2515,[313  64 483 318 187],618,5,10284,4.087440381558029,80.0,20.0
2516,0,2516,[313  64 483 318 187],618,5,10289,4.087802940007946,80.0,20.0
2517,0,2517,[483  28 121 405 237],128,5,10294,4.088165210484512,20.0,0.0
2518,0,2518,[313  64 483 318 187],214,5,10299,4.088527193330687,80.0,20.0
2519,0,2519,[313  64 483 318 187],618,5,10304,4.088888888888889,80.0,20.0
2520,0,2520,[187  25  28 235   1],416,4,10308,4.088853629512099,0.0,0.0
2521,0,2521,[ 12 228 294 300 588],297,2,10310,4.08802537668517,20.0,0.0
2522,0,2522,[313  64 483 318 187],214,5,10315,4.088386841062228,80.0,20.0
2523,0,2523,[313  64 483 318 187],214,5,10320,4.088748019017433,80.0,20.0
2524,0,2524,[313  64 483 318 187],214,5,10325,4.089108910891089,80.0,20.0
2525,0,2525,[ 82 204 111  56 197],416,5,10330,4.089469517022962,0.0,0.0
2526,0,2526,[313  64 483 318 187],618,5,10335,4.0898298377522755,80.0,20.0
2527,0,2527,[235 273 568  15 237],416,3,10338,4.089398734177215,0.0,0.0
2528,0,2528,[275  70  95 210  50],262,2,10340,4.088572558323448,0.0,20.0
2529,0,2529,[313  64 483 318 187],214,5,10345,4.08893280632411,80.0,20.0
2530,0,2530,[143  79  15  98 289],416,4,10349,4.088897668905571,0.0,20.0
2531,0,2531,[  9  69  64 258 405],43,5,10354,4.089257503949447,20.0,0.0
2532,0,2532,[313  64 483 318 187],618,5,10359,4.089617054875641,80.0,20.0
2533,0,2533,[313  64 483 318 187],214,5,10364,4.0899763220205205,80.0,20.0
2534,0,2534,[161 144 357 282 333],416,5,10369,4.090335305719921,0.0,0.0
2535,0,2535,[313  64 483 318 187],618,5,10374,4.090694006309148,80.0,20.0
2536,0,2536,[313  64 483 318 187],214,5,10379,4.09105242412298,80.0,20.0
2537,0,2537,[313  64 483 318 187],214,5,10384,4.091410559495666,80.0,20.0
2538,0,2538,[313  64 483 318 187],214,5,10389,4.0917684127609295,80.0,20.0
2539,0,2539,[ 95 275  97 238 258],654,4,10393,4.091732283464567,0.0,0.0
2540,0,2540,[286 275 143 172 121],43,5,10398,4.092089728453365,0.0,0.0
2541,0,2541,[ 50 202   1 323 748],417,3,10401,4.091660110149489,0.0,20.0
2542,0,2542,[313  64 483 318 187],618,5,10406,4.092017302398742,80.0,20.0
2543,0,2543,[197 423 471 173  88],373,2,10408,4.091194968553459,0.0,0.0
2544,0,2544,[ 50  28 603 300 153],751,4,10412,4.091159135559922,0.0,20.0
2545,0,2545,[313  64 483 318 187],214,5,10417,4.091516103692066,80.0,20.0
2546,0,2546,[313  64 483 318 187],618,5,10422,4.091872791519434,80.0,20.0
2547,0,2547,[181 117 302  28 742],297,4,10426,4.091836734693878,0.0,20.0
2548,0,2548,[313  64 483 318 187],214,5,10431,4.09219301686936,80.0,20.0
2549,0,2549,[568 118 127  64 268],417,4,10435,4.092156862745098,20.0,0.0
2550,0,2550,[ 28  69  70 237 143],128,4,10439,4.092120736965896,0.0,0.0
2551,0,2551,[175 269 286 294 508],854,3,10442,4.091692789968652,0.0,0.0
2552,0,2552,[ 56  50 257 742 475],416,3,10445,4.0912651782216995,0.0,20.0
2553,0,2553,[313  64 483 318 187],214,5,10450,4.091620986687549,80.0,20.0
2554,0,2554,[216 153 568 183 234],198,3,10453,4.09119373776908,0.0,0.0
2555,0,2555,[313  64 483 318 187],214,5,10458,4.091549295774648,80.0,20.0
2556,0,2556,[313  64 483 318 187],214,5,10463,4.091904575674619,80.0,20.0
2557,0,2557,[313  64 483 318 187],214,5,10468,4.0922595777951525,80.0,20.0
2558,0,2558,[  8 318 100 173 385],43,5,10473,4.092614302461899,20.0,0.0
2559,0,2559,[313  64 483 318 187],214,5,10478,4.09296875,80.0,20.0
2560,0,2560,[151 655  15 135  98],437,5,10483,4.093322920734089,0.0,20.0
2561,0,2561,[ 89 144 202 234 197],805,3,10486,4.092896174863388,0.0,0.0
2562,0,2562,[ 79  95 127 202 100],416,4,10490,4.092859929769801,0.0,0.0
2563,0,2563,[117 294 195 151 210],642,3,10493,4.092433697347894,0.0,0.0
2564,0,2564,[271 222 268 197 257],854,3,10496,4.092007797270955,0.0,0.0
2565,0,2565,[313  64 483 318 187],618,5,10501,4.092361652377241,80.0,20.0
2566,0,2566,[603 179 286 202  82],416,4,10505,4.0923256719906504,0.0,0.0
2567,0,2567,[153   1 182 196  98],198,4,10509,4.0922897196261685,0.0,20.0
2568,0,2568,[313  64 483 318 187],214,5,10514,4.092643051771117,80.0,20.0
2569,0,2569,[313  64 483 318 187],618,5,10519,4.092996108949416,80.0,20.0
2570,0,2570,[143 111  50 172 546],416,4,10523,4.0929599377674055,0.0,20.0
2571,0,2571,[313  64 483 318 187],618,5,10528,4.093312597200622,80.0,20.0
2572,0,2572,[313  64 483 318 187],618,5,10533,4.093664982510688,80.0,20.0
2573,0,2573,[ 15 294 508 237  70],62,1,10534,4.092463092463093,0.0,0.0
2574,0,2574,[313  64 483 318 187],618,5,10539,4.092815533980582,80.0,20.0
2575,0,2575,[288 183  79 135  88],405,3,10542,4.092391304347826,0.0,20.0
2576,0,2576,[313  64 483 318 187],214,5,10547,4.092743500194024,80.0,20.0
2577,0,2577,[  8 276 268 288 196],654,2,10549,4.091931730023274,0.0,20.0
2578,0,2578,[228  69 257  79 403],705,3,10552,4.0915083365645595,0.0,0.0
2579,0,2579,[276  79 117  64 265],618,4,10556,4.091472868217054,20.0,0.0
2580,0,2580,[483 215 173   4 427],618,3,10559,4.0910499806276635,20.0,0.0
2581,0,2581,[ 70 294 117 168 357],417,5,10564,4.09140201394268,0.0,0.0
2582,0,2582,[313  64 483 318 187],214,5,10569,4.091753774680604,80.0,20.0
2583,0,2583,[313  64 483 318 187],214,5,10574,4.092105263157895,80.0,20.0
2584,0,2584,[313  64 483 318 187],618,5,10579,4.092456479690522,80.0,20.0
2585,0,2585,[  1 183  88 403  12],416,4,10583,4.0924207269914925,20.0,0.0
2586,0,2586,[313  64 483 318 187],214,5,10588,4.092771550057982,80.0,20.0
2587,0,2587,[144   4 121 269  22],654,5,10593,4.093122102009273,0.0,0.0
2588,0,2588,[282 302 204 245 322],721,3,10596,4.092699884125145,0.0,0.0
2589,0,2589,[313  64 483 318 187],618,5,10601,4.0930501930501935,80.0,20.0
2590,0,2590,[546  98 302 475   7],62,4,10605,4.093014280200695,0.0,20.0
2591,0,2591,[588 127 748 258 294],159,3,10608,4.092592592592593,0.0,0.0
2592,0,2592,[313  64 483 318 187],214,5,10613,4.0929425376012345,80.0,20.0
2593,0,2593,[245 173 235 597  28],62,2,10615,4.092135697764071,0.0,0.0
2594,0,2594,[  8  22 176   4 333],416,5,10620,4.092485549132948,0.0,0.0
2595,0,2595,[168 238  79 603 222],854,5,10625,4.092835130970724,0.0,0.0
2596,0,2596,[ 71 121  50 168 216],588,5,10630,4.093184443588756,0.0,20.0
2597,0,2597,[168 275 179 185 182],416,4,10634,4.09314857582756,0.0,0.0
2598,0,2598,[127 215 748 197 179],198,4,10638,4.093112735667565,0.0,0.0
2599,0,2599,[197 181 194 215 302],405,4,10642,4.093076923076923,0.0,20.0
2600,0,2600,[313  64 483 318 187],214,5,10647,4.093425605536332,80.0,20.0
2601,0,2601,[313  64 483 318 187],214,5,10652,4.093774019984627,80.0,20.0
2602,0,2602,[588 200 118   1  28],618,4,10656,4.09373799462159,0.0,0.0
2603,0,2603,[ 22 268 185 235   4],854,1,10657,4.092549923195085,0.0,0.0
2604,0,2604,[301 258 204 588 172],711,4,10661,4.092514395393474,0.0,0.0
2605,0,2605,[185 588  50 196 357],601,3,10664,4.092095165003838,0.0,20.0
2606,0,2606,[313  64 483 318 187],214,5,10669,4.092443421557346,80.0,20.0
2607,0,2607,[313  64 483 318 187],214,5,10674,4.092791411042945,80.0,20.0
2608,0,2608,[603 403 132 144  22],416,5,10679,4.093139133767727,0.0,0.0
2609,0,2609,[ 70 423 204 294 144],62,0,10679,4.091570881226054,0.0,0.0
2610,0,2610,[313  64 483 318 187],618,5,10684,4.091918805055534,80.0,20.0
2611,0,2611,[423 186 268 275 210],588,3,10687,4.091500765696784,0.0,0.0
2612,0,2612,[275   9  50 282 742],416,5,10692,4.091848450057405,0.0,20.0
2613,0,2613,[318  22 174 215 269],373,5,10697,4.0921958684009185,20.0,0.0
2614,0,2614,[313  64 483 318 187],214,5,10702,4.092543021032505,80.0,20.0
2615,0,2615,[313  64 483 318 187],618,5,10707,4.092889908256881,80.0,20.0
2616,0,2616,[117 257 245 302 181],297,3,10710,4.092472296522736,0.0,20.0
2617,0,2617,[742 151 385 588   9],805,1,10711,4.091291061879297,0.0,0.0
2618,0,2618,[313  64 483 318 187],214,5,10716,4.091638029782359,80.0,20.0
2619,0,2619,[ 11 121 235  82 322],805,0,10716,4.090076335877862,0.0,0.0
2620,0,2620,[ 12  97 216 111 333],588,3,10719,4.089660434948493,20.0,0.0
2621,0,2621,[313  64 483 318 187],214,5,10724,4.090007627765065,80.0,20.0
2622,0,2622,[313  64 483 318 187],618,5,10729,4.090354555852078,80.0,20.0
2623,0,2623,[313  64 483 318 187],214,5,10734,4.090701219512195,80.0,20.0
2624,0,2624,[183 655 403 235   9],416,4,10738,4.0906666666666665,0.0,0.0
2625,0,2625,[238  69 405 210 143],601,1,10739,4.089489718202589,0.0,0.0
2626,0,2626,[153  25   1 265 173],417,3,10742,4.089074990483441,0.0,0.0
2627,0,2627,[313  64 483 318 187],214,5,10747,4.089421613394216,80.0,20.0
2628,0,2628,[ 28 153 118 357 568],642,2,10749,4.088626854317231,0.0,0.0
2629,0,2629,[ 97 210 588  70 173],128,3,10752,4.088212927756654,0.0,0.0
2630,0,2630,[268 237 153  95   8],416,3,10755,4.0877993158494865,0.0,0.0
2631,0,2631,[282 117  50 200 322],416,4,10759,4.087765957446808,0.0,20.0
2632,0,2632,[313  64 483 318 187],214,5,10764,4.088112419293582,80.0,20.0
2633,0,2633,[313  64 483 318 187],214,5,10769,4.088458618071375,80.0,20.0
2634,0,2634,[237 271 127 153 179],62,3,10772,4.088045540796964,0.0,0.0
2635,0,2635,[200 275 144 168 288],711,3,10775,4.08763277693475,0.0,20.0
2636,0,2636,[215 173  97 211 200],405,2,10777,4.086841107318923,0.0,0.0
2637,0,2637,[313  64 483 318 187],214,5,10782,4.087187263078089,80.0,20.0
2638,0,2638,[180 234 127 655  64],417,5,10787,4.087533156498674,20.0,0.0
2639,0,2639,[313  64 483 318 187],214,5,10792,4.087878787878788,80.0,20.0
2640,0,2640,[313  64 483 318 187],214,5,10797,4.088224157516092,80.0,20.0
2641,0,2641,[313  64 483 318 187],214,5,10802,4.088569265707797,80.0,20.0
2642,0,2642,[313  64 483 318 187],214,5,10807,4.088914112750662,80.0,20.0
2643,0,2643,[313  64 483 318 187],618,5,10812,4.0892586989409985,80.0,20.0
2644,0,2644,[215  96  50  97 121],198,3,10815,4.088846880907372,0.0,20.0
2645,0,2645,[313  64 483 318 187],618,5,10820,4.089191232048375,80.0,20.0
2646,0,2646,[301  88 215 385 197],751,4,10824,4.0891575368341515,0.0,0.0
2647,0,2647,[313  64 483 318 187],214,5,10829,4.089501510574018,80.0,20.0
2648,0,2648,[546 427  79  95 127],416,3,10832,4.089090222725557,0.0,0.0
2649,0,2649,[195 174  88  22 118],805,0,10832,4.08754716981132,0.0,0.0
2650,0,2650,[313  64 483 318 187],618,5,10837,4.087891361750283,80.0,20.0
2651,0,2651,[222 318 194   8 153],721,5,10842,4.088235294117647,20.0,0.0
2652,0,2652,[294  50 180  88 273],805,1,10843,4.087071240105541,0.0,20.0
2653,0,2653,[313  64 483 318 187],618,5,10848,4.087415222305953,80.0,20.0
2654,0,2654,[313  64 483 318 187],618,5,10853,4.087758945386064,80.0,20.0
2655,0,2655,[313  64 483 318 187],618,5,10858,4.088102409638554,80.0,20.0
2656,0,2656,[313  64 483 318 187],214,5,10863,4.088445615355664,80.0,20.0
2657,0,2657,[ 71 655 181 357 318],416,5,10868,4.088788562829195,20.0,20.0
2658,0,2658,[125 117  96 496 288],416,5,10873,4.089131252350508,0.0,20.0
2659,0,2659,[313  64 483 318 187],214,5,10878,4.089473684210526,80.0,20.0
2660,0,2660,[313  64 483 318 187],214,5,10883,4.089815858699737,80.0,20.0
2661,0,2661,[118 182 568 202 187],618,3,10886,4.089406461307288,0.0,0.0
2662,0,2662,[ 25 300  56  88   4],416,4,10890,4.089372887720616,0.0,0.0
2663,0,2663,[313  64 483 318 187],214,5,10895,4.089714714714715,80.0,20.0
2664,0,2664,[313  64 483 318 187],214,5,10900,4.090056285178236,80.0,20.0
2665,0,2665,[313  64 483 318 187],214,5,10905,4.09039759939985,80.0,20.0
2666,0,2666,[597  25  12 235 301],43,3,10908,4.089988751406074,20.0,0.0
2667,0,2667,[ 98 172 183  12 268],417,4,10912,4.0899550224887555,20.0,20.0
2668,0,2668,[289 288 132 216  71],588,4,10916,4.0899213188460095,0.0,20.0
2669,0,2669,[385 405 742  56  89],642,3,10919,4.0895131086142325,0.0,0.0
2670,0,2670,[313  64 483 318 187],214,5,10924,4.089853987270685,80.0,20.0
2671,0,2671,[357 403 144 323  25],417,2,10926,4.0890718562874255,0.0,0.0
2672,0,2672,[186 568  50   8 294],588,5,10931,4.089412644968201,0.0,20.0
2673,0,2673,[742 228 588  79 471],128,3,10934,4.0890052356020945,0.0,0.0
2674,0,2674,[515 496 405 100 742],417,1,10935,4.087850467289719,0.0,0.0
2675,0,2675,[111 597 168 132 197],854,3,10938,4.0874439461883405,0.0,0.0
2676,0,2676,[ 15 276  56 161 269],43,5,10943,4.0877848337691445,0.0,0.0
2677,0,2677,[168 161 117 328 300],128,4,10947,4.087752053771471,0.0,0.0
2678,0,2678,[313  64 483 318 187],214,5,10952,4.08809257185517,80.0,20.0
2679,0,2679,[300  15 748 245 269],416,4,10956,4.088059701492537,0.0,0.0
2680,0,2680,[135 176 118 172 168],198,4,10960,4.0880268556508765,0.0,0.0
2681,0,2681,[313  64 483 318 187],618,5,10965,4.088366890380313,80.0,20.0
2682,0,2682,[313  64 483 318 187],214,5,10970,4.088706671636228,80.0,20.0
2683,0,2683,[603 403 385 678 588],416,4,10974,4.088673621460507,0.0,0.0
2684,0,2684,[313  64 483 318 187],214,5,10979,4.08901303538175,80.0,20.0
2685,0,2685,[313  64 483 318 187],214,5,10984,4.089352196574833,80.0,20.0
2686,0,2686,[  4 282 132 153 742],854,2,10986,4.088574618533681,0.0,0.0
2687,0,2687,[475 282 195 151 234],297,1,10987,4.087425595238095,0.0,0.0
2688,0,2688,[313  64 483 318 187],618,5,10992,4.087764968389736,80.0,20.0
2689,0,2689,[313  64 483 318 187],214,5,10997,4.088104089219331,80.0,20.0
2690,0,2690,[191   8 144 238 200],297,2,10999,4.087328130806392,0.0,0.0
2691,0,2691,[313  64 483 318 187],214,5,11004,4.087667161961367,80.0,20.0
2692,0,2692,[313  64 483 318 187],214,5,11009,4.088005941329373,80.0,20.0
2693,0,2693,[313  64 483 318 187],214,5,11014,4.088344469190794,80.0,20.0
2694,0,2694,[313  64 483 318 187],214,5,11019,4.0886827458256025,80.0,20.0
2695,0,2695,[568 300  98 175 181],198,2,11021,4.087908011869437,0.0,40.0
2696,0,2696,[313  64 483 318 187],214,5,11026,4.0882461994809045,80.0,20.0
2697,0,2697,[202 153 568 323 180],417,3,11029,4.087842846553002,0.0,0.0
2698,0,2698,[313  64 483 318 187],618,5,11034,4.088180807706558,80.0,20.0
2699,0,2699,[313  64 483 318 187],214,5,11039,4.088518518518518,80.0,20.0
2700,0,2700,[300 603  79 118 204],416,4,11043,4.088485746019993,0.0,0.0
2701,0,2701,[313  64 483 318 187],214,5,11048,4.088823094004441,80.0,20.0
2702,0,2702,[313  64 483 318 187],618,5,11053,4.089160192378839,80.0,20.0
2703,0,2703,[313  64 483 318 187],618,5,11058,4.089497041420119,80.0,20.0
2704,0,2704,[313  64 483 318 187],618,5,11063,4.089833641404806,80.0,20.0
2705,0,2705,[313  64 483 318 187],618,5,11068,4.090169992609017,80.0,20.0
2706,0,2706,[ 96  79 195 172 185],417,1,11069,4.089028444772811,0.0,0.0
2707,0,2707,[ 22 125 385 185  69],230,4,11073,4.088995568685377,0.0,0.0
2708,0,2708,[313  64 483 318 187],618,5,11078,4.089331856773717,80.0,20.0
2709,0,2709,[603 181 210  70  28],128,4,11082,4.08929889298893,0.0,20.0
2710,0,2710,[313  64 483 318 187],214,5,11087,4.089634821099225,80.0,20.0
2711,0,2711,[173   1 403 144 678],805,4,11091,4.089601769911504,0.0,0.0
2712,0,2712,[313  64 483 318 187],618,5,11096,4.089937338739403,80.0,20.0
2713,0,2713,[222 216  88 289 265],588,3,11099,4.0895357406042745,0.0,0.0
2714,0,2714,[180  70 111  97 135],711,4,11103,4.089502762430939,0.0,0.0
2715,0,2715,[144  56 151 161  71],416,4,11107,4.089469808541973,0.0,0.0
2716,0,2716,[100 181 597 357 238],417,2,11109,4.0887007729113,0.0,20.0
2717,0,2717,[151  98  64 302  71],43,5,11114,4.089036055923473,20.0,20.0
2718,0,2718,[313  64 483 318 187],618,5,11119,4.089371092313351,80.0,20.0
2719,0,2719,[313  64 483 318 187],214,5,11124,4.089705882352941,80.0,20.0
2720,0,2720,[313  64 483 318 187],214,5,11129,4.0900404263138554,80.0,20.0
2721,0,2721,[174 568   4  12 191],618,4,11133,4.090007347538575,20.0,0.0
2722,0,2722,[313  64 483 318 187],618,5,11138,4.090341535071612,80.0,20.0
2723,0,2723,[313  64 483 318 187],214,5,11143,4.090675477239354,80.0,20.0
2724,0,2724,[678 288 328 405 125],921,2,11145,4.089908256880734,0.0,20.0
2725,0,2725,[235 276 173  50 257],62,4,11149,4.089875275128393,0.0,20.0
2726,0,2726,[ 15 135 655 174 200],437,5,11154,4.0902090209020905,0.0,0.0
2727,0,2727,[117 655 197 172  98],751,3,11157,4.089809384164223,0.0,20.0
2728,0,2728,[313  64 483 318 187],214,5,11162,4.090142909490656,80.0,20.0
2729,0,2729,[313  64 483 318 187],214,5,11167,4.09047619047619,80.0,20.0
2730,0,2730,[313  64 483 318 187],214,5,11172,4.090809227389235,80.0,20.0
2731,0,2731,[405 300  97  89 143],705,2,11174,4.0900439238653,0.0,0.0
2732,0,2732,[175 117  89 276 173],198,2,11176,4.0892791803878525,0.0,0.0
2733,0,2733,[313  64 483 318 187],214,5,11181,4.0896122896854425,80.0,20.0
2734,0,2734,[313  64 483 318 187],618,5,11186,4.089945155393053,80.0,20.0
2735,0,2735,[202  98 300 237  70],751,3,11189,4.089546783625731,0.0,20.0
2736,0,2736,[313  64 483 318 187],214,5,11194,4.089879430032883,80.0,20.0
2737,0,2737,[ 98 275 282 289 153],416,4,11198,4.089846603360117,0.0,20.0
2738,0,2738,[313  64 483 318 187],214,5,11203,4.090178897407813,80.0,20.0
2739,0,2739,[313  64 483 318 187],214,5,11208,4.090510948905109,80.0,20.0
2740,0,2740,[210 238 265 302 427],405,4,11212,4.09047792776359,0.0,0.0
2741,0,2741,[357 151 568  28 597],805,2,11214,4.089715536105033,0.0,0.0
2742,0,2742,[546 174 222 282 238],297,3,11217,4.0893182646737145,0.0,0.0
2743,0,2743,[313  64 483 318 187],618,5,11222,4.089650145772595,80.0,20.0
2744,0,2744,[69 22 82 95 88],405,3,11225,4.089253187613843,0.0,0.0
2745,0,2745,[313  64 483 318 187],214,5,11230,4.0895848506919155,80.0,20.0
2746,0,2746,[ 98 118   4   1 288],854,2,11232,4.088824171823807,0.0,40.0
2747,0,2747,[313  64 483 318 187],618,5,11237,4.089155749636099,80.0,20.0
2748,0,2748,[ 50  69  56 475 135],198,5,11242,4.089487086213168,0.0,20.0
2749,0,2749,[ 15 288 204  12 238],654,3,11245,4.089090909090909,20.0,20.0
2750,0,2750,[172 100 215 423 265],588,3,11248,4.08869501999273,0.0,0.0
2751,0,2751,[313  64 483 318 187],618,5,11253,4.089026162790698,80.0,20.0
2752,0,2752,[313  64 483 318 187],214,5,11258,4.089357065019978,80.0,20.0
2753,0,2753,[ 69  28 237 483 597],588,3,11261,4.088961510530138,20.0,0.0
2754,0,2754,[508  12  22 546 195],297,3,11264,4.088566243194192,20.0,0.0
2755,0,2755,[ 64 405 100 153 204],198,2,11266,4.087808417997097,20.0,0.0
2756,0,2756,[234 204  89  15 195],198,1,11267,4.086688429452304,0.0,0.0
2757,0,2757,[313  64 483 318 187],618,5,11272,4.087019579405366,80.0,20.0
2758,0,2758,[313  64 483 318 187],618,5,11277,4.08735048930772,80.0,20.0
2759,0,2759,[ 82 294 176  71 185],805,2,11279,4.086594202898551,0.0,0.0
2760,0,2760,[313  64 483 318 187],618,5,11284,4.086925027164071,80.0,20.0
2761,0,2761,[313  64 483 318 187],214,5,11289,4.087255611875452,80.0,20.0
2762,0,2762,[313  64 483 318 187],214,5,11294,4.087585957292798,80.0,20.0
2763,0,2763,[210 742 235  88 204],805,0,11294,4.086107091172214,0.0,0.0
2764,0,2764,[313  64 483 318 187],214,5,11299,4.086437613019892,80.0,20.0
2765,0,2765,[235 197 179 269 111],416,3,11302,4.086044830079537,0.0,0.0
2766,0,2766,[197 265 143 603 282],297,2,11304,4.085290928803759,0.0,0.0
2767,0,2767,[313  64 483 318 187],618,5,11309,4.085621387283237,80.0,20.0
2768,0,2768,[313  64 483 318 187],618,5,11314,4.085951607078368,80.0,20.0
2769,0,2769,[313  64 483 318 187],618,5,11319,4.086281588447654,80.0,20.0
2770,0,2770,[313  64 483 318 187],618,5,11324,4.086611331649224,80.0,20.0
2771,0,2771,[  4 197 357  56 435],297,2,11326,4.085858585858586,0.0,0.0
2772,0,2772,[ 96  64 100   1 121],253,5,11331,4.086188243779301,20.0,0.0
2773,0,2773,[125  97 191  69   1],505,1,11332,4.08507570295602,0.0,0.0
2774,0,2774,[313  64 483 318 187],618,5,11337,4.085405405405405,80.0,20.0
2775,0,2775,[132 471 276 161 313],416,4,11341,4.085374639769452,20.0,20.0
2776,0,2776,[118 427 182 258 144],907,5,11346,4.085703997119193,0.0,0.0
2777,0,2777,[313  64 483 318 187],618,5,11351,4.086033117350612,80.0,20.0
2778,0,2778,[313  64 483 318 187],214,5,11356,4.086362000719683,80.0,20.0
2779,0,2779,[286  22 276 235 508],62,4,11360,4.086330935251799,0.0,0.0
2780,0,2780,[172 435 143  70  97],437,2,11362,4.085580726357425,0.0,0.0
2781,0,2781,[403 357 322 323  50],721,4,11366,4.085549964054637,0.0,20.0
2782,0,2782,[313  64 483 318 187],618,5,11371,4.085878548329141,80.0,20.0
2783,0,2783,[313  64 483 318 187],618,5,11376,4.086206896551724,80.0,20.0
2784,0,2784,[313  64 483 318 187],618,5,11381,4.086535008976661,80.0,20.0
2785,0,2785,[202 144  22  96 173],698,2,11383,4.085786073223259,0.0,0.0
2786,0,2786,[111  69 196  15  71],345,4,11387,4.085755292429135,0.0,0.0
2787,0,2787,[313  64 483 318 187],214,5,11392,4.086083213773314,80.0,20.0
2788,0,2788,[313  64 483 318 187],618,5,11397,4.086410899964145,80.0,20.0
2789,0,2789,[ 95  56  15 568 301],588,5,11402,4.08673835125448,0.0,0.0
2790,0,2790,[118 144 268 302 195],854,0,11402,4.085274095306342,0.0,0.0
2791,0,2791,[151 173 471 100 132],588,4,11406,4.085243553008596,0.0,0.0
2792,0,2792,[323 742 403 300   1],416,4,11410,4.0852130325814535,0.0,0.0
2793,0,2793,[313  64 483 318 187],618,5,11415,4.08554044380816,80.0,20.0
2794,0,2794,[313  64 483 318 187],214,5,11420,4.085867620751341,80.0,20.0
2795,0,2795,[ 70 282  22 265 174],618,3,11423,4.085479256080115,0.0,0.0
2796,0,2796,[ 11 748  28 200  88],437,2,11425,4.084733643189131,0.0,0.0
2797,0,2797,[313  64 483 318 187],214,5,11430,4.08506075768406,80.0,20.0
2798,0,2798,[  1 300 603 168 118],297,2,11432,4.084315827081101,0.0,0.0
2799,0,2799,[313  64 483 318 187],214,5,11437,4.084642857142857,80.0,20.0
2800,0,2800,[313  64 483 318 187],618,5,11442,4.084969653695109,80.0,20.0
2801,0,2801,[182 273 174 546  56],297,3,11445,4.084582441113491,0.0,0.0
2802,0,2802,[174 357 180 286   4],875,3,11448,4.084195504816268,0.0,0.0
2803,0,2803,[313  64 483 318 187],214,5,11453,4.084522111269615,80.0,20.0
2804,0,2804,[313  64 483 318 187],618,5,11458,4.084848484848485,80.0,20.0
2805,0,2805,[121  70  12 228 265],417,2,11460,4.084105488239487,20.0,0.0
2806,0,2806,[173 185  70 286 135],417,3,11463,4.083719273245458,0.0,0.0
2807,0,2807,[ 69   4 186   1 210],642,4,11467,4.0836894586894585,0.0,0.0
2808,0,2808,[313  64 483 318 187],618,5,11472,4.084015663937344,80.0,20.0
2809,0,2809,[  4 276 300  12 176],416,4,11476,4.083985765124555,20.0,0.0
2810,0,2810,[ 64 215 475  71 180],711,3,11479,4.083600142298114,20.0,0.0
2811,0,2811,[313  64 483 318 187],618,5,11484,4.083926031294452,80.0,20.0
2812,0,2812,[483 191 568  28  98],128,5,11489,4.0842516885886955,20.0,20.0
2813,0,2813,[313  64 483 318 187],618,5,11494,4.08457711442786,80.0,20.0
2814,0,2814,[216 182 265 238 168],198,4,11498,4.084547069271759,0.0,0.0
2815,0,2815,[313  64 483 318 187],214,5,11503,4.084872159090909,80.0,20.0
2816,0,2816,[ 79 234   1  11 588],805,3,11506,4.084487042953497,0.0,0.0
2817,0,2817,[179  28 228 515 182],405,1,11507,4.083392476933995,0.0,0.0
2818,0,2818,[ 96 588 144 197 172],805,3,11510,4.083008158921603,0.0,0.0
2819,0,2819,[195 135 286 180 300],875,3,11513,4.082624113475178,0.0,0.0
2820,0,2820,[ 97 174 172 195 271],505,3,11516,4.082240340304857,0.0,0.0
2821,0,2821,[191  56 302 194 216],721,2,11518,4.081502480510276,0.0,0.0
2822,0,2822,[313  64 483 318 187],618,5,11523,4.08182784272051,80.0,20.0
2823,0,2823,[313  64 483 318 187],618,5,11528,4.0821529745042495,80.0,20.0
2824,0,2824,[588  25 265 597 268],416,4,11532,4.08212389380531,0.0,0.0
2825,0,2825,[135 202  50 238 121],437,4,11536,4.08209483368719,0.0,20.0
2826,0,2826,[435 153 125 238 132],373,4,11540,4.082065794128051,0.0,0.0
2827,0,2827,[273 125  12 300   1],253,3,11543,4.0816831683168315,20.0,0.0
2828,0,2828,[313  64 483 318 187],618,5,11548,4.0820077765995055,80.0,20.0
2829,0,2829,[172 427 234 237  71],618,5,11553,4.082332155477032,0.0,0.0
2830,0,2830,[313  64 483 318 187],214,5,11558,4.082656305192511,80.0,20.0
2831,0,2831,[322 181 475 238 257],417,2,11560,4.081920903954802,0.0,20.0
2832,0,2832,[  8 546 403   7 508],62,5,11565,4.08224496999647,0.0,0.0
2833,0,2833,[  7 515 168 318 471],416,5,11570,4.08256880733945,20.0,0.0
2834,0,2834,[313  64 483 318 187],214,5,11575,4.082892416225749,80.0,20.0
2835,0,2835,[176 568 118  12   8],416,4,11579,4.082863187588153,20.0,0.0
2836,0,2836,[313  64 483 318 187],618,5,11584,4.083186464575255,80.0,20.0
2837,0,2837,[313  64 483 318 187],618,5,11589,4.083509513742072,80.0,20.0
2838,0,2838,[568 151 234 191 597],618,4,11593,4.083480098626277,0.0,0.0
2839,0,2839,[265 427  28 132 245],416,4,11597,4.083450704225352,0.0,0.0
2840,0,2840,[313  64 483 318 187],214,5,11602,4.083773319253784,80.0,20.0
2841,0,2841,[  4 143 125 357 515],416,5,11607,4.084095707248417,0.0,0.0
2842,0,2842,[313  64 483 318 187],618,5,11612,4.0844178684488215,80.0,20.0
2843,0,2843,[  7 245 568 183 322],416,3,11615,4.084036568213784,0.0,0.0
2844,0,2844,[237 196 238 286 300],43,4,11619,4.084007029876977,0.0,0.0
2845,0,2845,[313  64 483 318 187],214,5,11624,4.084328882642305,80.0,20.0
2846,0,2846,[216 153 202 151 245],297,2,11626,4.083596768528276,0.0,0.0
2847,0,2847,[313  64 483 318 187],214,5,11631,4.083918539325842,80.0,20.0
2848,0,2848,[313  64 483 318 187],214,5,11636,4.084240084240085,80.0,20.0
2849,0,2849,[313  64 483 318 187],214,5,11641,4.084561403508772,80.0,20.0
2850,0,2850,[ 82 357  22 215 328],721,5,11646,4.084882497369344,0.0,0.0
2851,0,2851,[313  64 483 318 187],214,5,11651,4.085203366058906,80.0,20.0
2852,0,2852,[313  64 483 318 187],618,5,11656,4.085524009814231,80.0,20.0
2853,0,2853,[151  89 176 423   4],417,4,11660,4.085494043447793,0.0,0.0
2854,0,2854,[313  64 483 318 187],618,5,11665,4.085814360770578,80.0,20.0
2855,0,2855,[144 289  50  64 323],43,4,11669,4.08578431372549,20.0,20.0
2856,0,2856,[238 655  64 117 282],128,3,11672,4.085404270213511,20.0,0.0
2857,0,2857,[313  64 483 318 187],618,5,11677,4.085724282715185,80.0,20.0
2858,0,2858,[151 508 588 216  70],314,2,11679,4.0849947534102835,0.0,0.0
2859,0,2859,[288 588  88  82 181],805,0,11679,4.083566433566434,0.0,40.0
2860,0,2860,[210 173  97 180   8],62,4,11683,4.083537224746592,0.0,0.0
2861,0,2861,[313  64 483 318 187],214,5,11688,4.083857442348008,80.0,20.0
2862,0,2862,[204 196 195 200  71],416,5,11693,4.0841774362556755,0.0,0.0
2863,0,2863,[132 301 385 568 194],416,5,11698,4.084497206703911,0.0,0.0
2864,0,2864,[313  64 483 318 187],618,5,11703,4.0848167539267015,80.0,20.0
2865,0,2865,[385 210 118 200  25],345,2,11705,4.084089323098395,0.0,0.0
2866,0,2866,[271 269   9 118 144],854,3,11708,4.083711196372515,0.0,0.0
2867,0,2867,[515 172 405  70  98],230,5,11713,4.084030683403069,0.0,20.0
2868,0,2868,[322 111 191  69  56],721,3,11716,4.083652840711049,0.0,0.0
2869,0,2869,[313  64 483 318 187],618,5,11721,4.08397212543554,80.0,20.0
2870,0,2870,[288 268 216  15 168],588,5,11726,4.084291187739463,0.0,20.0
2871,0,2871,[313  64 483 318 187],214,5,11731,4.084610027855153,80.0,20.0
2872,0,2872,[289 144  50 282 273],416,4,11735,4.084580577793248,0.0,20.0
2873,0,2873,[181  22 597 228  15],62,2,11737,4.083855254001392,0.0,20.0
2874,0,2874,[ 98 258 161 204 182],49,1,11738,4.082782608695652,0.0,20.0
2875,0,2875,[313  64 483 318 187],618,5,11743,4.083101529902643,80.0,20.0
2876,0,2876,[313  64 483 318 187],618,5,11748,4.083420229405631,80.0,20.0
2877,0,2877,[313  64 483 318 187],618,5,11753,4.083738707435719,80.0,20.0
2878,0,2878,[313  64 483 318 187],214,5,11758,4.084056964223689,80.0,20.0
2879,0,2879,[313  64 483 318 187],618,5,11763,4.084375,80.0,20.0
2880,0,2880,[313  64 483 318 187],618,5,11768,4.084692814994794,80.0,20.0
2881,0,2881,[588  12 328 175 151],49,4,11772,4.084663428174879,20.0,0.0
2882,0,2882,[313  64 483 318 187],214,5,11777,4.0849809226500176,80.0,20.0
2883,0,2883,[427 288 194 286 196],416,5,11782,4.085298196948682,0.0,20.0
2884,0,2884,[161 111  79 153 302],416,5,11787,4.085615251299827,0.0,0.0
2885,0,2885,[ 96 118 427 143 318],416,4,11791,4.085585585585585,20.0,0.0
2886,0,2886,[313  64 483 318 187],618,5,11796,4.085902320748182,80.0,20.0
2887,0,2887,[153 385 742 496 173],654,5,11801,4.086218836565097,0.0,0.0
2888,0,2888,[603  12 403 294 183],805,4,11805,4.086188992731048,20.0,0.0
2889,0,2889,[195  82 302 294 288],654,3,11808,4.085813148788928,0.0,20.0
2890,0,2890,[313  64 483 318 187],214,5,11813,4.086129367001038,80.0,20.0
2891,0,2891,[313  64 483 318 187],618,5,11818,4.086445366528354,80.0,20.0
2892,0,2892,[125 237  11 276 427],618,3,11821,4.08606982371241,0.0,0.0
2893,0,2893,[313  64 483 318 187],618,5,11826,4.086385625431928,80.0,20.0
2894,0,2894,[313  64 483 318 187],618,5,11831,4.086701208981002,80.0,20.0
2895,0,2895,[  4 179 202 245 546],416,2,11833,4.085980662983426,0.0,0.0
2896,0,2896,[496 483 216 237 183],437,4,11837,4.08595098377632,20.0,0.0
2897,0,2897,[313  64 483 318 187],214,5,11842,4.086266390614217,80.0,20.0
2898,0,2898,[174 118 257 294 210],417,2,11844,4.0855467402552605,0.0,0.0
2899,0,2899,[313  64 483 318 187],214,5,11849,4.085862068965517,80.0,20.0
2900,0,2900,[313  64 483 318 187],618,5,11854,4.086177180282661,80.0,20.0
2901,0,2901,[313  64 483 318 187],214,5,11859,4.086492074431427,80.0,20.0
2902,0,2902,[313  64 483 318 187],618,5,11864,4.086806751636239,80.0,20.0
2903,0,2903,[121   1  96 588  82],253,4,11868,4.086776859504132,0.0,0.0
2904,0,2904,[313  64 483 318 187],618,5,11873,4.087091222030981,80.0,20.0
2905,0,2905,[588 286 185 173 275],416,5,11878,4.087405368203717,0.0,0.0
2906,0,2906,[  8  28 204 357 195],297,3,11881,4.08703130374957,0.0,0.0
2907,0,2907,[179 202  89 135  82],805,3,11884,4.086657496561211,0.0,0.0
2908,0,2908,[313  64 483 318 187],214,5,11889,4.086971467858371,80.0,20.0
2909,0,2909,[181 196 191 435 245],721,3,11892,4.08659793814433,0.0,20.0
2910,0,2910,[265 286 471 161 211],416,5,11897,4.086911714187565,0.0,0.0
2911,0,2911,[  4 273 168 125 313],416,5,11902,4.087225274725275,20.0,20.0
2912,0,2912,[313  64 483 318 187],618,5,11907,4.087538619979402,80.0,20.0
2913,0,2913,[286  64 385 655 597],416,4,11911,4.087508579272478,20.0,0.0
2914,0,2914,[313  64 483 318 187],618,5,11916,4.087821612349914,80.0,20.0
2915,0,2915,[ 25 357 117 182 151],297,3,11919,4.087448559670782,0.0,0.0
2916,0,2916,[313  64 483 318 187],214,5,11924,4.087761398697292,80.0,20.0
2917,0,2917,[238 195  98 235 118],62,4,11928,4.087731322823852,0.0,20.0
2918,0,2918,[ 96 191 269 153 357],854,4,11932,4.0877012675573825,0.0,0.0
2919,0,2919,[313  64 483 318 187],214,5,11937,4.088013698630137,80.0,20.0
2920,0,2920,[168 173  50  15 176],417,4,11941,4.087983567271483,0.0,20.0
2921,0,2921,[313  64 483 318 187],214,5,11946,4.08829568788501,80.0,20.0
2922,0,2922,[313  64 483 318 187],618,5,11951,4.0886075949367084,80.0,20.0
2923,0,2923,[313  64 483 318 187],618,5,11956,4.088919288645691,80.0,20.0
2924,0,2924,[313  64 483 318 187],618,5,11961,4.0892307692307694,80.0,20.0
2925,0,2925,[ 97 288  70 121 100],679,2,11963,4.088516746411483,0.0,20.0
2926,0,2926,[125 100  97  96 118],907,5,11968,4.0888281516911515,0.0,0.0
2927,0,2927,[257 655 185 202   1],417,3,11971,4.088456284153006,0.0,0.0
2928,0,2928,[118 405 508 144 385],654,3,11974,4.088084670536019,0.0,0.0
2929,0,2929,[228 742 269  95 197],297,1,11975,4.087030716723549,0.0,0.0
2930,0,2930,[313  64 483 318 187],618,5,11980,4.08734220402593,80.0,20.0
2931,0,2931,[313  64 483 318 187],618,5,11985,4.087653478854024,80.0,20.0
2932,0,2932,[ 70 135  82  69 294],230,4,11989,4.08762359359018,0.0,0.0
2933,0,2933,[313  64 483 318 187],618,5,11994,4.087934560327199,80.0,20.0
2934,0,2934,[176 196 127  50  82],618,5,11999,4.088245315161839,0.0,20.0
2935,0,2935,[176 187  97 194 196],416,5,12004,4.0885558583106265,0.0,0.0
2936,0,2936,[176 508 121 173  15],62,4,12008,4.088525706503234,0.0,0.0
2937,0,2937,[313  64 483 318 187],214,5,12013,4.0888359428182435,80.0,20.0
2938,0,2938,[ 95 222 515  50 183],698,3,12016,4.088465464443688,0.0,20.0
2939,0,2939,[258 173 144 546 121],805,1,12017,4.087414965986395,0.0,0.0
2940,0,2940,[238 111 196 202  97],437,3,12020,4.087045222713363,0.0,0.0
2941,0,2941,[234 515 237  56 151],297,3,12023,4.086675730795378,0.0,0.0
2942,0,2942,[313  64 483 318 187],618,5,12028,4.086986068637445,80.0,20.0
2943,0,2943,[257 597 483 496 322],417,1,12029,4.0859375,20.0,0.0
2944,0,2944,[742 423 269 153 197],854,4,12033,4.08590831918506,0.0,0.0
2945,0,2945,[153 300 135 194 323],721,3,12036,4.085539714867617,0.0,0.0
2946,0,2946,[313  64 483 318 187],618,5,12041,4.085850016966407,80.0,20.0
2947,0,2947,[135 100 286 143 185],354,3,12044,4.085481682496608,0.0,0.0
2948,0,2948,[ 98 179 173  70 183],62,4,12048,4.085452695829095,0.0,20.0
2949,0,2949,[222 483 168 257 111],62,3,12051,4.085084745762712,20.0,0.0
2950,0,2950,[313  64 483 318 187],214,5,12056,4.085394781430024,80.0,20.0
2951,0,2951,[313  64 483 318 187],618,5,12061,4.08570460704607,80.0,20.0
2952,0,2952,[678 603 286  56 405],416,4,12065,4.08567558415171,0.0,0.0
2953,0,2953,[313  64 483 318 187],618,5,12070,4.085985104942451,80.0,20.0
2954,0,2954,[313  64 483 318 187],618,5,12075,4.086294416243655,80.0,20.0
2955,0,2955,[ 28  88 238 603  15],416,4,12079,4.086265223274696,0.0,0.0
2956,0,2956,[322 168 257  96 483],854,2,12081,4.085559688873858,20.0,0.0
2957,0,2957,[173   4  25 121 271],854,2,12083,4.084854631507776,0.0,0.0
2958,0,2958,[313  64 483 318 187],618,5,12088,4.085163906725245,80.0,20.0
2959,0,2959,[ 95 187 301 269  98],416,4,12092,4.085135135135135,0.0,20.0
2960,0,2960,[313  64 483 318 187],618,5,12097,4.085444106720702,80.0,20.0
2961,0,2961,[313  64 483 318 187],214,5,12102,4.085752869682647,80.0,20.0
2962,0,2962,[568  22 191 183  88],416,4,12106,4.085723928450895,0.0,0.0
2963,0,2963,[678 197 118  64 302],416,3,12109,4.085357624831309,20.0,0.0
2964,0,2964,[313  64 483 318 187],214,5,12114,4.08566610455312,80.0,20.0
2965,0,2965,[204   4 275 273  11],618,2,12116,4.08496291301416,0.0,0.0
2966,0,2966,[216  11  98 183 186],618,4,12120,4.084934277047522,0.0,20.0
2967,0,2967,[313  64 483 318 187],214,5,12125,4.085242587601078,80.0,20.0
2968,0,2968,[313  64 483 318 187],618,5,12130,4.085550690468171,80.0,20.0
2969,0,2969,[313  64 483 318 187],214,5,12135,4.085858585858586,80.0,20.0
2970,0,2970,[294   1 144 237  71],654,3,12138,4.0854930999663415,0.0,0.0
2971,0,2971,[313  64 483 318 187],214,5,12143,4.085800807537012,80.0,20.0
2972,0,2972,[265 302 678 294  22],416,4,12147,4.08577194752775,0.0,0.0
2973,0,2973,[313  64 483 318 187],214,5,12152,4.086079354404842,80.0,20.0
2974,0,2974,[313  64 483 318 187],214,5,12157,4.086386554621849,80.0,20.0
2975,0,2975,[282 603 483 151 238],128,3,12160,4.086021505376344,20.0,0.0
2976,0,2976,[313  64 483 318 187],214,5,12165,4.0863285186429295,80.0,20.0
2977,0,2977,[313  64 483 318 187],618,5,12170,4.086635325721961,80.0,20.0
2978,0,2978,[405 323 275  15 143],921,3,12173,4.086270560590802,0.0,0.0
2979,0,2979,[216 588 234 176 185],416,5,12178,4.086577181208054,0.0,0.0
2980,0,2980,[313  64 483 318 187],214,5,12183,4.086883596108688,80.0,20.0
2981,0,2981,[185 546 234 161 318],416,4,12187,4.086854460093897,20.0,0.0
2982,0,2982,[423  11 117 196 118],297,3,12190,4.086490110626886,0.0,0.0
2983,0,2983,[313  64 483 318 187],214,5,12195,4.0867962466487935,80.0,20.0
2984,0,2984,[313  64 483 318 187],618,5,12200,4.0871021775544385,80.0,20.0
2985,0,2985,[ 69 483 288 427   8],711,3,12203,4.086738111185532,20.0,20.0
2986,0,2986,[204 515 194  22  64],405,3,12206,4.086374288583864,20.0,0.0
2987,0,2987,[313  64 483 318 187],618,5,12211,4.086680053547523,80.0,20.0
2988,0,2988,[313  64 483 318 187],214,5,12216,4.086985613917698,80.0,20.0
2989,0,2989,[313  64 483 318 187],214,5,12221,4.087290969899666,80.0,20.0
2990,0,2990,[222   7  89 257 286],354,3,12224,4.086927449013708,0.0,0.0
2991,0,2991,[121  96 282 172 403],618,3,12227,4.086564171122995,0.0,0.0
2992,0,2992,[313  64 483 318 187],214,5,12232,4.086869361844303,80.0,20.0
2993,0,2993,[313  64 483 318 187],618,5,12237,4.087174348697395,80.0,20.0
2994,0,2994,[313  64 483 318 187],214,5,12242,4.087479131886478,80.0,20.0
2995,0,2995,[313  64 483 318 187],618,5,12247,4.087783711615487,80.0,20.0
2996,0,2996,[185 475 174 172  11],198,4,12251,4.087754421087754,0.0,0.0
2997,0,2997,[204 678 100 282 121],345,2,12253,4.0870580386924615,0.0,0.0
2998,0,2998,[195 204 185 385 318],405,4,12257,4.08702900966989,20.0,0.0
2999,0,2999,[313  64 483 318 187],618,5,12262,4.0873333333333335,80.0,20.0
3000,0,3000,[288 195 282 269 258],854,3,12265,4.086971009663445,0.0,20.0
3001,0,3001,[313  64 483 318 187],214,5,12270,4.087275149900067,80.0,20.0
3002,0,3002,[313  64 483 318 187],618,5,12275,4.087579087579088,80.0,20.0
3003,0,3003,[ 12 200 185 121 197],805,4,12279,4.087549933422104,20.0,0.0
3004,0,3004,[ 56 678  64 405 333],345,3,12282,4.087188019966722,20.0,0.0
3005,0,3005,[313  64 483 318 187],214,5,12287,4.087491683300066,80.0,20.0
3006,0,3006,[ 97  71 185 179 187],198,2,12289,4.086797472564017,0.0,0.0
3007,0,3007,[111   4 153  22 403],416,5,12294,4.087101063829787,0.0,0.0
3008,0,3008,[ 50 238  70 245 151],416,3,12297,4.086739780658026,0.0,20.0
3009,0,3009,[185 265  97 475 245],417,3,12300,4.086378737541528,0.0,0.0
3010,0,3010,[179 276 183 182  82],416,3,12303,4.086017934241116,0.0,0.0
3011,0,3011,[313  64 483 318 187],618,5,12308,4.086321381142098,80.0,20.0
3012,0,3012,[313  64 483 318 187],618,5,12313,4.086624626617989,80.0,20.0
3013,0,3013,[186 216 286 282 194],854,0,12313,4.085268745852687,0.0,0.0
3014,0,3014,[185 546 742 153 181],417,1,12314,4.08424543946932,0.0,20.0
3015,0,3015,[313  64 483 318 187],618,5,12319,4.084549071618037,80.0,20.0
3016,0,3016,[313  64 483 318 187],214,5,12324,4.084852502485913,80.0,20.0
3017,0,3017,[313  64 483 318 187],618,5,12329,4.085155732273028,80.0,20.0
3018,0,3018,[313  64 483 318 187],214,5,12334,4.085458761179199,80.0,20.0
3019,0,3019,[313  64 483 318 187],214,5,12339,4.085761589403973,80.0,20.0
3020,0,3020,[ 88 153 172  50 603],373,5,12344,4.086064217146641,0.0,20.0
3021,0,3021,[515   1 202  96 215],416,5,12349,4.086366644606221,0.0,0.0
3022,0,3022,[313  64 483 318 187],214,5,12354,4.086668871981475,80.0,20.0
3023,0,3023,[313  64 483 318 187],214,5,12359,4.0869708994708995,80.0,20.0
3024,0,3024,[597  28 100 588  69],416,4,12363,4.086942148760331,0.0,0.0
3025,0,3025,[313  64 483 318 187],618,5,12368,4.087243886318572,80.0,20.0
3026,0,3026,[568 282  15  71 234],416,5,12373,4.087545424512719,0.0,0.0
3027,0,3027,[ 50 191  79 196   1],345,4,12377,4.087516512549538,0.0,20.0
3028,0,3028,[151 238 245  12  71],416,3,12380,4.087157477715418,20.0,0.0
3029,0,3029,[294 257 597   4 191],854,1,12381,4.086138613861386,0.0,0.0
3030,0,3030,[  9 328 111 294  50],43,5,12386,4.086440118772682,0.0,20.0
3031,0,3031,[313  64 483 318 187],214,5,12391,4.086741424802111,80.0,20.0
3032,0,3032,[111 174  28 202 211],297,3,12394,4.0863831190240685,0.0,0.0
3033,0,3033,[313  64 483 318 187],214,5,12399,4.08668424522083,80.0,20.0
3034,0,3034,[313  64 483 318 187],214,5,12404,4.086985172981878,80.0,20.0
3035,0,3035,[195 323 258  95 186],198,2,12406,4.086297760210804,0.0,0.0
3036,0,3036,[235 238 174 269   1],43,3,12409,4.085940072439908,0.0,0.0
3037,0,3037,[118 196 288 202 183],437,2,12411,4.085253456221198,0.0,20.0
3038,0,3038,[313  64 483 318 187],214,5,12416,4.085554458703521,80.0,20.0
3039,0,3039,[268 318 234 168 216],416,5,12421,4.085855263157895,20.0,0.0
3040,0,3040,[313  64 483 318 187],618,5,12426,4.086155869779677,80.0,20.0
3041,0,3041,[234 275 121 435 655],437,3,12429,4.085798816568047,0.0,0.0
3042,0,3042,[ 69  12 427   8 191],214,4,12433,4.085770621097601,20.0,0.0
3043,0,3043,[302 235 257 132 195],854,1,12434,4.0847568988173455,0.0,0.0
3044,0,3044,[742 286 568 100 588],43,5,12439,4.085057471264368,0.0,0.0
3045,0,3045,[144 403 475 235 655],417,3,12442,4.084701247537755,0.0,0.0
3046,0,3046,[235 100 175 245 168],297,3,12445,4.084345257630456,0.0,0.0
3047,0,3047,[204 191 423 144  95],698,0,12445,4.083005249343832,0.0,0.0
3048,0,3048,[423   7 222 475  50],62,4,12449,4.082978025582158,0.0,20.0
3049,0,3049,[496 179 294 204 191],416,4,12453,4.082950819672131,0.0,0.0
3050,0,3050,[196 168 143 603 144],751,5,12458,4.083251392985907,0.0,0.0
3051,0,3051,[195 204 237 186 216],618,2,12460,4.08256880733945,0.0,0.0
3052,0,3052,[322 318 323 127  96],416,3,12463,4.082214215525712,20.0,0.0
3053,0,3053,[197 275  71 282 245],128,3,12466,4.081859855926654,0.0,0.0
3054,0,3054,[313  64 483 318 187],214,5,12471,4.0821603927986905,80.0,20.0
3055,0,3055,[313  64 483 318 187],214,5,12476,4.082460732984293,80.0,20.0
3056,0,3056,[313  64 483 318 187],618,5,12481,4.08276087667648,80.0,20.0
3057,0,3057,[313  64 483 318 187],618,5,12486,4.083060824068018,80.0,20.0
3058,0,3058,[  4 144 179 176 273],62,4,12490,4.083033671134357,0.0,0.0
3059,0,3059,[313  64 483 318 187],618,5,12495,4.083333333333333,80.0,20.0
3060,0,3060,[313  64 483 318 187],214,5,12500,4.0836327997386475,80.0,20.0
3061,0,3061,[ 50 588   4 111 196],417,1,12501,4.082625734813847,0.0,20.0
3062,0,3062,[313  64 483 318 187],618,5,12506,4.08292523669605,80.0,20.0
3063,0,3063,[313  64 483 318 187],214,5,12511,4.08322454308094,80.0,20.0
3064,0,3064,[313  64 483 318 187],618,5,12516,4.08352365415987,80.0,20.0
3065,0,3065,[313  64 483 318 187],214,5,12521,4.08382257012394,80.0,20.0
3066,0,3066,[313  64 483 318 187],618,5,12526,4.084121291164004,80.0,20.0
3067,0,3067,[228 196 588  88 100],373,3,12529,4.083767926988266,0.0,0.0
3068,0,3068,[ 71 568  25 127 322],416,4,12533,4.0837406321277285,0.0,0.0
3069,0,3069,[313  64 483 318 187],214,5,12538,4.0840390879478825,80.0,20.0
3070,0,3070,[313  64 483 318 187],214,5,12543,4.0843373493975905,80.0,20.0
3071,0,3071,[313  64 483 318 187],214,5,12548,4.084635416666667,80.0,20.0
3072,0,3072,[173 282 568  50 333],588,5,12553,4.084933289944679,0.0,20.0
3073,0,3073,[237 185 194 403 515],416,4,12557,4.084905660377358,0.0,0.0
3074,0,3074,[403 328 471 271 117],43,3,12560,4.084552845528456,0.0,0.0
3075,0,3075,[655  95 197 215 216],373,4,12564,4.084525357607282,0.0,0.0
3076,0,3076,[313  64 483 318 187],618,5,12569,4.084822879428014,80.0,20.0
3077,0,3077,[ 15 202 742 173  71],416,5,12574,4.0851202079272255,0.0,0.0
3078,0,3078,[318 183 111 143 210],437,2,12576,4.084443000974343,20.0,0.0
3079,0,3079,[313  64 483 318 187],618,5,12581,4.08474025974026,80.0,20.0
3080,0,3080,[  9  69 588 179 100],601,3,12584,4.084388185654008,0.0,0.0
3081,0,3081,[313  64 483 318 187],618,5,12589,4.084685269305646,80.0,20.0
3082,0,3082,[118 318  50 471 423],416,4,12593,4.084657800843335,20.0,20.0
3083,0,3083,[  7 271 151 323 276],203,2,12595,4.083981841763943,0.0,0.0
3084,0,3084,[313  64 483 318 187],214,5,12600,4.084278768233387,80.0,20.0
3085,0,3085,[403 423 179 176 235],805,3,12603,4.083927414128321,0.0,0.0
3086,0,3086,[313  64 483 318 187],618,5,12608,4.084224165856819,80.0,20.0
3087,0,3087,[313  64 483 318 187],214,5,12613,4.084520725388601,80.0,20.0
3088,0,3088,[257   1 742 300 276],43,5,12618,4.084817092910327,0.0,0.0
3089,0,3089,[191 132   1 216 174],416,5,12623,4.085113268608414,0.0,0.0
3090,0,3090,[313  64 483 318 187],618,5,12628,4.085409252669039,80.0,20.0
3091,0,3091,[313  64 483 318 187],214,5,12633,4.085705045278137,80.0,20.0
3092,0,3092,[313 176   4 276 185],416,4,12637,4.085677335919819,20.0,20.0
3093,0,3093,[111 322 423 186 174],417,2,12639,4.085003232062055,0.0,0.0
3094,0,3094,[301 172 403 173 288],721,4,12643,4.08497576736672,0.0,20.0
3095,0,3095,[100 318   4 144 275],62,4,12647,4.084948320413437,20.0,0.0
3096,0,3096,[313  64 483 318 187],618,5,12652,4.085243784307394,80.0,20.0
3097,0,3097,[313  64 483 318 187],618,5,12657,4.085539057456423,80.0,20.0
3098,0,3098,[475 483 210 181 153],417,3,12660,4.085188770571152,20.0,20.0
3099,0,3099,[288   7 161 318 301],588,4,12664,4.0851612903225805,20.0,20.0
3100,0,3100,[313  64 483 318 187],214,5,12669,4.08545630441793,80.0,20.0
3101,0,3101,[313  64 483 318 187],214,5,12674,4.08575112830432,80.0,20.0
3102,0,3102,[161 202 144 301 111],43,5,12679,4.0860457621656465,0.0,0.0
3103,0,3103,[313  64 483 318 187],214,5,12684,4.086340206185567,80.0,20.0
3104,0,3104,[385  82 275 276 568],654,4,12688,4.086312399355878,0.0,0.0
3105,0,3105,[313  64 483 318 187],618,5,12693,4.086606567933033,80.0,20.0
3106,0,3106,[313  64 483 318 187],214,5,12698,4.086900547151593,80.0,20.0
3107,0,3107,[313  64 483 318 187],618,5,12703,4.087194337194338,80.0,20.0
3108,0,3108,[313  64 483 318 187],618,5,12708,4.087487938243808,80.0,20.0
3109,0,3109,[ 50 385 174 238  69],405,4,12712,4.087459807073955,0.0,20.0
3110,0,3110,[313  64 483 318 187],618,5,12717,4.087753134040502,80.0,20.0
3111,0,3111,[313  64 483 318 187],618,5,12722,4.088046272493573,80.0,20.0
3112,0,3112,[313  64 483 318 187],618,5,12727,4.088339222614841,80.0,20.0
3113,0,3113,[313  64 483 318 187],618,5,12732,4.088631984585742,80.0,20.0
3114,0,3114,[655 161  22 196  11],416,5,12737,4.08892455858748,0.0,0.0
3115,0,3115,[313  64 483 318 187],618,5,12742,4.089216944801027,80.0,20.0
3116,0,3116,[313  64 483 318 187],214,5,12747,4.089509143407122,80.0,20.0
3117,0,3117,[748 265 153 168  82],198,2,12749,4.088838999358563,0.0,0.0
3118,0,3118,[313  64 483 318 187],214,5,12754,4.089131131773004,80.0,20.0
3119,0,3119,[313  64 483 318 187],618,5,12759,4.089423076923077,80.0,20.0
3120,0,3120,[200 197  50 175 143],297,3,12762,4.089074014738865,0.0,20.0
3121,0,3121,[313  64 483 318 187],618,5,12767,4.089365791159513,80.0,20.0
3122,0,3122,[204 180 173 294  25],805,2,12769,4.088696765930195,0.0,0.0
3123,0,3123,[117 403 265  96 111],705,5,12774,4.08898847631242,0.0,0.0
3124,0,3124,[ 12 118  28 357  95],805,2,12776,4.08832,20.0,0.0
3125,0,3125,[234 202 275 196 286],416,5,12781,4.088611644273833,0.0,0.0
3126,0,3126,[ 70  28 127 275 195],62,3,12784,4.088263511352734,0.0,0.0
3127,0,3127,[313  64 483 318 187],214,5,12789,4.088554987212277,80.0,20.0
3128,0,3128,[313  64 483 318 187],618,5,12794,4.088846276765739,80.0,20.0
3129,0,3129,[118 172 238 216  89],751,2,12796,4.08817891373802,0.0,0.0
3130,0,3130,[275 202 175 302 385],43,4,12800,4.088150750558927,0.0,0.0
3131,0,3131,[313  64 483 318 187],214,5,12805,4.088441890166028,80.0,20.0
3132,0,3132,[301 302 427 318 132],416,5,12810,4.088732843919566,20.0,0.0
3133,0,3133,[313  64 483 318 187],214,5,12815,4.0890236119974475,80.0,20.0
3134,0,3134,[313  64 483 318 187],618,5,12820,4.089314194577352,80.0,20.0
3135,0,3135,[313  64 483 318 187],618,5,12825,4.089604591836735,80.0,20.0
3136,0,3136,[118 183 191  89 323],417,4,12829,4.089576028052279,0.0,0.0
3137,0,3137,[313  64 483 318 187],214,5,12834,4.089866156787763,80.0,20.0
3138,0,3138,[313  64 483 318 187],618,5,12839,4.090156100669003,80.0,20.0
3139,0,3139,[313  64 483 318 187],618,5,12844,4.090445859872611,80.0,20.0
3140,0,3140,[ 88 210 318 161 286],345,3,12847,4.090098694683222,20.0,0.0
3141,0,3141,[265 546  22   8 117],297,3,12850,4.089751750477403,0.0,0.0
3142,0,3142,[313  64 483 318 187],214,5,12855,4.090041361756284,80.0,20.0
3143,0,3143,[168  25 483 508  56],417,3,12858,4.0896946564885495,20.0,0.0
3144,0,3144,[313  64 483 318 187],214,5,12863,4.089984101748808,80.0,20.0
3145,0,3145,[313  64 483 318 187],618,5,12868,4.090273363000636,80.0,20.0
3146,0,3146,[313  64 483 318 187],618,5,12873,4.090562440419447,80.0,20.0
3147,0,3147,[313  64 483 318 187],214,5,12878,4.0908513341804325,80.0,20.0
3148,0,3148,[313  64 483 318 187],618,5,12883,4.091140044458558,80.0,20.0
3149,0,3149,[313  64 483 318 187],618,5,12888,4.091428571428572,80.0,20.0
3150,0,3150,[313  64 483 318 187],214,5,12893,4.091716915264995,80.0,20.0
3151,0,3151,[127 121  11 111 153],854,3,12896,4.091370558375634,0.0,0.0
3152,0,3152,[313  64 483 318 187],618,5,12901,4.091658737710118,80.0,20.0
3153,0,3153,[508 197 265 194  98],297,2,12903,4.090995561192137,0.0,20.0
3154,0,3154,[313  64 483 318 187],618,5,12908,4.091283676703645,80.0,20.0
3155,0,3155,[132 269 275 435 174],373,4,12912,4.091254752851711,0.0,0.0
3156,0,3156,[313  64 483 318 187],214,5,12917,4.091542603737726,80.0,20.0
3157,0,3157,[313  64 483 318 187],214,5,12922,4.0918302723242554,80.0,20.0
3158,0,3158,[ 96 173 234  95 210],417,3,12925,4.091484647040202,0.0,0.0
3159,0,3159,[313  64 483 318 187],214,5,12930,4.091772151898734,80.0,20.0
3160,0,3160,[173   7 176 273 748],297,4,12934,4.091743119266055,0.0,0.0
3161,0,3161,[235 323 197 234 385],805,3,12937,4.091397849462366,0.0,0.0
3162,0,3162,[313  64 483 318 187],214,5,12942,4.091685109073664,80.0,20.0
3163,0,3163,[313  64 483 318 187],618,5,12947,4.091972187104931,80.0,20.0
3164,0,3164,[ 89 181 180 357 237],198,3,12950,4.091627172195893,0.0,20.0
3165,0,3165,[313  64 483 318 187],214,5,12955,4.091914087176248,80.0,20.0
3166,0,3166,[313  64 483 318 187],618,5,12960,4.092200820966214,80.0,20.0
3167,0,3167,[313  64 483 318 187],214,5,12965,4.092487373737374,80.0,20.0
3168,0,3168,[222 268 496 216 185],417,1,12966,4.091511517828968,0.0,0.0
3169,0,3169,[313  64 483 318 187],214,5,12971,4.091798107255521,80.0,20.0
3170,0,3170,[135 144 200 323 286],417,2,12973,4.09113844213182,0.0,0.0
3171,0,3171,[ 71 121 271   8 202],907,4,12977,4.091109709962169,0.0,0.0
3172,0,3172,[313  64 483 318 187],214,5,12982,4.0913961550583045,80.0,20.0
3173,0,3173,[313  64 483 318 187],618,5,12987,4.091682419659735,80.0,20.0
3174,0,3174,[ 71  12  56 174  96],405,3,12990,4.0913385826771655,20.0,0.0
3175,0,3175,[215 117 194 100 748],751,4,12994,4.091309823677582,0.0,0.0
3176,0,3176,[588  70  71 180 100],437,2,12996,4.090651558073654,0.0,0.0
3177,0,3177,[313  64 483 318 187],214,5,13001,4.090937696664569,80.0,20.0
3178,0,3178,[313  64 483 318 187],618,5,13006,4.091223655237496,80.0,20.0
3179,0,3179,[ 82 132  98 172 127],417,4,13010,4.091194968553459,0.0,20.0
3180,0,3180,[185 289  25 302 100],49,4,13014,4.09116629990569,0.0,0.0
3181,0,3181,[215 597 471 132 568],618,4,13018,4.091137649277184,0.0,0.0
3182,0,3182,[313  64 483 318 187],618,5,13023,4.091423185673893,80.0,20.0
3183,0,3183,[313  64 483 318 187],618,5,13028,4.091708542713568,80.0,20.0
3184,0,3184,[678 161 197 191  98],416,4,13032,4.091679748822606,0.0,20.0
3185,0,3185,[313  64 483 318 187],618,5,13037,4.091964846202134,80.0,20.0
3186,0,3186,[111  56   4 294 191],62,3,13040,4.091622215249451,0.0,0.0
3187,0,3187,[313  64 483 318 187],214,5,13045,4.091907151819322,80.0,20.0
3188,0,3188,[313  64 483 318 187],214,5,13050,4.092191909689558,80.0,20.0
3189,0,3189,[175 143  56 215 211],297,4,13054,4.092163009404389,0.0,0.0
3190,0,3190,[313  64 483 318 187],214,5,13059,4.092447508617988,80.0,20.0
3191,0,3191,[313  64 483 318 187],214,5,13064,4.0927318295739346,80.0,20.0
3192,0,3192,[423 200 318 100 313],416,5,13069,4.093015972439712,40.0,20.0
3193,0,3193,[  8 180 161 174 135],405,3,13072,4.092673763306199,0.0,0.0
3194,0,3194,[313  64 483 318 187],618,5,13077,4.092957746478874,80.0,20.0
3195,0,3195,[216 153 313 603  70],354,1,13078,4.0919899874843555,20.0,20.0
3196,0,3196,[ 64 313 483 318 187],618,5,13083,4.092274006881452,80.0,20.0
3197,0,3197,[ 64 313 483 318 187],214,5,13088,4.092557848655409,80.0,20.0
3198,0,3198,[742 211 546  97  82],43,5,13093,4.092841512972804,0.0,0.0
3199,0,3199,[175  12   4 515 182],297,3,13096,4.0925,20.0,0.0
3200,0,3200,[ 64 313 483 318 187],618,5,13101,4.092783505154639,80.0,20.0
3201,0,3201,[ 64 313 483 318 187],214,5,13106,4.093066833229232,80.0,20.0
3202,0,3202,[ 64 313 483 318 187],618,5,13111,4.093349984389635,80.0,20.0
3203,0,3203,[ 64 313 483 318 187],214,5,13116,4.093632958801498,80.0,20.0
3204,0,3204,[300 181   4 168  96],198,3,13119,4.093291731669267,0.0,20.0
3205,0,3205,[ 64 313 483 318 187],214,5,13124,4.093574547723019,80.0,20.0
3206,0,3206,[302 182 228 175 143],297,3,13127,4.093233551605862,0.0,0.0
3207,0,3207,[ 64 313 483 318 187],214,5,13132,4.093516209476309,80.0,20.0
3208,0,3208,[ 64 313 483 318 187],214,5,13137,4.093798691181053,80.0,20.0
3209,0,3209,[ 64 313 483 318 187],618,5,13142,4.094080996884736,80.0,20.0
3210,0,3210,[294   9 748 301 276],324,5,13147,4.094363126751791,0.0,0.0
3211,0,3211,[588 153  50 118  15],642,3,13150,4.094022415940224,0.0,20.0
3212,0,3212,[ 64 313 483 318 187],618,5,13155,4.094304388422035,80.0,20.0
3213,0,3213,[ 64 313 483 318 187],214,5,13160,4.094586185438706,80.0,20.0
3214,0,3214,[ 64 313 483 318 187],618,5,13165,4.094867807153966,80.0,20.0
3215,0,3215,[ 64 313 483 318 187],618,5,13170,4.095149253731344,80.0,20.0
3216,0,3216,[194 496 172 121 187],698,2,13172,4.094497979483991,0.0,0.0
3217,0,3217,[ 64 313 483 318 187],618,5,13177,4.09477936606588,80.0,20.0
3218,0,3218,[ 64 313 483 318 187],214,5,13182,4.095060577819199,80.0,20.0
3219,0,3219,[202 471 183 204   7],618,2,13184,4.094409937888199,0.0,0.0
3220,0,3220,[  4   7 125 200 100],618,3,13187,4.0940701645451725,0.0,0.0
3221,0,3221,[385 235  95  22 153],922,2,13189,4.0934202358783365,0.0,0.0
3222,0,3222,[322 161 132 215 423],128,2,13191,4.092770710518151,0.0,0.0
3223,0,3223,[300 179 187 245 289],416,2,13193,4.09212158808933,0.0,0.0
3224,0,3224,[268  71 294 301 237],345,3,13196,4.091782945736434,0.0,0.0
3225,0,3225,[ 64 313 483 318 187],214,5,13201,4.092064476131432,80.0,20.0
3226,0,3226,[ 64 313 483 318 187],214,5,13206,4.092345832042144,80.0,20.0
3227,0,3227,[405 144 176   8 100],854,3,13209,4.092007434944238,0.0,0.0
3228,0,3228,[  8  22 202 568   1],618,3,13212,4.091669247445029,0.0,0.0
3229,0,3229,[ 79 144 179 588  95],416,3,13215,4.091331269349845,0.0,0.0
3230,0,3230,[ 64 313 483 318 187],618,5,13220,4.091612503868771,80.0,20.0
3231,0,3231,[423 200 185  70 302],416,5,13225,4.091893564356436,0.0,0.0
3232,0,3232,[127 191 405 125 318],416,5,13230,4.092174450974327,20.0,0.0
3233,0,3233,[273 275 100 289  22],854,3,13233,4.091836734693878,0.0,0.0
3234,0,3234,[655 174 403 127 100],198,4,13237,4.091808346213292,0.0,0.0
3235,0,3235,[515  97  25 125  28],230,4,13241,4.091779975278121,0.0,0.0
3236,0,3236,[196 222 471  12 174],43,4,13245,4.0917516218721035,20.0,0.0
3237,0,3237,[508 211  69 515   8],297,4,13249,4.091723285979,0.0,0.0
3238,0,3238,[125 132 288 427 196],416,5,13254,4.092003704847175,0.0,20.0
3239,0,3239,[173 121 174  64   9],416,5,13259,4.092283950617284,20.0,0.0
3240,0,3240,[357 153 144 471  28],373,2,13261,4.091638383215057,0.0,0.0
3241,0,3241,[ 70  96 191 328  12],62,3,13264,4.091301665638495,20.0,0.0
3242,0,3242,[ 98  95 121  88 161],711,4,13268,4.09127351218008,0.0,20.0
3243,0,3243,[ 64 313 483 318 187],618,5,13273,4.091553637484587,80.0,20.0
3244,0,3244,[ 64 313 483 318 187],214,5,13278,4.091833590138675,80.0,20.0
3245,0,3245,[ 64 313 483 318 187],618,5,13283,4.09211337030191,80.0,20.0
3246,0,3246,[508 268 588 202 200],297,3,13286,4.091777024946104,0.0,0.0
3247,0,3247,[ 64 313 483 318 187],214,5,13291,4.092056650246305,80.0,20.0
3248,0,3248,[483 385 234 302 238],417,4,13295,4.092028316405048,20.0,0.0
3249,0,3249,[ 50  15 237 210 245],62,2,13297,4.091384615384615,0.0,20.0
3250,0,3250,[ 56 423 191  97 176],416,5,13302,4.091664103352815,0.0,0.0
3251,0,3251,[333  15  64 258  12],345,4,13306,4.091635916359164,40.0,0.0
3252,0,3252,[175 222 302 269 288],721,3,13309,4.0913003381494,0.0,20.0
3253,0,3253,[ 64 313 483 318 187],618,5,13314,4.091579594345421,80.0,20.0
3254,0,3254,[ 64 313 483 318 187],618,5,13319,4.091858678955453,80.0,20.0
3255,0,3255,[ 64 313 483 318 187],214,5,13324,4.092137592137592,80.0,20.0
3256,0,3256,[300 173 196 216  98],416,5,13329,4.092416334049739,0.0,20.0
3257,0,3257,[597 144  25  79 588],618,4,13333,4.092387968078576,0.0,0.0
3258,0,3258,[289 268 204 294 121],345,2,13335,4.091745934335686,0.0,0.0
3259,0,3259,[176 215  64 143  97],198,3,13338,4.091411042944785,20.0,0.0
3260,0,3260,[ 64 313 483 318 187],214,5,13343,4.091689665746704,80.0,20.0
3261,0,3261,[ 64 313 483 318 187],618,5,13348,4.0919681177191904,80.0,20.0
3262,0,3262,[ 64 313 483 318 187],618,5,13353,4.092246399019308,80.0,20.0
3263,0,3263,[ 88 496 276 427 144],618,4,13357,4.092218137254902,0.0,0.0
3264,0,3264,[211 111 423 191  12],416,5,13362,4.092496171516079,20.0,0.0
3265,0,3265,[118  71   8 216 153],642,2,13364,4.091855480710349,0.0,0.0
3266,0,3266,[ 64 313 483 318 187],618,5,13369,4.09213345576982,80.0,20.0
3267,0,3267,[144 118 271 273   8],805,0,13369,4.090881272949816,0.0,0.0
3268,0,3268,[118 132  25 151  11],345,3,13372,4.090547568063628,0.0,0.0
3269,0,3269,[ 11  96 191 121 215],416,5,13377,4.090825688073394,0.0,0.0
3270,0,3270,[403 234 282 333 100],345,2,13379,4.0901864873127485,0.0,0.0
3271,0,3271,[179 318 118 215 200],198,4,13383,4.090158924205379,20.0,0.0
3272,0,3272,[ 64 313 483 318 187],214,5,13388,4.090436908035442,80.0,20.0
3273,0,3273,[228 125 161 265 435],230,4,13392,4.090409285277947,0.0,0.0
3274,0,3274,[ 64 313 483 318 187],618,5,13397,4.090687022900763,80.0,20.0
3275,0,3275,[ 69   4 423 211 238],297,2,13399,4.09004884004884,0.0,0.0
3276,0,3276,[ 64 313 483 318 187],618,5,13404,4.090326518156851,80.0,20.0
3277,0,3277,[187 195 168  64 127],405,4,13408,4.090298962782184,20.0,0.0
3278,0,3278,[238 323 471 286 181],416,4,13412,4.090271424214699,0.0,20.0
3279,0,3279,[ 64 313 483 318 187],618,5,13417,4.090548780487805,80.0,20.0
3280,0,3280,[ 64 313 483 318 187],214,5,13422,4.090825967692776,80.0,20.0
3281,0,3281,[182  12 301 132 210],416,5,13427,4.091102985984156,20.0,0.0
3282,0,3282,[ 64 313 483 318 187],618,5,13432,4.091379835516296,80.0,20.0
3283,0,3283,[186  28  82 118 185],437,1,13433,4.090438489646772,0.0,0.0
3284,0,3284,[313 301 273 423 257],416,4,13437,4.090410958904109,20.0,20.0
3285,0,3285,[258 172 135 200 117],417,3,13440,4.090079123554474,0.0,0.0
3286,0,3286,[ 64 313 483 318 187],618,5,13445,4.090355947672649,80.0,20.0
3287,0,3287,[143 100 288 153 196],437,4,13449,4.0903284671532845,0.0,20.0
3288,0,3288,[403  69  71 286   4],373,3,13452,4.089996959562177,0.0,0.0
3289,0,3289,[ 64 313 483 318 187],618,5,13457,4.090273556231003,80.0,20.0
3290,0,3290,[ 64 313 483 318 187],618,5,13462,4.0905499848070495,80.0,20.0
3291,0,3291,[117 222  64 546 175],43,4,13466,4.090522478736331,20.0,0.0
3292,0,3292,[ 64 313 483 318 187],618,5,13471,4.090798663832372,80.0,20.0
3293,0,3293,[ 64 313 483 318 187],214,5,13476,4.091074681238616,80.0,20.0
3294,0,3294,[161 405 143  56 179],751,3,13479,4.090743550834598,0.0,0.0
3295,0,3295,[ 64 313 483 318 187],214,5,13484,4.091019417475728,80.0,20.0
3296,0,3296,[ 64 313 483 318 187],618,5,13489,4.091295116772824,80.0,20.0
3297,0,3297,[ 64 313 483 318 187],214,5,13494,4.091570648878108,80.0,20.0
3298,0,3298,[ 64 313 483 318 187],618,5,13499,4.091846013943619,80.0,20.0
3299,0,3299,[ 64 313 483 318 187],214,5,13504,4.092121212121212,80.0,20.0
3300,0,3300,[ 64 313 483 318 187],618,5,13509,4.092396243562557,80.0,20.0
3301,0,3301,[294 427 174 204  79],128,4,13513,4.0923682616596,0.0,0.0
3302,0,3302,[678   9 191 176 276],416,3,13516,4.092037541628822,0.0,0.0
3303,0,3303,[ 64 313 483 318 187],618,5,13521,4.092312348668281,80.0,20.0
3304,0,3304,[181 275 151  50 127],618,3,13524,4.091981845688351,0.0,40.0
3305,0,3305,[117 191 323 235   8],43,3,13527,4.0916515426497275,0.0,0.0
3306,0,3306,[196  11  12   7  56],618,5,13532,4.09192621711521,20.0,0.0
3307,0,3307,[ 64 313 483 318 187],214,5,13537,4.092200725513906,80.0,20.0
3308,0,3308,[211 111  89 175 118],297,3,13540,4.091870655787247,0.0,0.0
3309,0,3309,[235 288 323  11 204],416,3,13543,4.0915407854984895,0.0,20.0
3310,0,3310,[ 64 313 483 318 187],214,5,13548,4.091815161582604,80.0,20.0
3311,0,3311,[ 82 748 237  71 435],505,2,13550,4.091183574879227,0.0,0.0
3312,0,3312,[125 275 403  64 161],618,3,13553,4.09085421068518,20.0,0.0
3313,0,3313,[ 64 313 483 318 187],618,5,13558,4.091128545564273,80.0,20.0
3314,0,3314,[ 64 313 483 318 187],618,5,13563,4.091402714932126,80.0,20.0
3315,0,3315,[ 64 313 483 318 187],214,5,13568,4.09167671893848,80.0,20.0
3316,0,3316,[135 197 191 196  98],437,5,13573,4.091950557732891,0.0,20.0
3317,0,3317,[ 64 182 313 161  69],416,5,13578,4.092224231464738,40.0,20.0
3318,0,3318,[235 151 183 405 742],416,3,13581,4.091895149141307,0.0,0.0
3319,0,3319,[ 64 313 483 318 187],618,5,13586,4.0921686746987955,80.0,20.0
3320,0,3320,[ 64 313 483 318 187],618,5,13591,4.092442035531467,80.0,20.0
3321,0,3321,[ 64 313 483 318 187],618,5,13596,4.0927152317880795,80.0,20.0
3322,0,3322,[ 64 313 483 318 187],214,5,13601,4.0929882636172135,80.0,20.0
3323,0,3323,[ 64 313 483 318 187],618,5,13606,4.093261131167268,80.0,20.0
3324,0,3324,[144  28  25   7 100],588,2,13608,4.092631578947368,0.0,0.0
3325,0,3325,[215  79 258  88 174],541,4,13612,4.092603728202045,0.0,0.0
3326,0,3326,[288  95 568  28 289],588,4,13616,4.092575894198978,0.0,20.0
3327,0,3327,[ 95  69 127 257 597],416,2,13618,4.091947115384615,0.0,0.0
3328,0,3328,[ 11  22 216 215  97],654,4,13622,4.091919495343947,0.0,0.0
3329,0,3329,[ 15  11 144   9 204],618,2,13624,4.0912912912912915,0.0,0.0
3330,0,3330,[475 322 135 125 286],417,3,13627,4.0909636745722,0.0,0.0
3331,0,3331,[ 64 313 483 318 187],618,5,13632,4.0912364945978394,80.0,20.0
3332,0,3332,[483  97 168 294 185],417,4,13636,4.091209120912091,20.0,0.0
3333,0,3333,[ 64 313 483 318 187],618,5,13641,4.0914817036592686,80.0,20.0
3334,0,3334,[238 187  70 597 100],416,4,13645,4.091454272863568,0.0,0.0
3335,0,3335,[ 64 313 483 318 187],214,5,13650,4.091726618705036,80.0,20.0
3336,0,3336,[ 64 313 483 318 187],214,5,13655,4.0919988013185495,80.0,20.0
3337,0,3337,[238 300 268  97 294],654,2,13657,4.091372079089275,0.0,0.0
3338,0,3338,[ 64 313 483 318 187],618,5,13662,4.091644204851752,80.0,20.0
3339,0,3339,[ 64 313 483 318 187],214,5,13667,4.091916167664671,80.0,20.0
3340,0,3340,[151 282 597 197 168],618,2,13669,4.091290032924274,0.0,0.0
3341,0,3341,[ 64 313 483 318 187],214,5,13674,4.091561938958708,80.0,20.0
3342,0,3342,[238 215 182 435 200],405,2,13676,4.090936284774155,0.0,0.0
3343,0,3343,[ 64 313 483 318 187],618,5,13681,4.091208133971292,80.0,20.0
3344,0,3344,[  7 268  69 238  95],297,3,13684,4.090881913303438,0.0,0.0
3345,0,3345,[ 64 313 483 318 187],618,5,13689,4.091153616258219,80.0,20.0
3346,0,3346,[269 265 423 588  98],711,3,13692,4.090827606812071,0.0,20.0
3347,0,3347,[ 64 313 483 318 187],618,5,13697,4.091099163679809,80.0,20.0
3348,0,3348,[ 64 313 483 318 187],618,5,13702,4.091370558375634,80.0,20.0
3349,0,3349,[216 333  12  50 151],854,3,13705,4.091044776119403,20.0,20.0
3350,0,3350,[ 64 313 483 318 187],618,5,13710,4.091316025067144,80.0,20.0
3351,0,3351,[ 64 313 483 318 187],214,5,13715,4.091587112171838,80.0,20.0
3352,0,3352,[ 64 313 483 318 187],618,5,13720,4.091858037578288,80.0,20.0
3353,0,3353,[568 186 204 318  50],588,5,13725,4.0921288014311274,20.0,20.0
3354,0,3354,[568 403 655  71 215],345,3,13728,4.091803278688524,0.0,0.0
3355,0,3355,[ 64 313 483 318 187],618,5,13733,4.09207389749702,80.0,20.0
3356,0,3356,[258 153 234 515  97],417,5,13738,4.092344355078939,0.0,0.0
3357,0,3357,[257 204  15 405 195],601,0,13738,4.091125670041691,0.0,0.0
3358,0,3358,[ 98 385 588 181 196],43,5,13743,4.091396248883596,0.0,40.0
3359,0,3359,[161  22   8  11 174],405,4,13747,4.091369047619048,0.0,0.0
3360,0,3360,[655   1  71 286 181],62,2,13749,4.090746801547159,0.0,20.0
3361,0,3361,[  8  82 301 269  22],721,5,13754,4.091017251635931,0.0,0.0
3362,0,3362,[471 127 161 175 215],922,0,13754,4.089800773119239,0.0,0.0
3363,0,3363,[ 64 313 483 318 187],618,5,13759,4.090071343638526,80.0,20.0
3364,0,3364,[323 403 269  98 181],345,3,13762,4.089747399702823,0.0,40.0
3365,0,3365,[100 127 197  22  12],373,2,13764,4.089126559714795,20.0,0.0
3366,0,3366,[172  96 185 268 179],417,2,13766,4.088506088506088,0.0,0.0
3367,0,3367,[ 64 313 483 318 187],214,5,13771,4.0887767220902616,80.0,20.0
3368,0,3368,[ 64 313 483 318 187],214,5,13776,4.089047195013357,80.0,20.0
3369,0,3369,[655 323 200 127  79],417,3,13779,4.088724035608308,0.0,0.0
3370,0,3370,[276 132  25 215 125],921,1,13780,4.087807772174429,0.0,0.0
3371,0,3371,[405 202 195  70 427],642,0,13780,4.086595492289442,0.0,0.0
3372,0,3372,[ 64 313 483 318 187],214,5,13785,4.086866291135488,80.0,20.0
3373,0,3373,[302 174 333 216   1],345,3,13788,4.086544161232958,0.0,0.0
3374,0,3374,[288 483 200 275 173],854,5,13793,4.086814814814815,20.0,20.0
3375,0,3375,[ 64 313 483 318 187],618,5,13798,4.087085308056872,80.0,20.0
3376,0,3376,[748 111  69 237  28],437,2,13800,4.086467278649689,0.0,0.0
3377,0,3377,[172 181 153  28 210],373,4,13804,4.086441681468324,0.0,20.0
3378,0,3378,[183 678 168 276 172],416,3,13807,4.086120153891684,0.0,0.0
3379,0,3379,[210 194 275 234 288],416,5,13812,4.086390532544379,0.0,20.0
3380,0,3380,[175 191   4 475 435],297,2,13814,4.085773439810707,0.0,0.0
3381,0,3381,[333 191 179 245   8],721,2,13816,4.085156712004731,0.0,0.0
3382,0,3382,[ 64 313 483 318 187],618,5,13821,4.085427135678392,80.0,20.0
3383,0,3383,[222 748 546 245 176],297,2,13823,4.084810874704492,0.0,0.0
3384,0,3384,[197 257 204 568  50],751,3,13826,4.084490398818316,0.0,20.0
3385,0,3385,[245 181 234 286 143],297,3,13829,4.084170112226817,0.0,20.0
3386,0,3386,[ 64 313 483 318 187],618,5,13834,4.084440507824033,80.0,20.0
3387,0,3387,[173  89 333  22 471],854,2,13836,4.083825265643448,0.0,0.0
3388,0,3388,[ 64 313 483 318 187],214,5,13841,4.084095603422838,80.0,20.0
3389,0,3389,[ 64 313 483 318 187],214,5,13846,4.084365781710915,80.0,20.0
3390,0,3390,[ 96  22 655 568 318],618,4,13850,4.084340902388676,20.0,0.0
3391,0,3391,[ 25 197 191  22 742],416,5,13855,4.084610849056604,0.0,0.0
3392,0,3392,[ 64 313 483 318 187],214,5,13860,4.084880636604774,80.0,20.0
3393,0,3393,[235 323   4 173   1],416,3,13863,4.084560989982322,0.0,0.0
3394,0,3394,[ 64 313 483 318 187],214,5,13868,4.084830633284241,80.0,20.0
3395,0,3395,[ 64 313 483 318 187],214,5,13873,4.08510011778563,80.0,20.0
3396,0,3396,[ 64 313 483 318 187],214,5,13878,4.085369443626729,80.0,20.0
3397,0,3397,[ 22  56  69  98 403],588,2,13880,4.084755738669806,0.0,20.0
3398,0,3398,[ 64 313 483 318 187],618,5,13885,4.085025007355105,80.0,20.0
3399,0,3399,[ 64 313 483 318 187],618,5,13890,4.0852941176470585,80.0,20.0
3400,0,3400,[ 22 568 191 301  11],416,5,13895,4.085563069685387,0.0,0.0
3401,0,3401,[ 69  96 143 276 313],416,4,13899,4.085537918871252,20.0,20.0
3402,0,3402,[496 357 153 143 216],416,5,13904,4.085806641198942,0.0,0.0
3403,0,3403,[174 168 385 508 328],49,1,13905,4.0849001175088135,0.0,0.0
3404,0,3404,[ 88 515 403 132 204],416,4,13909,4.0848751835535975,0.0,0.0
3405,0,3405,[ 64 313 483 318 187],618,5,13914,4.085143863769818,80.0,20.0
3406,0,3406,[ 64 313 483 318 187],618,5,13919,4.085412386263575,80.0,20.0
3407,0,3407,[ 64 313 483 318 187],214,5,13924,4.085680751173709,80.0,20.0
3408,0,3408,[ 64 313 483 318 187],214,5,13929,4.085948958638897,80.0,20.0
3409,0,3409,[ 64 313 483 318 187],214,5,13934,4.086217008797654,80.0,20.0
3410,0,3410,[ 64 313 483 318 187],618,5,13939,4.086484901788332,80.0,20.0
3411,0,3411,[185 655 111 265  97],618,4,13943,4.086459554513482,0.0,0.0
3412,0,3412,[ 64 313 483 318 187],214,5,13948,4.086727219455025,80.0,20.0
3413,0,3413,[ 64 313 483 318 187],618,5,13953,4.086994727592267,80.0,20.0
3414,0,3414,[ 64 313 483 318 187],214,5,13958,4.087262079062958,80.0,20.0
3415,0,3415,[423 288 200 588 197],297,1,13959,4.08635831381733,0.0,20.0
3416,0,3416,[185 357 228 568 135],417,1,13960,4.0854550775534095,0.0,0.0
3417,0,3417,[ 64 313 483 318 187],214,5,13965,4.085722644821533,80.0,20.0
3418,0,3418,[ 64 313 483 318 187],618,5,13970,4.085990055571805,80.0,20.0
3419,0,3419,[ 64 313 483 318 187],214,5,13975,4.08625730994152,80.0,20.0
3420,0,3420,[111 210 475 318 427],416,4,13979,4.086232095878398,20.0,0.0
3421,0,3421,[ 64 313 483 318 187],618,5,13984,4.086499123319696,80.0,20.0
3422,0,3422,[282 153  69 181 302],297,3,13987,4.0861817119485835,0.0,20.0
3423,0,3423,[ 64 313 483 318 187],214,5,13992,4.086448598130841,80.0,20.0
3424,0,3424,[ 64 313 483 318 187],618,5,13997,4.086715328467153,80.0,20.0
3425,0,3425,[ 64 313 483 318 187],214,5,14002,4.086981903093987,80.0,20.0
3426,0,3426,[143 423 385 174 403],198,2,14004,4.08637292092209,0.0,0.0
3427,0,3427,[ 64 313 483 318 187],214,5,14009,4.0866394399066515,80.0,20.0
3428,0,3428,[403 191 655 135 172],711,5,14014,4.086905803441237,0.0,0.0
3429,0,3429,[265  69 195 173 288],405,4,14018,4.086880466472303,0.0,20.0
3430,0,3430,[ 64 313 483 318 187],214,5,14023,4.087146604488487,80.0,20.0
3431,0,3431,[ 64 313 483 318 187],618,5,14028,4.0874125874125875,80.0,20.0
3432,0,3432,[ 64 313 483 318 187],618,5,14033,4.087678415380134,80.0,20.0
3433,0,3433,[ 64 313 483 318 187],618,5,14038,4.0879440885265,80.0,20.0
3434,0,3434,[ 64 313 483 318 187],214,5,14043,4.0882096069869,80.0,20.0
3435,0,3435,[ 22 597 179 357 405],805,2,14045,4.087601862630966,0.0,0.0
3436,0,3436,[ 64 313 483 318 187],618,5,14050,4.087867326156532,80.0,20.0
3437,0,3437,[197 546 257 328  88],416,2,14052,4.087260034904014,0.0,0.0
3438,0,3438,[ 64 313 483 318 187],618,5,14057,4.087525443442861,80.0,20.0
3439,0,3439,[100 423 183 121 237],618,5,14062,4.087790697674419,0.0,0.0
3440,0,3440,[ 64 313 483 318 187],618,5,14067,4.088055797733217,80.0,20.0
3441,0,3441,[ 64 313 483 318 187],618,5,14072,4.0883207437536315,80.0,20.0
3442,0,3442,[ 64 313 483 318 187],214,5,14077,4.088585535869881,80.0,20.0
3443,0,3443,[471  97  22 204 161],416,5,14082,4.088850174216028,0.0,0.0
3444,0,3444,[200 182 435  12 238],297,2,14084,4.0882438316400584,20.0,0.0
3445,0,3445,[ 64 313 483 318 187],214,5,14089,4.088508415554266,80.0,20.0
3446,0,3446,[ 64 313 483 318 187],618,5,14094,4.088772845953002,80.0,20.0
3447,0,3447,[ 64 313 483 318 187],618,5,14099,4.089037122969837,80.0,20.0
3448,0,3448,[ 64 313 483 318 187],214,5,14104,4.089301246738185,80.0,20.0
3449,0,3449,[265 228 427 181 403],711,3,14107,4.0889855072463765,0.0,20.0
3450,0,3450,[ 71 302 168 183 273],416,5,14112,4.089249492900609,0.0,0.0
3451,0,3451,[ 64 313 483 318 187],214,5,14117,4.089513325608343,80.0,20.0
3452,0,3452,[ 64 313 483 318 187],618,5,14122,4.089777005502461,80.0,20.0
3453,0,3453,[191 245 273  70 302],62,2,14124,4.089171974522293,0.0,0.0
3454,0,3454,[423 289 276 182 234],416,3,14127,4.088856729377714,0.0,0.0
3455,0,3455,[ 64 313 483 318 187],618,5,14132,4.08912037037037,80.0,20.0
3456,0,3456,[ 64 313 483 318 187],214,5,14137,4.089383858837142,80.0,20.0
3457,0,3457,[286  70 195 483 191],417,5,14142,4.089647194910353,20.0,0.0
3458,0,3458,[ 79 186 196 111 265],437,2,14144,4.089043076033536,0.0,0.0
3459,0,3459,[ 64 313 483 318 187],214,5,14149,4.089306358381503,80.0,20.0
3460,0,3460,[ 96  64 186   7 228],198,4,14153,4.089280554752961,20.0,0.0
3461,0,3461,[ 64 313 483 318 187],618,5,14158,4.089543616406702,80.0,20.0
3462,0,3462,[294 597  89 151 423],805,2,14160,4.0889402252382325,0.0,0.0
3463,0,3463,[ 64 313 483 318 187],214,5,14165,4.089203233256351,80.0,20.0
3464,0,3464,[508 182 357 288 153],62,4,14169,4.089177489177489,0.0,20.0
3465,0,3465,[ 64 313 483 318 187],214,5,14174,4.089440276976342,80.0,20.0
3466,0,3466,[405 100  64  28 174],345,4,14178,4.089414479376983,20.0,0.0
3467,0,3467,[323 275  96 238   8],416,4,14182,4.089388696655132,0.0,0.0
3468,0,3468,[215  79  56 269 286],416,5,14187,4.089651196310176,0.0,0.0
3469,0,3469,[258 405 143 173 568],198,2,14189,4.089048991354467,0.0,0.0
3470,0,3470,[ 64 313 483 318 187],214,5,14194,4.089311437626044,80.0,20.0
3471,0,3471,[168 151 385 121 237],654,5,14199,4.089573732718894,0.0,0.0
3472,0,3472,[357 678 568  56 313],416,4,14203,4.0895479412611575,20.0,20.0
3473,0,3473,[118 182   1 121 258],907,5,14208,4.089810017271157,0.0,0.0
3474,0,3474,[288 151 228  98 268],496,2,14210,4.089208633093525,0.0,40.0
3475,0,3475,[ 64 313 483 318 187],618,5,14215,4.089470655926352,80.0,20.0
3476,0,3476,[ 56  69 228 196 175],297,3,14218,4.089157319528329,0.0,0.0
3477,0,3477,[191 423 234 183 275],416,5,14223,4.089419206440483,0.0,0.0
3478,0,3478,[ 64 313 483 318 187],214,5,14228,4.089680942799655,80.0,20.0
3479,0,3479,[ 64 313 483 318 187],618,5,14233,4.089942528735632,80.0,20.0
3480,0,3480,[ 64 313 483 318 187],618,5,14238,4.090203964378052,80.0,20.0
3481,0,3481,[176 117 135 211 100],437,3,14241,4.089890867317633,0.0,0.0
3482,0,3482,[161 175 302 357 300],721,4,14245,4.089865058857307,0.0,0.0
3483,0,3483,[ 64 313 483 318 187],618,5,14250,4.090126291618829,80.0,20.0
3484,0,3484,[180  79 742  96 181],805,2,14252,4.089526542324247,0.0,20.0
3485,0,3485,[357 181  79 183 202],417,3,14255,4.089213998852553,0.0,20.0
3486,0,3486,[ 64 313 483 318 187],618,5,14260,4.08947519357614,80.0,20.0
3487,0,3487,[268 153 403 508 174],417,3,14263,4.089162844036697,0.0,0.0
3488,0,3488,[151 496 195  12 118],417,4,14267,4.089137288621382,20.0,0.0
3489,0,3489,[ 64 313 483 318 187],214,5,14272,4.089398280802293,80.0,20.0
3490,0,3490,[333 194 269 185 153],854,3,14275,4.089086221712976,0.0,0.0
3491,0,3491,[132 172  71 588 191],262,3,14278,4.088774341351661,0.0,0.0
3492,0,3492,[288  50 200 179 127],405,3,14281,4.088462639564844,0.0,40.0
3493,0,3493,[ 64 313 483 318 187],618,5,14286,4.088723526044648,80.0,20.0
3494,0,3494,[ 64 313 483 318 187],214,5,14291,4.08898426323319,80.0,20.0
3495,0,3495,[ 64 313 483 318 187],618,5,14296,4.089244851258581,80.0,20.0
3496,0,3496,[475 294  70 515 118],417,5,14301,4.089505290248785,0.0,0.0
3497,0,3497,[ 64 313 483 318 187],214,5,14306,4.089765580331618,80.0,20.0
3498,0,3498,[ 64 313 483 318 187],214,5,14311,4.090025721634753,80.0,20.0
3499,0,3499,[742 195 403 265 427],416,5,14316,4.090285714285714,0.0,0.0
3500,0,3500,[183 143 200  97 117],198,2,14318,4.089688660382747,0.0,0.0
3501,0,3501,[ 79 210 183 269 151],297,3,14321,4.089377498572245,0.0,0.0
3502,0,3502,[196   8 269 111 216],721,5,14326,4.08963745361119,0.0,0.0
3503,0,3503,[200 273 210 185 546],417,1,14327,4.088755707762557,0.0,0.0
3504,0,3504,[288 257 168 318 132],854,4,14331,4.088730385164052,20.0,20.0
3505,0,3505,[ 64 313 483 318 187],214,5,14336,4.088990302338848,80.0,20.0
3506,0,3506,[151  50 144  28 288],588,4,14340,4.088964927288281,0.0,40.0
3507,0,3507,[268 313 238 111 515],416,5,14345,4.089224629418472,20.0,20.0
3508,0,3508,[ 64 313 483 318 187],618,5,14350,4.089484183528071,80.0,20.0
3509,0,3509,[ 64 313 483 318 187],618,5,14355,4.089743589743589,80.0,20.0
3510,0,3510,[ 64 313 483 318 187],618,5,14360,4.090002848191398,80.0,20.0
3511,0,3511,[ 64 313 483 318 187],618,5,14365,4.090261958997722,80.0,20.0
3512,0,3512,[222 100 183 127   8],601,4,14369,4.090236265300313,0.0,0.0
3513,0,3513,[ 64 313 483 318 187],618,5,14374,4.09049516220831,80.0,20.0
3514,0,3514,[ 64 313 483 318 187],618,5,14379,4.0907539118065435,80.0,20.0
3515,0,3515,[172  64  25 403   4],417,2,14381,4.0901592718998865,20.0,0.0
3516,0,3516,[ 64 313 483 318 187],214,5,14386,4.090417969860677,80.0,20.0
3517,0,3517,[ 64 313 483 318 187],214,5,14391,4.090676520750426,80.0,20.0
3518,0,3518,[ 79   7 143 185 235],297,3,14394,4.090366581415175,0.0,0.0
3519,0,3519,[216 322 204 288 125],416,4,14398,4.0903409090909095,0.0,20.0
3520,0,3520,[ 64 313 483 318 187],618,5,14403,4.090599261573416,80.0,20.0
3521,0,3521,[ 56 168 215 276 172],416,4,14407,4.090573537762634,0.0,0.0
3522,0,3522,[ 64 313 483 318 187],618,5,14412,4.090831677547545,80.0,20.0
3523,0,3523,[ 64 313 483 318 187],618,5,14417,4.0910896708286035,80.0,20.0
3524,0,3524,[269 161 176  96 237],416,4,14421,4.091063829787234,0.0,0.0
3525,0,3525,[234 568 172  25 183],198,2,14423,4.0904707884288145,0.0,0.0
3526,0,3526,[191  70 257 471  64],43,4,14427,4.090445137510632,20.0,0.0
3527,0,3527,[ 64 313 483 318 187],618,5,14432,4.090702947845805,80.0,20.0
3528,0,3528,[185  64 216  98  79],618,4,14436,4.090677245678663,20.0,20.0
3529,0,3529,[  7 127 385 195 181],198,3,14439,4.090368271954675,0.0,20.0
3530,0,3530,[ 64 313 483 318 187],214,5,14444,4.090625885018408,80.0,20.0
3531,0,3531,[ 64 313 483 318 187],214,5,14449,4.0908833522083805,80.0,20.0
3532,0,3532,[ 64 313 483 318 187],214,5,14454,4.091140673648457,80.0,20.0
3533,0,3533,[173 216  28 195 121],62,4,14458,4.091114883984154,0.0,0.0
3534,0,3534,[289  15 475 100 276],525,3,14461,4.090806223479491,0.0,0.0
3535,0,3535,[ 64 313 483 318 187],214,5,14466,4.09106334841629,80.0,20.0
3536,0,3536,[ 64 313 483 318 187],214,5,14471,4.091320327961549,80.0,20.0
3537,0,3537,[181 294   9 100 222],887,2,14473,4.090729225551159,0.0,20.0
3538,0,3538,[ 64 313 483 318 187],618,5,14478,4.09098615428087,80.0,20.0
3539,0,3539,[ 64 313 483 318 187],214,5,14483,4.091242937853107,80.0,20.0
3540,0,3540,[ 64 313 483 318 187],214,5,14488,4.09149957639085,80.0,20.0
3541,0,3541,[655 288  22 568  96],416,5,14493,4.09175607001694,0.0,20.0
3542,0,3542,[475 132 174  15 202],588,2,14495,4.091165678803274,0.0,0.0
3543,0,3543,[ 64 313 483 318 187],214,5,14500,4.091422121896162,80.0,20.0
3544,0,3544,[265 202 237 125 588],618,3,14503,4.091114245416079,0.0,0.0
3545,0,3545,[ 70  64 121  95  71],198,1,14504,4.0902425267907505,20.0,0.0
3546,0,3546,[ 64 313 483 318 187],618,5,14509,4.090499013250635,80.0,20.0
3547,0,3547,[ 64 313 483 318 187],618,5,14514,4.090755355129651,80.0,20.0
3548,0,3548,[161  64  89   8   1],705,3,14517,4.090448013524937,20.0,0.0
3549,0,3549,[  7 357 144 515 174],417,2,14519,4.089859154929577,0.0,0.0
3550,0,3550,[  7 655 179  22 742],416,4,14523,4.089833849619826,0.0,0.0
3551,0,3551,[ 64 313 483 318 187],618,5,14528,4.09009009009009,80.0,20.0
3552,0,3552,[111 210  12 271 423],297,2,14530,4.08950182943991,20.0,0.0
3553,0,3553,[ 64 313 483 318 187],214,5,14535,4.089758019133371,80.0,20.0
3554,0,3554,[ 64 313 483 318 187],618,5,14540,4.090014064697609,80.0,20.0
3555,0,3555,[ 64 313 483 318 187],214,5,14545,4.090269966254218,80.0,20.0
3556,0,3556,[135 182  56 186   1],417,4,14549,4.09024458813607,0.0,0.0
3557,0,3557,[ 64 313 483 318 187],618,5,14554,4.090500281056774,80.0,20.0
3558,0,3558,[323 546 313  69 237],223,4,14558,4.090474852486653,20.0,20.0
3559,0,3559,[  8 151 427 204 196],416,4,14562,4.090449438202247,0.0,0.0
3560,0,3560,[ 64 313 483 318 187],214,5,14567,4.0907048581859025,80.0,20.0
3561,0,3561,[ 11 588 302  12 118],297,4,14571,4.0906793935991015,20.0,0.0
3562,0,3562,[222 172 173  12 235],417,2,14573,4.090092618579848,20.0,0.0
3563,0,3563,[118 194 286 588 423],416,4,14577,4.09006734006734,0.0,0.0
3564,0,3564,[ 64 313 483 318 187],618,5,14582,4.090322580645161,80.0,20.0
3565,0,3565,[405 475 333 294 748],416,4,14586,4.09029725182277,0.0,0.0
3566,0,3566,[ 64 313 483 318 187],214,5,14591,4.090552284833193,80.0,20.0
3567,0,3567,[ 64 313 483 318 187],618,5,14596,4.0908071748878925,80.0,20.0
3568,0,3568,[568  97  12  88 172],588,4,14600,4.090781731577473,20.0,0.0
3569,0,3569,[ 69 238 153 204 271],62,3,14603,4.09047619047619,0.0,0.0
3570,0,3570,[ 64 313 483 318 187],214,5,14608,4.090730887706525,80.0,20.0
3571,0,3571,[ 64 313 483 318 187],214,5,14613,4.090985442329227,80.0,20.0
3572,0,3572,[ 64 313 483 318 187],618,5,14618,4.091239854464036,80.0,20.0
3573,0,3573,[168  64 173 195 117],62,5,14623,4.091494124230554,20.0,0.0
3574,0,3574,[288 234 301 588  25],297,3,14626,4.091188811188811,0.0,20.0
3575,0,3575,[655   1 286 118 168],417,5,14631,4.091442953020135,0.0,0.0
3576,0,3576,[ 64 313 483 318 187],618,5,14636,4.091696952753704,80.0,20.0
3577,0,3577,[ 64 313 483 318 187],214,5,14641,4.091950810508664,80.0,20.0
3578,0,3578,[ 64 313 483 318 187],618,5,14646,4.092204526404023,80.0,20.0
3579,0,3579,[200 222 202 588 197],805,3,14649,4.091899441340782,0.0,0.0
3580,0,3580,[ 64 313 483 318 187],214,5,14654,4.092153029879922,80.0,20.0
3581,0,3581,[ 64 313 483 318 187],214,5,14659,4.092406476828588,80.0,20.0
3582,0,3582,[ 64 313 483 318 187],214,5,14664,4.092659782305331,80.0,20.0
3583,0,3583,[ 64 313 483 318 187],618,5,14669,4.092912946428571,80.0,20.0
3584,0,3584,[318 245 195 237   9],62,3,14672,4.092608089260809,20.0,0.0
3585,0,3585,[ 79 168 275 603 245],416,4,14676,4.092582264361406,0.0,0.0
3586,0,3586,[ 64 313 483 318 187],214,5,14681,4.092835238360747,80.0,20.0
3587,0,3587,[228  56 322  25 186],417,2,14683,4.092251950947603,0.0,0.0
3588,0,3588,[483 318  95 202 153],253,4,14687,4.0922262468654225,40.0,0.0
3589,0,3589,[237  79 357 258 118],854,3,14690,4.091922005571031,0.0,0.0
3590,0,3590,[  8 117  71 276 471],416,4,14694,4.091896407685882,0.0,0.0
3591,0,3591,[  1  25 132  97 257],416,4,14698,4.091870824053452,0.0,0.0
3592,0,3592,[ 64 313 483 318 187],618,5,14703,4.092123573615363,80.0,20.0
3593,0,3593,[ 89 151 144 357  25],805,4,14707,4.092097941012799,0.0,0.0
3594,0,3594,[117 275  50  25 237],654,4,14711,4.092072322670376,0.0,20.0
3595,0,3595,[ 64 313 483 318 187],214,5,14716,4.092324805339266,80.0,20.0
3596,0,3596,[ 64 313 483 318 187],618,5,14721,4.092577147623019,80.0,20.0
3597,0,3597,[127   1 357 385 172],416,5,14726,4.092829349638688,0.0,0.0
3598,0,3598,[ 64 313 483 318 187],214,5,14731,4.093081411503196,80.0,20.0
3599,0,3599,[301 357 222 282 286],721,5,14736,4.093333333333334,0.0,0.0
3600,0,3600,[483 276 271 118 153],62,3,14739,4.093029713968342,20.0,0.0
3601,0,3601,[ 64 313 483 318 187],618,5,14744,4.093281510272071,80.0,20.0
3602,0,3602,[ 64 313 483 318 187],214,5,14749,4.0935331668054395,80.0,20.0
3603,0,3603,[ 64 313 483 318 187],618,5,14754,4.093784683684794,80.0,20.0
3604,0,3604,[ 64 313 483 318 187],214,5,14759,4.094036061026352,80.0,20.0
3605,0,3605,[423  98 174 118 185],618,4,14763,4.094009983361065,0.0,20.0
3606,0,3606,[ 64 313 483 318 187],214,5,14768,4.094261158857776,80.0,20.0
3607,0,3607,[603 282  11  64 215],416,5,14773,4.094512195121951,20.0,0.0
3608,0,3608,[333  79 121 222  98],588,3,14776,4.094208922139097,0.0,20.0
3609,0,3609,[289 235 168 300 405],416,3,14779,4.093905817174515,0.0,0.0
3610,0,3610,[211  98 546 172 151],416,3,14782,4.093602880088618,0.0,20.0
3611,0,3611,[204 175 211 257 222],297,3,14785,4.093300110741971,0.0,0.0
3612,0,3612,[ 64 313 483 318 187],618,5,14790,4.093551065596457,80.0,20.0
3613,0,3613,[ 64 313 483 318 187],214,5,14795,4.0938018815716655,80.0,20.0
3614,0,3614,[ 15  89 265 318 496],437,3,14798,4.093499308437067,20.0,0.0
3615,0,3615,[ 25  56 183 173 168],297,5,14803,4.09375,0.0,0.0
3616,0,3616,[546  69  96 269 100],416,4,14807,4.093724080729887,0.0,0.0
3617,0,3617,[186 435 197 237 153],437,3,14810,4.093421779988944,0.0,0.0
3618,0,3618,[ 64 313 483 318 187],618,5,14815,4.093672285161647,80.0,20.0
3619,0,3619,[ 64 313 483 318 187],214,5,14820,4.093922651933702,80.0,20.0
3620,0,3620,[ 64 313 483 318 187],214,5,14825,4.094172880419774,80.0,20.0
3621,0,3621,[ 11 289 300 328  69],43,5,14830,4.094422970734401,0.0,0.0
3622,0,3622,[211 216   7 515 328],416,5,14835,4.094672922991996,0.0,0.0
3623,0,3623,[423  28 257 151 117],642,3,14838,4.094370860927152,0.0,0.0
3624,0,3624,[ 64 313 483 318 187],214,5,14843,4.094620689655172,80.0,20.0
3625,0,3625,[275 215 204 257  50],711,2,14845,4.094043022614451,0.0,20.0
3626,0,3626,[405 258   1 597 215],654,5,14850,4.094292803970223,0.0,0.0
3627,0,3627,[ 64 313 483 318 187],214,5,14855,4.094542447629548,80.0,20.0
3628,0,3628,[ 64 313 483 318 187],214,5,14860,4.094791953706255,80.0,20.0
3629,0,3629,[ 64 313 483 318 187],618,5,14865,4.095041322314049,80.0,20.0
3630,0,3630,[121  12 210 385 275],654,5,14870,4.09529055356651,20.0,0.0
3631,0,3631,[ 56 603   9 194 276],416,4,14874,4.095264317180617,0.0,0.0
3632,0,3632,[ 64 313 483 318 187],214,5,14879,4.09551334984861,80.0,20.0
3633,0,3633,[ 64 313 483 318 187],618,5,14884,4.095762245459548,80.0,20.0
3634,0,3634,[191 300 202 275 235],297,1,14885,4.094910591471802,0.0,0.0
3635,0,3635,[235 143  69 174 515],416,4,14889,4.0948844884488445,0.0,0.0
3636,0,3636,[118   7 200  12 234],417,4,14893,4.094858399780039,20.0,0.0
3637,0,3637,[ 64 313 483 318 187],618,5,14898,4.095107201759208,80.0,20.0
3638,0,3638,[235 118 153 357 603],805,3,14901,4.094806265457543,0.0,0.0
3639,0,3639,[ 64 313 483 318 187],214,5,14906,4.095054945054945,80.0,20.0
3640,0,3640,[117 235 294 385 121],416,4,14910,4.095028838231255,0.0,0.0
3641,0,3641,[323 222 210 405 127],417,1,14911,4.094179022515101,0.0,0.0
3642,0,3642,[ 64 313 483 318 187],214,5,14916,4.0944276695031565,80.0,20.0
3643,0,3643,[ 64 313 483 318 187],214,5,14921,4.0946761800219535,80.0,20.0
3644,0,3644,[197 181 405 200  82],805,2,14923,4.0941015089163235,0.0,20.0
3645,0,3645,[ 64 313 483 318 187],214,5,14928,4.094349972572682,80.0,20.0
3646,0,3646,[ 64 313 483 318 187],618,5,14933,4.0945982999725805,80.0,20.0
3647,0,3647,[200 237 216 174 318],262,1,14934,4.09375,20.0,0.0
3648,0,3648,[ 64 313 483 318 187],214,5,14939,4.093998355713894,80.0,20.0
3649,0,3649,[234 183 385  25 132],198,2,14941,4.093424657534246,0.0,0.0
3650,0,3650,[127 302 568 100 121],417,1,14942,4.092577376061353,0.0,0.0
3651,0,3651,[ 64 313 483 318 187],618,5,14947,4.092825848849945,80.0,20.0
3652,0,3652,[111 172 300 245 228],721,4,14951,4.092800437996168,0.0,0.0
3653,0,3653,[318 597  50  28 475],416,3,14954,4.092501368363437,20.0,20.0
3654,0,3654,[  1 143 211 238 204],297,3,14957,4.092202462380301,0.0,0.0
3655,0,3655,[ 64 313 483 318 187],214,5,14962,4.092450765864332,80.0,20.0
3656,0,3656,[202  79  95  82 181],230,5,14967,4.092698933552092,0.0,20.0
3657,0,3657,[238 318 237  69 216],618,3,14970,4.092400218698742,20.0,0.0
3658,0,3658,[ 79 185 180 127  50],214,4,14974,4.092374965837661,0.0,20.0
3659,0,3659,[ 64 313 483 318 187],618,5,14979,4.092622950819672,80.0,20.0
3660,0,3660,[ 64 313 483 318 187],214,5,14984,4.09287080032778,80.0,20.0
3661,0,3661,[211  88  28  79 237],416,3,14987,4.092572364827963,0.0,0.0
3662,0,3662,[235   1 127 216 176],416,4,14991,4.092547092547092,0.0,0.0
3663,0,3663,[ 64 313 483 318 187],618,5,14996,4.092794759825328,80.0,20.0
3664,0,3664,[ 64 313 483 318 187],214,5,15001,4.093042291950887,80.0,20.0
3665,0,3665,[173 210  56 234 288],437,3,15004,4.092744135297327,0.0,20.0
3666,0,3666,[ 64 313 483 318 187],214,5,15009,4.092991546223071,80.0,20.0
3667,0,3667,[333 597 161 403 187],416,4,15013,4.0929661941112325,0.0,0.0
3668,0,3668,[ 64 313 483 318 187],618,5,15018,4.093213409648405,80.0,20.0
3669,0,3669,[ 82 435 471 423 135],721,4,15022,4.0931880108991825,0.0,0.0
3670,0,3670,[172 187 403 173 176],198,5,15027,4.093435031326614,0.0,0.0
3671,0,3671,[181 302 655 117  28],345,4,15031,4.093409586056645,0.0,20.0
3672,0,3672,[ 64 313 483 318 187],618,5,15036,4.0936564116526,80.0,20.0
3673,0,3673,[216 276 282 181  69],630,1,15037,4.092814371257485,0.0,20.0
3674,0,3674,[ 64 313 483 318 187],618,5,15042,4.093061224489796,80.0,20.0
3675,0,3675,[ 97 496  56 273 144],416,5,15047,4.093307943416757,0.0,0.0
3676,0,3676,[ 64 313 483 318 187],618,5,15052,4.093554528147947,80.0,20.0
3677,0,3677,[273 328 655  70 153],416,5,15057,4.093800978792822,0.0,0.0
3678,0,3678,[ 64 313 483 318 187],618,5,15062,4.094047295460723,80.0,20.0
3679,0,3679,[ 64 313 483 318 187],618,5,15067,4.0942934782608695,80.0,20.0
3680,0,3680,[265   4 234 118 515],297,1,15068,4.093452866069003,0.0,0.0
3681,0,3681,[ 88 181 471  25 197],416,4,15072,4.093427485062466,0.0,20.0
3682,0,3682,[216  70 161 257 237],751,3,15075,4.0931306000543035,0.0,0.0
3683,0,3683,[ 69 111 196  96 568],417,1,15076,4.09229098805646,0.0,0.0
3684,0,3684,[ 64 313 483 318 187],618,5,15081,4.092537313432836,80.0,20.0
3685,0,3685,[ 64 313 483 318 187],618,5,15086,4.092783505154639,80.0,20.0
3686,0,3686,[ 64 313 483 318 187],214,5,15091,4.093029563330621,80.0,20.0
3687,0,3687,[ 64 313 483 318 187],214,5,15096,4.093275488069414,80.0,20.0
3688,0,3688,[204 385 216 234 318],198,2,15098,4.092708050962321,20.0,0.0
3689,0,3689,[111 423 302 328   8],854,2,15100,4.092140921409214,0.0,0.0
3690,0,3690,[ 64 313 483 318 187],214,5,15105,4.092386887022487,80.0,20.0
3691,0,3691,[ 64 313 483 318 187],618,5,15110,4.092632719393283,80.0,20.0
3692,0,3692,[471 423 151 234 179],416,3,15113,4.092336853506634,0.0,0.0
3693,0,3693,[144 235 357 234 245],297,1,15114,4.091499729290741,0.0,0.0
3694,0,3694,[ 64 313 483 318 187],214,5,15119,4.091745602165088,80.0,20.0
3695,0,3695,[ 64 313 483 318 187],214,5,15124,4.091991341991342,80.0,20.0
3696,0,3696,[ 64 313 483 318 187],618,5,15129,4.092236948877468,80.0,20.0
3697,0,3697,[ 64 313 483 318 187],618,5,15134,4.092482422931314,80.0,20.0
3698,0,3698,[173 508 151 603 496],354,1,15135,4.0916463909164635,0.0,0.0
3699,0,3699,[ 64 313 483 318 187],214,5,15140,4.091891891891892,80.0,20.0
3700,0,3700,[ 70 385  15  22 265],654,4,15144,4.0918670629559575,0.0,0.0
3701,0,3701,[ 64 313 483 318 187],214,5,15149,4.092112371690978,80.0,20.0
3702,0,3702,[ 64 313 483 318 187],618,5,15154,4.092357547934108,80.0,20.0
3703,0,3703,[258 215 168 333 125],588,4,15158,4.092332613390929,0.0,0.0
3704,0,3704,[ 64 313 483 318 187],214,5,15163,4.092577597840756,80.0,20.0
3705,0,3705,[ 64 313 483 318 187],214,5,15168,4.09282245008095,80.0,20.0
3706,0,3706,[ 64 313 483 318 187],214,5,15173,4.0930671702185055,80.0,20.0
3707,0,3707,[195 289 273   8 588],416,4,15177,4.093042071197411,0.0,0.0
3708,0,3708,[ 64 313 483 318 187],214,5,15182,4.093286600161768,80.0,20.0
3709,0,3709,[ 64 313 483 318 187],214,5,15187,4.093530997304582,80.0,20.0
3710,0,3710,[100 603 405 322 196],416,4,15191,4.093505793586634,0.0,0.0
3711,0,3711,[603 288 265 286 132],437,2,15193,4.092941810344827,0.0,20.0
3712,0,3712,[302 143 318 515  95],405,3,15196,4.092647454888231,20.0,0.0
3713,0,3713,[194 655 475 427 323],416,3,15199,4.092353257942919,0.0,0.0
3714,0,3714,[ 70 132 294  95 216],417,4,15203,4.092328398384926,0.0,0.0
3715,0,3715,[748 294 678 204 196],297,1,15204,4.0914962325080735,0.0,0.0
3716,0,3716,[222 179 204  82  98],128,3,15207,4.091202582728006,0.0,20.0
3717,0,3717,[ 64 313 483 318 187],214,5,15212,4.091447014523937,80.0,20.0
3718,0,3718,[ 64 313 483 318 187],214,5,15217,4.091691314869589,80.0,20.0
3719,0,3719,[204  15  97 423 144],373,2,15219,4.091129032258064,0.0,0.0
3720,0,3720,[ 64 313 483 318 187],214,5,15224,4.091373286750874,80.0,20.0
3721,0,3721,[742 294 216 357  98],24,4,15228,4.091348737238044,0.0,20.0
3722,0,3722,[ 64 313 483 318 187],214,5,15233,4.091592801504163,80.0,20.0
3723,0,3723,[496 127 175 216 196],43,4,15237,4.09156820622986,0.0,0.0
3724,0,3724,[ 64 313 483 318 187],618,5,15242,4.091812080536913,80.0,20.0
3725,0,3725,[ 64 313 483 318 187],618,5,15247,4.092055823939882,80.0,20.0
3726,0,3726,[294 202 302 111  79],416,5,15252,4.092299436544137,0.0,0.0
3727,0,3727,[568 121 475  12 318],62,4,15256,4.092274678111588,40.0,0.0
3728,0,3728,[ 25 196 191   7 286],354,3,15259,4.0919817645481364,0.0,0.0
3729,0,3729,[111  22  71 546 328],223,4,15263,4.091957104557641,0.0,0.0
3730,0,3730,[111 132 405 294 403],416,5,15268,4.092200482444385,0.0,0.0
3731,0,3731,[153 323 100 245 172],417,2,15270,4.091639871382637,0.0,0.0
3732,0,3732,[ 64 313 483 318 187],618,5,15275,4.0918832038574875,80.0,20.0
3733,0,3733,[ 64 313 483 318 187],214,5,15280,4.092126405998929,80.0,20.0
3734,0,3734,[ 64 313 483 318 187],214,5,15285,4.092369477911647,80.0,20.0
3735,0,3735,[197 427 216 175  71],373,3,15288,4.092077087794433,0.0,0.0
3736,0,3736,[ 64 313 483 318 187],214,5,15293,4.092320042815093,80.0,20.0
3737,0,3737,[  1  50 385 742 748],416,5,15298,4.092562867843767,0.0,20.0
3738,0,3738,[100  15 475 748  82],416,4,15302,4.092538111794598,0.0,0.0
3739,0,3739,[ 64 313 483 318 187],618,5,15307,4.092780748663102,80.0,20.0
3740,0,3740,[ 64 313 483 318 187],214,5,15312,4.093023255813954,80.0,20.0
3741,0,3741,[ 98 496   7 172 405],43,5,15317,4.093265633351149,0.0,20.0
3742,0,3742,[174  79 168 172  70],405,3,15320,4.092973550627839,0.0,0.0
3743,0,3743,[ 64 313 483 318 187],214,5,15325,4.093215811965812,80.0,20.0
3744,0,3744,[ 64 313 483 318 187],618,5,15330,4.093457943925234,80.0,20.0
3745,0,3745,[ 64 313 483 318 187],618,5,15335,4.093699946609717,80.0,20.0
3746,0,3746,[288 257 742 313 276],654,3,15338,4.093408059781158,20.0,40.0
3747,0,3747,[ 64 313 483 318 187],618,5,15343,4.093649946638207,80.0,20.0
3748,0,3748,[ 64 313 483 318 187],618,5,15348,4.0938917044545216,80.0,20.0
3749,0,3749,[ 64 313 483 318 187],618,5,15353,4.094133333333334,80.0,20.0
3750,0,3750,[ 64 313 483 318 187],214,5,15358,4.094374833377766,80.0,20.0
3751,0,3751,[111 117 748   1 742],345,3,15361,4.09408315565032,0.0,0.0
3752,0,3752,[ 64 313 483 318 187],618,5,15366,4.0943245403677055,80.0,20.0
3753,0,3753,[ 50 121 132 180  28],887,5,15371,4.09456579648375,0.0,20.0
3754,0,3754,[ 64 313 483 318 187],618,5,15376,4.094806924101198,80.0,20.0
3755,0,3755,[222 294 275 301 678],588,2,15378,4.094249201277956,0.0,0.0
3756,0,3756,[153 181 300 301 168],416,5,15383,4.0944902848017035,0.0,20.0
3757,0,3757,[ 64 313 483 318 187],214,5,15388,4.094731240021288,80.0,20.0
3758,0,3758,[403 132 168 111 496],588,2,15390,4.094173982442139,0.0,0.0
3759,0,3759,[ 64 313 483 318 187],618,5,15395,4.094414893617022,80.0,20.0
3760,0,3760,[151 121 475 435 588],437,1,15396,4.093592129752725,0.0,0.0
3761,0,3761,[ 28  11 143 276 111],223,4,15400,4.093567251461988,0.0,0.0
3762,0,3762,[ 64 313 483 318 187],214,5,15405,4.093808131809726,80.0,20.0
3763,0,3763,[ 64 313 483 318 187],214,5,15410,4.094048884165781,80.0,20.0
3764,0,3764,[ 64 313 483 318 187],214,5,15415,4.094289508632138,80.0,20.0
3765,0,3765,[323 111  28 655 471],721,3,15418,4.093998937865109,0.0,0.0
3766,0,3766,[118   8 318 168 403],642,3,15421,4.09370852136979,20.0,0.0
3767,0,3767,[ 64 313 483 318 187],618,5,15426,4.093949044585988,80.0,20.0
3768,0,3768,[121 143 202  50 182],128,4,15430,4.093924117803131,0.0,20.0
3769,0,3769,[ 11 196   8   7 588],618,4,15434,4.093899204244032,0.0,0.0
3770,0,3770,[186  96 258 271 318],854,3,15437,4.093609122248741,20.0,0.0
3771,0,3771,[ 64 313 483 318 187],618,5,15442,4.093849416755037,80.0,20.0
3772,0,3772,[ 64 313 483 318 187],618,5,15447,4.094089583885502,80.0,20.0
3773,0,3773,[257  95 435 181  70],297,2,15449,4.09353471118177,0.0,20.0
3774,0,3774,[318 153 655 603 197],437,5,15454,4.093774834437086,20.0,0.0
3775,0,3775,[234 125 403  71 174],416,5,15459,4.094014830508475,0.0,0.0
3776,0,3776,[ 11   4 423 588 475],297,3,15462,4.093725178713265,0.0,0.0
3777,0,3777,[ 56 273  64 496  98],253,3,15465,4.093435680254102,20.0,20.0
3778,0,3778,[ 64 313 483 318 187],618,5,15470,4.093675575549087,80.0,20.0
3779,0,3779,[300 603 357 195  98],875,4,15474,4.093650793650793,0.0,20.0
3780,0,3780,[ 64 313 483 318 187],214,5,15479,4.093890505157366,80.0,20.0
3781,0,3781,[ 64 313 483 318 187],214,5,15484,4.094130089899524,80.0,20.0
3782,0,3782,[ 64 313 483 318 187],214,5,15489,4.094369547977795,80.0,20.0
3783,0,3783,[202 603 748 182  89],297,2,15491,4.093816067653277,0.0,0.0
3784,0,3784,[ 98 423 196  70 405],198,1,15492,4.092998678996037,0.0,20.0
3785,0,3785,[ 64 313 483 318 187],214,5,15497,4.093238246170101,80.0,20.0
3786,0,3786,[ 64 313 483 318 187],214,5,15502,4.093477686823343,80.0,20.0
3787,0,3787,[ 64 313 483 318 187],214,5,15507,4.093717001055966,80.0,20.0
3788,0,3788,[294 742 275  15 588],416,5,15512,4.093956188968066,0.0,0.0
3789,0,3789,[568 179  98  50 172],417,2,15514,4.093403693931398,0.0,40.0
3790,0,3790,[ 56  50 191 121 100],805,4,15518,4.093379055658137,0.0,20.0
3791,0,3791,[161 172 471   9  88],345,3,15521,4.093090717299578,0.0,0.0
3792,0,3792,[ 12 603 216 215 196],437,4,15525,4.093066174532033,20.0,0.0
3793,0,3793,[ 64 313 483 318 187],214,5,15530,4.093305218766473,80.0,20.0
3794,0,3794,[ 95  97 496 153 286],373,3,15533,4.093017127799737,0.0,0.0
3795,0,3795,[ 64 313 483 318 187],214,5,15538,4.093256059009484,80.0,20.0
3796,0,3796,[258 182 546   9 215],62,4,15542,4.093231498551488,0.0,0.0
3797,0,3797,[282 294 172 275 257],921,2,15544,4.092680358083202,0.0,0.0
3798,0,3798,[ 64 313 483 318 187],618,5,15549,4.092919189260332,80.0,20.0
3799,0,3799,[ 64 423 655 173 175],373,3,15552,4.092631578947368,20.0,0.0
3800,0,3800,[ 79 144  95 151 328],373,4,15556,4.092607208629308,0.0,0.0
3801,0,3801,[ 64 313 483 318 187],618,5,15561,4.092845870594424,80.0,20.0
3802,0,3802,[ 64 313 483 318 187],618,5,15566,4.093084407047068,80.0,20.0
3803,0,3803,[ 50 742 183  69 200],416,5,15571,4.093322818086225,0.0,20.0
3804,0,3804,[183 151 111 174 153],297,3,15574,4.093035479632063,0.0,0.0
3805,0,3805,[289 318 322   1 153],416,3,15577,4.092748292170257,20.0,0.0
3806,0,3806,[  1 181 471 276 185],618,3,15580,4.092461255581823,0.0,20.0
3807,0,3807,[228  70 174 238 597],62,2,15582,4.091911764705882,0.0,0.0
3808,0,3808,[174 200  56 168 210],417,3,15585,4.091625098451037,0.0,0.0
3809,0,3809,[143   4  70 127  97],43,5,15590,4.091863517060368,0.0,0.0
3810,0,3810,[ 64 313 483 318 187],214,5,15595,4.092101810548413,80.0,20.0
3811,0,3811,[318  15 257 127 182],416,4,15599,4.092077649527807,20.0,0.0
3812,0,3812,[135 168 183 121   8],601,3,15602,4.09179124049305,0.0,0.0
3813,0,3813,[202 144  15  98 271],907,5,15607,4.092029365495542,0.0,20.0
3814,0,3814,[ 64 313 483 318 187],214,5,15612,4.092267365661861,80.0,20.0
3815,0,3815,[161 322  11 357 742],417,2,15614,4.0917190775681345,0.0,0.0
3816,0,3816,[168 204  71 172 257],601,2,15616,4.091171076761855,0.0,0.0
3817,0,3817,[182  79 268 475 202],417,4,15620,4.091147197485594,0.0,0.0
3818,0,3818,[ 64 127 144 197  69],373,2,15622,4.090599633411888,20.0,0.0
3819,0,3819,[ 64 313 483 318 187],618,5,15627,4.090837696335078,80.0,20.0
3820,0,3820,[ 70 403 237 174 191],642,4,15631,4.090813923056792,0.0,0.0
3821,0,3821,[323 200 301 269 238],416,4,15635,4.090790162218734,0.0,0.0
3822,0,3822,[191  15 234 196 597],618,4,15639,4.090766413811143,0.0,0.0
3823,0,3823,[ 64 313 483 318 187],214,5,15644,4.091004184100418,80.0,20.0
3824,0,3824,[125 132 144  96  79],373,3,15647,4.090718954248366,0.0,0.0
3825,0,3825,[ 64 313 483 318 187],618,5,15652,4.090956612650287,80.0,20.0
3826,0,3826,[ 64 313 483 318 187],618,5,15657,4.091194146851319,80.0,20.0
3827,0,3827,[ 12  50 323 204 100],345,4,15661,4.091170323928945,20.0,20.0
3828,0,3828,[127 191   4   7 257],416,4,15665,4.091146513449987,0.0,0.0
3829,0,3829,[546 118 496  15 403],43,5,15670,4.091383812010444,0.0,0.0
3830,0,3830,[118 151 313 182 204],416,3,15673,4.091098929783346,20.0,20.0
3831,0,3831,[ 64 313 483 318 187],618,5,15678,4.09133611691023,80.0,20.0
3832,0,3832,[ 95 186 588 257 210],417,2,15680,4.0907905035220455,0.0,0.0
3833,0,3833,[ 64 313 483 318 187],214,5,15685,4.091027647365675,80.0,20.0
3834,0,3834,[546 357   1 180 228],62,3,15688,4.0907431551499345,0.0,0.0
3835,0,3835,[276 132 235 127 302],416,3,15691,4.090458811261731,0.0,0.0
3836,0,3836,[ 64 313 483 318 187],214,5,15696,4.090695856137607,80.0,20.0
3837,0,3837,[ 64 313 483 318 187],618,5,15701,4.090932777488275,80.0,20.0
3838,0,3838,[ 82 546 403 273 318],416,4,15705,4.090909090909091,20.0,0.0
3839,0,3839,[ 64 313 483 318 187],214,5,15710,4.091145833333333,80.0,20.0
3840,0,3840,[228  79 195  71 144],230,2,15712,4.090601405883884,0.0,0.0
3841,0,3841,[215  12 117   8 496],618,4,15716,4.090577824049974,20.0,0.0
3842,0,3842,[ 64 313 483 318 187],214,5,15721,4.090814467863648,80.0,20.0
3843,0,3843,[202 143 168 257 174],922,4,15725,4.090790842872008,0.0,0.0
3844,0,3844,[ 64 313 483 318 187],618,5,15730,4.091027308192458,80.0,20.0
3845,0,3845,[210 333  15 181  95],588,5,15735,4.091263650546022,0.0,20.0
3846,0,3846,[ 64 313 483 318 187],214,5,15740,4.091499870028594,80.0,20.0
3847,0,3847,[ 64 313 483 318 187],214,5,15745,4.091735966735967,80.0,20.0
3848,0,3848,[ 64 313 483 318 187],618,5,15750,4.091971940763835,80.0,20.0
3849,0,3849,[ 64 313 483 318 187],618,5,15755,4.092207792207792,80.0,20.0
3850,0,3850,[ 64 313 483 318 187],618,5,15760,4.092443521163334,80.0,20.0
3851,0,3851,[ 64 313 483 318 187],214,5,15765,4.092679127725857,80.0,20.0
3852,0,3852,[ 64 313 483 318 187],618,5,15770,4.092914611990657,80.0,20.0
3853,0,3853,[125 271 182  50 183],505,1,15771,4.0921120913336795,0.0,20.0
3854,0,3854,[289 182  15 173   4],416,4,15775,4.092088197146563,0.0,0.0
3855,0,3855,[172  71  88 168 197],373,4,15779,4.092064315352697,0.0,0.0
3856,0,3856,[ 64 313 483 318 187],214,5,15784,4.092299714804252,80.0,20.0
3857,0,3857,[597  98 191 568 118],43,4,15788,4.0922757905650595,0.0,20.0
3858,0,3858,[ 64 313 483 318 187],214,5,15793,4.092511013215859,80.0,20.0
3859,0,3859,[ 64 313 483 318 187],618,5,15798,4.092746113989637,80.0,20.0
3860,0,3860,[ 64 313 483 318 187],618,5,15803,4.092981092981093,80.0,20.0
3861,0,3861,[ 22 132  98 273  15],416,5,15808,4.093215950284827,0.0,20.0
3862,0,3862,[ 64 313 483 318 187],214,5,15813,4.09345068599534,80.0,20.0
3863,0,3863,[125 678 173 301 237],588,2,15815,4.092908902691511,0.0,0.0
3864,0,3864,[405 185 546 151  97],416,3,15818,4.092626131953428,0.0,0.0
3865,0,3865,[288   9 385 100 151],416,4,15822,4.092602172788411,0.0,20.0
3866,0,3866,[ 64 313 483 318 187],618,5,15827,4.092836824411688,80.0,20.0
3867,0,3867,[118 191  95 117 222],43,5,15832,4.093071354705274,0.0,0.0
3868,0,3868,[ 64 313 483 318 187],618,5,15837,4.093305763763246,80.0,20.0
3869,0,3869,[ 64 313 483 318 187],618,5,15842,4.093540051679587,80.0,20.0
3870,0,3870,[496 403  95  50  71],618,4,15846,4.093515887367605,0.0,20.0
3871,0,3871,[ 64 313 483 318 187],214,5,15851,4.09375,80.0,20.0
3872,0,3872,[289 200 181 655  69],345,4,15855,4.093725793958172,0.0,20.0
3873,0,3873,[172  95 183 186 210],618,3,15858,4.093443469282396,0.0,0.0
3874,0,3874,[273  50  96 742 174],805,2,15860,4.0929032258064515,0.0,20.0
3875,0,3875,[ 64 313 483 318 187],214,5,15865,4.0931372549019605,80.0,20.0
3876,0,3876,[183 100 286 222  69],62,4,15869,4.09311323188032,0.0,0.0
3877,0,3877,[200 238 258 197 144],854,4,15873,4.093089221248066,0.0,0.0
3878,0,3878,[269 202 127 132 265],416,5,15878,4.093323021397268,0.0,0.0
3879,0,3879,[ 64 313 483 318 187],214,5,15883,4.093556701030928,80.0,20.0
3880,0,3880,[235 423 655 273  64],62,3,15886,4.093274929141974,20.0,0.0
3881,0,3881,[ 97 322 153 302 172],416,4,15890,4.093250901597115,0.0,0.0
3882,0,3882,[ 88 186 135 403  71],373,3,15893,4.092969353592583,0.0,0.0
3883,0,3883,[237 678 204 185 210],297,3,15896,4.092687950566426,0.0,0.0
3884,0,3884,[ 64 313 483 318 187],214,5,15901,4.0929214929214925,80.0,20.0
3885,0,3885,[117 742 174 200 597],764,4,15905,4.092897581060216,0.0,0.0
3886,0,3886,[153  12 318   9 187],416,5,15910,4.09313094931824,40.0,0.0
3887,0,3887,[ 64 313 483 318 187],214,5,15915,4.093364197530864,80.0,20.0
3888,0,3888,[ 64 313 483 318 187],618,5,15920,4.093597325790692,80.0,20.0
3889,0,3889,[ 64 313 483 318 187],214,5,15925,4.093830334190232,80.0,20.0
3890,0,3890,[678 211  97 289   4],416,3,15928,4.0935492161398095,0.0,0.0
3891,0,3891,[ 64 313 483 318 187],618,5,15933,4.093782117163412,80.0,20.0
3892,0,3892,[ 64 313 483 318 187],214,5,15938,4.094014898535834,80.0,20.0
3893,0,3893,[161 271 238 235 204],805,1,15939,4.093220338983051,0.0,0.0
3894,0,3894,[276 603 273  22 168],416,4,15943,4.093196405648267,0.0,0.0
3895,0,3895,[ 64 313 483 318 187],618,5,15948,4.093429158110883,80.0,20.0
3896,0,3896,[ 64 313 483 318 187],618,5,15953,4.0936617911213755,80.0,20.0
3897,0,3897,[187 294 168 121 588],698,2,15955,4.093124679322729,0.0,0.0
3898,0,3898,[ 64 313 483 318 187],618,5,15960,4.093357271095153,80.0,20.0
3899,0,3899,[197  98 151  88 265],618,3,15963,4.093076923076923,0.0,20.0
3900,0,3900,[215 300 151 100  64],345,4,15967,4.0930530633170985,20.0,0.0
3901,0,3901,[ 64 313 483 318 187],214,5,15972,4.0932854946181445,80.0,20.0
3902,0,3902,[204  79 172 238 496],373,5,15977,4.09351780681527,0.0,0.0
3903,0,3903,[ 64 313 483 318 187],214,5,15982,4.09375,80.0,20.0
3904,0,3904,[111 121 597 515 268],416,4,15986,4.093725992317542,0.0,0.0
3905,0,3905,[471 210 168  25 313],416,5,15991,4.093958013312852,20.0,20.0
3906,0,3906,[568 288 200  12 235],417,2,15993,4.093422062963911,20.0,20.0
3907,0,3907,[197 132 172 288 568],405,5,15998,4.093654042988741,0.0,20.0
3908,0,3908,[100 175 405  96 357],198,2,16000,4.093118444614991,0.0,0.0
3909,0,3909,[ 64 313 483 318 187],618,5,16005,4.093350383631714,80.0,20.0
3910,0,3910,[197 238 117  28 153],297,4,16009,4.093326514957811,0.0,0.0
3911,0,3911,[ 64 313 483 318 187],214,5,16014,4.093558282208589,80.0,20.0
3912,0,3912,[132 176 265  12 143],416,5,16019,4.093789930999233,20.0,0.0
3913,0,3913,[ 79 111  28 235 176],805,2,16021,4.093254982115483,0.0,0.0
3914,0,3914,[ 64 313 483 318 187],214,5,16026,4.093486590038315,80.0,20.0
3915,0,3915,[176 121 179  71   7],198,3,16029,4.09320735444331,0.0,0.0
3916,0,3916,[ 64 313 483 318 187],618,5,16034,4.093438856267552,80.0,20.0
3917,0,3917,[603 357 435 423 143],297,3,16037,4.09315977539561,0.0,0.0
3918,0,3918,[ 64 313 483 318 187],618,5,16042,4.093391171217148,80.0,20.0
3919,0,3919,[ 56   4  50 282 269],297,3,16045,4.093112244897959,0.0,20.0
3920,0,3920,[235 174  95  15 153],416,3,16048,4.092833460851823,0.0,0.0
3921,0,3921,[ 64 313 483 318 187],618,5,16053,4.093064762876083,80.0,20.0
3922,0,3922,[ 25 405  97 742 151],43,5,16058,4.093295946979352,0.0,0.0
3923,0,3923,[143 403 357 588 288],405,4,16062,4.0932721712538225,0.0,20.0
3924,0,3924,[111 238 173  12 151],417,4,16066,4.093248407643312,20.0,0.0
3925,0,3925,[273  95 275 289 182],416,3,16069,4.092969943963322,0.0,0.0
3926,0,3926,[ 69 289 742 172 748],416,4,16073,4.092946269416857,0.0,0.0
3927,0,3927,[ 64 313 483 318 187],214,5,16078,4.093177189409369,80.0,20.0
3928,0,3928,[288 179 153 168  22],416,4,16082,4.093153474166455,0.0,20.0
3929,0,3929,[313 471 210   4 286],416,5,16087,4.093384223918575,20.0,20.0
3930,0,3930,[ 64 313 483 318 187],214,5,16092,4.093614856270669,80.0,20.0
3931,0,3931,[ 64 313 483 318 187],214,5,16097,4.093845371312309,80.0,20.0
3932,0,3932,[153 185 100   9 228],601,5,16102,4.094075769132977,0.0,0.0
3933,0,3933,[ 64 313 483 318 187],214,5,16107,4.094306049822064,80.0,20.0
3934,0,3934,[181 568 202 748  28],373,3,16110,4.094027954256671,0.0,20.0
3935,0,3935,[ 64 313 483 318 187],214,5,16115,4.094258130081301,80.0,20.0
3936,0,3936,[ 64 313 483 318 187],618,5,16120,4.094488188976378,80.0,20.0
3937,0,3937,[ 88 144 286 238 269],373,3,16123,4.094210259014728,0.0,0.0
3938,0,3938,[427 515 180 175 313],405,2,16125,4.093678598629094,20.0,20.0
3939,0,3939,[288  11   4 185 603],297,3,16128,4.093401015228427,0.0,20.0
3940,0,3940,[ 64 313 483 318 187],618,5,16133,4.093631058107079,80.0,20.0
3941,0,3941,[588 143   9  25  64],314,4,16137,4.093607305936073,20.0,0.0
3942,0,3942,[ 64 313 483 318 187],214,5,16142,4.093837179812326,80.0,20.0
3943,0,3943,[ 64 197 269  98  50],345,5,16147,4.094066937119676,20.0,40.0
3944,0,3944,[301  95 289 144  64],43,5,16152,4.094296577946768,20.0,0.0
3945,0,3945,[ 64 313 483 318 187],214,5,16157,4.094526102382159,80.0,20.0
3946,0,3946,[742  50 118 238 471],854,2,16159,4.0939954395743605,0.0,20.0
3947,0,3947,[ 64 313 483 318 187],214,5,16164,4.094224924012158,80.0,20.0
3948,0,3948,[215 204 182 179  70],62,2,16166,4.093694606229425,0.0,0.0
3949,0,3949,[161 588 173   1 237],618,4,16170,4.093670886075949,0.0,0.0
3950,0,3950,[183   1 318 357 289],416,4,16174,4.093647177929638,20.0,0.0
3951,0,3951,[237  70  64 215 276],62,2,16176,4.093117408906883,20.0,0.0
3952,0,3952,[ 95 228 118 143  89],297,2,16178,4.092587907918037,0.0,0.0
3953,0,3953,[301 144 143 204 180],711,3,16181,4.092311583206879,0.0,0.0
3954,0,3954,[ 64 313 483 318 187],618,5,16186,4.092541087231353,80.0,20.0
3955,0,3955,[268 183  97 294  11],417,5,16191,4.0927704752275025,0.0,0.0
3956,0,3956,[238 195  79  22 135],618,3,16194,4.092494313874147,0.0,0.0
3957,0,3957,[275 180  28 172 603],373,3,16197,4.0922182920667005,0.0,0.0
3958,0,3958,[328  69 185  96 151],854,3,16200,4.091942409699419,0.0,0.0
3959,0,3959,[ 64 313 483 318 187],618,5,16205,4.092171717171717,80.0,20.0
3960,0,3960,[183   9 196 655  71],805,1,16206,4.091391062862914,0.0,0.0
3961,0,3961,[ 64 313 483 318 187],214,5,16211,4.091620393740535,80.0,20.0
3962,0,3962,[196 597 423 238 173],62,3,16214,4.091344940701489,0.0,0.0
3963,0,3963,[282  25  56 427 294],128,2,16216,4.090817356205853,0.0,0.0
3964,0,3964,[ 64 313 483 318 187],618,5,16221,4.091046658259773,80.0,20.0
3965,0,3965,[ 64 313 483 318 187],618,5,16226,4.091275844679778,80.0,20.0
3966,0,3966,[153  50 173 174 742],805,3,16229,4.091000756238971,0.0,20.0
3967,0,3967,[276 318 173 568  50],654,4,16233,4.090977822580645,20.0,20.0
3968,0,3968,[ 64 313 483 318 187],214,5,16238,4.091206853111615,80.0,20.0
3969,0,3969,[153  70 385 742 237],642,3,16241,4.090931989924433,0.0,0.0
3970,0,3970,[ 64 313 483 318 187],618,5,16246,4.0911609166456815,80.0,20.0
3971,0,3971,[ 64 313 483 318 187],618,5,16251,4.091389728096677,80.0,20.0
3972,0,3972,[ 70 237 268   1  82],128,3,16254,4.091115026428391,0.0,0.0
3973,0,3973,[318  69 603  12 216],854,4,16258,4.091092098641168,40.0,0.0
3974,0,3974,[ 64 313 483 318 187],618,5,16263,4.091320754716981,80.0,20.0
3975,0,3975,[238 403 328  82 181],49,1,16264,4.090543259557344,0.0,20.0
3976,0,3976,[ 64 313 483 318 187],618,5,16269,4.090771938647221,80.0,20.0
3977,0,3977,[ 64 313 483 318 187],214,5,16274,4.091000502765208,80.0,20.0
3978,0,3978,[ 11 196 181 235 222],805,1,16275,4.090223674290023,0.0,20.0
3979,0,3979,[405 151 179 117  71],128,3,16278,4.089949748743718,0.0,0.0
3980,0,3980,[ 64 313 483 318 187],618,5,16283,4.0901783471489574,80.0,20.0
3981,0,3981,[245 357  50  12 318],62,4,16287,4.0901557006529385,40.0,20.0
3982,0,3982,[ 64 313 483 318 187],214,5,16292,4.090384132563394,80.0,20.0
3983,0,3983,[ 64 313 483 318 187],214,5,16297,4.090612449799197,80.0,20.0
3984,0,3984,[135 196 215 655 127],405,4,16301,4.090589711417817,0.0,0.0
3985,0,3985,[210  69 238  70 182],62,4,16305,4.09056698444556,0.0,0.0
3986,0,3986,[322 132 405  11 195],416,4,16309,4.09054426887384,0.0,0.0
3987,0,3987,[238 182 385 144 181],230,1,16310,4.089769307923771,0.0,20.0
3988,0,3988,[ 64 313 483 318 187],618,5,16315,4.089997493106042,80.0,20.0
3989,0,3989,[ 15 111 195 357  11],630,3,16318,4.089724310776942,0.0,0.0
3990,0,3990,[ 64 313 483 318 187],618,5,16323,4.089952392883989,80.0,20.0
3991,0,3991,[ 64 313 483 318 187],214,5,16328,4.090180360721443,80.0,20.0
3992,0,3992,[ 64 313 483 318 187],618,5,16333,4.090408214375157,80.0,20.0
3993,0,3993,[ 64 313 483 318 187],618,5,16338,4.090635953930897,80.0,20.0
3994,0,3994,[210   8 117 423 238],654,5,16343,4.090863579474343,0.0,0.0
3995,0,3995,[ 50  28 183 216  95],618,3,16346,4.09059059059059,0.0,20.0
3996,0,3996,[328 237 268  88 282],314,5,16351,4.090818113585189,0.0,0.0
3997,0,3997,[144 301 597 237 289],588,2,16353,4.090295147573787,0.0,0.0
3998,0,3998,[ 64 313 483 318 187],214,5,16358,4.090522630657665,80.0,20.0
3999,0,3999,[ 64 313 483 318 187],618,5,16363,4.09075,80.0,20.0
4000,0,4000,[  9 357  97 176 183],416,5,16368,4.090977255686078,0.0,0.0
4001,0,4001,[ 64 313 483 318 187],618,5,16373,4.091204397801099,80.0,20.0
4002,0,4002,[ 64 313 483 318 187],618,5,16378,4.091431426430177,80.0,20.0
4003,0,4003,[ 64 313 483 318 187],618,5,16383,4.091658341658341,80.0,20.0
4004,0,4004,[  8 197 210   9 180],354,2,16385,4.091136079900124,0.0,0.0
4005,0,4005,[228 515 286 235 475],297,3,16388,4.090863704443335,0.0,0.0
4006,0,4006,[ 64 313 483 318 187],618,5,16393,4.091090591464936,80.0,20.0
4007,0,4007,[176 127 172 568 588],416,5,16398,4.091317365269461,0.0,0.0
4008,0,4008,[ 64 313 483 318 187],618,5,16403,4.091544025941631,80.0,20.0
4009,0,4009,[ 64 313 483 318 187],214,5,16408,4.091770573566085,80.0,20.0
4010,0,4010,[ 96 175 168 202 127],253,3,16411,4.091498379456494,0.0,0.0
4011,0,4011,[ 64 313 483 318 187],214,5,16416,4.091724825523429,80.0,20.0
4012,0,4012,[ 64 313 483 318 187],214,5,16421,4.091951158734114,80.0,20.0
4013,0,4013,[258  82 603 143 275],416,5,16426,4.092177379172895,0.0,0.0
4014,0,4014,[ 64 313 483 318 187],618,5,16431,4.092403486924034,80.0,20.0
4015,0,4015,[ 64 313 483 318 187],618,5,16436,4.092629482071713,80.0,20.0
4016,0,4016,[127 210 172 182 568],62,4,16440,4.09260642270351,0.0,0.0
4017,0,4017,[196 143 603 289   1],416,4,16444,4.09258337481334,0.0,0.0
4018,0,4018,[ 64 313 483 318 187],214,5,16449,4.092809156506593,80.0,20.0
4019,0,4019,[ 64 313 483 318 187],618,5,16454,4.093034825870647,80.0,20.0
4020,0,4020,[423 100 265 234  22],297,2,16456,4.092514299925392,0.0,0.0
4021,0,4021,[ 64  11 234 153 144],417,4,16460,4.09249129786176,20.0,0.0
4022,0,4022,[742 282 568 508 117],314,4,16464,4.092468307233408,0.0,0.0
4023,0,4023,[191 228   8 435 181],721,4,16468,4.092445328031809,0.0,20.0
4024,0,4024,[121 597   1  50 742],642,5,16473,4.092670807453416,0.0,20.0
4025,0,4025,[  4 168 258 161 100],417,2,16475,4.092151018380527,0.0,0.0
4026,0,4026,[ 64 313 483 318 187],618,5,16480,4.092376458902408,80.0,20.0
4027,0,4027,[ 89  25 125  15  98],854,2,16482,4.091857000993048,0.0,20.0
4028,0,4028,[ 64 313 483 318 187],618,5,16487,4.092082402581286,80.0,20.0
4029,0,4029,[ 56 181  98   4 161],198,3,16490,4.091811414392059,0.0,40.0
4030,0,4030,[173 117 121 200 318],345,4,16494,4.091788638055073,20.0,0.0
4031,0,4031,[ 64 313 483 318 187],618,5,16499,4.092013888888889,80.0,20.0
4032,0,4032,[ 64 313 483 318 187],618,5,16504,4.092239028018844,80.0,20.0
4033,0,4033,[ 64 313 483 318 187],618,5,16509,4.092464055528012,80.0,20.0
4034,0,4034,[ 64 313 483 318 187],214,5,16514,4.09268897149938,80.0,20.0
4035,0,4035,[ 64 313 483 318 187],618,5,16519,4.092913776015857,80.0,20.0
4036,0,4036,[ 64 313 483 318 187],214,5,16524,4.093138469160268,80.0,20.0
4037,0,4037,[748 153 322 202 185],805,2,16526,4.092620108964834,0.0,0.0
4038,0,4038,[ 64 313 483 318 187],214,5,16531,4.092844763555336,80.0,20.0
4039,0,4039,[238  79  70  50  98],437,4,16535,4.092821782178218,0.0,40.0
4040,0,4040,[ 88 275  64 127 323],416,3,16538,4.0925513486760705,20.0,0.0
4041,0,4041,[ 64 313 483 318 187],618,5,16543,4.0927758535378524,80.0,20.0
4042,0,4042,[282 237 216 180 471],854,1,16544,4.092010883007667,0.0,0.0
4043,0,4043,[ 64 313 483 318 187],618,5,16549,4.092235410484669,80.0,20.0
4044,0,4044,[ 64 313 483 318 187],214,5,16554,4.092459826946848,80.0,20.0
4045,0,4045,[ 64 313 483 318 187],214,5,16559,4.09268413247652,80.0,20.0
4046,0,4046,[ 64 313 483 318 187],214,5,16564,4.092908327155918,80.0,20.0
4047,0,4047,[127 135 515 268 200],417,4,16568,4.092885375494071,0.0,0.0
4048,0,4048,[ 95 168 195 202 100],417,4,16572,4.092862435169177,0.0,0.0
4049,0,4049,[132 228 294 257 423],887,4,16576,4.092839506172839,0.0,0.0
4050,0,4050,[ 64 313 483 318 187],214,5,16581,4.093063441125648,80.0,20.0
4051,0,4051,[ 64 313 483 318 187],214,5,16586,4.093287265547878,80.0,20.0
4052,0,4052,[ 64 313 483 318 187],618,5,16591,4.0935109795213425,80.0,20.0
4053,0,4053,[597  25  70 210   4],416,4,16595,4.093487913172176,0.0,0.0
4054,0,4054,[ 64 313 483 318 187],214,5,16600,4.093711467324291,80.0,20.0
4055,0,4055,[ 64 313 483 318 187],618,5,16605,4.093934911242603,80.0,20.0
4056,0,4056,[ 50 215   8   1 204],721,5,16610,4.094158245008627,0.0,20.0
4057,0,4057,[268 568 385 237 238],416,4,16614,4.0941350418925575,0.0,0.0
4058,0,4058,[175 216 210 179 318],198,4,16618,4.094111850209411,20.0,0.0
4059,0,4059,[211 179 302  97 143],416,4,16622,4.094088669950739,0.0,0.0
4060,0,4060,[132  28 588  69  64],345,3,16625,4.093819256340803,20.0,0.0
4061,0,4061,[427 196 228 238 100],230,3,16628,4.093549975381586,0.0,0.0
4062,0,4062,[ 64 313 483 318 187],618,5,16633,4.09377307408319,80.0,20.0
4063,0,4063,[237 161 403 151  79],198,2,16635,4.093257874015748,0.0,0.0
4064,0,4064,[ 64 313 483 318 187],618,5,16640,4.093480934809348,80.0,20.0
4065,0,4065,[ 64 313 483 318 187],214,5,16645,4.093703885882932,80.0,20.0
4066,0,4066,[ 97 302 210 151  15],416,4,16649,4.093680845832309,0.0,0.0
4067,0,4067,[ 64 313 483 318 187],618,5,16654,4.093903638151426,80.0,20.0
4068,0,4068,[194 228 151 275  28],297,2,16656,4.09338903907594,0.0,0.0
4069,0,4069,[294 288  12 427 475],601,2,16658,4.092874692874693,20.0,20.0
4070,0,4070,[175 173  15  79 385],43,4,16662,4.092851879145173,0.0,0.0
4071,0,4071,[ 64 313 483 318 187],618,5,16667,4.093074656188605,80.0,20.0
4072,0,4072,[118 182 216  11 237],297,3,16670,4.0928062852933955,0.0,0.0
4073,0,4073,[ 64 313 483 318 187],618,5,16675,4.0930289641629845,80.0,20.0
4074,0,4074,[ 64 313 483 318 187],214,5,16680,4.093251533742332,80.0,20.0
4075,0,4075,[ 15 118 202 318 151],43,5,16685,4.093473994111874,20.0,0.0
4076,0,4076,[655 475  95 144 288],342,5,16690,4.093696345351974,0.0,20.0
4077,0,4077,[ 64 313 483 318 187],618,5,16695,4.093918587542913,80.0,20.0
4078,0,4078,[ 64 313 483 318 187],618,5,16700,4.094140720764893,80.0,20.0
4079,0,4079,[ 64 313 483 318 187],214,5,16705,4.0943627450980395,80.0,20.0
4080,0,4080,[ 96 322 191 118 265],417,2,16707,4.093849546679736,0.0,0.0
4081,0,4081,[222 161  64 210 238],128,4,16711,4.093826555609995,20.0,0.0
4082,0,4082,[ 64 313 483 318 187],618,5,16716,4.094048493754592,80.0,20.0
4083,0,4083,[ 64 313 483 318 187],618,5,16721,4.094270323212537,80.0,20.0
4084,0,4084,[  8 603  12 200 496],437,5,16726,4.094492044063648,20.0,0.0
4085,0,4085,[  4 191  64  69 423],618,4,16730,4.094468918257465,20.0,0.0
4086,0,4086,[302 235  15  69 197],854,2,16732,4.093956447271838,0.0,0.0
4087,0,4087,[132 216 318  56  64],24,4,16736,4.0939334637964775,40.0,0.0
4088,0,4088,[ 64 313 483 318 187],618,5,16741,4.094155050134507,80.0,20.0
4089,0,4089,[ 64 313 483 318 187],618,5,16746,4.094376528117359,80.0,20.0
4090,0,4090,[ 64 313 483 318 187],618,5,16751,4.094597897824492,80.0,20.0
4091,0,4091,[ 64 313 483 318 187],618,5,16756,4.094819159335288,80.0,20.0
4092,0,4092,[ 64 313 483 318 187],214,5,16761,4.09504031272905,80.0,20.0
4093,0,4093,[118  11 117 216 328],223,2,16763,4.0945285784074255,0.0,0.0
4094,0,4094,[ 64 313 483 318 187],618,5,16768,4.094749694749694,80.0,20.0
4095,0,4095,[175 258  50 748 187],198,3,16771,4.094482421875,0.0,20.0
4096,0,4096,[ 50 435 222  22  56],721,4,16775,4.094459360507688,0.0,20.0
4097,0,4097,[568 121 211   4 655],417,2,16777,4.093948267447535,0.0,0.0
4098,0,4098,[322 181   4   9 216],805,0,16777,4.092949499878019,0.0,20.0
4099,0,4099,[183 117 235 257 475],62,4,16781,4.0929268292682925,0.0,0.0
4100,0,4100,[ 64 313 483 318 187],618,5,16786,4.093148012679834,80.0,20.0
4101,0,4101,[117  96 300 187 294],416,5,16791,4.093369088249634,0.0,0.0
4102,0,4102,[288  97 423   4 210],297,2,16793,4.092858883743602,0.0,20.0
4103,0,4103,[185  28 202  12 588],416,5,16798,4.09307992202729,20.0,0.0
4104,0,4104,[161 300 423 127 174],416,5,16803,4.093300852618758,0.0,0.0
4105,0,4105,[ 64 313 483 318 187],618,5,16808,4.093521675596688,80.0,20.0
4106,0,4106,[ 64 313 483 318 187],618,5,16813,4.093742391039688,80.0,20.0
4107,0,4107,[ 64 313 483 318 187],618,5,16818,4.0939629990262905,80.0,20.0
4108,0,4108,[ 98 265 176 200 300],297,2,16820,4.093453394986614,0.0,20.0
4109,0,4109,[235 294 176 121  82],416,4,16824,4.093430656934307,0.0,0.0
4110,0,4110,[  1 483 172 385 118],417,4,16828,4.0934079299440524,20.0,0.0
4111,0,4111,[ 64 191 153 258 235],417,4,16832,4.093385214007782,20.0,0.0
4112,0,4112,[300 191 200 196 153],198,3,16835,4.093119377583273,0.0,0.0
4113,0,4113,[ 64 313 483 318 187],214,5,16840,4.093339815264949,80.0,20.0
4114,0,4114,[ 64 313 483 318 187],214,5,16845,4.093560145808019,80.0,20.0
4115,0,4115,[508 153 215   4 144],297,2,16847,4.0930515063168125,0.0,0.0
4116,0,4116,[ 64 313 483 318 187],618,5,16852,4.0932717998542625,80.0,20.0
4117,0,4117,[ 64 313 483 318 187],214,5,16857,4.093491986401165,80.0,20.0
4118,0,4118,[ 64 313 483 318 187],214,5,16862,4.093712066035446,80.0,20.0
4119,0,4119,[172 216 275 300  98],416,5,16867,4.093932038834952,0.0,20.0
4120,0,4120,[ 98 151 234 174   1],805,4,16871,4.0939092453288035,0.0,20.0
4121,0,4121,[  4  15  28 100 427],373,3,16874,4.093643862202814,0.0,0.0
4122,0,4122,[ 64 313 483 318 187],618,5,16879,4.093863691486781,80.0,20.0
4123,0,4123,[ 64 313 483 318 187],618,5,16884,4.094083414161009,80.0,20.0
4124,0,4124,[ 64 313 483 318 187],618,5,16889,4.09430303030303,80.0,20.0
4125,0,4125,[197 322  79 238 597],805,3,16892,4.094037809015997,0.0,0.0
4126,0,4126,[ 64 313 483 318 187],618,5,16897,4.0942573297795,80.0,20.0
4127,0,4127,[ 64 313 483 318 187],618,5,16902,4.094476744186046,80.0,20.0
4128,0,4128,[286 471 200 423 258],416,5,16907,4.094696052312909,0.0,0.0
4129,0,4129,[ 64 313 483 318 187],214,5,16912,4.094915254237288,80.0,20.0
4130,0,4130,[202  71 323 187 127],416,4,16916,4.094892277898814,0.0,0.0
4131,0,4131,[ 64 313 483 318 187],214,5,16921,4.095111326234269,80.0,20.0
4132,0,4132,[ 64 313 483 318 187],618,5,16926,4.095330268570046,80.0,20.0
4133,0,4133,[ 22 172 117 655 202],805,1,16927,4.094581519109821,0.0,0.0
4134,0,4134,[  1 357  50 172 302],417,2,16929,4.094074969770254,0.0,20.0
4135,0,4135,[568 403  11 289 197],345,3,16932,4.093810444874275,0.0,0.0
4136,0,4136,[ 64 313 483 318 187],214,5,16937,4.094029489968576,80.0,20.0
4137,0,4137,[286 144  11 161 238],416,5,16942,4.094248429192847,0.0,0.0
4138,0,4138,[ 64 313 483 318 187],618,5,16947,4.094467262623822,80.0,20.0
4139,0,4139,[313 655   4 202 191],345,4,16951,4.094444444444444,20.0,20.0
4140,0,4140,[ 64 313 483 318 187],618,5,16956,4.09466312484907,80.0,20.0
4141,0,4141,[197 515 216 195 143],405,3,16959,4.094398841139546,0.0,0.0
4142,0,4142,[ 79 275 187 215 216],373,4,16963,4.094376055998069,0.0,0.0
4143,0,4143,[ 64 313 483 318 187],618,5,16968,4.094594594594595,80.0,20.0
4144,0,4144,[151 118 678 313 179],416,1,16969,4.093848009650181,20.0,20.0
4145,0,4145,[ 64 313 483 318 187],618,5,16974,4.094066570188133,80.0,20.0
4146,0,4146,[204 222 228 597 322],805,1,16975,4.093320472630817,0.0,0.0
4147,0,4147,[ 64 313 483 318 187],618,5,16980,4.093539054966249,80.0,20.0
4148,0,4148,[ 69 168  22   1  89],62,4,16984,4.09351651000241,0.0,0.0
4149,0,4149,[333 286 143 475 173],588,4,16988,4.093493975903614,0.0,0.0
4150,0,4150,[568 200  25  82 216],198,2,16990,4.092989641050349,0.0,0.0
4151,0,4151,[ 64 313 483 318 187],214,5,16995,4.093208092485549,80.0,20.0
4152,0,4152,[ 98 294 222 197 117],297,3,16998,4.0929448591379725,0.0,20.0
4153,0,4153,[ 50 204 143 135 269],805,3,17001,4.092681752527684,0.0,20.0
4154,0,4154,[ 64 313 483 318 187],214,5,17006,4.092900120336943,80.0,20.0
4155,0,4155,[  1 282  50 144 313],654,4,17010,4.092877767083734,20.0,40.0
4156,0,4156,[ 79 127 204 655  25],416,5,17015,4.0930959826798174,0.0,0.0
4157,0,4157,[ 64 313 483 318 187],618,5,17020,4.093314093314094,80.0,20.0
4158,0,4158,[151 216  12 313 194],416,4,17024,4.0932916566482325,40.0,20.0
4159,0,4159,[ 64 313 483 318 187],214,5,17029,4.093509615384615,80.0,20.0
4160,0,4160,[ 64 313 483 318 187],618,5,17034,4.093727469358328,80.0,20.0
4161,0,4161,[ 64 313 483 318 187],214,5,17039,4.093945218644882,80.0,20.0
4162,0,4162,[197 144 180  28 195],805,1,17040,4.093202017775643,0.0,0.0
4163,0,4163,[153 216 174  88 195],373,5,17045,4.093419788664746,0.0,0.0
4164,0,4164,[ 64 313 483 318 187],214,5,17050,4.093637454981993,80.0,20.0
4165,0,4165,[ 64 313 483 318 187],618,5,17055,4.093855016802689,80.0,20.0
4166,0,4166,[187 515 179 423 323],416,3,17058,4.093592512598992,0.0,0.0
4167,0,4167,[ 64 313 483 318 187],214,5,17063,4.093809980806142,80.0,20.0
4168,0,4168,[ 64 313 483 318 187],214,5,17068,4.0940273446869755,80.0,20.0
4169,0,4169,[515  82 435 216 153],230,5,17073,4.094244604316547,0.0,0.0
4170,0,4170,[168 357 176 515 187],698,3,17076,4.093982258451211,0.0,0.0
4171,0,4171,[288  70 265 180 161],417,2,17078,4.093480345158198,0.0,20.0
4172,0,4172,[ 64 313 483 318 187],214,5,17083,4.093697579678888,80.0,20.0
4173,0,4173,[202  56 423 234 300],297,1,17084,4.092956396741735,0.0,0.0
4174,0,4174,[ 56 597  69 216 323],416,3,17087,4.092694610778443,0.0,0.0
4175,0,4175,[245 508  98 288 117],62,3,17090,4.092432950191571,0.0,40.0
4176,0,4176,[ 64 313 483 318 187],618,5,17095,4.092650227435959,80.0,20.0
4177,0,4177,[ 64 313 483 318 187],214,5,17100,4.092867400670177,80.0,20.0
4178,0,4178,[ 64 313 483 318 187],618,5,17105,4.093084469968892,80.0,20.0
4179,0,4179,[ 64 313 483 318 187],214,5,17110,4.0933014354066986,80.0,20.0
4180,0,4180,[ 64 313 483 318 187],618,5,17115,4.09351829705812,80.0,20.0
4181,0,4181,[322 603  25 174   1],416,4,17119,4.09349593495935,0.0,0.0
4182,0,4182,[151 174 216 153  95],417,3,17122,4.093234520678939,0.0,0.0
4183,0,4183,[161  11   7 185  25],417,1,17123,4.0924952198852775,0.0,0.0
4184,0,4184,[ 64 313 483 318 187],618,5,17128,4.092712066905615,80.0,20.0
4185,0,4185,[ 64 313 483 318 187],618,5,17133,4.092928810320115,80.0,20.0
4186,0,4186,[269 174  28 153 195],805,2,17135,4.0924289467399095,0.0,0.0
4187,0,4187,[183 228 161 191 153],922,2,17137,4.091929321872016,0.0,0.0
4188,0,4188,[ 64 313 483 318 187],618,5,17142,4.092146096920506,80.0,20.0
4189,0,4189,[ 64 313 483 318 187],214,5,17147,4.09236276849642,80.0,20.0
4190,0,4190,[125  71 143 176 135],618,4,17151,4.092340730136006,0.0,0.0
4191,0,4191,[328 475   7  69  56],62,4,17155,4.092318702290076,0.0,0.0
4192,0,4192,[357  88 323 121  71],416,3,17158,4.092058192225137,0.0,0.0
4193,0,4193,[ 64 313 483 318 187],214,5,17163,4.092274678111588,80.0,20.0
4194,0,4194,[118 222 275 603   4],854,3,17166,4.092014302741359,0.0,0.0
4195,0,4195,[153 597   4  82 182],417,3,17169,4.091754051477598,0.0,0.0
4196,0,4196,[ 64 313 483 318 187],214,5,17174,4.091970455086967,80.0,20.0
4197,0,4197,[288 423 168 289 195],854,3,17177,4.091710338256313,0.0,20.0
4198,0,4198,[ 64 313 483 318 187],214,5,17182,4.091926649202191,80.0,20.0
4199,0,4199,[ 64 313 483 318 187],618,5,17187,4.092142857142857,80.0,20.0
4200,0,4200,[ 64 313 483 318 187],214,5,17192,4.092358962151868,80.0,20.0
4201,0,4201,[328 385 211 357   4],416,5,17197,4.092574964302713,0.0,0.0
4202,0,4202,[ 64 313 483 318 187],618,5,17202,4.092790863668808,80.0,20.0
4203,0,4203,[ 64 313 483 318 187],214,5,17207,4.093006660323502,80.0,20.0
4204,0,4204,[197 118 215  64  56],618,3,17210,4.092746730083234,20.0,0.0
4205,0,4205,[ 64 313 483 318 187],618,5,17215,4.092962434617213,80.0,20.0
4206,0,4206,[182  12 179 151 276],214,4,17219,4.092940337532684,20.0,0.0
4207,0,4207,[127  96  95 211 143],373,3,17222,4.092680608365019,0.0,0.0
4208,0,4208,[ 64 313 483 318 187],618,5,17227,4.092896174863388,80.0,20.0
4209,0,4209,[ 64 313 483 318 187],214,5,17232,4.093111638954869,80.0,20.0
4210,0,4210,[ 89 172 568 294   4],62,3,17235,4.092852054143909,0.0,0.0
4211,0,4211,[ 64 313 483 318 187],214,5,17240,4.09306742640076,80.0,20.0
4212,0,4212,[121 186   1 117 403],588,4,17244,4.093045335865179,0.0,0.0
4213,0,4213,[ 64 313 483 318 187],618,5,17249,4.093260560037969,80.0,20.0
4214,0,4214,[228   4 168 300 508],297,2,17251,4.09276393831554,0.0,0.0
4215,0,4215,[195 200 322 121 245],416,3,17254,4.092504743833017,0.0,0.0
4216,0,4216,[ 64 313 483 318 187],618,5,17259,4.092719943087503,80.0,20.0
4217,0,4217,[ 64 313 483 318 187],618,5,17264,4.092935040303462,80.0,20.0
4218,0,4218,[ 64 313 483 318 187],214,5,17269,4.093150035553449,80.0,20.0
4219,0,4219,[ 88 182 216 202  28],128,4,17273,4.093127962085308,0.0,0.0
4220,0,4220,[ 64 313 483 318 187],618,5,17278,4.0933428097607205,80.0,20.0
4221,0,4221,[ 88  64  79 385 269],345,4,17282,4.093320701089531,20.0,0.0
4222,0,4222,[294 385 173  11 176],805,2,17284,4.092825005919962,0.0,0.0
4223,0,4223,[286 216 276  12  22],62,4,17288,4.09280303030303,20.0,0.0
4224,0,4224,[ 64 313 483 318 187],214,5,17293,4.09301775147929,80.0,20.0
4225,0,4225,[ 64 313 483 318 187],618,5,17298,4.093232371036441,80.0,20.0
4226,0,4226,[276  89  11 175 265],198,2,17300,4.092737165838656,0.0,0.0
4227,0,4227,[ 79 222  56 322 179],805,4,17304,4.0927152317880795,0.0,0.0
4228,0,4228,[258  97 265 210  15],588,4,17308,4.092693308110665,0.0,0.0
4229,0,4229,[ 15 546 144 328 174],416,4,17312,4.092671394799054,0.0,0.0
4230,0,4230,[385 748   9   7 742],805,1,17313,4.091940439612385,0.0,0.0
4231,0,4231,[ 64 313 483 318 187],214,5,17318,4.092155009451796,80.0,20.0
4232,0,4232,[276 245  12 176 357],416,3,17321,4.091896999763761,20.0,0.0
4233,0,4233,[ 64 313 483 318 187],214,5,17326,4.092111478507322,80.0,20.0
4234,0,4234,[ 64 313 483 318 187],618,5,17331,4.09232585596222,80.0,20.0
4235,0,4235,[ 89 322 121 151 196],417,3,17334,4.092067988668555,0.0,0.0
4236,0,4236,[655 289 181  56 100],588,2,17336,4.091574227047439,0.0,20.0
4237,0,4237,[179  97 127 153  64],417,5,17341,4.091788579518641,20.0,0.0
4238,0,4238,[ 64 313 483 318 187],214,5,17346,4.092002830856334,80.0,20.0
4239,0,4239,[121 313 125 174 196],921,4,17350,4.091981132075472,20.0,20.0
4240,0,4240,[ 64 313 483 318 187],618,5,17355,4.092195236972413,80.0,20.0
4241,0,4241,[ 64 313 483 318 187],618,5,17360,4.092409240924092,80.0,20.0
4242,0,4242,[289  71  79 127 568],416,4,17364,4.092387461701626,0.0,0.0
4243,0,4243,[258 204 475 273 100],62,4,17368,4.092365692742695,0.0,0.0
4244,0,4244,[143 125 328 183 100],416,5,17373,4.092579505300353,0.0,0.0
4245,0,4245,[ 64 313 483 318 187],214,5,17378,4.092793217145549,80.0,20.0
4246,0,4246,[  9 588 235 125  28],416,4,17382,4.092771368024488,0.0,0.0
4247,0,4247,[ 64 313 483 318 187],618,5,17387,4.092984934086629,80.0,20.0
4248,0,4248,[ 64 313 483 318 187],214,5,17392,4.093198399623441,80.0,20.0
4249,0,4249,[153 313 191 181 143],416,5,17397,4.093411764705882,20.0,40.0
4250,0,4250,[ 64 313 483 318 187],618,5,17402,4.093625029404846,80.0,20.0
4251,0,4251,[ 64 313 483 318 187],618,5,17407,4.093838193791157,80.0,20.0
4252,0,4252,[ 64 313 483 318 187],214,5,17412,4.094051257935575,80.0,20.0
4253,0,4253,[ 64 313 483 318 187],214,5,17417,4.094264221908792,80.0,20.0
4254,0,4254,[ 64 313 483 318 187],618,5,17422,4.094477085781434,80.0,20.0
4255,0,4255,[  4 423 273  50  25],618,3,17425,4.09421992481203,0.0,20.0
4256,0,4256,[111 275 357 245 195],62,3,17428,4.093962884660559,0.0,0.0
4257,0,4257,[ 64 313 483 318 187],618,5,17433,4.094175669328323,80.0,20.0
4258,0,4258,[  8 655 294 496  82],887,4,17437,4.094153557173045,0.0,0.0
4259,0,4259,[179   1 180 427 132],198,4,17441,4.094131455399061,0.0,0.0
4260,0,4260,[ 15  64 597 294 748],417,4,17445,4.094109363999062,20.0,0.0
4261,0,4261,[471 258 173 194 508],854,3,17448,4.0938526513374,0.0,0.0
4262,0,4262,[ 64 313 483 318 187],214,5,17453,4.094065212291813,80.0,20.0
4263,0,4263,[ 64 313 483 318 187],618,5,17458,4.0942776735459665,80.0,20.0
4264,0,4264,[275 597 234 143 286],416,4,17462,4.094255568581477,0.0,0.0
4265,0,4265,[ 64 313 179 176 161],405,2,17464,4.093764650726676,40.0,20.0
4266,0,4266,[179 258 186 183 117],198,4,17468,4.0937426763534095,0.0,0.0
4267,0,4267,[ 88 742 127 118 185],416,3,17471,4.09348641049672,0.0,0.0
4268,0,4268,[ 64 313 483 318 187],618,5,17476,4.09369875849145,80.0,20.0
4269,0,4269,[318   8  22 678  79],416,4,17480,4.0936768149882905,20.0,0.0
4270,0,4270,[ 64 313 483 318 187],618,5,17485,4.093889018965114,80.0,20.0
4271,0,4271,[323  70 173 496 185],417,2,17487,4.093398876404494,0.0,0.0
4272,0,4272,[179 210  70  11 117],751,4,17491,4.093377018488182,0.0,0.0
4273,0,4273,[202   1 144 288 151],314,4,17495,4.093355170800187,0.0,20.0
4274,0,4274,[211 282 286 357 546],297,3,17498,4.093099415204678,0.0,0.0
4275,0,4275,[323   7  25 183 200],805,5,17503,4.093311506080449,0.0,0.0
4276,0,4276,[ 25   9 234 100 748],805,3,17506,4.093055880289922,0.0,0.0
4277,0,4277,[ 64 313 483 318 187],214,5,17511,4.093267882187939,80.0,20.0
4278,0,4278,[ 64 313 483 318 187],618,5,17516,4.093479784996495,80.0,20.0
4279,0,4279,[195  79 282  11  71],618,3,17519,4.093224299065421,0.0,0.0
4280,0,4280,[ 82 100 258 471 294],43,4,17523,4.093202522775052,0.0,0.0
4281,0,4281,[ 64 313 483 318 187],618,5,17528,4.093414292386735,80.0,20.0
4282,0,4282,[222 257 471  82 111],705,5,17533,4.09362596310997,0.0,0.0
4283,0,4283,[301  97   8 121 196],416,5,17538,4.093837535014005,0.0,0.0
4284,0,4284,[ 64 313 483 318 187],618,5,17543,4.094049008168028,80.0,20.0
4285,0,4285,[173 153 127 132 328],416,5,17548,4.094260382641157,0.0,0.0
4286,0,4286,[  4 258 475 181 215],416,4,17552,4.094238395148122,0.0,20.0
4287,0,4287,[202 385 313 318 238],618,3,17555,4.0939832089552235,40.0,20.0
4288,0,4288,[ 64 313 483 318 187],214,5,17560,4.094194450920961,80.0,20.0
4289,0,4289,[ 56   1 197  11 748],751,1,17561,4.093473193473193,0.0,0.0
4290,0,4290,[ 64 313 483 318 187],214,5,17566,4.0936844558378,80.0,20.0
4291,0,4291,[185 301 300 257 143],297,3,17569,4.0934296365330844,0.0,0.0
4292,0,4292,[100 168 276 258 121],416,4,17573,4.0934078732820876,0.0,0.0
4293,0,4293,[ 88  11 195 151 245],416,2,17575,4.092920353982301,0.0,0.0
4294,0,4294,[197  12 187  70 568],373,3,17578,4.092665890570431,20.0,0.0
4295,0,4295,[168 117  95 185 121],416,4,17582,4.092644320297952,0.0,0.0
4296,0,4296,[ 64 313 483 318 187],214,5,17587,4.092855480567838,80.0,20.0
4297,0,4297,[ 64 313 483 318 187],214,5,17592,4.093066542577943,80.0,20.0
4298,0,4298,[234 238  98 191 117],805,4,17596,4.093044894161433,0.0,20.0
4299,0,4299,[ 64 313 483 318 187],214,5,17601,4.093255813953489,80.0,20.0
4300,0,4300,[ 50 423 196 258  69],62,4,17605,4.093234131597303,0.0,20.0
4301,0,4301,[ 95 328 187 175  70],373,3,17608,4.092980009298001,0.0,0.0
4302,0,4302,[ 64 313 483 318 187],214,5,17613,4.0931907971182895,80.0,20.0
4303,0,4303,[135 111 172 328 403],62,3,17616,4.092936802973978,0.0,0.0
4304,0,4304,[ 64 313 483 318 187],214,5,17621,4.093147502903601,80.0,20.0
4305,0,4305,[ 28 204 405  96 289],887,5,17626,4.09335810496981,0.0,0.0
4306,0,4306,[215 168  95 183 655],618,4,17630,4.093336429068957,0.0,0.0
4307,0,4307,[121 204  28  25  69],43,5,17635,4.093546889507892,0.0,0.0
4308,0,4308,[ 64 313 483 318 187],618,5,17640,4.093757252262706,80.0,20.0
4309,0,4309,[ 50 742 237 271 222],62,2,17642,4.093271461716937,0.0,20.0
4310,0,4310,[423  25 168  15 405],854,3,17645,4.093017861285085,0.0,0.0
4311,0,4311,[ 64 313 483 318 187],618,5,17650,4.093228200371057,80.0,20.0
4312,0,4312,[ 64 313 483 318 187],214,5,17655,4.093438441919777,80.0,20.0
4313,0,4313,[ 64 313 483 318 187],214,5,17660,4.093648585999073,80.0,20.0
4314,0,4314,[ 64 313 483 318 187],618,5,17665,4.093858632676709,80.0,20.0
4315,0,4315,[132   7 423 546 302],62,3,17668,4.093605189990732,0.0,0.0
4316,0,4316,[ 64 313 483 318 187],214,5,17673,4.093815149409312,80.0,20.0
4317,0,4317,[ 64 313 483 318 187],618,5,17678,4.0940250115794345,80.0,20.0
4318,0,4318,[ 64 313 483 318 187],214,5,17683,4.09423477656865,80.0,20.0
4319,0,4319,[ 64 313 483 318 187],214,5,17688,4.094444444444444,80.0,20.0
4320,0,4320,[ 64 313 483 318 187],618,5,17693,4.094654015274242,80.0,20.0
4321,0,4321,[ 64 313 483 318 187],214,5,17698,4.094863489125405,80.0,20.0
4322,0,4322,[  8 173 238  79 475],437,4,17702,4.0948415452232245,0.0,0.0
4323,0,4323,[  8 301  50 294 228],297,3,17705,4.0945883441258095,0.0,20.0
4324,0,4324,[ 98 235  96 427 597],416,3,17708,4.094335260115607,0.0,20.0
4325,0,4325,[546 151 323 496 276],43,4,17712,4.0943134535367545,0.0,0.0
4326,0,4326,[275 546  70 204 258],416,4,17716,4.094291657037208,0.0,0.0
4327,0,4327,[ 64 313 483 318 187],214,5,17721,4.094500924214418,80.0,20.0
4328,0,4328,[403 168 191 288 187],416,5,17726,4.094710094710095,0.0,20.0
4329,0,4329,[ 28 118 471 185  25],618,2,17728,4.094226327944573,0.0,0.0
4330,0,4330,[405 195 257 273 318],854,3,17731,4.09397367813438,20.0,0.0
4331,0,4331,[ 22 121   8 183 117],253,5,17736,4.094182825484765,0.0,0.0
4332,0,4332,[202 294  71 210 588],887,5,17741,4.094391876298177,0.0,0.0
4333,0,4333,[257 100  15 471 423],854,2,17743,4.093908629441624,0.0,0.0
4334,0,4334,[268 151 125 100   1],588,3,17746,4.09365628604383,0.0,0.0
4335,0,4335,[ 64 313 483 318 187],214,5,17751,4.093865313653136,80.0,20.0
4336,0,4336,[ 95  82 121  79  97],43,5,17756,4.094074244869725,0.0,0.0
4337,0,4337,[ 64 313 483 318 187],214,5,17761,4.094283079760258,80.0,20.0
4338,0,4338,[ 12 125   9 210 143],345,4,17765,4.0942613505416,20.0,0.0
4339,0,4339,[ 64 313 483 318 187],214,5,17770,4.094470046082949,80.0,20.0
4340,0,4340,[ 11 238 483 275 132],214,4,17774,4.0944482838055745,20.0,0.0
4341,0,4341,[186 235  50 179 597],417,2,17776,4.093965914325196,0.0,20.0
4342,0,4342,[ 64 313 483 318 187],214,5,17781,4.094174533732443,80.0,20.0
4343,0,4343,[ 64 313 483 318 187],618,5,17786,4.09438305709024,80.0,20.0
4344,0,4344,[742  50 496 257  12],654,5,17791,4.094591484464902,20.0,20.0
4345,0,4345,[496   4 121 286 238],43,4,17795,4.094569719282099,0.0,0.0
4346,0,4346,[161  15 117 238 234],417,4,17799,4.094547964113182,0.0,0.0
4347,0,4347,[118 427 179  98  12],601,2,17801,4.094066237350506,20.0,20.0
4348,0,4348,[ 89  50 568 176 168],198,4,17805,4.094044607955852,0.0,20.0
4349,0,4349,[168 323 176 185 475],198,3,17808,4.0937931034482755,0.0,0.0
4350,0,4350,[ 97  95 323   4 222],43,4,17812,4.093771546770857,0.0,0.0
4351,0,4351,[301 655  82 200  97],711,4,17816,4.09375,0.0,0.0
4352,0,4352,[ 64 313 483 318 187],214,5,17821,4.093958189754193,80.0,20.0
4353,0,4353,[ 64 313 483 318 187],214,5,17826,4.094166283876895,80.0,20.0
4354,0,4354,[496 268 238  69 328],416,5,17831,4.094374282433984,0.0,0.0
4355,0,4355,[ 64 313 483 318 187],618,5,17836,4.0945821854912765,80.0,20.0
4356,0,4356,[597  89 234 202  70],417,4,17840,4.094560477392702,0.0,0.0
4357,0,4357,[ 64 313 483 318 187],214,5,17845,4.094768242312988,80.0,20.0
4358,0,4358,[423 357 125 161 294],721,3,17848,4.094517091075935,0.0,0.0
4359,0,4359,[597 313 161 269 403],416,4,17852,4.0944954128440365,20.0,20.0
4360,0,4360,[328 588 294  50  82],416,5,17857,4.09470304975923,0.0,20.0
4361,0,4361,[  1  70  69 288 117],345,3,17860,4.0944520861989915,0.0,20.0
4362,0,4362,[ 64 313 483 318 187],618,5,17865,4.094659637863855,80.0,20.0
4363,0,4363,[ 28 286   8 210  79],588,5,17870,4.0948670944088,0.0,0.0
4364,0,4364,[ 64 313 483 318 187],618,5,17875,4.095074455899198,80.0,20.0
4365,0,4365,[423  79 496 181 161],128,5,17880,4.095281722400366,0.0,20.0
4366,0,4366,[288 302 323   4  82],417,1,17881,4.094572933363866,0.0,20.0
4367,0,4367,[ 64 313 483 318 187],618,5,17886,4.09478021978022,80.0,20.0
4368,0,4368,[ 64 313 483 318 187],618,5,17891,4.094987411306935,80.0,20.0
4369,0,4369,[294 173 323 210 286],43,4,17895,4.0949656750572085,0.0,0.0
4370,0,4370,[ 64 313 483 318 187],618,5,17900,4.095172729352551,80.0,20.0
4371,0,4371,[ 64 313 483 318 187],214,5,17905,4.095379688929552,80.0,20.0
4372,0,4372,[222  56  50 403  64],198,4,17909,4.095357877887034,20.0,20.0
4373,0,4373,[322 204 111 173 301],721,5,17914,4.0955647005029725,0.0,0.0
4374,0,4374,[  4 234 215  69 191],198,3,17917,4.095314285714286,0.0,0.0
4375,0,4375,[ 64 313 483 318 187],618,5,17922,4.095521023765996,80.0,20.0
4376,0,4376,[423 176 234 202 143],416,5,17927,4.095727667352068,0.0,0.0
4377,0,4377,[ 64 313 483 318 187],618,5,17932,4.095934216537231,80.0,20.0
4378,0,4378,[183 118  79  98 168],805,4,17936,4.095912308746289,0.0,20.0
4379,0,4379,[ 64 313 483 318 187],214,5,17941,4.096118721461187,80.0,20.0
4380,0,4380,[ 64 313 483 318 187],214,5,17946,4.096325039945218,80.0,20.0
4381,0,4381,[655 222 294 237  82],62,2,17948,4.095846645367412,0.0,0.0
4382,0,4382,[ 64 313 483 318 187],618,5,17953,4.096052931781885,80.0,20.0
4383,0,4383,[ 22 742  89 174 323],764,3,17956,4.095802919708029,0.0,0.0
4384,0,4384,[742  79 323 597 200],417,1,17957,4.095096921322691,0.0,0.0
4385,0,4385,[ 64 313 483 318 187],618,5,17962,4.095303237574099,80.0,20.0
4386,0,4386,[ 64 313 483 318 187],618,5,17967,4.095509459767495,80.0,20.0
4387,0,4387,[ 64 313 483 318 187],214,5,17972,4.095715587967184,80.0,20.0
4388,0,4388,[258 125 748 235 118],417,4,17976,4.095693779904306,0.0,0.0
4389,0,4389,[ 64 313 483 318 187],214,5,17981,4.095899772209568,80.0,20.0
4390,0,4390,[ 64 313 483 318 187],214,5,17986,4.096105670690048,80.0,20.0
4391,0,4391,[210 271   8 195 288],62,3,17989,4.095856102003643,0.0,20.0
4392,0,4392,[ 50 655  22 118 121],588,3,17992,4.095606646938311,0.0,20.0
4393,0,4393,[117 568 121 216 196],654,5,17997,4.095812471552117,0.0,0.0
4394,0,4394,[202 153  97 286 179],437,3,18000,4.09556313993174,0.0,0.0
4395,0,4395,[168 655 269 215 237],416,4,18004,4.095541401273885,0.0,0.0
4396,0,4396,[ 64 313 483 318 187],618,5,18009,4.0957471002956565,80.0,20.0
4397,0,4397,[ 69 151  96 185 181],416,4,18013,4.095725329695316,0.0,20.0
4398,0,4398,[ 64 313 483 318 187],214,5,18018,4.09593089338486,80.0,20.0
4399,0,4399,[181 238 195  82 111],417,3,18021,4.095681818181818,0.0,20.0
4400,0,4400,[161  95  56 265 174],405,2,18023,4.095205635082936,0.0,0.0
4401,0,4401,[ 64 313 483 318 187],618,5,18028,4.095411176737846,80.0,20.0
4402,0,4402,[204  69  56 173 471],128,4,18032,4.095389507154213,0.0,0.0
4403,0,4403,[ 64 313 483 318 187],214,5,18037,4.095594913714804,80.0,20.0
4404,0,4404,[ 64 313 483 318 187],214,5,18042,4.095800227014756,80.0,20.0
4405,0,4405,[ 64 313 483 318 187],214,5,18047,4.096005447117567,80.0,20.0
4406,0,4406,[ 11 127 121  25 568],805,1,18048,4.095302927161335,0.0,0.0
4407,0,4407,[ 64 313 483 318 187],618,5,18053,4.095508166969147,80.0,20.0
4408,0,4408,[204 121 237  22 191],505,2,18055,4.095032887276027,0.0,0.0
4409,0,4409,[ 64 313 483 318 187],618,5,18060,4.095238095238095,80.0,20.0
4410,0,4410,[  1 357  89 185 204],805,4,18064,4.0952165041940605,0.0,0.0
4411,0,4411,[268 151   7 742 245],417,3,18067,4.094968268359021,0.0,0.0
4412,0,4412,[ 95 191 568 204 196],618,3,18070,4.094720145026059,0.0,0.0
4413,0,4413,[ 64 313 483 318 187],618,5,18075,4.094925237879474,80.0,20.0
4414,0,4414,[174  12 180 182  79],417,3,18078,4.094677236693092,20.0,0.0
4415,0,4415,[269 427 301   4 294],416,5,18083,4.0948822463768115,0.0,0.0
4416,0,4416,[ 64 313 483 318 187],618,5,18088,4.0950871632329635,80.0,20.0
4417,0,4417,[ 64 313 483 318 187],618,5,18093,4.095291987324582,80.0,20.0
4418,0,4418,[ 64 313 483 318 187],214,5,18098,4.095496718714641,80.0,20.0
4419,0,4419,[ 64 313 483 318 187],618,5,18103,4.095701357466063,80.0,20.0
4420,0,4420,[ 64 313 483 318 187],214,5,18108,4.09590590364171,80.0,20.0
4421,0,4421,[211 588 678 258 265],416,4,18112,4.0958842152872,0.0,0.0
4422,0,4422,[121 546 174 289   9],43,5,18117,4.096088627628307,0.0,0.0
4423,0,4423,[678  11  25 655  98],416,4,18121,4.096066907775769,0.0,20.0
4424,0,4424,[ 64 313 483 318 187],618,5,18126,4.096271186440678,80.0,20.0
4425,0,4425,[ 64 313 483 318 187],214,5,18131,4.096475372797108,80.0,20.0
4426,0,4426,[ 64 313 483 318 187],214,5,18136,4.096679466907612,80.0,20.0
4427,0,4427,[ 82 182 195 204 200],405,3,18139,4.09643179765131,0.0,0.0
4428,0,4428,[276  88 111  71 282],274,5,18144,4.096635809437796,0.0,0.0
4429,0,4429,[268 183  97  95 196],417,5,18149,4.096839729119639,0.0,0.0
4430,0,4430,[211 215 301 185 385],416,5,18154,4.097043556759196,0.0,0.0
4431,0,4431,[ 64 313 483 318 187],618,5,18159,4.097247292418772,80.0,20.0
4432,0,4432,[301 748 268 111 191],416,5,18164,4.097450936160613,0.0,0.0
4433,0,4433,[125 258  97 423 234],417,5,18169,4.09765448804691,0.0,0.0
4434,0,4434,[100 200 143   1 748],805,3,18172,4.097406989853439,0.0,0.0
4435,0,4435,[ 64 313 483 318 187],214,5,18177,4.09761045987376,80.0,20.0
4436,0,4436,[ 64 313 483 318 187],618,5,18182,4.09781383817895,80.0,20.0
4437,0,4437,[ 70 403   8 135 191],642,3,18185,4.097566471383506,0.0,0.0
4438,0,4438,[ 98  56 216 238 173],805,4,18189,4.0975444920027035,0.0,20.0
4439,0,4439,[ 64 313 483 318 187],214,5,18194,4.097747747747747,80.0,20.0
4440,0,4440,[176 322 127 546 313],416,3,18197,4.0975005629362755,20.0,20.0
4441,0,4441,[483 405 357 597 235],62,3,18200,4.09725348941918,20.0,0.0
4442,0,4442,[ 64 313 483 318 187],214,5,18205,4.097456673418861,80.0,20.0
4443,0,4443,[125 151 216 276   9],416,3,18208,4.0972097209720975,0.0,0.0
4444,0,4444,[237  88 275 216 435],437,3,18211,4.096962879640045,0.0,0.0
4445,0,4445,[ 64 127  70 194 173],373,4,18215,4.096941070625281,20.0,0.0
4446,0,4446,[ 64 313 483 318 187],618,5,18220,4.097144142118282,80.0,20.0
4447,0,4447,[ 64 313 483 318 187],618,5,18225,4.097347122302159,80.0,20.0
4448,0,4448,[ 64 313 483 318 187],618,5,18230,4.09755001123848,80.0,20.0
4449,0,4449,[ 64 313 483 318 187],618,5,18235,4.097752808988764,80.0,20.0
4450,0,4450,[125 118  82  71 179],601,1,18236,4.09705684115929,0.0,0.0
4451,0,4451,[ 64 313 483 318 187],214,5,18241,4.0972596585804135,80.0,20.0
4452,0,4452,[ 64 313 483 318 187],618,5,18246,4.09746238490905,80.0,20.0
4453,0,4453,[ 64 313 483 318 187],214,5,18251,4.097665020206556,80.0,20.0
4454,0,4454,[ 64 313 483 318 187],618,5,18256,4.097867564534231,80.0,20.0
4455,0,4455,[195  22 588 172 385],705,2,18258,4.097396768402154,0.0,0.0
4456,0,4456,[ 64 313 483 318 187],214,5,18263,4.09759928202827,80.0,20.0
4457,0,4457,[174 153 546 245 357],62,4,18267,4.097577388963661,0.0,0.0
4458,0,4458,[ 64 313 483 318 187],618,5,18272,4.097779771249159,80.0,20.0
4459,0,4459,[ 64 313 483 318 187],214,5,18277,4.097982062780269,80.0,20.0
4460,0,4460,[ 64 313 483 318 187],618,5,18282,4.098184263618023,80.0,20.0
4461,0,4461,[ 64 313 483 318 187],214,5,18287,4.098386373823398,80.0,20.0
4462,0,4462,[ 64 313 483 318 187],618,5,18292,4.098588393457316,80.0,20.0
4463,0,4463,[301 175  96 185  50],49,2,18294,4.098118279569892,0.0,20.0
4464,0,4464,[238  79 302 202 742],43,4,18298,4.098096304591265,0.0,0.0
4465,0,4465,[ 64 313 483 318 187],214,5,18303,4.098298253470667,80.0,20.0
4466,0,4466,[ 64 313 483 318 187],618,5,18308,4.098500111931945,80.0,20.0
4467,0,4467,[ 70  89 271 475 180],62,3,18311,4.098254252461952,0.0,0.0
4468,0,4468,[ 82 357  15 216 118],62,3,18314,4.09800850302081,0.0,0.0
4469,0,4469,[202 204 385 180   1],887,5,18319,4.0982102908277405,0.0,0.0
4470,0,4470,[ 64 313 483 318 187],618,5,18324,4.0984119883694925,80.0,20.0
4471,0,4471,[168 176 276 144 655],618,4,18328,4.098389982110913,0.0,0.0
4472,0,4472,[135  97  70  15  79],618,3,18331,4.098144422088084,0.0,0.0
4473,0,4473,[ 64 313 483 318 187],618,5,18336,4.098345999105946,80.0,20.0
4474,0,4474,[ 50 127 318 111 204],721,5,18341,4.098547486033519,20.0,20.0
4475,0,4475,[ 70 215 588 196 153],43,5,18346,4.098748882931188,0.0,0.0
4476,0,4476,[180  96 179 385  64],405,1,18347,4.09805673442037,20.0,0.0
4477,0,4477,[ 15  56 258 168 179],601,3,18350,4.09781152300134,0.0,0.0
4478,0,4478,[125 182 195   7 186],417,4,18354,4.097789685197589,0.0,0.0
4479,0,4479,[ 64 313 483 318 187],214,5,18359,4.097991071428571,80.0,20.0
4480,0,4480,[216 186 748 405   4],198,2,18361,4.097522874358402,0.0,0.0
4481,0,4481,[ 64 313 483 318 187],618,5,18366,4.097724230254351,80.0,20.0
4482,0,4482,[197 210 405 427 153],416,5,18371,4.097925496319429,0.0,0.0
4483,0,4483,[ 64 313 483 318 187],618,5,18376,4.098126672613738,80.0,20.0
4484,0,4484,[ 64 313 483 318 187],214,5,18381,4.098327759197325,80.0,20.0
4485,0,4485,[ 64 313 483 318 187],618,5,18386,4.098528756130182,80.0,20.0
4486,0,4486,[181  56 172 357 588],805,3,18389,4.098283931357254,0.0,20.0
4487,0,4487,[ 64 313 483 318 187],618,5,18394,4.098484848484849,80.0,20.0
4488,0,4488,[ 64 313 483 318 187],214,5,18399,4.098685676097126,80.0,20.0
4489,0,4489,[ 64 313 483 318 187],618,5,18404,4.098886414253897,80.0,20.0
4490,0,4490,[568 183 195 238 273],416,5,18409,4.0990870630149185,0.0,0.0
4491,0,4491,[185  15 196   4 182],416,5,18414,4.099287622439893,0.0,0.0
4492,0,4492,[ 64 313 483 318 187],618,5,18419,4.099488092588471,80.0,20.0
4493,0,4493,[288  71 172 111  11],416,5,18424,4.099688473520249,0.0,20.0
4494,0,4494,[ 64 313 483 318 187],618,5,18429,4.0998887652947715,80.0,20.0
4495,0,4495,[ 64 313 483 318 187],214,5,18434,4.10008896797153,80.0,20.0
4496,0,4496,[185 186 427   4 275],618,3,18437,4.099844340671559,0.0,0.0
4497,0,4497,[496 405 237 294 176],764,4,18441,4.099822143174745,0.0,0.0
4498,0,4498,[191 742 268 111  98],854,2,18443,4.099355412313847,0.0,20.0
4499,0,4499,[ 96 269 183 235 172],416,4,18447,4.099333333333333,0.0,0.0
4500,0,4500,[ 64 313 483 318 187],214,5,18452,4.099533437013997,80.0,20.0
4501,0,4501,[ 64 313 483 318 187],214,5,18457,4.0997334517992,80.0,20.0
4502,0,4502,[ 79 168 191 211  97],43,5,18462,4.099933377748168,0.0,0.0
4503,0,4503,[ 64 313 483 318 187],214,5,18467,4.100133214920071,80.0,20.0
4504,0,4504,[ 64 313 483 318 187],618,5,18472,4.100332963374028,80.0,20.0
4505,0,4505,[ 64 313 483 318 187],214,5,18477,4.100532623169108,80.0,20.0
4506,0,4506,[ 64 313 483 318 187],618,5,18482,4.100732194364322,80.0,20.0
4507,0,4507,[258 204 172  88 282],345,4,18486,4.100709849157054,0.0,0.0
4508,0,4508,[ 64 313 483 318 187],214,5,18491,4.100909292526059,80.0,20.0
4509,0,4509,[ 64 313 483 318 187],214,5,18496,4.101108647450111,80.0,20.0
4510,0,4510,[ 64 313 483 318 187],618,5,18501,4.1013079139880295,80.0,20.0
4511,0,4511,[ 64 313 483 318 187],618,5,18506,4.101507092198582,80.0,20.0
4512,0,4512,[ 64 313 483 318 187],214,5,18511,4.101706182140483,80.0,20.0
4513,0,4513,[197 273 269 271 200],805,3,18514,4.101462117855561,0.0,0.0
4514,0,4514,[603 318 202 216  12],416,5,18519,4.1016611295681065,40.0,0.0
4515,0,4515,[ 64 313 483 318 187],618,5,18524,4.101860053144375,80.0,20.0
4516,0,4516,[  1 195 597 515 546],416,3,18527,4.101616116891742,0.0,0.0
4517,0,4517,[435 125 135  95  56],230,3,18530,4.101372288623285,0.0,0.0
4518,0,4518,[ 64 313 483 318 187],214,5,18535,4.10157114405842,80.0,20.0
4519,0,4519,[ 64 313 483 318 187],214,5,18540,4.101769911504425,80.0,20.0
4520,0,4520,[ 64 313 483 318 187],214,5,18545,4.101968591019686,80.0,20.0
4521,0,4521,[ 50 268 235 216  70],417,2,18547,4.101503759398496,0.0,20.0
4522,0,4522,[238 174 180 357  64],373,4,18551,4.101481317709485,20.0,0.0
4523,0,4523,[258  56 204  71  96],887,4,18555,4.1014588859416445,0.0,0.0
4524,0,4524,[185  89 435  79 275],297,3,18558,4.10121546961326,0.0,0.0
4525,0,4525,[ 25  70 228 215 276],198,1,18559,4.10053026955369,0.0,0.0
4526,0,4526,[ 64 313 483 318 187],214,5,18564,4.1007289595758785,80.0,20.0
4527,0,4527,[ 64 313 483 318 187],214,5,18569,4.100927561837456,80.0,20.0
4528,0,4528,[ 64 313 483 318 187],618,5,18574,4.101126076396556,80.0,20.0
4529,0,4529,[301 288 182   9 588],416,5,18579,4.101324503311258,0.0,20.0
4530,0,4530,[269  64 172  69 173],345,5,18584,4.101522842639594,20.0,0.0
4531,0,4531,[161  71  89 132 176],437,1,18585,4.100838481906443,0.0,0.0
4532,0,4532,[289 111 748 282 127],721,3,18588,4.100595632031767,0.0,0.0
4533,0,4533,[427 182 100 121  69],198,3,18591,4.100352889280988,0.0,0.0
4534,0,4534,[ 64 313 483 318 187],618,5,18596,4.100551267916208,80.0,20.0
4535,0,4535,[ 98   7 215 237   1],618,5,18601,4.100749559082892,0.0,20.0
4536,0,4536,[ 64 313 483 318 187],214,5,18606,4.100947762838881,80.0,20.0
4537,0,4537,[135  96 186 405 318],642,2,18608,4.100484795063905,20.0,0.0
4538,0,4538,[ 98 423 215 216 269],654,5,18613,4.10068296981714,0.0,20.0
4539,0,4539,[286 655  88  95 121],437,2,18615,4.100220264317181,0.0,0.0
4540,0,4540,[ 64 313 483 318 187],214,5,18620,4.100418410041841,80.0,20.0
4541,0,4541,[172   8 195 265 151],654,5,18625,4.100616468516073,0.0,0.0
4542,0,4542,[ 64 313 483 318 187],618,5,18630,4.100814439797491,80.0,20.0
4543,0,4543,[ 64 313 483 318 187],618,5,18635,4.101012323943662,80.0,20.0
4544,0,4544,[ 64 313 483 318 187],214,5,18640,4.101210121012101,80.0,20.0
4545,0,4545,[200 181 435 143 117],437,3,18643,4.100967883853937,0.0,20.0
4546,0,4546,[100   8 174 268 678],588,2,18645,4.100505828018473,0.0,0.0
4547,0,4547,[183  95 435 215 202],405,2,18647,4.100043975373791,0.0,0.0
4548,0,4548,[ 22 194 322 423 195],416,4,18651,4.100021982853375,0.0,0.0
4549,0,4549,[210 294 328 678 471],921,4,18655,4.1,0.0,0.0
4550,0,4550,[333 168 200 180 508],854,4,18659,4.099978026807295,0.0,0.0
4551,0,4551,[ 71 282 288 276 655],314,4,18663,4.099956063268893,0.0,20.0
4552,0,4552,[603 234 257 289 179],416,2,18665,4.099494838567977,0.0,0.0
4553,0,4553,[197 181 323  50  70],751,3,18668,4.09925340360123,0.0,40.0
4554,0,4554,[125 289 181 117 258],588,3,18671,4.099012074643249,0.0,20.0
4555,0,4555,[127 302 294  11 276],43,5,18676,4.099209833187006,0.0,0.0
4556,0,4556,[ 64 313 483 318 187],618,5,18681,4.099407504937459,80.0,20.0
4557,0,4557,[ 64 313 483 318 187],214,5,18686,4.099605089951734,80.0,20.0
4558,0,4558,[568 300 228 151  64],705,3,18689,4.0993638955911385,20.0,0.0
4559,0,4559,[ 25 238 202 258  97],43,4,18693,4.099342105263158,0.0,0.0
4560,0,4560,[ 64 313 483 318 187],214,5,18698,4.099539574654681,80.0,20.0
4561,0,4561,[185 215 100 357 276],198,2,18700,4.099079351161771,0.0,0.0
4562,0,4562,[ 64 313 483 318 187],214,5,18705,4.099276791584484,80.0,20.0
4563,0,4563,[ 56 318  22 127 294],721,3,18708,4.099035933391762,20.0,0.0
4564,0,4564,[100 257 173 204 161],751,4,18712,4.099014238773275,0.0,0.0
4565,0,4565,[405 191 144 121 181],805,1,18713,4.098335523434078,0.0,20.0
4566,0,4566,[ 64 313 483 318 187],214,5,18718,4.098532953798993,80.0,20.0
4567,0,4567,[ 64 313 483 318 187],618,5,18723,4.098730297723293,80.0,20.0
4568,0,4568,[275   9 194 496 121],416,5,18728,4.098927555263733,0.0,0.0
4569,0,4569,[ 64 313 483 318 187],618,5,18733,4.099124726477024,80.0,20.0
4570,0,4570,[ 50 742 200 135 475],417,2,18735,4.098665499890615,0.0,20.0
4571,0,4571,[ 69 181  25 238 200],618,3,18738,4.0984251968503935,0.0,20.0
4572,0,4572,[179 216  56 322 118],128,2,18740,4.097966324076099,0.0,0.0
4573,0,4573,[ 28   7 588 202 235],805,1,18741,4.09728902492348,0.0,0.0
4574,0,4574,[ 64 313 483 318 187],214,5,18746,4.097486338797814,80.0,20.0
4575,0,4575,[132 172 182 496 405],128,3,18749,4.097246503496503,0.0,0.0
4576,0,4576,[127   8 151 215 176],618,3,18752,4.097006772995412,0.0,0.0
4577,0,4577,[597   9 215 191  50],416,4,18756,4.096985583224115,0.0,20.0
4578,0,4578,[176  22 257 161 195],416,4,18760,4.096964402708015,0.0,0.0
4579,0,4579,[ 64 313 483 318 187],618,5,18765,4.097161572052402,80.0,20.0
4580,0,4580,[ 64 313 483 318 187],618,5,18770,4.097358655315434,80.0,20.0
4581,0,4581,[ 64 313 483 318 187],618,5,18775,4.09755565255347,80.0,20.0
4582,0,4582,[ 50   1 403 228 235],62,3,18778,4.097316168448614,0.0,20.0
4583,0,4583,[ 82 588 179 172 302],405,3,18781,4.097076788830716,0.0,0.0
4584,0,4584,[ 64 313 483 318 187],214,5,18786,4.097273718647765,80.0,20.0
4585,0,4585,[258  88 151 597   4],805,1,18787,4.096598342782381,0.0,0.0
4586,0,4586,[ 97 179  70 215 300],128,1,18788,4.095923261390888,0.0,0.0
4587,0,4587,[ 64 313 483 318 187],618,5,18793,4.096120313862249,80.0,20.0
4588,0,4588,[ 64 191 118 181 204],618,3,18796,4.095881455654827,20.0,20.0
4589,0,4589,[202 313 268 597 196],416,4,18800,4.095860566448802,20.0,20.0
4590,0,4590,[ 64 313 483 318 187],618,5,18805,4.096057503811806,80.0,20.0
4591,0,4591,[333 200 216 508  11],854,3,18808,4.09581881533101,0.0,0.0
4592,0,4592,[ 64 313 483 318 187],618,5,18813,4.096015676028739,80.0,20.0
4593,0,4593,[ 64 313 483 318 187],618,5,18818,4.0962124510230735,80.0,20.0
4594,0,4594,[ 64 313 483 318 187],214,5,18823,4.096409140369968,80.0,20.0
4595,0,4595,[427 132   8  96 546],416,4,18827,4.0963881636205395,0.0,0.0
4596,0,4596,[ 71 172 483 423 151],128,3,18830,4.0961496628235805,20.0,0.0
4597,0,4597,[ 22 423 435  69 216],297,2,18832,4.095693779904306,0.0,0.0
4598,0,4598,[ 64 313 483 318 187],214,5,18837,4.095890410958904,80.0,20.0
4599,0,4599,[265 173 168 143 483],588,5,18842,4.096086956521739,20.0,0.0
4600,0,4600,[ 64 313 483 318 187],214,5,18847,4.096283416648554,80.0,20.0
4601,0,4601,[294 496 318 269 174],262,2,18849,4.095827900912647,20.0,0.0
4602,0,4602,[196 742 215  11 151],43,5,18854,4.096024331957419,0.0,0.0
4603,0,4603,[ 64 313 483 318 187],618,5,18859,4.09622067767159,80.0,20.0
4604,0,4604,[181  11 127 568 187],198,4,18863,4.096199782844734,0.0,20.0
4605,0,4605,[546 515 403 183  69],416,4,18867,4.096178897090751,0.0,0.0
4606,0,4606,[603 385 210  69 265],405,2,18869,4.0957238984154545,0.0,0.0
4607,0,4607,[ 64 313 483 318 187],214,5,18874,4.095920138888889,80.0,20.0
4608,0,4608,[ 64 313 483 318 187],618,5,18879,4.096116294206986,80.0,20.0
4609,0,4609,[ 64 313 483 318 187],618,5,18884,4.096312364425163,80.0,20.0
4610,0,4610,[210 215 271  70 127],43,4,18888,4.096291476903058,0.0,0.0
4611,0,4611,[275 202 100 357 603],416,5,18893,4.0964874241110145,0.0,0.0
4612,0,4612,[ 64 313 483 318 187],214,5,18898,4.096683286364621,80.0,20.0
4613,0,4613,[ 64 313 483 318 187],214,5,18903,4.096879063719116,80.0,20.0
4614,0,4614,[ 64 313 483 318 187],214,5,18908,4.097074756229686,80.0,20.0
4615,0,4615,[289 294 258  96 127],159,4,18912,4.097053726169844,0.0,0.0
4616,0,4616,[ 64 313 483 318 187],618,5,18917,4.097249296079705,80.0,20.0
4617,0,4617,[ 64 313 483 318 187],618,5,18922,4.097444781290602,80.0,20.0
4618,0,4618,[403  12 257 211  88],43,5,18927,4.097640181857545,20.0,0.0
4619,0,4619,[ 64 313 483 318 187],214,5,18932,4.097835497835498,80.0,20.0
4620,0,4620,[161  79 200 197 183],618,4,18936,4.097814325903484,0.0,0.0
4621,0,4621,[286  28 176 118  71],764,4,18940,4.097793163132843,0.0,0.0
4622,0,4622,[ 64 313 483 318 187],214,5,18945,4.097988319273199,80.0,20.0
4623,0,4623,[ 64 313 483 318 187],618,5,18950,4.09818339100346,80.0,20.0
4624,0,4624,[333 403 118 471 286],416,4,18954,4.098162162162162,0.0,0.0
4625,0,4625,[ 64 313 483 318 187],618,5,18959,4.098357111975789,80.0,20.0
4626,0,4626,[125 568  50  15   4],373,5,18964,4.0985519775232335,0.0,20.0
4627,0,4627,[ 28 185 496 172 273],618,5,18969,4.098746758859118,0.0,0.0
4628,0,4628,[143 427 496 748 144],907,5,18974,4.0989414560380215,0.0,0.0
4629,0,4629,[286  25 200 153 151],417,4,18978,4.098920086393089,0.0,0.0
4630,0,4630,[151 121 265 318 655],705,3,18981,4.098682789894191,20.0,0.0
4631,0,4631,[151  82 234 175 216],198,2,18983,4.098229706390328,0.0,0.0
4632,0,4632,[ 82 210 195 237 175],922,1,18984,4.097560975609756,0.0,0.0
4633,0,4633,[546 245 132 204 318],416,3,18987,4.097324126025033,20.0,0.0
4634,0,4634,[151 132  69  15  71],198,3,18990,4.097087378640777,0.0,0.0
4635,0,4635,[603 405   7  11 322],854,4,18994,4.097066436583262,0.0,0.0
4636,0,4636,[  4 153 204 238 269],43,4,18998,4.097045503558335,0.0,0.0
4637,0,4637,[403 176 127  71 471],416,5,19003,4.097240189736955,0.0,0.0
4638,0,4638,[ 64 313 483 318 187],618,5,19008,4.097434791981031,80.0,20.0
4639,0,4639,[111 405 276 300 294],708,3,19011,4.097198275862069,0.0,0.0
4640,0,4640,[ 64 313 483 318 187],214,5,19016,4.097392803275156,80.0,20.0
4641,0,4641,[ 50 237 496  71 215],654,4,19020,4.097371822490306,0.0,20.0
4642,0,4642,[237   1 294 678 322],416,2,19022,4.096920094766315,0.0,0.0
4643,0,4643,[ 64 313 483 318 187],618,5,19027,4.097114556416882,80.0,20.0
4644,0,4644,[ 64 313 483 318 187],214,5,19032,4.097308934337998,80.0,20.0
4645,0,4645,[322 174 405 269 357],805,2,19034,4.096857511838141,0.0,0.0
4646,0,4646,[196   9 186 216 197],354,2,19036,4.0964062836238435,0.0,0.0
4647,0,4647,[300  11 185 143  25],297,4,19040,4.096385542168675,0.0,0.0
4648,0,4648,[273  89 257 168 135],417,2,19042,4.095934609593461,0.0,0.0
4649,0,4649,[ 64 313 483 318 187],214,5,19047,4.096129032258064,80.0,20.0
4650,0,4650,[ 64 313 483 318 187],214,5,19052,4.096323371317996,80.0,20.0
4651,0,4651,[ 64 313 483 318 187],214,5,19057,4.096517626827171,80.0,20.0
4652,0,4652,[ 64 313 483 318 187],214,5,19062,4.096711798839459,80.0,20.0
4653,0,4653,[238  25 210 144 121],618,2,19064,4.0962612806188226,0.0,0.0
4654,0,4654,[ 64 313 483 318 187],214,5,19069,4.096455424274973,80.0,20.0
4655,0,4655,[588 100  64 125 655],417,3,19072,4.096219931271477,20.0,0.0
4656,0,4656,[ 64 313 483 318 187],618,5,19077,4.096414000429461,80.0,20.0
4657,0,4657,[300 182  79 258 180],128,4,19081,4.096393301846286,0.0,0.0
4658,0,4658,[496 180  79  25 483],417,2,19083,4.095943335479717,20.0,0.0
4659,0,4659,[ 82 603 195 168 111],805,2,19085,4.09549356223176,0.0,0.0
4660,0,4660,[ 71 176 294 435  11],230,5,19090,4.0956876206822574,0.0,0.0
4661,0,4661,[ 64 313 483 318 187],618,5,19095,4.095881595881596,80.0,20.0
4662,0,4662,[ 64 313 483 318 187],214,5,19100,4.096075487883337,80.0,20.0
4663,0,4663,[ 64 313 483 318 187],214,5,19105,4.096269296740995,80.0,20.0
4664,0,4664,[ 64 313 483 318 187],618,5,19110,4.096463022508039,80.0,20.0
4665,0,4665,[237  28 265  25  22],654,4,19114,4.0964423489069866,0.0,0.0
4666,0,4666,[ 28 222 215  70 271],43,4,19118,4.096421684165417,0.0,0.0
4667,0,4667,[483 655  25 161 173],618,3,19121,4.096186803770351,20.0,0.0
4668,0,4668,[211 216 289 173   8],43,5,19126,4.096380381237952,0.0,0.0
4669,0,4669,[ 64 313 483 318 187],618,5,19131,4.0965738758029975,80.0,20.0
4670,0,4670,[ 64 313 483 318 187],618,5,19136,4.096767287518732,80.0,20.0
4671,0,4671,[191  82   8  50  15],705,2,19138,4.096318493150685,0.0,20.0
4672,0,4672,[568 183 204 168 161],405,2,19140,4.095869890862401,0.0,0.0
4673,0,4673,[385 568 427 210 588],642,4,19144,4.0958493795464275,0.0,0.0
4674,0,4674,[245 185 301 508 748],297,3,19147,4.095614973262032,0.0,0.0
4675,0,4675,[127 181  79 151 269],43,5,19152,4.095808383233533,0.0,20.0
4676,0,4676,[196 515 357 265  56],405,2,19154,4.0953602736797095,0.0,0.0
4677,0,4677,[257 322 302  11 111],417,1,19155,4.094698589140658,0.0,0.0
4678,0,4678,[333  98  88 176 197],416,4,19159,4.094678350074802,0.0,20.0
4679,0,4679,[ 64 313 483 318 187],214,5,19164,4.0948717948717945,80.0,20.0
4680,0,4680,[ 69 127 100 471  56],854,4,19168,4.094851527451399,0.0,0.0
4681,0,4681,[168  64 176 121  15],62,4,19172,4.094831268688595,20.0,0.0
4682,0,4682,[ 64 313 483 318 187],618,5,19177,4.095024556907965,80.0,20.0
4683,0,4683,[ 79  56   7 282 258],270,3,19180,4.0947907771135785,0.0,0.0
4684,0,4684,[385 210  96 135 117],618,3,19183,4.0945570971184635,0.0,0.0
4685,0,4685,[ 64 313 483 318 187],618,5,19188,4.094750320102433,80.0,20.0
4686,0,4686,[ 64 313 483 318 187],214,5,19193,4.094943460635801,80.0,20.0
4687,0,4687,[ 64 313 483 318 187],618,5,19198,4.095136518771331,80.0,20.0
4688,0,4688,[ 64 313 483 318 187],214,5,19203,4.0953294945617404,80.0,20.0
4689,0,4689,[179 655 111 210 300],751,2,19205,4.094882729211087,0.0,0.0
4690,0,4690,[  7 161 216  56 172],751,3,19208,4.094649328501386,0.0,0.0
4691,0,4691,[ 64 313 483 318 187],618,5,19213,4.094842284739983,80.0,20.0
4692,0,4692,[ 64 313 483 318 187],214,5,19218,4.09503515874707,80.0,20.0
4693,0,4693,[ 64 313 483 318 187],618,5,19223,4.095227950575202,80.0,20.0
4694,0,4694,[ 64 313 483 318 187],618,5,19228,4.09542066027689,80.0,20.0
4695,0,4695,[ 64 313 483 318 187],214,5,19233,4.0956132879046,80.0,20.0
4696,0,4696,[ 64 313 483 318 187],214,5,19238,4.0958058335107514,80.0,20.0
4697,0,4697,[288  82 204 180 200],405,3,19241,4.095572584078331,0.0,20.0
4698,0,4698,[185 191 176 144 173],805,4,19245,4.095552245158545,0.0,0.0
4699,0,4699,[ 64 313 483 318 187],214,5,19250,4.095744680851064,80.0,20.0
4700,0,4700,[323 742  96 132 568],416,4,19254,4.09572431397575,0.0,0.0
4701,0,4701,[187 144 276 117 483],618,4,19258,4.095703955763505,20.0,0.0
4702,0,4702,[  1 748   4 196 235],805,1,19259,4.095045715500744,0.0,0.0
4703,0,4703,[ 64 313 483 318 187],214,5,19264,4.095238095238095,80.0,20.0
4704,0,4704,[ 64 313 483 318 187],618,5,19269,4.095430393198725,80.0,20.0
4705,0,4705,[748 318 471  69 423],721,4,19273,4.095410114747131,20.0,0.0
4706,0,4706,[273 168 222  15 235],854,3,19276,4.0951773953686,0.0,0.0
4707,0,4707,[ 97 234 273  98 300],297,3,19279,4.094944774851317,0.0,20.0
4708,0,4708,[191 196  12 211 143],43,5,19284,4.095136971756212,20.0,0.0
4709,0,4709,[ 64 313 483 318 187],214,5,19289,4.095329087048833,80.0,20.0
4710,0,4710,[ 64 313 483 318 187],618,5,19294,4.09552112078115,80.0,20.0
4711,0,4711,[ 11  69 234 496 237],437,3,19297,4.095288624787776,0.0,0.0
4712,0,4712,[ 70   1   8 300 173],297,3,19300,4.095056227455973,0.0,0.0
4713,0,4713,[132 181  79 121   1],588,5,19305,4.095248196860416,0.0,20.0
4714,0,4714,[323  28 328 125 228],721,3,19308,4.095015906680806,0.0,0.0
4715,0,4715,[168 568 125  69  89],417,3,19311,4.094783715012722,0.0,0.0
4716,0,4716,[ 64 313 483 318 187],214,5,19316,4.09497562009752,80.0,20.0
4717,0,4717,[ 69 318  25 174 403],43,5,19321,4.095167443832132,20.0,0.0
4718,0,4718,[328 655  70  12 144],416,5,19326,4.095359186268277,20.0,0.0
4719,0,4719,[268 196 215 182 234],297,2,19328,4.094915254237288,0.0,0.0
4720,0,4720,[204 742  22 588 117],52,5,19333,4.095106968862529,0.0,0.0
4721,0,4721,[ 64 313 483 318 187],618,5,19338,4.0952986022871665,80.0,20.0
4722,0,4722,[435 282 302  98 185],297,3,19341,4.095066694897311,0.0,20.0
4723,0,4723,[300 215 333 179 257],416,3,19344,4.094834885690093,0.0,0.0
4724,0,4724,[ 64 313 483 318 187],214,5,19349,4.0950264550264555,80.0,20.0
4725,0,4725,[ 64 313 483 318 187],618,5,19354,4.0952179432924245,80.0,20.0
4726,0,4726,[237 216 200 127 568],922,1,19355,4.094563147873916,0.0,0.0
4727,0,4727,[ 64 313 483 318 187],618,5,19360,4.094754653130288,80.0,20.0
4728,0,4728,[ 64 313 483 318 187],214,5,19365,4.094946077394798,80.0,20.0
4729,0,4729,[ 64  89 275 135 603],214,3,19368,4.094714587737844,20.0,0.0
4730,0,4730,[403 475 258 568 100],805,3,19371,4.094483195941661,0.0,0.0
4731,0,4731,[  8   9 151 194 257],854,3,19374,4.09425190194421,0.0,0.0
4732,0,4732,[121 215 403 118 237],43,5,19379,4.094443270652863,0.0,0.0
4733,0,4733,[ 64 313 483 318 187],618,5,19384,4.094634558512886,80.0,20.0
4734,0,4734,[ 64 313 483 318 187],214,5,19389,4.094825765575502,80.0,20.0
4735,0,4735,[  8 323 172 300  22],416,4,19393,4.094805743243243,0.0,0.0
4736,0,4736,[172 301  82 161 117],588,5,19398,4.094996833438885,0.0,0.0
4737,0,4737,[ 64 313 483 318 187],618,5,19403,4.095187842971718,80.0,20.0
4738,0,4738,[117 515 385 318  70],416,5,19408,4.095378771892804,20.0,0.0
4739,0,4739,[172 423 328  50  71],43,5,19413,4.095569620253165,0.0,20.0
4740,0,4740,[268 216 127 318 153],721,5,19418,4.095760388103775,20.0,0.0
4741,0,4741,[ 98 185 210 216 405],198,3,19421,4.09552931252636,0.0,20.0
4742,0,4742,[ 88 210 202  70 302],43,5,19426,4.095720008433481,0.0,0.0
4743,0,4743,[ 64 313 483 318 187],214,5,19431,4.095910623946037,80.0,20.0
4744,0,4744,[181 204  98 175 294],49,2,19433,4.095468914646997,0.0,40.0
4745,0,4745,[121   1 211 176 182],416,5,19438,4.0956595027391485,0.0,0.0
4746,0,4746,[202 216 151 172  82],416,4,19442,4.09563935116916,0.0,0.0
4747,0,4747,[ 25   8  15 271 275],43,4,19446,4.095619208087616,0.0,0.0
4748,0,4748,[508 237 357 144 748],297,3,19449,4.095388502842704,0.0,0.0
4749,0,4749,[546 161  82 322 211],417,2,19451,4.094947368421052,0.0,0.0
4750,0,4750,[174 357 222  82 588],601,3,19454,4.0947169017049045,0.0,0.0
4751,0,4751,[269 678 144 100 742],654,4,19458,4.09469696969697,0.0,0.0
4752,0,4752,[132 118  15  98 273],618,3,19461,4.094466652640437,0.0,20.0
4753,0,4753,[ 64 313 483 318 187],214,5,19466,4.09465713083719,80.0,20.0
4754,0,4754,[ 64 313 483 318 187],618,5,19471,4.0948475289169295,80.0,20.0
4755,0,4755,[211 144  64 313  50],43,5,19476,4.095037846930193,40.0,40.0
4756,0,4756,[ 64 313 483 318 187],618,5,19481,4.095228084927475,80.0,20.0
4757,0,4757,[ 64 313 483 318 187],214,5,19486,4.0954182429592265,80.0,20.0
4758,0,4758,[ 64 313 483 318 187],214,5,19491,4.095608321075856,80.0,20.0
4759,0,4759,[191 294 302   7 151],62,3,19494,4.095378151260504,0.0,0.0
4760,0,4760,[405 173  11 191 195],417,4,19498,4.095358118042428,0.0,0.0
4761,0,4761,[173 222 302 271 546],62,3,19501,4.095128097438051,0.0,0.0
4762,0,4762,[ 96 176 200 271 144],854,2,19503,4.094688221709007,0.0,0.0
4763,0,4763,[ 64 313 483 318 187],618,5,19508,4.09487825356843,80.0,20.0
4764,0,4764,[ 64 313 483 318 187],618,5,19513,4.095068205666317,80.0,20.0
4765,0,4765,[ 69 196 328 288  79],416,5,19518,4.095258078052875,0.0,20.0
4766,0,4766,[496 118  71 323 318],416,3,19521,4.095028319697923,20.0,0.0
4767,0,4767,[237  12 568 100  28],416,4,19525,4.095008389261745,20.0,0.0
4768,0,4768,[ 64 265 183 210 176],405,2,19527,4.094569092052842,20.0,0.0
4769,0,4769,[168 132 183 117  12],437,2,19529,4.09412997903564,20.0,0.0
4770,0,4770,[196 202 435 151  70],354,1,19530,4.093481450429679,0.0,0.0
4771,0,4771,[ 64 313 483 318 187],618,5,19535,4.093671416596814,80.0,20.0
4772,0,4772,[ 64 313 483 318 187],618,5,19540,4.093861303163629,80.0,20.0
4773,0,4773,[ 64 313 483 318 187],618,5,19545,4.094051110180143,80.0,20.0
4774,0,4774,[ 64 313 483 318 187],618,5,19550,4.0942408376963355,80.0,20.0
4775,0,4775,[ 64 313 483 318 187],618,5,19555,4.094430485762144,80.0,20.0
4776,0,4776,[ 97 204 238 179  95],198,2,19557,4.093992045216663,0.0,0.0
4777,0,4777,[161 132 273 200  71],416,5,19562,4.094181665969025,0.0,0.0
4778,0,4778,[742 286 125 238 294],854,1,19563,4.09353421217828,0.0,0.0
4779,0,4779,[ 64 313 483 318 187],214,5,19568,4.093723849372385,80.0,20.0
4780,0,4780,[ 64 313 483 318 187],618,5,19573,4.09391340723698,80.0,20.0
4781,0,4781,[ 64 183 385 181  96],405,2,19575,4.093475533249686,20.0,20.0
4782,0,4782,[200 181 121 275  25],711,4,19579,4.093455989964458,0.0,20.0
4783,0,4783,[ 64 313 483 318 187],214,5,19584,4.093645484949833,80.0,20.0
4784,0,4784,[ 64 313 483 318 187],214,5,19589,4.093834900731452,80.0,20.0
4785,0,4785,[742  88 588 216 496],642,4,19593,4.093815294609277,0.0,0.0
4786,0,4786,[117 568 385 175 100],43,4,19597,4.093795696678504,0.0,0.0
4787,0,4787,[ 70  56 268 125 423],416,5,19602,4.093984962406015,0.0,0.0
4788,0,4788,[117  50 195 168 427],230,4,19606,4.093965337231155,0.0,20.0
4789,0,4789,[265 357  95 228 385],198,1,19607,4.0933194154488515,0.0,0.0
4790,0,4790,[ 64 313 483 318 187],618,5,19612,4.093508662074724,80.0,20.0
4791,0,4791,[ 82 234   7 176 496],416,5,19617,4.093697829716193,0.0,0.0
4792,0,4792,[271 117 100 135  56],805,3,19620,4.09346964322971,0.0,0.0
4793,0,4793,[603 151 168 197 597],416,3,19623,4.093241551939925,0.0,0.0
4794,0,4794,[471 174 323 655 282],345,2,19625,4.092805005213765,0.0,0.0
4795,0,4795,[186 273 204 144   9],618,3,19628,4.092577147623019,0.0,0.0
4796,0,4796,[ 64 313 483 318 187],618,5,19633,4.092766312278507,80.0,20.0
4797,0,4797,[ 64 313 483 318 187],618,5,19638,4.092955398082534,80.0,20.0
4798,0,4798,[302   1  96 111 403],417,2,19640,4.092519274848927,0.0,0.0
4799,0,4799,[405 588   8 568 118],654,4,19644,4.0925,0.0,0.0
4800,0,4800,[  8 215  70  69 276],437,2,19646,4.092064153301395,0.0,0.0
4801,0,4801,[403 269 185 204  71],711,3,19649,4.091836734693878,0.0,0.0
4802,0,4802,[546   9 144  11 168],805,1,19650,4.0911930043722675,0.0,0.0
4803,0,4803,[ 64 313 483 318 187],214,5,19655,4.091382181515404,80.0,20.0
4804,0,4804,[ 64 313 483 318 187],618,5,19660,4.091571279916753,80.0,20.0
4805,0,4805,[ 64 313 483 318 187],214,5,19665,4.091760299625468,80.0,20.0
4806,0,4806,[111 515 258 403 185],417,3,19668,4.091533180778032,0.0,0.0
4807,0,4807,[ 64 313 483 318 187],618,5,19673,4.091722129783694,80.0,20.0
4808,0,4808,[269 357 276 475 172],214,2,19675,4.09128716988979,0.0,0.0
4809,0,4809,[ 64 313 483 318 187],618,5,19680,4.091476091476092,80.0,20.0
4810,0,4810,[286  71 216 597  95],416,3,19683,4.091249220536271,0.0,0.0
4811,0,4811,[ 64 313 483 318 187],214,5,19688,4.091438071487946,80.0,20.0
4812,0,4812,[210 546  97  95 132],416,3,19691,4.091211302721796,0.0,0.0
4813,0,4813,[235 286  56  69 269],297,3,19694,4.090984628167844,0.0,0.0
4814,0,4814,[302 191 271 273 546],297,2,19696,4.0905503634475595,0.0,0.0
4815,0,4815,[127 118 328  69 237],43,5,19701,4.090739202657807,0.0,0.0
4816,0,4816,[ 64 313 483 318 187],618,5,19706,4.090927963462736,80.0,20.0
4817,0,4817,[ 22  50 323  82 237],721,3,19709,4.090701535907016,0.0,20.0
4818,0,4818,[ 64 313 483 318 187],618,5,19714,4.090890226188006,80.0,20.0
4819,0,4819,[313   1  12  64 186],618,5,19719,4.0910788381742735,60.0,20.0
4820,0,4820,[174 196 176 216 655],417,3,19722,4.09085252022402,0.0,0.0
4821,0,4821,[127  22 742  95 215],416,4,19726,4.090833678971381,0.0,0.0
4822,0,4822,[ 64 313 483 318 187],214,5,19731,4.091022185361808,80.0,20.0
4823,0,4823,[403 121  64 168 210],43,5,19736,4.091210613598673,20.0,0.0
4824,0,4824,[ 64 313 483 318 187],214,5,19741,4.09139896373057,80.0,20.0
4825,0,4825,[117 265 427 471 204],618,3,19744,4.091172813924575,0.0,0.0
4826,0,4826,[ 64 313 483 318 187],214,5,19749,4.09136109384711,80.0,20.0
4827,0,4827,[301 186 748 275 180],437,3,19752,4.091135045567523,0.0,0.0
4828,0,4828,[300 191 181 204 174],505,2,19754,4.090702008697453,0.0,20.0
4829,0,4829,[ 64 313 483 318 187],618,5,19759,4.090890269151139,80.0,20.0
4830,0,4830,[ 71 151 405 202 655],416,4,19763,4.090871455185262,0.0,0.0
4831,0,4831,[ 64 313 483 318 187],214,5,19768,4.091059602649007,80.0,20.0
4832,0,4832,[197 151 238 202 191],437,5,19773,4.0912476722532585,0.0,0.0
4833,0,4833,[ 64 313 483 318 187],618,5,19778,4.0914356640463385,80.0,20.0
4834,0,4834,[301 121 100  98 151],416,4,19782,4.0914167528438465,0.0,20.0
4835,0,4835,[ 64 313 483 318 187],618,5,19787,4.091604631927212,80.0,20.0
4836,0,4836,[471 294  82 258 173],505,2,19789,4.091172214182344,0.0,0.0
4837,0,4837,[ 64 313 483 318 187],214,5,19794,4.091360066143034,80.0,20.0
4838,0,4838,[313 427 187  64 200],416,5,19799,4.091547840462906,40.0,20.0
4839,0,4839,[ 64 313 483 318 187],618,5,19804,4.0917355371900825,80.0,20.0
4840,0,4840,[ 64 322 301 127 655],721,4,19808,4.091716587481925,20.0,0.0
4841,0,4841,[655  12 748 168 357],805,3,19811,4.091491119372161,20.0,0.0
4842,0,4842,[ 64 313 483 318 187],618,5,19816,4.091678711542432,80.0,20.0
4843,0,4843,[748   1 132 181 318],642,3,19819,4.091453344343518,20.0,20.0
4844,0,4844,[202 196 144 185 748],417,3,19822,4.091228070175439,0.0,0.0
4845,0,4845,[ 64 313 483 318 187],618,5,19827,4.091415600495254,80.0,20.0
4846,0,4846,[ 64 313 483 318 187],618,5,19832,4.091603053435114,80.0,20.0
4847,0,4847,[135  95  82  96 265],230,3,19835,4.091377887788779,0.0,0.0
4848,0,4848,[100 222 111 173 196],297,4,19839,4.09135904310167,0.0,0.0
4849,0,4849,[ 64 313 483 318 187],214,5,19844,4.091546391752577,80.0,20.0
4850,0,4850,[ 64 313 483 318 187],214,5,19849,4.091733663162235,80.0,20.0
4851,0,4851,[204 186 215 151 211],437,3,19852,4.091508656224238,0.0,0.0
4852,0,4852,[182 185  70 258 144],416,5,19857,4.091695858232021,0.0,0.0
4853,0,4853,[ 64 313 483 318 187],618,5,19862,4.091882983106716,80.0,20.0
4854,0,4854,[ 64 313 483 318 187],214,5,19867,4.092070030895983,80.0,20.0
4855,0,4855,[ 64 313 483 318 187],214,5,19872,4.092257001647447,80.0,20.0
4856,0,4856,[211 385  11 748 132],416,5,19877,4.092443895408689,0.0,0.0
4857,0,4857,[ 64 313 483 318 187],618,5,19882,4.092630712227254,80.0,20.0
4858,0,4858,[111 185 210 183 117],618,3,19885,4.092405844824038,0.0,0.0
4859,0,4859,[ 64 313 483 318 187],214,5,19890,4.092592592592593,80.0,20.0
4860,0,4860,[ 22 172  71  82 176],405,3,19893,4.092367825550299,0.0,0.0
4861,0,4861,[ 98   7   1 748 182],297,2,19895,4.0919374742904155,0.0,20.0
4862,0,4862,[143 742 271 508 546],297,2,19897,4.091507300020563,0.0,0.0
4863,0,4863,[ 64 313 483 318 187],618,5,19902,4.091694078947368,80.0,20.0
4864,0,4864,[423   8  98 204 100],805,2,19904,4.091264131551902,0.0,20.0
4865,0,4865,[ 64 313 483 318 187],618,5,19909,4.091450883682696,80.0,20.0
4866,0,4866,[ 64 313 483 318 187],618,5,19914,4.091637559071296,80.0,20.0
4867,0,4867,[496 423   7 568 385],618,5,19919,4.091824157764996,0.0,0.0
4868,0,4868,[ 64 313 483 318 187],618,5,19924,4.092010679811049,80.0,20.0
4869,0,4869,[ 64 313 483 318 187],214,5,19929,4.092197125256673,80.0,20.0
4870,0,4870,[ 89 268 168 302  98],214,3,19932,4.091972900841716,0.0,20.0
4871,0,4871,[258 161  71 202 200],805,1,19933,4.091338259441708,0.0,0.0
4872,0,4872,[ 64 313 483 318 187],618,5,19938,4.091524728093577,80.0,20.0
4873,0,4873,[135 180 211 100 191],417,3,19941,4.091300779647107,0.0,0.0
4874,0,4874,[117 153 286 118 176],417,5,19946,4.09148717948718,0.0,0.0
4875,0,4875,[186  28  98 132 181],230,5,19951,4.091673502871206,0.0,40.0
4876,0,4876,[  4 111 603  56  69],416,5,19956,4.091859749846217,0.0,0.0
4877,0,4877,[ 64 313 483 318 187],618,5,19961,4.092045920459205,80.0,20.0
4878,0,4878,[ 15 235  79 603 597],416,3,19964,4.091822094691535,0.0,0.0
4879,0,4879,[200 268 588 286  28],345,2,19966,4.091393442622951,0.0,0.0
4880,0,4880,[235 257 195  89 174],922,3,19969,4.091169842245441,0.0,0.0
4881,0,4881,[238  69 183 288 435],437,1,19970,4.090536665301106,0.0,20.0
4882,0,4882,[ 64 313 483 318 187],618,5,19975,4.090722916240017,80.0,20.0
4883,0,4883,[ 64 313 483 318 187],618,5,19980,4.090909090909091,80.0,20.0
4884,0,4884,[ 64 313 483 318 187],618,5,19985,4.091095189355169,80.0,20.0
4885,0,4885,[301 174   8 183 121],416,5,19990,4.091281211625051,0.0,0.0
4886,0,4886,[ 64 313 483 318 187],214,5,19995,4.0914671577655,80.0,20.0
4887,0,4887,[111 185 238 196 385],417,3,19998,4.091243862520458,0.0,0.0
4888,0,4888,[ 64   1 475 180 195],417,5,20003,4.091429740233177,20.0,0.0
4889,0,4889,[ 22  71 143 127 174],618,5,20008,4.09161554192229,0.0,0.0
4890,0,4890,[ 64 313 483 318 187],618,5,20013,4.09180126763443,80.0,20.0
4891,0,4891,[ 64 313 483 318 187],214,5,20018,4.09198691741619,80.0,20.0
4892,0,4892,[496 257 181 172 118],417,1,20019,4.091354996934396,0.0,20.0
4893,0,4893,[ 64 313 483 318 187],618,5,20024,4.091540662035145,80.0,20.0
4894,0,4894,[588 211 257 508 655],417,2,20026,4.091113381001022,0.0,0.0
4895,0,4895,[ 56  50 655 234 568],805,3,20029,4.090890522875817,0.0,20.0
4896,0,4896,[195 173 483  12 748],437,4,20033,4.090871962425975,40.0,0.0
4897,0,4897,[ 64 313 483 318 187],618,5,20038,4.091057574520212,80.0,20.0
4898,0,4898,[ 64 313 483 318 187],618,5,20043,4.091243110838946,80.0,20.0
4899,0,4899,[ 64 313 483 318 187],618,5,20048,4.091428571428572,80.0,20.0
4900,0,4900,[ 64 313 483 318 187],214,5,20053,4.091613956335442,80.0,20.0
4901,0,4901,[ 64 313 483 318 187],214,5,20058,4.091799265605875,80.0,20.0
4902,0,4902,[ 15 273 323 202  11],417,3,20061,4.091576585763818,0.0,0.0
4903,0,4903,[210 216 186 127 748],373,4,20065,4.091557911908646,0.0,0.0
4904,0,4904,[  1 405 318 238 111],43,4,20069,4.091539245667686,20.0,0.0
4905,0,4905,[  1 172  28 546  50],62,3,20072,4.091316754993885,0.0,20.0
4906,0,4906,[568 318  82 182   1],198,3,20075,4.091094355003057,20.0,0.0
4907,0,4907,[ 88 302 300 597 210],416,3,20078,4.090872045639772,0.0,0.0
4908,0,4908,[ 64 313 483 318 187],618,5,20083,4.091057241800774,80.0,20.0
4909,0,4909,[ 64 313 483 318 187],618,5,20088,4.091242362525458,80.0,20.0
4910,0,4910,[100  22 202 210 568],373,3,20091,4.091020158827122,0.0,0.0
4911,0,4911,[ 70 187 403 132 143],416,5,20096,4.091205211726384,0.0,0.0
4912,0,4912,[ 64 313 483 318 187],214,5,20101,4.09139018929371,80.0,20.0
4913,0,4913,[ 69 257 515 234  96],417,2,20103,4.090964590964591,0.0,0.0
4914,0,4914,[655 276 135 222  79],354,0,20103,4.090132248219735,0.0,0.0
4915,0,4915,[ 64 313 483 318 187],618,5,20108,4.090317331163548,80.0,20.0
4916,0,4916,[ 64 313 483 318 187],618,5,20113,4.0905023388244866,80.0,20.0
4917,0,4917,[ 64 313 483 318 187],214,5,20118,4.090687271248475,80.0,20.0
4918,0,4918,[ 64 313 483 318 187],214,5,20123,4.090872128481399,80.0,20.0
4919,0,4919,[301 597 300 385 496],416,4,20127,4.090853658536585,0.0,0.0
4920,0,4920,[180 176  15 195 168],62,4,20131,4.090835196098354,0.0,0.0
4921,0,4921,[ 64 313 483 318 187],214,5,20136,4.091019910605445,80.0,20.0
4922,0,4922,[202 183 176  98 234],297,3,20139,4.090798293723339,0.0,20.0
4923,0,4923,[742 216 173 211  82],43,5,20144,4.090982940698619,0.0,0.0
4924,0,4924,[ 71 403 333  15 294],416,5,20149,4.0911675126903555,0.0,0.0
4925,0,4925,[144  98 197 286 222],854,3,20152,4.090946000812018,0.0,20.0
4926,0,4926,[ 98 288 302 151 127],854,4,20156,4.090927542114877,0.0,40.0
4927,0,4927,[269 191 423 127 196],416,5,20161,4.091112012987013,0.0,0.0
4928,0,4928,[ 64 313 483 318 187],214,5,20166,4.091296409007913,80.0,20.0
4929,0,4929,[ 64 313 483 318 187],618,5,20171,4.0914807302231235,80.0,20.0
4930,0,4930,[268 302  25 403 202],416,5,20176,4.0916649766781585,0.0,0.0
4931,0,4931,[ 64 313 483 318 187],618,5,20181,4.091849148418492,80.0,20.0
4932,0,4932,[ 64 313 483 318 187],214,5,20186,4.09203324548956,80.0,20.0
4933,0,4933,[ 64 313 483 318 187],214,5,20191,4.092217267936765,80.0,20.0
4934,0,4934,[ 64 313 483 318 187],214,5,20196,4.092401215805471,80.0,20.0
4935,0,4935,[ 64 313 483 318 187],618,5,20201,4.0925850891410045,80.0,20.0
4936,0,4936,[ 64 313 483 318 187],618,5,20206,4.092768887988657,80.0,20.0
4937,0,4937,[ 64 313 483 318 187],618,5,20211,4.092952612393682,80.0,20.0
4938,0,4938,[ 64 313 483 318 187],618,5,20216,4.093136262401296,80.0,20.0
4939,0,4939,[ 64 313 483 318 187],618,5,20221,4.09331983805668,80.0,20.0
4940,0,4940,[568 515 176 288 151],417,3,20224,4.0930985630439185,0.0,20.0
4941,0,4941,[ 64 313 483 318 187],214,5,20229,4.093282072035613,80.0,20.0
4942,0,4942,[ 64 313 483 318 187],214,5,20234,4.093465506777261,80.0,20.0
4943,0,4943,[ 64 313 483 318 187],214,5,20239,4.093648867313916,80.0,20.0
4944,0,4944,[294 196 275  50  97],921,3,20242,4.093427704752275,0.0,20.0
4945,0,4945,[ 64 313 483 318 187],618,5,20247,4.0936109987868985,80.0,20.0
4946,0,4946,[202 742 234 117 597],416,4,20251,4.09359207600566,0.0,0.0
4947,0,4947,[ 64 313 483 318 187],618,5,20256,4.093775262732417,80.0,20.0
4948,0,4948,[258 301 175  95  56],43,4,20260,4.093756314406951,0.0,0.0
4949,0,4949,[357 195  69 132 161],230,4,20264,4.0937373737373735,0.0,0.0
4950,0,4950,[ 64 313 483 318 187],618,5,20269,4.093920420117148,80.0,20.0
4951,0,4951,[196 678 427 161 215],416,4,20273,4.093901453957997,0.0,0.0
4952,0,4952,[ 64 313 483 318 187],618,5,20278,4.094084393296992,80.0,20.0
4953,0,4953,[172 302 508 181 288],62,3,20281,4.093863544610416,0.0,40.0
4954,0,4954,[202 318 125  12   7],314,5,20286,4.094046417759839,40.0,0.0
4955,0,4955,[151 204 173 161 196],345,4,20290,4.094027441485069,0.0,0.0
4956,0,4956,[ 64 313 483 318 187],214,5,20295,4.0942102077869675,80.0,20.0
4957,0,4957,[ 64 313 483 318 187],214,5,20300,4.09439290036305,80.0,20.0
4958,0,4958,[ 64 313 483 318 187],214,5,20305,4.094575519257915,80.0,20.0
4959,0,4959,[176 588  25  96 228],805,3,20308,4.094354838709678,0.0,0.0
4960,0,4960,[151  82 322  89  71],805,2,20310,4.093932674863939,0.0,0.0
4961,0,4961,[ 64 313 483 318 187],618,5,20315,4.094115276098347,80.0,20.0
4962,0,4962,[ 64 313 483 318 187],214,5,20320,4.094297803747733,80.0,20.0
4963,0,4963,[ 64 313 483 318 187],214,5,20325,4.094480257856567,80.0,20.0
4964,0,4964,[ 64 313 483 318 187],214,5,20330,4.094662638469285,80.0,20.0
4965,0,4965,[ 64 313 483 318 187],214,5,20335,4.094844945630286,80.0,20.0
4966,0,4966,[678 121 546 180  88],805,1,20336,4.0942218643044095,0.0,0.0
4967,0,4967,[ 64 313 483 318 187],618,5,20341,4.094404186795491,80.0,20.0
4968,0,4968,[238 271 111 191 286],854,3,20344,4.09418394043067,0.0,0.0
4969,0,4969,[ 64 313 483 318 187],214,5,20349,4.094366197183098,80.0,20.0
4970,0,4970,[ 64 313 483 318 187],214,5,20354,4.094548380607524,80.0,20.0
4971,0,4971,[237 603 151   1 195],854,2,20356,4.094127111826227,0.0,0.0
4972,0,4972,[ 64 313 483 318 187],618,5,20361,4.094309270058315,80.0,20.0
4973,0,4973,[ 64 313 483 318 187],618,5,20366,4.09449135504624,80.0,20.0
4974,0,4974,[ 64 313 483 318 187],214,5,20371,4.094673366834171,80.0,20.0
4975,0,4975,[ 64 313 483 318 187],214,5,20376,4.094855305466238,80.0,20.0
4976,0,4976,[ 64 313 483 318 187],214,5,20381,4.095037170986538,80.0,20.0
4977,0,4977,[176 228 172 216   1],198,4,20385,4.09501807955002,0.0,0.0
4978,0,4978,[403 269  15 204 211],373,4,20389,4.094998995782285,0.0,0.0
4979,0,4979,[265 423 588 238 121],416,5,20394,4.095180722891566,0.0,0.0
4980,0,4980,[ 64 313 483 318 187],214,5,20399,4.095362377032725,80.0,20.0
4981,0,4981,[ 64 313 483 318 187],214,5,20404,4.095543958249699,80.0,20.0
4982,0,4982,[588  11 111 568  50],345,4,20408,4.095524784266506,0.0,20.0
4983,0,4983,[ 12 742  15 301 471],416,5,20413,4.095706260032102,20.0,0.0
4984,0,4984,[ 64 313 483 318 187],618,5,20418,4.095887662988967,80.0,20.0
4985,0,4985,[655 200 423 385 222],805,2,20420,4.095467308463698,0.0,0.0
4986,0,4986,[ 64 313 483 318 187],214,5,20425,4.095648686585121,80.0,20.0
4987,0,4987,[ 70  56  12 257 121],416,4,20429,4.095629510825982,20.0,0.0
4988,0,4988,[168 597 302 127 132],62,3,20432,4.095409901783925,0.0,0.0
4989,0,4989,[202 127  56 181 275],618,3,20435,4.095190380761523,0.0,20.0
4990,0,4990,[288 180  97 200 568],405,2,20437,4.094770587056702,0.0,20.0
4991,0,4991,[ 64 313 483 318 187],618,5,20442,4.094951923076923,80.0,20.0
4992,0,4992,[286 568 257   7 100],416,4,20446,4.094932906068496,0.0,0.0
4993,0,4993,[ 82 210 237 176  11],230,5,20451,4.095114136964357,0.0,0.0
4994,0,4994,[ 64 313 483 318 187],618,5,20456,4.095295295295295,80.0,20.0
4995,0,4995,[ 64 313 483 318 187],618,5,20461,4.095476381104884,80.0,20.0
4996,0,4996,[ 64 313 483 318 187],214,5,20466,4.095657394436662,80.0,20.0
4997,0,4997,[268  22 328 100 748],416,5,20471,4.095838335334133,0.0,0.0
4998,0,4998,[269  12 151 603 204],297,3,20474,4.095619123824765,20.0,0.0
4999,0,4999,[ 64 313 483 318 187],618,5,20479,4.0958,80.0,20.0
5000,0,5000,[ 64 313 483 318 187],214,5,20484,4.0959808038392325,80.0,20.0
5001,0,5001,[ 79 313 655 748 173],751,2,20486,4.095561775289884,20.0,20.0
5002,0,5002,[  1 288  56 121 318],854,3,20489,4.095342794323406,20.0,20.0
5003,0,5003,[215 216  15 200 127],12,4,20493,4.095323741007194,0.0,0.0
5004,0,5004,[ 64 483 313 318 187],214,5,20498,4.095504495504495,80.0,20.0
5005,0,5005,[742 204 176   4 322],805,1,20499,4.0948861366360365,0.0,0.0
5006,0,5006,[357 496 125 655 403],417,4,20503,4.094867185939685,0.0,0.0
5007,0,5007,[174 151 197 237 471],345,4,20507,4.094848242811501,0.0,0.0
5008,0,5008,[ 64 483 313 318 187],618,5,20512,4.095028947893791,80.0,20.0
5009,0,5009,[180  15  69 318 288],854,4,20516,4.0950099800399204,20.0,20.0
5010,0,5010,[ 64 483 313 318 187],214,5,20521,4.09519058072241,80.0,20.0
5011,0,5011,[ 64 483 313 318 187],214,5,20526,4.09537110933759,80.0,20.0
5012,0,5012,[423 588 742 288 168],805,1,20527,4.09475364053461,0.0,20.0
5013,0,5013,[ 70  71  64   1 237],642,4,20531,4.094734742720383,20.0,0.0
5014,0,5014,[ 64 483 313 318 187],618,5,20536,4.094915254237288,80.0,20.0
5015,0,5015,[ 64 483 313 318 187],618,5,20541,4.095095693779904,80.0,20.0
5016,0,5016,[176 210 238  28 191],618,3,20544,4.094877416782938,0.0,0.0
5017,0,5017,[ 64 483 313 318 187],618,5,20549,4.0950577919489834,80.0,20.0
5018,0,5018,[265 144 202 286 211],373,2,20551,4.094640366606894,0.0,0.0
5019,0,5019,[237 151 118 313 288],416,2,20553,4.0942231075697215,20.0,40.0
5020,0,5020,[294  28 678 215  22],721,3,20556,4.0940051782513445,0.0,0.0
5021,0,5021,[ 64 483 313 318 187],214,5,20561,4.094185583432895,80.0,20.0
5022,0,5022,[127 121  82 185   4],198,1,20562,4.0935695799323115,0.0,0.0
5023,0,5023,[ 70 194 185  69 204],405,3,20565,4.093351910828026,0.0,0.0
5024,0,5024,[ 64 483 313 318 187],214,5,20570,4.093532338308457,80.0,20.0
5025,0,5025,[211 117 135 294 179],417,4,20574,4.093513728611222,0.0,0.0
5026,0,5026,[210 273 202 143   7],416,5,20579,4.093694052118559,0.0,0.0
5027,0,5027,[ 64 483 313 318 187],214,5,20584,4.09387430389817,80.0,20.0
5028,0,5028,[ 64 483 313 318 187],618,5,20589,4.094054483992841,80.0,20.0
5029,0,5029,[ 11 172  96 127 200],198,5,20594,4.094234592445328,0.0,0.0
5030,0,5030,[118 111 127  15 215],618,2,20596,4.093818326376466,0.0,0.0
5031,0,5031,[ 64 483 313 318 187],214,5,20601,4.093998410174881,80.0,20.0
5032,0,5032,[210 191 271 302  98],297,3,20604,4.093781045102324,0.0,20.0
5033,0,5033,[200 179 273  50 181],417,2,20606,4.093365117203019,0.0,40.0
5034,0,5034,[ 79 143 144 301 197],711,4,20610,4.093346573982125,0.0,0.0
5035,0,5035,[ 28 475 183 403  71],805,3,20613,4.093129467831613,0.0,0.0
5036,0,5036,[ 64 483 313 318 187],618,5,20618,4.093309509628747,80.0,20.0
5037,0,5037,[ 64 483 313 318 187],214,5,20623,4.093489479952362,80.0,20.0
5038,0,5038,[ 64 483 313 318 187],214,5,20628,4.093669378845009,80.0,20.0
5039,0,5039,[173 144 174 300   1],43,5,20633,4.093849206349207,0.0,0.0
5040,0,5040,[125 328 276  28 568],62,2,20635,4.093433842491569,0.0,0.0
5041,0,5041,[196  15 258 546 144],416,4,20639,4.093415311384371,0.0,0.0
5042,0,5042,[302 235 228 508 748],417,1,20640,4.092801903628793,0.0,0.0
5043,0,5043,[127   7 483 135 173],62,5,20645,4.092981760507533,20.0,0.0
5044,0,5044,[ 64 483 313 318 187],214,5,20650,4.093161546085233,80.0,20.0
5045,0,5045,[496 196 423  71 191],618,5,20655,4.093341260404281,0.0,0.0
5046,0,5046,[143 234 268  12 186],588,5,20660,4.0935209035070335,20.0,0.0
5047,0,5047,[  7 483 322 471 111],854,2,20662,4.09310618066561,20.0,0.0
5048,0,5048,[ 64 483 313 318 187],618,5,20667,4.093285799168152,80.0,20.0
5049,0,5049,[185 118 286 132 182],416,4,20671,4.093267326732673,0.0,0.0
5050,0,5050,[50 71 11 28 79],405,4,20675,4.093248861611562,0.0,20.0
5051,0,5051,[ 64 483 313 318 187],618,5,20680,4.0934283452098175,80.0,20.0
5052,0,5052,[ 64 483 313 318 187],618,5,20685,4.093607757767662,80.0,20.0
5053,0,5053,[ 64 483 313 318 187],214,5,20690,4.093787099327265,80.0,20.0
5054,0,5054,[ 64 483 313 318 187],214,5,20695,4.093966369930762,80.0,20.0
5055,0,5055,[322 655 185 197 121],805,2,20697,4.093552215189874,0.0,0.0
5056,0,5056,[546  69 318 302   7],43,5,20702,4.093731461340716,20.0,0.0
5057,0,5057,[ 64 483 313 318 187],618,5,20707,4.093910636615263,80.0,20.0
5058,0,5058,[ 64 483 313 318 187],214,5,20712,4.094089741055544,80.0,20.0
5059,0,5059,[ 22  97 187 151 385],505,3,20715,4.0938735177865615,0.0,0.0
5060,0,5060,[597  71   9   4 265],618,3,20718,4.093657379964434,0.0,0.0
5061,0,5061,[ 64 483 313 318 187],214,5,20723,4.0938364282892135,80.0,20.0
5062,0,5062,[174 181 748  70 172],654,4,20727,4.093817894528936,0.0,20.0
5063,0,5063,[ 96   1 176  79  98],417,3,20730,4.093601895734597,0.0,20.0
5064,0,5064,[ 64 216 357 588 211],416,5,20735,4.093780848963474,20.0,0.0
5065,0,5065,[ 64 483 313 318 187],618,5,20740,4.093959731543624,80.0,20.0
5066,0,5066,[ 64 483 313 318 187],618,5,20745,4.094138543516874,80.0,20.0
5067,0,5067,[ 64 483 313 318 187],618,5,20750,4.09431728492502,80.0,20.0
5068,0,5068,[ 64 483 313 318 187],618,5,20755,4.094495955809824,80.0,20.0
5069,0,5069,[235 597 475 245 286],417,3,20758,4.094280078895464,0.0,0.0
5070,0,5070,[603 238 294 186 268],854,2,20760,4.093867087359495,0.0,0.0
5071,0,5071,[ 64 483 313 318 187],214,5,20765,4.094045741324921,80.0,20.0
5072,0,5072,[ 64 483 313 318 187],618,5,20770,4.094224324857087,80.0,20.0
5073,0,5073,[ 64 483 313 318 187],618,5,20775,4.094402837997635,80.0,20.0
5074,0,5074,[ 64 483 313 318 187],618,5,20780,4.094581280788177,80.0,20.0
5075,0,5075,[496 121  25 196 265],230,4,20784,4.094562647754137,0.0,0.0
5076,0,5076,[ 64 483 313 318 187],618,5,20789,4.094740988772897,80.0,20.0
5077,0,5077,[ 64 483 313 318 187],214,5,20794,4.094919259551005,80.0,20.0
5078,0,5078,[ 64 483 313 318 187],618,5,20799,4.095097460129947,80.0,20.0
5079,0,5079,[ 64 483 313 318 187],214,5,20804,4.095275590551181,80.0,20.0
5080,0,5080,[ 64 483 313 318 187],618,5,20809,4.095453650856131,80.0,20.0
5081,0,5081,[  4 118  56 238  25],416,4,20813,4.095434868162141,0.0,0.0
5082,0,5082,[ 64 483 313 318 187],214,5,20818,4.095612827070628,80.0,20.0
5083,0,5083,[282 357 294  69  22],630,1,20819,4.095003933910307,0.0,0.0
5084,0,5084,[183 318 483   8 427],601,4,20823,4.094985250737463,40.0,0.0
5085,0,5085,[121 235 181 100 216],262,0,20823,4.094180102241447,0.0,20.0
5086,0,5086,[125  56 143 181 427],887,5,20828,4.094358167878907,0.0,20.0
5087,0,5087,[111  96 405  12 748],805,2,20830,4.093946540880503,20.0,0.0
5088,0,5088,[333 121 132 222 181],588,4,20834,4.093928080172922,0.0,20.0
5089,0,5089,[210 282 286 313 655],416,5,20839,4.094106090373281,20.0,20.0
5090,0,5090,[ 64 483 313 318 187],214,5,20844,4.09428403064231,80.0,20.0
5091,0,5091,[ 64 483 313 318 187],214,5,20849,4.0944619010212095,80.0,20.0
5092,0,5092,[ 64 483 313 318 187],214,5,20854,4.094639701551149,80.0,20.0
5093,0,5093,[ 64 483 313 318 187],214,5,20859,4.0948174322732624,80.0,20.0
5094,0,5094,[  8 471 748  12 185],416,5,20864,4.094995093228656,20.0,0.0
5095,0,5095,[174  15  79 196 238],373,5,20869,4.095172684458399,0.0,0.0
5096,0,5096,[ 64 483 313 318 187],618,5,20874,4.095350206003531,80.0,20.0
5097,0,5097,[161  56 173 200 748],805,3,20877,4.0951353471949785,0.0,0.0
5098,0,5098,[655 144 275 237 153],416,4,20881,4.09511668954697,0.0,0.0
5099,0,5099,[333 161 245 121 173],345,1,20882,4.094509803921569,0.0,0.0
5100,0,5100,[ 64 483 313 318 187],618,5,20887,4.094687316212507,80.0,20.0
5101,0,5101,[403 185  88 655 202],805,2,20889,4.094276754214034,0.0,0.0
5102,0,5102,[153 323 176  64 151],417,4,20893,4.094258279443465,20.0,0.0
5103,0,5103,[174 111  12 121 282],588,3,20896,4.094043887147335,20.0,0.0
5104,0,5104,[ 64 483 313 318 187],618,5,20901,4.094221351616063,80.0,20.0
5105,0,5105,[ 22 475 132 385 323],416,3,20904,4.0940070505287895,0.0,0.0
5106,0,5106,[289 423 111 179 216],342,3,20907,4.093792833365968,0.0,0.0
5107,0,5107,[ 64 483 313 318 187],618,5,20912,4.093970242756461,80.0,20.0
5108,0,5108,[202 153  89 143 405],642,1,20913,4.093364650616559,0.0,0.0
5109,0,5109,[ 12 496 357 235 475],416,3,20916,4.093150684931507,20.0,0.0
5110,0,5110,[121 161 496  98 265],230,5,20921,4.093328115828605,0.0,20.0
5111,0,5111,[ 64 483 313 318 187],618,5,20926,4.093505477308295,80.0,20.0
5112,0,5112,[300  95 204 294 748],416,4,20930,4.093487189516917,0.0,0.0
5113,0,5113,[238  28 271 288 245],297,2,20932,4.093077825576848,0.0,20.0
5114,0,5114,[ 25 216 153 197 111],854,2,20934,4.09266862170088,0.0,0.0
5115,0,5115,[273 181 173 258 151],417,3,20937,4.092455043002346,0.0,20.0
5116,0,5116,[195 181 121 191 210],805,1,20938,4.0918506937658785,0.0,20.0
5117,0,5117,[ 64 483 313 318 187],214,5,20943,4.092028135990621,80.0,20.0
5118,0,5118,[ 64 483 313 318 187],618,5,20948,4.092205508888455,80.0,20.0
5119,0,5119,[357 202 181 168 215],405,4,20952,4.0921875,0.0,20.0
5120,0,5120,[ 64 483 313 318 187],214,5,20957,4.09236477250537,80.0,20.0
5121,0,5121,[403 405 176 153 245],62,3,20960,4.092151503319016,0.0,0.0
5122,0,5122,[ 64 483 313 318 187],618,5,20965,4.092328713644349,80.0,20.0
5123,0,5123,[ 64 483 313 318 187],618,5,20970,4.092505854800937,80.0,20.0
5124,0,5124,[135 195 179 302 175],405,3,20973,4.092292682926829,0.0,0.0
5125,0,5125,[403   7 265  96 161],417,1,20974,4.0916894264533745,0.0,0.0
5126,0,5126,[197 153  95 117 603],297,3,20977,4.09147649697679,0.0,0.0
5127,0,5127,[215  71  64  22 300],416,5,20982,4.091653666146646,20.0,0.0
5128,0,5128,[ 69  95 568 403 742],43,5,20987,4.091830766231234,0.0,0.0
5129,0,5129,[ 64 483 313 318 187],618,5,20992,4.092007797270955,80.0,20.0
5130,0,5130,[100 269 301 135  97],297,5,20997,4.092184759306178,0.0,0.0
5131,0,5131,[173 471 197 257 238],854,3,21000,4.091971940763835,0.0,0.0
5132,0,5132,[ 64 483 313 318 187],618,5,21005,4.09214884083382,80.0,20.0
5133,0,5133,[ 64 483 313 318 187],618,5,21010,4.0923256719906504,80.0,20.0
5134,0,5134,[ 64 483 313 318 187],214,5,21015,4.092502434274587,80.0,20.0
5135,0,5135,[ 64 483 313 318 187],618,5,21020,4.092679127725857,80.0,20.0
5136,0,5136,[ 64 483 313 318 187],618,5,21025,4.0928557523846605,80.0,20.0
5137,0,5137,[ 64 483 313 318 187],618,5,21030,4.093032308291164,80.0,20.0
5138,0,5138,[ 64 483 313 318 187],618,5,21035,4.093208795485503,80.0,20.0
5139,0,5139,[ 64 483 313 318 187],214,5,21040,4.093385214007782,80.0,20.0
5140,0,5140,[289   7 176 182 385],416,4,21044,4.093367049212215,0.0,0.0
5141,0,5141,[318 265  50 302 132],405,4,21048,4.093348891481914,20.0,20.0
5142,0,5142,[216  97  70 161 182],230,4,21052,4.093330740812755,0.0,0.0
5143,0,5143,[ 64 483 313 318 187],618,5,21057,4.0935069984447905,80.0,20.0
5144,0,5144,[588 546 318 237  50],416,3,21060,4.093294460641399,20.0,20.0
5145,0,5145,[144 132 322 204  12],314,4,21064,4.093276331130975,20.0,0.0
5146,0,5146,[ 64 483 313 318 187],214,5,21069,4.093452496599961,80.0,20.0
5147,0,5147,[187 318 313 301 597],416,4,21073,4.093434343434343,40.0,20.0
5148,0,5148,[ 98 515 210 121 568],417,2,21075,4.093027772382987,0.0,20.0
5149,0,5149,[ 64 483 313 318 187],214,5,21080,4.093203883495145,80.0,20.0
5150,0,5150,[ 64 483 313 318 187],618,5,21085,4.093379926227917,80.0,20.0
5151,0,5151,[ 64 483 313 318 187],618,5,21090,4.093555900621118,80.0,20.0
5152,0,5152,[ 64 483 313 318 187],618,5,21095,4.093731806714535,80.0,20.0
5153,0,5153,[ 64 483 313 318 187],214,5,21100,4.093907644547924,80.0,20.0
5154,0,5154,[655  95 385 197 216],805,1,21101,4.093307468477207,0.0,0.0
5155,0,5155,[237 222 100   7 257],43,5,21106,4.093483320403413,0.0,0.0
5156,0,5156,[ 64 483 313 318 187],214,5,21111,4.0936591041303085,80.0,20.0
5157,0,5157,[ 64 483 313 318 187],214,5,21116,4.093834819697557,80.0,20.0
5158,0,5158,[ 64 483 313 318 187],618,5,21121,4.094010467144796,80.0,20.0
5159,0,5159,[268  28  15 678 289],721,3,21124,4.093798449612403,0.0,0.0
5160,0,5160,[328 234 100 237  50],253,5,21129,4.093974036039527,0.0,20.0
5161,0,5161,[ 64 483 313 318 187],214,5,21134,4.094149554436265,80.0,20.0
5162,0,5162,[  8 265  11   7 742],230,4,21138,4.0941313190005815,0.0,0.0
5163,0,5163,[ 64 483 313 318 187],214,5,21143,4.094306738962045,80.0,20.0
5164,0,5164,[118  95 185 117 179],198,1,21144,4.093707647628267,0.0,0.0
5165,0,5165,[313 234 471 186 127],618,4,21148,4.093689508323655,20.0,20.0
5166,0,5166,[182 276 475 655 151],62,4,21152,4.093671376040255,0.0,0.0
5167,0,5167,[ 64 483 313 318 187],214,5,21157,4.093846749226006,80.0,20.0
5168,0,5168,[ 88 186  71 118  50],43,4,21161,4.093828593538402,0.0,20.0
5169,0,5169,[ 64 483 313 318 187],214,5,21166,4.094003868471954,80.0,20.0
5170,0,5170,[282 197 318  82 265],416,5,21171,4.094179075614001,20.0,0.0
5171,0,5171,[ 64 483 313 318 187],618,5,21176,4.094354215003867,80.0,20.0
5172,0,5172,[ 64 483 313 318 187],618,5,21181,4.094529286680843,80.0,20.0
5173,0,5173,[ 64 483 313 318 187],618,5,21186,4.094704290684191,80.0,20.0
5174,0,5174,[211 117 191 172 471],43,4,21190,4.0946859903381645,0.0,0.0
5175,0,5175,[300 301 237 258  22],721,3,21193,4.094474497681607,0.0,0.0
5176,0,5176,[238  70 204 144 174],618,2,21195,4.094069924666796,0.0,0.0
5177,0,5177,[ 64 483 313 318 187],214,5,21200,4.094244882193897,80.0,20.0
5178,0,5178,[ 64 483 313 318 187],214,5,21205,4.094419772156787,80.0,20.0
5179,0,5179,[191  11 215 111   7],618,4,21209,4.094401544401545,0.0,0.0
5180,0,5180,[ 64 483 313 318 187],618,5,21214,4.094576336614553,80.0,20.0
5181,0,5181,[  8 187 748 176 197],416,5,21219,4.094751061366268,0.0,0.0
5182,0,5182,[168 403  22 288   1],805,3,21222,4.094539841790469,0.0,20.0
5183,0,5183,[ 64 186 202 286  98],711,4,21226,4.094521604938271,20.0,20.0
5184,0,5184,[ 64 483 313 318 187],618,5,21231,4.094696239151398,80.0,20.0
5185,0,5185,[ 64 483 313 318 187],214,5,21236,4.094870806016197,80.0,20.0
5186,0,5186,[508 121 496 168  15],128,5,21241,4.095045305571621,0.0,0.0
5187,0,5187,[403  88   9 748 245],345,2,21243,4.094641480339244,0.0,0.0
5188,0,5188,[ 64 294  96 153 276],62,4,21247,4.094623241472346,20.0,0.0
5189,0,5189,[187 179 174 132 655],373,2,21249,4.094219653179191,0.0,0.0
5190,0,5190,[ 64 483 313 318 187],618,5,21254,4.094394143710268,80.0,20.0
5191,0,5191,[748 403 153 597 328],416,4,21258,4.094375963020031,0.0,0.0
5192,0,5192,[ 64 483 313 318 187],214,5,21263,4.094550356248797,80.0,20.0
5193,0,5193,[748 257 597 289 427],416,2,21265,4.094147092799384,0.0,0.0
5194,0,5194,[ 64 483 313 318 187],618,5,21270,4.09432146294514,80.0,20.0
5195,0,5195,[276 273 196  50 172],618,4,21274,4.0943033102386455,0.0,20.0
5196,0,5196,[ 64 483 313 318 187],214,5,21279,4.094477583221089,80.0,20.0
5197,0,5197,[ 64 483 313 318 187],214,5,21284,4.0946517891496725,80.0,20.0
5198,0,5198,[ 64 483 313 318 187],618,5,21289,4.094825928063089,80.0,20.0
5199,0,5199,[ 64 483 313 318 187],214,5,21294,4.095,80.0,20.0
5200,0,5200,[ 64 483 313 318 187],214,5,21299,4.095174004999039,80.0,20.0
5201,0,5201,[257 258 288  11  71],630,2,21301,4.094771241830065,0.0,20.0
5202,0,5202,[435 186 588 288 143],405,3,21304,4.0945608302902174,0.0,20.0
5203,0,5203,[568 176 515   1 235],417,3,21307,4.09435049961568,0.0,0.0
5204,0,5204,[118  69 405   1  70],198,2,21309,4.093948126801153,0.0,0.0
5205,0,5205,[173   8 546 183 100],805,3,21312,4.09373799462159,0.0,0.0
5206,0,5206,[ 64 483 313 318 187],618,5,21317,4.09391204148262,80.0,20.0
5207,0,5207,[ 64 483 313 318 187],214,5,21322,4.094086021505376,80.0,20.0
5208,0,5208,[ 25 187  82 427 197],618,3,21325,4.093875983874064,0.0,0.0
5209,0,5209,[ 64 483 313 318 187],214,5,21330,4.09404990403071,80.0,20.0
5210,0,5210,[ 64 483 313 318 187],618,5,21335,4.094223757436192,80.0,20.0
5211,0,5211,[ 64 483 313 318 187],618,5,21340,4.094397544128933,80.0,20.0
5212,0,5212,[ 64 483 313 318 187],618,5,21345,4.094571264147324,80.0,20.0
5213,0,5213,[180 204 258 127  89],805,1,21346,4.093977752205601,0.0,0.0
5214,0,5214,[475 427 323 200 403],198,4,21350,4.093959731543624,0.0,0.0
5215,0,5215,[276 143 194 111 742],416,4,21354,4.093941717791411,0.0,0.0
5216,0,5216,[ 64 483 313 318 187],618,5,21359,4.094115391987732,80.0,20.0
5217,0,5217,[ 64 483 313 318 187],214,5,21364,4.094288999616712,80.0,20.0
5218,0,5218,[ 64 483 313 318 187],214,5,21369,4.094462540716612,80.0,20.0
5219,0,5219,[ 97 202 185 195 151],297,2,21371,4.094061302681992,0.0,0.0
5220,0,5220,[185   7 234  70 100],417,2,21373,4.093660218348975,0.0,0.0
5221,0,5221,[496  15 748 268 195],416,5,21378,4.093833780160858,0.0,0.0
5222,0,5222,[271 475 405 333 268],854,3,21381,4.093624353819644,0.0,0.0
5223,0,5223,[ 64 483 313 318 187],618,5,21386,4.0937978560490045,80.0,20.0
5224,0,5224,[215 301 204 194 655],751,4,21390,4.09377990430622,0.0,0.0
5225,0,5225,[ 64 483 313 318 187],214,5,21395,4.093953310371221,80.0,20.0
5226,0,5226,[742 174  82  11 176],230,5,21400,4.094126650086092,0.0,0.0
5227,0,5227,[ 64 483 313 318 187],618,5,21405,4.094299923488906,80.0,20.0
5228,0,5228,[ 64 483 313 318 187],214,5,21410,4.094473130617709,80.0,20.0
5229,0,5229,[174 173  25 275 182],618,2,21412,4.094072657743786,0.0,0.0
5230,0,5230,[196 144 234 132 161],416,5,21417,4.0942458420952015,0.0,0.0
5231,0,5231,[228 496  79 183 132],417,2,21419,4.093845565749236,0.0,0.0
5232,0,5232,[ 64 483 313 318 187],214,5,21424,4.094018727307472,80.0,20.0
5233,0,5233,[228 161 257  95 475],711,3,21427,4.093809705769965,0.0,0.0
5234,0,5234,[ 64 483 313 318 187],214,5,21432,4.093982808022923,80.0,20.0
5235,0,5235,[ 64 483 313 318 187],214,5,21437,4.0941558441558445,80.0,20.0
5236,0,5236,[132 268 294 403 185],417,4,21441,4.094137865189994,0.0,0.0
5237,0,5237,[121 471 328 161   8],416,5,21446,4.094310805651012,0.0,0.0
5238,0,5238,[174  28  79 742 748],751,3,21449,4.094101927848826,0.0,0.0
5239,0,5239,[ 25 496 197 172 228],373,4,21453,4.094083969465649,0.0,0.0
5240,0,5240,[196 403   7 173 655],417,4,21457,4.094066017935509,0.0,0.0
5241,0,5241,[ 64 483 313 318 187],214,5,21462,4.094238840137352,80.0,20.0
5242,0,5242,[ 64 483 313 318 187],214,5,21467,4.094411596414266,80.0,20.0
5243,0,5243,[ 64 483 313 318 187],214,5,21472,4.094584286803967,80.0,20.0
5244,0,5244,[423 568 143 322 197],805,1,21473,4.093994280266921,0.0,0.0
5245,0,5245,[ 64 483 313 318 187],618,5,21478,4.094166984369043,80.0,20.0
5246,0,5246,[ 64 483 313 318 187],214,5,21483,4.09433962264151,80.0,20.0
5247,0,5247,[ 64 483 313 318 187],214,5,21488,4.094512195121951,80.0,20.0
5248,0,5248,[ 56 216 215   1  22],618,4,21492,4.094494189369404,0.0,0.0
5249,0,5249,[ 64 483 313 318 187],214,5,21497,4.094666666666667,80.0,20.0
5250,0,5250,[  9 121 328 748   7],159,1,21498,4.09407731860598,0.0,0.0
5251,0,5251,[215  71 269 195 597],416,4,21502,4.094059405940594,0.0,0.0
5252,0,5252,[ 64 483 313 318 187],214,5,21507,4.094231867504283,80.0,20.0
5253,0,5253,[ 64 483 313 318 187],214,5,21512,4.0944042634183475,80.0,20.0
5254,0,5254,[ 64 483 313 318 187],618,5,21517,4.094576593720267,80.0,20.0
5255,0,5255,[475 328 215 196 135],62,3,21520,4.094368340943683,0.0,0.0
5256,0,5256,[301 748 238  70 603],416,5,21525,4.094540612516645,0.0,0.0
5257,0,5257,[125  69  70 568 234],230,4,21529,4.094522632179536,0.0,0.0
5258,0,5258,[ 64 483 313 318 187],214,5,21534,4.09469480889903,80.0,20.0
5259,0,5259,[ 28 100   9 405  95],805,1,21535,4.094106463878327,0.0,0.0
5260,0,5260,[ 64 483 313 318 187],618,5,21540,4.0942786542482414,80.0,20.0
5261,0,5261,[ 64 483 313 318 187],214,5,21545,4.094450779171417,80.0,20.0
5262,0,5262,[ 64 483 313 318 187],214,5,21550,4.094622838685161,80.0,20.0
5263,0,5263,[168 588 196 195 742],805,1,21551,4.094034954407295,0.0,0.0
5264,0,5264,[ 64 483 313 318 187],214,5,21556,4.094207027540361,80.0,20.0
5265,0,5265,[ 64 483 313 318 187],618,5,21561,4.094379035320927,80.0,20.0
5266,0,5266,[ 64 483 313 318 187],618,5,21566,4.094550977786216,80.0,20.0
5267,0,5267,[238  22 302 568 151],62,3,21569,4.094343204252088,0.0,0.0
5268,0,5268,[276 222 204 117 132],62,4,21573,4.094325298918201,0.0,0.0
5269,0,5269,[153  70  71 471 235],416,4,21577,4.094307400379507,0.0,0.0
5270,0,5270,[ 64 483 313 318 187],618,5,21582,4.09447922595333,80.0,20.0
5271,0,5271,[ 64 483 313 318 187],618,5,21587,4.094650986342944,80.0,20.0
5272,0,5272,[318 181 276   9 173],618,2,21589,4.094253745495923,20.0,20.0
5273,0,5273,[211 546  56 238 471],416,4,21593,4.094235874099355,0.0,0.0
5274,0,5274,[ 64 483 313 318 187],618,5,21598,4.094407582938389,80.0,20.0
5275,0,5275,[475 127 655 210  15],416,4,21602,4.0943896891584535,0.0,0.0
5276,0,5276,[ 64 483 313 318 187],214,5,21607,4.094561303771082,80.0,20.0
5277,0,5277,[ 64 483 313 318 187],618,5,21612,4.094732853353543,80.0,20.0
5278,0,5278,[ 64 483 313 318 187],618,5,21617,4.0949043379427925,80.0,20.0
5279,0,5279,[ 64 483 313 318 187],618,5,21622,4.095075757575757,80.0,20.0
5280,0,5280,[ 8 89 56 12  7],214,5,21627,4.095247112289339,20.0,0.0
5281,0,5281,[ 64 483 313 318 187],214,5,21632,4.0954184021204085,80.0,20.0
5282,0,5282,[385   1 174 300 257],751,3,21635,4.095211054325194,0.0,0.0
5283,0,5283,[423 268 202 265  69],588,2,21637,4.0948145344436035,0.0,0.0
5284,0,5284,[300 265 568 143 322],128,4,21641,4.094796594134342,0.0,0.0
5285,0,5285,[168  56 258 238 153],198,5,21646,4.094967839576239,0.0,0.0
5286,0,5286,[ 64 483 313 318 187],618,5,21651,4.09513902023832,80.0,20.0
5287,0,5287,[151 191 328 121 294],62,3,21654,4.094931921331316,0.0,0.0
5288,0,5288,[ 64 483 313 318 187],214,5,21659,4.095103044053697,80.0,20.0
5289,0,5289,[ 64 483 313 318 187],618,5,21664,4.0952741020793955,80.0,20.0
5290,0,5290,[ 64 483 313 318 187],214,5,21669,4.095445095445095,80.0,20.0
5291,0,5291,[ 64 483 313 318 187],618,5,21674,4.095616024187453,80.0,20.0
5292,0,5292,[174 194 185 237 282],297,3,21677,4.09540903079539,0.0,0.0
5293,0,5293,[ 64 483 313 318 187],214,5,21682,4.095579901775595,80.0,20.0
5294,0,5294,[ 64 483 313 318 187],618,5,21687,4.095750708215298,80.0,20.0
5295,0,5295,[153 357  11 603  97],416,5,21692,4.0959214501510575,0.0,0.0
5296,0,5296,[238 271   7 405 174],62,3,21695,4.095714555408722,0.0,0.0
5297,0,5297,[117 318 202 186   1],618,4,21699,4.095696489241223,20.0,0.0
5298,0,5298,[ 64 483 313 318 187],618,5,21704,4.095867144744291,80.0,20.0
5299,0,5299,[ 11 288 258 289 742],223,0,21704,4.095094339622642,0.0,20.0
5300,0,5300,[ 64 483 313 318 187],214,5,21709,4.095265044331258,80.0,20.0
5301,0,5301,[ 64 483 313 318 187],618,5,21714,4.095435684647303,80.0,20.0
5302,0,5302,[ 64 483 313 318 187],214,5,21719,4.0956062606072035,80.0,20.0
5303,0,5303,[161 143 282 385 182],618,4,21723,4.095588235294118,0.0,0.0
5304,0,5304,[  4  96 202 125  89],373,4,21727,4.0955702167766255,0.0,0.0
5305,0,5305,[ 64 483 313 318 187],214,5,21732,4.09574067093856,80.0,20.0
5306,0,5306,[ 64 483 313 318 187],618,5,21737,4.095911060863011,80.0,20.0
5307,0,5307,[172 132 111 546  56],262,2,21739,4.095516201959307,0.0,0.0
5308,0,5308,[ 64 483 313 318 187],618,5,21744,4.095686569975514,80.0,20.0
5309,0,5309,[ 64 483 313 318 187],618,5,21749,4.095856873822975,80.0,20.0
5310,0,5310,[ 64 483 313 318 187],214,5,21754,4.09602711353794,80.0,20.0
5311,0,5311,[174 357 183  88  98],805,3,21757,4.09582078313253,0.0,20.0
5312,0,5312,[ 64 483 313 318 187],618,5,21762,4.095990965556183,80.0,20.0
5313,0,5313,[ 64 483 313 318 187],618,5,21767,4.0961610839292435,80.0,20.0
5314,0,5314,[ 64 483 313 318 187],214,5,21772,4.096331138287865,80.0,20.0
5315,0,5315,[111 496 385   1 568],588,2,21774,4.095936794582393,0.0,0.0
5316,0,5316,[ 64 483 313 318 187],214,5,21779,4.096106827158172,80.0,20.0
5317,0,5317,[ 98 100 194   7 265],96,4,21783,4.096088755171117,0.0,20.0
5318,0,5318,[515 269 204 294 196],416,5,21788,4.096258695243467,0.0,0.0
5319,0,5319,[ 64 483 313 318 187],214,5,21793,4.0964285714285715,80.0,20.0
5320,0,5320,[ 64 483 313 318 187],618,5,21798,4.0965983837624504,80.0,20.0
5321,0,5321,[ 98 269 748 235  69],345,3,21801,4.096392333709132,0.0,20.0
5322,0,5322,[ 64 483 313 318 187],618,5,21806,4.09656208904753,80.0,20.0
5323,0,5323,[ 64 483 313 318 187],214,5,21811,4.096731780616079,80.0,20.0
5324,0,5324,[211 496 144 222  69],43,5,21816,4.096901408450704,0.0,0.0
5325,0,5325,[ 64 483 313 318 187],618,5,21821,4.097070972587307,80.0,20.0
5326,0,5326,[ 69  11 471  15 204],416,5,21826,4.097240473061761,0.0,0.0
5327,0,5327,[ 64 483 313 318 187],214,5,21831,4.09740990990991,80.0,20.0
5328,0,5328,[ 64 483 313 318 187],618,5,21836,4.0975792831675735,80.0,20.0
5329,0,5329,[181 423  98 302 172],417,2,21838,4.09718574108818,0.0,40.0
5330,0,5330,[ 64 483 313 318 187],618,5,21843,4.097355092853123,80.0,20.0
5331,0,5331,[168  97 100 597  25],416,4,21847,4.097336834208552,0.0,0.0
5332,0,5332,[200 238  50   8  97],711,5,21852,4.097506094130883,0.0,20.0
5333,0,5333,[427 234 742 121  28],416,5,21857,4.097675290588676,0.0,0.0
5334,0,5334,[ 64 483 313 318 187],618,5,21862,4.0978444236176195,80.0,20.0
5335,0,5335,[ 64 483 313 318 187],618,5,21867,4.098013493253373,80.0,20.0
5336,0,5336,[ 64 483 313 318 187],618,5,21872,4.098182499531572,80.0,20.0
5337,0,5337,[ 70 210 182 181 275],128,4,21876,4.098164106406894,0.0,20.0
5338,0,5338,[ 64 483 313 318 187],618,5,21881,4.098333021165012,80.0,20.0
5339,0,5339,[182 173  89 423  56],198,4,21885,4.098314606741573,0.0,0.0
5340,0,5340,[ 64 483 313 318 187],618,5,21890,4.098483430069275,80.0,20.0
5341,0,5341,[ 64 483 313 318 187],618,5,21895,4.09865219019094,80.0,20.0
5342,0,5342,[ 64 483 313 318 187],214,5,21900,4.098820887142055,80.0,20.0
5343,0,5343,[ 64 483 313 318 187],618,5,21905,4.098989520958084,80.0,20.0
5344,0,5344,[257 183  12 194 181],416,4,21909,4.098971000935454,20.0,20.0
5345,0,5345,[211 300 427 546 655],416,4,21913,4.098952487841377,0.0,0.0
5346,0,5346,[ 64 483 313 318 187],618,5,21918,4.09912100243127,80.0,20.0
5347,0,5347,[ 64 483 313 318 187],618,5,21923,4.099289454001496,80.0,20.0
5348,0,5348,[ 64 483 313 318 187],618,5,21928,4.099457842587399,80.0,20.0
5349,0,5349,[195 117 181 135 194],297,3,21931,4.099252336448598,0.0,20.0
5350,0,5350,[301 237  12 423   4],43,5,21936,4.099420669033825,20.0,0.0
5351,0,5351,[423  28 483 100 144],437,3,21939,4.0992152466367715,20.0,0.0
5352,0,5352,[ 70 238 216 655 258],416,5,21944,4.099383523257986,0.0,0.0
5353,0,5353,[117 237  96 216 183],62,4,21948,4.099364960776989,0.0,0.0
5354,0,5354,[ 71 228 195 202 235],887,4,21952,4.099346405228758,0.0,0.0
5355,0,5355,[ 69  56 313 182 183],405,3,21955,4.099141150112024,20.0,20.0
5356,0,5356,[ 64 483 313 318 187],214,5,21960,4.099309314915065,80.0,20.0
5357,0,5357,[235 357 385 182  50],417,3,21963,4.099104143337066,0.0,20.0
5358,0,5358,[ 64 483 313 318 187],618,5,21968,4.099272252285874,80.0,20.0
5359,0,5359,[143  50 187  70   9],416,5,21973,4.099440298507463,0.0,20.0
5360,0,5360,[237 216 100  96 144],62,3,21976,4.099235217310203,0.0,0.0
5361,0,5361,[237  12 174   4  96],62,4,21980,4.099216710182768,20.0,0.0
5362,0,5362,[ 64 483 313 318 187],214,5,21985,4.099384672757785,80.0,20.0
5363,0,5363,[ 64 483 313 318 187],618,5,21990,4.099552572706935,80.0,20.0
5364,0,5364,[ 64 483 313 318 187],618,5,21995,4.099720410065237,80.0,20.0
5365,0,5365,[597 182 194 234 187],416,4,21999,4.099701826313828,0.0,0.0
5366,0,5366,[151  70 181 210 144],373,4,22003,4.09968324948761,0.0,20.0
5367,0,5367,[168 603 301 127   7],416,5,22008,4.099850968703428,0.0,0.0
5368,0,5368,[195   8 182  56 161],416,5,22013,4.100018625442354,0.0,0.0
5369,0,5369,[ 64 483 313 318 187],618,5,22018,4.100186219739292,80.0,20.0
5370,0,5370,[257 268 515  97 238],417,4,22022,4.100167566561161,0.0,0.0
5371,0,5371,[ 64 483 313 318 187],214,5,22027,4.100335070737156,80.0,20.0
5372,0,5372,[ 64 483 313 318 187],618,5,22032,4.100502512562814,80.0,20.0
5373,0,5373,[ 64 483 313 318 187],618,5,22037,4.100669892072943,80.0,20.0
5374,0,5374,[ 64 483 313 318 187],618,5,22042,4.100837209302326,80.0,20.0
5375,0,5375,[515  79 357 235 143],297,3,22045,4.100632440476191,0.0,0.0
5376,0,5376,[282   9  79 471 176],416,5,22050,4.100799702436303,0.0,0.0
5377,0,5377,[ 56 100 168 742 210],43,5,22055,4.100966902194124,0.0,0.0
5378,0,5378,[191   7  89 515 273],417,3,22058,4.10076222346161,0.0,0.0
5379,0,5379,[  8  50 546  69  89],297,3,22061,4.100557620817844,0.0,20.0
5380,0,5380,[ 64 483 313 318 187],214,5,22066,4.100724772347148,80.0,20.0
5381,0,5381,[ 64 483 313 318 187],618,5,22071,4.100891861761427,80.0,20.0
5382,0,5382,[403 144 546 678 568],416,3,22074,4.100687349061862,0.0,0.0
5383,0,5383,[ 64 483 313 318 187],618,5,22079,4.100854383358098,80.0,20.0
5384,0,5384,[275 174  12 135 483],62,5,22084,4.101021355617456,40.0,0.0
5385,0,5385,[ 82 111 742  12  95],654,5,22089,4.101188265874489,20.0,0.0
5386,0,5386,[ 64 483 313 318 187],214,5,22094,4.101355114163727,80.0,20.0
5387,0,5387,[175 276 222 265 288],922,2,22096,4.100965107646622,0.0,20.0
5388,0,5388,[385 235 216 238 197],416,4,22100,4.100946372239748,0.0,0.0
5389,0,5389,[ 15 742 153 204 210],62,2,22102,4.100556586270872,0.0,0.0
5390,0,5390,[204 269   4 144 117],43,5,22107,4.100723427935448,0.0,0.0
5391,0,5391,[ 64 483 313 318 187],618,5,22112,4.100890207715134,80.0,20.0
5392,0,5392,[ 64 483 313 318 187],214,5,22117,4.101056925644354,80.0,20.0
5393,0,5393,[288 385 403 588 289],416,4,22121,4.101038190582129,0.0,20.0
5394,0,5394,[282 210 496 483 228],128,3,22124,4.100834105653383,20.0,0.0
5395,0,5395,[202 258 265 323  11],416,4,22128,4.100815418828762,0.0,0.0
5396,0,5396,[323 168 197 238  96],805,5,22133,4.100982027052066,0.0,0.0
5397,0,5397,[ 64 483 313 318 187],618,5,22138,4.101148573545758,80.0,20.0
5398,0,5398,[ 64 483 313 318 187],214,5,22143,4.101315058344138,80.0,20.0
5399,0,5399,[ 56  98  71 245  82],62,4,22147,4.101296296296296,0.0,20.0
5400,0,5400,[ 64 483 313 318 187],214,5,22152,4.1014626920940565,80.0,20.0
5401,0,5401,[ 64 483 313 318 187],618,5,22157,4.1016290262865605,80.0,20.0
5402,0,5402,[228 186 175 427  95],198,2,22159,4.101240051823061,0.0,0.0
5403,0,5403,[276 195  12 191 117],630,3,22162,4.101036269430052,20.0,0.0
5404,0,5404,[245 210 603 678 215],921,3,22165,4.100832562442183,0.0,0.0
5405,0,5405,[405 276 211 200 258],416,4,22169,4.1008139104698484,0.0,0.0
5406,0,5406,[ 64 483 313 318 187],214,5,22174,4.100980210837803,80.0,20.0
5407,0,5407,[ 64 483 313 318 187],214,5,22179,4.101146449704142,80.0,20.0
5408,0,5408,[ 64 483 313 318 187],618,5,22184,4.101312627102977,80.0,20.0
5409,0,5409,[180 211 588 483 176],417,4,22188,4.101293900184843,20.0,0.0
5410,0,5410,[423 275 273  11 237],618,4,22192,4.101275180188505,0.0,0.0
5411,0,5411,[ 64 483 313 318 187],214,5,22197,4.101441241685144,80.0,20.0
5412,0,5412,[ 64 483 313 318 187],618,5,22202,4.101607241825236,80.0,20.0
5413,0,5413,[ 64 483 313 318 187],214,5,22207,4.101773180642778,80.0,20.0
5414,0,5414,[ 79 742 496 483  82],588,4,22211,4.101754385964912,20.0,0.0
5415,0,5415,[  4 238 127 216  12],805,2,22213,4.101366322008863,20.0,0.0
5416,0,5416,[742 118   1 117 475],62,2,22215,4.100978401329149,0.0,0.0
5417,0,5417,[ 71  88 204 313  98],345,4,22219,4.100959763750462,20.0,40.0
5418,0,5418,[483 204 269 215 135],711,3,22222,4.100756597158147,20.0,0.0
5419,0,5419,[ 64 483 313 318 187],214,5,22227,4.100922509225092,80.0,20.0
5420,0,5420,[ 64 483 313 318 187],214,5,22232,4.101088360081166,80.0,20.0
5421,0,5421,[ 64 483 313 318 187],618,5,22237,4.101254149760236,80.0,20.0
5422,0,5422,[ 64 483 313 318 187],214,5,22242,4.101419878296146,80.0,20.0
5423,0,5423,[174 210 322 269 216],805,1,22243,4.100848082595871,0.0,0.0
5424,0,5424,[234   7 204  79 182],297,1,22244,4.100276497695853,0.0,0.0
5425,0,5425,[ 64 483 313 318 187],214,5,22249,4.100442314780685,80.0,20.0
5426,0,5426,[288 111  64 294   7],416,5,22254,4.100608070757325,20.0,20.0
5427,0,5427,[153 121  82  70 265],416,5,22259,4.100773765659543,0.0,0.0
5428,0,5428,[183 182  98 180 265],198,3,22262,4.100571007552035,0.0,20.0
5429,0,5429,[ 64 483 313 318 187],214,5,22267,4.100736648250461,80.0,20.0
5430,0,5430,[ 12 257 748 121 496],654,5,22272,4.1009022279506535,20.0,0.0
5431,0,5431,[ 11 403   7 385 238],416,5,22277,4.1010677466863035,0.0,0.0
5432,0,5432,[ 64 483 313 318 187],214,5,22282,4.101233204491073,80.0,20.0
5433,0,5433,[ 64 483 313 318 187],214,5,22287,4.101398601398602,80.0,20.0
5434,0,5434,[238 282  11 118 174],654,3,22290,4.1011959521619135,0.0,0.0
5435,0,5435,[ 64 483 313 318 187],214,5,22295,4.101361295069904,80.0,20.0
5436,0,5436,[  8 748 100  95 276],654,3,22298,4.101158727239286,0.0,0.0
5437,0,5437,[  1 176 597 174 185],417,2,22300,4.1007723427730784,0.0,0.0
5438,0,5438,[ 64 483 313 318 187],618,5,22305,4.100937672366244,80.0,20.0
5439,0,5439,[ 12 238 182 302  56],49,4,22309,4.1009191176470585,20.0,0.0
5440,0,5440,[ 64 483 313 318 187],214,5,22314,4.101084359492741,80.0,20.0
5441,0,5441,[238 117 603   1 196],751,3,22317,4.100882028665931,0.0,0.0
5442,0,5442,[265 271 301 748 176],297,2,22319,4.100496049972442,0.0,0.0
5443,0,5443,[ 64 483 313 318 187],214,5,22324,4.100661278471712,80.0,20.0
5444,0,5444,[235 301  25 269  71],345,2,22326,4.1002754820936635,0.0,0.0
5445,0,5445,[ 64 483 313 318 187],618,5,22331,4.100440690414984,80.0,20.0
5446,0,5446,[176 161 603 268 678],416,4,22335,4.100422250780246,0.0,0.0
5447,0,5447,[237   4 269 191  79],854,3,22338,4.100220264317181,0.0,0.0
5448,0,5448,[ 89 111 322 471 100],854,2,22340,4.099834832079281,0.0,0.0
5449,0,5449,[117 275 475 172  88],588,3,22343,4.099633027522936,0.0,0.0
5450,0,5450,[ 64 483 313 318 187],214,5,22348,4.099798202164741,80.0,20.0
5451,0,5451,[ 64 483 313 318 187],618,5,22353,4.099963316214233,80.0,20.0
5452,0,5452,[ 82 204  71 322 286],416,4,22357,4.09994498441225,0.0,0.0
5453,0,5453,[ 64 483 313 318 187],618,5,22362,4.1001100110011,80.0,20.0
5454,0,5454,[ 64 483 313 318 187],214,5,22367,4.100274977085243,80.0,20.0
5455,0,5455,[294 546 143 127 202],416,4,22371,4.1002565982404695,0.0,0.0
5456,0,5456,[588 161  12 568 322],805,1,22372,4.099688473520249,20.0,0.0
5457,0,5457,[ 64 483 313 318 187],214,5,22377,4.099853426163429,80.0,20.0
5458,0,5458,[172 515  89 588  50],417,2,22379,4.099468767173475,0.0,20.0
5459,0,5459,[179 294 197  50 135],721,3,22382,4.099267399267399,0.0,20.0
5460,0,5460,[100 174 294 276  88],416,3,22385,4.099066105108954,0.0,0.0
5461,0,5461,[118 238 181 180 423],805,1,22386,4.098498718418162,0.0,20.0
5462,0,5462,[125 333  98  96  95],416,4,22390,4.098480688266521,0.0,20.0
5463,0,5463,[197 222  69 200  50],854,5,22395,4.098645680819912,0.0,20.0
5464,0,5464,[ 22 597 286 357 215],416,4,22399,4.098627630375114,0.0,0.0
5465,0,5465,[121 182 588 257   4],417,1,22400,4.098060739114526,0.0,0.0
5466,0,5466,[471 210 151  50  79],505,2,22402,4.097676970916408,0.0,20.0
5467,0,5467,[117 269 211 515  95],416,4,22406,4.0976591075347475,0.0,0.0
5468,0,5468,[ 64 483 313 318 187],618,5,22411,4.097824099469738,80.0,20.0
5469,0,5469,[228 181 135 151 234],417,2,22413,4.09744058500914,0.0,20.0
5470,0,5470,[132 118 121 328 179],128,2,22415,4.097057210747578,0.0,0.0
5471,0,5471,[301 471 271 483 117],907,5,22420,4.097222222222222,20.0,0.0
5472,0,5472,[ 64 483 313 318 187],618,5,22425,4.097387173396674,80.0,20.0
5473,0,5473,[ 64 483 313 318 187],618,5,22430,4.097552064303983,80.0,20.0
5474,0,5474,[ 64 483 313 318 187],214,5,22435,4.097716894977169,80.0,20.0
5475,0,5475,[ 64 483 313 318 187],618,5,22440,4.097881665449233,80.0,20.0
5476,0,5476,[568 195 151 153 172],654,5,22445,4.09804637575315,0.0,0.0
5477,0,5477,[185  64 357 302 202],417,3,22448,4.09784592917123,20.0,0.0
5478,0,5478,[121 427  79 196 127],214,5,22453,4.098010585873334,0.0,0.0
5479,0,5479,[ 64 483 313 318 187],214,5,22458,4.098175182481752,80.0,20.0
5480,0,5480,[181 515  11 200   1],417,4,22462,4.098157270571064,0.0,20.0
5481,0,5481,[ 64 483 313 318 187],214,5,22467,4.098321780372127,80.0,20.0
5482,0,5482,[ 64 483 313 318 187],214,5,22472,4.0984862301659675,80.0,20.0
5483,0,5483,[ 64 483 313 318 187],618,5,22477,4.0986506199854125,80.0,20.0
5484,0,5484,[144 121 508  69 216],654,4,22481,4.098632634457612,0.0,0.0
5485,0,5485,[238 161  88  12  15],43,4,22485,4.098614655486694,20.0,0.0
5486,0,5486,[268 210  79   4 144],297,2,22487,4.098232185164935,0.0,0.0
5487,0,5487,[ 64 483 313 318 187],214,5,22492,4.098396501457726,80.0,20.0
5488,0,5488,[301 132 603 172 235],416,4,22496,4.098378575332483,0.0,0.0
5489,0,5489,[ 64 483 313 318 187],214,5,22501,4.098542805100182,80.0,20.0
5490,0,5490,[515 216 742 125 597],417,2,22503,4.098160626479694,0.0,0.0
5491,0,5491,[202  71 173 282 385],345,1,22504,4.097596504005827,0.0,0.0
5492,0,5492,[ 98 237 300  64 216],198,3,22507,4.097396686692154,20.0,20.0
5493,0,5493,[111  70 181 172 237],128,2,22509,4.097014925373134,0.0,20.0
5494,0,5494,[ 64 483 313 318 187],618,5,22514,4.097179253867152,80.0,20.0
5495,0,5495,[ 64 483 313 318 187],618,5,22519,4.0973435225618635,80.0,20.0
5496,0,5496,[  4 200 202 546  82],49,0,22519,4.0965981444424235,0.0,0.0
5497,0,5497,[ 64 483 313 318 187],214,5,22524,4.096762459076028,80.0,20.0
5498,0,5498,[204 222 161 135 385],922,1,22525,4.096199308965266,0.0,0.0
5499,0,5499,[196   1 238 216 588],345,3,22528,4.096,0.0,0.0
5500,0,5500,[ 98 288 286 183 328],416,5,22533,4.096164333757499,0.0,40.0
5501,0,5501,[313  15  71 288 185],618,3,22536,4.095965103598691,20.0,40.0
5502,0,5502,[ 56  96 357  71 174],601,2,22538,4.09558422678539,0.0,0.0
5503,0,5503,[678 276 210 187 655],416,3,22541,4.095385174418604,0.0,0.0
5504,0,5504,[ 64 483 313 318 187],214,5,22546,4.0955495004541325,80.0,20.0
5505,0,5505,[ 64 483 313 318 187],214,5,22551,4.095713766799855,80.0,20.0
5506,0,5506,[286 153 288 300 268],721,4,22555,4.095696386417287,0.0,20.0
5507,0,5507,[ 64 483 313 318 187],618,5,22560,4.095860566448802,80.0,20.0
5508,0,5508,[ 69 132  11 228 265],405,3,22563,4.095661644581594,0.0,0.0
5509,0,5509,[ 64 483 313 318 187],214,5,22568,4.095825771324864,80.0,20.0
5510,0,5510,[ 64 483 313 318 187],618,5,22573,4.095989838504808,80.0,20.0
5511,0,5511,[294  50  64 258 151],62,4,22577,4.095972423802612,20.0,20.0
5512,0,5512,[ 64 483 313 318 187],214,5,22582,4.096136404861237,80.0,20.0
5513,0,5513,[181 237  98 172 168],654,4,22586,4.096118969894813,0.0,40.0
5514,0,5514,[ 64 483 313 318 187],214,5,22591,4.096282864913872,80.0,20.0
5515,0,5515,[ 64 483 313 318 187],214,5,22596,4.096446700507614,80.0,20.0
5516,0,5516,[ 96  15 182 121 276],62,4,22600,4.096429218778321,0.0,0.0
5517,0,5517,[  1 111   8 286 168],679,2,22602,4.096049293222182,0.0,0.0
5518,0,5518,[143 258 427 121  79],128,4,22606,4.096031889835115,0.0,0.0
5519,0,5519,[403 655  97  25 405],198,2,22608,4.095652173913043,0.0,0.0
5520,0,5520,[655 183 196  82 174],417,4,22612,4.095634848759283,0.0,0.0
5521,0,5521,[302   4 257 215 258],62,2,22614,4.095255342267294,0.0,0.0
5522,0,5522,[ 64 483 313 318 187],618,5,22619,4.095419156255658,80.0,20.0
5523,0,5523,[121 483 186 288 286],854,2,22621,4.095039826212889,20.0,20.0
5524,0,5524,[ 64 483 313 318 187],618,5,22626,4.095203619909502,80.0,20.0
5525,0,5525,[258 245  15  64 282],128,2,22628,4.094824466159971,20.0,0.0
5526,0,5526,[  1 195  69   7 153],416,5,22633,4.094988239551293,0.0,0.0
5527,0,5527,[ 64 483 313 318 187],618,5,22638,4.095151953690304,80.0,20.0
5528,0,5528,[ 64 483 313 318 187],618,5,22643,4.095315608609152,80.0,20.0
5529,0,5529,[ 64 483 313 318 187],214,5,22648,4.095479204339964,80.0,20.0
5530,0,5530,[89  8  7 50 79],354,4,22652,4.09546194178268,0.0,20.0
5531,0,5531,[ 64 483 313 318 187],214,5,22657,4.095625451916124,80.0,20.0
5532,0,5532,[ 64 483 313 318 187],618,5,22662,4.09578890294596,80.0,20.0
5533,0,5533,[ 64 483 313 318 187],618,5,22667,4.095952294904229,80.0,20.0
5534,0,5534,[ 64 483 313 318 187],214,5,22672,4.096115627822945,80.0,20.0
5535,0,5535,[313 268 176 357 168],416,5,22677,4.096278901734104,20.0,20.0
5536,0,5536,[ 64 483 313 318 187],214,5,22682,4.096442116669676,80.0,20.0
5537,0,5537,[ 64 483 313 318 187],618,5,22687,4.096605272661611,80.0,20.0
5538,0,5538,[ 64 483 313 318 187],618,5,22692,4.096768369741831,80.0,20.0
5539,0,5539,[ 64 483 313 318 187],618,5,22697,4.096931407942238,80.0,20.0
5540,0,5540,[483 475 301 204  22],588,4,22701,4.096913914455874,20.0,0.0
5541,0,5541,[ 64 483 313 318 187],214,5,22706,4.097076867556838,80.0,20.0
5542,0,5542,[ 64 483 313 318 187],618,5,22711,4.0972397618618075,80.0,20.0
5543,0,5543,[ 64 483 313 318 187],214,5,22716,4.097402597402597,80.0,20.0
5544,0,5544,[ 64 483 313 318 187],618,5,22721,4.097565374211001,80.0,20.0
5545,0,5545,[ 64 483 313 318 187],618,5,22726,4.097728092318788,80.0,20.0
5546,0,5546,[ 64 483 313 318 187],214,5,22731,4.097890751757707,80.0,20.0
5547,0,5547,[427 235 204 182 313],416,4,22735,4.0978731074261,20.0,20.0
5548,0,5548,[222  56 475 185   7],417,2,22737,4.097495044152099,0.0,0.0
5549,0,5549,[174 183 197 196  98],437,4,22741,4.097477477477478,0.0,20.0
5550,0,5550,[ 64 483 313 318 187],618,5,22746,4.09764006485318,80.0,20.0
5551,0,5551,[ 25 282 176 313 597],416,4,22750,4.097622478386167,20.0,20.0
5552,0,5552,[125 195 118 127 546],159,4,22754,4.097604898253197,0.0,0.0
5553,0,5553,[ 64 483 313 318 187],618,5,22759,4.097767374864962,80.0,20.0
5554,0,5554,[ 64 483 313 318 187],618,5,22764,4.097929792979298,80.0,20.0
5555,0,5555,[496  56 289 127 215],416,4,22768,4.097912167026638,0.0,0.0
5556,0,5556,[ 64 483 313 318 187],214,5,22773,4.098074500629836,80.0,20.0
5557,0,5557,[322  79 195 268 127],417,3,22776,4.0978769341489745,0.0,0.0
5558,0,5558,[ 64 483 313 318 187],618,5,22781,4.098039215686274,80.0,20.0
5559,0,5559,[ 64 483 313 318 187],214,5,22786,4.098201438848921,80.0,20.0
5560,0,5560,[185 204 121 423 238],618,3,22789,4.098003956123,0.0,0.0
5561,0,5561,[294 202 568  96 742],230,3,22792,4.097806544408487,0.0,0.0
5562,0,5562,[ 64 483 313 318 187],214,5,22797,4.097968721912637,80.0,20.0
5563,0,5563,[357  56 127 191   7],417,4,22801,4.097951114306254,0.0,0.0
5564,0,5564,[265  79 269 742 508],297,2,22803,4.097574123989219,0.0,0.0
5565,0,5565,[168 211 216 588 132],230,5,22808,4.097736255839022,0.0,0.0
5566,0,5566,[ 64 483 313 318 187],618,5,22813,4.0978983294413505,80.0,20.0
5567,0,5567,[ 64 483 313 318 187],618,5,22818,4.098060344827586,80.0,20.0
5568,0,5568,[ 95  79 202 215 265],437,3,22821,4.0978631711258755,0.0,0.0
5569,0,5569,[ 64 483 313 318 187],214,5,22826,4.098025134649911,80.0,20.0
5570,0,5570,[ 64 483 313 318 187],214,5,22831,4.09818704002872,80.0,20.0
5571,0,5571,[ 64 483 313 318 187],618,5,22836,4.098348887293611,80.0,20.0
5572,0,5572,[357 187 300  56  22],875,3,22839,4.098151803337521,0.0,0.0
5573,0,5573,[ 98 191 328 194 183],416,5,22844,4.098313598851812,0.0,20.0
5574,0,5574,[ 64 483 313 318 187],618,5,22849,4.09847533632287,80.0,20.0
5575,0,5575,[173 179 174  56   8],875,4,22853,4.098457675753228,0.0,0.0
5576,0,5576,[ 64 483 313 318 187],618,5,22858,4.09861932938856,80.0,20.0
5577,0,5577,[ 64 483 313 318 187],214,5,22863,4.098780925062747,80.0,20.0
5578,0,5578,[ 64 483 313 318 187],618,5,22868,4.098942462806955,80.0,20.0
5579,0,5579,[ 69 288 333 191 118],854,3,22871,4.098745519713262,0.0,20.0
5580,0,5580,[100 483 143 176 275],618,4,22875,4.098727826554381,20.0,0.0
5581,0,5581,[ 64 483 313 318 187],214,5,22880,4.098889286993909,80.0,20.0
5582,0,5582,[ 64 483 313 318 187],618,5,22885,4.099050689593408,80.0,20.0
5583,0,5583,[ 98 234 179 546 204],805,3,22888,4.098853868194842,0.0,20.0
5584,0,5584,[258 302  11 235   8],43,4,22892,4.098836168307968,0.0,0.0
5585,0,5585,[ 64 483 313 318 187],618,5,22897,4.098997493734336,80.0,20.0
5586,0,5586,[483 176 132 100 286],854,3,22900,4.098800787542509,20.0,0.0
5587,0,5587,[ 64 483 313 318 187],618,5,22905,4.098962061560487,80.0,20.0
5588,0,5588,[153 185 546 173 245],297,3,22908,4.098765432098766,0.0,0.0
5589,0,5589,[ 64 483 313 318 187],214,5,22913,4.098926654740608,80.0,20.0
5590,0,5590,[ 64 483 313 318 187],214,5,22918,4.099087819710249,80.0,20.0
5591,0,5591,[  1  64 111 302  56],345,4,22922,4.099070100143061,20.0,0.0
5592,0,5592,[ 64 483 313 318 187],214,5,22927,4.099231181834436,80.0,20.0
5593,0,5593,[275 235 215 132  22],62,4,22931,4.099213442974616,0.0,0.0
5594,0,5594,[ 64 483 313 318 187],618,5,22936,4.099374441465594,80.0,20.0
5595,0,5595,[ 64 483 313 318 187],618,5,22941,4.099535382416011,80.0,20.0
5596,0,5596,[197 144 111  71  15],618,2,22943,4.099160264427372,0.0,0.0
5597,0,5597,[151 172 168   8 222],43,5,22948,4.099321186137907,0.0,0.0
5598,0,5598,[  1 200  82 176 121],887,4,22952,4.099303447044115,0.0,0.0
5599,0,5599,[ 64 483 313 318 187],618,5,22957,4.099464285714285,80.0,20.0
5600,0,5600,[ 64 483 313 318 187],618,5,22962,4.0996250669523295,80.0,20.0
5601,0,5601,[ 11 196  56 435 216],297,4,22966,4.099607283113174,0.0,0.0
5602,0,5602,[655 196  95 180 603],405,1,22967,4.099054078172408,0.0,0.0
5603,0,5603,[ 64 483 313 318 187],618,5,22972,4.099214846538187,80.0,20.0
5604,0,5604,[ 64 483 313 318 187],618,5,22977,4.099375557537913,80.0,20.0
5605,0,5605,[194 423 222 151 333],854,3,22980,4.099179450588655,0.0,0.0
5606,0,5606,[ 64 483 313 318 187],214,5,22985,4.099340110576065,80.0,20.0
5607,0,5607,[ 64 483 313 318 187],618,5,22990,4.099500713266762,80.0,20.0
5608,0,5608,[ 64 483 313 318 187],214,5,22995,4.0996612586913885,80.0,20.0
5609,0,5609,[496 183 196 200 174],416,5,23000,4.09982174688057,0.0,0.0
5610,0,5610,[ 64 483 313 318 187],618,5,23005,4.099982177864908,80.0,20.0
5611,0,5611,[  4 181 191  25 403],43,5,23010,4.100142551674982,0.0,20.0
5612,0,5612,[ 64 483 313 318 187],618,5,23015,4.10030286834135,80.0,20.0
5613,0,5613,[191 235  15  70 144],416,4,23019,4.100285001781261,0.0,0.0
5614,0,5614,[ 64 483 313 318 187],214,5,23024,4.100445235975067,80.0,20.0
5615,0,5615,[  7 238 181 118 245],297,3,23027,4.100249287749287,0.0,20.0
5616,0,5616,[181  82  70 748 245],417,4,23031,4.1002314402706075,0.0,20.0
5617,0,5617,[742   4  97 257 153],416,4,23035,4.1002135991456035,0.0,0.0
5618,0,5618,[515 135 153 183 300],698,2,23037,4.099839829151095,0.0,0.0
5619,0,5619,[144   9 186 187 427],618,4,23041,4.09982206405694,0.0,0.0
5620,0,5620,[121 183 215 151  25],618,3,23044,4.099626400996264,0.0,0.0
5621,0,5621,[ 64 483 313 318 187],214,5,23049,4.099786552828175,80.0,20.0
5622,0,5622,[ 95  50 176 258 357],416,4,23053,4.099768806686822,0.0,20.0
5623,0,5623,[ 64 483 313 318 187],214,5,23058,4.0999288762446655,80.0,20.0
5624,0,5624,[ 64 483 313 318 187],618,5,23063,4.100088888888889,80.0,20.0
5625,0,5625,[172 215 197  12 200],345,5,23068,4.10024884464984,20.0,0.0
5626,0,5626,[302 678 282 153 143],416,4,23072,4.100231028967478,0.0,0.0
5627,0,5627,[ 64 483 313 318 187],214,5,23077,4.100390902629709,80.0,20.0
5628,0,5628,[471 318 588  88 276],416,3,23080,4.100195416592645,20.0,0.0
5629,0,5629,[196  97   8 127 282],618,3,23083,4.1,0.0,0.0
5630,0,5630,[ 11 496 603 655 125],416,5,23088,4.100159829515184,0.0,0.0
5631,0,5631,[275  98  79 300  12],24,5,23093,4.1003196022727275,20.0,20.0
5632,0,5632,[ 64 483 313 318 187],618,5,23098,4.100479318302858,80.0,20.0
5633,0,5633,[ 64 483 313 318 187],214,5,23103,4.100638977635783,80.0,20.0
5634,0,5634,[ 64 483 313 318 187],618,5,23108,4.100798580301686,80.0,20.0
5635,0,5635,[ 64 483 313 318 187],214,5,23113,4.100958126330731,80.0,20.0
5636,0,5636,[ 89 143   9 496  98],342,3,23116,4.100762817101295,0.0,20.0
5637,0,5637,[238 288  69 179 100],62,4,23120,4.100744945015963,0.0,20.0
5638,0,5638,[ 50 117  64 197 185],416,5,23125,4.100904415676538,20.0,20.0
5639,0,5639,[282 200 121 111 318],416,5,23130,4.101063829787234,20.0,0.0
5640,0,5640,[405 294  56 597  50],62,2,23132,4.10069136677894,0.0,20.0
5641,0,5641,[  4 211 173 196 568],405,3,23135,4.100496277915632,0.0,0.0
5642,0,5642,[118  96 173 196 176],198,3,23138,4.100301258195995,0.0,0.0
5643,0,5643,[257   1  56 302   8],297,3,23141,4.100106307583275,0.0,0.0
5644,0,5644,[  8 275 294   1 143],921,2,23143,4.099734278122232,0.0,0.0
5645,0,5645,[ 64 483 313 318 187],214,5,23148,4.099893730074389,80.0,20.0
5646,0,5646,[ 11   1 328 238 200],854,3,23151,4.09969895519745,0.0,0.0
5647,0,5647,[135   8 235 144 191],854,3,23154,4.099504249291785,0.0,0.0
5648,0,5648,[200 215 191  79 271],297,0,23154,4.098778544875199,0.0,0.0
5649,0,5649,[ 64 483 313 318 187],214,5,23159,4.098938053097345,80.0,20.0
5650,0,5650,[ 64 483 313 318 187],618,5,23164,4.099097504866395,80.0,20.0
5651,0,5651,[ 64 483 313 318 187],214,5,23169,4.099256900212314,80.0,20.0
5652,0,5652,[603 268 200 144 357],297,3,23172,4.099062444719618,0.0,0.0
5653,0,5653,[ 64 483 313 318 187],214,5,23177,4.099221789883268,80.0,20.0
5654,0,5654,[496 286 117 289 100],416,4,23181,4.099204244031831,0.0,0.0
5655,0,5655,[427 282 237 234 127],253,5,23186,4.0993635077793495,0.0,0.0
5656,0,5656,[ 64 483 313 318 187],618,5,23191,4.099522715220082,80.0,20.0
5657,0,5657,[ 64 483 313 318 187],214,5,23196,4.099681866383881,80.0,20.0
5658,0,5658,[ 64 483 313 318 187],618,5,23201,4.0998409613005835,80.0,20.0
5659,0,5659,[ 64 483 313 318 187],214,5,23206,4.1,80.0,20.0
5660,0,5660,[211 194 222 603   1],297,3,23209,4.099805688040982,0.0,0.0
5661,0,5661,[ 64 483 313 318 187],618,5,23214,4.099964676792653,80.0,20.0
5662,0,5662,[ 82 111 202  56  22],416,5,23219,4.100123609394314,0.0,0.0
5663,0,5663,[  9  12  50 257 181],62,4,23223,4.10010593220339,20.0,40.0
5664,0,5664,[197  98 323  11 318],345,4,23227,4.10008826125331,20.0,20.0
5665,0,5665,[ 64 483 313 318 187],214,5,23232,4.1002470878926935,80.0,20.0
5666,0,5666,[405  88  15 588 202],43,5,23237,4.100405858478913,0.0,0.0
5667,0,5667,[ 64 483 313 318 187],618,5,23242,4.100564573041638,80.0,20.0
5668,0,5668,[144 121 265 161 301],437,0,23242,4.099841241841594,0.0,0.0
5669,0,5669,[ 64 483 313 318 187],618,5,23247,4.1,80.0,20.0
5670,0,5670,[111 181 288 121  82],437,1,23248,4.099453359195909,0.0,40.0
5671,0,5671,[ 64 483 313 318 187],618,5,23253,4.099612129760225,80.0,20.0
5672,0,5672,[ 64 483 313 318 187],618,5,23258,4.099770844350432,80.0,20.0
5673,0,5673,[195 286  56  64 176],416,5,23263,4.0999295029961225,20.0,0.0
5674,0,5674,[ 64 483 313 318 187],618,5,23268,4.100088105726872,80.0,20.0
5675,0,5675,[ 95  69 185 197 265],711,3,23271,4.099894291754757,0.0,0.0
5676,0,5676,[215 200  69 403 180],405,3,23274,4.099700546063062,0.0,0.0
5677,0,5677,[172 265  25 268 234],588,5,23279,4.0998591053187745,0.0,0.0
5678,0,5678,[153 271 302 175 211],43,3,23282,4.099665434055291,0.0,0.0
5679,0,5679,[ 64 483 313 318 187],618,5,23287,4.0998239436619714,80.0,20.0
5680,0,5680,[ 64 483 313 318 187],214,5,23292,4.099982397465235,80.0,20.0
5681,0,5681,[318 323 215 100 423],416,4,23296,4.099964801126364,20.0,0.0
5682,0,5682,[ 64 289 144 238 333],854,2,23298,4.09959528418089,20.0,0.0
5683,0,5683,[185 294  96 496 204],262,2,23300,4.099225897255454,0.0,0.0
5684,0,5684,[ 64 483 313 318 187],618,5,23305,4.09938434476693,80.0,20.0
5685,0,5685,[210 568  28 405 191],43,5,23310,4.099542736545902,0.0,0.0
5686,0,5686,[286 118   7 475 194],297,3,23313,4.099349393353262,0.0,0.0
5687,0,5687,[357 202 100 127 204],373,2,23315,4.0989803094233475,0.0,0.0
5688,0,5688,[ 64 483 313 318 187],618,5,23320,4.0991386886974865,80.0,20.0
5689,0,5689,[195  82 202   7 100],887,4,23324,4.099121265377856,0.0,0.0
5690,0,5690,[ 64 483 313 318 187],214,5,23329,4.099279564224213,80.0,20.0
5691,0,5691,[ 56 174  95 515 173],297,4,23333,4.09926212227688,0.0,0.0
5692,0,5692,[568 496 185 100 333],416,5,23338,4.099420340769366,0.0,0.0
5693,0,5693,[ 64 483 313 318 187],618,5,23343,4.099578503688092,80.0,20.0
5694,0,5694,[168   1 118 313 471],43,4,23347,4.0995610184372255,20.0,20.0
5695,0,5695,[135   4 357 271   7],854,4,23351,4.099543539325842,0.0,0.0
5696,0,5696,[471 655 385 172  22],705,3,23354,4.099350535369493,0.0,0.0
5697,0,5697,[ 64 483 313 318 187],618,5,23359,4.099508599508599,80.0,20.0
5698,0,5698,[ 64 483 313 318 187],214,5,23364,4.099666608176873,80.0,20.0
5699,0,5699,[121 125  70 405  96],230,4,23368,4.099649122807017,0.0,0.0
5700,0,5700,[357 118 546 655 197],416,3,23371,4.099456235748114,0.0,0.0
5701,0,5701,[ 12 597 258  88   4],416,3,23374,4.099263416345142,20.0,0.0
5702,0,5702,[ 71 318 153 144 204],62,3,23377,4.099070664562511,20.0,0.0
5703,0,5703,[ 64 483 313 318 187],214,5,23382,4.099228611500701,80.0,20.0
5704,0,5704,[ 64 483 313 318 187],214,5,23387,4.0993865030674845,80.0,20.0
5705,0,5705,[ 64 483 313 318 187],618,5,23392,4.099544339291973,80.0,20.0
5706,0,5706,[ 64 483 313 318 187],618,5,23397,4.0997021202032595,80.0,20.0
5707,0,5707,[ 64 483 313 318 187],214,5,23402,4.099859845830413,80.0,20.0
5708,0,5708,[172 597  28 588 117],805,1,23403,4.099316868102996,0.0,0.0
5709,0,5709,[ 64 483 313 318 187],618,5,23408,4.099474605954466,80.0,20.0
5710,0,5710,[ 64 483 313 318 187],214,5,23413,4.0996322885659255,80.0,20.0
5711,0,5711,[ 64 483 313 318 187],618,5,23418,4.099789915966387,80.0,20.0
5712,0,5712,[515  95  12 257 111],417,3,23421,4.099597409417119,20.0,0.0
5713,0,5713,[568 318 210 288 143],618,3,23424,4.0994049702485125,20.0,20.0
5714,0,5714,[ 95  96   4 186 144],618,2,23426,4.099037620297463,0.0,0.0
5715,0,5715,[ 64 483 313 318 187],618,5,23431,4.099195241427572,80.0,20.0
5716,0,5716,[173 215 235 196 301],297,3,23434,4.099002973587546,0.0,0.0
5717,0,5717,[289 318 268   7  69],588,2,23436,4.098635886673662,20.0,0.0
5718,0,5718,[483 117  70 238   7],618,3,23439,4.0984437838783006,20.0,0.0
5719,0,5719,[265 385 172 111 275],618,3,23442,4.098251748251748,0.0,0.0
5720,0,5720,[202 228 237 168 181],922,4,23446,4.098234574375109,0.0,20.0
5721,0,5721,[174 211 318   1 118],416,4,23450,4.098217406501224,20.0,0.0
5722,0,5722,[228 176 168 357 161],405,1,23451,4.09767604403285,0.0,0.0
5723,0,5723,[ 64 483 313 318 187],618,5,23456,4.097833682739343,80.0,20.0
5724,0,5724,[ 64 483 313 318 187],214,5,23461,4.097991266375546,80.0,20.0
5725,0,5725,[ 64 483 313 318 187],618,5,23466,4.098148794970311,80.0,20.0
5726,0,5726,[ 64 483 313 318 187],214,5,23471,4.098306268552471,80.0,20.0
5727,0,5727,[ 64 483 313 318 187],618,5,23476,4.098463687150838,80.0,20.0
5728,0,5728,[ 64 483 313 318 187],618,5,23481,4.098621050794205,80.0,20.0
5729,0,5729,[ 12 268 196 282 276],314,3,23484,4.098429319371728,20.0,0.0
5730,0,5730,[ 50 111  56 742  70],417,2,23486,4.098063165241668,0.0,20.0
5731,0,5731,[ 64 483 313 318 187],618,5,23491,4.098220516399163,80.0,20.0
5732,0,5732,[197 174 323 678  71],345,2,23493,4.097854526425955,0.0,0.0
5733,0,5733,[182 204 323  25 176],198,2,23495,4.097488664108824,0.0,0.0
5734,0,5734,[ 64 483 313 318 187],214,5,23500,4.097646033129904,80.0,20.0
5735,0,5735,[ 64 483 313 318 187],618,5,23505,4.097803347280335,80.0,20.0
5736,0,5736,[ 64 483 313 318 187],214,5,23510,4.09796060658881,80.0,20.0
5737,0,5737,[210   7 318  95 191],618,3,23513,4.097769257581039,20.0,0.0
5738,0,5738,[181 195 173 204 191],437,4,23517,4.097752221641401,0.0,20.0
5739,0,5739,[323 258  82 471 127],43,3,23520,4.097560975609756,0.0,0.0
5740,0,5740,[  7 273  88 234 187],618,5,23525,4.097718167566626,0.0,0.0
5741,0,5741,[174 195   8 294 508],601,2,23527,4.097352838732149,0.0,0.0
5742,0,5742,[127 135  96 121 202],618,3,23530,4.0971617621452205,0.0,0.0
5743,0,5743,[  9 151 515   7 385],416,4,23534,4.097144846796658,0.0,0.0
5744,0,5744,[181 313 143 196 427],416,5,23539,4.097302001740644,20.0,40.0
5745,0,5745,[ 64 483 313 318 187],618,5,23544,4.097459101983989,80.0,20.0
5746,0,5746,[ 64 483 313 318 187],618,5,23549,4.097616147555247,80.0,20.0
5747,0,5747,[143 181  25 568 405],230,3,23552,4.097425191370911,0.0,20.0
5748,0,5748,[ 64 483 313 318 187],214,5,23557,4.097582188206645,80.0,20.0
5749,0,5749,[196 215 588  56  88],437,2,23559,4.097217391304348,0.0,0.0
5750,0,5750,[194 173 210  97  12],297,4,23563,4.097200486871849,20.0,0.0
5751,0,5751,[173 588  88  25  28],751,5,23568,4.097357440890125,0.0,0.0
5752,0,5752,[111  71 173  25 257],223,4,23572,4.097340517990614,0.0,0.0
5753,0,5753,[ 12 269 748 215 144],297,2,23574,4.096976016684046,20.0,0.0
5754,0,5754,[185  98 121 222 181],198,2,23576,4.096611642050391,0.0,40.0
5755,0,5755,[238  50 132  82 603],416,5,23581,4.096768589298124,0.0,20.0
5756,0,5756,[ 56 678 200 268 403],416,4,23585,4.096751780441202,0.0,0.0
5757,0,5757,[385  25 597   4 117],805,1,23586,4.09621396318166,0.0,0.0
5758,0,5758,[ 64 483 313 318 187],618,5,23591,4.0963708977253,80.0,20.0
5759,0,5759,[ 64 483 313 318 187],214,5,23596,4.096527777777778,80.0,20.0
5760,0,5760,[ 98 117 269 508   8],654,4,23600,4.096511022391946,0.0,20.0
5761,0,5761,[222  95   1 196  71],805,2,23602,4.096147171121139,0.0,0.0
5762,0,5762,[ 71 144 173 237  15],907,5,23607,4.096304008328995,0.0,0.0
5763,0,5763,[ 64 483 313 318 187],214,5,23612,4.09646079111728,80.0,20.0
5764,0,5764,[ 64 483 313 318 187],618,5,23617,4.096617519514311,80.0,20.0
5765,0,5765,[ 64 483 313 318 187],618,5,23622,4.096774193548387,80.0,20.0
5766,0,5766,[ 64 483 313 318 187],618,5,23627,4.0969308132477895,80.0,20.0
5767,0,5767,[143  97  15 202  56],43,5,23632,4.097087378640777,0.0,0.0
5768,0,5768,[ 64 483 313 318 187],214,5,23637,4.09724388975559,80.0,20.0
5769,0,5769,[185 235 196 742 151],416,3,23640,4.097053726169844,0.0,0.0
5770,0,5770,[273 275 153 172 200],416,5,23645,4.097210188875412,0.0,0.0
5771,0,5771,[117 268  11 182 508],417,4,23649,4.097193347193347,0.0,0.0
5772,0,5772,[ 64 483 313 318 187],214,5,23654,4.097349731508747,80.0,20.0
5773,0,5773,[ 64 483 313 318 187],214,5,23659,4.0975060616556975,80.0,20.0
5774,0,5774,[603 118 234 471 257],270,4,23663,4.0974891774891775,0.0,0.0
5775,0,5775,[748  25  82 121 269],654,4,23667,4.097472299168975,0.0,0.0
5776,0,5776,[ 64 483 313 318 187],214,5,23672,4.097628526917085,80.0,20.0
5777,0,5777,[179 168 405 269   7],416,4,23676,4.097611630321911,0.0,0.0
5778,0,5778,[483 210  15  82 180],62,4,23680,4.097594739574321,20.0,0.0
5779,0,5779,[ 25 588  50 748 288],297,3,23683,4.097404844290658,0.0,40.0
5780,0,5780,[196 288 405 174 135],601,2,23685,4.09704203425013,0.0,20.0
5781,0,5781,[ 64 483 313 318 187],214,5,23690,4.097198201314424,80.0,20.0
5782,0,5782,[ 64 483 313 318 187],214,5,23695,4.097354314369705,80.0,20.0
5783,0,5783,[235  88 275 258 289],416,2,23697,4.096991701244813,0.0,0.0
5784,0,5784,[194 127 228 318 289],721,4,23701,4.096974935177182,20.0,0.0
5785,0,5785,[ 64 483 313 318 187],214,5,23706,4.097131005876253,80.0,20.0
5786,0,5786,[655 323 118 161 318],345,2,23708,4.096768619319164,20.0,0.0
5787,0,5787,[245 185  22 175 197],297,3,23711,4.096579129232896,0.0,0.0
5788,0,5788,[  4 323  28  95 271],43,3,23714,4.0963897046121955,0.0,0.0
5789,0,5789,[568 238   9 144 423],618,3,23717,4.096200345423143,0.0,0.0
5790,0,5790,[ 64 483 313 318 187],618,5,23722,4.096356415126921,80.0,20.0
5791,0,5791,[ 64 483 313 318 187],618,5,23727,4.096512430939226,80.0,20.0
5792,0,5792,[174 385  95 216 175],373,3,23730,4.096323148627654,0.0,0.0
5793,0,5793,[271 118  11  56 144],297,2,23732,4.095961339316534,0.0,0.0
5794,0,5794,[302 132  11 328 423],416,5,23737,4.09611734253667,0.0,0.0
5795,0,5795,[ 64 483 313 318 187],214,5,23742,4.096273291925466,80.0,20.0
5796,0,5796,[405 328 172 588  64],43,5,23747,4.096429187510782,20.0,0.0
5797,0,5797,[200 153 144 269 302],416,5,23752,4.0965850293204555,0.0,0.0
5798,0,5798,[ 12  69 202 181 403],417,3,23755,4.096395930332816,20.0,20.0
5799,0,5799,[ 64 483 313 318 187],214,5,23760,4.096551724137931,80.0,20.0
5800,0,5800,[185 210 194 588 508],297,4,23764,4.096535080158593,0.0,0.0
5801,0,5801,[111 185 204 269   4],416,5,23769,4.096690796277146,0.0,0.0
5802,0,5802,[ 64 483 313 318 187],214,5,23774,4.096846458728244,80.0,20.0
5803,0,5803,[ 50 471 286  95  28],588,5,23779,4.097002067539628,0.0,20.0
5804,0,5804,[ 25 187 215 603 174],373,4,23783,4.096985357450474,0.0,0.0
5805,0,5805,[211 288 300 282 111],297,1,23784,4.096451946262487,0.0,20.0
5806,0,5806,[127 655 435 186 195],405,4,23788,4.0964353366626485,0.0,0.0
5807,0,5807,[403 235 183 265 228],922,2,23790,4.096074380165289,0.0,0.0
5808,0,5808,[ 95 173 269 568 385],654,5,23795,4.096229987949733,0.0,0.0
5809,0,5809,[144  97 423  28 143],618,5,23800,4.096385542168675,0.0,0.0
5810,0,5810,[ 64 483 313 318 187],214,5,23805,4.0965410428497675,80.0,20.0
5811,0,5811,[191  98 183 318 288],405,4,23809,4.096524432209223,20.0,40.0
5812,0,5812,[118 196 496 143 475],601,2,23811,4.09616377085842,0.0,0.0
5813,0,5813,[ 64 483 313 318 187],618,5,23816,4.096319229446165,80.0,20.0
5814,0,5814,[ 64 483 313 318 187],214,5,23821,4.096474634565778,80.0,20.0
5815,0,5815,[ 25   4 483 176 235],854,1,23822,4.095942228335626,20.0,0.0
5816,0,5816,[ 64 483 313 318 187],214,5,23827,4.096097644834107,80.0,20.0
5817,0,5817,[ 64 483 313 318 187],214,5,23832,4.096253007906497,80.0,20.0
5818,0,5818,[302 245 238 210 258],297,4,23836,4.096236466746864,0.0,0.0
5819,0,5819,[202 100 210 195 655],416,5,23841,4.096391752577319,0.0,0.0
5820,0,5820,[194 168 181  11 175],297,4,23845,4.096375193265762,0.0,20.0
5821,0,5821,[603 135  22  50 176],854,3,23848,4.096186877361731,0.0,20.0
5822,0,5822,[ 69 121 174 195 496],505,3,23851,4.09599862613773,0.0,0.0
5823,0,5823,[ 64 483 313 318 187],618,5,23856,4.096153846153846,80.0,20.0
5824,0,5824,[ 64 483 313 318 187],618,5,23861,4.096309012875537,80.0,20.0
5825,0,5825,[210  25 191  79  50],805,4,23865,4.0962924819773425,0.0,20.0
5826,0,5826,[ 64 483 313 318 187],618,5,23870,4.096447571649219,80.0,20.0
5827,0,5827,[ 64 483 313 318 187],214,5,23875,4.096602608098833,80.0,20.0
5828,0,5828,[182 288 135 271 172],62,3,23878,4.096414479327501,0.0,20.0
5829,0,5829,[ 64 483 313 318 187],618,5,23883,4.096569468267582,80.0,20.0
5830,0,5830,[333 288 151 300  71],416,4,23887,4.0965529068770365,0.0,20.0
5831,0,5831,[ 12  97  89 508 100],297,5,23892,4.096707818930041,20.0,0.0
5832,0,5832,[ 64 483 313 318 187],214,5,23897,4.096862677867307,80.0,20.0
5833,0,5833,[ 69 588 655 427 215],373,4,23901,4.096846074734316,0.0,0.0
5834,0,5834,[ 22   1 357 515 121],230,5,23906,4.097000856898029,0.0,0.0
5835,0,5835,[118 211  28 185 294],416,4,23910,4.0969842357779305,0.0,0.0
5836,0,5836,[191 228 111 322 282],128,1,23911,4.096453657700874,0.0,0.0
5837,0,5837,[118 210  22 234 191],642,3,23914,4.0962658444672835,0.0,0.0
5838,0,5838,[197  15 194   4 111],342,2,23916,4.095906833361877,0.0,0.0
5839,0,5839,[ 64 483 313 318 187],618,5,23921,4.0960616438356166,80.0,20.0
5840,0,5840,[100 568 475 385 228],805,2,23923,4.095702790618045,0.0,0.0
5841,0,5841,[ 64 483 313 318 187],214,5,23928,4.095857583019514,80.0,20.0
5842,0,5842,[195 197  88  11 185],805,2,23930,4.095498887557762,0.0,0.0
5843,0,5843,[ 25  98 588 301 174],588,3,23933,4.095311430527036,0.0,20.0
5844,0,5844,[ 64 483 313 318 187],618,5,23938,4.09546621043627,80.0,20.0
5845,0,5845,[ 64 483 313 318 187],618,5,23943,4.09562093739309,80.0,20.0
5846,0,5846,[117 294 204 742 496],314,5,23948,4.095775611424663,0.0,0.0
5847,0,5847,[127  96 153 288 568],417,2,23950,4.095417236662107,0.0,20.0
5848,0,5848,[ 64 483 313 318 187],214,5,23955,4.095571892631219,80.0,20.0
5849,0,5849,[182 161 196 210 238],416,5,23960,4.095726495726495,0.0,0.0
5850,0,5850,[265 276  22 121  69],416,4,23964,4.0957101350196545,0.0,0.0
5851,0,5851,[ 69 216 271 273 475],62,4,23968,4.095693779904306,0.0,0.0
5852,0,5852,[268 121  88 172 182],128,3,23971,4.095506577823339,0.0,0.0
5853,0,5853,[ 64 483 313 318 187],214,5,23976,4.095661086436625,80.0,20.0
5854,0,5854,[144 237 215  88 568],416,3,23979,4.095473953885568,0.0,0.0
5855,0,5855,[ 64 483 313 318 187],214,5,23984,4.095628415300546,80.0,20.0
5856,0,5856,[181  95  98 100 174],262,1,23985,4.09509988048489,0.0,40.0
5857,0,5857,[ 56 118 322  69 235],416,2,23987,4.094742232843974,0.0,0.0
5858,0,5858,[294 275 318 216 603],854,3,23990,4.094555384877966,20.0,0.0
5859,0,5859,[ 64 483 313 318 187],618,5,23995,4.0947098976109215,80.0,20.0
5860,0,5860,[175  22 127 117 300],253,4,23999,4.09469373826992,0.0,0.0
5861,0,5861,[ 64 483 313 318 187],618,5,24004,4.094848174684408,80.0,20.0
5862,0,5862,[603   9 597 151 153],416,3,24007,4.09466143612485,0.0,0.0
5863,0,5863,[ 64 483 313 318 187],618,5,24012,4.0948158253751705,80.0,20.0
5864,0,5864,[ 64 483 313 318 187],214,5,24017,4.094970161977835,80.0,20.0
5865,0,5865,[ 98 318 265   1 323],416,4,24021,4.094953972042277,20.0,20.0
5866,0,5866,[ 96   9 258  28  82],62,4,24025,4.094937787625703,0.0,0.0
5867,0,5867,[197 748 100  79  89],805,4,24029,4.09492160872529,0.0,0.0
5868,0,5868,[121 237 127 405 748],759,3,24032,4.094735048560231,0.0,0.0
5869,0,5869,[  8 597 183 127 238],618,3,24035,4.0945485519591145,0.0,0.0
5870,0,5870,[235 237 181  50  12],416,3,24038,4.094362118889457,20.0,40.0
5871,0,5871,[ 96 471 301  70 385],416,5,24043,4.094516348773842,0.0,0.0
5872,0,5872,[427 144 127  98  71],618,5,24048,4.094670526136557,0.0,20.0
5873,0,5873,[ 64 483 313 318 187],618,5,24053,4.094824651004426,80.0,20.0
5874,0,5874,[ 64 483 313 318 187],618,5,24058,4.094978723404255,80.0,20.0
5875,0,5875,[228 118 483 100  69],601,3,24061,4.094792375765827,20.0,0.0
5876,0,5876,[ 50 228 568 423 265],128,4,24065,4.0947762463842095,0.0,20.0
5877,0,5877,[ 64 483 313 318 187],618,5,24070,4.094930248383804,80.0,20.0
5878,0,5878,[ 71 742 282 286  11],345,2,24072,4.094573907127063,0.0,0.0
5879,0,5879,[200 258 403 282  79],416,5,24077,4.094727891156462,0.0,0.0
5880,0,5880,[181 258 186 568 195],642,3,24080,4.094541744601258,0.0,20.0
5881,0,5881,[ 64 483 313 318 187],214,5,24085,4.094695681740904,80.0,20.0
5882,0,5882,[211 173  95  71 132],416,4,24089,4.094679585245623,0.0,0.0
5883,0,5883,[ 64 483 313 318 187],214,5,24094,4.094833446634942,80.0,20.0
5884,0,5884,[483 151  69 318 111],618,3,24097,4.0946474086661,40.0,0.0
5885,0,5885,[318  70 174  98  56],405,4,24101,4.094631328576282,20.0,20.0
5886,0,5886,[185 742 187 288  79],416,5,24106,4.094785119755393,0.0,20.0
5887,0,5887,[210 118 143  82 179],601,2,24108,4.094429347826087,0.0,0.0
5888,0,5888,[742 546 191 176 300],416,4,24112,4.094413312956359,0.0,0.0
5889,0,5889,[182 288 216 435 172],437,2,24114,4.094057724957556,0.0,20.0
5890,0,5890,[ 64 483 313 318 187],618,5,24119,4.09421150908165,80.0,20.0
5891,0,5891,[  1 597 300  56 182],416,4,24123,4.094195519348268,0.0,0.0
5892,0,5892,[ 64 483 313 318 187],214,5,24128,4.0943492278975055,80.0,20.0
5893,0,5893,[742 117   4 508 161],345,4,24132,4.094333220223956,0.0,0.0
5894,0,5894,[ 64 483 313 318 187],618,5,24137,4.0944868532654795,80.0,20.0
5895,0,5895,[ 64 483 313 318 187],214,5,24142,4.094640434192673,80.0,20.0
5896,0,5896,[194 168 405 423 197],416,5,24147,4.09479396303205,0.0,0.0
5897,0,5897,[127 323 678 237 403],416,2,24149,4.094438792811123,0.0,0.0
5898,0,5898,[ 15 423 742 191 210],62,2,24151,4.094083743007289,0.0,0.0
5899,0,5899,[496 176  96 273 197],416,5,24156,4.094237288135593,0.0,0.0
5900,0,5900,[ 64 483 313 318 187],214,5,24161,4.094390781223521,80.0,20.0
5901,0,5901,[176 508 216 294 144],854,1,24162,4.093866485936971,0.0,0.0
5902,0,5902,[ 64 483 313 318 187],214,5,24167,4.094019989835677,80.0,20.0
5903,0,5903,[176 271 294 237 197],854,2,24169,4.093665311653116,0.0,0.0
5904,0,5904,[ 64 483 313 318 187],618,5,24174,4.093818797629128,80.0,20.0
5905,0,5905,[179 200  96  79 143],405,2,24176,4.0934642736200475,0.0,0.0
5906,0,5906,[200  56  15 144 186],417,4,24180,4.09344845099035,0.0,0.0
5907,0,5907,[435  79   8 265 135],297,2,24182,4.093094109681787,0.0,0.0
5908,0,5908,[318 273 328 187  25],416,5,24187,4.093247588424437,20.0,0.0
5909,0,5909,[ 64 483 313 318 187],214,5,24192,4.093401015228427,80.0,20.0
5910,0,5910,[475 118 357 216 275],854,3,24195,4.093216037895449,0.0,0.0
5911,0,5911,[186 194 423  69  88],373,4,24199,4.093200270635995,0.0,0.0
5912,0,5912,[471 257 288  56  50],297,2,24201,4.0928462709284625,0.0,40.0
5913,0,5913,[ 64 483 313 318 187],618,5,24206,4.0929996618194115,80.0,20.0
5914,0,5914,[  8 174 286 204 118],297,3,24209,4.092814877430262,0.0,0.0
5915,0,5915,[ 64 483 313 318 187],618,5,24214,4.092968221771467,80.0,20.0
5916,0,5916,[ 64 483 313 318 187],618,5,24219,4.093121514280885,80.0,20.0
5917,0,5917,[237 216 258 427 265],128,4,24223,4.0931057789793845,0.0,0.0
5918,0,5918,[ 64 483 313 318 187],214,5,24228,4.093258996452104,80.0,20.0
5919,0,5919,[ 64 483 313 318 187],618,5,24233,4.093412162162162,80.0,20.0
5920,0,5920,[258   8 151 143 161],711,5,24238,4.093565276135788,0.0,0.0
5921,0,5921,[ 95 496  56 179   7],342,5,24243,4.0937183383991895,0.0,0.0
5922,0,5922,[100  64 318 483 181],62,5,24248,4.093871348978558,60.0,20.0
5923,0,5923,[181 191 151 300  25],345,3,24251,4.093686698176907,0.0,20.0
5924,0,5924,[ 64 483 313 318 187],214,5,24256,4.093839662447257,80.0,20.0
5925,0,5925,[475 176 204 174  69],437,2,24258,4.093486331420857,0.0,0.0
5926,0,5926,[ 64 483 313 318 187],618,5,24263,4.093639277880884,80.0,20.0
5927,0,5927,[172 275 237 127 125],618,3,24266,4.093454790823212,0.0,0.0
5928,0,5928,[655 174  25 403 151],198,4,24270,4.093439028503964,0.0,0.0
5929,0,5929,[174 121  89 597  96],417,1,24271,4.0929173693086005,0.0,0.0
5930,0,5930,[423 471 151 187 328],416,4,24275,4.092901702916877,0.0,0.0
5931,0,5931,[186 211 196 405  69],43,4,24279,4.092886041807148,0.0,0.0
5932,0,5932,[385 117 196 144 238],373,3,24282,4.092701837181864,0.0,0.0
5933,0,5933,[ 64 483 313 318 187],214,5,24287,4.0928547354229865,80.0,20.0
5934,0,5934,[ 64 483 313 318 187],618,5,24292,4.093007582139848,80.0,20.0
5935,0,5935,[ 64 483 313 318 187],214,5,24297,4.09316037735849,80.0,20.0
5936,0,5936,[ 64 483 313 318 187],618,5,24302,4.093313121104935,80.0,20.0
5937,0,5937,[ 64 483 313 318 187],214,5,24307,4.093465813405187,80.0,20.0
5938,0,5938,[200 288 603  22   7],297,3,24310,4.0932816972554305,0.0,20.0
5939,0,5939,[234  70 202 257 301],297,2,24312,4.092929292929293,0.0,0.0
5940,0,5940,[ 64 483 313 318 187],214,5,24317,4.093081972731864,80.0,20.0
5941,0,5941,[ 64 483 313 318 187],214,5,24322,4.093234601144395,80.0,20.0
5942,0,5942,[ 64 483 313 318 187],618,5,24327,4.093387178192832,80.0,20.0
5943,0,5943,[  8 475 302 257 268],854,2,24329,4.093034993270525,0.0,0.0
5944,0,5944,[ 64 483 313 318 187],618,5,24334,4.093187552565181,80.0,20.0
5945,0,5945,[ 64 483 313 318 187],214,5,24339,4.093340060544904,80.0,20.0
5946,0,5946,[ 64 483 313 318 187],618,5,24344,4.093492517235581,80.0,20.0
5947,0,5947,[ 64 483 313 318 187],618,5,24349,4.09364492266308,80.0,20.0
5948,0,5948,[ 64 483 313 318 187],214,5,24354,4.093797276853253,80.0,20.0
5949,0,5949,[318 385  56 597 568],416,4,24358,4.093781512605042,20.0,0.0
5950,0,5950,[ 70 135  25 202   1],417,3,24361,4.093597714669803,0.0,0.0
5951,0,5951,[ 64 483 313 318 187],618,5,24366,4.09375,80.0,20.0
5952,0,5952,[ 96 403 597 546 180],417,2,24368,4.0933982865781955,0.0,0.0
5953,0,5953,[234 515  82 385 588],405,2,24370,4.093046691299967,0.0,0.0
5954,0,5954,[ 98  95 268 546 588],416,3,24373,4.092863140218304,0.0,20.0
5955,0,5955,[ 64 483 313 318 187],618,5,24378,4.093015446608462,80.0,20.0
5956,0,5956,[  4 271 258 179 182],62,4,24382,4.092999832130267,0.0,0.0
5957,0,5957,[ 64 483 313 318 187],214,5,24387,4.093152064451158,80.0,20.0
5958,0,5958,[ 64 483 313 318 187],214,5,24392,4.093304245678805,80.0,20.0
5959,0,5959,[135 228  79   1 161],417,1,24393,4.0927852348993286,0.0,0.0
5960,0,5960,[318 125 121 568 496],642,4,24397,4.092769669518537,20.0,0.0
5961,0,5961,[143 568 318 111   4],345,5,24402,4.092921838309292,20.0,0.0
5962,0,5962,[271 197 237 423 211],297,2,24404,4.0925708535971825,0.0,0.0
5963,0,5963,[ 64 483 313 318 187],618,5,24409,4.092723004694836,80.0,20.0
5964,0,5964,[ 64 483 313 318 187],618,5,24414,4.092875104777871,80.0,20.0
5965,0,5965,[174 678 597 258 172],416,3,24417,4.092691920885015,0.0,0.0
5966,0,5966,[  4 515 153 271 475],297,3,24420,4.092508798391151,0.0,0.0
5967,0,5967,[117 210 678  97 508],654,3,24423,4.092325737265416,0.0,0.0
5968,0,5968,[ 64 483 313 318 187],214,5,24428,4.09247780197688,80.0,20.0
5969,0,5969,[ 64 483 313 318 187],214,5,24433,4.0926298157453935,80.0,20.0
5970,0,5970,[118 195 603 742 238],805,2,24435,4.092279350192597,0.0,0.0
5971,0,5971,[ 64 483 313 318 187],214,5,24440,4.092431346282653,80.0,20.0
5972,0,5972,[300 173  11 427 258],24,5,24445,4.092583291478319,0.0,0.0
5973,0,5973,[ 50  71 258 655 546],262,3,24448,4.0924004017408775,0.0,20.0
5974,0,5974,[333 153 196 273  22],416,5,24453,4.09255230125523,0.0,0.0
5975,0,5975,[121 216  95  69 186],711,2,24455,4.092202141900937,0.0,0.0
5976,0,5976,[187 172 174 471 678],416,4,24459,4.092186715743684,0.0,0.0
5977,0,5977,[235 288 195 194 222],854,2,24461,4.091836734693878,0.0,20.0
5978,0,5978,[ 64 483 313 318 187],618,5,24466,4.091988626860679,80.0,20.0
5979,0,5979,[  7 153 215 300  50],751,3,24469,4.0918060200668895,0.0,20.0
5980,0,5980,[ 64 483 313 318 187],618,5,24474,4.091957866577496,80.0,20.0
5981,0,5981,[ 64 483 313 318 187],618,5,24479,4.092109662320294,80.0,20.0
5982,0,5982,[603 269  97 168 357],373,4,24483,4.092094267090088,0.0,0.0
5983,0,5983,[191 172 179 237 181],128,3,24486,4.091911764705882,0.0,20.0
5984,0,5984,[125 597 168  56   7],62,4,24490,4.091896407685882,0.0,0.0
5985,0,5985,[286  50 197 276 483],354,4,24494,4.0918810557968595,20.0,20.0
5986,0,5986,[423 286 125 173   8],416,5,24499,4.092032737598129,0.0,0.0
5987,0,5987,[268 286 655 234  56],417,5,24504,4.092184368737475,0.0,0.0
5988,0,5988,[258 245 196 181  64],62,4,24508,4.092168976456837,20.0,20.0
5989,0,5989,[235   4  28 125  56],416,4,24512,4.092153589315526,0.0,0.0
5990,0,5990,[  4  11 282 237  22],297,3,24515,4.091971290268736,0.0,0.0
5991,0,5991,[ 64 483 313 318 187],214,5,24520,4.092122830440587,80.0,20.0
5992,0,5992,[302 161 196 182 405],417,2,24522,4.091773736025363,0.0,0.0
5993,0,5993,[ 64 483 313 318 187],618,5,24527,4.0919252585919255,80.0,20.0
5994,0,5994,[ 64 483 313 318 187],618,5,24532,4.092076730608841,80.0,20.0
5995,0,5995,[ 64 483 313 318 187],618,5,24537,4.092228152101401,80.0,20.0
5996,0,5996,[588 318 200 185 168],437,3,24540,4.092046023011505,20.0,0.0
5997,0,5997,[ 64 483 313 318 187],618,5,24545,4.0921973991330445,80.0,20.0
5998,0,5998,[323 196 282  98 191],416,4,24549,4.09218203033839,0.0,20.0
5999,0,5999,[ 64 483 313 318 187],214,5,24554,4.092333333333333,80.0,20.0
6000,0,6000,[ 64 483 313 318 187],618,5,24559,4.0924845859023495,80.0,20.0
6001,0,6001,[655 127 187 151 121],887,3,24562,4.092302565811396,0.0,0.0
6002,0,6002,[405  96 282   8 403],705,4,24566,4.092287189738464,0.0,0.0
6003,0,6003,[333 181 132 286 144],588,4,24570,4.092271818787475,0.0,20.0
6004,0,6004,[ 64 483 313 318 187],618,5,24575,4.0924229808492925,80.0,20.0
6005,0,6005,[121 300 257  50  11],654,5,24580,4.092574092574092,0.0,20.0
6006,0,6006,[508  98 403 111 237],62,3,24583,4.092392209089396,0.0,20.0
6007,0,6007,[678 265 269 174 216],416,4,24587,4.092376830892144,0.0,0.0
6008,0,6008,[245 273 268 475   7],416,3,24590,4.092195040772175,0.0,0.0
6009,0,6009,[118 265 496   7 143],618,4,24594,4.092179700499168,0.0,0.0
6010,0,6010,[ 64 483 313 318 187],214,5,24599,4.092330727000499,80.0,20.0
6011,0,6011,[ 88 234 222 288 483],588,4,24603,4.092315369261477,20.0,20.0
6012,0,6012,[427  96 117 174 168],416,5,24608,4.092466322966905,0.0,0.0
6013,0,6013,[195  82 182 151 273],416,4,24612,4.092450947788493,0.0,0.0
6014,0,6014,[286  88 151 568 168],711,4,24616,4.092435577722361,0.0,0.0
6015,0,6015,[ 64 483 313 318 187],214,5,24621,4.092586436170213,80.0,20.0
6016,0,6016,[228  82 197 276  97],128,3,24624,4.092404852916736,0.0,0.0
6017,0,6017,[ 64 483 313 318 187],214,5,24629,4.092555666334331,80.0,20.0
6018,0,6018,[117  70 174 211 265],417,3,24632,4.0923741485296565,0.0,0.0
6019,0,6019,[276  79  25 588 238],43,4,24636,4.092358803986711,0.0,0.0
6020,0,6020,[403  28 127 655 603],405,4,24640,4.092343464540774,0.0,0.0
6021,0,6021,[ 11 238 215  28 204],654,5,24645,4.092494187977416,0.0,0.0
6022,0,6022,[ 64 483 313 318 187],214,5,24650,4.092644861364769,80.0,20.0
6023,0,6023,[ 64 483 313 318 187],618,5,24655,4.0927954847277555,80.0,20.0
6024,0,6024,[258 423 238  98 216],43,4,24659,4.092780082987552,0.0,20.0
6025,0,6025,[ 64 483 313 318 187],618,5,24664,4.092930633919681,80.0,20.0
6026,0,6026,[ 64 483 313 318 187],618,5,24669,4.093081134892982,80.0,20.0
6027,0,6027,[ 64 483 313 318 187],618,5,24674,4.093231585932316,80.0,20.0
6028,0,6028,[ 28  97  56 179 237],437,3,24677,4.093050257090728,0.0,0.0
6029,0,6029,[ 64 483 313 318 187],214,5,24682,4.093200663349917,80.0,20.0
6030,0,6030,[143  15 100 117 294],654,2,24684,4.092853589786105,0.0,0.0
6031,0,6031,[ 64 483 313 318 187],214,5,24689,4.093003978779841,80.0,20.0
6032,0,6032,[ 64 483 313 318 187],618,5,24694,4.093154317918117,80.0,20.0
6033,0,6033,[118 179 172 748  88],805,2,24696,4.092807424593968,0.0,0.0
6034,0,6034,[294  50  71 237 471],128,5,24701,4.092957746478874,0.0,20.0
6035,0,6035,[ 64 483 313 318 187],214,5,24706,4.093108018555335,80.0,20.0
6036,0,6036,[678 222  70 168 121],654,5,24711,4.093258240848104,0.0,0.0
6037,0,6037,[597 202 483 151  79],618,3,24714,4.093077177873468,20.0,0.0
6038,0,6038,[211 153  15 300   4],416,5,24719,4.093227355522438,0.0,0.0
6039,0,6039,[568 180 294 135 197],805,2,24721,4.092880794701987,0.0,0.0
6040,0,6040,[ 64 483 313 318 187],214,5,24726,4.093030955139877,80.0,20.0
6041,0,6041,[ 64 483 313 318 187],214,5,24731,4.093181065872228,80.0,20.0
6042,0,6042,[ 64 483 313 318 187],214,5,24736,4.093331126923713,80.0,20.0
6043,0,6043,[ 64 483 313 318 187],618,5,24741,4.093481138318994,80.0,20.0
6044,0,6044,[ 97  50 238   8 176],437,3,24744,4.0933002481389575,0.0,20.0
6045,0,6045,[ 64   7 423   1 597],62,2,24746,4.092954019186239,20.0,0.0
6046,0,6046,[ 64 483 313 318 187],214,5,24751,4.093104018521581,80.0,20.0
6047,0,6047,[ 64 483 313 318 187],214,5,24756,4.093253968253968,80.0,20.0
6048,0,6048,[ 64 483 313 318 187],214,5,24761,4.093403868408001,80.0,20.0
6049,0,6049,[237 318 204 268 100],654,3,24764,4.093223140495867,20.0,0.0
6050,0,6050,[ 64 483 313 318 187],618,5,24769,4.093372996198975,80.0,20.0
6051,0,6051,[ 64 483 313 318 187],214,5,24774,4.093522802379379,80.0,20.0
6052,0,6052,[328 215  28 151 265],373,4,24778,4.093507351726417,0.0,0.0
6053,0,6053,[ 50 202 117 748 302],297,3,24781,4.093326726131483,0.0,20.0
6054,0,6054,[ 64 483 313 318 187],214,5,24786,4.093476465730801,80.0,20.0
6055,0,6055,[ 64 483 313 318 187],214,5,24791,4.093626155878468,80.0,20.0
6056,0,6056,[196 678 127 153 185],805,3,24794,4.093445600132078,0.0,0.0
6057,0,6057,[ 64 483 313 318 187],214,5,24799,4.093595245955761,80.0,20.0
6058,0,6058,[181  82 118 191 515],417,4,24803,4.093579798646641,0.0,20.0
6059,0,6059,[ 64 483 313 318 187],214,5,24808,4.093729372937294,80.0,20.0
6060,0,6060,[ 64 483 313 318 187],618,5,24813,4.0938788978716385,80.0,20.0
6061,0,6061,[268 172 238 204 313],416,5,24818,4.094028373474101,20.0,20.0
6062,0,6062,[ 64 483 313 318 187],214,5,24823,4.094177799769091,80.0,20.0
6063,0,6063,[269 117 151 238 210],654,5,24828,4.094327176781003,0.0,0.0
6064,0,6064,[ 64 483 313 318 187],618,5,24833,4.094476504534213,80.0,20.0
6065,0,6065,[ 64 483 313 318 187],618,5,24838,4.094625783053083,80.0,20.0
6066,0,6066,[ 64 483 313 318 187],618,5,24843,4.094775012361958,80.0,20.0
6067,0,6067,[301 405 121 238 195],416,5,24848,4.094924192485168,0.0,0.0
6068,0,6068,[238 111 237 275 210],43,4,24852,4.094908551655957,0.0,0.0
6069,0,6069,[ 64 483 313 318 187],618,5,24857,4.09505766062603,80.0,20.0
6070,0,6070,[ 64 483 313 318 187],214,5,24862,4.095206720474386,80.0,20.0
6071,0,6071,[ 64 483 313 318 187],618,5,24867,4.095355731225297,80.0,20.0
6072,0,6072,[ 64 483 313 318 187],214,5,24872,4.095504692903013,80.0,20.0
6073,0,6073,[ 64 483 313 318 187],214,5,24877,4.0956536055317745,80.0,20.0
6074,0,6074,[143 603 288 515 289],416,4,24881,4.095637860082305,0.0,20.0
6075,0,6075,[ 64 483 313 318 187],214,5,24886,4.095786701777485,80.0,20.0
6076,0,6076,[ 64 483 313 318 187],618,5,24891,4.095935494487412,80.0,20.0
6077,0,6077,[172  69   8 496 357],601,3,24894,4.095755182625863,0.0,0.0
6078,0,6078,[ 64 483 313 318 187],214,5,24899,4.095903931567692,80.0,20.0
6079,0,6079,[ 12 176 127  97 185],618,5,24904,4.096052631578948,20.0,0.0
6080,0,6080,[ 70  96 275 179  79],416,4,24908,4.096036836046703,0.0,0.0
6081,0,6081,[323 216 143 204 423],43,4,24912,4.096021045708649,0.0,0.0
6082,0,6082,[403 204 197 168 187],405,4,24916,4.096005260562222,0.0,0.0
6083,0,6083,[181 265 435 200  95],437,3,24919,4.095825115055884,0.0,20.0
6084,0,6084,[403 118 210 427 191],416,4,24923,4.095809367296631,0.0,0.0
6085,0,6085,[286 143 121 234 237],437,3,24926,4.095629313177785,0.0,0.0
6086,0,6086,[111 568  97 144 210],588,2,24928,4.095285033678331,0.0,0.0
6087,0,6087,[ 64 483 313 318 187],214,5,24933,4.095433639947437,80.0,20.0
6088,0,6088,[ 64 483 313 318 187],618,5,24938,4.0955821974051565,80.0,20.0
6089,0,6089,[175 168 282 117 100],854,3,24941,4.0954022988505745,0.0,0.0
6090,0,6090,[475 333 151 273 742],854,3,24944,4.095222459366278,0.0,0.0
6091,0,6091,[ 64 483 313 318 187],214,5,24949,4.095370978332239,80.0,20.0
6092,0,6092,[179  12 234 174 475],601,3,24952,4.0951912030198585,20.0,0.0
6093,0,6093,[118 423 313 678 185],416,3,24955,4.095011486708238,20.0,20.0
6094,0,6094,[ 64 483 313 318 187],618,5,24960,4.095159967186218,80.0,20.0
6095,0,6095,[323 173  50   4 496],764,1,24961,4.094652230971128,0.0,20.0
6096,0,6096,[294 143  64  11  82],43,5,24966,4.0948007216663935,20.0,0.0
6097,0,6097,[ 64 483 313 318 187],618,5,24971,4.094949163660217,80.0,20.0
6098,0,6098,[118  22  12 168  98],416,4,24975,4.094933595671422,20.0,20.0
6099,0,6099,[ 12 173 200 403 238],417,5,24980,4.0950819672131145,20.0,0.0
6100,0,6100,[588 173  15  98 121],764,4,24984,4.095066382560236,0.0,20.0
6101,0,6101,[ 71 568   9 100 300],416,5,24989,4.0952146837102585,0.0,0.0
6102,0,6102,[ 64 483 313 318 187],618,5,24994,4.095362936260855,80.0,20.0
6103,0,6103,[ 64 483 313 318 187],618,5,24999,4.095511140235911,80.0,20.0
6104,0,6104,[ 64 483 313 318 187],618,5,25004,4.095659295659296,80.0,20.0
6105,0,6105,[ 64 483 313 318 187],618,5,25009,4.095807402554864,80.0,20.0
6106,0,6106,[423 333 197 323 202],416,4,25013,4.095791714426069,0.0,0.0
6107,0,6107,[ 64 483 313 318 187],214,5,25018,4.095939751146038,80.0,20.0
6108,0,6108,[597 403 153 161 568],416,4,25022,4.095924046488787,0.0,0.0
6109,0,6109,[405 258 318  96 151],854,4,25026,4.095908346972177,20.0,0.0
6110,0,6110,[ 64 483 313 318 187],214,5,25031,4.09605629193258,80.0,20.0
6111,0,6111,[276   8 202 265  98],437,4,25035,4.096040575916231,0.0,20.0
6112,0,6112,[181 235 175  50 183],297,4,25039,4.096024865041715,0.0,40.0
6113,0,6113,[238 196 423 182  71],405,2,25041,4.09568204121688,0.0,0.0
6114,0,6114,[568 237 151 191  15],642,4,25045,4.095666394112837,0.0,0.0
6115,0,6115,[ 64 483 313 318 187],214,5,25050,4.095814257684761,80.0,20.0
6116,0,6116,[ 64 483 313 318 187],618,5,25055,4.095962072911558,80.0,20.0
6117,0,6117,[603 179 194 323 597],416,2,25057,4.095619483491337,0.0,0.0
6118,0,6118,[180  98 211 172 181],437,5,25062,4.095767282235659,0.0,40.0
6119,0,6119,[197 588  12 151 215],345,4,25066,4.095751633986928,20.0,0.0
6120,0,6120,[ 64 483 313 318 187],618,5,25071,4.095899362849208,80.0,20.0
6121,0,6121,[ 64 483 313 318 187],214,5,25076,4.096047043449853,80.0,20.0
6122,0,6122,[ 64 483 313 318 187],618,5,25081,4.0961946758125105,80.0,20.0
6123,0,6123,[508 603  25 237   1],297,4,25085,4.096178967994775,0.0,0.0
6124,0,6124,[ 64 483 313 318 187],214,5,25090,4.096326530612245,80.0,20.0
6125,0,6125,[ 64 483 313 318 187],618,5,25095,4.096474045053869,80.0,20.0
6126,0,6126,[161 127  79  89 228],805,2,25097,4.096131875306023,0.0,0.0
6127,0,6127,[100  70 405   7  56],230,3,25100,4.095953002610966,0.0,0.0
6128,0,6128,[ 64 483 313 318 187],618,5,25105,4.096100505792136,80.0,20.0
6129,0,6129,[ 64 483 313 318 187],214,5,25110,4.096247960848287,80.0,20.0
6130,0,6130,[  8 186 597 111 143],588,4,25114,4.096232262273691,0.0,0.0
6131,0,6131,[181   7 125 318 204],62,4,25118,4.096216568819308,20.0,20.0
6132,0,6132,[ 50 475 186 118 385],588,2,25120,4.095874775803033,0.0,20.0
6133,0,6133,[118 121 748 742 302],345,2,25122,4.095533094228888,0.0,0.0
6134,0,6134,[471 300 302 187  82],416,5,25127,4.095680521597392,0.0,0.0
6135,0,6135,[173 496  56 328 742],416,5,25132,4.095827900912647,0.0,0.0
6136,0,6136,[ 64 483 313 318 187],214,5,25137,4.095975232198143,80.0,20.0
6137,0,6137,[ 64 483 313 318 187],618,5,25142,4.096122515477354,80.0,20.0
6138,0,6138,[ 64 483 313 318 187],618,5,25147,4.096269750773741,80.0,20.0
6139,0,6139,[ 64 483 313 318 187],214,5,25152,4.09641693811075,80.0,20.0
6140,0,6140,[588 427 181  11 168],618,5,25157,4.096564077511806,0.0,20.0
6141,0,6141,[215  96 173 273 322],416,4,25161,4.0965483555845,0.0,0.0
6142,0,6142,[ 64 483 313 318 187],214,5,25166,4.096695425687774,80.0,20.0
6143,0,6143,[ 64 483 313 318 187],214,5,25171,4.096842447916667,80.0,20.0
6144,0,6144,[ 64 483 313 318 187],214,5,25176,4.096989422294548,80.0,20.0
6145,0,6145,[ 64 483 313 318 187],214,5,25181,4.097136348844777,80.0,20.0
6146,0,6146,[222 742  98  79 151],43,5,25186,4.097283227590695,0.0,20.0
6147,0,6147,[ 88 588   8  11 655],618,4,25190,4.097267404033832,0.0,0.0
6148,0,6148,[ 64 483 313 318 187],618,5,25195,4.097414213693283,80.0,20.0
6149,0,6149,[  7 216 181  95 423],43,5,25200,4.097560975609756,0.0,20.0
6150,0,6150,[ 64 483 313 318 187],214,5,25205,4.097707689806535,80.0,20.0
6151,0,6151,[ 64 483 313 318 187],618,5,25210,4.097854356306892,80.0,20.0
6152,0,6152,[268  82 245 655  79],128,2,25212,4.097513408093613,0.0,0.0
6153,0,6153,[275  89  96 111 100],854,3,25215,4.097335066623335,0.0,0.0
6154,0,6154,[187 100   4  82 195],373,2,25217,4.096994313566206,0.0,0.0
6155,0,6155,[ 64 483 313 318 187],618,5,25222,4.097141000649772,80.0,20.0
6156,0,6156,[328  25  98 143 273],416,5,25227,4.097287640084457,0.0,20.0
6157,0,6157,[294 183 333 588 546],416,4,25231,4.097271841506982,0.0,0.0
6158,0,6158,[435 385 127 181 143],373,2,25233,4.0969313200194835,0.0,20.0
6159,0,6159,[173 237 187 318 111],416,4,25237,4.0969155844155845,20.0,0.0
6160,0,6160,[ 64 483 313 318 187],618,5,25242,4.097062165232916,80.0,20.0
6161,0,6161,[222 191 403  28 276],62,4,25246,4.09704641350211,0.0,0.0
6162,0,6162,[ 64 483 313 318 187],214,5,25251,4.097192925523284,80.0,20.0
6163,0,6163,[302 268 508 257 185],854,2,25253,4.096852693056457,0.0,0.0
6164,0,6164,[ 64 483 313 318 187],214,5,25258,4.096999188969992,80.0,20.0
6165,0,6165,[276 174 568 655  15],198,2,25260,4.096659098280895,0.0,0.0
6166,0,6166,[ 64 483 313 318 187],618,5,25265,4.096805578076861,80.0,20.0
6167,0,6167,[286 235 153  12 132],417,4,25269,4.096789883268483,20.0,0.0
6168,0,6168,[ 64 483 313 318 187],214,5,25274,4.0969362943751015,80.0,20.0
6169,0,6169,[ 64 483 313 318 187],214,5,25279,4.09708265802269,80.0,20.0
6170,0,6170,[ 88 197 323 143 258],345,4,25283,4.097066925943931,0.0,0.0
6171,0,6171,[288 228 216 197 245],721,3,25286,4.096889176928062,0.0,20.0
6172,0,6172,[100  12 294 742  50],654,3,25289,4.096711485501377,20.0,20.0
6173,0,6173,[ 64 483 313 318 187],618,5,25294,4.096857790735342,80.0,20.0
6174,0,6174,[ 64 483 313 318 187],618,5,25299,4.097004048582996,80.0,20.0
6175,0,6175,[678   8 265 546 597],416,2,25301,4.0966645077720205,0.0,0.0
6176,0,6176,[ 95 176 568  71 200],198,2,25303,4.096325076898171,0.0,0.0
6177,0,6177,[385  89 197 204 195],405,3,25306,4.096147620589187,0.0,0.0
6178,0,6178,[ 89 210 182 132  56],405,3,25309,4.095970221718725,0.0,0.0
6179,0,6179,[ 64 483 313 318 187],214,5,25314,4.096116504854369,80.0,20.0
6180,0,6180,[ 64 483 313 318 187],214,5,25319,4.096262740656852,80.0,20.0
6181,0,6181,[ 64 483 313 318 187],214,5,25324,4.096408929149143,80.0,20.0
6182,0,6182,[ 64 483 313 318 187],214,5,25329,4.096555070354197,80.0,20.0
6183,0,6183,[ 64 483 313 318 187],214,5,25334,4.096701164294955,80.0,20.0
6184,0,6184,[ 15 333 276  22 597],416,3,25337,4.096523848019402,0.0,0.0
6185,0,6185,[215 748 135  70 196],297,3,25340,4.096346589072098,0.0,0.0
6186,0,6186,[153 655 117 742 282],416,5,25345,4.096492645870374,0.0,0.0
6187,0,6187,[ 64 483 313 318 187],618,5,25350,4.0966386554621845,80.0,20.0
6188,0,6188,[234 182 151 173  25],618,2,25352,4.096299886896106,0.0,0.0
6189,0,6189,[288 187 234 176 471],416,5,25357,4.096445880452342,0.0,20.0
6190,0,6190,[742  28 588 222   1],297,3,25360,4.096268777257309,0.0,0.0
6191,0,6191,[ 64 483 313 318 187],618,5,25365,4.096414728682171,80.0,20.0
6192,0,6192,[ 64 483 313 318 187],214,5,25370,4.096560632972711,80.0,20.0
6193,0,6193,[423 265 435  28 168],297,2,25372,4.096222150468195,0.0,0.0
6194,0,6194,[ 69 294 238 496 185],417,2,25374,4.09588377723971,0.0,0.0
6195,0,6195,[588 318 238 183  22],601,3,25377,4.095706907682375,20.0,0.0
6196,0,6196,[ 95   4 127  15 173],373,4,25381,4.095691463611425,0.0,0.0
6197,0,6197,[ 64 483 313 318 187],618,5,25386,4.095837366892546,80.0,20.0
6198,0,6198,[ 11 135 144 185  50],230,3,25389,4.095660590417809,0.0,20.0
6199,0,6199,[ 95 195 496 333  22],416,4,25393,4.095645161290323,0.0,0.0
6200,0,6200,[ 64 483 313 318 187],214,5,25398,4.095791001451379,80.0,20.0
6201,0,6201,[174 403 496 202  88],373,3,25401,4.095614317961948,0.0,0.0
6202,0,6202,[161 588 275 118 100],588,2,25403,4.095276479123005,0.0,0.0
6203,0,6203,[ 70 234 748 245  96],642,3,25406,4.095099935525467,0.0,0.0
6204,0,6204,[216  71 238  98 275],416,5,25411,4.095245769540693,0.0,20.0
6205,0,6205,[ 64 483 313 318 187],618,5,25416,4.0953915565581696,80.0,20.0
6206,0,6206,[191  95 269 748 117],297,2,25418,4.0950539713227005,0.0,0.0
6207,0,6207,[125 245 403 322 202],417,4,25422,4.095038659793815,0.0,0.0
6208,0,6208,[185 118  69 172 222],198,2,25424,4.094701240135287,0.0,0.0
6209,0,6209,[ 64 483 313 318 187],214,5,25429,4.094847020933978,80.0,20.0
6210,0,6210,[127 237  25 313  28],43,5,25434,4.094992754789889,20.0,20.0
6211,0,6211,[ 64 483 313 318 187],214,5,25439,4.095138441725692,80.0,20.0
6212,0,6212,[471 234 204 186 202],588,4,25443,4.095123128923225,0.0,0.0
6213,0,6213,[132 195  56 183 471],505,2,25445,4.094785967170904,0.0,0.0
6214,0,6214,[196 328 210 333 176],416,5,25450,4.094931617055511,0.0,0.0
6215,0,6215,[173 294 183 475 228],297,3,25453,4.094755469755469,0.0,0.0
6216,0,6216,[191 185  22 127 257],601,4,25457,4.094740228405984,0.0,0.0
6217,0,6217,[196 328 168 100  88],373,4,25461,4.094724991958829,0.0,0.0
6218,0,6218,[ 64 483 313 318 187],618,5,25466,4.094870557967519,80.0,20.0
6219,0,6219,[ 12 153  79 181  11],654,4,25470,4.094855305466238,20.0,20.0
6220,0,6220,[ 64 483 313 318 187],618,5,25475,4.095000803729304,80.0,20.0
6221,0,6221,[238 237 210 173 174],618,2,25477,4.094664095146255,0.0,0.0
6222,0,6222,[211 302   7 200 742],297,3,25480,4.094488188976378,0.0,0.0
6223,0,6223,[ 96  97 174  22 655],405,3,25483,4.094312339331619,0.0,0.0
6224,0,6224,[228 357 176 185  96],805,4,25487,4.09429718875502,0.0,0.0
6225,0,6225,[427  71  79 318 301],711,4,25491,4.094282043045294,20.0,0.0
6226,0,6226,[423  70 197 318 195],198,2,25493,4.093945720250522,20.0,0.0
6227,0,6227,[ 64 483 313 318 187],618,5,25498,4.094091201027617,80.0,20.0
6228,0,6228,[423 191   4 289 302],43,5,25503,4.094236635093916,0.0,0.0
6229,0,6229,[ 64 483 313 318 187],618,5,25508,4.09438202247191,80.0,20.0
6230,0,6230,[ 64 483 313 318 187],214,5,25513,4.0945273631840795,80.0,20.0
6231,0,6231,[546 238 173 210 111],297,3,25516,4.094351732991014,0.0,0.0
6232,0,6232,[ 64 483 313 318 187],618,5,25521,4.094497031926841,80.0,20.0
6233,0,6233,[ 64 483 313 318 187],618,5,25526,4.094642284247674,80.0,20.0
6234,0,6234,[176 200 197  22  88],416,4,25530,4.094627105052125,0.0,0.0
6235,0,6235,[678 216 475 210 258],416,3,25533,4.094451571520206,0.0,0.0
6236,0,6236,[ 64 483 313 318 187],214,5,25538,4.0945967612634275,80.0,20.0
6237,0,6237,[161 216 245 423 132],128,3,25541,4.094421288874639,0.0,0.0
6238,0,6238,[ 64 483 313 318 187],214,5,25546,4.094566436928995,80.0,20.0
6239,0,6239,[121 183 117 144 235],62,4,25550,4.094551282051282,0.0,0.0
6240,0,6240,[237 300 121 238 196],751,2,25552,4.094215670565615,0.0,0.0
6241,0,6241,[183 143 273 403 427],416,5,25557,4.094360781800705,0.0,0.0
6242,0,6242,[ 64 483 313 318 187],618,5,25562,4.094505846548134,80.0,20.0
6243,0,6243,[ 12 471 238 423 655],373,3,25565,4.0943305573350415,20.0,0.0
6244,0,6244,[435 588 282 118 603],297,2,25567,4.093995196156926,0.0,0.0
6245,0,6245,[ 64 483 313 318 187],618,5,25572,4.094140249759846,80.0,20.0
6246,0,6246,[ 64 483 313 318 187],618,5,25577,4.094285256923323,80.0,20.0
6247,0,6247,[111  64  28  15 318],705,4,25581,4.094270166453265,40.0,0.0
6248,0,6248,[237 111 144 216 483],854,1,25582,4.09377500400064,20.0,0.0
6249,0,6249,[202 288  79 357 271],297,1,25583,4.09328,0.0,20.0
6250,0,6250,[127  69 471 181 238],43,3,25586,4.093105103183491,0.0,20.0
6251,0,6251,[ 12 515 471 748 475],297,3,25589,4.092930262316059,20.0,0.0
6252,0,6252,[ 64 483 313 318 187],214,5,25594,4.0930753238445545,80.0,20.0
6253,0,6253,[ 64 483 313 318 187],618,5,25599,4.093220338983051,80.0,20.0
6254,0,6254,[ 64 483 313 318 187],618,5,25604,4.093365307753797,80.0,20.0
6255,0,6255,[238 111  97 496 127],417,3,25607,4.093190537084399,0.0,0.0
6256,0,6256,[568 100 180 289 168],887,3,25610,4.093015822279048,0.0,0.0
6257,0,6257,[151 176 496  25 294],887,4,25614,4.0930009587727705,0.0,0.0
6258,0,6258,[ 64 483 313 318 187],214,5,25619,4.093145869947276,80.0,20.0
6259,0,6259,[588  88 161 300 265],416,4,25623,4.093130990415336,0.0,0.0
6260,0,6260,[423 276 121 546 323],223,2,25625,4.092796677846989,0.0,0.0
6261,0,6261,[ 64 483 313 318 187],214,5,25630,4.092941552219738,80.0,20.0
6262,0,6262,[ 88 568 238 187 175],373,3,25633,4.092767044547341,0.0,0.0
6263,0,6263,[597 143  69 276 288],416,3,25636,4.092592592592593,0.0,20.0
6264,0,6264,[ 64 483 313 318 187],618,5,25641,4.092737430167598,80.0,20.0
6265,0,6265,[258 135 235 204 357],62,4,25645,4.092722630067028,0.0,0.0
6266,0,6266,[ 64 483 313 318 187],618,5,25650,4.092867400670177,80.0,20.0
6267,0,6267,[ 64 483 313 318 187],214,5,25655,4.09301212507977,80.0,20.0
6268,0,6268,[175   7 174  98 228],198,3,25658,4.092837773169564,0.0,20.0
6269,0,6269,[195 471  11 191 568],630,4,25662,4.092822966507177,0.0,0.0
6270,0,6270,[191 151 204 318 185],416,4,25666,4.092808164567055,20.0,0.0
6271,0,6271,[ 64 483 313 318 187],618,5,25671,4.092952806122449,80.0,20.0
6272,0,6272,[ 11 117 300 195 588],416,5,25676,4.093097401562251,0.0,0.0
6273,0,6273,[ 64 483 313 318 187],214,5,25681,4.093241950908511,80.0,20.0
6274,0,6274,[ 64 483 313 318 187],618,5,25686,4.093386454183267,80.0,20.0
6275,0,6275,[ 64 483 313 318 187],618,5,25691,4.09353091140854,80.0,20.0
6276,0,6276,[323 197 185 200 237],198,2,25693,4.093197387286921,0.0,0.0
6277,0,6277,[196 228 143  56  79],198,1,25694,4.09270468302007,0.0,0.0
6278,0,6278,[235 195 118 179 403],416,2,25696,4.092371396719223,0.0,0.0
6279,0,6279,[172 210 117 588 475],588,4,25700,4.092356687898089,0.0,0.0
6280,0,6280,[179 125 202 302 180],417,4,25704,4.092341983760548,0.0,0.0
6281,0,6281,[235 508 118 125 172],62,4,25708,4.092327284304361,0.0,0.0
6282,0,6282,[ 97 196 748 176 222],297,4,25712,4.092312589527296,0.0,0.0
6283,0,6283,[471 288 151 144 174],416,4,25716,4.092297899427116,0.0,20.0
6284,0,6284,[186 204 546 215 238],43,3,25719,4.0921241050119335,0.0,0.0
6285,0,6285,[181  79 568  11   1],198,3,25722,4.091950365892459,0.0,20.0
6286,0,6286,[265 268 508 111 273],417,1,25723,4.091458565293463,0.0,0.0
6287,0,6287,[200  82 357 144 176],416,5,25728,4.091603053435114,0.0,0.0
6288,0,6288,[423 135 121 185 168],854,4,25732,4.091588487835904,0.0,0.0
6289,0,6289,[ 64 483 313 318 187],214,5,25737,4.091732909379968,80.0,20.0
6290,0,6290,[168   1 275 195 655],62,3,25740,4.091559370529327,0.0,0.0
6291,0,6291,[322   7  56 257 172],416,3,25743,4.091385886840432,0.0,0.0
6292,0,6292,[ 64 483 313 318 187],214,5,25748,4.091530271730494,80.0,20.0
6293,0,6293,[ 64 483 313 318 187],214,5,25753,4.091674610740387,80.0,20.0
6294,0,6294,[323 496 234   7 151],417,2,25755,4.091342335186656,0.0,0.0
6295,0,6295,[216 172 191  64 181],345,5,25760,4.09148665819568,20.0,20.0
6296,0,6296,[ 64 483 313 318 187],214,5,25765,4.091630935366047,80.0,20.0
6297,0,6297,[ 64 483 313 318 187],618,5,25770,4.091775166719594,80.0,20.0
6298,0,6298,[483 187 172  96  98],618,4,25774,4.091760596920146,20.0,20.0
6299,0,6299,[125 100 288  89 191],342,3,25777,4.091587301587301,0.0,20.0
6300,0,6300,[ 64 483 313 318 187],618,5,25782,4.0917314711950485,80.0,20.0
6301,0,6301,[ 64 483 313 318 187],618,5,25787,4.09187559504919,80.0,20.0
6302,0,6302,[269 185 289 318   8],854,4,25791,4.091861018562589,20.0,0.0
6303,0,6303,[234 132  82  64 200],416,5,25796,4.092005076142132,20.0,0.0
6304,0,6304,[294 265 403 385 257],922,3,25799,4.091831879460745,0.0,0.0
6305,0,6305,[ 64 483 313 318 187],618,5,25804,4.09197589597209,80.0,20.0
6306,0,6306,[151 117  50 195 288],642,2,25806,4.091644204851752,0.0,40.0
6307,0,6307,[742 471 588  79 181],297,2,25808,4.091312618896639,0.0,20.0
6308,0,6308,[ 15 143 181 111 496],907,5,25813,4.091456649231257,0.0,20.0
6309,0,6309,[300 204 483 211  25],698,1,25814,4.090966719492869,20.0,0.0
6310,0,6310,[100 183 194 423 121],416,5,25819,4.091110758992236,0.0,0.0
6311,0,6311,[ 64 313 483 318 187],214,5,25824,4.091254752851711,80.0,20.0
6312,0,6312,[ 64 313 483 318 187],214,5,25829,4.091398701092983,80.0,20.0
6313,0,6313,[118  64 286 204 132],62,2,25831,4.09106746911625,20.0,0.0
6314,0,6314,[ 64 313 483 318 187],214,5,25836,4.091211401425178,80.0,20.0
6315,0,6315,[ 82 273 423 475  56],416,4,25840,4.09119696010133,0.0,0.0
6316,0,6316,[333 185 323 176 118],416,3,25843,4.091024220357765,0.0,0.0
6317,0,6317,[204 237 173 111 515],416,4,25847,4.091009813232035,0.0,0.0
6318,0,6318,[471 194 144 153 257],297,1,25848,4.090520652001899,0.0,0.0
6319,0,6319,[ 64 313 483 318 187],214,5,25853,4.090664556962025,80.0,20.0
6320,0,6320,[ 64 313 483 318 187],618,5,25858,4.0908084163898115,80.0,20.0
6321,0,6321,[ 25 185 197 271 475],854,4,25862,4.090794052515027,0.0,0.0
6322,0,6322,[568 186 268 300 182],128,4,25866,4.090779693183616,0.0,0.0
6323,0,6323,[ 64 313 483 318 187],618,5,25871,4.090923466160658,80.0,20.0
6324,0,6324,[ 64 313 483 318 187],618,5,25876,4.091067193675889,80.0,20.0
6325,0,6325,[168 173 176 655 405],198,4,25880,4.091052797976604,0.0,0.0
6326,0,6326,[245 475 200 144  70],416,3,25883,4.090880354038249,0.0,0.0
6327,0,6327,[ 64 313 483 318 187],618,5,25888,4.09102402022756,80.0,20.0
6328,0,6328,[ 64 313 483 318 187],618,5,25893,4.091167641017538,80.0,20.0
6329,0,6329,[286 333 191 597  69],416,4,25897,4.091153238546603,0.0,0.0
6330,0,6330,[269 172 271 300 144],43,4,25901,4.091138840625494,0.0,0.0
6331,0,6331,[ 82 185 546 211 111],416,4,25905,4.091124447252053,0.0,0.0
6332,0,6332,[ 50 215 603 742 508],297,3,25908,4.090952155376598,0.0,20.0
6333,0,6333,[ 64 313 483 318 187],618,5,25913,4.091095674139564,80.0,20.0
6334,0,6334,[117 258 153 273 678],416,4,25917,4.091081294396211,0.0,0.0
6335,0,6335,[215 258 186 196 176],198,4,25921,4.09106691919192,0.0,0.0
6336,0,6336,[ 64 313 483 318 187],214,5,25926,4.09121035190153,80.0,20.0
6337,0,6337,[ 50  89  22 121 597],854,2,25928,4.090880403912906,0.0,20.0
6338,0,6338,[ 64 313 483 318 187],618,5,25933,4.091023820791923,80.0,20.0
6339,0,6339,[ 64 313 483 318 187],618,5,25938,4.0911671924290225,80.0,20.0
6340,0,6340,[237 268 427 204  95],416,3,25941,4.0909951111812015,0.0,0.0
6341,0,6341,[ 64 313 483 318 187],214,5,25946,4.09113844213182,80.0,20.0
6342,0,6342,[ 64 313 483 318 187],214,5,25951,4.091281727889012,80.0,20.0
6343,0,6343,[ 64 313 483 318 187],618,5,25956,4.091424968474149,80.0,20.0
6344,0,6344,[ 64 313 483 318 187],214,5,25961,4.0915681639085895,80.0,20.0
6345,0,6345,[ 64 313 483 318 187],618,5,25966,4.091711314213678,80.0,20.0
6346,0,6346,[ 70 228 161 210  15],417,2,25968,4.091381755159918,0.0,0.0
6347,0,6347,[ 64 313 483 318 187],214,5,25973,4.091524889729048,80.0,20.0
6348,0,6348,[ 64 313 483 318 187],618,5,25978,4.0916679792093245,80.0,20.0
6349,0,6349,[100 238 135 234 204],297,3,25981,4.091496062992126,0.0,0.0
6350,0,6350,[195 121  25 405 237],159,2,25983,4.0911667453944265,0.0,0.0
6351,0,6351,[179 568 328 180 117],373,3,25986,4.090994962216625,0.0,0.0
6352,0,6352,[294 385 228 237 161],230,3,25989,4.090823233118212,0.0,0.0
6353,0,6353,[265 427 118  64 161],416,4,25993,4.0908089392508655,20.0,0.0
6354,0,6354,[ 50 258 265  22 471],505,3,25996,4.090637293469709,0.0,20.0
6355,0,6355,[176 603 211  71 257],416,4,26000,4.090623033354311,0.0,0.0
6356,0,6356,[258 191 161   4  25],43,5,26005,4.090766084631115,0.0,0.0
6357,0,6357,[  1 181 475 300 168],198,4,26009,4.090751808744888,0.0,20.0
6358,0,6358,[ 64 313 483 318 187],618,5,26014,4.090894794779054,80.0,20.0
6359,0,6359,[173 121  71 135 143],198,2,26016,4.090566037735849,0.0,0.0
6360,0,6360,[ 64 313 483 318 187],618,5,26021,4.090709008017607,80.0,20.0
6361,0,6361,[ 64 313 483 318 187],214,5,26026,4.090851933354291,80.0,20.0
6362,0,6362,[ 64 313 483 318 187],618,5,26031,4.090994813767091,80.0,20.0
6363,0,6363,[ 64 313 483 318 187],214,5,26036,4.091137649277184,80.0,20.0
6364,0,6364,[ 64 313 483 318 187],214,5,26041,4.091280439905734,80.0,20.0
6365,0,6365,[742   4 195 294  96],416,5,26046,4.091423185673893,0.0,0.0
6366,0,6366,[ 64 313 483 318 187],618,5,26051,4.091565886602796,80.0,20.0
6367,0,6367,[286 222 173 195 121],705,2,26053,4.09123743718593,0.0,0.0
6368,0,6368,[ 64 313 483 318 187],618,5,26058,4.091380122468205,80.0,20.0
6369,0,6369,[ 64 313 483 318 187],618,5,26063,4.091522762951334,80.0,20.0
6370,0,6370,[742 117 132 176   4],416,5,26068,4.091665358656412,0.0,0.0
6371,0,6371,[546 273 144 655 161],416,4,26072,4.091650973006905,0.0,0.0
6372,0,6372,[195  25   9 318 288],416,5,26077,4.091793503844343,20.0,20.0
6373,0,6373,[143 405 234 403 301],416,5,26082,4.091935989959209,0.0,0.0
6374,0,6374,[100  69 151 597 182],416,3,26085,4.091764705882353,0.0,0.0
6375,0,6375,[ 64 313 483 318 187],214,5,26090,4.091907151819322,80.0,20.0
6376,0,6376,[ 64 313 483 318 187],618,5,26095,4.092049553081386,80.0,20.0
6377,0,6377,[ 64 313 483 318 187],618,5,26100,4.092191909689558,80.0,20.0
6378,0,6378,[197 204 216 117 286],297,3,26103,4.092020692898574,0.0,0.0
6379,0,6379,[144   9 475 183  96],416,4,26107,4.092006269592477,0.0,0.0
6380,0,6380,[  7 245 508  28 258],62,3,26110,4.09183513555869,0.0,0.0
6381,0,6381,[ 56 655 216   4 496],618,3,26113,4.091664055155124,0.0,0.0
6382,0,6382,[273   8 211 181 215],416,5,26118,4.091806360645465,0.0,20.0
6383,0,6383,[191 385  25 427 496],373,4,26122,4.091791979949875,0.0,0.0
6384,0,6384,[ 96 597 135 197 222],854,3,26125,4.091620986687549,0.0,0.0
6385,0,6385,[ 95 173 403 385  64],373,3,26128,4.091450046977764,20.0,0.0
6386,0,6386,[196 168   8 216 172],62,5,26133,4.0915922968529825,0.0,0.0
6387,0,6387,[ 69 175 135 423  28],721,4,26137,4.091577958672511,0.0,0.0
6388,0,6388,[ 64 313 483 318 187],618,5,26142,4.091720143997495,80.0,20.0
6389,0,6389,[ 64 313 483 318 187],214,5,26147,4.0918622848200314,80.0,20.0
6390,0,6390,[ 64 313 483 318 187],618,5,26152,4.092004381161008,80.0,20.0
6391,0,6391,[ 64 313 483 318 187],618,5,26157,4.092146433041302,80.0,20.0
6392,0,6392,[ 64 313 483 318 187],618,5,26162,4.092288440481777,80.0,20.0
6393,0,6393,[  1  64 181 143 151],198,4,26166,4.092274006881452,20.0,20.0
6394,0,6394,[ 64 313 483 318 187],618,5,26171,4.092415949960907,80.0,20.0
6395,0,6395,[168 211 655 100 258],417,4,26175,4.092401500938086,0.0,0.0
6396,0,6396,[273 286  82  11 258],416,5,26180,4.092543379709238,0.0,0.0
6397,0,6397,[151 100 318 200 238],854,5,26185,4.092685214129416,20.0,0.0
6398,0,6398,[ 64 313 483 318 187],618,5,26190,4.0928270042194095,80.0,20.0
6399,0,6399,[118 588 282  71  69],654,2,26192,4.0925,0.0,0.0
6400,0,6400,[ 64 313 483 318 187],214,5,26197,4.0926417747227,80.0,20.0
6401,0,6401,[ 64 313 483 318 187],214,5,26202,4.092783505154639,80.0,20.0
6402,0,6402,[ 64 313 483 318 187],214,5,26207,4.092925191316571,80.0,20.0
6403,0,6403,[ 96   4 151 168 172],618,2,26209,4.09259837601499,0.0,0.0
6404,0,6404,[385 118 168   7 288],588,2,26211,4.092271662763466,0.0,20.0
6405,0,6405,[603 275 238 588 180],437,4,26215,4.092257258819856,0.0,0.0
6406,0,6406,[135 182 302 144 211],297,3,26218,4.092086780084283,0.0,0.0
6407,0,6407,[ 64 313 483 318 187],618,5,26223,4.092228464419476,80.0,20.0
6408,0,6408,[ 64 313 483 318 187],214,5,26228,4.09237010454049,80.0,20.0
6409,0,6409,[ 64 313 483 318 187],214,5,26233,4.092511700468019,80.0,20.0
6410,0,6410,[286  70  64 161 135],417,3,26236,4.092341288410545,20.0,0.0
6411,0,6411,[ 64 313 483 318 187],214,5,26241,4.092482844666251,80.0,20.0
6412,0,6412,[496  88 294 216  79],128,5,26246,4.0926243567753,0.0,0.0
6413,0,6413,[121 100 197 111 204],437,3,26249,4.0924540068599935,0.0,0.0
6414,0,6414,[ 64 313 483 318 187],214,5,26254,4.092595479345285,80.0,20.0
6415,0,6415,[423 153  95 515 588],416,4,26258,4.092581047381546,0.0,0.0
6416,0,6416,[ 25 135 515 475 144],417,2,26260,4.0922549477949195,0.0,0.0
6417,0,6417,[ 82  71 117 275 257],43,5,26265,4.092396385166719,0.0,0.0
6418,0,6418,[245 100 405  71  97],907,5,26270,4.092537778470167,0.0,0.0
6419,0,6419,[ 64 313 483 318 187],214,5,26275,4.092679127725857,80.0,20.0
6420,0,6420,[ 64 313 483 318 187],618,5,26280,4.092820432954368,80.0,20.0
6421,0,6421,[ 64 313 483 318 187],214,5,26285,4.092961694176269,80.0,20.0
6422,0,6422,[ 64 313 483 318 187],618,5,26290,4.093102911412113,80.0,20.0
6423,0,6423,[ 64 313 483 318 187],618,5,26295,4.093244084682441,80.0,20.0
6424,0,6424,[183 181 195 222 265],297,3,26298,4.09307392996109,0.0,20.0
6425,0,6425,[ 64 313 483 318 187],214,5,26303,4.093215063803299,80.0,20.0
6426,0,6426,[ 64 313 483 318 187],214,5,26308,4.093356153726466,80.0,20.0
6427,0,6427,[210 313 276 215 294],921,4,26312,4.093341630367144,20.0,20.0
6428,0,6428,[173 143 597 191 195],705,1,26313,4.092860475968269,0.0,0.0
6429,0,6429,[  8 143 182 546 300],297,2,26315,4.092534992223951,0.0,0.0
6430,0,6430,[ 64 313 483 318 187],214,5,26320,4.092676100139947,80.0,20.0
6431,0,6431,[313 286   8 185 258],711,5,26325,4.092817164179104,20.0,20.0
6432,0,6432,[ 64 313 483 318 187],618,5,26330,4.092958184361884,80.0,20.0
6433,0,6433,[ 64 313 483 318 187],214,5,26335,4.093099160708735,80.0,20.0
6434,0,6434,[ 64 313 483 318 187],618,5,26340,4.093240093240094,80.0,20.0
6435,0,6435,[405 568  50 111 275],128,4,26344,4.093225605966439,0.0,20.0
6436,0,6436,[238  64 196  69 313],405,4,26348,4.093211123194035,40.0,20.0
6437,0,6437,[127 302 118 176  97],62,2,26350,4.092885989437714,0.0,0.0
6438,0,6438,[ 64 313 483 318 187],618,5,26355,4.093026867526014,80.0,20.0
6439,0,6439,[597  96 546 127 496],416,3,26358,4.0928571428571425,0.0,0.0
6440,0,6440,[ 64 313 483 318 187],618,5,26363,4.092997981679863,80.0,20.0
6441,0,6441,[ 64 313 483 318 187],214,5,26368,4.093138776777399,80.0,20.0
6442,0,6442,[294 179 238 269 313],617,1,26369,4.092658699363651,20.0,20.0
6443,0,6443,[ 64 483 313 318 187],618,5,26374,4.092799503414029,80.0,20.0
6444,0,6444,[ 64 483 313 318 187],214,5,26379,4.092940263770364,80.0,20.0
6445,0,6445,[245 180 655 179 322],128,1,26380,4.092460440583308,0.0,0.0
6446,0,6446,[597 238  69 204  50],654,5,26385,4.0926012098650535,0.0,20.0
6447,0,6447,[423  82  70 195 597],416,4,26389,4.092586848635236,0.0,0.0
6448,0,6448,[ 64 483 313 318 187],214,5,26394,4.092727554659637,80.0,20.0
6449,0,6449,[222  50 172 121 302],417,0,26394,4.092093023255814,0.0,20.0
6450,0,6450,[121 234 132 275 185],437,4,26398,4.09207874748101,0.0,0.0
6451,0,6451,[269 200 185   4 118],854,3,26401,4.091909485430874,0.0,0.0
6452,0,6452,[ 22 173  28 748 742],297,3,26404,4.091740275840694,0.0,0.0
6453,0,6453,[ 64 483 313 318 187],618,5,26409,4.09188100402851,80.0,20.0
6454,0,6454,[313 748 496  98 405],654,5,26414,4.092021688613478,20.0,40.0
6455,0,6455,[ 64 483 313 318 187],618,5,26419,4.092162329615861,80.0,20.0
6456,0,6456,[237  25 597 174 318],43,4,26423,4.0921480563729284,20.0,0.0
6457,0,6457,[403  28  89 265 286],373,2,26425,4.091824094146794,0.0,0.0
6458,0,6458,[ 64 483 313 318 187],618,5,26430,4.091964700418021,80.0,20.0
6459,0,6459,[117  69  25 238 176],416,5,26435,4.092105263157895,0.0,0.0
6460,0,6460,[ 25 173 282 237 597],618,2,26437,4.091781457978641,0.0,0.0
6461,0,6461,[132 168 403  25  79],416,5,26442,4.091922005571031,0.0,0.0
6462,0,6462,[ 64 483 313 318 187],618,5,26447,4.0920625096704315,80.0,20.0
6463,0,6463,[ 64 483 313 318 187],214,5,26452,4.09220297029703,80.0,20.0
6464,0,6464,[185  97  95 132 183],230,4,26456,4.092188708430008,0.0,0.0
6465,0,6465,[  1 174  82 191 471],416,5,26461,4.092329106093412,0.0,0.0
6466,0,6466,[100 289 603   1 194],854,2,26463,4.092005566723365,0.0,0.0
6467,0,6467,[ 22 153  25 282 117],297,4,26467,4.091991341991342,0.0,0.0
6468,0,6468,[ 64 483 313 318 187],618,5,26472,4.092131705054877,80.0,20.0
6469,0,6469,[294 234 235 127  71],416,4,26476,4.092117465224112,0.0,0.0
6470,0,6470,[655 179 153 182 748],417,5,26481,4.092257765414928,0.0,0.0
6471,0,6471,[289   9 471 268 118],416,3,26484,4.092088998763906,0.0,0.0
6472,0,6472,[132 195  97 568   8],618,3,26487,4.091920284257686,0.0,0.0
6473,0,6473,[288 238 194 294 483],342,3,26490,4.0917516218721035,20.0,20.0
6474,0,6474,[ 64 483 313 318 187],214,5,26495,4.091891891891892,80.0,20.0
6475,0,6475,[121  25   1 269 118],43,5,26500,4.092032118591724,0.0,0.0
6476,0,6476,[603  70  64 357 423],405,3,26503,4.091863517060368,20.0,0.0
6477,0,6477,[ 64 483 313 318 187],214,5,26508,4.092003704847175,80.0,20.0
6478,0,6478,[385 196 471 546   1],705,4,26512,4.091989504553172,0.0,0.0
6479,0,6479,[ 64 483 313 318 187],618,5,26517,4.092129629629629,80.0,20.0
6480,0,6480,[ 64 483 313 318 187],618,5,26522,4.09226971146428,80.0,20.0
6481,0,6481,[237 168 195   9 196],618,3,26525,4.092101203332305,0.0,0.0
6482,0,6482,[ 28 175  25 273 405],805,2,26527,4.091778497609131,0.0,0.0
6483,0,6483,[151  70 357 496 301],416,4,26531,4.091764342998149,0.0,0.0
6484,0,6484,[144 237 288 111 180],62,1,26532,4.091287586738628,0.0,20.0
6485,0,6485,[ 64 483 313 318 187],214,5,26537,4.091427690410114,80.0,20.0
6486,0,6486,[ 64 483 313 318 187],214,5,26542,4.091567750886388,80.0,20.0
6487,0,6487,[  1  69 172 289 258],345,3,26545,4.091399506781751,0.0,0.0
6488,0,6488,[ 50 385  25   4   9],618,2,26547,4.091077207582062,0.0,20.0
6489,0,6489,[195 100  79  28 597],618,4,26551,4.091063174114022,0.0,0.0
6490,0,6490,[ 64 483 313 318 187],618,5,26556,4.091203204436913,80.0,20.0
6491,0,6491,[ 64 483 313 318 187],214,5,26561,4.091343191620456,80.0,20.0
6492,0,6492,[ 64 483 313 318 187],214,5,26566,4.091483135684584,80.0,20.0
6493,0,6493,[496 228 168 181  97],230,4,26570,4.091469048352325,0.0,20.0
6494,0,6494,[ 12  22 215 143   4],654,5,26575,4.091608929946112,20.0,0.0
6495,0,6495,[118 423 181 300 191],198,2,26577,4.091286945812808,0.0,20.0
6496,0,6496,[385  11 357  95 216],230,4,26581,4.091272895182392,0.0,0.0
6497,0,6497,[ 64 483 313 318 187],618,5,26586,4.091412742382271,80.0,20.0
6498,0,6498,[301 197 597  96 235],416,3,26589,4.091244806893368,0.0,0.0
6499,0,6499,[273 127 174 357 117],805,1,26590,4.090769230769231,0.0,0.0
6500,0,6500,[515 423 597 202 405],417,3,26593,4.090601445931395,0.0,0.0
6501,0,6501,[ 64 483 313 318 187],214,5,26598,4.090741310366041,80.0,20.0
6502,0,6502,[ 64 483 313 318 187],618,5,26603,4.09088113178533,80.0,20.0
6503,0,6503,[276 216 144 195 597],416,3,26606,4.090713407134071,0.0,0.0
6504,0,6504,[ 64 483 313 318 187],214,5,26611,4.090853189853958,80.0,20.0
6505,0,6505,[ 64 483 313 318 187],214,5,26616,4.090992929603443,80.0,20.0
6506,0,6506,[ 64 483 313 318 187],214,5,26621,4.091132626402336,80.0,20.0
6507,0,6507,[ 64 483 313 318 187],214,5,26626,4.091272280270436,80.0,20.0
6508,0,6508,[ 64 483 313 318 187],214,5,26631,4.091411891227531,80.0,20.0
6509,0,6509,[ 64 483 313 318 187],618,5,26636,4.091551459293394,80.0,20.0
6510,0,6510,[183 117 678 197   7],805,4,26640,4.091537398249117,0.0,0.0
6511,0,6511,[ 64 483 313 318 187],618,5,26645,4.0916769041769046,80.0,20.0
6512,0,6512,[ 64 483 313 318 187],214,5,26650,4.091816367265469,80.0,20.0
6513,0,6513,[ 69 215 111  50 423],618,4,26654,4.091802272029475,0.0,20.0
6514,0,6514,[ 64 483 313 318 187],618,5,26659,4.0919416730621645,80.0,20.0
6515,0,6515,[282 204   4 245   9],416,4,26663,4.091927562922038,0.0,0.0
6516,0,6516,[ 64 483 313 318 187],214,5,26668,4.0920669019487494,80.0,20.0
6517,0,6517,[ 56 483 181 357 423],679,4,26672,4.092052776925438,20.0,20.0
6518,0,6518,[ 64 483 313 318 187],214,5,26677,4.092192053996012,80.0,20.0
6519,0,6519,[132 742 276 151 546],314,4,26681,4.0921779141104295,0.0,0.0
6520,0,6520,[ 64 483 313 318 187],618,5,26686,4.092317129274651,80.0,20.0
6521,0,6521,[ 64 483 313 318 187],214,5,26691,4.09245630174793,80.0,20.0
6522,0,6522,[568 237 588 546   1],314,5,26696,4.0925954315499,0.0,0.0
6523,0,6523,[196  98  69 273 258],416,5,26701,4.092734518700184,0.0,20.0
6524,0,6524,[118 174  95  71  12],437,3,26704,4.092567049808429,20.0,0.0
6525,0,6525,[186 471 237 215 191],128,4,26708,4.092552865461232,0.0,0.0
6526,0,6526,[282 216 168 215  79],618,3,26711,4.092385475716256,0.0,0.0
6527,0,6527,[ 64 483 313 318 187],618,5,26716,4.092524509803922,80.0,20.0
6528,0,6528,[ 64 483 313 318 187],618,5,26721,4.0926635013018835,80.0,20.0
6529,0,6529,[ 64 483 313 318 187],618,5,26726,4.092802450229709,80.0,20.0
6530,0,6530,[ 64 483 313 318 187],618,5,26731,4.092941356606952,80.0,20.0
6531,0,6531,[ 64 483 313 318 187],214,5,26736,4.093080220453154,80.0,20.0
6532,0,6532,[302 216 118 135 282],854,1,26737,4.0926067656513085,0.0,0.0
6533,0,6533,[508 111 322 294 483],128,3,26740,4.092439546985002,20.0,0.0
6534,0,6534,[ 64 483 313 318 187],214,5,26745,4.092578423871461,80.0,20.0
6535,0,6535,[276 118 597 475 151],416,0,26745,4.091952264381885,0.0,0.0
6536,0,6536,[ 64 483 313 318 187],214,5,26750,4.092091173321095,80.0,20.0
6537,0,6537,[ 64 483 313 318 187],214,5,26755,4.092230039767513,80.0,20.0
6538,0,6538,[568 216  28 176   7],805,2,26757,4.091910077993577,0.0,0.0
6539,0,6539,[ 64 483 313 318 187],214,5,26762,4.0920489296636084,80.0,20.0
6540,0,6540,[318 111  22 655  56],588,3,26765,4.091881975233145,20.0,0.0
6541,0,6541,[ 64 483 313 318 187],618,5,26770,4.092020788749618,80.0,20.0
6542,0,6542,[135 385 742 234 172],642,3,26773,4.0918538896530645,0.0,0.0
6543,0,6543,[ 64 483 313 318 187],618,5,26778,4.091992665036675,80.0,20.0
6544,0,6544,[313 288 237  64  28],642,4,26782,4.091978609625668,40.0,40.0
6545,0,6545,[ 64 483 313 318 187],618,5,26787,4.09211732355637,80.0,20.0
6546,0,6546,[ 97 748 275 168  64],373,4,26791,4.092103253398503,20.0,0.0
6547,0,6547,[ 25 216 125 179 235],417,2,26793,4.091783750763592,0.0,0.0
6548,0,6548,[172  71  69 202 238],437,3,26796,4.0916170407695835,0.0,0.0
6549,0,6549,[ 64 483 313 318 187],214,5,26801,4.09175572519084,80.0,20.0
6550,0,6550,[ 64 483 313 318 187],618,5,26806,4.091894367272173,80.0,20.0
6551,0,6551,[ 64 483 313 318 187],214,5,26811,4.092032967032967,80.0,20.0
6552,0,6552,[ 64 483 313 318 187],618,5,26816,4.092171524492599,80.0,20.0
6553,0,6553,[ 64 483 313 318 187],214,5,26821,4.09231003967043,80.0,20.0
6554,0,6554,[125 204  69 194 289],416,4,26825,4.092295957284516,0.0,0.0
6555,0,6555,[496 515   9 385   8],416,5,26830,4.092434411226358,0.0,0.0
6556,0,6556,[ 28  11 180 161  56],805,1,26831,4.091962787860302,0.0,0.0
6557,0,6557,[ 64 483 313 318 187],214,5,26836,4.092101250381214,80.0,20.0
6558,0,6558,[ 64 483 313 318 187],214,5,26841,4.092239670681506,80.0,20.0
6559,0,6559,[ 64 483 313 318 187],214,5,26846,4.092378048780488,80.0,20.0
6560,0,6560,[ 64 483 313 318 187],214,5,26851,4.092516384697455,80.0,20.0
6561,0,6561,[ 64 483 313 318 187],214,5,26856,4.092654678451692,80.0,20.0
6562,0,6562,[200 423 185 175  98],297,3,26859,4.092488191375895,0.0,20.0
6563,0,6563,[ 64 483 313 318 187],214,5,26864,4.0926264472882385,80.0,20.0
6564,0,6564,[ 88 357 183 655  25],416,4,26868,4.092612338156893,0.0,0.0
6565,0,6565,[ 64 483 313 318 187],214,5,26873,4.09275053304904,80.0,20.0
6566,0,6566,[ 64 483 313 318 187],618,5,26878,4.09288868585351,80.0,20.0
6567,0,6567,[ 64 483 313 318 187],214,5,26883,4.093026796589525,80.0,20.0
6568,0,6568,[313  98 323 215 202],345,3,26886,4.0928604049322574,20.0,40.0
6569,0,6569,[ 64 483 313 318 187],618,5,26891,4.092998477929985,80.0,20.0
6570,0,6570,[ 70  12 125  22 258],416,5,26896,4.093136508902755,20.0,0.0
6571,0,6571,[186 175 568 181  22],405,4,26900,4.0931223371880705,0.0,20.0
6572,0,6572,[ 64 483 313 318 187],214,5,26905,4.0932603073178155,80.0,20.0
6573,0,6573,[269 175 180 143 294],805,2,26907,4.092941892303012,0.0,0.0
6574,0,6574,[ 64 483 313 318 187],214,5,26912,4.093079847908745,80.0,20.0
6575,0,6575,[ 64 483 313 318 187],214,5,26917,4.093217761557177,80.0,20.0
6576,0,6576,[ 64 483 313 318 187],618,5,26922,4.093355633267447,80.0,20.0
6577,0,6577,[ 71 172 200 288 237],922,3,26925,4.093189419276376,0.0,20.0
6578,0,6578,[403 423  15  25 196],43,5,26930,4.093327253381973,0.0,0.0
6579,0,6579,[318  71 275  28 423],262,4,26934,4.093313069908815,20.0,0.0
6580,0,6580,[ 28 276 508 153 588],654,3,26937,4.093146938155296,0.0,0.0
6581,0,6581,[187 300 151 269 546],416,3,26940,4.092980856882407,0.0,0.0
6582,0,6582,[ 11 200 288  71 235],805,1,26941,4.092511013215859,0.0,20.0
6583,0,6583,[ 64 483 313 318 187],214,5,26946,4.092648845686512,80.0,20.0
6584,0,6584,[ 64 483 313 318 187],214,5,26951,4.092786636294609,80.0,20.0
6585,0,6585,[ 64 483 313 318 187],214,5,26956,4.0929243850592165,80.0,20.0
6586,0,6586,[ 64 483 313 318 187],618,5,26961,4.093062091999393,80.0,20.0
6587,0,6587,[200   9 153 427 276],416,4,26965,4.093047965998785,0.0,0.0
6588,0,6588,[ 64 483 313 318 187],214,5,26970,4.093185612384277,80.0,20.0
6589,0,6589,[302  89  96 111 196],751,3,26973,4.093019726858877,0.0,0.0
6590,0,6590,[196 588 200 323 245],345,2,26975,4.092702169625246,0.0,0.0
6591,0,6591,[173 143 144 405  98],654,5,26980,4.092839805825243,0.0,20.0
6592,0,6592,[ 64 483 313 318 187],618,5,26985,4.092977400273017,80.0,20.0
6593,0,6593,[ 64 483 313 318 187],214,5,26990,4.093114952987564,80.0,20.0
6594,0,6594,[ 64 483 313 318 187],618,5,26995,4.09325246398787,80.0,20.0
6595,0,6595,[ 64 483 313 318 187],214,5,27000,4.0933899332929045,80.0,20.0
6596,0,6596,[ 64 483 313 318 187],618,5,27005,4.093527360921631,80.0,20.0
6597,0,6597,[ 64 483 313 318 187],214,5,27010,4.093664746892998,80.0,20.0
6598,0,6598,[ 64 483 313 318 187],214,5,27015,4.093802091225943,80.0,20.0
6599,0,6599,[ 64 483 313 318 187],214,5,27020,4.093939393939394,80.0,20.0
6600,0,6600,[180  71 185 385 182],405,1,27021,4.093470686259658,0.0,0.0
6601,0,6601,[210   8 200 568 187],416,5,27026,4.093607997576492,0.0,0.0
6602,0,6602,[ 98 245   1  25 471],128,3,27029,4.093442374678177,0.0,20.0
6603,0,6603,[ 56 568 546 175 294],805,2,27031,4.093125378558449,0.0,0.0
6604,0,6604,[ 64 483 313 318 187],214,5,27036,4.093262679788039,80.0,20.0
6605,0,6605,[ 64 483 313 318 187],214,5,27041,4.093399939448986,80.0,20.0
6606,0,6606,[  1  70 202 282  56],618,2,27043,4.093083093688512,0.0,0.0
6607,0,6607,[ 64 483 313 318 187],618,5,27048,4.093220338983051,80.0,20.0
6608,0,6608,[ 64 483 313 318 187],214,5,27053,4.093357542744742,80.0,20.0
6609,0,6609,[275   8  25 195 151],618,0,27053,4.092738275340393,0.0,0.0
6610,0,6610,[144 403 245 185 273],416,4,27057,4.092724247466344,0.0,0.0
6611,0,6611,[423 357  79 475  97],198,2,27059,4.092407743496673,0.0,0.0
6612,0,6612,[333   8  96 186 185],854,2,27061,4.092091335248752,0.0,0.0
6613,0,6613,[172 273   9   7 143],805,2,27063,4.091775022679165,0.0,0.0
6614,0,6614,[ 64 483 313 318 187],618,5,27068,4.091912320483749,80.0,20.0
6615,0,6615,[496 183 175 435 176],698,1,27069,4.0914449818621526,0.0,0.0
6616,0,6616,[323 546 168 568 153],417,2,27071,4.0911289103823485,0.0,0.0
6617,0,6617,[ 15 151 238 144 100],43,4,27075,4.091115140525838,0.0,0.0
6618,0,6618,[174  56 176 100 172],618,5,27080,4.091252455053634,0.0,0.0
6619,0,6619,[ 64 483 313 318 187],618,5,27085,4.091389728096677,80.0,20.0
6620,0,6620,[135 117 161 235   1],417,2,27087,4.091073855913004,0.0,0.0
6621,0,6621,[ 64 483 313 318 187],618,5,27092,4.091211114466929,80.0,20.0
6622,0,6622,[ 64 483 313 318 187],618,5,27097,4.091348331571795,80.0,20.0
6623,0,6623,[ 95 588 197 405 180],805,1,27098,4.090881642512077,0.0,0.0
6624,0,6624,[385 100   4 405   9],805,1,27099,4.0904150943396225,0.0,0.0
6625,0,6625,[ 64 483 313 318 187],618,5,27104,4.090552369453667,80.0,20.0
6626,0,6626,[427  71  96 180 423],887,4,27108,4.090538705296514,0.0,0.0
6627,0,6627,[ 64 483 313 318 187],618,5,27113,4.090675920337961,80.0,20.0
6628,0,6628,[268 100 181  11 183],416,5,27118,4.090813093980993,0.0,20.0
6629,0,6629,[191 197 265 286 161],416,5,27123,4.090950226244344,0.0,0.0
6630,0,6630,[258  71 210 127  56],416,5,27128,4.0910873171467355,0.0,0.0
6631,0,6631,[196 568 181 318 435],405,3,27131,4.090922798552473,20.0,20.0
6632,0,6632,[ 64 483 313 318 187],618,5,27136,4.091059852253882,80.0,20.0
6633,0,6633,[ 64 483 313 318 187],618,5,27141,4.09119686463672,80.0,20.0
6634,0,6634,[ 64 483 313 318 187],214,5,27146,4.091333835719668,80.0,20.0
6635,0,6635,[ 69 183 132  56 179],62,5,27151,4.091470765521398,0.0,0.0
6636,0,6636,[ 64 483 313 318 187],618,5,27156,4.09160765406057,80.0,20.0
6637,0,6637,[ 64 483 313 318 187],618,5,27161,4.09174450135583,80.0,20.0
6638,0,6638,[ 64 483 313 318 187],618,5,27166,4.091881307425817,80.0,20.0
6639,0,6639,[228 183 742  98 597],805,2,27168,4.091566265060241,0.0,20.0
6640,0,6640,[ 89 176 288 603  79],805,4,27172,4.091552477036591,0.0,20.0
6641,0,6641,[ 64 483 313 318 187],214,5,27177,4.091689250225835,80.0,20.0
6642,0,6642,[ 89 127 210 117  50],198,4,27181,4.091675447839831,0.0,20.0
6643,0,6643,[ 64 483 313 318 187],618,5,27186,4.091812161348585,80.0,20.0
6644,0,6644,[588 302 186 153 222],43,4,27190,4.091798344620015,0.0,0.0
6645,0,6645,[ 64 483 313 318 187],214,5,27195,4.0919349984953355,80.0,20.0
6646,0,6646,[275 289 269  56 588],416,4,27199,4.091921167443959,0.0,0.0
6647,0,6647,[ 64 483 313 318 187],618,5,27204,4.092057761732852,80.0,20.0
6648,0,6648,[180 238 173 294   7],805,3,27207,4.091893517822229,0.0,0.0
6649,0,6649,[172  50 238 268 257],654,4,27211,4.09187969924812,0.0,20.0
6650,0,6650,[ 64 483 313 318 187],214,5,27216,4.092016238159675,80.0,20.0
6651,0,6651,[ 64 483 313 318 187],618,5,27221,4.0921527360192425,80.0,20.0
6652,0,6652,[ 64 483 313 318 187],214,5,27226,4.092289192845333,80.0,20.0
6653,0,6653,[ 64 483 313 318 187],214,5,27231,4.0924256086564474,80.0,20.0
6654,0,6654,[151 168 186 357 132],373,4,27235,4.092411720510894,0.0,0.0
6655,0,6655,[ 98 568  71 172  56],62,4,27239,4.092397836538462,0.0,20.0
6656,0,6656,[172 237 276  69 238],128,4,27243,4.092383956737269,0.0,0.0
6657,0,6657,[ 71  97  79 151 405],907,5,27248,4.092520276359267,0.0,0.0
6658,0,6658,[ 64 483 313 318 187],214,5,27253,4.092656555038294,80.0,20.0
6659,0,6659,[269 313 125 385  28],345,2,27255,4.092342342342342,20.0,20.0
6660,0,6660,[180 483  11 655  89],417,5,27260,4.092478606815793,20.0,0.0
6661,0,6661,[ 64 483 313 318 187],618,5,27265,4.092614830381267,80.0,20.0
6662,0,6662,[ 25 216 237  82 475],198,2,27267,4.0923007654209815,0.0,0.0
6663,0,6663,[385 186 265  79 357],230,4,27271,4.092286914765906,0.0,0.0
6664,0,6664,[173 172  70  11 211],43,5,27276,4.092423105776444,0.0,0.0
6665,0,6665,[603 132  56 294 282],854,3,27279,4.092259225922592,0.0,0.0
6666,0,6666,[302 313 301 182  28],416,5,27284,4.092395380230989,20.0,20.0
6667,0,6667,[ 64 483 313 318 187],618,5,27289,4.09253149370126,80.0,20.0
6668,0,6668,[196 423 135 180 185],198,1,27290,4.092067776278302,0.0,0.0
6669,0,6669,[286  97  89 186 216],417,4,27294,4.092053973013493,0.0,0.0
6670,0,6670,[ 64 483 313 318 187],618,5,27299,4.092190076450307,80.0,20.0
6671,0,6671,[ 64 483 313 318 187],618,5,27304,4.092326139088729,80.0,20.0
6672,0,6672,[ 71 117  79  56 181],505,2,27306,4.092012588041361,0.0,20.0
6673,0,6673,[ 64 483 313 318 187],214,5,27311,4.09214863649985,80.0,20.0
6674,0,6674,[ 64 483 313 318 187],618,5,27316,4.0922846441947565,80.0,20.0
6675,0,6675,[258 471 427 194 235],416,4,27320,4.092270820850809,0.0,0.0
6676,0,6676,[ 64 483 313 318 187],618,5,27325,4.092406769507264,80.0,20.0
6677,0,6677,[215 268  71   1 117],314,5,27330,4.092542677448338,0.0,0.0
6678,0,6678,[ 64 483 313 318 187],214,5,27335,4.092678544692319,80.0,20.0
6679,0,6679,[ 64 483 313 318 187],618,5,27340,4.092814371257485,80.0,20.0
6680,0,6680,[183 204 318 603 475],437,3,27343,4.092650800778326,20.0,0.0
6681,0,6681,[216 257   1  69 183],297,2,27345,4.092337623466028,0.0,0.0
6682,0,6682,[173 143 168 483 132],698,2,27347,4.0920245398773005,20.0,0.0
6683,0,6683,[173  79 132 195 100],214,5,27352,4.092160383004189,0.0,0.0
6684,0,6684,[127 143 195  22 275],618,3,27355,4.091997008227374,0.0,0.0
6685,0,6685,[181  22 125 216 318],588,4,27359,4.091983248579121,20.0,20.0
6686,0,6686,[288 568 423 748   8],416,5,27364,4.0921190369373415,0.0,20.0
6687,0,6687,[ 64 313 483 318 187],214,5,27369,4.092254784688995,80.0,20.0
6688,0,6688,[172 322  11 276 568],630,2,27371,4.091941994319031,0.0,0.0
6689,0,6689,[ 64 313 483 318 187],214,5,27376,4.092077727952168,80.0,20.0
6690,0,6690,[ 12 403 313  97 187],416,5,27381,4.092213421013302,40.0,20.0
6691,0,6691,[ 64 313 483 318 187],214,5,27386,4.092349073520622,80.0,20.0
6692,0,6692,[  8  15  56   1 322],721,4,27390,4.092335275661139,0.0,0.0
6693,0,6693,[ 64 313 483 318 187],618,5,27395,4.092470869435315,80.0,20.0
6694,0,6694,[125 191 748 471   8],416,5,27400,4.09260642270351,0.0,0.0
6695,0,6695,[127 655 257 742  96],417,2,27402,4.092293906810036,0.0,0.0
6696,0,6696,[655 172   1 385   9],887,3,27405,4.092130804837987,0.0,0.0
6697,0,6697,[ 64 313 483 318 187],214,5,27410,4.092266348163631,80.0,20.0
6698,0,6698,[471 288 269  88 144],416,4,27414,4.092252575011195,0.0,20.0
6699,0,6699,[ 64 313 483 318 187],214,5,27419,4.092388059701492,80.0,20.0
6700,0,6700,[ 64 313 483 318 187],618,5,27424,4.0925235039546335,80.0,20.0
6701,0,6701,[ 64 313 483 318 187],618,5,27429,4.09265890778872,80.0,20.0
6702,0,6702,[153  98 268 475 302],854,3,27432,4.092495897359392,0.0,20.0
6703,0,6703,[172  82 275   8 238],618,2,27434,4.092183770883055,0.0,0.0
6704,0,6704,[318 216 182 183 202],405,2,27436,4.091871737509321,20.0,0.0
6705,0,6705,[ 64 313 483 318 187],618,5,27441,4.092007157769162,80.0,20.0
6706,0,6706,[265  79 185  70 508],297,3,27444,4.091844341732518,0.0,0.0
6707,0,6707,[ 64 313 483 318 187],214,5,27449,4.091979725700656,80.0,20.0
6708,0,6708,[ 64 313 483 318 187],214,5,27454,4.092115069309882,80.0,20.0
6709,0,6709,[475 289   7 282 318],416,3,27457,4.091952309985097,20.0,0.0
6710,0,6710,[328  70 286  12  96],416,5,27462,4.092087617344658,20.0,0.0
6711,0,6711,[288   7 385 202 127],417,3,27465,4.091924910607866,0.0,20.0
6712,0,6712,[423 200 385   7 265],417,3,27468,4.091762252346194,0.0,0.0
6713,0,6713,[568 228 181 195 496],230,2,27470,4.091450700029789,0.0,20.0
6714,0,6714,[405 301 173 742 289],345,4,27474,4.091437081161579,0.0,0.0
6715,0,6715,[ 64 313 483 318 187],618,5,27479,4.09157236450268,80.0,20.0
6716,0,6716,[300  98  12 265  28],297,3,27482,4.091409855590293,20.0,20.0
6717,0,6717,[ 64 313 483 318 187],618,5,27487,4.09154510270914,80.0,20.0
6718,0,6718,[748 288 302 216 282],416,5,27492,4.091680309569877,0.0,20.0
6719,0,6719,[ 64 313 483 318 187],214,5,27497,4.091815476190476,80.0,20.0
6720,0,6720,[ 64 313 483 318 187],214,5,27502,4.0919506025889,80.0,20.0
6721,0,6721,[195  71  88  82 179],805,1,27503,4.091490627789349,0.0,0.0
6722,0,6722,[ 96  79 333 186 357],854,2,27505,4.091179532946601,0.0,0.0
6723,0,6723,[ 64 313 483 318 187],214,5,27510,4.091314693634741,80.0,20.0
6724,0,6724,[215 211 588  11 238],437,2,27512,4.091003717472119,0.0,0.0
6725,0,6725,[ 64 313 483 318 187],214,5,27517,4.091138864109426,80.0,20.0
6726,0,6726,[234 471 168  50 228],297,2,27519,4.090828006540805,0.0,20.0
6727,0,6727,[268  79 546   7 183],416,4,27523,4.090814506539833,0.0,0.0
6728,0,6728,[ 64 313 483 318 187],618,5,27528,4.090949621043245,80.0,20.0
6729,0,6729,[ 64 313 483 318 187],214,5,27533,4.091084695393759,80.0,20.0
6730,0,6730,[ 64 313 483 318 187],618,5,27538,4.0912197296092705,80.0,20.0
6731,0,6731,[125 294 172   8 597],416,4,27542,4.091206179441474,0.0,0.0
6732,0,6732,[ 64 313 483 318 187],618,5,27547,4.0913411555027475,80.0,20.0
6733,0,6733,[173  15  50 161 423],416,5,27552,4.091476091476092,0.0,20.0
6734,0,6734,[ 64 313 483 318 187],618,5,27557,4.091610987379362,80.0,20.0
6735,0,6735,[ 50 245 172 117 237],505,2,27559,4.091300475059382,0.0,20.0
6736,0,6736,[ 64 313 483 318 187],214,5,27564,4.091435356983821,80.0,20.0
6737,0,6737,[282 237 125 257 216],630,2,27566,4.091124962897002,0.0,0.0
6738,0,6738,[ 64 313 483 318 187],618,5,27571,4.091259830835435,80.0,20.0
6739,0,6739,[ 79 121 125 748 508],417,2,27573,4.0909495548961425,0.0,0.0
6740,0,6740,[ 64 313 483 318 187],214,5,27578,4.091084408841418,80.0,20.0
6741,0,6741,[181   4 117 200 288],416,5,27583,4.0912192227825575,0.0,40.0
6742,0,6742,[ 64 313 483 318 187],214,5,27588,4.091353996737357,80.0,20.0
6743,0,6743,[ 64 313 483 318 187],618,5,27593,4.091488730723606,80.0,20.0
6744,0,6744,[176 245 286 185 237],297,4,27597,4.091475166790215,0.0,0.0
6745,0,6745,[143   1  22 179 234],805,3,27600,4.091313370886451,0.0,0.0
6746,0,6746,[ 64 313 483 318 187],618,5,27605,4.0914480509856235,80.0,20.0
6747,0,6747,[ 64 313 483 318 187],618,5,27610,4.091582691167753,80.0,20.0
6748,0,6748,[471  22 655 117 216],588,4,27614,4.091569121351311,0.0,0.0
6749,0,6749,[302 182 168 125 318],62,4,27618,4.091555555555556,20.0,0.0
6750,0,6750,[ 64 313 483 318 187],214,5,27623,4.091690119982225,80.0,20.0
6751,0,6751,[496 174  12 176 200],417,3,27626,4.091528436018957,20.0,0.0
6752,0,6752,[ 64 313 483 318 187],618,5,27631,4.0916629646083225,80.0,20.0
6753,0,6753,[135  79 237 195  50],230,3,27634,4.091501332543678,0.0,20.0
6754,0,6754,[135 168 191   4 181],62,5,27639,4.091635825314582,0.0,20.0
6755,0,6755,[ 64 313 483 318 187],618,5,27644,4.0917702782711665,80.0,20.0
6756,0,6756,[204 234  97  56 183],198,2,27646,4.091460707414533,0.0,0.0
6757,0,6757,[237 588 216  71  64],618,4,27650,4.091447173720035,20.0,0.0
6758,0,6758,[  8  98 289  22 202],887,4,27654,4.091433644030182,0.0,20.0
6759,0,6759,[ 64 313 483 318 187],214,5,27659,4.091568047337278,80.0,20.0
6760,0,6760,[183 179 100  79  56],198,3,27662,4.091406596657299,0.0,0.0
6761,0,6761,[ 64 313 483 318 187],618,5,27667,4.091540964211772,80.0,20.0
6762,0,6762,[202   4  98 235 403],49,1,27668,4.091083838533195,0.0,20.0
6763,0,6763,[603 238 161  50 172],405,3,27671,4.090922531046718,0.0,20.0
6764,0,6764,[ 64 313 483 318 187],618,5,27676,4.0910569105691055,80.0,20.0
6765,0,6765,[ 64 313 483 318 187],618,5,27681,4.091191250369494,80.0,20.0
6766,0,6766,[ 64 313 483 318 187],618,5,27686,4.091325550465494,80.0,20.0
6767,0,6767,[194   1 301 742 191],416,5,27691,4.091459810874705,0.0,0.0
6768,0,6768,[  1 405 588 121 568],887,4,27695,4.091446299305658,0.0,0.0
6769,0,6769,[483 742 215 186   8],588,5,27700,4.091580502215657,20.0,0.0
6770,0,6770,[ 64 313 483 318 187],618,5,27705,4.091714665485157,80.0,20.0
6771,0,6771,[ 64 313 483 318 187],214,5,27710,4.091848789131719,80.0,20.0
6772,0,6772,[475 216  97 546 238],62,4,27714,4.09183522811162,0.0,0.0
6773,0,6773,[111 471 588 121 323],416,4,27718,4.0918216710953645,0.0,0.0
6774,0,6774,[235 174 294 357 288],416,4,27722,4.091808118081181,0.0,20.0
6775,0,6775,[238 172 197 427 403],618,3,27725,4.091646989374262,0.0,0.0
6776,0,6776,[ 64 313 483 318 187],214,5,27730,4.09178102405194,80.0,20.0
6777,0,6777,[515 742  97 161  22],416,5,27735,4.091915019179699,0.0,0.0
6778,0,6778,[  8 328 216 405   9],416,5,27740,4.09204897477504,0.0,0.0
6779,0,6779,[ 64 313 483 318 187],618,5,27745,4.092182890855457,80.0,20.0
6780,0,6780,[ 64 313 483 318 187],214,5,27750,4.092316767438431,80.0,20.0
6781,0,6781,[151   1  70 302  97],417,4,27754,4.092303155411383,0.0,0.0
6782,0,6782,[ 64 313 483 318 187],618,5,27759,4.092436974789916,80.0,20.0
6783,0,6783,[655 161 118 427 588],416,4,27763,4.092423349056604,0.0,0.0
6784,0,6784,[ 64 313 483 318 187],214,5,27768,4.092557111274871,80.0,20.0
6785,0,6785,[ 56  25 323 132 515],417,3,27771,4.092396109637489,0.0,0.0
6786,0,6786,[ 64 313 483 318 187],618,5,27776,4.092529836452041,80.0,20.0
6787,0,6787,[ 64 313 483 318 187],214,5,27781,4.092663523865645,80.0,20.0
6788,0,6788,[ 64 313 483 318 187],618,5,27786,4.092797171895714,80.0,20.0
6789,0,6789,[ 64 313 483 318 187],214,5,27791,4.092930780559646,80.0,20.0
6790,0,6790,[ 64 313 483 318 187],214,5,27796,4.093064349874834,80.0,20.0
6791,0,6791,[ 15  70 322 508 132],314,3,27799,4.092903415783274,0.0,0.0
6792,0,6792,[286 568  12 111 143],416,5,27804,4.093036949801266,20.0,0.0
6793,0,6793,[ 64 313 483 318 187],214,5,27809,4.093170444509862,80.0,20.0
6794,0,6794,[588 135 144 222  97],297,4,27813,4.093156732891832,0.0,0.0
6795,0,6795,[174 742 301 161 588],588,4,27817,4.093143025309005,0.0,0.0
6796,0,6796,[ 50 237 302 300  12],297,4,27821,4.0931293217596,20.0,20.0
6797,0,6797,[ 15  11 742 269 568],654,4,27825,4.093115622241836,0.0,0.0
6798,0,6798,[183 180 135 357   8],875,4,27829,4.093101926753935,0.0,0.0
6799,0,6799,[176 301 265 211 173],437,2,27831,4.092794117647059,0.0,0.0
6800,0,6800,[118 423 144 182 508],417,3,27834,4.092633436259374,0.0,0.0
6801,0,6801,[ 64 313 483 318 187],618,5,27839,4.092766833284328,80.0,20.0
6802,0,6802,[ 64 313 483 318 187],618,5,27844,4.092900191092165,80.0,20.0
6803,0,6803,[ 64 313 483 318 187],214,5,27849,4.093033509700176,80.0,20.0
6804,0,6804,[181 289  50 197   8],416,4,27853,4.093019838354151,0.0,40.0
6805,0,6805,[ 64 313 483 318 187],618,5,27858,4.093153100205701,80.0,20.0
6806,0,6806,[ 64 313 483 318 187],214,5,27863,4.093286322902894,80.0,20.0
6807,0,6807,[181  64 234 471 357],416,5,27868,4.093419506462984,20.0,20.0
6808,0,6808,[ 64 313 483 318 187],618,5,27873,4.0935526509032165,80.0,20.0
6809,0,6809,[ 64 313 483 318 187],618,5,27878,4.093685756240823,80.0,20.0
6810,0,6810,[ 64 313 483 318 187],618,5,27883,4.093818822493026,80.0,20.0
6811,0,6811,[ 64 313 483 318 187],214,5,27888,4.09395184967704,80.0,20.0
6812,0,6812,[588  98 258 202 269],297,4,27892,4.093938059591957,0.0,20.0
6813,0,6813,[385 153  70   4 174],416,5,27897,4.094071030231875,0.0,0.0
6814,0,6814,[196 294 100  71 546],43,5,27902,4.094203961848863,0.0,0.0
6815,0,6815,[ 95  71 405 181 427],198,2,27904,4.093896713615023,0.0,20.0
6816,0,6816,[322 117 275 121  79],128,4,27908,4.09388293970955,0.0,0.0
6817,0,6817,[318  28  56 161 289],588,4,27912,4.093869169844529,20.0,0.0
6818,0,6818,[ 64 313 483 318 187],618,5,27917,4.094002053086963,80.0,20.0
6819,0,6819,[143  69 151  15 258],198,3,27920,4.093841642228739,0.0,0.0
6820,0,6820,[ 64 313 483 318 187],618,5,27925,4.093974490543909,80.0,20.0
6821,0,6821,[ 88 153 228  56 655],805,2,27927,4.093667546174142,0.0,0.0
6822,0,6822,[423  97 210 588  79],405,3,27930,4.093507254873223,0.0,0.0
6823,0,6823,[ 64 313 483 318 187],214,5,27935,4.093640093786635,80.0,20.0
6824,0,6824,[286 181 127 271 210],62,3,27938,4.093479853479853,0.0,20.0
6825,0,6825,[ 64 313 483 318 187],618,5,27943,4.093612657486083,80.0,20.0
6826,0,6826,[228 245 471  98 294],505,3,27946,4.093452468141204,0.0,20.0
6827,0,6827,[328 318 588  97 323],416,4,27950,4.093438781487991,20.0,0.0
6828,0,6828,[ 64 313 483 318 187],618,5,27955,4.093571533167374,80.0,20.0
6829,0,6829,[ 64 313 483 318 187],214,5,27960,4.093704245973646,80.0,20.0
6830,0,6830,[ 64 313 483 318 187],618,5,27965,4.093836919923876,80.0,20.0
6831,0,6831,[ 64 313 483 318 187],618,5,27970,4.0939695550351285,80.0,20.0
6832,0,6832,[117 185 187  97 100],618,5,27975,4.094102151324455,0.0,0.0
6833,0,6833,[ 64 313 483 318 187],214,5,27980,4.094234708808897,80.0,20.0
6834,0,6834,[ 64 313 483 318 187],214,5,27985,4.0943672275054865,80.0,20.0
6835,0,6835,[ 64 313 483 318 187],214,5,27990,4.094499707431246,80.0,20.0
6836,0,6836,[ 64 313 483 318 187],214,5,27995,4.094632148603188,80.0,20.0
6837,0,6837,[ 64 313 483 318 187],214,5,28000,4.094764551038315,80.0,20.0
6838,0,6838,[ 64 313 483 318 187],618,5,28005,4.094896914753619,80.0,20.0
6839,0,6839,[ 64 313 483 318 187],214,5,28010,4.095029239766082,80.0,20.0
6840,0,6840,[172 194 216  71 238],373,5,28015,4.095161526092676,0.0,0.0
6841,0,6841,[ 64 313 483 318 187],618,5,28020,4.095293773750365,80.0,20.0
6842,0,6842,[ 64 313 483 318 187],618,5,28025,4.095425982756101,80.0,20.0
6843,0,6843,[ 56  64 508 294   9],314,3,28028,4.095265926358855,20.0,0.0
6844,0,6844,[ 64 313 483 318 187],618,5,28033,4.095398100803506,80.0,20.0
6845,0,6845,[ 64 313 483 318 187],618,5,28038,4.095530236634531,80.0,20.0
6846,0,6846,[ 64 313 483 318 187],214,5,28043,4.095662333868848,80.0,20.0
6847,0,6847,[  1 678 172 282 161],345,1,28044,4.0952102803738315,0.0,0.0
6848,0,6848,[216 546 268 117 235],416,3,28047,4.095050372317127,0.0,0.0
6849,0,6849,[748  97 174 597 125],417,3,28050,4.094890510948905,0.0,0.0
6850,0,6850,[ 64 313 483 318 187],214,5,28055,4.095022624434389,80.0,20.0
6851,0,6851,[423   1 385 475 216],417,4,28059,4.095008756567426,0.0,0.0
6852,0,6852,[161 568  70  56 204],751,3,28062,4.094848971253466,0.0,0.0
6853,0,6853,[176 117 216 181 153],297,5,28067,4.094981032973446,0.0,20.0
6854,0,6854,[ 64 313 483 318 187],618,5,28072,4.095113056163385,80.0,20.0
6855,0,6855,[ 64 313 483 318 187],618,5,28077,4.09524504084014,80.0,20.0
6856,0,6856,[183   4 151 265 748],416,4,28081,4.095231150648972,0.0,0.0
6857,0,6857,[  1 117 427 173 216],128,5,28086,4.095363079615048,0.0,0.0
6858,0,6858,[ 64 313 483 318 187],214,5,28091,4.095494970112261,80.0,20.0
6859,0,6859,[ 64 313 483 318 187],214,5,28096,4.095626822157435,80.0,20.0
6860,0,6860,[265 182 603  28 191],416,5,28101,4.095758635767381,0.0,0.0
6861,0,6861,[ 64 313 483 318 187],618,5,28106,4.095890410958904,80.0,20.0
6862,0,6862,[ 64 313 483 318 187],618,5,28111,4.096022147748798,80.0,20.0
6863,0,6863,[ 64 313 483 318 187],618,5,28116,4.096153846153846,80.0,20.0
6864,0,6864,[ 64 313 483 318 187],214,5,28121,4.096285506190823,80.0,20.0
6865,0,6865,[238 127   7 385 118],416,4,28125,4.09627148266822,0.0,0.0
6866,0,6866,[ 56  71 268 515  11],416,5,28130,4.096403087228775,0.0,0.0
6867,0,6867,[ 64 313 483 318 187],214,5,28135,4.096534653465347,80.0,20.0
6868,0,6868,[322   1 173 333 180],854,2,28137,4.096229436599214,0.0,0.0
6869,0,6869,[ 64 313 483 318 187],618,5,28142,4.096360989810772,80.0,20.0
6870,0,6870,[ 64 313 483 318 187],618,5,28147,4.0964925047300245,80.0,20.0
6871,0,6871,[151  79 173 322 216],128,3,28150,4.096332945285216,0.0,0.0
6872,0,6872,[ 64 313 483 318 187],618,5,28155,4.09646442601484,80.0,20.0
6873,0,6873,[ 64 313 483 318 187],618,5,28160,4.096595868489962,80.0,20.0
6874,0,6874,[ 64 313 483 318 187],618,5,28165,4.096727272727272,80.0,20.0
6875,0,6875,[ 64 313 483 318 187],618,5,28170,4.096858638743456,80.0,20.0
6876,0,6876,[ 64 313 483 318 187],214,5,28175,4.096989966555184,80.0,20.0
6877,0,6877,[ 64 313 483 318 187],214,5,28180,4.097121256179122,80.0,20.0
6878,0,6878,[238 143  96  25 427],230,2,28182,4.096816397732229,0.0,0.0
6879,0,6879,[282 742 151 257 197],416,3,28185,4.096656976744186,0.0,0.0
6880,0,6880,[183 276  82  95 181],198,2,28187,4.096352274378724,0.0,20.0
6881,0,6881,[ 64 313 483 318 187],214,5,28192,4.0964835803545485,80.0,20.0
6882,0,6882,[  1  98 175 191 111],43,4,28196,4.096469562690687,0.0,20.0
6883,0,6883,[286  28 302 173 471],345,2,28198,4.096165020337013,0.0,0.0
6884,0,6884,[ 64 313 483 318 187],214,5,28203,4.0962962962962965,80.0,20.0
6885,0,6885,[216 215 132  97 210],62,3,28206,4.096137089747313,0.0,0.0
6886,0,6886,[ 98   8 179 258 313],49,2,28208,4.095832728328736,20.0,40.0
6887,0,6887,[ 64 483 313 318 187],214,5,28213,4.095963995354239,80.0,20.0
6888,0,6888,[385 471 161 300 271],43,3,28216,4.095804906372478,0.0,0.0
6889,0,6889,[181 111   9 173  25],618,1,28217,4.095355587808418,0.0,20.0
6890,0,6890,[ 82  70 216 282 275],128,3,28220,4.095196633289798,0.0,0.0
6891,0,6891,[546 179  22 597 222],62,4,28224,4.095182820661637,0.0,0.0
6892,0,6892,[172 403 204 100  25],43,5,28229,4.095314086754678,0.0,0.0
6893,0,6893,[ 64 483 313 318 187],214,5,28234,4.095445314766463,80.0,20.0
6894,0,6894,[ 64 483 313 318 187],618,5,28239,4.09557650471356,80.0,20.0
6895,0,6895,[237   4 385 196 288],654,4,28243,4.095562645011601,0.0,20.0
6896,0,6896,[271  82 121  11 423],505,5,28248,4.095693779904306,0.0,0.0
6897,0,6897,[ 64 483 313 318 187],618,5,28253,4.095824876775877,80.0,20.0
6898,0,6898,[185  28 195  79 191],437,3,28256,4.095666038556312,0.0,0.0
6899,0,6899,[118 111 194 185 273],416,4,28260,4.095652173913043,0.0,0.0
6900,0,6900,[ 71 318 100 301 268],588,4,28264,4.095638313287929,20.0,0.0
6901,0,6901,[ 64 483 313 318 187],214,5,28269,4.095769342219646,80.0,20.0
6902,0,6902,[ 64 483 313 318 187],618,5,28274,4.095900333188469,80.0,20.0
6903,0,6903,[ 64 483 313 318 187],618,5,28279,4.096031286210892,80.0,20.0
6904,0,6904,[ 97 100 118 257 211],297,3,28282,4.095872556118755,0.0,0.0
6905,0,6905,[ 64 483 313 318 187],214,5,28287,4.0960034752389225,80.0,20.0
6906,0,6906,[ 15 176 275  56 151],854,3,28290,4.09584479513537,0.0,0.0
6907,0,6907,[211 588  97 235 471],43,3,28293,4.095686160972785,0.0,0.0
6908,0,6908,[  7 216 185 597 181],618,4,28297,4.095672311477783,0.0,20.0
6909,0,6909,[  9 302 181   8 258],416,5,28302,4.095803183791606,0.0,20.0
6910,0,6910,[ 64 483 313 318 187],618,5,28307,4.095934018231804,80.0,20.0
6911,0,6911,[ 79 245 181 678  71],921,4,28311,4.095920138888889,0.0,20.0
6912,0,6912,[286 748 271 195 435],297,1,28312,4.095472298567915,0.0,0.0
6913,0,6913,[ 12 496 127  70 238],618,3,28315,4.09531385594446,20.0,0.0
6914,0,6914,[182  79  89  98  88],437,2,28317,4.095010845986985,0.0,20.0
6915,0,6915,[ 64 483 313 318 187],618,5,28322,4.0951417004048585,80.0,20.0
6916,0,6916,[ 64 483 313 318 187],214,5,28327,4.095272516987134,80.0,20.0
6917,0,6917,[742 161 181  70 235],417,1,28328,4.094825093957791,0.0,20.0
6918,0,6918,[135 282 118 597  89],854,2,28330,4.0945223298164475,0.0,0.0
6919,0,6919,[475 318  71 269 121],711,3,28333,4.094364161849711,20.0,0.0
6920,0,6920,[ 64 483 313 318 187],618,5,28338,4.094495015171218,80.0,20.0
6921,0,6921,[ 64 483 313 318 187],214,5,28343,4.094625830684773,80.0,20.0
6922,0,6922,[ 64 483 313 318 187],214,5,28348,4.09475660840676,80.0,20.0
6923,0,6923,[  4 204 238 181  70],405,4,28352,4.0947429231658,0.0,20.0
6924,0,6924,[  7 117  12   9  96],805,3,28355,4.094584837545126,20.0,0.0
6925,0,6925,[ 70 288 289 117  64],345,3,28358,4.094426797574357,20.0,20.0
6926,0,6926,[153 222  70 265  95],198,1,28359,4.093980077955825,0.0,0.0
6927,0,6927,[ 95 282 603 181 153],297,3,28362,4.093822170900693,0.0,20.0
6928,0,6928,[ 64 483 313 318 187],214,5,28367,4.093952951363833,80.0,20.0
6929,0,6929,[ 56 265   1 655 196],416,5,28372,4.094083694083694,0.0,0.0
6930,0,6930,[ 64 483 313 318 187],618,5,28377,4.094214399076613,80.0,20.0
6931,0,6931,[ 96 197 125 202 385],373,2,28379,4.093912290825159,0.0,0.0
6932,0,6932,[ 64 483 313 318 187],214,5,28384,4.094042982835713,80.0,20.0
6933,0,6933,[194 200 144 328  95],416,4,28388,4.094029420248053,0.0,0.0
6934,0,6934,[423 515   1  82 222],417,4,28392,4.094015861571737,0.0,0.0
6935,0,6935,[ 64 483 313 318 187],214,5,28397,4.094146482122261,80.0,20.0
6936,0,6936,[273 153  70   1 191],62,3,28400,4.093988755946374,0.0,0.0
6937,0,6937,[  8 496 173 289   4],416,4,28404,4.093975208993946,0.0,0.0
6938,0,6938,[357   9 508 405   4],62,4,28408,4.093961665946102,0.0,0.0
6939,0,6939,[118 237 405 597 143],416,2,28410,4.093659942363113,0.0,0.0
6940,0,6940,[151 483 118  97 168],128,3,28413,4.093502377179081,20.0,0.0
6941,0,6941,[153 288 546 127 210],417,2,28415,4.093200806683953,0.0,20.0
6942,0,6942,[269 471  50 265 234],297,2,28417,4.092899323059196,0.0,20.0
6943,0,6943,[210  89 222  70   7],297,5,28422,4.093029953917051,0.0,0.0
6944,0,6944,[194 655 597 181 173],751,3,28425,4.092872570194385,0.0,20.0
6945,0,6945,[ 64 174 597 546 235],416,2,28427,4.092571264036856,20.0,0.0
6946,0,6946,[ 64 483 313 318 187],618,5,28432,4.09270188570606,80.0,20.0
6947,0,6947,[ 64 483 313 318 187],618,5,28437,4.092832469775475,80.0,20.0
6948,0,6948,[ 64 483 313 318 187],618,5,28442,4.092963016261333,80.0,20.0
6949,0,6949,[ 64 483 313 318 187],214,5,28447,4.093093525179856,80.0,20.0
6950,0,6950,[269 118 471 257   9],854,2,28449,4.092792403970652,0.0,0.0
6951,0,6951,[ 64 483 313 318 187],618,5,28454,4.092922899884925,80.0,20.0
6952,0,6952,[385  88 210 211 181],373,4,28458,4.092909535452323,0.0,20.0
6953,0,6953,[ 64 483 313 318 187],618,5,28463,4.093039976991659,80.0,20.0
6954,0,6954,[ 64 483 313 318 187],214,5,28468,4.093170381020848,80.0,20.0
6955,0,6955,[258 100 111   8  79],43,5,28473,4.093300747556067,0.0,0.0
6956,0,6956,[ 64 655 216 423 181],405,4,28477,4.0932873364956155,20.0,20.0
6957,0,6957,[ 98  88 174 191   8],342,2,28479,4.092986490370796,0.0,20.0
6958,0,6958,[ 64 483 313 318 187],214,5,28484,4.093116827130335,80.0,20.0
6959,0,6959,[ 64 483 313 318 187],618,5,28489,4.093247126436782,80.0,20.0
6960,0,6960,[423 597 275   1 210],62,2,28491,4.092946415744864,0.0,0.0
6961,0,6961,[151   7 195 357 333],854,3,28494,4.092789428325194,0.0,0.0
6962,0,6962,[ 64 483 313 318 187],618,5,28499,4.092919718512135,80.0,20.0
6963,0,6963,[ 64 483 313 318 187],618,5,28504,4.093049971280873,80.0,20.0
6964,0,6964,[ 64 483 313 318 187],618,5,28509,4.0931801866475235,80.0,20.0
6965,0,6965,[655 597  50 204 215],62,1,28510,4.092736146999713,0.0,20.0
6966,0,6966,[269  71  95 546  64],262,2,28512,4.092435768623511,20.0,0.0
6967,0,6967,[ 11  70 196 118 215],416,4,28516,4.092422502870264,0.0,0.0
6968,0,6968,[ 89  64 237 568 143],642,4,28520,4.092409240924092,20.0,0.0
6969,0,6969,[100 181 405 222 655],417,1,28521,4.0919655667144905,0.0,20.0
6970,0,6970,[181 135 588 195  50],417,1,28522,4.091522019796299,0.0,40.0
6971,0,6971,[269 111 172 180 132],711,4,28526,4.091508892713712,0.0,0.0
6972,0,6972,[603 153 423  12  88],805,3,28529,4.091352359099384,20.0,0.0
6973,0,6973,[294 185 151   7 176],805,4,28533,4.091339260108977,0.0,0.0
6974,0,6974,[180  97  64 135  28],373,1,28534,4.0908960573476705,20.0,0.0
6975,0,6975,[ 64 483 313 318 187],618,5,28539,4.091026376146789,80.0,20.0
6976,0,6976,[245 118  50 282  71],345,1,28540,4.09058334527734,0.0,20.0
6977,0,6977,[ 56   1 174 144 172],43,5,28545,4.090713671539123,0.0,0.0
6978,0,6978,[ 98  15  28 234 273],618,4,28549,4.090700673448918,0.0,20.0
6979,0,6979,[323 322 135 175 423],805,3,28552,4.09054441260745,0.0,0.0
6980,0,6980,[568 294 405   1 322],128,4,28556,4.09053144248675,0.0,0.0
6981,0,6981,[238 111  64 204 276],416,4,28560,4.090518476081352,20.0,0.0
6982,0,6982,[151 117 195  96 237],62,4,28564,4.090505513389661,0.0,0.0
6983,0,6983,[  7   9 245 234 385],416,4,28568,4.09049255441008,0.0,0.0
6984,0,6984,[ 64 483 313 318 187],214,5,28573,4.090622763063708,80.0,20.0
6985,0,6985,[546  95 288 179 322],416,1,28574,4.090180360721443,0.0,20.0
6986,0,6986,[288 257  22 237 185],297,3,28577,4.090024330900243,0.0,20.0
6987,0,6987,[ 64 483 313 318 187],618,5,28582,4.090154550658271,80.0,20.0
6988,0,6988,[ 64 483 313 318 187],618,5,28587,4.090284733152096,80.0,20.0
6989,0,6989,[  7 276 144 187 313],618,4,28591,4.090271816881259,20.0,20.0
6990,0,6990,[275 237 405 471 117],43,4,28595,4.090258904305536,0.0,0.0
6991,0,6991,[ 64 483 313 318 187],214,5,28600,4.090389016018307,80.0,20.0
6992,0,6992,[ 64 483 313 318 187],214,5,28605,4.0905190905190905,80.0,20.0
6993,0,6993,[276  95 117  71  22],314,4,28609,4.090506148126966,0.0,0.0
6994,0,6994,[ 79 216 268  97 100],654,2,28611,4.090207290922087,0.0,0.0
6995,0,6995,[275 151 748 265  28],416,4,28615,4.090194396798171,0.0,0.0
6996,0,6996,[403  97 588  82 186],642,5,28620,4.090324424753466,0.0,0.0
6997,0,6997,[228 195 483 655 196],62,3,28623,4.090168619605602,20.0,0.0
6998,0,6998,[ 64 483 313 318 187],618,5,28628,4.090298614087727,80.0,20.0
6999,0,6999,[  9 135 179 144 191],62,4,28632,4.090285714285714,0.0,0.0
7000,0,7000,[186 475 496 228   4],417,2,28634,4.089987144693615,0.0,0.0
7001,0,7001,[ 79 100 328 117  12],43,5,28639,4.090117109397315,20.0,0.0
7002,0,7002,[ 64 483 313 318 187],618,5,28644,4.09024703698415,80.0,20.0
7003,0,7003,[121 182  25 183 294],417,3,28647,4.0900913763563675,0.0,0.0
7004,0,7004,[187 216 135 151 168],198,5,28652,4.090221270521057,0.0,0.0
7005,0,7005,[127 238 471 235 300],416,4,28656,4.090208392806166,0.0,0.0
7006,0,7006,[151 276 143  11 300],654,4,28660,4.090195518766947,0.0,0.0
7007,0,7007,[ 64 483 313 318 187],618,5,28665,4.0903253424657535,80.0,20.0
7008,0,7008,[ 64 483 313 318 187],214,5,28670,4.090455129119703,80.0,20.0
7009,0,7009,[ 64 483 313 318 187],214,5,28675,4.09058487874465,80.0,20.0
7010,0,7010,[161 174  28 202  82],805,0,28675,4.090001426330053,0.0,0.0
7011,0,7011,[121 427 237 403 151],416,3,28678,4.089845978322875,0.0,0.0
7012,0,7012,[427 197  15 508 181],128,5,28683,4.089975759304149,0.0,20.0
7013,0,7013,[ 64 483 313 318 187],618,5,28688,4.090105503279156,80.0,20.0
7014,0,7014,[121 204 161 237  69],128,5,28693,4.090235210263721,0.0,0.0
7015,0,7015,[294 286 182 471 211],416,5,28698,4.09036488027366,0.0,0.0
7016,0,7016,[ 64 483 313 318 187],618,5,28703,4.090494513324782,80.0,20.0
7017,0,7017,[210   8 195 176 276],416,4,28707,4.090481618694785,0.0,0.0
7018,0,7018,[ 64 483 313 318 187],618,5,28712,4.090611198176378,80.0,20.0
7019,0,7019,[ 64 483 313 318 187],214,5,28717,4.090740740740741,80.0,20.0
7020,0,7020,[  7 127 286 265 568],416,5,28722,4.090870246403647,0.0,0.0
7021,0,7021,[ 64 483 313 318 187],214,5,28727,4.09099971518086,80.0,20.0
7022,0,7022,[132 175 258 228 655],198,3,28730,4.090844368503489,0.0,0.0
7023,0,7023,[ 12 588 174 655  89],373,4,28734,4.090831435079727,20.0,0.0
7024,0,7024,[ 64 483 313 318 187],214,5,28739,4.090960854092526,80.0,20.0
7025,0,7025,[ 64 483 313 318 187],618,5,28744,4.0910902362653,80.0,20.0
7026,0,7026,[196 515 333 183 100],416,5,28749,4.0912195816137755,0.0,0.0
7027,0,7027,[245 151 258 273 135],297,3,28752,4.091064314171884,0.0,0.0
7028,0,7028,[127   1 588 183  98],416,5,28757,4.091193626404894,0.0,20.0
7029,0,7029,[197 216 288 269 215],721,4,28761,4.091180654338549,0.0,20.0
7030,0,7030,[144 183 475 200 175],805,4,28765,4.0911676859621675,0.0,0.0
7031,0,7031,[127 172 405 121 222],805,2,28767,4.090870307167235,0.0,0.0
7032,0,7032,[100 235 216  98 176],417,2,28769,4.090573012939002,0.0,20.0
7033,0,7033,[121  82 118 508 282],128,4,28773,4.090560136479954,0.0,0.0
7034,0,7034,[183 135 151 144 237],62,3,28776,4.090405117270789,0.0,0.0
7035,0,7035,[ 64 483 313 318 187],618,5,28781,4.090534394542353,80.0,20.0
7036,0,7036,[357 127 333 597 185],416,4,28785,4.09052152906068,0.0,0.0
7037,0,7037,[ 64 483 313 318 187],214,5,28790,4.090650753054845,80.0,20.0
7038,0,7038,[ 64 483 313 318 187],214,5,28795,4.090779940332434,80.0,20.0
7039,0,7039,[ 64 483 313 318 187],214,5,28800,4.090909090909091,80.0,20.0
7040,0,7040,[ 97 185 100  88 153],437,3,28803,4.0907541542394545,0.0,0.0
7041,0,7041,[ 64 483 313 318 187],214,5,28808,4.090883271797785,80.0,20.0
7042,0,7042,[ 64 483 313 318 187],214,5,28813,4.091012352690615,80.0,20.0
7043,0,7043,[423 196 748 216 588],416,5,28818,4.09114139693356,0.0,0.0
7044,0,7044,[200 153 300 210  69],198,4,28822,4.091128459900639,0.0,0.0
7045,0,7045,[ 64 483 313 318 187],618,5,28827,4.091257451036049,80.0,20.0
7046,0,7046,[216 135 204  70  56],642,2,28829,4.090960692493259,0.0,0.0
7047,0,7047,[ 64 483 313 318 187],618,5,28834,4.0910896708286035,80.0,20.0
7048,0,7048,[125 172  97  98 121],588,2,28836,4.090793020286566,0.0,20.0
7049,0,7049,[185 168 603   4 175],805,4,28840,4.090780141843972,0.0,0.0
7050,0,7050,[187 197 742 318 322],416,4,28844,4.090767267054319,20.0,0.0
7051,0,7051,[ 56 288 273 322   9],805,1,28845,4.090328984685196,0.0,20.0
7052,0,7052,[ 64 483 313 318 187],214,5,28850,4.090457961151283,80.0,20.0
7053,0,7053,[187 173 153 161   1],416,5,28855,4.0905869010490505,0.0,0.0
7054,0,7054,[118 282 257 313 179],416,2,28857,4.090290574060949,20.0,20.0
7055,0,7055,[132 238 127 181 276],601,4,28861,4.090277777777778,0.0,20.0
7056,0,7056,[ 64 483 313 318 187],618,5,28866,4.090406688394502,80.0,20.0
7057,0,7057,[215 197  56 238 313],345,5,28871,4.090535562482289,20.0,20.0
7058,0,7058,[275 144 182   8  28],297,3,28874,4.090381073806488,0.0,0.0
7059,0,7059,[597 423 496  11 153],416,4,28878,4.090368271954675,0.0,0.0
7060,0,7060,[187 172 385 200  25],416,5,28883,4.090497096728509,0.0,0.0
7061,0,7061,[ 12  97 238 655 151],24,5,28888,4.090625885018408,20.0,0.0
7062,0,7062,[ 64 483 313 318 187],214,5,28893,4.09075463683987,80.0,20.0
7063,0,7063,[ 64 483 313 318 187],214,5,28898,4.0908833522083805,80.0,20.0
7064,0,7064,[ 64 483 313 318 187],618,5,28903,4.09101203113942,80.0,20.0
7065,0,7065,[ 64 483 313 318 187],214,5,28908,4.091140673648457,80.0,20.0
7066,0,7066,[427 181 176   7 151],887,5,28913,4.091269279750955,0.0,20.0
7067,0,7067,[ 64 483 313 318 187],618,5,28918,4.091397849462366,80.0,20.0
7068,0,7068,[588  96 197 597 118],751,2,28920,4.091101994624417,0.0,0.0
7069,0,7069,[ 12 483 176 144 301],437,2,28922,4.090806223479491,40.0,0.0
7070,0,7070,[ 69 161 121 273 117],417,1,28923,4.090369113279593,0.0,0.0
7071,0,7071,[ 64 483 313 318 187],214,5,28928,4.090497737556561,80.0,20.0
7072,0,7072,[151 423  79 483  88],354,2,28930,4.090202177293935,20.0,0.0
7073,0,7073,[195 176 546 191 204],62,4,28934,4.090189426067289,0.0,0.0
7074,0,7074,[ 64 483 313 318 187],618,5,28939,4.090318021201414,80.0,20.0
7075,0,7075,[ 64 483 313 318 187],618,5,28944,4.090446579988694,80.0,20.0
7076,0,7076,[318  97 132 568 588],588,4,28948,4.0904337996326126,20.0,0.0
7077,0,7077,[257  56   4  95 216],416,3,28951,4.090279740039559,0.0,0.0
7078,0,7078,[ 64 483 313 318 187],618,5,28956,4.09040824975279,80.0,20.0
7079,0,7079,[ 71  56  70 313  82],654,4,28960,4.090395480225989,20.0,20.0
7080,0,7080,[118 568 294 288 483],62,1,28961,4.08995904533258,20.0,20.0
7081,0,7081,[ 64 483 313 318 187],618,5,28966,4.0900875458909915,80.0,20.0
7082,0,7082,[ 64  69 100  95 294],679,2,28968,4.089792460821686,20.0,0.0
7083,0,7083,[748 273 181 546 143],805,0,28968,4.089215132693393,0.0,20.0
7084,0,7084,[ 64 483 313 318 187],618,5,28973,4.089343683839097,80.0,20.0
7085,0,7085,[197  64 215 318 228],405,4,28977,4.089331075359865,40.0,0.0
7086,0,7086,[238 258 111 282  97],297,3,28980,4.089177367010018,0.0,0.0
7087,0,7087,[ 64 483 313 318 187],214,5,28985,4.089305869074492,80.0,20.0
7088,0,7088,[ 64 483 313 318 187],214,5,28990,4.089434334885033,80.0,20.0
7089,0,7089,[ 88  12  15 161  79],373,5,28995,4.089562764456982,20.0,0.0
7090,0,7090,[ 64 483 313 318 187],618,5,29000,4.089691157805669,80.0,20.0
7091,0,7091,[ 64 483 313 318 187],618,5,29005,4.089819514946418,80.0,20.0
7092,0,7092,[ 64 483 313 318 187],618,5,29010,4.089947835894544,80.0,20.0
7093,0,7093,[ 64 483 313 318 187],618,5,29015,4.090076120665351,80.0,20.0
7094,0,7094,[202 204 385  69 588],230,4,29019,4.090063424947146,0.0,0.0
7095,0,7095,[  8 328 100 197  22],416,5,29024,4.090191657271703,0.0,0.0
7096,0,7096,[ 64 483 313 318 187],214,5,29029,4.090319853459208,80.0,20.0
7097,0,7097,[168 181 357 185 183],601,5,29034,4.090448013524937,0.0,20.0
7098,0,7098,[ 64 483 313 318 187],214,5,29039,4.0905761374841525,80.0,20.0
7099,0,7099,[ 64 483 313 318 187],618,5,29044,4.090704225352113,80.0,20.0
7100,0,7100,[ 64 483 313 318 187],618,5,29049,4.090832277144064,80.0,20.0
7101,0,7101,[ 64 483 313 318 187],214,5,29054,4.090960292875247,80.0,20.0
7102,0,7102,[174 222 195 153 173],601,4,29058,4.090947486977334,0.0,0.0
7103,0,7103,[ 22  11 496 655 174],618,5,29063,4.09107545045045,0.0,0.0
7104,0,7104,[210  71 168  98 357],601,3,29066,4.090921885995778,0.0,20.0
7105,0,7105,[  4 275 132 175 186],373,3,29069,4.090768364762173,0.0,0.0
7106,0,7106,[427  64 185  88 182],405,3,29072,4.090614886731392,20.0,0.0
7107,0,7107,[ 64 483 313 318 187],214,5,29077,4.090742824985932,80.0,20.0
7108,0,7108,[ 64 483 313 318 187],618,5,29082,4.090870727247151,80.0,20.0
7109,0,7109,[191 185  11 288 196],405,4,29086,4.0908579465541495,0.0,20.0
7110,0,7110,[245 191  98 405  97],128,3,29089,4.0907045422584725,0.0,20.0
7111,0,7111,[174 258 172  56 135],721,2,29091,4.09041057367829,0.0,0.0
7112,0,7112,[ 64 483 313 318 187],618,5,29096,4.0905384507240266,80.0,20.0
7113,0,7113,[ 64 483 313 318 187],214,5,29101,4.090666291818948,80.0,20.0
7114,0,7114,[318 196 678 151   4],654,5,29106,4.090794096978215,20.0,0.0
7115,0,7115,[268 294 237 235  96],416,3,29109,4.090640809443507,0.0,0.0
7116,0,7116,[175 181 427 403 200],922,2,29111,4.0903470563439654,0.0,20.0
7117,0,7117,[282 117 172 183   8],416,5,29116,4.090474852486653,0.0,0.0
7118,0,7118,[ 95 238  25 245 276],416,2,29118,4.090181205225453,0.0,0.0
7119,0,7119,[ 28 121 357 179  88],805,2,29120,4.089887640449438,0.0,0.0
7120,0,7120,[318 173 172 269 286],711,4,29124,4.089875017553714,20.0,0.0
7121,0,7121,[ 64 483 313 318 187],214,5,29129,4.0900028081999436,80.0,20.0
7122,0,7122,[ 28 175  96  89  70],405,1,29130,4.089569001825073,0.0,0.0
7123,0,7123,[172 275 132 496 216],128,3,29133,4.089416058394161,0.0,0.0
7124,0,7124,[ 64 483 313 318 187],214,5,29138,4.0895438596491225,80.0,20.0
7125,0,7125,[125 405 235  89  22],854,2,29140,4.089250631490317,0.0,0.0
7126,0,7126,[301 678 655 222  98],588,1,29141,4.088817174126561,0.0,20.0
7127,0,7127,[ 64 483 313 318 187],618,5,29146,4.088945005611672,80.0,20.0
7128,0,7128,[186 143 423 265 313],405,4,29150,4.088932529106467,20.0,20.0
7129,0,7129,[ 64 483 313 318 187],214,5,29155,4.0890603085554,80.0,20.0
7130,0,7130,[ 64 483 313 318 187],618,5,29160,4.089188052166596,80.0,20.0
7131,0,7131,[ 11 508 100 288 153],297,4,29164,4.089175546831183,0.0,20.0
7132,0,7132,[ 64 483 313 318 187],618,5,29169,4.089303238469087,80.0,20.0
7133,0,7133,[ 64 483 313 318 187],618,5,29174,4.0894308943089435,80.0,20.0
7134,0,7134,[ 11 135 179   8 385],405,3,29177,4.08927820602663,0.0,0.0
7135,0,7135,[ 64 483 313 318 187],618,5,29182,4.089405829596412,80.0,20.0
7136,0,7136,[ 64 483 313 318 187],618,5,29187,4.0895334174022695,80.0,20.0
7137,0,7137,[257  82  28  25 403],43,5,29192,4.089660969459232,0.0,0.0
7138,0,7138,[216 282 191 181 117],618,3,29195,4.08950833450063,0.0,20.0
7139,0,7139,[323  22 196 286 191],416,4,29199,4.089495798319327,0.0,0.0
7140,0,7140,[135   8  56 161 185],437,4,29203,4.0894832656490685,0.0,0.0
7141,0,7141,[603 197 180 125 195],854,3,29206,4.089330719686362,0.0,0.0
7142,0,7142,[ 64 483 313 318 187],618,5,29211,4.089458210835783,80.0,20.0
7143,0,7143,[ 64 483 313 318 187],618,5,29216,4.089585666293393,80.0,20.0
7144,0,7144,[323 135 181 322 222],805,3,29219,4.089433170048985,0.0,20.0
7145,0,7145,[ 64 483 313 318 187],214,5,29224,4.0895605933389305,80.0,20.0
7146,0,7146,[ 89 191 257 210  28],705,3,29227,4.089408143276899,0.0,0.0
7147,0,7147,[111  82 144  28  50],734,3,29230,4.089255735870173,0.0,20.0
7148,0,7148,[ 64 483 313 318 187],214,5,29235,4.0893831305077635,80.0,20.0
7149,0,7149,[ 64 483 313 318 187],618,5,29240,4.08951048951049,80.0,20.0
7150,0,7150,[ 64 483 313 318 187],214,5,29245,4.089637812893302,80.0,20.0
7151,0,7151,[69 50 15  7 71],588,3,29248,4.089485458612975,0.0,20.0
7152,0,7152,[238 269  97  89 216],354,3,29251,4.089333146931358,0.0,0.0
7153,0,7153,[423 568 265 286   7],588,3,29254,4.089180877830584,0.0,0.0
7154,0,7154,[ 64 483 313 318 187],214,5,29259,4.089308176100629,80.0,20.0
7155,0,7155,[ 64 483 313 318 187],214,5,29264,4.089435438792622,80.0,20.0
7156,0,7156,[ 64 483 313 318 187],618,5,29269,4.089562665921475,80.0,20.0
7157,0,7157,[ 64 483 313 318 187],618,5,29274,4.089689857502096,80.0,20.0
7158,0,7158,[ 64 483 313 318 187],214,5,29279,4.0898170135493785,80.0,20.0
7159,0,7159,[182 597  71 300 153],416,4,29283,4.089804469273743,0.0,0.0
7160,0,7160,[168 597 423  22 125],62,3,29286,4.08965228320067,0.0,0.0
7161,0,7161,[125 302 127 153 210],62,4,29290,4.089639765428651,0.0,0.0
7162,0,7162,[ 12 238 301 216  56],345,5,29295,4.0897668574619574,20.0,0.0
7163,0,7163,[ 64 483 313 318 187],214,5,29300,4.089893914014517,80.0,20.0
7164,0,7164,[196 742 204 423 234],297,1,29301,4.089462665736217,0.0,0.0
7165,0,7165,[655 153   8 200 603],437,5,29306,4.089589729277142,0.0,0.0
7166,0,7166,[197 176 245 237 603],416,3,29309,4.089437700572066,0.0,0.0
7167,0,7167,[222  98 268 117 144],588,2,29311,4.089146205357143,0.0,20.0
7168,0,7168,[ 64 483 313 318 187],214,5,29316,4.08927325986888,80.0,20.0
7169,0,7169,[ 64 483 313 318 187],618,5,29321,4.089400278940028,80.0,20.0
7170,0,7170,[475 322 748 202 302],417,3,29324,4.089248361455864,0.0,0.0
7171,0,7171,[ 64 483 313 318 187],618,5,29329,4.089375348577803,80.0,20.0
7172,0,7172,[328 143 215  69 748],416,5,29334,4.089502300292764,0.0,0.0
7173,0,7173,[ 64 483 313 318 187],214,5,29339,4.089629216615556,80.0,20.0
7174,0,7174,[ 64 483 313 318 187],214,5,29344,4.089756097560976,80.0,20.0
7175,0,7175,[121 655 216 318 161],618,4,29348,4.089743589743589,20.0,0.0
7176,0,7176,[ 69 132 194 183 202],405,3,29351,4.089591751428173,0.0,0.0
7177,0,7177,[202 172 211 655  56],437,5,29356,4.089718584563945,0.0,0.0
7178,0,7178,[ 64 483 313 318 187],618,5,29361,4.089845382365232,80.0,20.0
7179,0,7179,[ 64 483 313 318 187],214,5,29366,4.089972144846796,80.0,20.0
7180,0,7180,[215  11 423 196 143],416,5,29371,4.090098872023395,0.0,0.0
7181,0,7181,[ 64 483 313 318 187],214,5,29376,4.090225563909774,80.0,20.0
7182,0,7182,[ 64 483 313 318 187],214,5,29381,4.090352220520674,80.0,20.0
7183,0,7183,[ 64 483 313 318 187],214,5,29386,4.090478841870824,80.0,20.0
7184,0,7184,[ 64 483 313 318 187],618,5,29391,4.090605427974948,80.0,20.0
7185,0,7185,[ 56  82   4 238 117],805,2,29393,4.090314500417478,0.0,0.0
7186,0,7186,[ 28 323 301  50 121],416,4,29397,4.090301934047586,0.0,20.0
7187,0,7187,[ 64 483 313 318 187],214,5,29402,4.090428491930996,80.0,20.0
7188,0,7188,[273 195  50  56 125],62,5,29407,4.0905550146056475,0.0,20.0
7189,0,7189,[153 195  95 597 197],805,2,29409,4.090264255910988,0.0,0.0
7190,0,7190,[ 64 483 313 318 187],214,5,29414,4.090390766235572,80.0,20.0
7191,0,7191,[282 294 313 333 182],907,5,29419,4.0905172413793105,20.0,20.0
7192,0,7192,[269 427 216 286 603],416,5,29424,4.090643681356875,0.0,0.0
7193,0,7193,[ 64 483 313 318 187],214,5,29429,4.09077008618293,80.0,20.0
7194,0,7194,[ 64 483 313 318 187],618,5,29434,4.090896455872134,80.0,20.0
7195,0,7195,[202 276  89 143 282],764,4,29438,4.090883824346859,0.0,0.0
7196,0,7196,[143 216 403 222  25],711,4,29442,4.090871196331805,0.0,0.0
7197,0,7197,[ 28 216 118 173 257],654,4,29446,4.090858571825507,0.0,0.0
7198,0,7198,[161 228 195 191 288],417,2,29448,4.09056813446312,0.0,20.0
7199,0,7199,[ 64 483 313 318 187],214,5,29453,4.090694444444445,80.0,20.0
7200,0,7200,[210 173 235  95 135],297,3,29456,4.090542980141647,0.0,0.0
7201,0,7201,[ 95  69 257 546  15],314,5,29461,4.090669258539295,0.0,0.0
7202,0,7202,[471  28 748 132 215],416,5,29466,4.0907955018742195,0.0,0.0
7203,0,7203,[ 64 483 313 318 187],618,5,29471,4.090921710161021,80.0,20.0
7204,0,7204,[ 69 117 182  98 161],505,2,29473,4.090631505898681,0.0,20.0
7205,0,7205,[588   1 289  82 222],588,3,29476,4.090480155426034,0.0,0.0
7206,0,7206,[268 196 405 678  50],416,4,29480,4.090467600943527,0.0,20.0
7207,0,7207,[ 28 471 318 294 222],588,4,29484,4.090455049944506,20.0,0.0
7208,0,7208,[ 64 483 313 318 187],214,5,29489,4.0905812179220415,80.0,20.0
7209,0,7209,[ 64 483 313 318 187],618,5,29494,4.090707350901526,80.0,20.0
7210,0,7210,[568 742 100 183 427],416,5,29499,4.090833448897517,0.0,0.0
7211,0,7211,[ 64 483 313 318 187],618,5,29504,4.09095951192457,80.0,20.0
7212,0,7212,[ 64 483 313 318 187],618,5,29509,4.091085539997227,80.0,20.0
7213,0,7213,[ 64 483 313 318 187],618,5,29514,4.091211533130025,80.0,20.0
7214,0,7214,[ 64 483 313 318 187],214,5,29519,4.091337491337491,80.0,20.0
7215,0,7215,[288 508 273 215  98],62,3,29522,4.091186252771618,0.0,40.0
7216,0,7216,[ 64 483 313 318 187],214,5,29527,4.0913121795760015,80.0,20.0
7217,0,7217,[ 64 483 313 318 187],214,5,29532,4.091438071487946,80.0,20.0
7218,0,7218,[174  28 111 202 210],43,5,29537,4.091563928521956,0.0,0.0
7219,0,7219,[168 328  70 216   8],43,5,29542,4.091689750692521,0.0,0.0
7220,0,7220,[ 64 483 313 318 187],618,5,29547,4.091815538014125,80.0,20.0
7221,0,7221,[196  98 748  25 143],751,4,29551,4.091802824702299,0.0,20.0
7222,0,7222,[ 64 483 313 318 187],618,5,29556,4.091928561539526,80.0,20.0
7223,0,7223,[301  64   1 211 216],416,5,29561,4.092054263565892,20.0,0.0
7224,0,7224,[ 98 202  56 117 258],588,3,29564,4.091903114186851,0.0,20.0
7225,0,7225,[ 64 483 313 318 187],214,5,29569,4.092028784943261,80.0,20.0
7226,0,7226,[ 64 483 313 318 187],618,5,29574,4.092154420921545,80.0,20.0
7227,0,7227,[ 64 483 313 318 187],214,5,29579,4.092280022136137,80.0,20.0
7228,0,7228,[ 64 483 313 318 187],214,5,29584,4.0924055886014665,80.0,20.0
7229,0,7229,[196 121 125 191  69],417,3,29587,4.092254495159059,0.0,0.0
7230,0,7230,[403  89  12 323 132],417,4,29591,4.092241736965842,20.0,0.0
7231,0,7231,[508 151  97 174 204],62,3,29594,4.092090707964601,0.0,0.0
7232,0,7232,[  4 204 258 301 385],49,0,29594,4.091524955067054,0.0,0.0
7233,0,7233,[257  96 237 282 174],854,0,29594,4.090959358584462,0.0,0.0
7234,0,7234,[300 289 153 191 204],43,5,29599,4.091085003455425,0.0,0.0
7235,0,7235,[ 64 483 313 318 187],214,5,29604,4.091210613598673,80.0,20.0
7236,0,7236,[ 64 483 313 318 187],618,5,29609,4.091336189028603,80.0,20.0
7237,0,7237,[496  12 181  71 597],43,4,29613,4.091323570046974,20.0,20.0
7238,0,7238,[ 64  95 181 153 174],198,4,29617,4.091310954551734,20.0,20.0
7239,0,7239,[ 64 483 313 318 187],214,5,29622,4.091436464088398,80.0,20.0
7240,0,7240,[ 95 174  12  79  22],416,4,29626,4.0914238364866735,20.0,0.0
7241,0,7241,[238 318 185 215 268],416,5,29631,4.091549295774648,20.0,0.0
7242,0,7242,[117 678 288  71  50],416,4,29635,4.091536656081734,0.0,40.0
7243,0,7243,[ 64 483 313 318 187],214,5,29640,4.091662065157371,80.0,20.0
7244,0,7244,[ 64 483 313 318 187],214,5,29645,4.091787439613527,80.0,20.0
7245,0,7245,[ 64 483 313 318 187],214,5,29650,4.091912779464532,80.0,20.0
7246,0,7246,[748 275 200  69 286],437,3,29653,4.091762108458672,0.0,0.0
7247,0,7247,[245 655 323 161 333],345,1,29654,4.091335540838852,0.0,0.0
7248,0,7248,[ 64 483 313 318 187],618,5,29659,4.091460891157401,80.0,20.0
7249,0,7249,[ 98 135 655  12 215],618,5,29664,4.091586206896552,20.0,20.0
7250,0,7250,[655 195  98 186 427],405,5,29669,4.091711488070611,0.0,20.0
7251,0,7251,[ 79 216   4 294  56],417,2,29671,4.09142305570877,0.0,0.0
7252,0,7252,[ 64 483 313 318 187],214,5,29676,4.091548324831105,80.0,20.0
7253,0,7253,[294 323 588 405 179],417,2,29678,4.091259994485801,0.0,0.0
7254,0,7254,[210 300  98  25 151],128,3,29681,4.091109579600276,0.0,20.0
7255,0,7255,[ 64 483 313 318 187],618,5,29686,4.091234840132304,80.0,20.0
7256,0,7256,[185   7 300 204 748],416,5,29691,4.091360066143034,0.0,0.0
7257,0,7257,[ 64 483 313 318 187],618,5,29696,4.091485257646735,80.0,20.0
7258,0,7258,[508 357 228 196 471],297,3,29699,4.091334894613583,0.0,0.0
7259,0,7259,[ 64 483 313 318 187],214,5,29704,4.091460055096419,80.0,20.0
7260,0,7260,[271 196 222 237 153],297,4,29708,4.091447459027682,0.0,0.0
7261,0,7261,[ 64 483 313 318 187],618,5,29713,4.091572569540071,80.0,20.0
7262,0,7262,[202 216  15 405 235],416,4,29717,4.0915599614484375,0.0,0.0
7263,0,7263,[ 64 483 313 318 187],618,5,29722,4.091685022026431,80.0,20.0
7264,0,7264,[ 64 483 313 318 187],618,5,29727,4.091810048176187,80.0,20.0
7265,0,7265,[ 25 318 237 294 176],24,4,29731,4.091797412606661,20.0,0.0
7266,0,7266,[234 117 423  56 182],230,3,29734,4.0916471721480665,0.0,0.0
7267,0,7267,[ 64 483 313 318 187],618,5,29739,4.091772151898734,80.0,20.0
7268,0,7268,[204 135 427 302 200],405,4,29743,4.091759526757463,0.0,0.0
7269,0,7269,[597  79  69 323  95],416,2,29745,4.091471801925723,0.0,0.0
7270,0,7270,[ 64 483 313 318 187],214,5,29750,4.09159675422913,80.0,20.0
7271,0,7271,[ 64 483 313 318 187],618,5,29755,4.091721672167217,80.0,20.0
7272,0,7272,[121 168 204 435 180],437,2,29757,4.091434071222329,0.0,0.0
7273,0,7273,[ 64 483 313 318 187],214,5,29762,4.091558977178994,80.0,20.0
7274,0,7274,[132   7 151  15 403],417,4,29766,4.091546391752577,0.0,0.0
7275,0,7275,[ 64 483 313 318 187],214,5,29771,4.091671247938428,80.0,20.0
7276,0,7276,[294 301 211 196 168],43,5,29776,4.0917960698089875,0.0,0.0
7277,0,7277,[ 88 655  98 202 210],354,0,29776,4.091233855454795,0.0,20.0
7278,0,7278,[ 64 483 313 318 187],618,5,29781,4.09135870311856,80.0,20.0
7279,0,7279,[  7  88 200   8 742],805,2,29783,4.0910714285714285,0.0,0.0
7280,0,7280,[ 64 483 313 318 187],214,5,29788,4.091196264249416,80.0,20.0
7281,0,7281,[  4  25  11  97 211],416,5,29793,4.091321065641307,0.0,0.0
7282,0,7282,[151 173 210  95 265],588,5,29798,4.091445832761225,0.0,0.0
7283,0,7283,[181 168   7   9 191],618,4,29802,4.091433278418451,0.0,20.0
7284,0,7284,[ 97 288 385 597 265],654,3,29805,4.091283459162663,0.0,20.0
7285,0,7285,[197 117 143 153 301],751,4,29809,4.091270930551743,0.0,0.0
7286,0,7286,[ 64 483 313 318 187],618,5,29814,4.091395636064224,80.0,20.0
7287,0,7287,[ 64 483 313 318 187],618,5,29819,4.091520307354555,80.0,20.0
7288,0,7288,[333   4 275 403  82],416,5,29824,4.091644944436823,0.0,0.0
7289,0,7289,[ 64 483 313 318 187],214,5,29829,4.091769547325103,80.0,20.0
7290,0,7290,[176  89 475 174 185],297,5,29834,4.091894116033466,0.0,0.0
7291,0,7291,[265 181  79 118 258],270,3,29837,4.09174437739989,0.0,20.0
7292,0,7292,[ 64 483 313 318 187],618,5,29842,4.091868915398327,80.0,20.0
7293,0,7293,[182  28 268 655 200],416,5,29847,4.0919934192486975,0.0,0.0
7294,0,7294,[135 117 427 288 187],618,4,29851,4.091980808773132,0.0,20.0
7295,0,7295,[ 64 483 313 318 187],214,5,29856,4.092105263157895,80.0,20.0
7296,0,7296,[289 275 318 202 588],764,5,29861,4.0922296834315475,20.0,0.0
7297,0,7297,[ 88   1  22 288  28],805,1,29862,4.091805974239517,0.0,20.0
7298,0,7298,[172 100 185 200 182],417,2,29864,4.09151938621729,0.0,0.0
7299,0,7299,[ 64 483 313 318 187],618,5,29869,4.091643835616439,80.0,20.0
7300,0,7300,[257 423 655  82 546],416,3,29872,4.091494315847144,0.0,0.0
7301,0,7301,[238  12 269 161  56],416,5,29877,4.091618734593262,20.0,0.0
7302,0,7302,[ 95 237 185 186 121],230,5,29882,4.091743119266055,0.0,0.0
7303,0,7303,[ 64 483 313 318 187],618,5,29887,4.091867469879518,80.0,20.0
7304,0,7304,[ 64 483 313 318 187],618,5,29892,4.091991786447639,80.0,20.0
7305,0,7305,[313 328  71 323 258],416,4,29896,4.091979195182042,20.0,20.0
7306,0,7306,[ 64 483 313 318 187],214,5,29901,4.0921034624332835,80.0,20.0
7307,0,7307,[228 257 100 288 135],62,2,29903,4.091817186644773,0.0,20.0
7308,0,7308,[294 215  28 475 328],416,4,29907,4.091804624435627,0.0,0.0
7309,0,7309,[118 322 515 173 237],416,2,29909,4.091518467852257,0.0,0.0
7310,0,7310,[ 64 483 313 318 187],214,5,29914,4.091642730132677,80.0,20.0
7311,0,7311,[294 273 204 100  89],297,3,29917,4.0914934354485775,0.0,0.0
7312,0,7312,[276 211 294 323 588],416,3,29920,4.091344181594421,0.0,0.0
7313,0,7313,[121  28 275 423 196],62,3,29923,4.091194968553459,0.0,0.0
7314,0,7314,[ 64 483 313 318 187],214,5,29928,4.091319207108681,80.0,20.0
7315,0,7315,[ 64 483 313 318 187],214,5,29933,4.091443411700383,80.0,20.0
7316,0,7316,[ 64 483 313 318 187],618,5,29938,4.09156758234249,80.0,20.0
7317,0,7317,[185  69 181 357 144],417,1,29939,4.091145121617928,0.0,20.0
7318,0,7318,[ 15 100  64 191  71],373,4,29943,4.091132668397322,20.0,0.0
7319,0,7319,[ 64 483 313 318 187],214,5,29948,4.091256830601093,80.0,20.0
7320,0,7320,[ 64 483 313 318 187],618,5,29953,4.091380958885398,80.0,20.0
7321,0,7321,[234 180   7 237  11],198,2,29955,4.091095329145042,0.0,0.0
7322,0,7322,[ 64 483 313 318 187],214,5,29960,4.091219445582412,80.0,20.0
7323,0,7323,[405  70 423 173 294],416,5,29965,4.091343528126707,0.0,0.0
7324,0,7324,[191 568 127  97  70],198,2,29967,4.091058020477815,0.0,0.0
7325,0,7325,[ 64 483 313 318 187],618,5,29972,4.091182091182091,80.0,20.0
7326,0,7326,[ 64 483 313 318 187],214,5,29977,4.091306128019653,80.0,20.0
7327,0,7327,[ 64 483 313 318 187],618,5,29982,4.091430131004367,80.0,20.0
7328,0,7328,[496 121  64 268 182],214,4,29986,4.09141765588757,20.0,0.0
7329,0,7329,[ 64 483 313 318 187],214,5,29991,4.091541609822647,80.0,20.0
7330,0,7330,[ 82  28 427 508 471],128,5,29996,4.091665529941345,0.0,0.0
7331,0,7331,[ 64 483 313 318 187],618,5,30001,4.091789416257502,80.0,20.0
7332,0,7332,[403 655 286 546  70],417,4,30005,4.091776898949952,0.0,0.0
7333,0,7333,[  9 197 385   4  25],416,5,30010,4.0919007362967,0.0,0.0
7334,0,7334,[ 64 483 313 318 187],214,5,30015,4.0920245398773005,80.0,20.0
7335,0,7335,[ 64 483 313 318 187],214,5,30020,4.0921483097055615,80.0,20.0
7336,0,7336,[ 71 423 173  82  97],712,4,30024,4.092135750306665,0.0,0.0
7337,0,7337,[ 64 483 313 318 187],214,5,30029,4.092259471245571,80.0,20.0
7338,0,7338,[286 153 187 385 216],416,5,30034,4.092383158468456,0.0,0.0
7339,0,7339,[568  88  98  22 200],416,4,30038,4.092370572207084,0.0,20.0
7340,0,7340,[ 64 483 313 318 187],618,5,30043,4.092494210598011,80.0,20.0
7341,0,7341,[ 64 483 313 318 187],618,5,30048,4.09261781530918,80.0,20.0
7342,0,7342,[ 64 483 313 318 187],618,5,30053,4.092741386354351,80.0,20.0
7343,0,7343,[286 185  89 318 111],711,4,30057,4.092728758169935,20.0,0.0
7344,0,7344,[ 64 483 313 318 187],214,5,30062,4.0928522804629,80.0,20.0
7345,0,7345,[ 64 483 313 318 187],214,5,30067,4.092975769126055,80.0,20.0
7346,0,7346,[111 435 271 273  11],297,2,30069,4.092690894242548,0.0,0.0
7347,0,7347,[ 64 483 313 318 187],618,5,30074,4.092814371257485,80.0,20.0
7348,0,7348,[ 64 483 313 318 187],214,5,30079,4.092937814668662,80.0,20.0
7349,0,7349,[ 64 483 313 318 187],214,5,30084,4.093061224489796,80.0,20.0
7350,0,7350,[111 183 597  96 245],417,2,30086,4.09277649299415,0.0,0.0
7351,0,7351,[ 64 483 313 318 187],618,5,30091,4.092899891186072,80.0,20.0
7352,0,7352,[ 11 269 275 121 258],43,5,30096,4.093023255813954,0.0,0.0
7353,0,7353,[318 475 117 258 294],24,4,30100,4.093010606472668,20.0,0.0
7354,0,7354,[ 64 483 313 318 187],618,5,30105,4.0931339225017,80.0,20.0
7355,0,7355,[ 64  22  96 179 173],405,3,30108,4.092985318107667,20.0,0.0
7356,0,7356,[ 64 483 313 318 187],214,5,30113,4.093108604050564,80.0,20.0
7357,0,7357,[196 111 294  56 194],342,1,30114,4.0926882304974175,0.0,0.0
7358,0,7358,[ 64 483 313 318 187],618,5,30119,4.092811523304797,80.0,20.0
7359,0,7359,[118 475 222  25 678],588,1,30120,4.092391304347826,0.0,0.0
7360,0,7360,[258 179 228 175 185],805,3,30123,4.09224290177965,0.0,0.0
7361,0,7361,[ 64 483 313 318 187],618,5,30128,4.092366204835643,80.0,20.0
7362,0,7362,[328 257 275 258 210],43,5,30133,4.092489474399022,0.0,0.0
7363,0,7363,[ 64 483 313 318 187],618,5,30138,4.092612710483433,80.0,20.0
7364,0,7364,[ 64 483 313 318 187],214,5,30143,4.092735913102512,80.0,20.0
7365,0,7365,[385 276  98   7  11],43,5,30148,4.0928590822698885,0.0,20.0
7366,0,7366,[ 64 483 313 318 187],618,5,30153,4.092982217999186,80.0,20.0
7367,0,7367,[496 132 475 222   8],711,4,30157,4.092969598262758,0.0,0.0
7368,0,7368,[ 64 483 313 318 187],214,5,30162,4.093092685574705,80.0,20.0
7369,0,7369,[ 64 483 313 318 187],618,5,30167,4.093215739484396,80.0,20.0
7370,0,7370,[ 64 483 313 318 187],214,5,30172,4.093338760005427,80.0,20.0
7371,0,7371,[275 282 176 173 597],416,4,30176,4.093326098752034,0.0,0.0
7372,0,7372,[185 168 204 568  64],618,4,30180,4.093313440933135,20.0,0.0
7373,0,7373,[328 125 273 282 117],253,3,30183,4.093165174938974,0.0,0.0
7374,0,7374,[118 273 151 271 357],854,4,30187,4.093152542372882,0.0,0.0
7375,0,7375,[471 118 181  95 183],705,4,30191,4.093139913232104,0.0,20.0
7376,0,7376,[ 97 678  82 234 333],416,4,30195,4.09312728751525,0.0,0.0
7377,0,7377,[ 64 483 313 318 187],214,5,30200,4.09325020330713,80.0,20.0
7378,0,7378,[ 64 483 313 318 187],618,5,30205,4.093373085783981,80.0,20.0
7379,0,7379,[ 56 237 182 588 234],437,3,30208,4.093224932249322,0.0,0.0
7380,0,7380,[ 96 187  56 603 282],416,5,30213,4.093347784853001,0.0,0.0
7381,0,7381,[168 258 245 204 216],297,3,30216,4.093199674884855,0.0,0.0
7382,0,7382,[ 64 483 313 318 187],618,5,30221,4.09332249762969,80.0,20.0
7383,0,7383,[597 322 318 210 161],416,3,30224,4.0931744312026,20.0,0.0
7384,0,7384,[ 64 483 313 318 187],214,5,30229,4.093297224102911,80.0,20.0
7385,0,7385,[ 64 483 313 318 187],618,5,30234,4.093419983753046,80.0,20.0
7386,0,7386,[423  79 182 204 496],618,4,30238,4.093407337214025,0.0,0.0
7387,0,7387,[121 275  97 234  28],437,2,30240,4.093123984840282,0.0,0.0
7388,0,7388,[ 64 483 313 318 187],214,5,30245,4.0932467180944645,80.0,20.0
7389,0,7389,[195  25   4 294 132],854,1,30246,4.092828146143437,0.0,0.0
7390,0,7390,[257 265 385  64 168],417,3,30249,4.09268028683534,20.0,0.0
7391,0,7391,[333 202 144  25 257],416,4,30253,4.092667748917749,0.0,0.0
7392,0,7392,[ 4 25 56 95 28],764,3,30256,4.092519951305289,0.0,0.0
7393,0,7393,[  8 237 216 196 153],721,4,30260,4.0925074384636195,0.0,0.0
7394,0,7394,[ 96 427 216 153 168],253,3,30263,4.092359702501691,0.0,0.0
7395,0,7395,[211 655 258 111 204],416,5,30268,4.092482422931314,0.0,0.0
7396,0,7396,[185  64 508 588 597],417,1,30269,4.092064350412329,20.0,0.0
7397,0,7397,[ 64 483 313 318 187],618,5,30274,4.092187077588537,80.0,20.0
7398,0,7398,[ 64 483 313 318 187],214,5,30279,4.092309771590756,80.0,20.0
7399,0,7399,[161   7 427 117 196],198,2,30281,4.092027027027027,0.0,0.0
7400,0,7400,[ 64 483 313 318 187],618,5,30286,4.092149709498717,80.0,20.0
7401,0,7401,[ 88  22 186 238 187],618,4,30290,4.092137260199946,0.0,0.0
7402,0,7402,[ 64 483 313 318 187],214,5,30295,4.092259894637309,80.0,20.0
7403,0,7403,[125 385 286  88 132],416,4,30299,4.092247433819557,0.0,0.0
7404,0,7404,[197  69 204 294  11],416,5,30304,4.092370020256584,0.0,0.0
7405,0,7405,[ 64 483 313 318 187],618,5,30309,4.092492573588982,80.0,20.0
7406,0,7406,[ 12 168  22 222 179],601,4,30313,4.092480086404752,20.0,0.0
7407,0,7407,[197  70 121  28 588],437,1,30314,4.092062634989201,0.0,0.0
7408,0,7408,[ 64 483 313 318 187],618,5,30319,4.09218518018626,80.0,20.0
7409,0,7409,[ 64 483 313 318 187],214,5,30324,4.092307692307692,80.0,20.0
7410,0,7410,[ 79 185 168 172 238],416,5,30329,4.092430171366887,0.0,0.0
7411,0,7411,[  4 211  22 151 202],416,4,30333,4.092417701025364,0.0,0.0
7412,0,7412,[ 64 483 313 318 187],214,5,30338,4.092540132200189,80.0,20.0
7413,0,7413,[100  25 125   8 286],342,3,30341,4.092392770434313,0.0,0.0
7414,0,7414,[195   7 176  15 318],416,5,30346,4.092515171948753,20.0,0.0
7415,0,7415,[748   1  82  69 288],416,5,30351,4.092637540453074,0.0,20.0
7416,0,7416,[268 245 496 258 742],907,5,30356,4.092759875960631,0.0,0.0
7417,0,7417,[ 70 235  79 471 268],297,2,30358,4.092477756807765,0.0,0.0
7418,0,7418,[ 64 483 313 318 187],618,5,30363,4.092600080873433,80.0,20.0
7419,0,7419,[ 64 483 313 318 187],214,5,30368,4.092722371967655,80.0,20.0
7420,0,7420,[143 168 174 173  71],601,3,30371,4.092575124646274,0.0,0.0
7421,0,7421,[ 64 483 313 318 187],214,5,30376,4.092697386149286,80.0,20.0
7422,0,7422,[ 64 483 313 318 187],214,5,30381,4.092819614711034,80.0,20.0
7423,0,7423,[238  79  28 211 168],373,4,30385,4.092807112068965,0.0,0.0
7424,0,7424,[318 269 245 111 323],345,3,30388,4.092659932659933,20.0,0.0
7425,0,7425,[ 64 483 313 318 187],618,5,30393,4.092782116886615,80.0,20.0
7426,0,7426,[269 143 181 144 195],416,5,30398,4.092904268210583,0.0,20.0
7427,0,7427,[ 12 161 143  15 234],437,4,30402,4.092891760904685,20.0,0.0
7428,0,7428,[ 64 483 313 318 187],214,5,30407,4.093013864584735,80.0,20.0
7429,0,7429,[245 294 194 257  50],297,1,30408,4.092597577388964,0.0,20.0
7430,0,7430,[597 405 475 357 210],417,2,30410,4.092315973624007,0.0,0.0
7431,0,7431,[ 64 483 313 318 187],618,5,30415,4.092438105489774,80.0,20.0
7432,0,7432,[ 64 483 313 318 187],618,5,30420,4.092560204493475,80.0,20.0
7433,0,7433,[ 64 483 313 318 187],214,5,30425,4.092682270648372,80.0,20.0
7434,0,7434,[ 64 483 313 318 187],618,5,30430,4.09280430396772,80.0,20.0
7435,0,7435,[588 195 216 568 121],230,3,30433,4.0926573426573425,0.0,0.0
7436,0,7436,[100 168   9  69 211],43,5,30438,4.09277934651069,0.0,0.0
7437,0,7437,[ 64 483 313 318 187],618,5,30443,4.092901317558484,80.0,20.0
7438,0,7438,[ 71 181 100   7 117],49,2,30445,4.092619975803199,0.0,20.0
7439,0,7439,[ 64 483 313 318 187],214,5,30450,4.092741935483871,80.0,20.0
7440,0,7440,[ 25 118 238 173   1],805,4,30454,4.092729471845182,0.0,0.0
7441,0,7441,[ 64 483 313 318 187],618,5,30459,4.09285138403655,80.0,20.0
7442,0,7442,[174 588 275 328 127],43,5,30464,4.092973263469031,0.0,0.0
7443,0,7443,[ 64 483 313 318 187],618,5,30469,4.09309511015583,80.0,20.0
7444,0,7444,[185 182 423  71 153],230,4,30473,4.093082605775688,0.0,0.0
7445,0,7445,[ 64 483 313 318 187],214,5,30478,4.093204405049691,80.0,20.0
7446,0,7446,[ 64 483 313 318 187],618,5,30483,4.09332617161273,80.0,20.0
7447,0,7447,[268 597 153 195  70],654,4,30487,4.093313641245972,0.0,0.0
7448,0,7448,[ 64 483 313 318 187],618,5,30492,4.093435360451068,80.0,20.0
7449,0,7449,[ 64 483 313 318 187],618,5,30497,4.093557046979866,80.0,20.0
7450,0,7450,[475 245 222   7 257],417,2,30499,4.093276070326131,0.0,0.0
7451,0,7451,[ 64 483 313 318 187],618,5,30504,4.093397745571659,80.0,20.0
7452,0,7452,[ 64 483 313 318 187],618,5,30509,4.09351938816584,80.0,20.0
7453,0,7453,[ 64 483 313 318 187],214,5,30514,4.093640998121813,80.0,20.0
7454,0,7454,[187  71 423  95 182],198,2,30516,4.093360160965795,0.0,0.0
7455,0,7455,[ 64 483 313 318 187],618,5,30521,4.093481759656652,80.0,20.0
7456,0,7456,[ 64 483 313 318 187],214,5,30526,4.093603325734209,80.0,20.0
7457,0,7457,[216 742 127 117 271],62,3,30529,4.0934566908018235,0.0,0.0
7458,0,7458,[323 403   9 172 300],416,4,30533,4.093444161415739,0.0,0.0
7459,0,7459,[174 135   1 471 276],618,3,30536,4.093297587131367,0.0,0.0
7460,0,7460,[ 64 483 313 318 187],214,5,30541,4.093419112719475,80.0,20.0
7461,0,7461,[302 174 597 118 196],654,4,30545,4.093406593406593,0.0,0.0
7462,0,7462,[ 64 483 313 318 187],214,5,30550,4.093528071820984,80.0,20.0
7463,0,7463,[202 196 234  25 143],345,3,30553,4.093381564844587,0.0,0.0
7464,0,7464,[215 135 187 168 403],198,5,30558,4.093503014065639,0.0,0.0
7465,0,7465,[471 196 183 237 200],416,4,30562,4.093490490222341,0.0,0.0
7466,0,7466,[405  50 678 323 185],416,3,30565,4.093344047140753,0.0,20.0
7467,0,7467,[ 64 483 313 318 187],618,5,30570,4.0934654525977505,80.0,20.0
7468,0,7468,[ 64 483 313 318 187],618,5,30575,4.0935868255455885,80.0,20.0
7469,0,7469,[127 118 228  95 176],805,1,30576,4.093172690763052,0.0,0.0
7470,0,7470,[ 64 483 313 318 187],618,5,30581,4.093294070405568,80.0,20.0
7471,0,7471,[  1 117 655 405  28],345,3,30584,4.093147751605995,0.0,0.0
7472,0,7472,[144 234 222 174 288],297,2,30586,4.092867656898167,0.0,20.0
7473,0,7473,[ 64 483 313 318 187],618,5,30591,4.092989028632593,80.0,20.0
7474,0,7474,[ 95 568 200 275 185],618,3,30594,4.092842809364549,0.0,0.0
7475,0,7475,[ 64 483 313 318 187],214,5,30599,4.092964151952916,80.0,20.0
7476,0,7476,[ 64 483 313 318 187],618,5,30604,4.093085462083724,80.0,20.0
7477,0,7477,[405 161 125 496   7],417,1,30605,4.092671837389676,0.0,0.0
7478,0,7478,[ 64 483 313 318 187],618,5,30610,4.092793154164995,80.0,20.0
7479,0,7479,[748   1 273 546 238],416,4,30614,4.092780748663102,0.0,0.0
7480,0,7480,[ 64 483 313 318 187],618,5,30619,4.092902018446732,80.0,20.0
7481,0,7481,[ 64 483 313 318 187],214,5,30624,4.093023255813954,80.0,20.0
7482,0,7482,[216  56  22 423  97],642,3,30627,4.092877188293465,0.0,0.0
7483,0,7483,[ 64 483 313 318 187],618,5,30632,4.092998396579369,80.0,20.0
7484,0,7484,[211 196  69 117 111],416,5,30637,4.09311957247829,0.0,0.0
7485,0,7485,[  8  25 200 183 286],297,4,30641,4.093107133315522,0.0,0.0
7486,0,7486,[ 64 483 313 318 187],618,5,30646,4.093228262321357,80.0,20.0
7487,0,7487,[ 64 483 313 318 187],214,5,30651,4.093349358974359,80.0,20.0
7488,0,7488,[ 64 483 313 318 187],618,5,30656,4.093470423287489,80.0,20.0
7489,0,7489,[172 238  50 603 588],416,5,30661,4.093591455273698,0.0,20.0
7490,0,7490,[ 97 111 603  12 196],416,5,30666,4.093712454945935,20.0,0.0
7491,0,7491,[ 12  22 742  96 294],805,2,30668,4.093432995194875,20.0,0.0
7492,0,7492,[294 121  71 405 211],230,5,30673,4.093553983718137,0.0,0.0
7493,0,7493,[187  12  95   8 588],618,3,30676,4.093408059781158,20.0,0.0
7494,0,7494,[ 64 483 313 318 187],214,5,30681,4.093529019346231,80.0,20.0
7495,0,7495,[196   4  98 191 210],805,2,30683,4.093249733191035,0.0,20.0
7496,0,7496,[ 69 568 135 210 132],618,4,30687,4.093237294917968,0.0,0.0
7497,0,7497,[210 144 216  69 204],373,4,30691,4.093224859962657,0.0,0.0
7498,0,7498,[ 64 483 313 318 187],214,5,30696,4.093345779437258,80.0,20.0
7499,0,7499,[ 64 483 313 318 187],214,5,30701,4.093466666666667,80.0,20.0
7500,0,7500,[ 64 483 313 318 187],618,5,30706,4.093587521663778,80.0,20.0
7501,0,7501,[257 161 323 183 186],417,2,30708,4.093308451079712,0.0,0.0
7502,0,7502,[ 64 483 313 318 187],214,5,30713,4.093429294948687,80.0,20.0
7503,0,7503,[202 194  70 286 282],416,5,30718,4.093550106609808,0.0,0.0
7504,0,7504,[228 168 237 179 403],198,3,30721,4.093404397068621,0.0,0.0
7505,0,7505,[ 64 483 313 318 187],214,5,30726,4.093525179856115,80.0,20.0
7506,0,7506,[ 64 483 313 318 187],214,5,30731,4.093645930464899,80.0,20.0
7507,0,7507,[ 82   8 568 748   1],805,1,30732,4.093233883857219,0.0,0.0
7508,0,7508,[328  25 117 180 603],373,4,30736,4.0932214675722465,0.0,0.0
7509,0,7509,[ 64 483 313 318 187],214,5,30741,4.093342210386152,80.0,20.0
7510,0,7510,[ 64 483 313 318 187],618,5,30746,4.093462921049128,80.0,20.0
7511,0,7511,[183 127  96 245 748],416,4,30750,4.093450479233227,0.0,0.0
7512,0,7512,[172 276  96 228 210],230,3,30753,4.093304938107281,0.0,0.0
7513,0,7513,[181 151  70 210  98],198,4,30757,4.093292520628161,0.0,40.0
7514,0,7514,[ 64 483 313 318 187],214,5,30762,4.093413173652695,80.0,20.0
7515,0,7515,[135   4  98 202 427],618,3,30765,4.093267695582757,0.0,20.0
7516,0,7516,[238 179 257 117  25],416,3,30768,4.093122256219236,0.0,0.0
7517,0,7517,[  1 286 568 323  11],43,4,30772,4.093109869646183,0.0,0.0
7518,0,7518,[ 64 483 313 318 187],618,5,30777,4.093230482776965,80.0,20.0
7519,0,7519,[121 210 118 151  50],654,4,30781,4.093218085106383,0.0,20.0
7520,0,7520,[  7 182 475 271 215],297,2,30783,4.092939768647787,0.0,0.0
7521,0,7521,[ 64 483 313 318 187],618,5,30788,4.0930603562882215,80.0,20.0
7522,0,7522,[ 64 483 313 318 187],214,5,30793,4.093180911870265,80.0,20.0
7523,0,7523,[ 64 483 313 318 187],214,5,30798,4.0933014354066986,80.0,20.0
7524,0,7524,[186 216 172  64 288],642,3,30801,4.093156146179402,20.0,20.0
7525,0,7525,[ 64 483 313 318 187],618,5,30806,4.093276640977943,80.0,20.0
7526,0,7526,[471  88 603   1  96],416,4,30810,4.0932642487046635,0.0,0.0
7527,0,7527,[423  15  88  50  69],43,5,30815,4.093384697130712,0.0,20.0
7528,0,7528,[ 64 483 313 318 187],214,5,30820,4.093505113560898,80.0,20.0
7529,0,7529,[200 118  98 216 385],417,4,30824,4.093492695883134,0.0,20.0
7530,0,7530,[ 64 483 313 318 187],214,5,30829,4.093613065993892,80.0,20.0
7531,0,7531,[ 64 483 313 318 187],214,5,30834,4.093733404142326,80.0,20.0
7532,0,7532,[ 64 483 313 318 187],214,5,30839,4.093853710341166,80.0,20.0
7533,0,7533,[135  70  15 286 179],373,2,30841,4.093575789753119,0.0,0.0
7534,0,7534,[ 64 483 313 318 187],618,5,30846,4.093696084936961,80.0,20.0
7535,0,7535,[ 64 483 313 318 187],618,5,30851,4.093816348195329,80.0,20.0
7536,0,7536,[ 64 483 313 318 187],618,5,30856,4.093936579540931,80.0,20.0
7537,0,7537,[ 70 144 237 238  22],62,2,30858,4.093658795436455,0.0,0.0
7538,0,7538,[121 258  82 405 174],642,3,30861,4.093513728611222,0.0,0.0
7539,0,7539,[ 64 483 313 318 187],618,5,30866,4.093633952254642,80.0,20.0
7540,0,7540,[ 64 483 313 318 187],618,5,30871,4.09375414401273,80.0,20.0
7541,0,7541,[ 64 483 313 318 187],618,5,30876,4.09387430389817,80.0,20.0
7542,0,7542,[ 25 496 588  28 168],654,4,30880,4.093861858676919,0.0,0.0
7543,0,7543,[568 237  11 276 181],654,3,30883,4.093716861081655,0.0,20.0
7544,0,7544,[202 328 173 151 269],43,5,30888,4.093836978131213,0.0,0.0
7545,0,7545,[ 97 143  50 151  15],373,3,30891,4.0936920222634505,0.0,20.0
7546,0,7546,[180 211  82 286  11],417,5,30896,4.093812110772492,0.0,0.0
7547,0,7547,[ 64 483 313 318 187],618,5,30901,4.093932167461579,80.0,20.0
7548,0,7548,[322 121 135 117  12],417,2,30903,4.093654788713737,20.0,0.0
7549,0,7549,[ 64 483 313 318 187],214,5,30908,4.093774834437086,80.0,20.0
7550,0,7550,[135 475 197 238  22],854,4,30912,4.093762415574096,0.0,0.0
7551,0,7551,[153 294 195   4  25],854,1,30913,4.093352754237288,0.0,0.0
7552,0,7552,[ 64 483 313 318 187],618,5,30918,4.093472792267973,80.0,20.0
7553,0,7553,[196 496  25 186 435],230,4,30922,4.093460418321419,0.0,0.0
7554,0,7554,[ 64 483 313 318 187],618,5,30927,4.0935804103242885,80.0,20.0
7555,0,7555,[194  56 588 275  22],416,5,30932,4.093700370566437,0.0,0.0
7556,0,7556,[597  12 234  95 475],805,3,30935,4.093555643773985,20.0,0.0
7557,0,7557,[168  88  11 132 143],496,1,30936,4.093146335009262,0.0,0.0
7558,0,7558,[269 423  11 196 294],805,1,30937,4.092737134541606,0.0,0.0
7559,0,7559,[300 118 168   7 286],297,3,30940,4.092592592592593,0.0,0.0
7560,0,7560,[  4 427  28 151 215],416,4,30944,4.092580346515011,0.0,0.0
7561,0,7561,[238 597 234 228 678],805,3,30947,4.092435863528167,0.0,0.0
7562,0,7562,[ 64 483 313 318 187],618,5,30952,4.092555864075102,80.0,20.0
7563,0,7563,[301   8 168  12 568],416,5,30957,4.09267583289265,20.0,0.0
7564,0,7564,[ 64 483 313 318 187],214,5,30962,4.092795769993391,80.0,20.0
7565,0,7565,[ 64 483 313 318 187],214,5,30967,4.092915675389902,80.0,20.0
7566,0,7566,[197 172  71  70  50],128,3,30970,4.092771243557553,0.0,20.0
7567,0,7567,[ 64 483 313 318 187],214,5,30975,4.0928911205073994,80.0,20.0
7568,0,7568,[ 64 483 313 318 187],214,5,30980,4.0930109657814775,80.0,20.0
7569,0,7569,[179  25  71 151 153],805,4,30984,4.092998678996037,0.0,0.0
7570,0,7570,[ 64 483 313 318 187],618,5,30989,4.093118478404438,80.0,20.0
7571,0,7571,[ 64 483 313 318 187],214,5,30994,4.093238246170101,80.0,20.0
7572,0,7572,[200 257  69  88 197],416,3,30997,4.093093886174567,0.0,0.0
7573,0,7573,[ 89 302 182  50 357],62,4,31001,4.093081594930024,0.0,20.0
7574,0,7574,[ 64 483 313 318 187],618,5,31006,4.093201320132013,80.0,20.0
7575,0,7575,[ 64 483 313 318 187],618,5,31011,4.093321013727561,80.0,20.0
7576,0,7576,[ 64 483 313 318 187],618,5,31016,4.09344067572918,80.0,20.0
7577,0,7577,[237 151 318  95  71],654,4,31020,4.0934283452098175,20.0,0.0
7578,0,7578,[ 64 483 313 318 187],618,5,31025,4.09354796147249,80.0,20.0
7579,0,7579,[423 234 301 194 210],416,5,31030,4.093667546174142,0.0,0.0
7580,0,7580,[151 186 181 144 174],373,4,31034,4.093655190608099,0.0,20.0
7581,0,7581,[176 197 204 200  50],618,3,31037,4.093510946979689,0.0,20.0
7582,0,7582,[265  82 168 257 678],416,3,31040,4.093366741395227,0.0,0.0
7583,0,7583,[ 64 483 313 318 187],618,5,31045,4.093486286919831,80.0,20.0
7584,0,7584,[ 64 483 313 318 187],214,5,31050,4.093605800922874,80.0,20.0
7585,0,7585,[ 64 483 313 318 187],618,5,31055,4.093725283416821,80.0,20.0
7586,0,7586,[ 64 483 313 318 187],214,5,31060,4.093844734414129,80.0,20.0
7587,0,7587,[153  50 216 186 301],43,4,31064,4.093832366895097,0.0,20.0
7588,0,7588,[ 64 483 313 318 187],618,5,31069,4.093951772302016,80.0,20.0
7589,0,7589,[ 64 483 313 318 187],214,5,31074,4.094071146245059,80.0,20.0
7590,0,7590,[196 179 475  70 603],437,3,31077,4.093927018838098,0.0,0.0
7591,0,7591,[269 176 294 268 151],297,3,31080,4.093782929399368,0.0,0.0
7592,0,7592,[ 64 483 313 318 187],618,5,31085,4.093902278414329,80.0,20.0
7593,0,7593,[ 64 483 313 318 187],618,5,31090,4.09402159599684,80.0,20.0
7594,0,7594,[ 64 483 313 318 187],214,5,31095,4.094140882159316,80.0,20.0
7595,0,7595,[222 175 191 603 185],297,4,31099,4.094128488678252,0.0,0.0
7596,0,7596,[568 125 132 197 257],416,4,31103,4.094116098459918,0.0,0.0
7597,0,7597,[288 127 173 111  50],417,2,31105,4.093840484337984,0.0,40.0
7598,0,7598,[ 64 483 313 318 187],618,5,31110,4.093959731543624,80.0,20.0
7599,0,7599,[216 180 121 228 179],417,2,31112,4.093684210526316,0.0,0.0
7600,0,7600,[183 546 215 176 187],416,4,31116,4.093671885278253,0.0,0.0
7601,0,7601,[210 135 211 144 496],437,3,31119,4.093528018942384,0.0,0.0
7602,0,7602,[273  98 204   1 168],618,4,31123,4.093515717479942,0.0,20.0
7603,0,7603,[ 64 174 202 273 132],416,5,31128,4.093634928984745,20.0,0.0
7604,0,7604,[176   4 302 597 117],62,3,31131,4.093491124260355,0.0,0.0
7605,0,7605,[483  12   4 100  89],342,4,31135,4.093478832500657,40.0,0.0
7606,0,7606,[ 64 483 313 318 187],618,5,31140,4.093598001840411,80.0,20.0
7607,0,7607,[403 423 202 161  95],711,4,31144,4.093585699263933,0.0,0.0
7608,0,7608,[275  95 176 153 211],416,4,31148,4.093573399921146,0.0,0.0
7609,0,7609,[127  28 385 273 118],618,4,31152,4.093561103810775,0.0,0.0
7610,0,7610,[ 64 483 313 318 187],214,5,31157,4.093680199710945,80.0,20.0
7611,0,7611,[ 64 483 313 318 187],214,5,31162,4.093799264319496,80.0,20.0
7612,0,7612,[ 64 483 313 318 187],618,5,31167,4.0939182976487585,80.0,20.0
7613,0,7613,[ 64 483 313 318 187],618,5,31172,4.094037299711059,80.0,20.0
7614,0,7614,[111   1 144 748 117],297,1,31173,4.093630991464216,0.0,0.0
7615,0,7615,[403 144   8  50 185],416,5,31178,4.09375,0.0,20.0
7616,0,7616,[174 742 238 195   4],654,5,31183,4.093868977287646,0.0,0.0
7617,0,7617,[ 64 483 313 318 187],618,5,31188,4.093987923339459,80.0,20.0
7618,0,7618,[ 64 483 313 318 187],618,5,31193,4.094106838167739,80.0,20.0
7619,0,7619,[127 357 405 237 194],416,4,31197,4.0940944881889765,0.0,0.0
7620,0,7620,[ 64 483 313 318 187],618,5,31202,4.094213357827057,80.0,20.0
7621,0,7621,[172 742 121 471 245],907,5,31207,4.094332196273943,0.0,0.0
7622,0,7622,[ 64 483 313 318 187],618,5,31212,4.094451003541913,80.0,20.0
7623,0,7623,[ 64 483 313 318 187],214,5,31217,4.094569779643232,80.0,20.0
7624,0,7624,[ 64 483 313 318 187],618,5,31222,4.094688524590164,80.0,20.0
7625,0,7625,[117 322 300 179  28],416,3,31225,4.094544977707842,0.0,0.0
7626,0,7626,[179  22 168  79  56],405,3,31228,4.094401468467288,0.0,0.0
7627,0,7627,[117 333 405 125  11],854,2,31230,4.094126900891452,0.0,0.0
7628,0,7628,[328 222 288 191 508],62,3,31233,4.093983484073928,0.0,20.0
7629,0,7629,[ 64 483 313 318 187],214,5,31238,4.094102228047182,80.0,20.0
7630,0,7630,[ 64 483 313 318 187],214,5,31243,4.094220940898965,80.0,20.0
7631,0,7631,[ 64 483 313 318 187],618,5,31248,4.09433962264151,80.0,20.0
7632,0,7632,[125 301 294 568  22],588,4,31252,4.094327263199267,0.0,0.0
7633,0,7633,[ 79 328 176 117 258],854,2,31254,4.094052921142258,0.0,0.0
7634,0,7634,[323  79 151 357 568],417,2,31256,4.093778650949575,0.0,0.0
7635,0,7635,[ 64 483 313 318 187],618,5,31261,4.0938973284442115,80.0,20.0
7636,0,7636,[132 202 245 191  11],764,4,31265,4.093885033390075,0.0,0.0
7637,0,7637,[ 64 483 313 318 187],214,5,31270,4.094003665881121,80.0,20.0
7638,0,7638,[176 333 282 153 288],854,2,31272,4.093729545752062,0.0,20.0
7639,0,7639,[ 98 234  11 202 302],416,5,31277,4.093848167539267,0.0,20.0
7640,0,7640,[ 64 483 313 318 187],214,5,31282,4.093966758277713,80.0,20.0
7641,0,7641,[ 64 483 313 318 187],214,5,31287,4.094085317979586,80.0,20.0
7642,0,7642,[508 568 191 268 196],214,4,31291,4.09407300798116,0.0,0.0
7643,0,7643,[427  70  56 228 117],198,2,31293,4.093799058084772,0.0,0.0
7644,0,7644,[ 64 483 313 318 187],214,5,31298,4.093917593198169,80.0,20.0
7645,0,7645,[174 194 176 121 515],698,3,31301,4.09377452262621,0.0,0.0
7646,0,7646,[ 64 483 313 318 187],214,5,31306,4.0938930299463845,80.0,20.0
7647,0,7647,[ 64 483 313 318 187],214,5,31311,4.094011506276151,80.0,20.0
7648,0,7648,[ 64 483 313 318 187],618,5,31316,4.0941299516276635,80.0,20.0
7649,0,7649,[258 153   8 678 655],805,2,31318,4.093856209150327,0.0,0.0
7650,0,7650,[ 79 483 179 181 268],128,3,31321,4.0937132400993335,20.0,20.0
7651,0,7651,[ 98 168 228 173 427],128,4,31325,4.093700993204391,0.0,20.0
7652,0,7652,[742  82 269 385 273],805,1,31326,4.093296746373971,0.0,0.0
7653,0,7653,[ 64 483 313 318 187],214,5,31331,4.093415207734518,80.0,20.0
7654,0,7654,[ 64 483 313 318 187],214,5,31336,4.093533638145003,80.0,20.0
7655,0,7655,[222 322 238 196 515],417,3,31339,4.093390804597701,0.0,0.0
7656,0,7656,[ 64 483 313 318 187],214,5,31344,4.09350920726133,80.0,20.0
7657,0,7657,[ 64 483 313 318 187],618,5,31349,4.093627579002351,80.0,20.0
7658,0,7658,[168 597  96  97 405],642,4,31353,4.093615354484919,0.0,0.0
7659,0,7659,[ 64 483 313 318 187],214,5,31358,4.093733681462141,80.0,20.0
7660,0,7660,[742 294 282 748  88],907,5,31363,4.093851977548623,0.0,0.0
7661,0,7661,[  1  71 288 423 257],642,3,31366,4.093709214304359,0.0,20.0
7662,0,7662,[ 64 483 313 318 187],214,5,31371,4.093827482709122,80.0,20.0
7663,0,7663,[ 64 483 313 318 187],214,5,31376,4.093945720250522,80.0,20.0
7664,0,7664,[423  71 286 235 333],416,4,31380,4.0939334637964775,0.0,0.0
7665,0,7665,[ 64 483 313 318 187],618,5,31385,4.094051656665797,80.0,20.0
7666,0,7666,[ 64 483 313 318 187],214,5,31390,4.094169818703534,80.0,20.0
7667,0,7667,[ 98 323 286 288 257],416,3,31393,4.0940271257172665,0.0,40.0
7668,0,7668,[ 64 483 313 318 187],214,5,31398,4.094145260138219,80.0,20.0
7669,0,7669,[ 64 483 313 318 187],618,5,31403,4.094263363754889,80.0,20.0
7670,0,7670,[ 79  22 168 475 258],854,4,31407,4.094251075479077,0.0,0.0
7671,0,7671,[ 64 483 313 318 187],214,5,31412,4.09436913451512,80.0,20.0
7672,0,7672,[ 64 483 313 318 187],214,5,31417,4.094487162778575,80.0,20.0
7673,0,7673,[546 185  28 180 588],805,1,31418,4.094083919728955,0.0,0.0
7674,0,7674,[ 70 161   8 204 216],437,3,31421,4.093941368078176,0.0,0.0
7675,0,7675,[  4 496  12  25 197],618,2,31423,4.093668577384054,20.0,0.0
7676,0,7676,[100 546 143 302 161],49,2,31425,4.093395857756937,0.0,0.0
7677,0,7677,[182 197  56   7  15],198,4,31429,4.093383693670226,0.0,0.0
7678,0,7678,[471  50 655  22 195],887,3,31432,4.093241307461909,0.0,20.0
7679,0,7679,[ 64 483 313 318 187],214,5,31437,4.093359375,80.0,20.0
7680,0,7680,[125 204 183 197 588],618,2,31439,4.093086837651348,0.0,0.0
7681,0,7681,[ 64 483 313 318 187],214,5,31444,4.093204894558709,80.0,20.0
7682,0,7682,[153 132  15 235 118],417,4,31448,4.0931927632435245,0.0,0.0
7683,0,7683,[471 143 100  25 238],618,2,31450,4.092920353982301,0.0,0.0
7684,0,7684,[  9 237  50  88  69],345,5,31455,4.093038386467144,0.0,20.0
7685,0,7685,[118 471 238  11 187],416,4,31459,4.093026281550872,0.0,0.0
7686,0,7686,[ 64 483 313 318 187],214,5,31464,4.093144269545987,80.0,20.0
7687,0,7687,[ 64 483 313 318 187],618,5,31469,4.093262226847035,80.0,20.0
7688,0,7688,[ 64 483 313 318 187],214,5,31474,4.09338015346599,80.0,20.0
7689,0,7689,[ 71 748 655 195  95],416,4,31478,4.093368010403121,0.0,0.0
7690,0,7690,[237  82   9 322  56],416,3,31481,4.093225848394227,0.0,0.0
7691,0,7691,[153 603 328 200 288],416,5,31486,4.09334373374935,0.0,20.0
7692,0,7692,[228 121 204 655 191],198,2,31488,4.09307162355388,0.0,0.0
7693,0,7693,[111 228 161 546 132],417,1,31489,4.092669612685209,0.0,0.0
7694,0,7694,[ 64 483 313 318 187],618,5,31494,4.0927875243664715,80.0,20.0
7695,0,7695,[ 64 483 313 318 187],214,5,31499,4.092905405405405,80.0,20.0
7696,0,7696,[ 64 483 313 318 187],618,5,31504,4.093023255813954,80.0,20.0
7697,0,7697,[ 64 483 313 318 187],214,5,31509,4.093141075604053,80.0,20.0
7698,0,7698,[ 64 483 313 318 187],214,5,31514,4.093258864787635,80.0,20.0
7699,0,7699,[127   7 172 357 175],214,4,31518,4.093246753246754,0.0,0.0
7700,0,7700,[161 211 268  12 323],417,3,31521,4.0931047915855086,20.0,0.0
7701,0,7701,[ 28 405 117 172 403],705,4,31525,4.0930927031939754,0.0,0.0
7702,0,7702,[ 64 483 313 318 187],618,5,31530,4.093210437491886,80.0,20.0
7703,0,7703,[  1 588  79 435  64],230,5,31535,4.093328141225338,20.0,0.0
7704,0,7704,[216 215 742 181 508],654,3,31538,4.093186242699546,0.0,20.0
7705,0,7705,[273 121 127  88 222],805,1,31539,4.092784842979497,0.0,0.0
7706,0,7706,[181  64 143 174  71],618,5,31544,4.092902556117815,20.0,20.0
7707,0,7707,[  4  95 117  56 111],654,5,31549,4.0930202387130254,0.0,0.0
7708,0,7708,[ 64 483 313 318 187],214,5,31554,4.0931378907770135,80.0,20.0
7709,0,7709,[234  12 313 100 282],345,4,31558,4.093125810635538,40.0,20.0
7710,0,7710,[ 64 483 313 318 187],618,5,31563,4.093243418493062,80.0,20.0
7711,0,7711,[ 64 483 313 318 187],618,5,31568,4.093360995850622,80.0,20.0
7712,0,7712,[118 471 258 265 234],416,4,31572,4.093348891481914,0.0,0.0
7713,0,7713,[ 64 483 313 318 187],214,5,31577,4.093466424682395,80.0,20.0
7714,0,7714,[ 64 483 313 318 187],618,5,31582,4.093583927414128,80.0,20.0
7715,0,7715,[ 70 483 286 210 144],417,3,31585,4.0934421980300675,20.0,0.0
7716,0,7716,[ 64 483 313 318 187],618,5,31590,4.093559673448231,80.0,20.0
7717,0,7717,[268 322 174 742 276],128,1,31591,4.093158849442861,0.0,0.0
7718,0,7718,[100 204 210 127  69],62,4,31595,4.093146780671072,0.0,0.0
7719,0,7719,[187  64 237 183 234],416,4,31599,4.093134715025907,20.0,0.0
7720,0,7720,[ 64 483 313 318 187],618,5,31604,4.093252169408108,80.0,20.0
7721,0,7721,[210 132   7  22 268],588,4,31608,4.093240093240094,0.0,0.0
7722,0,7722,[322 258 275   8 748],907,4,31612,4.093228020199405,0.0,0.0
7723,0,7723,[ 64 483 313 318 187],214,5,31617,4.093345416882444,80.0,20.0
7724,0,7724,[ 64 483 313 318 187],618,5,31622,4.093462783171521,80.0,20.0
7725,0,7725,[ 64 483 313 318 187],214,5,31627,4.093580119078436,80.0,20.0
7726,0,7726,[ 64 483 313 318 187],618,5,31632,4.093697424614986,80.0,20.0
7727,0,7727,[ 64 483 313 318 187],214,5,31637,4.0938146997929605,80.0,20.0
7728,0,7728,[273 125 172 423   8],416,5,31642,4.093931944624143,0.0,0.0
7729,0,7729,[196 268  56 125 405],416,5,31647,4.094049159120311,0.0,0.0
7730,0,7730,[568 143 174   7 173],618,4,31651,4.09403699392058,0.0,0.0
7731,0,7731,[ 50 508 748 132 286],345,3,31654,4.093895499224004,0.0,20.0
7732,0,7732,[238 127  56 483  64],214,5,31659,4.094012672960042,40.0,0.0
7733,0,7733,[322 237 302 603 135],854,2,31661,4.093741918800103,0.0,0.0
7734,0,7734,[202 181 655  89 197],711,5,31666,4.093859082094376,0.0,20.0
7735,0,7735,[435 100  89 357 211],698,2,31668,4.09358841778697,0.0,0.0
7736,0,7736,[ 70 271 135 515  98],297,4,31672,4.0935763215716685,0.0,20.0
7737,0,7737,[  1 269  56 268 132],345,4,31676,4.093564228482812,0.0,0.0
7738,0,7738,[ 64 483 313 318 187],214,5,31681,4.093681354180126,80.0,20.0
7739,0,7739,[202 588 265  98 546],416,4,31685,4.093669250645995,0.0,20.0
7740,0,7740,[357  82 194 179  50],373,3,31688,4.093527967962795,0.0,20.0
7741,0,7741,[ 64 483 313 318 187],214,5,31693,4.093645052957892,80.0,20.0
7742,0,7742,[ 64 483 313 318 187],214,5,31698,4.09376210771019,80.0,20.0
7743,0,7743,[ 95 222 265 597 282],588,4,31702,4.09375,0.0,0.0
7744,0,7744,[ 64 483 313 318 187],214,5,31707,4.093867010974822,80.0,20.0
7745,0,7745,[195 127  69  12 265],618,4,31711,4.093854892847921,20.0,0.0
7746,0,7746,[ 64 483 313 318 187],618,5,31716,4.093971860074868,80.0,20.0
7747,0,7747,[301   4 151  71 197],345,4,31720,4.093959731543624,0.0,0.0
7748,0,7748,[ 64 483 313 318 187],214,5,31725,4.094076655052265,80.0,20.0
7749,0,7749,[153 288 179 289 475],416,2,31727,4.093806451612903,0.0,20.0
7750,0,7750,[173 245 132 748 588],642,4,31731,4.093794349116243,0.0,0.0
7751,0,7751,[ 64 483 313 318 187],618,5,31736,4.09391124871001,80.0,20.0
7752,0,7752,[ 64 483 313 318 187],618,5,31741,4.094028118147814,80.0,20.0
7753,0,7753,[ 28 385 121  25 210],588,4,31745,4.094015991746195,0.0,0.0
7754,0,7754,[265  15 603 161  79],128,5,31750,4.094132817537073,0.0,0.0
7755,0,7755,[322 117 423 289 245],416,2,31752,4.093862815884476,0.0,0.0
7756,0,7756,[ 64 483 313 318 187],618,5,31757,4.093979631300761,80.0,20.0
7757,0,7757,[ 64 483 313 318 187],618,5,31762,4.094096416602217,80.0,20.0
7758,0,7758,[ 64 483 313 318 187],618,5,31767,4.09421317180049,80.0,20.0
7759,0,7759,[ 64 483 313 318 187],618,5,31772,4.094329896907216,80.0,20.0
7760,0,7760,[172 111  98 333  71],907,5,31777,4.094446591934029,0.0,20.0
7761,0,7761,[ 64 483 313 318 187],214,5,31782,4.094563256892553,80.0,20.0
7762,0,7762,[546 603 182 153 191],416,4,31786,4.094551075615097,0.0,0.0
7763,0,7763,[118 187 210 423 742],416,4,31790,4.094538897475528,0.0,0.0
7764,0,7764,[ 64 483 313 318 187],214,5,31795,4.094655505473278,80.0,20.0
7765,0,7765,[176 186  89 475  50],417,4,31799,4.09464331702292,0.0,20.0
7766,0,7766,[ 64 483 313 318 187],618,5,31804,4.094759881550148,80.0,20.0
7767,0,7767,[ 64 483 313 318 187],214,5,31809,4.094876416065912,80.0,20.0
7768,0,7768,[ 64 483 313 318 187],618,5,31814,4.0949929205818,80.0,20.0
7769,0,7769,[435 197 313 185 515],354,2,31816,4.094723294723295,20.0,20.0
7770,0,7770,[ 64 483 313 318 187],214,5,31821,4.09483978895895,80.0,20.0
7771,0,7771,[ 64 483 313 318 187],214,5,31826,4.094956253216675,80.0,20.0
7772,0,7772,[294 143   4  64  79],43,5,31831,4.095072687508041,20.0,0.0
7773,0,7773,[216 125 357 222 237],854,2,31833,4.094803190120916,0.0,0.0
7774,0,7774,[ 64 483 313 318 187],618,5,31838,4.09491961414791,80.0,20.0
7775,0,7775,[ 64 483 313 318 187],618,5,31843,4.095036008230453,80.0,20.0
7776,0,7776,[328 121 318 471 257],416,4,31847,4.095023788093095,20.0,0.0
7777,0,7777,[276  71 427 222 228],601,4,31851,4.095011571097968,0.0,0.0
7778,0,7778,[405  89 423  95   4],642,1,31852,4.094613703560869,0.0,0.0
7779,0,7779,[276 302 288 181   4],654,2,31854,4.094344473007712,0.0,40.0
7780,0,7780,[273 269 117   7 235],297,4,31858,4.094332348027246,0.0,0.0
7781,0,7781,[ 64 483 313 318 187],214,5,31863,4.094448727833462,80.0,20.0
7782,0,7782,[273 742  50   9  56],854,4,31867,4.094436592573558,0.0,20.0
7783,0,7783,[ 70 265 742 215  69],297,1,31868,4.094039054470709,0.0,0.0
7784,0,7784,[ 64 483 313 318 187],214,5,31873,4.094155427103404,80.0,20.0
7785,0,7785,[ 64 483 313 318 187],618,5,31878,4.094271769843308,80.0,20.0
7786,0,7786,[174 405 385  50 100],805,2,31880,4.094002825221523,0.0,20.0
7787,0,7787,[ 64 483 313 318 187],618,5,31885,4.09411915767848,80.0,20.0
7788,0,7788,[323  79 403 603 282],416,4,31889,4.0941070740788295,0.0,0.0
7789,0,7789,[  1 742  22 276 143],314,4,31893,4.094094993581515,0.0,0.0
7790,0,7790,[ 64 483 313 318 187],214,5,31898,4.094211269413425,80.0,20.0
7791,0,7791,[ 71 111 173   7 117],49,1,31899,4.093814168377824,0.0,0.0
7792,0,7792,[269 196 127 546 515],416,4,31903,4.093802130116772,0.0,0.0
7793,0,7793,[174   4 597 144 271],805,0,31903,4.093276879651014,0.0,0.0
7794,0,7794,[ 64 483 313 318 187],618,5,31908,4.093393200769724,80.0,20.0
7795,0,7795,[ 64 483 313 318 187],214,5,31913,4.093509492047204,80.0,20.0
7796,0,7796,[125 742 748 318 151],345,3,31916,4.0933692445812495,20.0,0.0
7797,0,7797,[ 64 483 313 318 187],618,5,31921,4.093485509104899,80.0,20.0
7798,0,7798,[ 64 483 313 318 187],618,5,31926,4.093601743813309,80.0,20.0
7799,0,7799,[ 50 143  70  15 175],198,1,31927,4.0932051282051285,0.0,20.0
7800,0,7800,[288  12 742  11 588],314,5,31932,4.093321369055249,20.0,20.0
7801,0,7801,[132  25 202 405 301],416,5,31937,4.093437580107665,0.0,0.0
7802,0,7802,[228  50 423   9  96],62,3,31940,4.0932974496988335,0.0,20.0
7803,0,7803,[ 64 483 313 318 187],214,5,31945,4.093413634033829,80.0,20.0
7804,0,7804,[135 215 234 197   1],297,1,31946,4.0930172966047405,0.0,0.0
7805,0,7805,[ 64 483 313 318 187],214,5,31951,4.093133487061235,80.0,20.0
7806,0,7806,[ 64 483 313 318 187],214,5,31956,4.0932496477520175,80.0,20.0
7807,0,7807,[ 12  98 196 151 168],43,5,31961,4.093365778688525,20.0,20.0
7808,0,7808,[ 64 483 313 318 187],618,5,31966,4.093481879882187,80.0,20.0
7809,0,7809,[ 64 483 313 318 187],618,5,31971,4.09359795134443,80.0,20.0
7810,0,7810,[195 174 191  97 322],417,3,31974,4.093457943925234,0.0,0.0
7811,0,7811,[100  82 258  97   8],62,4,31978,4.0934459805427545,0.0,0.0
7812,0,7812,[111 238 234 161 204],437,3,31981,4.093306028414181,0.0,0.0
7813,0,7813,[173   9 216 185   4],854,3,31984,4.093166112106475,0.0,0.0
7814,0,7814,[265 125 588 234 313],588,4,31988,4.093154190658989,20.0,20.0
7815,0,7815,[288 385  64 187 195],416,5,31993,4.093270214943705,20.0,20.0
7816,0,7816,[ 64 483 313 318 187],214,5,31998,4.093386209543303,80.0,20.0
7817,0,7817,[268 588  69 257 161],314,5,32003,4.093502174469173,0.0,0.0
7818,0,7818,[403 423 161 121 294],417,3,32006,4.09336232254764,0.0,0.0
7819,0,7819,[ 64 483 313 318 187],214,5,32011,4.093478260869565,80.0,20.0
7820,0,7820,[ 88 181 187 168  71],405,2,32013,4.093210586881473,0.0,20.0
7821,0,7821,[181 427  89 357 195],198,4,32017,4.093198670416773,0.0,20.0
7822,0,7822,[ 64 483 313 318 187],618,5,32022,4.093314585197494,80.0,20.0
7823,0,7823,[161 300 196  56   1],128,4,32026,4.093302658486707,0.0,0.0
7824,0,7824,[173  22  71 318 117],642,4,32030,4.093290734824281,20.0,0.0
7825,0,7825,[ 64 483 313 318 187],214,5,32035,4.093406593406593,80.0,20.0
7826,0,7826,[427 357 172  28 238],373,4,32039,4.0933946595119455,0.0,0.0
7827,0,7827,[333 196 197 191   7],416,5,32044,4.093510475217169,0.0,0.0
7828,0,7828,[ 64 483 313 318 187],618,5,32049,4.093626261336058,80.0,20.0
7829,0,7829,[153  50 357 143 183],805,4,32053,4.093614303959131,0.0,20.0
7830,0,7830,[ 64 483 313 318 187],214,5,32058,4.093730047248116,80.0,20.0
7831,0,7831,[ 64 483 313 318 187],214,5,32063,4.093845760980592,80.0,20.0
7832,0,7832,[ 64 483 313 318 187],214,5,32068,4.09396144516788,80.0,20.0
7833,0,7833,[ 64 483 313 318 187],214,5,32073,4.094077099821292,80.0,20.0
7834,0,7834,[  4 111  11 215 245],297,1,32074,4.093682195277601,0.0,0.0
7835,0,7835,[ 64 483 313 318 187],214,5,32079,4.0937978560490045,80.0,20.0
7836,0,7836,[127 471 215 269 748],416,5,32084,4.093913487303816,0.0,0.0
7837,0,7837,[ 64 483 313 318 187],214,5,32089,4.09402908905333,80.0,20.0
7838,0,7838,[ 64 483 313 318 187],618,5,32094,4.094144661308841,80.0,20.0
7839,0,7839,[ 22 235  89 258 275],297,4,32098,4.094132653061225,0.0,0.0
7840,0,7840,[288 300 357 301 185],416,5,32103,4.094248182629767,0.0,20.0
7841,0,7841,[  8  25  22 132 423],416,5,32108,4.094363682733997,0.0,0.0
7842,0,7842,[ 64 483 313 318 187],214,5,32113,4.094479153385184,80.0,20.0
7843,0,7843,[ 64 483 313 318 187],618,5,32118,4.094594594594595,80.0,20.0
7844,0,7844,[ 64 483 313 318 187],618,5,32123,4.094710006373487,80.0,20.0
7845,0,7845,[ 64 483 313 318 187],214,5,32128,4.0948253887331125,80.0,20.0
7846,0,7846,[ 28  97 237 174  22],416,4,32132,4.09481330444756,0.0,0.0
7847,0,7847,[678  98 385 153 568],805,3,32135,4.0946738022426095,0.0,20.0
7848,0,7848,[ 64 483 313 318 187],618,5,32140,4.094789145114027,80.0,20.0
7849,0,7849,[  1  70 121  98 135],618,4,32144,4.094777070063694,0.0,20.0
7850,0,7850,[143 496   9  50 301],416,5,32149,4.094892370398675,0.0,20.0
7851,0,7851,[216  98 294  56 172],230,4,32153,4.094880285277636,0.0,20.0
7852,0,7852,[294 172   1   8 117],43,5,32158,4.094995543104546,0.0,0.0
7853,0,7853,[111  15 179 228 132],62,2,32160,4.094728800611153,0.0,0.0
7854,0,7854,[403 180 125  70  98],417,5,32165,4.09484404837683,0.0,20.0
7855,0,7855,[655 273  79 318 748],416,5,32170,4.094959266802444,20.0,0.0
7856,0,7856,[ 88  11 748 187 173],416,4,32174,4.094947180857834,0.0,0.0
7857,0,7857,[ 64 483 313 318 187],214,5,32179,4.0950623568338,80.0,20.0
7858,0,7858,[ 64 483 313 318 187],214,5,32184,4.095177503499173,80.0,20.0
7859,0,7859,[ 64 483 313 318 187],618,5,32189,4.09529262086514,80.0,20.0
7860,0,7860,[ 64 483 313 318 187],618,5,32194,4.095407708942883,80.0,20.0
7861,0,7861,[286 282 179 268 257],416,3,32197,4.095268379547189,0.0,0.0
7862,0,7862,[ 64 483 313 318 187],618,5,32202,4.095383441434567,80.0,20.0
7863,0,7863,[ 64 483 313 318 187],214,5,32207,4.095498474059003,80.0,20.0
7864,0,7864,[318 265 118 172   7],618,4,32211,4.095486331849968,20.0,0.0
7865,0,7865,[ 64 483 313 318 187],618,5,32216,4.095601322145945,80.0,20.0
7866,0,7866,[ 64 483 313 318 187],618,5,32221,4.095716283208339,80.0,20.0
7867,0,7867,[ 64 483 313 318 187],214,5,32226,4.095831215048297,80.0,20.0
7868,0,7868,[ 64 483 313 318 187],618,5,32231,4.09594611767696,80.0,20.0
7869,0,7869,[ 64 483 313 318 187],618,5,32236,4.096060991105464,80.0,20.0
7870,0,7870,[183 471 515 215   7],416,5,32241,4.096175835344937,0.0,0.0
7871,0,7871,[ 64 483 313 318 187],618,5,32246,4.096290650406504,80.0,20.0
7872,0,7872,[ 64 483 313 318 187],618,5,32251,4.096405436301283,80.0,20.0
7873,0,7873,[ 64 483 313 318 187],214,5,32256,4.096520193040386,80.0,20.0
7874,0,7874,[ 64 483 313 318 187],214,5,32261,4.096634920634921,80.0,20.0
7875,0,7875,[ 12 125 496 323 161],417,2,32263,4.096368715083799,20.0,0.0
7876,0,7876,[475 185 194 216 546],416,3,32266,4.096229529008506,0.0,0.0
7877,0,7877,[ 64 483 313 318 187],618,5,32271,4.096344249809596,80.0,20.0
7878,0,7878,[427  89   8 204 235],642,2,32273,4.096078182510471,0.0,0.0
7879,0,7879,[117 245 121  12 403],417,4,32277,4.096065989847716,20.0,0.0
7880,0,7880,[ 64 483 313 318 187],214,5,32282,4.096180687729984,80.0,20.0
7881,0,7881,[ 64 483 313 318 187],618,5,32287,4.0962953565085005,80.0,20.0
7882,0,7882,[125  69 161 328 117],505,2,32289,4.0960294304198905,0.0,0.0
7883,0,7883,[204  97 100  15  64],43,5,32294,4.096144089294774,20.0,0.0
7884,0,7884,[237 172   8 182 176],618,4,32298,4.0961318960050725,0.0,0.0
7885,0,7885,[144 294 405 228 135],805,1,32299,4.095739284808522,0.0,0.0
7886,0,7886,[ 70  71 302  64   1],43,5,32304,4.095853936858121,20.0,0.0
7887,0,7887,[195 603 258 282 235],416,4,32308,4.095841784989858,0.0,0.0
7888,0,7888,[515 258 588 423 185],297,4,32312,4.095829636202307,0.0,0.0
7889,0,7889,[172 258 196 135 127],417,3,32315,4.095690747782003,0.0,0.0
7890,0,7890,[161  22 202 185 427],230,5,32320,4.095805347864656,0.0,0.0
7891,0,7891,[568 182 196 237 216],62,3,32323,4.095666497719209,0.0,0.0
7892,0,7892,[ 64 483 313 318 187],618,5,32328,4.095781071835804,80.0,20.0
7893,0,7893,[265 100 276 200 257],416,3,32331,4.0956422599442615,0.0,0.0
7894,0,7894,[161 603  15 289 173],416,4,32335,4.095630145661811,0.0,0.0
7895,0,7895,[508 257 742 100   4],62,3,32338,4.09549138804458,0.0,0.0
7896,0,7896,[196 282 168  82 238],12,5,32343,4.095605926301127,0.0,0.0
7897,0,7897,[258 173 215 333 300],416,5,32348,4.095720435553305,0.0,0.0
7898,0,7898,[289  98  28  22 176],887,4,32352,4.095708317508546,0.0,20.0
7899,0,7899,[ 64 483 313 318 187],618,5,32357,4.095822784810126,80.0,20.0
7900,0,7900,[ 64 180 245 161  11],417,4,32361,4.095810656878876,20.0,0.0
7901,0,7901,[ 64 483 313 318 187],214,5,32366,4.095925082257656,80.0,20.0
7902,0,7902,[275 144 135 475  69],437,2,32368,4.095659875996457,0.0,0.0
7903,0,7903,[268  79 100 185   4],416,5,32373,4.095774291497976,0.0,0.0
7904,0,7904,[ 64 483 313 318 187],214,5,32378,4.095888678051866,80.0,20.0
7905,0,7905,[ 64 483 313 318 187],618,5,32383,4.096003035669112,80.0,20.0
7906,0,7906,[288 180 302  12 235],62,3,32386,4.095864423928165,20.0,20.0
7907,0,7907,[435 286 118 496 197],437,2,32388,4.095599393019727,0.0,0.0
7908,0,7908,[294 191 132 655 546],262,2,32390,4.095334429131369,0.0,0.0
7909,0,7909,[  4 302 588 121  70],49,2,32392,4.095069532237674,0.0,0.0
7910,0,7910,[211  12 275 111  97],43,5,32397,4.095183921122488,20.0,0.0
7911,0,7911,[111 196 200 318 181],437,4,32401,4.095171890798786,20.0,20.0
7912,0,7912,[ 64 483 313 318 187],214,5,32406,4.095286237836472,80.0,20.0
7913,0,7913,[235 678  82 328 475],416,2,32408,4.095021480919889,0.0,0.0
7914,0,7914,[ 64 483 313 318 187],214,5,32413,4.095135818066962,80.0,20.0
7915,0,7915,[ 97 597 471 210 568],618,3,32416,4.09499747347145,0.0,0.0
7916,0,7916,[ 64 483 313 318 187],214,5,32421,4.095111784766957,80.0,20.0
7917,0,7917,[ 12 215  98 228 100],297,3,32424,4.094973478151048,20.0,20.0
7918,0,7918,[ 64 483 313 318 187],618,5,32429,4.095087763606516,80.0,20.0
7919,0,7919,[ 64 483 313 318 187],214,5,32434,4.09520202020202,80.0,20.0
7920,0,7920,[276 257 318 313 258],416,3,32437,4.095063754576443,40.0,20.0
7921,0,7921,[117 588 275 568 258],588,4,32441,4.0950517546074225,0.0,0.0
7922,0,7922,[235 153  82   4 173],642,2,32443,4.094787328032311,0.0,0.0
7923,0,7923,[204  12  50 161 186],437,3,32446,4.094649167087329,20.0,20.0
7924,0,7924,[ 64 483 313 318 187],214,5,32451,4.094763406940063,80.0,20.0
7925,0,7925,[265 173 588  79  97],437,2,32453,4.094499116830684,0.0,0.0
7926,0,7926,[ 64 483 313 318 187],618,5,32458,4.094613346789454,80.0,20.0
7927,0,7927,[ 64 483 313 318 187],618,5,32463,4.094727547931383,80.0,20.0
7928,0,7928,[179  56 182 200 175],198,4,32467,4.094715600958507,0.0,0.0
7929,0,7929,[185  88 269  15 276],416,3,32470,4.094577553593947,0.0,0.0
7930,0,7930,[ 64 483 313 318 187],618,5,32475,4.0946917160509395,80.0,20.0
7931,0,7931,[ 64 483 313 318 187],214,5,32480,4.0948058497226425,80.0,20.0
7932,0,7932,[ 64 483 313 318 187],618,5,32485,4.094919954619942,80.0,20.0
7933,0,7933,[ 64 483 313 318 187],214,5,32490,4.095034030753718,80.0,20.0
7934,0,7934,[568 215 195 181  25],416,5,32495,4.095148078134845,0.0,20.0
7935,0,7935,[ 64 483 313 318 187],618,5,32500,4.095262096774194,80.0,20.0
7936,0,7936,[313 258 210 196 423],354,2,32502,4.094998110117173,20.0,20.0
7937,0,7937,[ 97 202  95 185  82],230,5,32507,4.095112118921643,0.0,0.0
7938,0,7938,[  7 313 168  69 238],416,5,32512,4.095226099004912,20.0,20.0
7939,0,7939,[ 64 483 313 318 187],214,5,32517,4.095340050377834,80.0,20.0
7940,0,7940,[202 144 275  79  69],43,5,32522,4.095453973051253,0.0,0.0
7941,0,7941,[144 245  71 282 268],416,4,32526,4.095441954167716,0.0,0.0
7942,0,7942,[  4 197  82  69 427],198,3,32529,4.095304041294221,0.0,0.0
7943,0,7943,[ 64 282 568 197   8],416,5,32534,4.0954179254783485,20.0,0.0
7944,0,7944,[405 174 117 121 216],43,5,32539,4.095531780994336,0.0,0.0
7945,0,7945,[ 64 483 313 318 187],214,5,32544,4.095645607853008,80.0,20.0
7946,0,7946,[ 64 483 313 318 187],214,5,32549,4.095759406065182,80.0,20.0
7947,0,7947,[ 64 483 313 318 187],214,5,32554,4.095873175641671,80.0,20.0
7948,0,7948,[179 173 282 210 403],416,4,32558,4.0958611146056105,0.0,0.0
7949,0,7949,[568 185   4 288 471],618,2,32560,4.0955974842767295,0.0,20.0
7950,0,7950,[ 64 483 313 318 187],214,5,32565,4.095711231291661,80.0,20.0
7951,0,7951,[187 301 385 235 302],416,4,32569,4.095699195171026,0.0,0.0
7952,0,7952,[ 64 483 313 318 187],618,5,32574,4.095812900792154,80.0,20.0
7953,0,7953,[ 25  69 275 300 258],43,5,32579,4.095926577822479,0.0,0.0
7954,0,7954,[194 200  11  64 357],416,5,32584,4.096040226272784,20.0,0.0
7955,0,7955,[121  96 100 202 234],230,4,32588,4.096028154851684,0.0,0.0
7956,0,7956,[237  95  82 210  88],588,4,32592,4.096016086464748,0.0,0.0
7957,0,7957,[ 64 483 313 318 187],214,5,32597,4.096129680824328,80.0,20.0
7958,0,7958,[ 95 194 100 202 172],373,3,32600,4.095991958788793,0.0,0.0
7959,0,7959,[ 64 483 313 318 187],618,5,32605,4.096105527638191,80.0,20.0
7960,0,7960,[ 64 483 313 318 187],618,5,32610,4.096219067956287,80.0,20.0
7961,0,7961,[333 111  50 300 288],416,5,32615,4.096332579753831,0.0,40.0
7962,0,7962,[127 568  64 117  15],198,2,32617,4.096069320607811,20.0,0.0
7963,0,7963,[185 172 135 655 196],198,3,32620,4.095931692616776,0.0,0.0
7964,0,7964,[ 64 483 313 318 187],214,5,32625,4.096045197740113,80.0,20.0
7965,0,7965,[174 515  79 742 288],417,1,32626,4.095656540296259,0.0,20.0
7966,0,7966,[ 64 483 313 318 187],618,5,32631,4.095770051462282,80.0,20.0
7967,0,7967,[258 151 427   8  82],711,4,32635,4.095758032128514,0.0,0.0
7968,0,7968,[ 97 211 323 132 125],417,4,32639,4.095746015811269,0.0,0.0
7969,0,7969,[143   8 210 282 301],416,5,32644,4.09585947302384,0.0,0.0
7970,0,7970,[ 64 483 313 318 187],214,5,32649,4.095972901768913,80.0,20.0
7971,0,7971,[271  50 127  89 289],854,4,32653,4.095960863020572,0.0,20.0
7972,0,7972,[172 357 125 181 568],230,4,32657,4.095948827292111,0.0,20.0
7973,0,7973,[276   9 237  12 301],416,3,32660,4.0958113870077755,20.0,0.0
7974,0,7974,[ 64 483 313 318 187],214,5,32665,4.095924764890282,80.0,20.0
7975,0,7975,[ 64 483 313 318 187],618,5,32670,4.096038114343029,80.0,20.0
7976,0,7976,[ 64 483 313 318 187],618,5,32675,4.096151435376708,80.0,20.0
7977,0,7977,[ 64 483 313 318 187],618,5,32680,4.096264728002006,80.0,20.0
7978,0,7978,[ 15 176 125 153 132],417,5,32685,4.096377992229603,0.0,0.0
7979,0,7979,[ 64 483 313 318 187],214,5,32690,4.0964912280701755,80.0,20.0
7980,0,7980,[471 655 172 273 288],416,5,32695,4.0966044355343945,0.0,20.0
7981,0,7981,[ 64 483 313 318 187],214,5,32700,4.096717614632924,80.0,20.0
7982,0,7982,[151 182 471 405 328],416,4,32704,4.09670549918577,0.0,0.0
7983,0,7983,[ 64 483 313 318 187],618,5,32709,4.096818637274549,80.0,20.0
7984,0,7984,[176 475 182 143 179],437,2,32711,4.096556042579837,0.0,0.0
7985,0,7985,[ 64 483 313 318 187],214,5,32716,4.096669171049336,80.0,20.0
7986,0,7986,[153 118 258  25 678],654,3,32719,4.096531864279454,0.0,0.0
7987,0,7987,[ 64 483 313 318 187],618,5,32724,4.0966449674511765,80.0,20.0
7988,0,7988,[  7 191 405  64 175],854,5,32729,4.096758042308173,20.0,0.0
7989,0,7989,[323 172 118 111 257],417,1,32730,4.0963704630788484,0.0,0.0
7990,0,7990,[168 245  89 235  96],417,3,32733,4.096233262420223,0.0,0.0
7991,0,7991,[ 64 483 313 318 187],214,5,32738,4.096346346346347,80.0,20.0
7992,0,7992,[204 423 234 294  69],297,0,32738,4.095833854622795,0.0,0.0
7993,0,7993,[ 64 483 313 318 187],214,5,32743,4.095946960220165,80.0,20.0
7994,0,7994,[183 222 288 423  96],805,3,32746,4.095809881175735,0.0,20.0
7995,0,7995,[135  89 603 181 172],214,2,32748,4.095547773886944,0.0,20.0
7996,0,7996,[210 121 173 211 186],437,2,32750,4.095285732149556,0.0,0.0
7997,0,7997,[ 15 100 357 328 215],416,5,32755,4.095398849712428,0.0,0.0
7998,0,7998,[182 357 496 173 132],417,4,32759,4.095386923365421,0.0,0.0
7999,0,7999,[508 175 151 238  79],297,3,32762,4.09525,0.0,0.0
8000,0,8000,[ 64 483 313 318 187],214,5,32767,4.095363079615048,80.0,20.0
8001,0,8001,[ 64 483 313 318 187],214,5,32772,4.095476130967258,80.0,20.0
8002,0,8002,[294 405 597  25 588],887,4,32776,4.095464200924654,0.0,0.0
8003,0,8003,[168   1 245 234 235],297,1,32777,4.095077461269366,0.0,0.0
8004,0,8004,[ 96 588 151  89  82],373,3,32780,4.094940662086196,0.0,0.0
8005,0,8005,[257 144  12 238 237],62,2,32782,4.0946789907569325,20.0,0.0
8006,0,8006,[ 64 483 313 318 187],214,5,32787,4.094792056950169,80.0,20.0
8007,0,8007,[ 79 215 273 257 265],416,4,32791,4.09478021978022,0.0,0.0
8008,0,8008,[ 64 483 313 318 187],618,5,32796,4.0948932450992634,80.0,20.0
8009,0,8009,[ 64 483 313 318 187],618,5,32801,4.095006242197253,80.0,20.0
8010,0,8010,[181  28 174 182 405],230,4,32805,4.094994382723755,0.0,20.0
8011,0,8011,[ 64 483 313 318 187],618,5,32810,4.095107338991513,80.0,20.0
8012,0,8012,[276   7 328 273 195],62,4,32814,4.095095469861475,0.0,0.0
8013,0,8013,[ 64 483 313 318 187],618,5,32819,4.09520838532568,80.0,20.0
8014,0,8014,[168  98 597 257 258],654,5,32824,4.095321272613849,0.0,20.0
8015,0,8015,[ 64 483 313 318 187],214,5,32829,4.095434131736527,80.0,20.0
8016,0,8016,[173  82 546 678 111],416,3,32832,4.095297492827741,0.0,0.0
8017,0,8017,[ 64 483 313 318 187],618,5,32837,4.095410326764779,80.0,20.0
8018,0,8018,[ 64 483 313 318 187],618,5,32842,4.09552313256017,80.0,20.0
8019,0,8019,[ 79  64 161 313 318],405,4,32846,4.095511221945137,60.0,20.0
8020,0,8020,[  9 127 742 333 200],416,5,32851,4.095623987034036,0.0,0.0
8021,0,8021,[238 385 197 174 294],805,2,32853,4.095362752430815,0.0,0.0
8022,0,8022,[ 12 294 302 173 161],49,2,32855,4.095101582949021,20.0,0.0
8023,0,8023,[202 265 161  64 300],416,5,32860,4.095214356929213,20.0,0.0
8024,0,8024,[ 64 483 313 318 187],214,5,32865,4.095327102803738,80.0,20.0
8025,0,8025,[183   1 174 144  71],805,2,32867,4.095066035384999,0.0,0.0
8026,0,8026,[423 117   4  12  82],417,4,32871,4.0950541921016566,20.0,0.0
8027,0,8027,[294 271 286 117 328],62,1,32872,4.094668659691081,0.0,0.0
8028,0,8028,[ 11 153 301 655 210],437,2,32874,4.094407771827127,0.0,0.0
8029,0,8029,[179 265 302 273 288],416,4,32878,4.09439601494396,0.0,20.0
8030,0,8030,[ 64 483 313 318 187],214,5,32883,4.094508778483377,80.0,20.0
8031,0,8031,[ 64 483 313 318 187],214,5,32888,4.094621513944223,80.0,20.0
8032,0,8032,[385 202 181 588  98],416,5,32893,4.094734221336985,0.0,40.0
8033,0,8033,[111  25 179   4 174],416,4,32897,4.094722429673886,0.0,0.0
8034,0,8034,[121 276 161 742 546],416,3,32900,4.094586185438706,0.0,0.0
8035,0,8035,[ 64 483 313 318 187],214,5,32905,4.094698855151817,80.0,20.0
8036,0,8036,[323 268 288 282 210],345,2,32907,4.094438223217619,0.0,20.0
8037,0,8037,[475  22 216 237 483],62,4,32911,4.094426474247325,20.0,0.0
8038,0,8038,[ 28  15 282 423 181],721,5,32916,4.094539121781316,0.0,20.0
8039,0,8039,[ 64 483 313 318 187],618,5,32921,4.094651741293532,80.0,20.0
8040,0,8040,[117  71  69 301 143],437,1,32922,4.094266882228578,0.0,0.0
8041,0,8041,[ 64 483 313 318 187],618,5,32927,4.094379507585177,80.0,20.0
8042,0,8042,[ 64 483 313 318 187],214,5,32932,4.094492104935969,80.0,20.0
8043,0,8043,[ 95 202  50 135 286],297,3,32935,4.094356041770263,0.0,20.0
8044,0,8044,[127 191 322 258  82],417,4,32939,4.094344313238036,0.0,0.0
8045,0,8045,[265 286  97 302 100],297,4,32943,4.094332587621178,0.0,0.0
8046,0,8046,[ 64 597 174 423 269],43,4,32947,4.094320864918603,20.0,0.0
8047,0,8047,[ 64 483 313 318 187],214,5,32952,4.094433399602385,80.0,20.0
8048,0,8048,[ 64 483 313 318 187],214,5,32957,4.094545906323767,80.0,20.0
8049,0,8049,[ 64 483 313 318 187],618,5,32962,4.094658385093168,80.0,20.0
8050,0,8050,[179 181 475 258 118],198,4,32966,4.094646627748106,0.0,20.0
8051,0,8051,[276 151 135 273 286],62,4,32970,4.094634873323398,0.0,0.0
8052,0,8052,[ 64 483 313 318 187],618,5,32975,4.094747299143177,80.0,20.0
8053,0,8053,[588 269  69 176 322],416,4,32979,4.094735535137819,0.0,0.0
8054,0,8054,[111 210 483 475 100],588,2,32981,4.09447548106766,20.0,0.0
8055,0,8055,[ 64 483 313 318 187],618,5,32986,4.094587884806356,80.0,20.0
8056,0,8056,[ 64 483 313 318 187],618,5,32991,4.094700260642919,80.0,20.0
8057,0,8057,[ 95 276 187   9 191],618,2,32993,4.094440307768677,0.0,0.0
8058,0,8058,[143 405  70 288  82],642,2,32995,4.094180419406874,0.0,20.0
8059,0,8059,[257 234 748 117 168],642,4,32999,4.094168734491316,0.0,0.0
8060,0,8060,[ 64 483 313 318 187],618,5,33004,4.094281106562462,80.0,20.0
8061,0,8061,[ 89   8 216 118 153],805,2,33006,4.0940213346564125,0.0,0.0
8062,0,8062,[ 79 282 385 742 427],416,5,33011,4.094133697135061,0.0,0.0
8063,0,8063,[ 96 176 294  11 197],805,3,33014,4.093998015873016,0.0,0.0
8064,0,8064,[196 508 173  96 183],417,3,33017,4.093862368257905,0.0,0.0
8065,0,8065,[ 64 483 313 318 187],214,5,33022,4.093974708653608,80.0,20.0
8066,0,8066,[ 69 568  25 288 210],417,0,33022,4.093467212098673,0.0,20.0
8067,0,8067,[ 64 483 313 318 187],214,5,33027,4.0935795736241944,80.0,20.0
8068,0,8068,[ 64 235 237 185 111],854,2,33029,4.093320114016607,20.0,0.0
8069,0,8069,[318 100  70 187 403],618,4,33033,4.093308550185873,20.0,0.0
8070,0,8070,[ 64 483 313 318 187],214,5,33038,4.093420889604758,80.0,20.0
8071,0,8071,[ 64 483 313 318 187],214,5,33043,4.093533201189296,80.0,20.0
8072,0,8072,[ 64 483 313 318 187],214,5,33048,4.093645484949833,80.0,20.0
8073,0,8073,[ 64 483 313 318 187],214,5,33053,4.093757740896706,80.0,20.0
8074,0,8074,[ 64 483 313 318 187],214,5,33058,4.093869969040248,80.0,20.0
8075,0,8075,[ 64 483 313 318 187],618,5,33063,4.093982169390787,80.0,20.0
8076,0,8076,[ 64 483 313 318 187],214,5,33068,4.094094341958648,80.0,20.0
8077,0,8077,[215 222 118 210  82],198,2,33070,4.093835107699926,0.0,0.0
8078,0,8078,[678 174 216 313 385],654,5,33075,4.093947270701819,20.0,20.0
8079,0,8079,[ 64 483 313 318 187],618,5,33080,4.094059405940594,80.0,20.0
8080,0,8080,[ 64 483 313 318 187],618,5,33085,4.094171513426556,80.0,20.0
8081,0,8081,[ 64 483 313 318 187],214,5,33090,4.094283593170007,80.0,20.0
8082,0,8082,[237   9  71 245   7],764,5,33095,4.094395645181245,0.0,0.0
8083,0,8083,[182  28   1 258 245],297,2,33097,4.094136566056408,0.0,0.0
8084,0,8084,[ 64 483 313 318 187],618,5,33102,4.094248608534323,80.0,20.0
8085,0,8085,[  1  11 174  82 111],49,0,33102,4.093742270591145,0.0,0.0
8086,0,8086,[195 191 204  79 202],618,2,33104,4.093483368368987,0.0,0.0
8087,0,8087,[ 64 483 313 318 187],214,5,33109,4.093595450049456,80.0,20.0
8088,0,8088,[210  70  15 182 245],416,4,33113,4.093583879342317,0.0,0.0
8089,0,8089,[ 25 151 385 125 118],417,4,33117,4.093572311495674,0.0,0.0
8090,0,8090,[111 210 427 132 151],128,2,33119,4.093313558274626,0.0,0.0
8091,0,8091,[ 64  56  71 132 238],198,4,33123,4.0933020266930304,20.0,0.0
8092,0,8092,[655  50  64 179 496],416,4,33127,4.093290497961201,20.0,20.0
8093,0,8093,[357 210   8 237 202],230,5,33132,4.093402520385471,0.0,0.0
8094,0,8094,[ 64 483 313 318 187],214,5,33137,4.093514515132798,80.0,20.0
8095,0,8095,[ 64 483 313 318 187],618,5,33142,4.0936264822134385,80.0,20.0
8096,0,8096,[288 125 385 294  50],642,4,33146,4.093614919105842,0.0,40.0
8097,0,8097,[269 318 211 678  96],416,4,33150,4.093603358854038,20.0,0.0
8098,0,8098,[ 79  50 288 323 144],416,4,33154,4.09359180145697,0.0,40.0
8099,0,8099,[ 64 483 313 318 187],618,5,33159,4.093703703703704,80.0,20.0
8100,0,8100,[603 508  22 175  96],854,3,33162,4.093568695222812,0.0,0.0
8101,0,8101,[ 64 483 313 318 187],214,5,33167,4.0936805726981,80.0,20.0
8102,0,8102,[173 286 318 195 172],62,4,33171,4.093669011477231,20.0,0.0
8103,0,8103,[ 64 483 313 318 187],214,5,33176,4.093780848963474,80.0,20.0
8104,0,8104,[ 64 483 313 318 187],618,5,33181,4.09389265885256,80.0,20.0
8105,0,8105,[588  98 143 235 210],416,4,33185,4.093881075746361,0.0,20.0
8106,0,8106,[ 64 483 313 318 187],214,5,33190,4.093992845688911,80.0,20.0
8107,0,8107,[222 269   4  71 210],654,4,33194,4.093981253083374,0.0,0.0
8108,0,8108,[183 185 222 144 117],297,4,33198,4.093969663337033,0.0,0.0
8109,0,8109,[ 64 483 313 318 187],618,5,33203,4.094081381011097,80.0,20.0
8110,0,8110,[427 471 257 111  98],416,4,33207,4.094069781777833,0.0,20.0
8111,0,8111,[ 22 143 182 318 191],618,5,33212,4.094181459566075,20.0,0.0
8112,0,8112,[748 238  12 202 471],373,3,33215,4.09404659188956,20.0,0.0
8113,0,8113,[265 257  70 196   1],654,5,33220,4.094158245008627,0.0,0.0
8114,0,8114,[ 64 483 313 318 187],618,5,33225,4.094269870609981,80.0,20.0
8115,0,8115,[174  70 273 118 204],297,3,33228,4.0941350418925575,0.0,0.0
8116,0,8116,[117   1   8 132 496],253,5,33233,4.094246642848343,0.0,0.0
8117,0,8117,[ 69  56 151 302   1],62,3,33236,4.094111850209411,0.0,0.0
8118,0,8118,[300 222   9 568 181],630,3,33239,4.093977090774726,0.0,20.0
8119,0,8119,[ 64 483 313 318 187],618,5,33244,4.094088669950739,80.0,20.0
8120,0,8120,[161 125 603 403 245],416,4,33248,4.094077084102943,0.0,0.0
8121,0,8121,[ 64 483 313 318 187],214,5,33253,4.094188623491751,80.0,20.0
8122,0,8122,[  9 210  28 385 678],416,4,33257,4.094177028191555,0.0,0.0
8123,0,8123,[ 64 483 313 318 187],618,5,33262,4.094288527818809,80.0,20.0
8124,0,8124,[ 64 483 313 318 187],214,5,33267,4.0944,80.0,20.0
8125,0,8125,[ 64 483 313 318 187],214,5,33272,4.094511444745262,80.0,20.0
8126,0,8126,[ 64 483 313 318 187],214,5,33277,4.094622862064723,80.0,20.0
8127,0,8127,[ 64 483 313 318 187],618,5,33282,4.094734251968504,80.0,20.0
8128,0,8128,[185 100  96 403 132],618,4,33286,4.094722598105548,0.0,0.0
8129,0,8129,[ 64 483 313 318 187],214,5,33291,4.094833948339484,80.0,20.0
8130,0,8130,[234 196  15  28  71],345,3,33294,4.094699298979215,0.0,0.0
8131,0,8131,[288 210 302 427   4],405,5,33299,4.094810624692572,0.0,20.0
8132,0,8132,[258 182 153 202 275],416,5,33304,4.0949219230296325,0.0,0.0
8133,0,8133,[ 64 483 313 318 187],618,5,33309,4.095033194000492,80.0,20.0
8134,0,8134,[268  70  56 191 385],345,4,33313,4.095021511985249,0.0,0.0
8135,0,8135,[ 64 483 313 318 187],214,5,33318,4.095132743362832,80.0,20.0
8136,0,8136,[210 496 568  98  96],230,3,33321,4.09499815656876,0.0,20.0
8137,0,8137,[ 64 483 313 318 187],618,5,33326,4.0951093634799705,80.0,20.0
8138,0,8138,[ 64 483 313 318 187],618,5,33331,4.095220543064259,80.0,20.0
8139,0,8139,[483 216 276 197 132],437,5,33336,4.095331695331695,20.0,0.0
8140,0,8140,[135 175  79  69  56],214,3,33339,4.095197150227245,0.0,0.0
8141,0,8141,[286 357 300 748 603],297,3,33342,4.095062638172439,0.0,0.0
8142,0,8142,[  9 183 202 471  64],618,2,33344,4.09480535429203,20.0,0.0
8143,0,8143,[ 96 228 185 245 210],417,1,33345,4.094425343811395,0.0,0.0
8144,0,8144,[117 748  12 168 153],416,5,33350,4.094536525475752,20.0,0.0
8145,0,8145,[ 64 483 313 318 187],618,5,33355,4.0946476798428675,80.0,20.0
8146,0,8146,[257  11  56 313 678],416,3,33358,4.094513317785688,20.0,20.0
8147,0,8147,[427 276 286  98  82],416,4,33362,4.094501718213058,0.0,20.0
8148,0,8148,[ 64 483 313 318 187],214,5,33367,4.094612835930789,80.0,20.0
8149,0,8149,[ 64 483 313 318 187],618,5,33372,4.094723926380368,80.0,20.0
8150,0,8150,[176  71 127 173 125],601,2,33374,4.0944669365722,0.0,0.0
8151,0,8151,[ 64 483 313 318 187],214,5,33379,4.094578017664377,80.0,20.0
8152,0,8152,[483 323 357 322 496],417,2,33381,4.0943211087943086,20.0,0.0
8153,0,8153,[ 64 483 313 318 187],214,5,33386,4.094432180524896,80.0,20.0
8154,0,8154,[ 64 483 313 318 187],214,5,33391,4.094543225015328,80.0,20.0
8155,0,8155,[ 64 483 313 318 187],214,5,33396,4.094654242275626,80.0,20.0
8156,0,8156,[ 64 483 313 318 187],214,5,33401,4.094765232315803,80.0,20.0
8157,0,8157,[ 64 483 313 318 187],214,5,33406,4.094876195145869,80.0,20.0
8158,0,8158,[ 64 483 313 318 187],214,5,33411,4.094987130775831,80.0,20.0
8159,0,8159,[ 71 483 318 151  69],62,5,33416,4.095098039215686,40.0,0.0
8160,0,8160,[ 64 483 313 318 187],214,5,33421,4.095208920475432,80.0,20.0
8161,0,8161,[423 603 200 588  11],297,3,33424,4.095074736584171,0.0,0.0
8162,0,8162,[ 64 483 313 318 187],214,5,33429,4.09518559353179,80.0,20.0
8163,0,8163,[ 50 238  96 265 194],405,2,33431,4.094928956393924,0.0,20.0
8164,0,8164,[ 64 483 313 318 187],214,5,33436,4.095039804041641,80.0,20.0
8165,0,8165,[211 127  70 568 216],417,3,33439,4.094905706588293,0.0,0.0
8166,0,8166,[ 64 483 313 318 187],618,5,33444,4.095016529937554,80.0,20.0
8167,0,8167,[ 64 483 313 318 187],214,5,33449,4.095127326150832,80.0,20.0
8168,0,8168,[282  28 195 168  56],654,4,33453,4.095115681233933,0.0,0.0
8169,0,8169,[ 96  56 269 144  71],805,3,33456,4.094981640146879,0.0,0.0
8170,0,8170,[ 64 483 313 318 187],618,5,33461,4.095092399951047,80.0,20.0
8171,0,8171,[ 64 483 313 318 187],214,5,33466,4.0952031326480665,80.0,20.0
8172,0,8172,[ 22 515 196 211  95],405,1,33467,4.094824421876912,0.0,0.0
8173,0,8173,[172 204 508 228 125],601,3,33470,4.094690482016149,0.0,0.0
8174,0,8174,[ 22  71 204  89 168],922,3,33473,4.094556574923548,0.0,0.0
8175,0,8175,[ 71  97  12 301 202],437,2,33475,4.0943003913894325,20.0,0.0
8176,0,8176,[ 64 483 313 318 187],618,5,33480,4.094411153234683,80.0,20.0
8177,0,8177,[ 64 483 313 318 187],618,5,33485,4.094521887992174,80.0,20.0
8178,0,8178,[ 64 483 313 318 187],618,5,33490,4.094632595671842,80.0,20.0
8179,0,8179,[172  69 245  79  50],128,3,33493,4.094498777506113,0.0,20.0
8180,0,8180,[ 79   4  97 194 185],405,3,33496,4.094364992054761,0.0,0.0
8181,0,8181,[ 64 483 313 318 187],618,5,33501,4.094475678318259,80.0,20.0
8182,0,8182,[ 70 286 568 323 288],345,2,33503,4.0942197238176705,0.0,20.0
8183,0,8183,[ 88 197  71 185 423],618,4,33507,4.094208211143695,0.0,0.0
8184,0,8184,[  7 143 202  25 271],297,3,33510,4.094074526572999,0.0,0.0
8185,0,8185,[ 97 655 423 471  11],618,4,33514,4.094063034449059,0.0,0.0
8186,0,8186,[ 64 483 313 318 187],618,5,33519,4.094173689996335,80.0,20.0
8187,0,8187,[ 70 176  50 135  97],198,3,33522,4.094040058622374,0.0,20.0
8188,0,8188,[471  95 234  28  88],416,3,33525,4.093906459885212,0.0,0.0
8189,0,8189,[222  64 257 235  15],43,4,33529,4.093894993894994,20.0,0.0
8190,0,8190,[195 210 228  98 174],297,3,33532,4.093761445488951,0.0,20.0
8191,0,8191,[597  69 173 237 357],854,3,33535,4.0936279296875,0.0,0.0
8192,0,8192,[257 385  70  50 237],416,3,33538,4.093494446478702,0.0,20.0
8193,0,8193,[ 64 483 313 318 187],618,5,33543,4.093605076885526,80.0,20.0
8194,0,8194,[ 70 185 238 143 235],416,4,33547,4.0935936546674805,0.0,0.0
8195,0,8195,[  1  95 135 357  28],698,2,33549,4.093338213762811,0.0,0.0
8196,0,8196,[ 82 200 197 273 191],618,4,33553,4.0933268268878855,0.0,0.0
8197,0,8197,[ 64 483 313 318 187],618,5,33558,4.093437423761893,80.0,20.0
8198,0,8198,[568 172 173 185 655],405,5,33563,4.093547993657763,0.0,0.0
8199,0,8199,[ 64 483 313 318 187],618,5,33568,4.093658536585366,80.0,20.0
8200,0,8200,[ 64 483 313 318 187],618,5,33573,4.093769052554567,80.0,20.0
8201,0,8201,[222 168 172 181  56],496,3,33576,4.093635698610095,0.0,20.0
8202,0,8202,[  9 200  15 405 202],764,5,33581,4.093746190418139,0.0,0.0
8203,0,8203,[117  96 196 322 195],416,4,33585,4.093734763529985,0.0,0.0
8204,0,8204,[ 64 483 313 318 187],618,5,33590,4.0938452163315056,80.0,20.0
8205,0,8205,[ 64 483 313 318 187],618,5,33595,4.093955642213015,80.0,20.0
8206,0,8206,[ 64 483 313 318 187],214,5,33600,4.094066041184355,80.0,20.0
8207,0,8207,[ 64 483 313 318 187],618,5,33605,4.094176413255361,80.0,20.0
8208,0,8208,[ 64 483 313 318 187],618,5,33610,4.094286758435863,80.0,20.0
8209,0,8209,[  1 143 275 174 318],262,2,33612,4.0940316686967115,20.0,0.0
8210,0,8210,[ 64 483 313 318 187],618,5,33617,4.094142004627938,80.0,20.0
8211,0,8211,[ 64 483 313 318 187],618,5,33622,4.094252313687287,80.0,20.0
8212,0,8212,[ 64 483 313 318 187],214,5,33627,4.094362595884573,80.0,20.0
8213,0,8213,[238 603  71  69  98],128,5,33632,4.094472851229608,0.0,20.0
8214,0,8214,[ 96   4   1 234  56],642,3,33635,4.09433962264151,0.0,0.0
8215,0,8215,[151 204 228  71 121],601,1,33636,4.0939629990262905,0.0,0.0
8216,0,8216,[ 64 483 313 318 187],618,5,33641,4.094073262747962,80.0,20.0
8217,0,8217,[237 318 313 173 471],43,4,33645,4.094061815526892,40.0,20.0
8218,0,8218,[ 64 483 313 318 187],618,5,33650,4.094172040394208,80.0,20.0
8219,0,8219,[ 64 483 313 318 187],618,5,33655,4.094282238442823,80.0,20.0
8220,0,8220,[173 183  71 318 475],601,4,33659,4.094270769979321,20.0,0.0
8221,0,8221,[275 483 228   9 191],698,1,33660,4.093894429579178,20.0,0.0
8222,0,8222,[ 64 483 313 318 187],214,5,33665,4.0940046211844825,80.0,20.0
8223,0,8223,[ 64 483 313 318 187],214,5,33670,4.094114785992218,80.0,20.0
8224,0,8224,[238 318 475 144 257],62,3,33673,4.093981762917933,20.0,0.0
8225,0,8225,[ 64 483 313 318 187],214,5,33678,4.094091903719913,80.0,20.0
8226,0,8226,[483 258 235   9 268],854,3,33681,4.093958915765164,20.0,0.0
8227,0,8227,[204 121 195 496 748],654,5,33686,4.094069032571706,0.0,0.0
8228,0,8228,[144   1 300 597 172],43,4,33690,4.094057601166606,0.0,0.0
8229,0,8229,[ 64 483 313 318 187],214,5,33695,4.094167679222357,80.0,20.0
8230,0,8230,[655 194 238  96 471],373,4,33699,4.0941562386101324,0.0,0.0
8231,0,8231,[132 286 275 471 568],416,5,33704,4.094266277939747,0.0,0.0
8232,0,8232,[ 64 483 313 318 187],618,5,33709,4.0943762905380785,80.0,20.0
8233,0,8233,[245 678 515 100 234],297,2,33711,4.094121933446685,0.0,0.0
8234,0,8234,[ 82 173   4 471 204],373,3,33714,4.093989071038251,0.0,0.0
8235,0,8235,[95 97 25 79  9],43,5,33719,4.094099077221952,0.0,0.0
8236,0,8236,[216  96 276  88 210],618,1,33720,4.0937234430010925,0.0,0.0
8237,0,8237,[ 97 195 301 333 153],416,5,33725,4.09383345472202,0.0,0.0
8238,0,8238,[  4 172 286 144   1],62,2,33727,4.093579317878383,0.0,0.0
8239,0,8239,[258 176 117 235  50],417,3,33730,4.093446601941747,0.0,20.0
8240,0,8240,[323 117  15 185   4],417,2,33732,4.093192573716782,0.0,0.0
8241,0,8241,[ 64 483 313 318 187],214,5,33737,4.09330259645717,80.0,20.0
8242,0,8242,[  1 186  12 515 181],417,4,33741,4.093291277447531,20.0,20.0
8243,0,8243,[318  15 222 258 179],721,4,33745,4.0932799611838915,20.0,0.0
8244,0,8244,[ 64 483 313 318 187],214,5,33750,4.0933899332929045,80.0,20.0
8245,0,8245,[  8  25 121 318 161],416,5,33755,4.093499878729081,20.0,0.0
8246,0,8246,[ 64 483 313 318 187],214,5,33760,4.093609797502122,80.0,20.0
8247,0,8247,[294 268 405 117   1],872,2,33762,4.093355965082444,0.0,0.0
8248,0,8248,[238  11 179 117 300],416,4,33766,4.093344647836101,0.0,0.0
8249,0,8249,[117 405 318   9  12],345,5,33771,4.093454545454545,40.0,0.0
8250,0,8250,[ 64 483 313 318 187],618,5,33776,4.093564416434371,80.0,20.0
8251,0,8251,[ 64 483 313 318 187],214,5,33781,4.0936742607852645,80.0,20.0
8252,0,8252,[268 282 318 202   1],907,5,33786,4.093784078516903,20.0,0.0
8253,0,8253,[ 64 483 313 318 187],214,5,33791,4.093893869638963,80.0,20.0
8254,0,8254,[302 182 257 483 202],417,3,33794,4.0937613567534825,20.0,0.0
8255,0,8255,[ 28 121 132 125 185],618,4,33798,4.09375,0.0,0.0
8256,0,8256,[172 234 202 176 196],437,4,33802,4.093738645997336,0.0,0.0
8257,0,8257,[179 268  28  15 289],721,4,33806,4.0937272947444905,0.0,0.0
8258,0,8258,[ 64 483 313 318 187],618,5,33811,4.093837026274367,80.0,20.0
8259,0,8259,[ 64 483 313 318 187],214,5,33816,4.093946731234867,80.0,20.0
8260,0,8260,[ 64 483 313 318 187],214,5,33821,4.0940564096356376,80.0,20.0
8261,0,8261,[275 385 269 301 276],43,5,33826,4.094166061486323,0.0,0.0
8262,0,8262,[294  22 273 173 568],805,1,33827,4.093791601113397,0.0,0.0
8263,0,8263,[ 97 135 405 117 313],642,3,33830,4.093659244917715,20.0,20.0
8264,0,8264,[ 64 483 313 318 187],618,5,33835,4.093768905021173,80.0,20.0
8265,0,8265,[ 64 483 313 318 187],214,5,33840,4.093878538591822,80.0,20.0
8266,0,8266,[ 64 483 313 318 187],618,5,33845,4.093988145639289,80.0,20.0
8267,0,8267,[275 202   4 238  15],416,5,33850,4.094097726173198,0.0,0.0
8268,0,8268,[ 64 483 313 318 187],618,5,33855,4.094207280203168,80.0,20.0
8269,0,8269,[ 64 483 313 318 187],214,5,33860,4.094316807738815,80.0,20.0
8270,0,8270,[475 161 385 202 403],588,1,33861,4.093942691331157,0.0,0.0
8271,0,8271,[ 50 204 328 245 228],62,1,33862,4.093568665377176,0.0,20.0
8272,0,8272,[195 678   7 237 210],416,3,33865,4.09343648011604,0.0,0.0
8273,0,8273,[ 11 195  50 161 211],437,2,33867,4.093183466279913,0.0,20.0
8274,0,8274,[385  79 257  88  82],43,5,33872,4.093293051359517,0.0,0.0
8275,0,8275,[ 64 483 313 318 187],214,5,33877,4.093402609956501,80.0,20.0
8276,0,8276,[ 64 483 313 318 187],214,5,33882,4.093512142080464,80.0,20.0
8277,0,8277,[  8  70 196 234 313],618,3,33885,4.093380043488765,20.0,20.0
8278,0,8278,[265   8 222  11 546],654,5,33890,4.093489551878246,0.0,0.0
8279,0,8279,[405 333 357   1 176],416,5,33895,4.093599033816425,0.0,0.0
8280,0,8280,[ 95 588 257 202 597],887,5,33900,4.093708489312885,0.0,0.0
8281,0,8281,[ 79 100 204  56 210],416,5,33905,4.093817918377203,0.0,0.0
8282,0,8282,[ 64 483 313 318 187],618,5,33910,4.093927321018954,80.0,20.0
8283,0,8283,[ 69 655 127 100 427],24,5,33915,4.094036697247707,0.0,0.0
8284,0,8284,[ 64 483 313 318 187],618,5,33920,4.094146047073023,80.0,20.0
8285,0,8285,[ 64 483 313 318 187],618,5,33925,4.094255370504466,80.0,20.0
8286,0,8286,[ 12 471 168 100 191],416,5,33930,4.094364667551587,20.0,0.0
8287,0,8287,[269 294 403 234 471],345,2,33932,4.094111969111969,0.0,0.0
8288,0,8288,[215 174 111 294  69],654,4,33936,4.094100615273254,0.0,0.0
8289,0,8289,[191 176 210 313 288],416,5,33941,4.094209891435464,20.0,40.0
8290,0,8290,[191 176 357 234  96],405,3,33944,4.094077915812327,0.0,0.0
8291,0,8291,[143 204 211 173  11],405,4,33948,4.094066570188133,0.0,0.0
8292,0,8292,[ 64 483 313 318 187],214,5,33953,4.0941758109248765,80.0,20.0
8293,0,8293,[  1 357 228  56  97],230,3,33956,4.094043887147335,0.0,0.0
8294,0,8294,[ 64 483 313 318 187],618,5,33961,4.094153104279687,80.0,20.0
8295,0,8295,[ 64 111  97 385 174],618,4,33965,4.09414175506268,20.0,0.0
8296,0,8296,[125 237 294  95 204],416,3,33968,4.094009883090274,0.0,0.0
8297,0,8297,[216 191 322 508  56],128,3,33971,4.093878042901904,0.0,0.0
8298,0,8298,[245 195 135 222 288],417,2,33973,4.0936257380407275,0.0,20.0
8299,0,8299,[ 64 483 313 318 187],214,5,33978,4.093734939759036,80.0,20.0
8300,0,8300,[471 174 204  69 546],416,4,33982,4.093723647753283,0.0,0.0
8301,0,8301,[ 64 483 313 318 187],214,5,33987,4.093832811370754,80.0,20.0
8302,0,8302,[176 173 222 475 748],297,4,33991,4.093821510297483,0.0,0.0
8303,0,8303,[ 64 483 313 318 187],618,5,33996,4.09393063583815,80.0,20.0
8304,0,8304,[ 64 483 313 318 187],214,5,34001,4.094039735099337,80.0,20.0
8305,0,8305,[ 64 483 313 318 187],214,5,34006,4.094148808090537,80.0,20.0
8306,0,8306,[151  28 257 742 173],297,2,34008,4.093896713615023,0.0,0.0
8307,0,8307,[ 64 483 313 318 187],618,5,34013,4.094005777563794,80.0,20.0
8308,0,8308,[ 64 483 313 318 187],214,5,34018,4.094114815260561,80.0,20.0
8309,0,8309,[161 235 268 568  88],416,3,34021,4.093983152827918,0.0,0.0
8310,0,8310,[ 89 318 194   9 294],854,3,34024,4.093851522079172,20.0,0.0
8311,0,8311,[204  64 153 237  15],198,2,34026,4.093599615014437,20.0,0.0
8312,0,8312,[288 286  79 268 300],297,2,34028,4.093347768555275,0.0,20.0
8313,0,8313,[294 245 289 238 655],345,2,34030,4.0930959826798174,0.0,0.0
8314,0,8314,[ 64 483 313 318 187],618,5,34035,4.093205051112448,80.0,20.0
8315,0,8315,[ 64 483 313 318 187],618,5,34040,4.093314093314094,80.0,20.0
8316,0,8316,[ 64 483 313 318 187],214,5,34045,4.093423109294217,80.0,20.0
8317,0,8317,[ 64 483 313 318 187],214,5,34050,4.0935320990622746,80.0,20.0
8318,0,8318,[186 228  64 515 268],417,4,34054,4.0935208558721,20.0,0.0
8319,0,8319,[ 64 483 313 318 187],214,5,34059,4.093629807692308,80.0,20.0
8320,0,8320,[ 69 111 282 496 181],128,3,34062,4.093498377598847,0.0,20.0
8321,0,8321,[121 174  79 200 237],416,4,34066,4.093487142513819,0.0,0.0
8322,0,8322,[  7   1 153 100  95],297,3,34069,4.093355761143818,0.0,0.0
8323,0,8323,[135 475  98 197  64],711,5,34074,4.0934646804420955,20.0,20.0
8324,0,8324,[117 265 257 176 471],416,4,34078,4.093453453453454,0.0,0.0
8325,0,8325,[ 64 483 313 318 187],618,5,34083,4.093562334854672,80.0,20.0
8326,0,8326,[ 64 483 313 318 187],214,5,34088,4.093671190104479,80.0,20.0
8327,0,8327,[ 64 483 313 318 187],214,5,34093,4.0937800192122955,80.0,20.0
8328,0,8328,[204 210  98 202 276],230,5,34098,4.093888822187537,0.0,20.0
8329,0,8329,[ 70 318  98 121 100],62,4,34102,4.093877551020408,20.0,20.0
8330,0,8330,[191 210  88 471 258],345,4,34106,4.093866282559117,0.0,0.0
8331,0,8331,[ 64 483 313 318 187],618,5,34111,4.0939750360057605,80.0,20.0
8332,0,8332,[ 64 483 313 318 187],618,5,34116,4.094083763350534,80.0,20.0
8333,0,8333,[ 64 483 313 318 187],214,5,34121,4.094192464602831,80.0,20.0
8334,0,8334,[ 28  50 179   7 237],262,2,34123,4.093941211757649,0.0,20.0
8335,0,8335,[ 64 483 313 318 187],618,5,34128,4.09404990403071,80.0,20.0
8336,0,8336,[ 64 483 313 318 187],214,5,34133,4.094158570229099,80.0,20.0
8337,0,8337,[202 268  88 313  50],416,4,34137,4.094147277524586,20.0,40.0
8338,0,8338,[ 64 483 313 318 187],214,5,34142,4.094255905983931,80.0,20.0
8339,0,8339,[151 423 202 483  11],417,5,34147,4.094364508393285,20.0,0.0
8340,0,8340,[ 64 483 313 318 187],214,5,34152,4.0944730847620185,80.0,20.0
8341,0,8341,[180 210  96 678 323],805,3,34155,4.094341884440182,0.0,0.0
8342,0,8342,[ 64 483 313 318 187],618,5,34160,4.094450437492509,80.0,20.0
8343,0,8343,[282 265 194 183 234],416,5,34165,4.094558964525407,0.0,0.0
8344,0,8344,[153 258 268  25 238],416,5,34170,4.094667465548232,0.0,0.0
8345,0,8345,[294  50 121  56 742],417,2,34172,4.094416486939852,0.0,20.0
8346,0,8346,[ 64 483 313 318 187],214,5,34177,4.094524979034383,80.0,20.0
8347,0,8347,[ 64 483 313 318 187],618,5,34182,4.09463344513656,80.0,20.0
8348,0,8348,[ 64 483 313 318 187],618,5,34187,4.094741885255719,80.0,20.0
8349,0,8349,[508 215 258 118   8],654,3,34190,4.094610778443114,0.0,0.0
8350,0,8350,[ 64 483 313 318 187],214,5,34195,4.094719195305951,80.0,20.0
8351,0,8351,[175 195  71 265 174],405,2,34197,4.094468390804598,0.0,0.0
8352,0,8352,[ 64 483 313 318 187],618,5,34202,4.094576798754939,80.0,20.0
8353,0,8353,[111 222 151 121  82],921,3,34205,4.094445774479292,0.0,0.0
8354,0,8354,[ 64 483 313 318 187],214,5,34210,4.094554159186116,80.0,20.0
8355,0,8355,[313 289   1 117 161],43,5,34215,4.094662517951173,20.0,20.0
8356,0,8356,[273  15 181 322  97],416,4,34219,4.094651190618643,0.0,20.0
8357,0,8357,[ 64 483 313 318 187],618,5,34224,4.094759511844939,80.0,20.0
8358,0,8358,[ 64 483 313 318 187],618,5,34229,4.094867807153966,80.0,20.0
8359,0,8359,[ 64 483 313 318 187],618,5,34234,4.094976076555024,80.0,20.0
8360,0,8360,[ 64 483 313 318 187],214,5,34239,4.095084320057409,80.0,20.0
8361,0,8361,[195 257 475 182 174],297,2,34241,4.094833771824923,0.0,0.0
8362,0,8362,[ 64 100   4 215 111],618,3,34244,4.094702857826139,20.0,0.0
8363,0,8363,[ 69 181  98  11 323],630,3,34247,4.094571975131516,0.0,40.0
8364,0,8364,[197 301 385 328 568],416,5,34252,4.094680215182307,0.0,0.0
8365,0,8365,[197 174  50 153 483],437,5,34257,4.094788429356921,20.0,20.0
8366,0,8366,[172  69 427 179 269],373,4,34261,4.094777100513924,0.0,0.0
8367,0,8367,[ 11 197   8 182 210],437,2,34263,4.094526768642448,0.0,0.0
8368,0,8368,[323 168 173 515 182],416,4,34267,4.094515473772255,0.0,0.0
8369,0,8369,[132 179 228 427 174],601,5,34272,4.094623655913979,0.0,0.0
8370,0,8370,[ 64 483 313 318 187],214,5,34277,4.094731812208816,80.0,20.0
8371,0,8371,[ 64 483 313 318 187],214,5,34282,4.09483994266603,80.0,20.0
8372,0,8372,[300 186 191  56 153],43,4,34286,4.094828615788845,0.0,0.0
8373,0,8373,[202  79 153 238 216],417,3,34289,4.094697874373059,0.0,0.0
8374,0,8374,[204  71 471 288 179],416,4,34293,4.094686567164179,0.0,20.0
8375,0,8375,[174 568 173   7 118],417,2,34295,4.094436485195797,0.0,0.0
8376,0,8376,[282 125 357 328 257],416,4,34299,4.094425211889698,0.0,0.0
8377,0,8377,[174 196 257   1 423],705,4,34303,4.094413941274767,0.0,0.0
8378,0,8378,[ 64 483 313 318 187],214,5,34308,4.0945220193340495,80.0,20.0
8379,0,8379,[ 97   9 423 286  98],62,2,34310,4.094272076372315,0.0,20.0
8380,0,8380,[ 64 483 313 318 187],618,5,34315,4.094380145567355,80.0,20.0
8381,0,8381,[ 64 483 313 318 187],618,5,34320,4.094488188976378,80.0,20.0
8382,0,8382,[ 64 483 313 318 187],214,5,34325,4.094596206608613,80.0,20.0
8383,0,8383,[ 64 483 313 318 187],618,5,34330,4.094704198473282,80.0,20.0
8384,0,8384,[ 64 483 313 318 187],214,5,34335,4.094812164579606,80.0,20.0
8385,0,8385,[210 323 403  98   8],805,3,34338,4.094681612210827,0.0,20.0
8386,0,8386,[ 64 483 313 318 187],618,5,34343,4.094789555264099,80.0,20.0
8387,0,8387,[ 64 483 313 318 187],618,5,34348,4.094897472579876,80.0,20.0
8388,0,8388,[173 269 132 471   1],854,3,34351,4.09476695672905,0.0,0.0
8389,0,8389,[ 64 483 313 318 187],214,5,34356,4.0948748510131106,80.0,20.0
8390,0,8390,[ 64 483 313 318 187],214,5,34361,4.094982719580503,80.0,20.0
8391,0,8391,[588   1  95 172 385],43,5,34366,4.0950905624404195,0.0,0.0
8392,0,8392,[ 64 483 313 318 187],214,5,34371,4.095198379602049,80.0,20.0
8393,0,8393,[ 64 483 313 318 187],214,5,34376,4.0953061710745775,80.0,20.0
8394,0,8394,[ 64 483 313 318 187],618,5,34381,4.095413936867183,80.0,20.0
8395,0,8395,[151 423 471  50 496],505,3,34384,4.095283468318247,0.0,20.0
8396,0,8396,[ 64 483 313 318 187],618,5,34389,4.095391211146838,80.0,20.0
8397,0,8397,[385 183  28 191 202],618,4,34393,4.095379852345797,0.0,0.0
8398,0,8398,[222   4 405  11 228],805,1,34394,4.095011310870341,0.0,0.0
8399,0,8399,[ 64 483 313 318 187],618,5,34399,4.095119047619048,80.0,20.0
8400,0,8400,[ 64 483 313 318 187],618,5,34404,4.0952267587192,80.0,20.0
8401,0,8401,[ 64 483 313 318 187],618,5,34409,4.095334444179957,80.0,20.0
8402,0,8402,[118 197 200 143 168],618,3,34412,4.095204093776032,0.0,0.0
8403,0,8403,[210 135   9 183  98],618,3,34415,4.095073774393146,0.0,20.0
8404,0,8404,[238  50 127   8 179],601,3,34418,4.094943486020226,0.0,20.0
8405,0,8405,[ 64 483 313 318 187],618,5,34423,4.095051153937663,80.0,20.0
8406,0,8406,[ 64 483 313 318 187],214,5,34428,4.095158796241227,80.0,20.0
8407,0,8407,[288 275 182 185 172],416,5,34433,4.095266412940057,0.0,20.0
8408,0,8408,[  8   1 173 143 288],297,3,34436,4.095136163634201,0.0,20.0
8409,0,8409,[ 98 179 100  56 257],214,4,34440,4.095124851367419,0.0,20.0
8410,0,8410,[357 161 546 273 144],417,1,34441,4.094756866008798,0.0,0.0
8411,0,8411,[216 423  96 202 302],416,5,34446,4.094864479315264,0.0,0.0
8412,0,8412,[ 64 483 313 318 187],214,5,34451,4.094972067039106,80.0,20.0
8413,0,8413,[ 64 483 313 318 187],618,5,34456,4.0950796291894465,80.0,20.0
8414,0,8414,[111 143 655 210 151],705,2,34458,4.094830659536542,0.0,0.0
8415,0,8415,[318 197 117 195 161],437,2,34460,4.094581749049429,20.0,0.0
8416,0,8416,[185 515 302 168  25],417,2,34462,4.094332897707021,0.0,0.0
8417,0,8417,[ 64 483 313 318 187],214,5,34467,4.094440484675695,80.0,20.0
8418,0,8418,[300   8  15 175 196],721,5,34472,4.094548046086233,0.0,0.0
8419,0,8419,[ 64 483 313 318 187],214,5,34477,4.094655581947744,80.0,20.0
8420,0,8420,[ 64 483 313 318 187],214,5,34482,4.094763092269327,80.0,20.0
8421,0,8421,[ 28 475 403 151 173],416,3,34485,4.094633103775825,0.0,0.0
8422,0,8422,[ 64 483 313 318 187],618,5,34490,4.094740591238276,80.0,20.0
8423,0,8423,[276 268  12  79 127],214,3,34493,4.094610636277303,20.0,0.0
8424,0,8424,[172 289 132 174 153],416,4,34497,4.09459940652819,0.0,0.0
8425,0,8425,[ 64 483 313 318 187],214,5,34502,4.094706859719914,80.0,20.0
8426,0,8426,[ 64 483 313 318 187],214,5,34507,4.094814287409517,80.0,20.0
8427,0,8427,[ 64 483 313 318 187],618,5,34512,4.094921689606075,80.0,20.0
8428,0,8428,[121 117  69 118 173],642,4,34516,4.094910428283308,0.0,0.0
8429,0,8429,[ 64 483 313 318 187],618,5,34521,4.095017793594306,80.0,20.0
8430,0,8430,[ 64 483 313 318 187],618,5,34526,4.095125133436128,80.0,20.0
8431,0,8431,[127 144 597   4  79],618,4,34530,4.0951138519924095,0.0,0.0
8432,0,8432,[222 597  71 322 161],805,1,34531,4.094746827937863,0.0,0.0
8433,0,8433,[  7  28 483 202  50],751,4,34535,4.094735594024188,20.0,20.0
8434,0,8434,[ 64 483 313 318 187],214,5,34540,4.09484291641968,80.0,20.0
8435,0,8435,[ 64 483 313 318 187],618,5,34545,4.094950213371266,80.0,20.0
8436,0,8436,[515 210 508 257 118],297,3,34548,4.094820433803485,0.0,0.0
8437,0,8437,[313 174 268 405  56],416,5,34553,4.094927707987675,20.0,20.0
8438,0,8438,[ 82 427  15 195 655],705,1,34554,4.094560966939211,0.0,0.0
8439,0,8439,[ 64 483 313 318 187],214,5,34559,4.094668246445497,80.0,20.0
8440,0,8440,[ 64 483 313 318 187],618,5,34564,4.094775500533112,80.0,20.0
8441,0,8441,[ 64 483 313 318 187],618,5,34569,4.094882729211087,80.0,20.0
8442,0,8442,[ 64 483 313 318 187],618,5,34574,4.094989932488452,80.0,20.0
8443,0,8443,[ 64 483 313 318 187],618,5,34579,4.095097110374231,80.0,20.0
8444,0,8444,[ 64 483 313 318 187],214,5,34584,4.095204262877442,80.0,20.0
8445,0,8445,[168 216  12 132 191],405,3,34587,4.095074591522614,20.0,0.0
8446,0,8446,[  7 235 294 276  69],416,3,34590,4.094944950870131,0.0,0.0
8447,0,8447,[ 64 483 313 318 187],214,5,34595,4.095052083333333,80.0,20.0
8448,0,8448,[ 64 483 313 318 187],618,5,34600,4.095159190436738,80.0,20.0
8449,0,8449,[ 97  15 302 258 294],43,5,34605,4.095266272189349,0.0,0.0
8450,0,8450,[ 88 515 180  95  82],405,1,34606,4.0949000118329195,0.0,0.0
8451,0,8451,[ 64 483 313 318 187],618,5,34611,4.0950070989115,80.0,20.0
8452,0,8452,[ 64 483 313 318 187],618,5,34616,4.095114160653023,80.0,20.0
8453,0,8453,[ 64 483 313 318 187],618,5,34621,4.095221197066477,80.0,20.0
8454,0,8454,[111 210 216 215 135],62,3,34624,4.095091661738616,0.0,0.0
8455,0,8455,[ 97 151 235 127 333],416,3,34627,4.09496215704825,0.0,0.0
8456,0,8456,[121 471  69 496  28],43,4,34631,4.094950928225139,0.0,0.0
8457,0,8457,[ 64 100 180 196 127],214,5,34636,4.095057933317569,20.0,0.0
8458,0,8458,[175 234 181 515 127],405,3,34639,4.094928478543563,0.0,20.0
8459,0,8459,[313 742 143 117  64],642,5,34644,4.095035460992908,40.0,20.0
8460,0,8460,[ 64 483 313 318 187],214,5,34649,4.095142418153882,80.0,20.0
8461,0,8461,[ 64 483 313 318 187],214,5,34654,4.095249350035453,80.0,20.0
8462,0,8462,[ 64 483 313 318 187],618,5,34659,4.095356256646579,80.0,20.0
8463,0,8463,[ 64 483 313 318 187],214,5,34664,4.095463137996219,80.0,20.0
8464,0,8464,[ 64 483 313 318 187],214,5,34669,4.095569994093325,80.0,20.0
8465,0,8465,[187  95 195 200  79],198,2,34671,4.095322466335932,0.0,0.0
8466,0,8466,[222  82  56  22 237],721,3,34674,4.095193102633755,0.0,0.0
8467,0,8467,[153 168 196 515 357],416,5,34679,4.0952999527633445,0.0,0.0
8468,0,8468,[ 64 483 313 318 187],214,5,34684,4.0954067776597,80.0,20.0
8469,0,8469,[161 143  88  22 475],711,5,34689,4.095513577331759,0.0,0.0
8470,0,8470,[117 181 174  96 135],417,1,34690,4.0951481525203635,0.0,20.0
8471,0,8471,[176 222 748  82 173],805,3,34693,4.095018885741266,0.0,0.0
8472,0,8472,[ 64 483 313 318 187],618,5,34698,4.095125693378969,80.0,20.0
8473,0,8473,[245 288 273  11   7],297,3,34701,4.094996459759264,0.0,20.0
8474,0,8474,[ 64 483 313 318 187],618,5,34706,4.095103244837758,80.0,20.0
8475,0,8475,[603  79  98 111 748],416,5,34711,4.095210004719207,0.0,20.0
8476,0,8476,[ 64 483 313 318 187],618,5,34716,4.095316739412528,80.0,20.0
8477,0,8477,[ 64 483 313 318 187],618,5,34721,4.095423448926634,80.0,20.0
8478,0,8478,[ 64 483 313 318 187],214,5,34726,4.095530133270433,80.0,20.0
8479,0,8479,[ 64 483 313 318 187],214,5,34731,4.09563679245283,80.0,20.0
8480,0,8480,[202 294 588 288 176],417,3,34734,4.095507605235231,0.0,20.0
8481,0,8481,[185  70 211 151 183],417,4,34738,4.095496345201603,0.0,0.0
8482,0,8482,[ 64 483 313 318 187],214,5,34743,4.095602970647176,80.0,20.0
8483,0,8483,[ 64 483 313 318 187],618,5,34748,4.095709570957096,80.0,20.0
8484,0,8484,[748 118 144 125  96],417,3,34751,4.095580436063642,0.0,0.0
8485,0,8485,[ 64 483 313 318 187],618,5,34756,4.0956870139052555,80.0,20.0
8486,0,8486,[ 64 483 313 318 187],214,5,34761,4.095793566631318,80.0,20.0
8487,0,8487,[ 64 483 313 318 187],214,5,34766,4.095900094250707,80.0,20.0
8488,0,8488,[ 64 483 313 318 187],618,5,34771,4.096006596772294,80.0,20.0
8489,0,8489,[ 64 483 313 318 187],214,5,34776,4.096113074204947,80.0,20.0
8490,0,8490,[ 64 483 313 318 187],214,5,34781,4.096219526557531,80.0,20.0
8491,0,8491,[ 64 483 313 318 187],214,5,34786,4.096325953838908,80.0,20.0
8492,0,8492,[ 64 483 313 318 187],214,5,34791,4.09643235605793,80.0,20.0
8493,0,8493,[ 64 483 313 318 187],214,5,34796,4.0965387332234515,80.0,20.0
8494,0,8494,[ 64 483 313 318 187],618,5,34801,4.096645085344321,80.0,20.0
8495,0,8495,[ 64 483 313 318 187],618,5,34806,4.096751412429379,80.0,20.0
8496,0,8496,[ 64 483 313 318 187],214,5,34811,4.0968577144874665,80.0,20.0
8497,0,8497,[ 64 483 313 318 187],214,5,34816,4.096963991527418,80.0,20.0
8498,0,8498,[ 64 483 313 318 187],618,5,34821,4.097070243558066,80.0,20.0
8499,0,8499,[  1 100  96 174  79],854,2,34823,4.096823529411765,0.0,0.0
8500,0,8500,[ 64 483 313 318 187],214,5,34828,4.096929772967886,80.0,20.0
8501,0,8501,[ 64 483 313 318 187],214,5,34833,4.0970359915314045,80.0,20.0
8502,0,8502,[ 50 118 286 182 195],416,4,34837,4.097024579560156,0.0,20.0
8503,0,8503,[475 100   7 234  95],416,3,34840,4.09689557855127,0.0,0.0
8504,0,8504,[ 69  64 151 161 568],618,4,34844,4.0968841857730744,20.0,0.0
8505,0,8505,[ 64 483 313 318 187],618,5,34849,4.096990359746061,80.0,20.0
8506,0,8506,[ 98 175 144  11 237],43,4,34853,4.096978958504761,0.0,20.0
8507,0,8507,[222 121   1  69 143],128,4,34857,4.096967559943582,0.0,0.0
8508,0,8508,[204 143  71 176 111],618,3,34860,4.0968386414384765,0.0,0.0
8509,0,8509,[ 95 357 546 173 135],297,3,34863,4.096709753231492,0.0,0.0
8510,0,8510,[ 64 483 313 318 187],618,5,34868,4.096815885324873,80.0,20.0
8511,0,8511,[143  70 191  64 210],345,5,34873,4.096921992481203,20.0,0.0
8512,0,8512,[ 64 483 313 318 187],214,5,34878,4.097028074709268,80.0,20.0
8513,0,8513,[ 56 186 568 742  89],417,3,34881,4.096899224806202,0.0,0.0
8514,0,8514,[289  11  69 318 333],345,3,34884,4.0967704051673515,20.0,0.0
8515,0,8515,[ 64 483 313 318 187],214,5,34889,4.09687646782527,80.0,20.0
8516,0,8516,[ 64 483 313 318 187],618,5,34894,4.096982505577081,80.0,20.0
8517,0,8517,[ 64 483 313 318 187],214,5,34899,4.097088518431557,80.0,20.0
8518,0,8518,[258   1 204  56 181],642,4,34903,4.097077121727902,0.0,20.0
8519,0,8519,[ 64 483 313 318 187],214,5,34908,4.097183098591549,80.0,20.0
8520,0,8520,[ 64 483 313 318 187],214,5,34913,4.097289050580918,80.0,20.0
8521,0,8521,[ 64 483 313 318 187],618,5,34918,4.097394977704764,80.0,20.0
8522,0,8522,[322 403  11 235 174],417,2,34920,4.097148891235481,0.0,0.0
8523,0,8523,[  1  28 268 204  98],297,3,34923,4.0970201783200375,0.0,20.0
8524,0,8524,[268 496 151   1  22],314,5,34928,4.0971260997067445,0.0,0.0
8525,0,8525,[ 64 483 313 318 187],618,5,34933,4.097231996246775,80.0,20.0
8526,0,8526,[ 64 483 313 318 187],618,5,34938,4.097337867948868,80.0,20.0
8527,0,8527,[202  96 176   9   8],416,5,34943,4.097443714821764,0.0,0.0
8528,0,8528,[ 64 483 313 318 187],214,5,34948,4.097549536874194,80.0,20.0
8529,0,8529,[ 64 483 313 318 187],214,5,34953,4.097655334114888,80.0,20.0
8530,0,8530,[ 64 483 313 318 187],214,5,34958,4.097761106552573,80.0,20.0
8531,0,8531,[ 64 483 313 318 187],618,5,34963,4.097866854195968,80.0,20.0
8532,0,8532,[ 69 357 268 125 322],721,4,34967,4.097855384975976,0.0,0.0
8533,0,8533,[127  70 143  79 182],405,3,34970,4.097726740098429,0.0,0.0
8534,0,8534,[ 28 423 222 322 143],679,2,34972,4.097480960749854,0.0,0.0
8535,0,8535,[ 70 471 194 144 173],416,5,34977,4.097586691658857,0.0,0.0
8536,0,8536,[597 151  70  71 234],642,2,34979,4.0973409862949515,0.0,0.0
8537,0,8537,[ 95 161   1 127 173],198,3,34982,4.0972124619348795,0.0,0.0
8538,0,8538,[187 294   7 195  95],505,1,34983,4.096849748214076,0.0,0.0
8539,0,8539,[ 64 483 313 318 187],214,5,34988,4.096955503512881,80.0,20.0
8540,0,8540,[ 98  71  11 125  88],416,4,34992,4.096944151738672,0.0,20.0
8541,0,8541,[ 64 483 313 318 187],618,5,34997,4.097049871224538,80.0,20.0
8542,0,8542,[ 64 483 313 318 187],618,5,35002,4.097155565960436,80.0,20.0
8543,0,8543,[182 294 151 403 191],417,5,35007,4.097261235955056,0.0,0.0
8544,0,8544,[ 69 568 318  56 181],588,4,35011,4.097249853715623,20.0,20.0
8545,0,8545,[ 64 483 313 318 187],618,5,35016,4.097355487947578,80.0,20.0
8546,0,8546,[301  82 276  12 215],437,2,35018,4.0971100971100975,20.0,0.0
8547,0,8547,[197 117 176 282  11],297,3,35021,4.096981750116987,0.0,0.0
8548,0,8548,[ 64 483 313 318 187],618,5,35026,4.097087378640777,80.0,20.0
8549,0,8549,[185  11 173 176 222],297,5,35031,4.09719298245614,0.0,0.0
8550,0,8550,[ 64 483 313 318 187],214,5,35036,4.097298561571746,80.0,20.0
8551,0,8551,[ 64 483 313 318 187],618,5,35041,4.097404115996258,80.0,20.0
8552,0,8552,[ 64 483 313 318 187],214,5,35046,4.097509645738337,80.0,20.0
8553,0,8553,[100 111 180  50 603],437,4,35050,4.097498246434417,0.0,20.0
8554,0,8554,[ 64 483 313 318 187],618,5,35055,4.09760374050263,80.0,20.0
8555,0,8555,[  4  12 294 471 289],854,1,35056,4.09724170172978,20.0,0.0
8556,0,8556,[742   1  56  71  28],588,5,35061,4.097347201121888,0.0,0.0
8557,0,8557,[185 111  98 508 173],49,2,35063,4.097102126665109,0.0,20.0
8558,0,8558,[ 64 483 313 318 187],214,5,35068,4.09720761771235,80.0,20.0
8559,0,8559,[ 64 483 313 318 187],618,5,35073,4.09731308411215,80.0,20.0
8560,0,8560,[185   4 132 100   8],618,3,35076,4.097184908305104,0.0,0.0
8561,0,8561,[ 64 483 313 318 187],214,5,35081,4.097290352721327,80.0,20.0
8562,0,8562,[ 79 286  12 210 568],588,5,35086,4.097395772509635,20.0,0.0
8563,0,8563,[ 64 483 313 318 187],618,5,35091,4.097501167678655,80.0,20.0
8564,0,8564,[ 50 508 195 179  11],214,4,35095,4.0974897840046705,0.0,20.0
8565,0,8565,[288 197 268 678 286],416,4,35099,4.09747840298856,0.0,20.0
8566,0,8566,[ 50 143 182 237 678],416,3,35102,4.097350297653787,0.0,20.0
8567,0,8567,[ 64 483 313 318 187],618,5,35107,4.097455648926237,80.0,20.0
8568,0,8568,[ 64 483 313 318 187],214,5,35112,4.097560975609756,80.0,20.0
8569,0,8569,[ 64 483 313 318 187],618,5,35117,4.097666277712952,80.0,20.0
8570,0,8570,[ 64 483 313 318 187],214,5,35122,4.097771555244429,80.0,20.0
8571,0,8571,[ 64 483 313 318 187],618,5,35127,4.097876808212786,80.0,20.0
8572,0,8572,[318 191  88  97 228],405,2,35129,4.0976321007815235,20.0,0.0
8573,0,8573,[288 204 168 655 238],62,2,35131,4.097387450431537,0.0,20.0
8574,0,8574,[ 64 483 313 318 187],214,5,35136,4.097492711370262,80.0,20.0
8575,0,8575,[ 22 197 196  28 269],416,5,35141,4.097597947761194,0.0,0.0
8576,0,8576,[742  69  12 144 568],314,4,35145,4.097586568730326,20.0,0.0
8577,0,8577,[ 64 483 313 318 187],214,5,35150,4.097691769643274,80.0,20.0
8578,0,8578,[180  95 187 403 435],405,2,35152,4.097447254924816,0.0,0.0
8579,0,8579,[100 195 748 323 135],417,2,35154,4.097202797202797,0.0,0.0
8580,0,8580,[ 64 483 313 318 187],618,5,35159,4.0973080060599,80.0,20.0
8581,0,8581,[ 64 483 313 318 187],214,5,35164,4.097413190398509,80.0,20.0
8582,0,8582,[151 655 202  12 195],417,5,35169,4.097518350227193,20.0,0.0
8583,0,8583,[328   1 357 118 301],416,4,35173,4.097506989748369,0.0,0.0
8584,0,8584,[273 100 187   9 318],618,4,35177,4.097495631916133,20.0,0.0
8585,0,8585,[183 257  97 179  56],416,3,35180,4.097367808059632,0.0,0.0
8586,0,8586,[678 144 175 546 172],805,3,35183,4.097240013974613,0.0,0.0
8587,0,8587,[ 64 483 313 318 187],214,5,35188,4.097345132743363,80.0,20.0
8588,0,8588,[ 64 483 313 318 187],214,5,35193,4.097450227034579,80.0,20.0
8589,0,8589,[ 64 483 313 318 187],618,5,35198,4.09755529685681,80.0,20.0
8590,0,8590,[ 64 483 313 318 187],214,5,35203,4.0976603422186,80.0,20.0
8591,0,8591,[ 64 483 313 318 187],214,5,35208,4.097765363128492,80.0,20.0
8592,0,8592,[ 79 135 403 153  71],373,3,35211,4.097637612009775,0.0,0.0
8593,0,8593,[197 117 228 135 568],373,3,35214,4.097509890621364,0.0,0.0
8594,0,8594,[ 64 483 313 318 187],618,5,35219,4.0976148923792906,80.0,20.0
8595,0,8595,[423 186 174 276 496],43,4,35223,4.097603536528618,0.0,0.0
8596,0,8596,[282 210 181  71   1],618,3,35226,4.097475863673375,0.0,20.0
8597,0,8597,[ 64 483 313 318 187],214,5,35231,4.097580832751802,80.0,20.0
8598,0,8598,[100 118  98 181 286],907,5,35236,4.097685777415979,0.0,40.0
8599,0,8599,[ 64 483 313 318 187],214,5,35241,4.0977906976744185,80.0,20.0
8600,0,8600,[228 748 222 216  50],198,2,35243,4.0975467968840835,0.0,20.0
8601,0,8601,[ 64 483 313 318 187],618,5,35248,4.097651708904906,80.0,20.0
8602,0,8602,[313  71 173 597 238],618,3,35251,4.0975241194932,20.0,20.0
8603,0,8603,[ 64 483 313 318 187],214,5,35256,4.097629009762901,80.0,20.0
8604,0,8604,[191 111 174  70 176],764,4,35260,4.097617664148751,0.0,0.0
8605,0,8605,[ 64 483 313 318 187],618,5,35265,4.09772251917267,80.0,20.0
8606,0,8606,[269 435 168 238 275],354,5,35270,4.097827349831532,0.0,0.0
8607,0,8607,[ 64 483 313 318 187],214,5,35275,4.097932156133829,80.0,20.0
8608,0,8608,[ 64 483 313 318 187],214,5,35280,4.098036938088048,80.0,20.0
8609,0,8609,[301 210 179 427   4],416,4,35284,4.098025551684088,0.0,0.0
8610,0,8610,[ 64 483 313 318 187],214,5,35289,4.098130298455464,80.0,20.0
8611,0,8611,[ 64 483 313 318 187],214,5,35294,4.098235020901068,80.0,20.0
8612,0,8612,[ 71 288 294 174  64],601,2,35296,4.097991408336236,20.0,20.0
8613,0,8613,[ 64 483 313 318 187],618,5,35301,4.098096122591131,80.0,20.0
8614,0,8614,[ 64 483 313 318 187],214,5,35306,4.098200812536274,80.0,20.0
8615,0,8615,[153 183 257 302  96],416,4,35310,4.098189415041783,0.0,0.0
8616,0,8616,[ 64 483 313 318 187],618,5,35315,4.098294069861901,80.0,20.0
8617,0,8617,[ 64 483 313 318 187],214,5,35320,4.098398700394523,80.0,20.0
8618,0,8618,[ 64 483 313 318 187],214,5,35325,4.098503306648103,80.0,20.0
8619,0,8619,[ 64 483 313 318 187],214,5,35330,4.098607888631091,80.0,20.0
8620,0,8620,[211 118 173 475 742],417,4,35334,4.098596450527781,0.0,0.0
8621,0,8621,[ 64 483 313 318 187],618,5,35339,4.098700997448388,80.0,20.0
8622,0,8622,[ 70 183  25 546 588],417,2,35341,4.09845761335962,0.0,0.0
8623,0,8623,[ 64 483 313 318 187],618,5,35346,4.098562152133581,80.0,20.0
8624,0,8624,[ 64 483 313 318 187],214,5,35351,4.0986666666666665,80.0,20.0
8625,0,8625,[ 64 483 313 318 187],618,5,35356,4.098771156967308,80.0,20.0
8626,0,8626,[282 121 742 118 191],854,1,35357,4.098411962443492,0.0,0.0
8627,0,8627,[ 64 483 313 318 187],618,5,35362,4.098516458043579,80.0,20.0
8628,0,8628,[202 568 181 117 121],345,3,35365,4.0983891528566465,0.0,20.0
8629,0,8629,[196  82   4 385 678],805,1,35366,4.098030127462341,0.0,0.0
8630,0,8630,[ 64 483 313 318 187],618,5,35371,4.098134630981346,80.0,20.0
8631,0,8631,[ 64 483 313 318 187],618,5,35376,4.098239110287303,80.0,20.0
8632,0,8632,[ 64 483 313 318 187],618,5,35381,4.098343565388625,80.0,20.0
8633,0,8633,[496 748  97 153  98],654,4,35385,4.098332175121612,0.0,20.0
8634,0,8634,[ 64 483 313 318 187],214,5,35390,4.098436595251882,80.0,20.0
8635,0,8635,[ 64 483 313 318 187],618,5,35395,4.09854099119963,80.0,20.0
8636,0,8636,[143  95 222 588  12],654,5,35400,4.098645362973254,20.0,0.0
8637,0,8637,[ 64 483 313 318 187],618,5,35405,4.098749710581153,80.0,20.0
8638,0,8638,[328 111 496 235 143],416,4,35409,4.098738279893507,0.0,0.0
8639,0,8639,[423 215   1 655  28],705,2,35411,4.098495370370371,0.0,0.0
8640,0,8640,[ 64 483 313 318 187],618,5,35416,4.0985996991089,80.0,20.0
8641,0,8641,[ 64 483 313 318 187],214,5,35421,4.098704003702847,80.0,20.0
8642,0,8642,[ 64 483 313 318 187],214,5,35426,4.098808284160592,80.0,20.0
8643,0,8643,[318   4 151 294  70],416,4,35430,4.098796853308653,20.0,0.0
8644,0,8644,[ 64 483 313 318 187],214,5,35435,4.0989010989010985,80.0,20.0
8645,0,8645,[216   4 597 174 200],417,1,35436,4.098542678695351,0.0,0.0
8646,0,8646,[237 143 174 568 471],43,4,35440,4.098531282525731,0.0,0.0
8647,0,8647,[ 64 483 313 318 187],214,5,35445,4.0986355226642,80.0,20.0
8648,0,8648,[ 28 678 328  56 405],416,4,35449,4.098624118395191,0.0,0.0
8649,0,8649,[173 273   7 216  28],297,5,35454,4.098728323699422,0.0,0.0
8650,0,8650,[ 70 176 228  89 187],405,1,35455,4.098370130620737,0.0,0.0
8651,0,8651,[ 64 483 313 318 187],618,5,35460,4.098474341192788,80.0,20.0
8652,0,8652,[ 64 483 313 318 187],214,5,35465,4.098578527678262,80.0,20.0
8653,0,8653,[172 257 168  82 475],601,3,35468,4.0984515830829675,0.0,0.0
8654,0,8654,[173 288 238 302 143],297,4,35472,4.098440207972271,0.0,20.0
8655,0,8655,[ 64 483 313 318 187],214,5,35477,4.098544362292052,80.0,20.0
8656,0,8656,[ 15  12 276 655 195],416,4,35481,4.098532979092064,20.0,0.0
8657,0,8657,[144 423 200 235 275],297,1,35482,4.098175098175099,0.0,0.0
8658,0,8658,[ 70 275   7  69 237],297,4,35486,4.098163760249451,0.0,0.0
8659,0,8659,[313 245 237 288 172],416,3,35489,4.098036951501155,20.0,40.0
8660,0,8660,[  9 185 588   1 176],416,5,35494,4.098141092252627,0.0,0.0
8661,0,8661,[ 64 483 313 318 187],618,5,35499,4.09824520895867,80.0,20.0
8662,0,8662,[276  70 405 168  82],62,3,35502,4.098118434722383,0.0,0.0
8663,0,8663,[  1 191 301 275 168],416,5,35507,4.098222530009234,0.0,0.0
8664,0,8664,[100 191  69   4 195],62,5,35512,4.098326601269475,0.0,0.0
8665,0,8665,[118 204 174 210 100],62,3,35515,4.09819986152781,0.0,0.0
8666,0,8666,[ 64 483 313 318 187],214,5,35520,4.098303911388023,80.0,20.0
8667,0,8667,[ 64 483 313 318 187],214,5,35525,4.098407937240425,80.0,20.0
8668,0,8668,[ 11 603  12 258 121],416,5,35530,4.098511939093321,20.0,0.0
8669,0,8669,[405   7 288 568 204],416,5,35535,4.098615916955017,0.0,20.0
8670,0,8670,[132 427 245 276 475],416,2,35537,4.098373889978088,0.0,0.0
8671,0,8671,[197  28 111   9 127],805,1,35538,4.098016605166052,0.0,0.0
8672,0,8672,[385  98 181 172 161],417,2,35540,4.09777470310158,0.0,40.0
8673,0,8673,[135 268  11 357 228],297,4,35544,4.097763430943048,0.0,0.0
8674,0,8674,[ 64 483 313 318 187],618,5,35549,4.097867435158501,80.0,20.0
8675,0,8675,[ 95  98 216 423 475],417,4,35553,4.0978561549100965,0.0,20.0
8676,0,8676,[ 64 483 313 318 187],214,5,35558,4.097960124466982,80.0,20.0
8677,0,8677,[181 202 111 100  98],345,4,35562,4.097948836137359,0.0,40.0
8678,0,8678,[ 50 210 204 313  70],43,5,35567,4.098052771056573,20.0,40.0
8679,0,8679,[196 181 655 186  82],405,4,35571,4.098041474654378,0.0,20.0
8680,0,8680,[121  95 175 294  82],805,1,35572,4.097684598548554,0.0,0.0
8681,0,8681,[185 748 204  95 258],297,2,35574,4.0974429854872145,0.0,0.0
8682,0,8682,[127 328  89  15 273],253,4,35578,4.097431763215479,0.0,0.0
8683,0,8683,[185 423 135 168 496],230,4,35582,4.097420543528328,0.0,0.0
8684,0,8684,[ 64 483 313 318 187],618,5,35587,4.097524467472654,80.0,20.0
8685,0,8685,[ 64 483 313 318 187],618,5,35592,4.0976283674879115,80.0,20.0
8686,0,8686,[ 64 483 313 318 187],214,5,35597,4.097732243582365,80.0,20.0
8687,0,8687,[195 268  64 197 238],416,5,35602,4.097836095764273,20.0,0.0
8688,0,8688,[289 234 144 318 302],416,4,35606,4.09782483599954,20.0,0.0
8689,0,8689,[483  71 183 318  98],618,5,35611,4.097928653624856,40.0,20.0
8690,0,8690,[  8 191  25 300  71],24,5,35616,4.098032447359337,0.0,0.0
8691,0,8691,[ 64 483 313 318 187],618,5,35621,4.098136217211229,80.0,20.0
8692,0,8692,[ 64 483 313 318 187],214,5,35626,4.098239963188773,80.0,20.0
8693,0,8693,[235  95 186 174 318],43,3,35629,4.098113641591903,20.0,0.0
8694,0,8694,[ 64 483 313 318 187],618,5,35634,4.098217366302473,80.0,20.0
8695,0,8695,[144 117  50 222 173],43,5,35639,4.098321067157314,0.0,20.0
8696,0,8696,[ 64 483 313 318 187],618,5,35644,4.098424744164655,80.0,20.0
8697,0,8697,[ 64 483 313 318 187],214,5,35649,4.0985283973327205,80.0,20.0
8698,0,8698,[ 64 483 313 318 187],618,5,35654,4.0986320266697325,80.0,20.0
8699,0,8699,[ 64 483 313 318 187],618,5,35659,4.098735632183908,80.0,20.0
8700,0,8700,[234 568 195 496 403],618,4,35663,4.098724284564993,0.0,0.0
8701,0,8701,[172   4  79 302  56],654,5,35668,4.098827855665364,0.0,0.0
8702,0,8702,[ 64 483 313 318 187],214,5,35673,4.098931402964495,80.0,20.0
8703,0,8703,[ 64 483 313 318 187],214,5,35678,4.099034926470588,80.0,20.0
8704,0,8704,[161 234  79 275 237],618,4,35682,4.099023549684089,0.0,0.0
8705,0,8705,[288 202 135 179  79],437,4,35686,4.099012175511142,0.0,20.0
8706,0,8706,[ 64 483 313 318 187],618,5,35691,4.099115654071436,80.0,20.0
8707,0,8707,[ 64 483 313 318 187],214,5,35696,4.0992191088654115,80.0,20.0
8708,0,8708,[ 64 483 313 318 187],214,5,35701,4.099322539901252,80.0,20.0
8709,0,8709,[ 64 483 313 318 187],214,5,35706,4.099425947187141,80.0,20.0
8710,0,8710,[ 64 483 313 318 187],214,5,35711,4.09952933073126,80.0,20.0
8711,0,8711,[ 64 483 313 318 187],618,5,35716,4.099632690541782,80.0,20.0
8712,0,8712,[ 64 483 313 318 187],214,5,35721,4.099736026626879,80.0,20.0
8713,0,8713,[742 294 385 273  28],805,0,35721,4.099265549690154,0.0,0.0
8714,0,8714,[ 64 483 313 318 187],214,5,35726,4.099368904188181,80.0,20.0
8715,0,8715,[286 742 273 211 202],297,3,35729,4.099242771913722,0.0,0.0
8716,0,8716,[ 64 483 313 318 187],618,5,35734,4.099346105311461,80.0,20.0
8717,0,8717,[ 64 483 313 318 187],618,5,35739,4.099449415003441,80.0,20.0
8718,0,8718,[100 546 183 186 172],417,2,35741,4.099208624842299,0.0,0.0
8719,0,8719,[ 64 483 313 318 187],618,5,35746,4.0993119266055045,80.0,20.0
8720,0,8720,[597 318 215 186 275],43,3,35749,4.099185873179681,20.0,0.0
8721,0,8721,[183  96 173  79   1],417,3,35752,4.099059848658564,0.0,0.0
8722,0,8722,[117 568 181 546  22],62,4,35756,4.099048492491115,0.0,20.0
8723,0,8723,[568  88 176 204 234],618,4,35760,4.099037138927097,0.0,0.0
8724,0,8724,[ 88  22 210  25 144],805,1,35761,4.098681948424069,0.0,0.0
8725,0,8725,[483 228 238  71 222],62,4,35765,4.0986706394682555,20.0,0.0
8726,0,8726,[ 64 483 313 318 187],618,5,35770,4.098773920018334,80.0,20.0
8727,0,8727,[185 258 186 127 588],417,3,35773,4.098648029330889,0.0,0.0
8728,0,8728,[ 64 483 313 318 187],214,5,35778,4.098751288807423,80.0,20.0
8729,0,8729,[ 64 483 313 318 187],214,5,35783,4.09885452462772,80.0,20.0
8730,0,8730,[ 64 483 313 318 187],214,5,35788,4.098957736799909,80.0,20.0
8731,0,8731,[ 64 483 313 318 187],618,5,35793,4.099060925332112,80.0,20.0
8732,0,8732,[100 182 385 111  22],416,5,35798,4.099164090232452,0.0,0.0
8733,0,8733,[ 64 483 313 318 187],618,5,35803,4.099267231509045,80.0,20.0
8734,0,8734,[ 79  96 100 273 173],417,1,35804,4.0989124212936465,0.0,0.0
8735,0,8735,[ 64 483 313 318 187],618,5,35809,4.0990155677655675,80.0,20.0
8736,0,8736,[ 64 483 313 318 187],214,5,35814,4.099118690626073,80.0,20.0
8737,0,8737,[269 427 423  97  98],711,4,35818,4.099107347219043,0.0,20.0
8738,0,8738,[ 64 483 313 318 187],214,5,35823,4.099210435976657,80.0,20.0
8739,0,8739,[257 300 655 282 385],416,4,35827,4.099199084668192,0.0,0.0
8740,0,8740,[ 98  79 403 210 237],588,2,35829,4.098958929184304,0.0,20.0
8741,0,8741,[ 98 568  97 183 282],416,5,35834,4.099061999542439,0.0,20.0
8742,0,8742,[ 98 655 496 216 423],437,5,35839,4.0991650463227725,0.0,20.0
8743,0,8743,[403 175 176  89   8],805,4,35843,4.099153705397987,0.0,0.0
8744,0,8744,[597 210 257 187  50],416,3,35846,4.099028016009148,0.0,20.0
8745,0,8745,[ 64 483 313 318 187],214,5,35851,4.099131031328607,80.0,20.0
8746,0,8746,[ 64 483 313 318 187],618,5,35856,4.099234023093632,80.0,20.0
8747,0,8747,[202  89 222 322  56],417,3,35859,4.0991083676268865,0.0,0.0
8748,0,8748,[168  96 121  71 483],601,2,35861,4.098868442107669,20.0,0.0
8749,0,8749,[333 508  50 117  71],345,3,35864,4.098742857142857,0.0,20.0
8750,0,8750,[483  79 168 196 111],128,4,35868,4.098731573534454,20.0,0.0
8751,0,8751,[ 64 483 313 318 187],618,5,35873,4.098834552102376,80.0,20.0
8752,0,8752,[ 64 483 313 318 187],214,5,35878,4.098937507140409,80.0,20.0
8753,0,8753,[ 64 483 313 318 187],618,5,35883,4.099040438656614,80.0,20.0
8754,0,8754,[ 64 483 313 318 187],618,5,35888,4.099143346659052,80.0,20.0
8755,0,8755,[ 64 483 313 318 187],214,5,35893,4.099246231155779,80.0,20.0
8756,0,8756,[174  70   7 173 151],764,4,35897,4.099234897796049,0.0,0.0
8757,0,8757,[ 64 483 313 318 187],618,5,35902,4.099337748344371,80.0,20.0
8758,0,8758,[ 82  69  25 174 385],373,3,35905,4.0992122388400505,0.0,0.0
8759,0,8759,[423 322 179 121 182],417,3,35908,4.099086757990867,0.0,0.0
8760,0,8760,[ 64 483 313 318 187],214,5,35913,4.099189590229426,80.0,20.0
8761,0,8761,[ 64 483 313 318 187],618,5,35918,4.099292398995663,80.0,20.0
8762,0,8762,[ 64  97 117  71 143],705,3,35921,4.099166951957092,20.0,0.0
8763,0,8763,[  9 286 144 546 204],416,4,35925,4.099155636695572,0.0,0.0
8764,0,8764,[176 181  97 678 435],297,3,35928,4.099030233884769,0.0,20.0
8765,0,8765,[ 64 483 313 318 187],214,5,35933,4.099133013917408,80.0,20.0
8766,0,8766,[ 64 483 313 318 187],618,5,35938,4.0992357705030225,80.0,20.0
8767,0,8767,[ 64 483 313 318 187],214,5,35943,4.099338503649635,80.0,20.0
8768,0,8768,[ 11 568 117 176 100],416,5,35948,4.099441213365264,0.0,0.0
8769,0,8769,[ 64 483 313 318 187],618,5,35953,4.099543899657925,80.0,20.0
8770,0,8770,[ 64 483 313 318 187],214,5,35958,4.099646562535629,80.0,20.0
8771,0,8771,[323   8 597 161  25],43,3,35961,4.09952120383037,0.0,0.0
8772,0,8772,[ 64 483 313 318 187],618,5,35966,4.099623845890801,80.0,20.0
8773,0,8773,[222 313 275 153   8],654,5,35971,4.099726464554365,20.0,20.0
8774,0,8774,[ 25 181 210 174 496],417,0,35971,4.099259259259259,0.0,20.0
8775,0,8775,[603 258 228 748   9],805,1,35972,4.09890610756609,0.0,0.0
8776,0,8776,[ 64 483 313 318 187],618,5,35977,4.099008772929247,80.0,20.0
8777,0,8777,[  1 328 117   8 168],854,2,35979,4.098769651401231,0.0,0.0
8778,0,8778,[  7 215 275  15 216],618,2,35981,4.098530584349015,0.0,0.0
8779,0,8779,[ 64 483 313 318 187],618,5,35986,4.098633257403189,80.0,20.0
8780,0,8780,[100 196 144 118 603],805,2,35988,4.098394260334814,0.0,0.0
8781,0,8781,[ 12  70 127 257   1],630,2,35990,4.098155317695285,20.0,0.0
8782,0,8782,[ 64 483 313 318 187],618,5,35995,4.0982579984060115,80.0,20.0
8783,0,8783,[ 64 483 313 318 187],618,5,36000,4.098360655737705,80.0,20.0
8784,0,8784,[ 64 483 313 318 187],618,5,36005,4.0984632896983495,80.0,20.0
8785,0,8785,[ 64 483 313 318 187],214,5,36010,4.098565900295926,80.0,20.0
8786,0,8786,[ 15 204  22 276 508],601,3,36013,4.0984408785706155,0.0,0.0
8787,0,8787,[427 174 282 286 257],705,3,36016,4.098315885298134,0.0,0.0
8788,0,8788,[ 69 258 257 202  28],43,5,36021,4.098418477642507,0.0,0.0
8789,0,8789,[ 64 483 313 318 187],214,5,36026,4.0985210466439135,80.0,20.0
8790,0,8790,[181 222 202 118 111],417,2,36028,4.098282334205438,0.0,20.0
8791,0,8791,[ 64 483 313 318 187],214,5,36033,4.098384895359418,80.0,20.0
8792,0,8792,[318 235 111 187  25],887,3,36036,4.098259979529171,20.0,0.0
8793,0,8793,[ 25  28  79 568 216],128,4,36040,4.098248806004094,0.0,0.0
8794,0,8794,[748 127 515 588 182],417,4,36044,4.098237635019897,0.0,0.0
8795,0,8795,[ 64 483 313 318 187],214,5,36049,4.098340154615735,80.0,20.0
8796,0,8796,[168 294 237 276 118],62,2,36051,4.0981016255541665,0.0,0.0
8797,0,8797,[ 64 483 313 318 187],214,5,36056,4.098204137303933,80.0,20.0
8798,0,8798,[ 64 483 313 318 187],618,5,36061,4.098306625752927,80.0,20.0
8799,0,8799,[200 273 176 313 423],618,5,36066,4.098409090909091,20.0,20.0
8800,0,8800,[200 125  28  69  22],416,5,36071,4.098511532780366,0.0,0.0
8801,0,8801,[471 300   7  98  22],416,5,36076,4.098613951374688,0.0,20.0
8802,0,8802,[174 597 151 742 273],416,3,36079,4.0984891514256505,0.0,0.0
8803,0,8803,[ 64 483 313 318 187],214,5,36084,4.098591549295775,80.0,20.0
8804,0,8804,[ 64 483 313 318 187],618,5,36089,4.098693923906871,80.0,20.0
8805,0,8805,[ 64 483 313 318 187],618,5,36094,4.098796275266864,80.0,20.0
8806,0,8806,[118 235 423 121 258],805,0,36094,4.09833087316907,0.0,0.0
8807,0,8807,[ 88  56 385  64 423],416,4,36098,4.098319709355132,20.0,0.0
8808,0,8808,[  7 237 172 185 546],416,3,36101,4.098195027812465,0.0,0.0
8809,0,8809,[ 64 483 313 318 187],618,5,36106,4.098297389330306,80.0,20.0
8810,0,8810,[ 98 269 748 328 132],416,5,36111,4.098399727613211,0.0,20.0
8811,0,8811,[ 89 185 257 176 191],854,3,36114,4.098275079437131,0.0,0.0
8812,0,8812,[215  64 568 143 132],128,3,36117,4.098150459548394,20.0,0.0
8813,0,8813,[183 202 204 144  25],698,0,36117,4.097685500340368,0.0,0.0
8814,0,8814,[282 216 328 286 161],416,5,36122,4.097787861599547,0.0,0.0
8815,0,8815,[ 64 483 313 318 187],618,5,36127,4.097890199637024,80.0,20.0
8816,0,8816,[568 153 318   4 125],416,5,36132,4.097992514460701,20.0,0.0
8817,0,8817,[228 597 179 288  98],805,2,36134,4.0977545928782035,0.0,40.0
8818,0,8818,[ 64 483 313 318 187],214,5,36139,4.09785689987527,80.0,20.0
8819,0,8819,[118 496  25 265 132],618,3,36142,4.097732426303855,0.0,0.0
8820,0,8820,[127 195 288  50 204],416,5,36147,4.097834712617617,0.0,40.0
8821,0,8821,[ 64 483 313 318 187],618,5,36152,4.097936975742462,80.0,20.0
8822,0,8822,[ 64 483 313 318 187],618,5,36157,4.098039215686274,80.0,20.0
8823,0,8823,[151 471 204 288   8],416,4,36161,4.0980281051677245,0.0,20.0
8824,0,8824,[ 64 483 313 318 187],214,5,36166,4.098130311614731,80.0,20.0
8825,0,8825,[ 22 423   7 475 187],416,4,36170,4.098119193292545,0.0,0.0
8826,0,8826,[ 82 282  56 197 546],416,4,36174,4.09810807748952,0.0,0.0
8827,0,8827,[ 64 483 313 318 187],618,5,36179,4.098210240144994,80.0,20.0
8828,0,8828,[183 118 185  70 216],198,2,36181,4.0979725903273305,0.0,0.0
8829,0,8829,[ 64 483 313 318 187],618,5,36186,4.098074745186863,80.0,20.0
8830,0,8830,[ 64 483 313 318 187],618,5,36191,4.098176876910882,80.0,20.0
8831,0,8831,[ 64 483 313 318 187],214,5,36196,4.098278985507246,80.0,20.0
8832,0,8832,[ 22 300 194 323 179],721,4,36200,4.098267859164497,0.0,0.0
8833,0,8833,[  1 210 200 135 121],618,4,36204,4.098256735340729,0.0,0.0
8834,0,8834,[ 64 483 313 318 187],214,5,36209,4.0983588002263724,80.0,20.0
8835,0,8835,[435 194 588 135 202],297,2,36211,4.098121321865097,0.0,0.0
8836,0,8836,[234 195 176 302 173],297,3,36214,4.0979970578250535,0.0,0.0
8837,0,8837,[ 64 483 313 318 187],618,5,36219,4.098099117447386,80.0,20.0
8838,0,8838,[ 64 135 121 357 258],854,4,36223,4.098088019006675,20.0,0.0
8839,0,8839,[ 64 483 313 318 187],618,5,36228,4.098190045248868,80.0,20.0
8840,0,8840,[ 25 191  70  15  82],416,5,36233,4.098292048410813,0.0,0.0
8841,0,8841,[237  56 748 423 678],297,2,36235,4.09805473874689,0.0,0.0
8842,0,8842,[ 64 483 313 318 187],214,5,36240,4.098156734139998,80.0,20.0
8843,0,8843,[ 71   8 121 200 175],49,1,36241,4.097806422433288,0.0,0.0
8844,0,8844,[ 64 483 313 318 187],618,5,36246,4.097908422837762,80.0,20.0
8845,0,8845,[111  82  56 200   1],49,1,36247,4.097558218403798,0.0,0.0
8846,0,8846,[ 50 172   9 144 328],62,3,36250,4.097434158471798,0.0,20.0
8847,0,8847,[ 64 483 313 318 187],214,5,36255,4.0975361663652805,80.0,20.0
8848,0,8848,[118   1 385 222 742],417,3,36258,4.097412136964628,0.0,0.0
8849,0,8849,[237 118 144  12 172],43,5,36263,4.097514124293785,20.0,0.0
8850,0,8850,[204 175 183 174  79],198,2,36265,4.097277143825557,0.0,0.0
8851,0,8851,[ 79 235 191 238 196],43,3,36268,4.0971531857207415,0.0,0.0
8852,0,8852,[ 64 483 313 318 187],618,5,36273,4.097255167739749,80.0,20.0
8853,0,8853,[289 215 125 597 318],588,3,36276,4.097131240117461,20.0,0.0
8854,0,8854,[ 64 483 313 318 187],214,5,36281,4.0972332015810276,80.0,20.0
8855,0,8855,[ 25 191 318 185   8],711,5,36286,4.097335140018067,20.0,0.0
8856,0,8856,[194   1  56 196 333],416,5,36291,4.097437055436378,0.0,0.0
8857,0,8857,[ 64 483 313 318 187],214,5,36296,4.097538947843757,80.0,20.0
8858,0,8858,[ 50  98 405 235 210],417,1,36297,4.0971892990179475,0.0,40.0
8859,0,8859,[ 11 183 275 423 496],437,3,36300,4.0970654627539504,0.0,0.0
8860,0,8860,[ 64 483 313 318 187],214,5,36305,4.097167362600158,80.0,20.0
8861,0,8861,[ 64 483 313 318 187],214,5,36310,4.097269239449334,80.0,20.0
8862,0,8862,[135 268  12 195 127],214,3,36313,4.097145436082591,20.0,0.0
8863,0,8863,[385  95 125 179 300],416,3,36316,4.097021660649819,0.0,0.0
8864,0,8864,[ 64 483 313 318 187],618,5,36321,4.0971235194585445,80.0,20.0
8865,0,8865,[748 328 588 403 151],373,3,36324,4.096999774419129,0.0,0.0
8866,0,8866,[204 100 268 269   8],416,5,36329,4.0971016127213264,0.0,0.0
8867,0,8867,[ 64 483 313 318 187],214,5,36334,4.0972034280559315,80.0,20.0
8868,0,8868,[235 176 111 427 288],416,4,36338,4.09719246814748,0.0,20.0
8869,0,8869,[ 64 483 313 318 187],618,5,36343,4.097294250281849,80.0,20.0
8870,0,8870,[183  25 111 302 117],297,4,36347,4.097283282606245,0.0,0.0
8871,0,8871,[ 64 483 313 318 187],618,5,36352,4.097385031559964,80.0,20.0
8872,0,8872,[ 64 483 313 318 187],618,5,36357,4.097486757579173,80.0,20.0
8873,0,8873,[ 64 483 313 318 187],618,5,36362,4.097588460671625,80.0,20.0
8874,0,8874,[273 195 245 174 117],297,3,36365,4.0974647887323945,0.0,0.0
8875,0,8875,[323 405 301 100 357],416,4,36369,4.097453808021632,0.0,0.0
8876,0,8876,[ 64 483 313 318 187],214,5,36374,4.097555480455108,80.0,20.0
8877,0,8877,[ 64 483 313 318 187],618,5,36379,4.09765712998423,80.0,20.0
8878,0,8878,[318 423 181 143 234],588,4,36383,4.097646131321095,20.0,20.0
8879,0,8879,[ 64 483 313 318 187],618,5,36388,4.097747747747747,80.0,20.0
8880,0,8880,[173   7   1 111 515],417,3,36391,4.0976241414255155,0.0,0.0
8881,0,8881,[174 172  64 234 195],618,4,36395,4.097613150191398,20.0,0.0
8882,0,8882,[  7  96  79 423 333],854,3,36398,4.097489586851289,0.0,0.0
8883,0,8883,[153 179 483 475 121],601,4,36402,4.09747861323728,20.0,0.0
8884,0,8884,[ 64 483 313 318 187],214,5,36407,4.097580191333709,80.0,20.0
8885,0,8885,[ 64 483 313 318 187],618,5,36412,4.097681746567634,80.0,20.0
8886,0,8886,[ 64 483 313 318 187],214,5,36417,4.0977832789467765,80.0,20.0
8887,0,8887,[216 748 435 286   8],297,3,36420,4.097659765976598,0.0,0.0
8888,0,8888,[ 64 483 313 318 187],214,5,36425,4.097761277984025,80.0,20.0
8889,0,8889,[ 64 483 313 318 187],214,5,36430,4.097862767154106,80.0,20.0
8890,0,8890,[ 64 483 313 318 187],214,5,36435,4.097964233494545,80.0,20.0
8891,0,8891,[ 64 483 313 318 187],214,5,36440,4.098065677013046,80.0,20.0
8892,0,8892,[678 196 286  71 302],416,4,36444,4.098054649724502,0.0,0.0
8893,0,8893,[ 64 483 313 318 187],618,5,36449,4.098156060265348,80.0,20.0
8894,0,8894,[216 135 222 748   1],198,3,36452,4.0980326025857226,0.0,0.0
8895,0,8895,[333 197 182  88 117],416,4,36456,4.098021582733813,0.0,0.0
8896,0,8896,[118 135 286 173 405],62,2,36458,4.097785770484433,0.0,0.0
8897,0,8897,[655 748 228  11 117],198,2,36460,4.09755001123848,0.0,0.0
8898,0,8898,[269 405 151 234  79],416,4,36464,4.0975390493313855,0.0,0.0
8899,0,8899,[ 64 483 313 318 187],618,5,36469,4.097640449438202,80.0,20.0
8900,0,8900,[ 64 483 313 318 187],618,5,36474,4.097741826761038,80.0,20.0
8901,0,8901,[ 64 483 313 318 187],214,5,36479,4.097843181307572,80.0,20.0
8902,0,8902,[ 64 483 313 318 187],618,5,36484,4.097944513085477,80.0,20.0
8903,0,8903,[ 56 257 118  64 125],642,4,36488,4.0979335130278525,20.0,0.0
8904,0,8904,[ 64 483 313 318 187],618,5,36493,4.098034811903425,80.0,20.0
8905,0,8905,[427 100 475 282  96],907,4,36497,4.098023804176959,0.0,0.0
8906,0,8906,[ 64 483 313 318 187],618,5,36502,4.098125070169529,80.0,20.0
8907,0,8907,[ 64 483 313 318 187],618,5,36507,4.098226313426133,80.0,20.0
8908,0,8908,[568 269 161   7 121],43,5,36512,4.0983275339544285,0.0,0.0
8909,0,8909,[118 300 132 301 269],345,3,36515,4.098204264870931,0.0,0.0
8910,0,8910,[282 427 127 313 275],618,3,36518,4.098081023454157,20.0,20.0
8911,0,8911,[294 655 597   1 185],805,2,36520,4.097845601436266,0.0,0.0
8912,0,8912,[183 194 125 195 603],416,5,36525,4.097946819252777,0.0,0.0
8913,0,8913,[ 64 483 313 318 187],214,5,36530,4.098048014359435,80.0,20.0
8914,0,8914,[ 64 483 313 318 187],618,5,36535,4.098149186763881,80.0,20.0
8915,0,8915,[ 15  56 496  95 265],654,4,36539,4.098138178555406,0.0,0.0
8916,0,8916,[174 265 238  98 405],198,3,36542,4.098015027475609,0.0,20.0
8917,0,8917,[195  89 197 111  98],805,3,36545,4.097891904014353,0.0,20.0
8918,0,8918,[603 508 300 135 234],297,3,36548,4.09776880816235,0.0,0.0
8919,0,8919,[ 64 483 313 318 187],214,5,36553,4.097869955156951,80.0,20.0
8920,0,8920,[127  71 269 117  96],416,5,36558,4.097971079475395,0.0,0.0
8921,0,8921,[173 234 588 215 182],437,2,36560,4.097735933647164,0.0,0.0
8922,0,8922,[ 64 483 313 318 187],214,5,36565,4.0978370503193995,80.0,20.0
8923,0,8923,[588  28 176 289 237],764,5,36570,4.097938144329897,0.0,0.0
8924,0,8924,[215 268 179 275 322],128,1,36571,4.097591036414566,0.0,0.0
8925,0,8925,[ 64 483 313 318 187],214,5,36576,4.0976921353349764,80.0,20.0
8926,0,8926,[168 216 183 234 546],297,3,36579,4.097569172174302,0.0,0.0
8927,0,8927,[265 118  11 471 318],618,3,36582,4.09744623655914,20.0,0.0
8928,0,8928,[289 273 182 117 322],416,3,36585,4.097323328480233,0.0,0.0
8929,0,8929,[ 64 483 313 318 187],214,5,36590,4.097424412094065,80.0,20.0
8930,0,8930,[ 64 483 313 318 187],618,5,36595,4.097525473071324,80.0,20.0
8931,0,8931,[423 215  70 301 496],43,5,36600,4.097626511419615,0.0,0.0
8932,0,8932,[ 95 742 211  11 153],297,3,36603,4.097503638195455,0.0,0.0
8933,0,8933,[655 275 568 210  69],416,5,36608,4.097604656368928,0.0,0.0
8934,0,8934,[168 174   1 313  50],654,5,36613,4.09770565193061,20.0,40.0
8935,0,8935,[176 276  98 423 197],198,3,36616,4.097582811101164,0.0,20.0
8936,0,8936,[ 64 483 313 318 187],214,5,36621,4.097683786505539,80.0,20.0
8937,0,8937,[ 64 483 313 318 187],618,5,36626,4.097784739315283,80.0,20.0
8938,0,8938,[100   7 300 515 182],297,3,36629,4.09766193086475,0.0,0.0
8939,0,8939,[118 271 385 153 294],43,4,36633,4.097651006711409,0.0,0.0
8940,0,8940,[111 173  25 215 151],618,1,36634,4.097304552063528,0.0,0.0
8941,0,8941,[ 69 271 276   9 210],62,4,36638,4.097293670319839,0.0,0.0
8942,0,8942,[357 151  79 121 174],214,5,36643,4.097394610309739,0.0,0.0
8943,0,8943,[161 228 235  11  89],417,2,36645,4.097160107334526,0.0,0.0
8944,0,8944,[215 121 282 238 268],345,3,36648,4.097037451089994,0.0,0.0
8945,0,8945,[300  12 185  25 210],416,5,36653,4.09713838587078,20.0,0.0
8946,0,8946,[ 64 483 313 318 187],214,5,36658,4.097239298088745,80.0,20.0
8947,0,8947,[ 64  25 568 151 318],373,5,36663,4.097340187751453,40.0,0.0
8948,0,8948,[ 64 483 313 318 187],618,5,36668,4.097441054866466,80.0,20.0
8949,0,8949,[ 64 483 313 318 187],618,5,36673,4.097541899441341,80.0,20.0
8950,0,8950,[ 64 483 313 318 187],214,5,36678,4.097642721483633,80.0,20.0
8951,0,8951,[ 64 483 313 318 187],214,5,36683,4.0977435210008935,80.0,20.0
8952,0,8952,[269 151 176 144 195],297,2,36685,4.097509214788339,0.0,0.0
8953,0,8953,[ 64 483 313 318 187],214,5,36690,4.097610006700916,80.0,20.0
8954,0,8954,[ 64 483 313 318 187],618,5,36695,4.097710776102736,80.0,20.0
8955,0,8955,[300  28 333 132 100],416,5,36700,4.09781152300134,0.0,0.0
8956,0,8956,[ 71 127 748  69  88],505,2,36702,4.0975773138327565,0.0,0.0
8957,0,8957,[ 64 483 313 318 187],618,5,36707,4.097678053136861,80.0,20.0
8958,0,8958,[ 64 483 313 318 187],618,5,36712,4.097778769952003,80.0,20.0
8959,0,8959,[215  56 197 194 204],416,5,36717,4.097879464285715,0.0,0.0
8960,0,8960,[ 64 483 313 318 187],618,5,36722,4.0979801361455195,80.0,20.0
8961,0,8961,[237 211   8  12  88],416,3,36725,4.097857621066726,20.0,0.0
8962,0,8962,[ 25 172   4 151 258],654,4,36729,4.097846703112797,0.0,0.0
8963,0,8963,[  7 210  98 405 289],416,4,36733,4.097835787594824,0.0,20.0
8964,0,8964,[ 64 483 313 318 187],618,5,36738,4.097936419408812,80.0,20.0
8965,0,8965,[ 64 483 313 318 187],214,5,36743,4.098037028775374,80.0,20.0
8966,0,8966,[174 181 258  69 117],642,4,36747,4.098026095684175,0.0,20.0
8967,0,8967,[328 194 273 100 289],854,2,36749,4.097792149866191,0.0,0.0
8968,0,8968,[ 64 483 313 318 187],618,5,36754,4.097892741665738,80.0,20.0
8969,0,8969,[ 22 143  95 435 300],698,1,36755,4.097547380156076,0.0,0.0
8970,0,8970,[302 144 121 234   1],417,2,36757,4.097313565934678,0.0,0.0
8971,0,8971,[238 245 121 568   7],416,4,36761,4.097302719572002,0.0,0.0
8972,0,8972,[196 235 742 127 168],805,1,36762,4.09695753928452,0.0,0.0
8973,0,8973,[405 185 222 294 202],805,2,36764,4.096723868954758,0.0,0.0
8974,0,8974,[ 64 483 313 318 187],214,5,36769,4.096824512534819,80.0,20.0
8975,0,8975,[ 64 427  71 655  82],711,3,36772,4.096702317290553,20.0,0.0
8976,0,8976,[237 423  22 197 385],618,4,36776,4.096691545059596,0.0,0.0
8977,0,8977,[588   1 210 748  15],654,4,36780,4.096680775228336,0.0,0.0
8978,0,8978,[118 100 282 597 183],416,3,36783,4.096558636819245,0.0,0.0
8979,0,8979,[ 64 483 313 318 187],214,5,36788,4.096659242761692,80.0,20.0
8980,0,8980,[ 22 597 678 357 143],416,3,36791,4.0965371339494485,0.0,0.0
8981,0,8981,[  8  82 191 423 385],618,4,36795,4.096526386105545,0.0,0.0
8982,0,8982,[ 64 483 313 318 187],214,5,36800,4.096626962039408,80.0,20.0
8983,0,8983,[ 64 483 313 318 187],214,5,36805,4.096727515583259,80.0,20.0
8984,0,8984,[ 64 483 313 318 187],214,5,36810,4.096828046744574,80.0,20.0
8985,0,8985,[ 97 125  64 222 273],253,3,36813,4.09670598709103,20.0,0.0
8986,0,8986,[ 64 483 313 318 187],618,5,36818,4.096806498275287,80.0,20.0
8987,0,8987,[655 153 204 603 172],437,5,36823,4.096906987093903,0.0,0.0
8988,0,8988,[181  22 143 318  15],588,5,36828,4.097007453554344,20.0,20.0
8989,0,8989,[ 64 483 313 318 187],214,5,36833,4.097107897664071,80.0,20.0
8990,0,8990,[ 64 483 313 318 187],618,5,36838,4.097208319430542,80.0,20.0
8991,0,8991,[276 204  12 187 288],618,2,36840,4.096975088967971,20.0,20.0
8992,0,8992,[121 174 172 323 204],345,3,36843,4.096853107972867,0.0,0.0
8993,0,8993,[215 216  64 322 257],314,4,36847,4.096842339337336,20.0,0.0
8994,0,8994,[ 64 483 313 318 187],618,5,36852,4.096942745969983,80.0,20.0
8995,0,8995,[ 64 483 313 318 187],214,5,36857,4.097043130280125,80.0,20.0
8996,0,8996,[ 64 483 313 318 187],618,5,36862,4.097143492275203,80.0,20.0
8997,0,8997,[ 25 200 471  98 603],416,5,36867,4.0972438319626585,0.0,20.0
8998,0,8998,[  8 216  69  70 153],43,5,36872,4.097344149349928,0.0,0.0
8999,0,8999,[ 22 100 211 597 471],416,4,36876,4.097333333333333,0.0,0.0
9000,0,9000,[289  88 173 333 403],416,3,36879,4.0972114209532275,0.0,0.0
9001,0,9001,[ 64 483 313 318 187],618,5,36884,4.0973117085092206,80.0,20.0
9002,0,9002,[ 64 483 313 318 187],214,5,36889,4.097411973786516,80.0,20.0
9003,0,9003,[ 64 483 313 318 187],214,5,36894,4.097512216792537,80.0,20.0
9004,0,9004,[111 181 132 118 191],416,4,36898,4.0975013881177125,0.0,20.0
9005,0,9005,[568  98 748 174 288],417,2,36900,4.097268487674883,0.0,40.0
9006,0,9006,[ 64 483 313 318 187],214,5,36905,4.097368713223049,80.0,20.0
9007,0,9007,[ 64 483 313 318 187],214,5,36910,4.09746891651865,80.0,20.0
9008,0,9008,[588 471 301 237  71],345,2,36912,4.097236097236097,0.0,0.0
9009,0,9009,[202 748 475  88  11],805,1,36913,4.0968923418423975,0.0,0.0
9010,0,9010,[ 64 483 313 318 187],618,5,36918,4.096992564643214,80.0,20.0
9011,0,9011,[ 69 748 215 117 161],345,3,36921,4.096870838881491,0.0,0.0
9012,0,9012,[179  96 597 568 300],751,2,36923,4.096638189282148,0.0,0.0
9013,0,9013,[ 71 655 111  89 125],62,3,36926,4.096516529842467,0.0,0.0
9014,0,9014,[ 64 483 313 318 187],618,5,36931,4.096616749861342,80.0,20.0
9015,0,9015,[288 258   8 313 286],223,1,36932,4.096273291925466,20.0,40.0
9016,0,9016,[ 64 483 313 318 187],214,5,36937,4.096373516690695,80.0,20.0
9017,0,9017,[ 64 483 313 318 187],618,5,36942,4.09647371922821,80.0,20.0
9018,0,9018,[181 215  82 273 300],416,5,36947,4.096573899545404,0.0,20.0
9019,0,9019,[ 64 483 313 318 187],214,5,36952,4.096674057649667,80.0,20.0
9020,0,9020,[302   8 234 161  82],416,5,36957,4.096774193548387,0.0,0.0
9021,0,9021,[588 202 161 258   8],805,0,36957,4.096320106406561,0.0,0.0
9022,0,9022,[ 15  56 211 117 568],416,5,36962,4.09642025933725,0.0,0.0
9023,0,9023,[ 64 483 313 318 187],618,5,36967,4.096520390070922,80.0,20.0
9024,0,9024,[ 12 237 508 475  11],24,5,36972,4.096620498614959,20.0,0.0
9025,0,9025,[ 64  89 423  50 153],96,5,36977,4.096720584976734,20.0,20.0
9026,0,9026,[  4 210 135 475 173],417,2,36979,4.09648831283926,0.0,0.0
9027,0,9027,[ 64 483 313 318 187],618,5,36984,4.096588391670359,80.0,20.0
9028,0,9028,[ 25 117 282 179   7],416,4,36988,4.0965776940967995,0.0,0.0
9029,0,9029,[ 64 483 313 318 187],214,5,36993,4.096677740863788,80.0,20.0
9030,0,9030,[ 64 483 313 318 187],618,5,36998,4.096777765474477,80.0,20.0
9031,0,9031,[483 202 222  15  95],417,4,37002,4.0967670504871565,20.0,0.0
9032,0,9032,[286 191  95 127 174],373,3,37005,4.096645632680173,0.0,0.0
9033,0,9033,[118  89 496  69 222],417,2,37007,4.096413548815586,0.0,0.0
9034,0,9034,[  8  70  96 153 258],62,4,37011,4.096402877697842,0.0,0.0
9035,0,9035,[  9 143 273 179 180],805,1,37012,4.096060203629925,0.0,0.0
9036,0,9036,[173 588 245 328 161],128,3,37015,4.09593891778245,0.0,0.0
9037,0,9037,[ 64 483 313 318 187],618,5,37020,4.096038946669617,80.0,20.0
9038,0,9038,[ 64 483 313 318 187],214,5,37025,4.0961389534240515,80.0,20.0
9039,0,9039,[ 64 483 313 318 187],214,5,37030,4.096238938053097,80.0,20.0
9040,0,9040,[ 64 483 313 318 187],618,5,37035,4.096338900564097,80.0,20.0
9041,0,9041,[ 64 483 313 318 187],214,5,37040,4.096438840964389,80.0,20.0
9042,0,9042,[ 64 483 313 318 187],214,5,37045,4.096538759261307,80.0,20.0
9043,0,9043,[322 183  98 588 182],416,4,37049,4.0965280849181775,0.0,20.0
9044,0,9044,[ 64 483 313 318 187],214,5,37054,4.096627971254837,80.0,20.0
9045,0,9045,[176 471  15 135  89],922,2,37056,4.096396197214238,0.0,0.0
9046,0,9046,[ 64 483 313 318 187],214,5,37061,4.096496076047308,80.0,20.0
9047,0,9047,[183 173 175 288 144],297,3,37064,4.096374889478338,0.0,20.0
9048,0,9048,[423 508 403  50 483],62,4,37068,4.096364239142447,20.0,20.0
9049,0,9049,[ 64 483 313 318 187],214,5,37073,4.09646408839779,80.0,20.0
9050,0,9050,[282 161 748 258 127],416,5,37078,4.096563915589438,0.0,0.0
9051,0,9051,[ 70 289  96 318 496],416,4,37082,4.096553247901016,20.0,0.0
9052,0,9052,[288 748  25 655 258],416,5,37087,4.096653043190103,0.0,20.0
9053,0,9053,[ 64 483 313 318 187],618,5,37092,4.096752816434725,80.0,20.0
9054,0,9054,[ 64 483 313 318 187],618,5,37097,4.096852567642187,80.0,20.0
9055,0,9055,[ 64 483 313 318 187],214,5,37102,4.096952296819788,80.0,20.0
9056,0,9056,[ 64 483 313 318 187],618,5,37107,4.097052003974826,80.0,20.0
9057,0,9057,[357 185 234 475 215],297,3,37110,4.096930889821152,0.0,0.0
9058,0,9058,[276  50  22 237 151],654,4,37114,4.096920189866431,0.0,20.0
9059,0,9059,[ 64 483 313 318 187],214,5,37119,4.097019867549669,80.0,20.0
9060,0,9060,[ 64 483 313 318 187],214,5,37124,4.097119523231432,80.0,20.0
9061,0,9061,[ 64 483 313 318 187],214,5,37129,4.097219156919002,80.0,20.0
9062,0,9062,[ 64 483 313 318 187],618,5,37134,4.097318768619663,80.0,20.0
9063,0,9063,[  8 245   7   1 144],297,2,37136,4.097087378640777,0.0,0.0
9064,0,9064,[ 64 483 313 318 187],618,5,37141,4.097186982901269,80.0,20.0
9065,0,9065,[ 64 483 313 318 187],618,5,37146,4.097286565188617,80.0,20.0
9066,0,9066,[318 195  71 268 125],416,5,37151,4.097386125510091,20.0,0.0
9067,0,9067,[ 88 161 111  96 153],805,2,37153,4.097154830172034,0.0,0.0
9068,0,9068,[ 50  28 196 216 268],128,4,37157,4.097144117322748,0.0,20.0
9069,0,9069,[ 64 483 313 318 187],618,5,37162,4.097243660418964,80.0,20.0
9070,0,9070,[181 185 215  88 151],618,4,37166,4.0972329401389045,0.0,20.0
9071,0,9071,[ 64 483 313 318 187],618,5,37171,4.097332451499118,80.0,20.0
9072,0,9072,[100 245 111  69 125],417,2,37173,4.097101289540395,0.0,0.0
9073,0,9073,[ 64 483 313 318 187],214,5,37178,4.097200793475865,80.0,20.0
9074,0,9074,[ 11 238 289 475   8],416,3,37181,4.097079889807163,0.0,0.0
9075,0,9075,[173 496 143 655 237],416,4,37185,4.097069193477303,0.0,0.0
9076,0,9076,[265 238  50  71 211],416,5,37190,4.097168668062135,0.0,20.0
9077,0,9077,[ 64 483 313 318 187],214,5,37195,4.097268120731439,80.0,20.0
9078,0,9078,[168  25 228  71 211],373,5,37200,4.0973675514924555,0.0,0.0
9079,0,9079,[ 71 215 275 471 202],128,3,37203,4.097246696035242,0.0,0.0
9080,0,9080,[ 64 483 313 318 187],618,5,37208,4.09734610725691,80.0,20.0
9081,0,9081,[ 64 483 313 318 187],618,5,37213,4.097445496586655,80.0,20.0
9082,0,9082,[ 15   1 174 202 200],416,5,37218,4.097544864031708,0.0,0.0
9083,0,9083,[ 64 483 313 318 187],214,5,37223,4.097644209599295,80.0,20.0
9084,0,9084,[196 180 323 132 742],417,3,37226,4.097523390203633,0.0,0.0
9085,0,9085,[ 64 483 313 318 187],618,5,37231,4.097622716266784,80.0,20.0
9086,0,9086,[ 64 483 313 318 187],214,5,37236,4.097722020468802,80.0,20.0
9087,0,9087,[655 282 515 143  50],416,5,37241,4.097821302816901,0.0,20.0
9088,0,9088,[333 301 597  64  22],416,4,37245,4.097810540213445,20.0,0.0
9089,0,9089,[ 64 483 313 318 187],214,5,37250,4.097909790979098,80.0,20.0
9090,0,9090,[100 276  82 168  56],618,4,37254,4.09789902100979,0.0,0.0
9091,0,9091,[269 228  71  88 423],805,1,37255,4.097558293004839,0.0,0.0
9092,0,9092,[742 100 237  56  12],297,4,37259,4.0975475640602665,20.0,0.0
9093,0,9093,[175 179 237   8 302],721,3,37262,4.097426874862546,0.0,0.0
9094,0,9094,[191 403 210 174  98],417,3,37265,4.097306212204508,0.0,20.0
9095,0,9095,[568  71  88 328 153],416,4,37269,4.097295514511873,0.0,0.0
9096,0,9096,[237 405 288  70   7],262,2,37271,4.097064966472463,0.0,20.0
9097,0,9097,[ 64 483 313 318 187],214,5,37276,4.0971642119147065,80.0,20.0
9098,0,9098,[ 64 483 313 318 187],214,5,37281,4.097263435542367,80.0,20.0
9099,0,9099,[276 273 211 245  22],416,3,37284,4.097142857142857,0.0,0.0
9100,0,9100,[ 88 117 238 144 546],805,1,37285,4.0968025491704205,0.0,0.0
9101,0,9101,[100 111  98 216 655],417,2,37287,4.096572181938035,0.0,20.0
9102,0,9102,[588   4 568 161  82],373,3,37290,4.096451719213446,0.0,0.0
9103,0,9103,[173  69 174 257 176],416,4,37294,4.096441124780316,0.0,0.0
9104,0,9104,[ 89 357  50  98 183],417,4,37298,4.096430532674355,0.0,40.0
9105,0,9105,[288 475 186 483  50],711,3,37301,4.096310125192181,20.0,40.0
9106,0,9106,[ 96 216   7  98 117],805,3,37304,4.096189744152849,0.0,20.0
9107,0,9107,[ 64 483 313 318 187],618,5,37309,4.096288976723759,80.0,20.0
9108,0,9108,[153 121  12 294 180],805,2,37311,4.0960588429026235,20.0,0.0
9109,0,9109,[ 64 483 313 318 187],214,5,37316,4.09615806805708,80.0,20.0
9110,0,9110,[ 98 143  22 435 427],405,4,37320,4.096147513994073,0.0,20.0
9111,0,9111,[ 70 121 111 568  25],417,1,37321,4.095807726075505,0.0,0.0
9112,0,9112,[202  69 313  82 196],711,3,37324,4.095687479424997,20.0,20.0
9113,0,9113,[286   4 471  82  96],416,5,37329,4.095786701777485,0.0,0.0
9114,0,9114,[ 64 483 313 318 187],618,5,37334,4.0958859023587495,80.0,20.0
9115,0,9115,[222 204 215 100  11],43,5,37339,4.095985081175955,0.0,0.0
9116,0,9116,[172 132 588  70 568],711,4,37343,4.095974553032796,0.0,0.0
9117,0,9117,[118   9 258 121 318],601,3,37346,4.095854354025006,20.0,0.0
9118,0,9118,[ 64 483 313 318 187],618,5,37351,4.095953503673648,80.0,20.0
9119,0,9119,[ 50 196 153  82 603],373,4,37355,4.09594298245614,0.0,20.0
9120,0,9120,[161 282   1 294  82],128,4,37359,4.0959324635456635,0.0,0.0
9121,0,9121,[ 70   1 173  22 405],416,5,37364,4.096031572023679,0.0,0.0
9122,0,9122,[258 127  79 597 405],43,4,37368,4.096021045708649,0.0,0.0
9123,0,9123,[ 64 483 313 318 187],214,5,37373,4.096120122753178,80.0,20.0
9124,0,9124,[288 216  11 161 185],405,3,37376,4.096,0.0,20.0
9125,0,9125,[210 235  56  97 508],62,4,37380,4.095989480604866,0.0,0.0
9126,0,9126,[216 100 175 228 173],805,3,37383,4.095869398488003,0.0,0.0
9127,0,9127,[ 64 483 313 318 187],214,5,37388,4.0959684487291845,80.0,20.0
9128,0,9128,[ 64 483 313 318 187],618,5,37393,4.096067477270238,80.0,20.0
9129,0,9129,[ 64 483 313 318 187],618,5,37398,4.096166484118291,80.0,20.0
9130,0,9130,[204 294 228 132  98],887,4,37402,4.096155952250575,0.0,20.0
9131,0,9131,[ 64 483 313 318 187],618,5,37407,4.096254927726675,80.0,20.0
9132,0,9132,[678 111 313 174 302],345,4,37411,4.096244388481331,20.0,20.0
9133,0,9133,[ 64 483 313 318 187],214,5,37416,4.0963433326034595,80.0,20.0
9134,0,9134,[ 64 483 313 318 187],214,5,37421,4.096442255062945,80.0,20.0
9135,0,9135,[216 597 168 144 483],751,4,37425,4.09643169877408,20.0,0.0
9136,0,9136,[237  71 403 191 211],416,4,37429,4.096421144795885,0.0,0.0
9137,0,9137,[ 64 483 313 318 187],618,5,37434,4.096520026263953,80.0,20.0
9138,0,9138,[ 64 483 313 318 187],214,5,37439,4.09661888609257,80.0,20.0
9139,0,9139,[ 64 483 313 318 187],214,5,37444,4.09671772428884,80.0,20.0
9140,0,9140,[  4  28 100 168 204],43,5,37449,4.096816540859862,0.0,0.0
9141,0,9141,[238 385 173   4 588],712,4,37453,4.096805950557865,0.0,0.0
9142,0,9142,[204 322  82 655  79],805,1,37454,4.096467242699333,0.0,0.0
9143,0,9143,[ 64 483 313 318 187],618,5,37459,4.09656605424322,80.0,20.0
9144,0,9144,[ 64 483 313 318 187],214,5,37464,4.096664844177146,80.0,20.0
9145,0,9145,[215   1 153 282 294],416,5,37469,4.0967636125082,0.0,0.0
9146,0,9146,[742  97 174 125   9],416,5,37474,4.096862359243468,0.0,0.0
9147,0,9147,[ 64 483 313 318 187],214,5,37479,4.09696108439003,80.0,20.0
9148,0,9148,[ 64 483 313 318 187],618,5,37484,4.097059787954968,80.0,20.0
9149,0,9149,[ 64 483 313 318 187],618,5,37489,4.097158469945355,80.0,20.0
9150,0,9150,[202 173  12 301 597],43,4,37493,4.097147852693695,20.0,0.0
9151,0,9151,[ 64 483 313 318 187],214,5,37498,4.097246503496503,80.0,20.0
9152,0,9152,[ 64 483 313 318 187],214,5,37503,4.097345132743363,80.0,20.0
9153,0,9153,[568 111 328 258  15],416,5,37508,4.097443740441337,0.0,0.0
9154,0,9154,[276 180  64 275 174],62,5,37513,4.0975423265974875,20.0,0.0
9155,0,9155,[143 328 286  97 275],43,5,37518,4.097640891218873,0.0,0.0
9156,0,9156,[ 64 483 313 318 187],214,5,37523,4.0977394343125475,80.0,20.0
9157,0,9157,[ 64 483 313 318 187],214,5,37528,4.097837955885565,80.0,20.0
9158,0,9158,[191 185 173 215  89],198,4,37532,4.0978272737198385,0.0,0.0
9159,0,9159,[333 385 197 313 475],416,4,37536,4.097816593886463,20.0,20.0
9160,0,9160,[ 79 132 151 228 181],373,4,37540,4.097805916384674,0.0,20.0
9161,0,9161,[276  12  69 405  98],62,4,37544,4.097795241213709,20.0,20.0
9162,0,9162,[ 64 483 313 318 187],618,5,37549,4.097893702935719,80.0,20.0
9163,0,9163,[ 64 483 313 318 187],214,5,37554,4.097992143168922,80.0,20.0
9164,0,9164,[313 289 294 403  71],345,1,37555,4.0976541189307145,20.0,20.0
9165,0,9165,[ 64 483 313 318 187],214,5,37560,4.097752563822824,80.0,20.0
9166,0,9166,[ 64 483 313 318 187],214,5,37565,4.097850987236828,80.0,20.0
9167,0,9167,[ 64 483 313 318 187],618,5,37570,4.097949389179756,80.0,20.0
9168,0,9168,[153 403 300 323 161],198,2,37572,4.097720580215945,0.0,0.0
9169,0,9169,[ 64 483 313 318 187],214,5,37577,4.097818974918211,80.0,20.0
9170,0,9170,[ 64 483 313 318 187],618,5,37582,4.097917348162687,80.0,20.0
9171,0,9171,[ 64 483 313 318 187],214,5,37587,4.098015699956389,80.0,20.0
9172,0,9172,[191  69 185 276 187],416,4,37591,4.0980050147171045,0.0,0.0
9173,0,9173,[ 79 228 748 185 273],805,2,37593,4.09777632439503,0.0,0.0
9174,0,9174,[275 191 405 603 118],416,4,37597,4.097765667574932,0.0,0.0
9175,0,9175,[ 64 483 313 318 187],214,5,37602,4.097863993025284,80.0,20.0
9176,0,9176,[273 191 302 282  56],416,5,37607,4.097962297046966,0.0,0.0
9177,0,9177,[ 64 483 313 318 187],214,5,37612,4.098060579646982,80.0,20.0
9178,0,9178,[228 176 323 742  98],417,2,37614,4.097832007843992,0.0,20.0
9179,0,9179,[265 496 172 200 655],417,2,37616,4.09760348583878,0.0,0.0
9180,0,9180,[ 64 483 313 318 187],618,5,37621,4.09770177540573,80.0,20.0
9181,0,9181,[143 405 215 265 678],416,4,37625,4.097691134829013,0.0,0.0
9182,0,9182,[195 174 655 186 237],618,4,37629,4.097680496569748,0.0,0.0
9183,0,9183,[132 265 117 197  71],618,4,37633,4.097669860627177,0.0,0.0
9184,0,9184,[ 64 483 313 318 187],214,5,37638,4.09776810016331,80.0,20.0
9185,0,9185,[ 64 483 313 318 187],214,5,37643,4.097866318310473,80.0,20.0
9186,0,9186,[ 64 483 313 318 187],618,5,37648,4.097964515075651,80.0,20.0
9187,0,9187,[ 64 483 313 318 187],214,5,37653,4.098062690465825,80.0,20.0
9188,0,9188,[210  15 235  82 151],62,4,37657,4.0980520187180325,0.0,0.0
9189,0,9189,[ 64 483 313 318 187],214,5,37662,4.098150163220892,80.0,20.0
9190,0,9190,[496 153 597 282 275],654,4,37666,4.098139484278098,0.0,0.0
9191,0,9191,[ 98 143 678 202 125],345,2,37668,4.097911227154047,0.0,20.0
9192,0,9192,[174 318 195  56   1],618,4,37672,4.097900576525618,20.0,0.0
9193,0,9193,[175 183 265 276 127],198,2,37674,4.097672395040243,0.0,0.0
9194,0,9194,[215 234 182  15 385],198,2,37676,4.097444263186515,0.0,0.0
9195,0,9195,[144 357 191   7  98],805,4,37680,4.097433666811657,0.0,20.0
9196,0,9196,[ 64 483 313 318 187],618,5,37685,4.0975318038490816,80.0,20.0
9197,0,9197,[ 64 483 313 318 187],214,5,37690,4.097629919547728,80.0,20.0
9198,0,9198,[ 50  56  95 200   4],49,1,37691,4.097293184041743,0.0,20.0
9199,0,9199,[ 64 483 313 318 187],618,5,37696,4.097391304347826,80.0,20.0
9200,0,9200,[121  56  79  96  98],230,3,37699,4.097272035648299,0.0,20.0
9201,0,9201,[  8 100 655 678 194],416,4,37703,4.097261464898935,0.0,0.0
9202,0,9202,[ 25  95 427  28 176],698,1,37704,4.09692491578833,0.0,0.0
9203,0,9203,[ 95 328 144 288 174],416,4,37708,4.0969143850499785,0.0,20.0
9204,0,9204,[ 64 483 313 318 187],618,5,37713,4.097012493210212,80.0,20.0
9205,0,9205,[132 151 546 195 144],416,3,37716,4.0968933304366715,0.0,0.0
9206,0,9206,[ 64 483 313 318 187],214,5,37721,4.096991419572065,80.0,20.0
9207,0,9207,[185 294 174 323 546],805,2,37723,4.096763683753258,0.0,0.0
9208,0,9208,[269 333 197 588 117],345,3,37726,4.096644586817244,0.0,0.0
9209,0,9209,[ 56 655  28 196 471],128,3,37729,4.096525515743757,0.0,0.0
9210,0,9210,[ 70  64   8 313  95],416,4,37733,4.096515036369558,40.0,20.0
9211,0,9211,[ 64 483 313 318 187],214,5,37738,4.096613113330439,80.0,20.0
9212,0,9212,[ 64 483 313 318 187],214,5,37743,4.096711169000326,80.0,20.0
9213,0,9213,[ 64 483 313 318 187],618,5,37748,4.096809203386152,80.0,20.0
9214,0,9214,[ 64 151 288  69 172],214,2,37750,4.096581660336408,20.0,20.0
9215,0,9215,[234  15 568 276 496],618,3,37753,4.096462673611111,0.0,0.0
9216,0,9216,[ 56 111 357 153  25],854,3,37756,4.096343712704785,0.0,0.0
9217,0,9217,[ 64 483 313 318 187],214,5,37761,4.096441744413105,80.0,20.0
9218,0,9218,[ 64 483 313 318 187],214,5,37766,4.096539754854105,80.0,20.0
9219,0,9219,[508 245  69  89 269],297,3,37769,4.096420824295011,0.0,0.0
9220,0,9220,[748 655 265 127  95],416,4,37773,4.096410367639085,0.0,0.0
9221,0,9221,[ 64 483 313 318 187],618,5,37778,4.0965083495987855,80.0,20.0
9222,0,9222,[ 64 483 313 318 187],618,5,37783,4.096606310311179,80.0,20.0
9223,0,9223,[588 195 180  95 125],373,3,37786,4.0964874241110145,0.0,0.0
9224,0,9224,[ 71 151 117   4 385],198,1,37787,4.096151761517615,0.0,0.0
9225,0,9225,[235  71 385 204 182],49,0,37787,4.095707782354216,0.0,0.0
9226,0,9226,[ 64 483 313 318 187],618,5,37792,4.095805787363173,80.0,20.0
9227,0,9227,[ 15 144 222 179 294],62,2,37794,4.0955786736020805,0.0,0.0
9228,0,9228,[  9 588 182 265 194],416,5,37799,4.095676671362011,0.0,0.0
9229,0,9229,[197 191 655 427 234],416,5,37804,4.095774647887324,0.0,0.0
9230,0,9230,[ 64 483 313 318 187],618,5,37809,4.095872603184921,80.0,20.0
9231,0,9231,[ 64 483 313 318 187],618,5,37814,4.095970537261699,80.0,20.0
9232,0,9232,[ 71 258 117  79 182],128,4,37818,4.09596014296545,0.0,0.0
9233,0,9233,[ 64 483 313 318 187],214,5,37823,4.096058046350444,80.0,20.0
9234,0,9234,[289  25  69  12 313],43,5,37828,4.096155928532756,40.0,20.0
9235,0,9235,[191 568 271 216 258],62,3,37831,4.096037245560849,0.0,0.0
9236,0,9236,[ 64 483 313 318 187],214,5,37836,4.096135108801559,80.0,20.0
9237,0,9237,[ 69 172 403  88  79],43,5,37841,4.096232950855163,0.0,0.0
9238,0,9238,[ 64 483 313 318 187],618,5,37846,4.096330771728542,80.0,20.0
9239,0,9239,[210 288 111 268 161],345,3,37849,4.096212121212122,0.0,20.0
9240,0,9240,[ 64 483 313 318 187],618,5,37854,4.096309923168488,80.0,20.0
9241,0,9241,[273 200  11  50 268],297,4,37858,4.0962995022722355,0.0,20.0
9242,0,9242,[ 64 483 313 318 187],618,5,37863,4.096397273612464,80.0,20.0
9243,0,9243,[ 64 483 313 318 187],618,5,37868,4.096495023799221,80.0,20.0
9244,0,9244,[ 11 588 515 153 385],416,5,37873,4.096592752839372,0.0,0.0
9245,0,9245,[ 64 483 313 318 187],618,5,37878,4.096690460739779,80.0,20.0
9246,0,9246,[  8 546 215 210 191],62,4,37882,4.096680004325727,0.0,0.0
9247,0,9247,[ 64 483 313 318 187],618,5,37887,4.0967776816609,80.0,20.0
9248,0,9248,[ 64 483 313 318 187],214,5,37892,4.096875337874365,80.0,20.0
9249,0,9249,[161 111  22  89 286],711,4,37896,4.096864864864865,0.0,0.0
9250,0,9250,[322 210 179 211 257],416,2,37898,4.096638201275538,0.0,0.0
9251,0,9251,[328 204  69 168 265],373,5,37903,4.096735840899265,0.0,0.0
9252,0,9252,[ 64 483 313 318 187],214,5,37908,4.096833459418567,80.0,20.0
9253,0,9253,[258 174 234   8 405],805,1,37909,4.096498811324833,0.0,0.0
9254,0,9254,[ 64 483 313 318 187],214,5,37914,4.096596434359806,80.0,20.0
9255,0,9255,[ 95 168  50 238 100],437,4,37918,4.096585998271392,0.0,20.0
9256,0,9256,[ 64 483 313 318 187],214,5,37923,4.096683590796154,80.0,20.0
9257,0,9257,[ 64 483 313 318 187],618,5,37928,4.096781162238065,80.0,20.0
9258,0,9258,[ 89  79 286   7 276],354,3,37931,4.096662706555784,0.0,0.0
9259,0,9259,[  1 194 742 258 153],416,5,37936,4.096760259179265,0.0,0.0
9260,0,9260,[ 64 483 313 318 187],214,5,37941,4.096857790735342,80.0,20.0
9261,0,9261,[678 125  28 194 216],416,4,37945,4.096847333189376,0.0,0.0
9262,0,9262,[ 82  70 237 568 603],416,4,37949,4.096836877901328,0.0,0.0
9263,0,9263,[174   8 181 161 588],437,3,37952,4.096718480138169,0.0,20.0
9264,0,9264,[ 64 483 313 318 187],214,5,37957,4.09681597409606,80.0,20.0
9265,0,9265,[182 742   7 191 181],62,4,37961,4.09680552557738,0.0,20.0
9266,0,9266,[ 64 483 313 318 187],214,5,37966,4.096902989101111,80.0,20.0
9267,0,9267,[ 64 483 313 318 187],214,5,37971,4.097000431592576,80.0,20.0
9268,0,9268,[222  56 151 135 288],854,5,37976,4.097097853058583,0.0,20.0
9269,0,9269,[ 64 483 313 318 187],214,5,37981,4.097195253505933,80.0,20.0
9270,0,9270,[175 181 276 258 204],198,2,37983,4.096969043253155,0.0,20.0
9271,0,9271,[ 15  82 176 132 234],618,4,37987,4.096958584987058,0.0,0.0
9272,0,9272,[ 64 483 313 318 187],214,5,37992,4.09705596894209,80.0,20.0
9273,0,9273,[183 210  98 117  56],297,5,37997,4.097153331895623,0.0,20.0
9274,0,9274,[ 50 748 194  70  64],373,5,38002,4.097250673854448,20.0,20.0
9275,0,9275,[ 64 483 313 318 187],214,5,38007,4.0973479948253555,80.0,20.0
9276,0,9276,[117 196  97  89 172],417,4,38011,4.097337501347418,0.0,0.0
9277,0,9277,[ 64 483 313 318 187],618,5,38016,4.097434791981031,80.0,20.0
9278,0,9278,[ 64 483 313 318 187],618,5,38021,4.097532061644574,80.0,20.0
9279,0,9279,[ 64 483 313 318 187],214,5,38026,4.097629310344828,80.0,20.0
9280,0,9280,[  1  69   8 357 127],62,4,38030,4.097618791078547,0.0,0.0
9281,0,9281,[  7 597   9  70 117],314,4,38034,4.097608274078862,0.0,0.0
9282,0,9282,[273  28  97 197  70],416,5,38039,4.097705483141226,0.0,0.0
9283,0,9283,[301 237 300 748 289],345,2,38041,4.097479534683326,0.0,0.0
9284,0,9284,[ 64 483 313 318 187],618,5,38046,4.0975767366720515,80.0,20.0
9285,0,9285,[ 64 483 313 318 187],618,5,38051,4.097673917725609,80.0,20.0
9286,0,9286,[168 237 403 258  69],198,4,38055,4.097663400452245,0.0,0.0
9287,0,9287,[172 742 385 202 191],345,3,38058,4.097545219638243,0.0,0.0
9288,0,9288,[ 64 483 313 318 187],618,5,38063,4.097642372698891,80.0,20.0
9289,0,9289,[ 64 483 313 318 187],214,5,38068,4.0977395048439185,80.0,20.0
9290,0,9290,[ 79 313 191 210 333],416,5,38073,4.097836616080078,20.0,20.0
9291,0,9291,[ 64 483 313 318 187],214,5,38078,4.0979337064141195,80.0,20.0
9292,0,9292,[200 235  12 328 174],416,4,38082,4.097923167975896,20.0,0.0
9293,0,9293,[125 515 168 568 294],230,4,38086,4.097912631805466,0.0,0.0
9294,0,9294,[ 89 118  11 235 121],417,3,38089,4.097794513179129,0.0,0.0
9295,0,9295,[210 153 588  11 288],417,2,38091,4.097568846815835,0.0,20.0
9296,0,9296,[ 50 603 275 204 100],437,5,38096,4.0976659137356135,0.0,20.0
9297,0,9297,[168 100  28   8 276],654,3,38099,4.097547859754786,0.0,0.0
9298,0,9298,[ 98 183 288 655 100],437,3,38102,4.097429831164641,0.0,40.0
9299,0,9299,[ 64 483 313 318 187],618,5,38107,4.09752688172043,80.0,20.0
9300,0,9300,[ 64 483 313 318 187],618,5,38112,4.097623911407376,80.0,20.0
9301,0,9301,[ 64 483 313 318 187],618,5,38117,4.0977209202322085,80.0,20.0
9302,0,9302,[153 202  50 288 423],297,2,38119,4.09749543158121,0.0,40.0
9303,0,9303,[ 56 174 186 275   4],618,3,38122,4.0973774720550304,0.0,0.0
9304,0,9304,[ 64 483 313 318 187],214,5,38127,4.0974744760881245,80.0,20.0
9305,0,9305,[  9 742 546 405 258],159,3,38130,4.097356544165055,0.0,0.0
9306,0,9306,[ 64 483 313 318 187],618,5,38135,4.097453529601375,80.0,20.0
9307,0,9307,[496 143  97 191 222],128,3,38138,4.097335625268586,0.0,0.0
9308,0,9308,[  1 238  96 181  82],49,1,38139,4.097002900418949,0.0,20.0
9309,0,9309,[286 197  50 302 288],721,3,38142,4.096885069817401,0.0,40.0
9310,0,9310,[245 405 153 357 268],417,4,38146,4.09687466437547,0.0,0.0
9311,0,9311,[ 64 483 313 318 187],214,5,38151,4.096971649484536,80.0,20.0
9312,0,9312,[ 64 483 313 318 187],618,5,38156,4.097068613765704,80.0,20.0
9313,0,9313,[183 385 100 301 294],416,5,38161,4.097165557225682,0.0,0.0
9314,0,9314,[300 427 215  82 191],705,2,38163,4.096940418679549,0.0,0.0
9315,0,9315,[ 64 483 313 318 187],214,5,38168,4.097037355088021,80.0,20.0
9316,0,9316,[ 64 483 313 318 187],214,5,38173,4.09713427068799,80.0,20.0
9317,0,9317,[ 96 323 174 215 197],416,4,38177,4.0971238463189525,0.0,0.0
9318,0,9318,[427 405  71 300 245],416,4,38181,4.097113424187144,0.0,0.0
9319,0,9319,[135 168 153  98 111],805,4,38185,4.097103004291846,0.0,20.0
9320,0,9320,[234 678 173 333 179],416,3,38188,4.096985302006223,0.0,0.0
9321,0,9321,[588 172 211 238 268],417,3,38191,4.096867624973182,0.0,0.0
9322,0,9322,[ 64 483 313 318 187],214,5,38196,4.096964496406736,80.0,20.0
9323,0,9323,[ 64 483 313 318 187],618,5,38201,4.097061347061347,80.0,20.0
9324,0,9324,[ 64 483 313 318 187],618,5,38206,4.0971581769437,80.0,20.0
9325,0,9325,[197 117 269  56 313],751,3,38209,4.097040531846451,20.0,20.0
9326,0,9326,[228 151 282  50   4],297,1,38210,4.096708480754798,0.0,20.0
9327,0,9327,[655 258  11 117  71],345,4,38214,4.096698113207547,0.0,0.0
9328,0,9328,[197 289 202 357 333],416,4,38218,4.096687747882946,0.0,0.0
9329,0,9329,[ 64 483 318 313 187],618,5,38223,4.096784565916399,80.0,20.0
9330,0,9330,[ 64 483 318 313 187],618,5,38228,4.096881363197943,80.0,20.0
9331,0,9331,[211 195 186  97  56],230,3,38231,4.096763823403343,0.0,0.0
9332,0,9332,[210 144   1 748  12],654,5,38236,4.096860602164363,20.0,0.0
9333,0,9333,[ 64 483 318 313 187],214,5,38241,4.096957360188558,80.0,20.0
9334,0,9334,[ 64 483 318 313 187],618,5,38246,4.097054097482593,80.0,20.0
9335,0,9335,[ 64 483 318 313 187],618,5,38251,4.097150814053128,80.0,20.0
9336,0,9336,[  7 423 191 183 403],62,4,38255,4.097140409124987,0.0,0.0
9337,0,9337,[ 64 483 318 313 187],618,5,38260,4.097237095737845,80.0,20.0
9338,0,9338,[ 64 483 318 313 187],618,5,38265,4.097333761644716,80.0,20.0
9339,0,9339,[271 357 186 132 257],854,3,38268,4.097216274089936,0.0,0.0
9340,0,9340,[ 64 483 318 313 187],214,5,38273,4.0973129215287445,80.0,20.0
9341,0,9341,[ 64 483 318 313 187],214,5,38278,4.0974095482766,80.0,20.0
9342,0,9342,[ 64 483 318 313 187],214,5,38283,4.097506154340148,80.0,20.0
9343,0,9343,[ 64 483 318 313 187],618,5,38288,4.097602739726027,80.0,20.0
9344,0,9344,[ 64 483 318 313 187],214,5,38293,4.097699304440877,80.0,20.0
9345,0,9345,[191 172  69  11 125],262,3,38296,4.097581853199229,0.0,0.0
9346,0,9346,[ 64 483 318 313 187],618,5,38301,4.097678399486466,80.0,20.0
9347,0,9347,[ 64 483 318 313 187],214,5,38306,4.0977749251176725,80.0,20.0
9348,0,9348,[ 64 483 318 313 187],214,5,38311,4.097871430099476,80.0,20.0
9349,0,9349,[ 64 483 318 313 187],618,5,38316,4.097967914438502,80.0,20.0
9350,0,9350,[186 588 597 742 257],417,1,38317,4.097636616404663,0.0,0.0
9351,0,9351,[328 742 197 423 257],416,4,38321,4.0976261762189905,0.0,0.0
9352,0,9352,[196   9 655 176 118],618,3,38324,4.0975088206992405,0.0,0.0
9353,0,9353,[127  11 195 202 588],405,4,38328,4.097498396407953,0.0,0.0
9354,0,9354,[200 196  70 237 210],416,4,38332,4.09748797434527,0.0,0.0
9355,0,9355,[323 168 300 210 172],416,4,38336,4.0974775545104745,0.0,0.0
9356,0,9356,[ 15 210 234   1 385],416,5,38341,4.097574008763493,0.0,0.0
9357,0,9357,[ 64 483 318 313 187],618,5,38346,4.097670442402222,80.0,20.0
9358,0,9358,[ 64 483 318 313 187],214,5,38351,4.097766855433273,80.0,20.0
9359,0,9359,[ 82  98 216 288 748],654,4,38355,4.097756410256411,0.0,40.0
9360,0,9360,[588 174 302 228 153],297,4,38359,4.097745967311185,0.0,0.0
9361,0,9361,[100 603  25 403 153],416,5,38364,4.097842341380047,0.0,0.0
9362,0,9362,[135 173 483 186   7],354,3,38367,4.097725088112784,20.0,0.0
9363,0,9363,[ 64 483 318 313 187],618,5,38372,4.097821443827424,80.0,20.0
9364,0,9364,[151 294  50 153 179],62,4,38376,4.097810998398291,0.0,20.0
9365,0,9365,[405  95 588  25 655],417,2,38378,4.097587016869528,0.0,0.0
9366,0,9366,[135 195 234 403 182],405,4,38382,4.097576598697556,0.0,0.0
9367,0,9367,[238 210 183  25 127],416,5,38387,4.09767292912041,0.0,0.0
9368,0,9368,[ 64 483 318 313 187],214,5,38392,4.097769238979613,80.0,20.0
9369,0,9369,[181 515  79 269 111],297,3,38395,4.097652081109925,0.0,20.0
9370,0,9370,[268 655 282  88 151],588,4,38399,4.097641660441789,0.0,0.0
9371,0,9371,[ 95 268  98 318 215],416,4,38403,4.097631241997439,20.0,20.0
9372,0,9372,[ 64 483 318 313 187],214,5,38408,4.0977275152032435,80.0,20.0
9373,0,9373,[ 64 483 318 313 187],618,5,38413,4.097823767868572,80.0,20.0
9374,0,9374,[ 64 483 318 313 187],214,5,38418,4.09792,80.0,20.0
9375,0,9375,[ 64 483 318 313 187],214,5,38423,4.0980162116040955,80.0,20.0
9376,0,9376,[483 273 237  64 151],62,4,38427,4.098005758771462,40.0,0.0
9377,0,9377,[289  12  82 121   1],588,4,38431,4.097995308168053,20.0,0.0
9378,0,9378,[ 69 197 678 204 318],345,4,38435,4.097984859793155,20.0,0.0
9379,0,9379,[234 237 121 127   4],416,4,38439,4.097974413646056,0.0,0.0
9380,0,9380,[ 82 568 161 117  96],751,3,38442,4.097857371282379,0.0,0.0
9381,0,9381,[423  88 143 288 186],642,3,38445,4.097740353869111,0.0,20.0
9382,0,9382,[603 195 118 135 210],437,2,38447,4.097516785676223,0.0,0.0
9383,0,9383,[144 328  15 196 385],373,3,38450,4.097399829497016,0.0,0.0
9384,0,9384,[273   7 125 235 191],62,5,38455,4.09749600426212,0.0,0.0
9385,0,9385,[ 64 483 318 313 187],214,5,38460,4.0975921585339865,80.0,20.0
9386,0,9386,[ 64 483 318 313 187],618,5,38465,4.097688292319165,80.0,20.0
9387,0,9387,[ 64 483 318 313 187],214,5,38470,4.097784405624201,80.0,20.0
9388,0,9388,[403 161 471 423 181],373,2,38472,4.097560975609756,0.0,20.0
9389,0,9389,[216 181 173 423 168],354,3,38475,4.097444089456869,0.0,20.0
9390,0,9390,[ 64 483 318 313 187],618,5,38480,4.097540198061974,80.0,20.0
9391,0,9391,[185 471  96 153 268],416,5,38485,4.0976362862010225,0.0,0.0
9392,0,9392,[ 98 187 215 127  82],618,5,38490,4.0977323538805495,0.0,20.0
9393,0,9393,[ 82 322 403 194  64],416,4,38494,4.097721950180967,20.0,0.0
9394,0,9394,[181 471 172 187 191],505,1,38495,4.097392229909526,0.0,20.0
9395,0,9395,[ 64 483 318 313 187],214,5,38500,4.097488292890592,80.0,20.0
9396,0,9396,[ 50 144 215 748 300],416,5,38505,4.0975843354262,0.0,20.0
9397,0,9397,[ 64 483 318 313 187],618,5,38510,4.0976803575228775,80.0,20.0
9398,0,9398,[100  56 179  11 742],417,3,38513,4.097563570592616,0.0,0.0
9399,0,9399,[144  69 742 328 483],62,2,38515,4.097340425531915,20.0,0.0
9400,0,9400,[ 97  95 302   7 186],417,3,38518,4.097223699606425,0.0,0.0
9401,0,9401,[228 172  88 196 100],805,2,38520,4.097000638162093,0.0,0.0
9402,0,9402,[ 64 483 318 313 187],618,5,38525,4.097096671275125,80.0,20.0
9403,0,9403,[ 64 483 318 313 187],618,5,38530,4.097192683964271,80.0,20.0
9404,0,9404,[ 64 483 318 313 187],618,5,38535,4.097288676236045,80.0,20.0
9405,0,9405,[ 64 483 318 313 187],214,5,38540,4.097384648096959,80.0,20.0
9406,0,9406,[289  56 117  12  79],345,4,38544,4.097374295737217,20.0,0.0
9407,0,9407,[288 289 357 475 748],416,3,38547,4.097257653061225,0.0,20.0
9408,0,9408,[151  69 173 204 168],922,2,38549,4.097034753958975,0.0,0.0
9409,0,9409,[385  56 173 216 597],588,4,38553,4.0970244420828905,0.0,0.0
9410,0,9410,[ 64 483 318 313 187],214,5,38558,4.097120391031772,80.0,20.0
9411,0,9411,[100  69 269 742 132],416,5,38563,4.09721631959201,0.0,0.0
9412,0,9412,[  1 357 655 403 568],417,4,38567,4.0972059917135875,0.0,0.0
9413,0,9413,[294 100 333 215 423],416,5,38572,4.097301890800935,0.0,0.0
9414,0,9414,[ 64 483 318 313 187],618,5,38577,4.0973977695167285,80.0,20.0
9415,0,9415,[204  25 302  50 191],43,5,38582,4.097493627867459,0.0,20.0
9416,0,9416,[151 318 403 181  22],642,3,38585,4.097377083997027,20.0,20.0
9417,0,9417,[ 64 483 313 318 187],618,5,38590,4.097472924187725,80.0,20.0
9418,0,9418,[168  28 216 475 204],297,4,38594,4.097462575644973,0.0,0.0
9419,0,9419,[ 64 483 313 318 187],618,5,38599,4.097558386411889,80.0,20.0
9420,0,9420,[ 64 483 313 318 187],214,5,38604,4.097654176838977,80.0,20.0
9421,0,9421,[ 64 483 313 318 187],618,5,38609,4.09774994693271,80.0,20.0
9422,0,9422,[475 258 195 588 168],297,4,38613,4.097739573384272,0.0,0.0
9423,0,9423,[289  98 357 144 127],854,3,38616,4.097623089983022,0.0,20.0
9424,0,9424,[ 50 216 181  12  69],437,4,38620,4.097612732095491,20.0,40.0
9425,0,9425,[ 64 483 313 318 187],214,5,38625,4.097708465945257,80.0,20.0
9426,0,9426,[ 64 483 313 318 187],214,5,38630,4.097804179484459,80.0,20.0
9427,0,9427,[603 161  15 237 294],416,4,38634,4.0977938056851935,0.0,0.0
9428,0,9428,[568  56 435 172  69],405,4,38638,4.097783434086329,0.0,0.0
9429,0,9429,[323 117 183 168 186],198,3,38641,4.097667020148462,0.0,0.0
9430,0,9430,[ 64 483 313 318 187],618,5,38646,4.097762697487011,80.0,20.0
9431,0,9431,[ 64 483 313 318 187],618,5,38651,4.097858354537744,80.0,20.0
9432,0,9432,[211 678  22  98  15],416,4,38655,4.09784798049401,0.0,20.0
9433,0,9433,[294 173  79  71  96],907,5,38660,4.097943608225567,0.0,0.0
9434,0,9434,[ 64 483 313 318 187],618,5,38665,4.098039215686274,80.0,20.0
9435,0,9435,[655  28 546 273 195],416,4,38669,4.098028825773633,0.0,0.0
9436,0,9436,[ 64 483 313 318 187],618,5,38674,4.098124403941931,80.0,20.0
9437,0,9437,[742  95 197 173  82],416,4,38678,4.0981140072049165,0.0,0.0
9438,0,9438,[200 185 294  95  28],262,0,38678,4.097679838965992,0.0,0.0
9439,0,9439,[ 64 483 313 318 187],618,5,38683,4.097775423728813,80.0,20.0
9440,0,9440,[111 211 117 173 100],416,5,38688,4.097870988242771,0.0,0.0
9441,0,9441,[ 64 483 313 318 187],618,5,38693,4.097966532514298,80.0,20.0
9442,0,9442,[294 216   7 257 276],62,3,38696,4.097850259451445,0.0,0.0
9443,0,9443,[ 95 144  69   1 153],230,4,38700,4.097839898348157,0.0,0.0
9444,0,9444,[258  71 125 161 313],345,2,38702,4.097617787188989,20.0,20.0
9445,0,9445,[118 151 742  71 269],43,5,38707,4.097713317806479,0.0,0.0
9446,0,9446,[ 69  71 496  25 161],314,4,38711,4.0977029744892555,0.0,0.0
9447,0,9447,[127 161 185  82 294],805,1,38712,4.097375105842507,0.0,0.0
9448,0,9448,[ 64 483 313 318 187],214,5,38717,4.09747063181289,80.0,20.0
9449,0,9449,[238 176 117  71  95],805,2,38719,4.097248677248677,0.0,0.0
9450,0,9450,[ 64 483 313 318 187],618,5,38724,4.097344196381336,80.0,20.0
9451,0,9451,[197 294 475 176 143],416,4,38728,4.097333897587812,0.0,0.0
9452,0,9452,[302 204 187 603 182],405,3,38731,4.097217814450439,0.0,0.0
9453,0,9453,[ 64 483 313 318 187],214,5,38736,4.097313306536916,80.0,20.0
9454,0,9454,[ 64 483 313 318 187],618,5,38741,4.097408778424114,80.0,20.0
9455,0,9455,[ 64  22 588 132  71],405,3,38744,4.0972927241962775,20.0,0.0
9456,0,9456,[ 64 483 313 318 187],618,5,38749,4.0973881780691555,80.0,20.0
9457,0,9457,[ 64 483 313 318 187],618,5,38754,4.097483611757243,80.0,20.0
9458,0,9458,[179 187 132 483 191],214,5,38759,4.097579025266942,20.0,0.0
9459,0,9459,[546 176 403 118 211],417,4,38763,4.097568710359408,0.0,0.0
9460,0,9460,[182 153  11 185 427],416,5,38768,4.097664094704577,0.0,0.0
9461,0,9461,[ 64 483 313 318 187],214,5,38773,4.097759458888184,80.0,20.0
9462,0,9462,[ 64 483 313 318 187],618,5,38778,4.097854802916623,80.0,20.0
9463,0,9463,[ 64 483 313 318 187],618,5,38783,4.097950126796281,80.0,20.0
9464,0,9464,[117   4 200 273 678],805,2,38785,4.097728473322768,0.0,0.0
9465,0,9465,[ 64 483 313 318 187],618,5,38790,4.097823790407775,80.0,20.0
9466,0,9466,[ 64 483 313 318 187],214,5,38795,4.097919087356079,80.0,20.0
9467,0,9467,[ 64 483 313 318 187],214,5,38800,4.09801436417406,80.0,20.0
9468,0,9468,[ 64 483 313 318 187],214,5,38805,4.098109620868096,80.0,20.0
9469,0,9469,[276 168 323 289 597],43,3,38808,4.097993664202746,0.0,0.0
9470,0,9470,[117 288 603 182 275],437,2,38810,4.097772146552634,0.0,20.0
9471,0,9471,[742  25 200  11 294],854,2,38812,4.097550675675675,0.0,0.0
9472,0,9472,[234 117 210 265 111],416,5,38817,4.097645941095746,0.0,0.0
9473,0,9473,[ 64 483 313 318 187],214,5,38822,4.097741186404898,80.0,20.0
9474,0,9474,[ 64 483 313 318 187],618,5,38827,4.0978364116094985,80.0,20.0
9475,0,9475,[  8 183 187  82 742],416,5,38832,4.097931616715914,0.0,0.0
9476,0,9476,[ 64 483 313 318 187],214,5,38837,4.098026801730505,80.0,20.0
9477,0,9477,[300 294 257 215 132],416,4,38841,4.098016459168601,0.0,0.0
9478,0,9478,[117 313 271 216  70],43,4,38845,4.098006118788902,20.0,20.0
9479,0,9479,[333 357 597 276 238],416,3,38848,4.09789029535865,0.0,0.0
9480,0,9480,[ 64 483 313 318 187],618,5,38853,4.097985444573357,80.0,20.0
9481,0,9481,[ 64 483 313 318 187],618,5,38858,4.098080573718625,80.0,20.0
9482,0,9482,[196 328 403  64 271],62,3,38861,4.09796477907835,20.0,0.0
9483,0,9483,[ 88 265 273 276 234],618,4,38865,4.097954449599325,0.0,0.0
9484,0,9484,[ 64 483 313 318 187],618,5,38870,4.098049551924091,80.0,20.0
9485,0,9485,[597 118 168 181  12],417,3,38873,4.097933797174784,20.0,20.0
9486,0,9486,[ 64 483 313 318 187],214,5,38878,4.09802888162749,80.0,20.0
9487,0,9487,[ 64 483 313 318 187],214,5,38883,4.0981239460370995,80.0,20.0
9488,0,9488,[174  22 194 313 132],405,4,38887,4.098113605227105,20.0,20.0
9489,0,9489,[ 71 161  50 197 323],805,3,38890,4.097997892518441,0.0,20.0
9490,0,9490,[271 179 275 111 423],62,2,38892,4.097776841217996,0.0,0.0
9491,0,9491,[235  96 210  22 286],416,4,38896,4.097766540244416,0.0,0.0
9492,0,9492,[  1   4 210 405  22],416,5,38901,4.097861582218477,0.0,0.0
9493,0,9493,[ 64 483 313 318 187],618,5,38906,4.097956604171055,80.0,20.0
9494,0,9494,[143 175 185 168 423],354,4,38910,4.097946287519747,0.0,0.0
9495,0,9495,[ 64 483 313 318 187],214,5,38915,4.098041280539174,80.0,20.0
9496,0,9496,[176 179 235   9  11],416,3,38918,4.097925660734969,0.0,0.0
9497,0,9497,[ 64 508 143 215 117],345,5,38923,4.098020635923352,20.0,0.0
9498,0,9498,[ 64 483 313 318 187],618,5,38928,4.098115591114854,80.0,20.0
9499,0,9499,[181 197 168  95  88],711,5,38933,4.098210526315789,0.0,20.0
9500,0,9500,[237 173 174 275 603],297,5,38938,4.09830544153247,0.0,0.0
9501,0,9501,[ 64 483 313 318 187],214,5,38943,4.098400336771206,80.0,20.0
9502,0,9502,[ 89 286 588  97  11],437,0,38943,4.097969062401347,0.0,0.0
9503,0,9503,[191 210 258  95   1],198,4,38947,4.097958754208754,0.0,0.0
9504,0,9504,[496 678  28 275  12],654,5,38952,4.098053655970542,20.0,0.0
9505,0,9505,[405 174  15 132  56],601,2,38954,4.0978329476120345,0.0,0.0
9506,0,9506,[ 56   4 125 475 655],342,4,38958,4.097822656989587,0.0,0.0
9507,0,9507,[ 89 125 748 132 143],642,3,38961,4.097707193941944,0.0,0.0
9508,0,9508,[195 748 234 185 405],417,3,38964,4.0975917551793035,0.0,0.0
9509,0,9509,[ 64 483 313 318 187],618,5,38969,4.0976866456361725,80.0,20.0
9510,0,9510,[475 318 111 216  15],588,3,38972,4.0975712333088,20.0,0.0
9511,0,9511,[  8   7 483 423 144],342,5,38977,4.097666105971404,20.0,0.0
9512,0,9512,[ 64 483 313 318 187],618,5,38982,4.097760958688111,80.0,20.0
9513,0,9513,[182 135 282 427 508],342,2,38984,4.097540466680681,0.0,0.0
9514,0,9514,[ 96  50 132 151  97],642,3,38987,4.097425118234367,0.0,20.0
9515,0,9515,[423 196  25  11   1],618,4,38991,4.097414880201765,0.0,0.0
9516,0,9516,[144 100 222 210 313],654,4,38995,4.097404644320689,20.0,20.0
9517,0,9517,[ 88 200 179 238  11],437,3,38998,4.097289346501366,0.0,0.0
9518,0,9518,[ 64 483 313 318 187],618,5,39003,4.0973841790104,80.0,20.0
9519,0,9519,[ 64 483 313 318 187],618,5,39008,4.097478991596638,80.0,20.0
9520,0,9520,[ 64 483 313 318 187],618,5,39013,4.097573784266358,80.0,20.0
9521,0,9521,[742 546   1 300 268],416,4,39017,4.097563537072044,0.0,0.0
9522,0,9522,[496 202 302 300   4],43,5,39022,4.097658300955581,0.0,0.0
9523,0,9523,[237 742 405 302  71],62,1,39023,4.097333053338933,0.0,0.0
9524,0,9524,[ 64 483 313 318 187],618,5,39028,4.097427821522309,80.0,20.0
9525,0,9525,[ 64 174  70 172 748],373,5,39033,4.097522569808944,20.0,0.0
9526,0,9526,[182 216 144 168 200],417,3,39036,4.097407368531542,0.0,0.0
9527,0,9527,[258 286   1 235 216],417,3,39039,4.097292191435768,0.0,0.0
9528,0,9528,[403  50 318 216 294],62,4,39043,4.09728198132018,20.0,20.0
9529,0,9529,[ 64 483 313 318 187],618,5,39048,4.097376705141658,80.0,20.0
9530,0,9530,[301 161  71 568 196],416,5,39053,4.09747140908614,0.0,0.0
9531,0,9531,[200 180 176  56 117],437,3,39056,4.0973562736047,0.0,0.0
9532,0,9532,[  4 235 286 183 216],416,4,39060,4.097346061051086,0.0,0.0
9533,0,9533,[ 64 483 313 318 187],618,5,39065,4.097440738409901,80.0,20.0
9534,0,9534,[ 64 483 313 318 187],618,5,39070,4.097535395909806,80.0,20.0
9535,0,9535,[ 98  79 121  25 100],618,4,39074,4.097525167785235,0.0,20.0
9536,0,9536,[ 69 215 603  79 181],373,5,39079,4.097619796581735,0.0,20.0
9537,0,9537,[194 125 238 245 748],416,4,39083,4.097609561752988,0.0,0.0
9538,0,9538,[  4   7 187 132  69],416,5,39088,4.09770416186183,0.0,0.0
9539,0,9539,[318 568 186  28 385],588,4,39092,4.09769392033543,20.0,0.0
9540,0,9540,[ 64 483 313 318 187],214,5,39097,4.097788491772351,80.0,20.0
9541,0,9541,[294 318 405  97  71],416,5,39102,4.097883043387131,20.0,0.0
9542,0,9542,[ 64 483 313 318 187],618,5,39107,4.097977575186,80.0,20.0
9543,0,9543,[597 215 153 210 172],751,4,39111,4.097967309304275,0.0,0.0
9544,0,9544,[ 64 483 313 318 187],214,5,39116,4.09806181246726,80.0,20.0
9545,0,9545,[204 234 427 238 182],618,3,39119,4.0979467839932955,0.0,0.0
9546,0,9546,[ 64 483 313 318 187],618,5,39124,4.098041269508746,80.0,20.0
9547,0,9547,[ 88 197 100 215  25],373,3,39127,4.097926267281106,0.0,0.0
9548,0,9548,[ 64 483 313 318 187],214,5,39132,4.098020735155513,80.0,20.0
9549,0,9549,[ 64 483 313 318 187],214,5,39137,4.098115183246073,80.0,20.0
9550,0,9550,[301 151 313  12 286],345,4,39141,4.098104910480578,40.0,20.0
9551,0,9551,[182  12 118  69 127],416,4,39145,4.098094639865996,20.0,0.0
9552,0,9552,[ 64 483 313 318 187],214,5,39150,4.098189050560033,80.0,20.0
9553,0,9553,[202 483 257 172 273],417,2,39152,4.097969436885075,20.0,0.0
9554,0,9554,[ 64 483 313 318 187],618,5,39157,4.098063840920984,80.0,20.0
9555,0,9555,[ 64 483 313 318 187],618,5,39162,4.098158225198828,80.0,20.0
9556,0,9556,[405  25 118   4 235],345,2,39164,4.0979386836873495,0.0,0.0
9557,0,9557,[ 12 238 508 235 186],417,3,39167,4.097823812513078,20.0,0.0
9558,0,9558,[222  50 288 111 323],805,3,39170,4.097708965372947,0.0,40.0
9559,0,9559,[ 95 597 288 172 202],417,2,39172,4.097489539748954,0.0,20.0
9560,0,9560,[ 64 483 313 318 187],618,5,39177,4.09758393473486,80.0,20.0
9561,0,9561,[258 357 125 191  69],630,0,39177,4.097155406818657,0.0,0.0
9562,0,9562,[276 143 302  69 197],416,4,39181,4.09714524730733,0.0,0.0
9563,0,9563,[300 173 117  12 302],654,5,39186,4.097239648682559,20.0,0.0
9564,0,9564,[ 64 483 313 318 187],618,5,39191,4.097334030318871,80.0,20.0
9565,0,9565,[191 655 496 265 153],373,5,39196,4.097428392222454,0.0,0.0
9566,0,9566,[144 118 121  70 174],751,4,39200,4.097418208424793,0.0,0.0
9567,0,9567,[238  96 588  71 195],601,0,39200,4.096989966555184,0.0,0.0
9568,0,9568,[ 64 483 313 318 187],618,5,39205,4.097084334831226,80.0,20.0
9569,0,9569,[ 64 483 313 318 187],618,5,39210,4.09717868338558,80.0,20.0
9570,0,9570,[151 196 204 258 257],297,2,39212,4.096959565353672,0.0,0.0
9571,0,9571,[276 286 211 275  12],416,4,39216,4.096949435854576,20.0,0.0
9572,0,9572,[ 64 483 313 318 187],214,5,39221,4.0970437689334585,80.0,20.0
9573,0,9573,[ 64 483 313 318 187],214,5,39226,4.097138082306246,80.0,20.0
9574,0,9574,[  4 161 427 143 237],416,4,39230,4.097127937336815,0.0,0.0
9575,0,9575,[ 64 483 313 318 187],214,5,39235,4.097222222222222,80.0,20.0
9576,0,9576,[ 64 483 313 318 187],214,5,39240,4.097316487417772,80.0,20.0
9577,0,9577,[ 64 483 313 318 187],618,5,39245,4.097410732929631,80.0,20.0
9578,0,9578,[222 423 168 144 269],43,5,39250,4.097504958763963,0.0,0.0
9579,0,9579,[ 56 268 300 173 435],721,4,39254,4.097494780793319,0.0,0.0
9580,0,9580,[323 258 245 475 322],417,3,39257,4.09738023170859,0.0,0.0
9581,0,9581,[210 588 597 181 168],416,4,39261,4.097370068879148,0.0,20.0
9582,0,9582,[515 172 181 186  11],405,4,39265,4.097359908170719,0.0,20.0
9583,0,9583,[ 64 483 313 318 187],618,5,39270,4.097454090150251,80.0,20.0
9584,0,9584,[435 161 210   4  95],373,5,39275,4.0975482524778295,0.0,0.0
9585,0,9585,[ 64 483 313 318 187],618,5,39280,4.097642395159608,80.0,20.0
9586,0,9586,[546 216 151 423 174],62,4,39284,4.09763221028476,0.0,0.0
9587,0,9587,[ 96 191 132 183 423],405,3,39287,4.097517730496454,0.0,0.0
9588,0,9588,[269  95  96 117 238],373,5,39292,4.097611846907915,0.0,0.0
9589,0,9589,[ 64 483 313 318 187],618,5,39297,4.097705943691345,80.0,20.0
9590,0,9590,[300 117 546 127 282],416,4,39301,4.097695756438328,0.0,0.0
9591,0,9591,[294  11  98  95  25],230,4,39305,4.097685571309425,0.0,20.0
9592,0,9592,[ 64 483 313 318 187],618,5,39310,4.097779630980924,80.0,20.0
9593,0,9593,[ 64 483 313 318 187],214,5,39315,4.097873671044403,80.0,20.0
9594,0,9594,[ 64 483 313 318 187],618,5,39320,4.097967691505993,80.0,20.0
9595,0,9595,[144  22 153 318 475],416,4,39324,4.0979574822842855,20.0,0.0
9596,0,9596,[ 64 483 313 318 187],214,5,39329,4.09805147441909,80.0,20.0
9597,0,9597,[ 64 483 313 318 187],214,5,39334,4.098145446968118,80.0,20.0
9598,0,9598,[135 475  28 195  71],437,1,39335,4.097822689863527,0.0,0.0
9599,0,9599,[100 121  15 423 475],416,4,39339,4.0978125,0.0,0.0
9600,0,9600,[257  15 405  70 153],642,2,39341,4.097594000624935,0.0,0.0
9601,0,9601,[204 385 302 237 238],345,4,39345,4.097583836700688,0.0,0.0
9602,0,9602,[ 71 322   7 238  56],416,4,39349,4.097573674893263,0.0,0.0
9603,0,9603,[197  95 234  28 301],437,3,39352,4.097459391920033,0.0,0.0
9604,0,9604,[111  70   8  56 568],654,5,39357,4.097553357626237,0.0,0.0
9605,0,9605,[118 202 197 328 153],416,4,39361,4.097543202165314,0.0,0.0
9606,0,9606,[ 64 483 313 318 187],618,5,39366,4.097637139585719,80.0,20.0
9607,0,9607,[ 50 100 197  12 202],297,3,39369,4.097522897585345,20.0,20.0
9608,0,9608,[204  82  96   4 180],805,1,39370,4.09720054115933,0.0,0.0
9609,0,9609,[546 302 117 294 135],417,2,39372,4.096982310093653,0.0,0.0
9610,0,9610,[294 423 282 289 300],223,2,39374,4.096764124440745,0.0,0.0
9611,0,9611,[515 176 216 161 117],230,5,39379,4.0968580940491055,0.0,0.0
9612,0,9612,[423 210 238 100 258],654,4,39383,4.096848018308541,0.0,0.0
9613,0,9613,[ 95 257  97   9  79],43,5,39388,4.096941959642188,0.0,0.0
9614,0,9614,[210 268 269 100 385],416,5,39393,4.097035881435257,0.0,0.0
9615,0,9615,[210 508  28 143 175],297,5,39398,4.097129783693844,0.0,0.0
9616,0,9616,[ 12 135   8  96  98],854,4,39402,4.097119683893106,20.0,20.0
9617,0,9617,[ 64 483 313 318 187],618,5,39407,4.097213557912248,80.0,20.0
9618,0,9618,[301 237   1 118 546],416,2,39409,4.09699552968084,0.0,0.0
9619,0,9619,[ 98 496 655  25  15],588,2,39411,4.096777546777547,0.0,20.0
9620,0,9620,[ 64 483 313 318 187],214,5,39416,4.096871427086581,80.0,20.0
9621,0,9621,[ 64 483 313 318 187],618,5,39421,4.096965287881937,80.0,20.0
9622,0,9622,[ 64 483 313 318 187],618,5,39426,4.097059129169698,80.0,20.0
9623,0,9623,[ 64 483 313 318 187],618,5,39431,4.097152950955944,80.0,20.0
9624,0,9624,[ 82 276 182 568 132],128,4,39435,4.097142857142857,0.0,0.0
9625,0,9625,[ 64 483 313 318 187],214,5,39440,4.097236650737586,80.0,20.0
9626,0,9626,[ 64 483 313 318 187],214,5,39445,4.097330424846785,80.0,20.0
9627,0,9627,[ 64 483 313 318 187],214,5,39450,4.097424179476527,80.0,20.0
9628,0,9628,[ 64 483 313 318 187],618,5,39455,4.0975179146328795,80.0,20.0
9629,0,9629,[ 98 475 187 176   7],198,5,39460,4.097611630321911,0.0,20.0
9630,0,9630,[588 202 238 655 515],405,3,39463,4.097497663793998,0.0,0.0
9631,0,9631,[238   7 289  71  11],43,4,39467,4.097487541528239,0.0,0.0
9632,0,9632,[ 64 483 313 318 187],214,5,39472,4.09758123118447,80.0,20.0
9633,0,9633,[153 238  69 117 289],854,3,39475,4.097467303300809,0.0,0.0
9634,0,9634,[ 64 483 313 318 187],214,5,39480,4.097560975609756,80.0,20.0
9635,0,9635,[ 64 483 313 318 187],214,5,39485,4.097654628476547,80.0,20.0
9636,0,9636,[111 202 301 125 182],907,5,39490,4.097748261907233,0.0,0.0
9637,0,9637,[ 64 483 313 318 187],618,5,39495,4.097841875907864,80.0,20.0
9638,0,9638,[385  98  69 357 515],417,4,39499,4.097831725282706,0.0,20.0
9639,0,9639,[ 64 483 313 318 187],618,5,39504,4.097925311203319,80.0,20.0
9640,0,9640,[ 64 483 313 318 187],618,5,39509,4.098018877709781,80.0,20.0
9641,0,9641,[ 64 483 313 318 187],618,5,39514,4.098112424808131,80.0,20.0
9642,0,9642,[  7 235 168 127  50],854,4,39518,4.098102250337032,0.0,20.0
9643,0,9643,[ 15 235   1 100  12],417,3,39521,4.0979883865615925,20.0,0.0
9644,0,9644,[286 151 471 187  50],416,4,39525,4.097978227060653,0.0,20.0
9645,0,9645,[173 471  79 195 286],416,5,39530,4.098071739581173,0.0,0.0
9646,0,9646,[ 64 483 313 318 187],618,5,39535,4.098165232714834,80.0,20.0
9647,0,9647,[282 385 268 597 117],588,4,39539,4.098155058043118,0.0,0.0
9648,0,9648,[ 64 483 313 318 187],618,5,39544,4.098248523163022,80.0,20.0
9649,0,9649,[294 127  50  22 568],62,3,39547,4.098134715025907,0.0,20.0
9650,0,9650,[ 64 483 313 318 187],618,5,39552,4.098228162884675,80.0,20.0
9651,0,9651,[ 64 483 313 318 187],214,5,39557,4.098321591380025,80.0,20.0
9652,0,9652,[ 95  50  22 182 173],505,2,39559,4.098104216305812,0.0,20.0
9653,0,9653,[222 294 234 183 202],297,2,39561,4.097886886264761,0.0,0.0
9654,0,9654,[ 64 483 313 318 187],618,5,39566,4.097980321077162,80.0,20.0
9655,0,9655,[ 15 191 121   1 276],764,3,39569,4.0978666114333056,0.0,0.0
9656,0,9656,[ 64 483 313 318 187],618,5,39574,4.097960028994512,80.0,20.0
9657,0,9657,[ 64 483 313 318 187],214,5,39579,4.098053427210602,80.0,20.0
9658,0,9658,[132 175  70 200 173],405,2,39581,4.097836214929082,0.0,0.0
9659,0,9659,[135 322 603 271 289],854,3,39584,4.097722567287785,0.0,0.0
9660,0,9660,[ 64 483 313 318 187],214,5,39589,4.0978159610806335,80.0,20.0
9661,0,9661,[  4  98 318  50 257],854,3,39592,4.097702339060236,20.0,40.0
9662,0,9662,[ 97 597  96 357   7],417,2,39594,4.09748525302701,0.0,0.0
9663,0,9663,[ 64 483 313 318 187],214,5,39599,4.097578642384106,80.0,20.0
9664,0,9664,[ 64 483 313 318 187],618,5,39604,4.097672012415933,80.0,20.0
9665,0,9665,[121  28  56  82 144],230,3,39607,4.097558452307056,0.0,0.0
9666,0,9666,[ 64 483 313 318 187],618,5,39612,4.097651805110169,80.0,20.0
9667,0,9667,[ 64 483 313 318 187],214,5,39617,4.097745138601573,80.0,20.0
9668,0,9668,[ 82 289 496 118   8],416,3,39620,4.097631606164029,0.0,0.0
9669,0,9669,[ 64 483 313 318 187],214,5,39625,4.097724922440538,80.0,20.0
9670,0,9670,[ 25  28 300  82 258],128,3,39628,4.09761141557233,0.0,0.0
9671,0,9671,[222  89  15 273 173],417,3,39631,4.097497932175352,0.0,0.0
9672,0,9672,[ 64 483 313 318 187],618,5,39636,4.097591233329887,80.0,20.0
9673,0,9673,[ 64 483 313 318 187],618,5,39641,4.097684515195369,80.0,20.0
9674,0,9674,[318  89 153 403 300],198,4,39645,4.097674418604651,20.0,0.0
9675,0,9675,[ 64 483 313 318 187],618,5,39650,4.0977676725919805,80.0,20.0
9676,0,9676,[ 28 748   4 174 216],654,5,39655,4.097860907305983,0.0,0.0
9677,0,9677,[ 64 483 313 318 187],214,5,39660,4.097954122752635,80.0,20.0
9678,0,9678,[313 185 273 282 191],618,4,39664,4.097944002479595,20.0,20.0
9679,0,9679,[121 210 655 222 180],62,4,39668,4.097933884297521,0.0,0.0
9680,0,9680,[111 357 288  64 245],721,3,39671,4.097820473091622,20.0,20.0
9681,0,9681,[588  95 143 185 127],405,3,39674,4.097707085312952,0.0,0.0
9682,0,9682,[ 64 483 313 318 187],618,5,39679,4.097800268511825,80.0,20.0
9683,0,9683,[ 64 483 313 318 187],618,5,39684,4.0978934324659235,80.0,20.0
9684,0,9684,[ 89 183 588 603 546],805,3,39687,4.097780072276716,0.0,0.0
9685,0,9685,[ 64 483 313 318 187],214,5,39692,4.097873219079084,80.0,20.0
9686,0,9686,[125 475 288 216 118],417,3,39695,4.097759884381129,0.0,20.0
9687,0,9687,[ 64 483 313 318 187],214,5,39700,4.097853014037985,80.0,20.0
9688,0,9688,[186 257 235 483 181],417,2,39702,4.097636494994323,20.0,20.0
9689,0,9689,[ 56 117 185 111   9],416,5,39707,4.097729618163054,0.0,0.0
9690,0,9690,[ 64 483 313 318 187],214,5,39712,4.097822722113301,80.0,20.0
9691,0,9691,[ 64 483 313 318 187],214,5,39717,4.097915806851011,80.0,20.0
9692,0,9692,[237 471  88 191 508],345,4,39721,4.097905705148045,0.0,0.0
9693,0,9693,[181 118  89  88  50],751,3,39724,4.097792448937487,0.0,40.0
9694,0,9694,[  7 271 176  82 237],62,3,39727,4.097679216090769,0.0,0.0
9695,0,9695,[ 97 194 237 211 269],416,4,39731,4.097669141914191,0.0,0.0
9696,0,9696,[546 197  11 204  89],297,2,39733,4.097452820459936,0.0,0.0
9697,0,9697,[235 100 678 273 111],805,2,39735,4.097236543617241,0.0,0.0
9698,0,9698,[125   4 245 143 100],416,4,39739,4.097226518197752,0.0,0.0
9699,0,9699,[ 15  79  71 588 235],43,4,39743,4.097216494845361,0.0,0.0
9700,0,9700,[748   1 172 286 237],345,2,39745,4.09700030924647,0.0,0.0
9701,0,9701,[300 276  50  79 186],198,2,39747,4.096784168212739,0.0,20.0
9702,0,9702,[143  70 258 216 228],128,2,39749,4.096568071730393,0.0,0.0
9703,0,9703,[ 64 483 313 318 187],214,5,39754,4.096661170651278,80.0,20.0
9704,0,9704,[ 64 483 313 318 187],214,5,39759,4.0967542503863985,80.0,20.0
9705,0,9705,[237 215 294  69 143],128,4,39763,4.096744281887492,0.0,0.0
9706,0,9706,[ 64 483 313 318 187],214,5,39768,4.096837333882765,80.0,20.0
9707,0,9707,[111 257  25 302 121],417,0,39768,4.096415327564895,0.0,0.0
9708,0,9708,[216 210 153 301 265],437,2,39770,4.096199402616129,0.0,0.0
9709,0,9709,[175 132 302   8 186],405,4,39774,4.096189495365603,0.0,0.0
9710,0,9710,[ 64 483 313 318 187],618,5,39779,4.096282566162084,80.0,20.0
9711,0,9711,[ 64 483 313 318 187],618,5,39784,4.096375617792422,80.0,20.0
9712,0,9712,[ 64 483 313 318 187],214,5,39789,4.096468650262535,80.0,20.0
9713,0,9713,[ 64 483 313 318 187],618,5,39794,4.09656166357834,80.0,20.0
9714,0,9714,[153  71   7  64 269],43,5,39799,4.096654657745754,20.0,0.0
9715,0,9715,[135  82 427  69 385],198,3,39802,4.096541786743516,0.0,0.0
9716,0,9716,[ 64 483 313 318 187],214,5,39807,4.096634763815993,80.0,20.0
9717,0,9717,[228 245 173  15 182],128,3,39810,4.096521918090142,0.0,0.0
9718,0,9718,[ 82 144  71 258 100],416,5,39815,4.096614878073876,0.0,0.0
9719,0,9719,[183 603 271 678 200],297,2,39817,4.0963991769547325,0.0,0.0
9720,0,9720,[ 82 427  79 276 568],198,1,39818,4.096080650138875,0.0,0.0
9721,0,9721,[181  50 286 258 118],270,3,39821,4.095967907837894,0.0,40.0
9722,0,9722,[ 64 483 313 318 187],618,5,39826,4.096060886557646,80.0,20.0
9723,0,9723,[ 64 483 313 318 187],618,5,39831,4.096153846153846,80.0,20.0
9724,0,9724,[ 64 483 313 318 187],618,5,39836,4.096246786632391,80.0,20.0
9725,0,9725,[ 64 483 313 318 187],618,5,39841,4.096339707999178,80.0,20.0
9726,0,9726,[151  97 313 483 655],588,3,39844,4.096226997018608,40.0,20.0
9727,0,9727,[132 268  22 403 202],416,5,39849,4.096319901315789,0.0,0.0
9728,0,9728,[ 70 237 161 357 258],416,4,39853,4.096310001027855,0.0,0.0
9729,0,9729,[ 82 196 175 269 204],373,3,39856,4.096197327852004,0.0,0.0
9730,0,9730,[300 568 234 302 172],416,5,39861,4.096290206556366,0.0,0.0
9731,0,9731,[333 174 144 185  98],416,5,39866,4.096383066173448,0.0,20.0
9732,0,9732,[ 64 483 313 318 187],214,5,39871,4.096475906709134,80.0,20.0
9733,0,9733,[300 118 151 237 197],297,1,39872,4.096157797411136,0.0,0.0
9734,0,9734,[161 144 179 289  98],416,3,39875,4.096045197740113,0.0,20.0
9735,0,9735,[ 64 483 313 318 187],214,5,39880,4.096138044371405,80.0,20.0
9736,0,9736,[ 64 483 313 318 187],618,5,39885,4.096230871931806,80.0,20.0
9737,0,9737,[185 245 423   4 179],417,3,39888,4.096118299445472,0.0,0.0
9738,0,9738,[127 268  50  96 515],416,5,39893,4.0962111099702225,0.0,20.0
9739,0,9739,[ 64 483 313 318 187],618,5,39898,4.096303901437372,80.0,20.0
9740,0,9740,[322 117 100 300 235],416,3,39901,4.096191356123601,0.0,0.0
9741,0,9741,[289   8  22  28 568],887,4,39905,4.09618148224184,0.0,0.0
9742,0,9742,[ 64 483 313 318 187],214,5,39910,4.0962742481781795,80.0,20.0
9743,0,9743,[ 64 483 313 318 187],214,5,39915,4.0963669950738915,80.0,20.0
9744,0,9744,[234 228 195  64 179],405,3,39918,4.096254489481786,20.0,0.0
9745,0,9745,[ 95 174  98 273 245],764,4,39922,4.096244613174636,0.0,20.0
9746,0,9746,[ 64 483 313 318 187],214,5,39927,4.096337334564481,80.0,20.0
9747,0,9747,[ 64 483 313 318 187],214,5,39932,4.096430036930652,80.0,20.0
9748,0,9748,[275 238 172 182  82],62,5,39937,4.096522720279003,0.0,0.0
9749,0,9749,[216 318 748 172 655],437,5,39942,4.096615384615385,20.0,0.0
9750,0,9750,[  1 121 194  22   4],854,0,39942,4.096195262024407,0.0,0.0
9751,0,9751,[ 64 483 313 318 187],618,5,39947,4.096287940935193,80.0,20.0
9752,0,9752,[172 257 568 300 288],654,4,39951,4.096278068286681,0.0,20.0
9753,0,9753,[ 25  28 496  50  79],128,4,39955,4.096268197662497,0.0,20.0
9754,0,9754,[  4 202 313   8 191],405,5,39960,4.096360840594567,20.0,20.0
9755,0,9755,[ 64 483 313 318 187],618,5,39965,4.096453464534646,80.0,20.0
9756,0,9756,[168 385 181 294 182],416,5,39970,4.096546069488572,0.0,20.0
9757,0,9757,[ 64 483 313 318 187],214,5,39975,4.0966386554621845,80.0,20.0
9758,0,9758,[  4   7   9  15 173],618,1,39976,4.096321344400041,0.0,0.0
9759,0,9759,[204 117 385  79 258],43,5,39981,4.09641393442623,0.0,0.0
9760,0,9760,[143 200 202  22 183],618,4,39985,4.096404056961377,0.0,0.0
9761,0,9761,[ 98 294 197 200  96],416,5,39990,4.096496619545175,0.0,20.0
9762,0,9762,[ 64 483 313 318 187],618,5,39995,4.096589163167059,80.0,20.0
9763,0,9763,[176 237  56 127 143],922,2,39997,4.0963744367062676,0.0,0.0
9764,0,9764,[ 64 483 313 318 187],618,5,40002,4.096466973886328,80.0,20.0
9765,0,9765,[ 69 181  95 234 195],712,2,40004,4.0962523039115295,0.0,20.0
9766,0,9766,[ 64 483 313 318 187],214,5,40009,4.096344834647281,80.0,20.0
9767,0,9767,[202 268 508 132  97],417,4,40013,4.096334971334971,0.0,0.0
9768,0,9768,[ 64 483 313 318 187],618,5,40018,4.096427474664756,80.0,20.0
9769,0,9769,[191 161 100 328  82],43,5,40023,4.096519959058342,0.0,0.0
9770,0,9770,[ 64 483 313 318 187],618,5,40028,4.096612424521544,80.0,20.0
9771,0,9771,[423  70 197 471 161],721,4,40032,4.096602537863283,0.0,0.0
9772,0,9772,[174 483  25 427 228],128,2,40034,4.096388007776527,20.0,0.0
9773,0,9773,[ 64 483 313 318 187],214,5,40039,4.096480458358911,80.0,20.0
9774,0,9774,[475 318 151 202  69],711,4,40043,4.096470588235294,20.0,0.0
9775,0,9775,[ 64 483 313 318 187],214,5,40048,4.096563011456628,80.0,20.0
9776,0,9776,[204  22  56 268 144],297,3,40051,4.096450854045208,0.0,0.0
9777,0,9777,[568 181  12   4  50],805,2,40053,4.0962364491716095,20.0,40.0
9778,0,9778,[ 64 483 313 318 187],214,5,40058,4.096328867982411,80.0,20.0
9779,0,9779,[742 323 257 496 597],630,3,40061,4.096216768916156,0.0,0.0
9780,0,9780,[ 64 483 313 318 187],214,5,40066,4.096309170841427,80.0,20.0
9781,0,9781,[ 64 483 313 318 187],214,5,40071,4.096401553874463,80.0,20.0
9782,0,9782,[ 64 483 313 318 187],214,5,40076,4.096493918021057,80.0,20.0
9783,0,9783,[405 174 222   7  82],62,4,40080,4.096484055600981,0.0,0.0
9784,0,9784,[ 64 483 313 318 187],214,5,40085,4.096576392437404,80.0,20.0
9785,0,9785,[ 64 483 313 318 187],618,5,40090,4.096668710402616,80.0,20.0
9786,0,9786,[271 302  97  25  95],297,3,40093,4.096556656789619,0.0,0.0
9787,0,9787,[216 742  56 385 313],43,5,40098,4.096648957907642,20.0,20.0
9788,0,9788,[273  71 118  25 603],416,4,40102,4.096639084686894,0.0,0.0
9789,0,9789,[301 228 269 216 194],297,3,40105,4.09652706843718,0.0,0.0
9790,0,9790,[ 64 121 210 245  69],62,4,40109,4.096517209682362,20.0,0.0
9791,0,9791,[179 197  71 423 588],128,4,40113,4.096507352941177,0.0,0.0
9792,0,9792,[ 15  70 271 483 275],62,2,40115,4.096293270703564,20.0,0.0
9793,0,9793,[ 64 483 313 318 187],618,5,40120,4.096385542168675,80.0,20.0
9794,0,9794,[257 202 100 191  11],297,2,40122,4.096171516079632,0.0,0.0
9795,0,9795,[515 597  25 322 191],417,2,40124,4.095957533687219,0.0,0.0
9796,0,9796,[144 257  12 117 191],297,2,40126,4.095743594978054,20.0,0.0
9797,0,9797,[ 64 483 313 318 187],214,5,40131,4.0958358848744645,80.0,20.0
9798,0,9798,[ 64 483 313 318 187],618,5,40136,4.095928155934279,80.0,20.0
9799,0,9799,[ 64 483 313 318 187],618,5,40141,4.096020408163265,80.0,20.0
9800,0,9800,[ 95 121 196  79 200],417,3,40144,4.095908580757065,0.0,0.0
9801,0,9801,[204 357   1 228 276],198,2,40146,4.09569475617221,0.0,0.0
9802,0,9802,[172 121 135   4 153],62,5,40151,4.095787003978374,0.0,0.0
9803,0,9803,[215  12 288 435  11],405,4,40155,4.09577723378213,20.0,20.0
9804,0,9804,[ 64 483 313 318 187],618,5,40160,4.09586945436002,80.0,20.0
9805,0,9805,[ 64 483 313 318 187],214,5,40165,4.0959616561289005,80.0,20.0
9806,0,9806,[ 69   1 111 174 294],417,2,40167,4.095747935148363,0.0,0.0
9807,0,9807,[ 97  82  12 202 181],588,3,40170,4.095636215334421,20.0,20.0
9808,0,9808,[ 64 483 313 318 187],618,5,40175,4.095728412682231,80.0,20.0
9809,0,9809,[286 181  25 496 302],417,1,40176,4.095412844036697,0.0,20.0
9810,0,9810,[238 318 222 496 181],654,4,40180,4.095403118948119,20.0,20.0
9811,0,9811,[ 64 483 313 318 187],214,5,40185,4.095495311863025,80.0,20.0
9812,0,9812,[ 64 483 313 318 187],618,5,40190,4.095587485987975,80.0,20.0
9813,0,9813,[475 111  79 197 186],437,2,40192,4.09537395557367,0.0,0.0
9814,0,9814,[  1 210 257 300 121],751,3,40195,4.095262353540499,0.0,0.0
9815,0,9815,[258 269 603 117 588],805,2,40197,4.0950488997555015,0.0,0.0
9816,0,9816,[143 204 237 172 202],642,4,40201,4.09503921768361,0.0,0.0
9817,0,9817,[ 64 483 313 318 187],618,5,40206,4.095131391322061,80.0,20.0
9818,0,9818,[ 64 483 313 318 187],214,5,40211,4.095223546185966,80.0,20.0
9819,0,9819,[197 603  12 195  22],854,3,40214,4.095112016293279,20.0,0.0
9820,0,9820,[197 216 301  70 176],437,2,40216,4.094898686488138,0.0,0.0
9821,0,9821,[187 471  88 211 333],416,4,40220,4.094889024638566,0.0,0.0
9822,0,9822,[ 64 483 313 318 187],618,5,40225,4.0949811666497,80.0,20.0
9823,0,9823,[ 64 483 313 318 187],618,5,40230,4.09507328990228,80.0,20.0
9824,0,9824,[546 300 228 174 100],297,2,40232,4.094860050890585,0.0,0.0
9825,0,9825,[ 69  70 508  15 174],654,3,40235,4.094748626094036,0.0,0.0
9826,0,9826,[238 118 174 196 216],437,4,40239,4.09473898443065,0.0,0.0
9827,0,9827,[ 64 483 313 318 187],618,5,40244,4.094831094831095,80.0,20.0
9828,0,9828,[179 172  97  12 143],437,4,40248,4.094821446739241,20.0,0.0
9829,0,9829,[ 64 483 313 318 187],214,5,40253,4.094913530010173,80.0,20.0
9830,0,9830,[ 64 483 313 318 187],618,5,40258,4.0950055945478585,80.0,20.0
9831,0,9831,[ 64 483 313 318 187],214,5,40263,4.095097640358015,80.0,20.0
9832,0,9832,[ 64 483 313 318 187],214,5,40268,4.095189667446354,80.0,20.0
9833,0,9833,[228 216  11 508 597],417,1,40269,4.094874923733984,0.0,0.0
9834,0,9834,[403 118 322 197 100],416,3,40272,4.094763599389934,0.0,0.0
9835,0,9835,[ 64 483 313 318 187],618,5,40277,4.094855632370883,80.0,20.0
9836,0,9836,[197 127 144 655 216],373,2,40279,4.094642675612484,0.0,0.0
9837,0,9837,[286  88  98  15 237],342,2,40281,4.094429762146778,0.0,20.0
9838,0,9838,[ 64 483 313 318 187],618,5,40286,4.094521800996036,80.0,20.0
9839,0,9839,[ 64 483 313 318 187],618,5,40291,4.0946138211382115,80.0,20.0
9840,0,9840,[  8 186  96 196 234],618,3,40294,4.094502591200081,0.0,0.0
9841,0,9841,[288 222  15  97 742],734,4,40298,4.094492989229831,0.0,20.0
9842,0,9842,[ 64 483 313 318 187],214,5,40303,4.094584984252768,80.0,20.0
9843,0,9843,[ 79 197  22 153  56],297,3,40306,4.094473791141812,0.0,0.0
9844,0,9844,[ 64 483 313 318 187],618,5,40311,4.094565769426104,80.0,20.0
9845,0,9845,[ 64 483 313 318 187],214,5,40316,4.094657729027016,80.0,20.0
9846,0,9846,[ 64 483 313 318 187],214,5,40321,4.094749669950239,80.0,20.0
9847,0,9847,[ 64 483 313 318 187],618,5,40326,4.094841592201462,80.0,20.0
9848,0,9848,[ 64 483 313 318 187],214,5,40331,4.094933495786374,80.0,20.0
9849,0,9849,[ 25 174 161 151 655],417,2,40333,4.094720812182741,0.0,0.0
9850,0,9850,[118  95 176  69 211],297,2,40335,4.0945081717592124,0.0,0.0
9851,0,9851,[ 64 483 313 318 187],618,5,40340,4.094600081201786,80.0,20.0
9852,0,9852,[ 64 483 313 318 187],214,5,40345,4.094691971988227,80.0,20.0
9853,0,9853,[191  15 144 257  95],417,3,40348,4.094580880860565,0.0,0.0
9854,0,9854,[ 64 483 313 318 187],214,5,40353,4.0946727549467274,80.0,20.0
9855,0,9855,[302 235 322 318 269],416,3,40356,4.094561688311688,20.0,0.0
9856,0,9856,[ 64 483 313 318 187],618,5,40361,4.094653545703561,80.0,20.0
9857,0,9857,[288 196 168 275  50],214,1,40362,4.09433962264151,0.0,40.0
9858,0,9858,[ 64 483 313 318 187],214,5,40367,4.0944314839233185,80.0,20.0
9859,0,9859,[294 257 179 132 289],342,2,40369,4.09421906693712,0.0,0.0
9860,0,9860,[ 64 483 313 318 187],618,5,40374,4.094310921813204,80.0,20.0
9861,0,9861,[ 98  96 187 180  95],887,4,40378,4.09430135875076,0.0,20.0
9862,0,9862,[132 588   4 196 385],345,3,40381,4.09419040859779,0.0,0.0
9863,0,9863,[ 64 483 313 318 187],214,5,40386,4.094282238442823,80.0,20.0
9864,0,9864,[ 70 237 153 286 222],297,5,40391,4.094374049670552,0.0,0.0
9865,0,9865,[ 64 483 313 318 187],214,5,40396,4.094465842286641,80.0,20.0
9866,0,9866,[111 151  11  69  56],654,5,40401,4.094557616296747,0.0,0.0
9867,0,9867,[  7 568  22 121 288],416,5,40406,4.094649371706526,0.0,20.0
9868,0,9868,[135 186 168 276 496],230,4,40410,4.09463978113284,0.0,0.0
9869,0,9869,[ 64 483 313 318 187],214,5,40415,4.094731509625126,80.0,20.0
9870,0,9870,[ 64 483 313 318 187],214,5,40420,4.094823219531962,80.0,20.0
9871,0,9871,[ 64 483 313 318 187],214,5,40425,4.0949149108589955,80.0,20.0
9872,0,9872,[ 64 483 313 318 187],214,5,40430,4.0950065836118705,80.0,20.0
9873,0,9873,[357  50 172 135 215],198,5,40435,4.095098237796233,0.0,20.0
9874,0,9874,[ 64 483 313 318 187],618,5,40440,4.095189873417722,80.0,20.0
9875,0,9875,[ 64 483 313 318 187],214,5,40445,4.095281490481977,80.0,20.0
9876,0,9876,[ 64 483 313 318 187],214,5,40450,4.095373088994634,80.0,20.0
9877,0,9877,[ 64 483 313 318 187],214,5,40455,4.095464668961328,80.0,20.0
9878,0,9878,[ 64 483 313 318 187],618,5,40460,4.095556230387691,80.0,20.0
9879,0,9879,[182 135 288 179 313],405,3,40463,4.095445344129555,20.0,40.0
9880,0,9880,[ 64 483 313 318 187],214,5,40468,4.095536888978848,80.0,20.0
9881,0,9881,[ 64 483 313 318 187],618,5,40473,4.095628415300546,80.0,20.0
9882,0,9882,[475 357 301  25 276],416,3,40476,4.095517555398159,0.0,0.0
9883,0,9883,[  8 181 215   4 180],405,4,40480,4.095507891541886,0.0,20.0
9884,0,9884,[195 288   1 471 385],416,5,40485,4.095599393019727,0.0,20.0
9885,0,9885,[153 294 151  50 302],417,3,40488,4.095488569694518,0.0,20.0
9886,0,9886,[508   4 191 153  11],417,3,40491,4.095377768787296,0.0,0.0
9887,0,9887,[ 82 183 276 161 176],230,4,40495,4.095368122977346,0.0,0.0
9888,0,9888,[ 64 483 313 318 187],214,5,40500,4.09545960157751,80.0,20.0
9889,0,9889,[117  28 197   7 471],416,5,40505,4.095551061678463,0.0,0.0
9890,0,9890,[282 238 194 275 210],297,3,40508,4.095440299261956,0.0,0.0
9891,0,9891,[294 144 174 288   1],588,3,40511,4.09532955923979,0.0,20.0
9892,0,9892,[ 64 483 313 318 187],214,5,40516,4.0954210047508335,80.0,20.0
9893,0,9893,[132 282  22 187 196],416,5,40521,4.095512431776834,0.0,0.0
9894,0,9894,[185 183 179 423 191],416,4,40525,4.0955027791814045,0.0,0.0
9895,0,9895,[173 508  64 111 405],314,3,40528,4.095392077607114,20.0,0.0
9896,0,9896,[ 64 483 313 318 187],214,5,40533,4.095483479842376,80.0,20.0
9897,0,9897,[328  50 471 483  89],854,3,40536,4.095372802586381,20.0,20.0
9898,0,9898,[216 144 202 191 257],43,5,40541,4.0954641883018486,0.0,0.0
9899,0,9899,[ 64 483 313 318 187],618,5,40546,4.095555555555555,80.0,20.0
9900,0,9900,[ 64 483 313 318 187],214,5,40551,4.095646904353096,80.0,20.0
9901,0,9901,[191 185 302  98 234],416,5,40556,4.09573823470006,0.0,20.0
9902,0,9902,[742 234   9 237 144],416,4,40560,4.0957285671008785,0.0,0.0
9903,0,9903,[ 98 546 257 194 300],297,1,40561,4.095415993537965,0.0,20.0
9904,0,9904,[125  25 182 181 143],230,3,40564,4.095305401312468,0.0,20.0
9905,0,9905,[ 64 483 313 318 187],618,5,40569,4.095396729254997,80.0,20.0
9906,0,9906,[323 125 405  88   1],416,3,40572,4.095286161300091,0.0,0.0
9907,0,9907,[174   1 228 172 222],198,3,40575,4.09517561566411,0.0,0.0
9908,0,9908,[ 64 483 313 318 187],214,5,40580,4.095266929054395,80.0,20.0
9909,0,9909,[182  64 173 322 117],417,4,40584,4.095257315842583,20.0,0.0
9910,0,9910,[ 64 483 313 318 187],214,5,40589,4.095348602562809,80.0,20.0
9911,0,9911,[ 64 483 313 318 187],214,5,40594,4.0954398708636,80.0,20.0
9912,0,9912,[143 196   8  96 603],805,2,40596,4.095228487844245,0.0,0.0
9913,0,9913,[ 64 483 313 318 187],618,5,40601,4.095319749848699,80.0,20.0
9914,0,9914,[ 28  15  69 191  95],642,5,40606,4.095410993444276,0.0,0.0
9915,0,9915,[269  96 475 748 301],416,4,40610,4.095401371520775,0.0,0.0
9916,0,9916,[ 69 265  56  95 211],297,2,40612,4.095190077644449,0.0,0.0
9917,0,9917,[ 64 483 313 318 187],618,5,40617,4.095281306715064,80.0,20.0
9918,0,9918,[235 174 475  82  98],416,3,40620,4.09517088416171,0.0,20.0
9919,0,9919,[  7 588 191 515 257],297,3,40623,4.095060483870967,0.0,0.0
9920,0,9920,[427  12 333 151 286],416,4,40627,4.095050902126801,20.0,0.0
9921,0,9921,[ 64 483 313 318 187],214,5,40632,4.095142108445878,80.0,20.0
9922,0,9922,[ 64 483 313 318 187],214,5,40637,4.095233296382142,80.0,20.0
9923,0,9923,[318   9  97 483  25],618,3,40640,4.095122934300686,40.0,0.0
9924,0,9924,[ 64 483 313 318 187],618,5,40645,4.095214105793451,80.0,20.0
9925,0,9925,[ 64 483 313 318 187],618,5,40650,4.095305258915978,80.0,20.0
9926,0,9926,[ 64 483 313 318 187],214,5,40655,4.095396393673819,80.0,20.0
9927,0,9927,[ 64 483 313 318 187],214,5,40660,4.095487510072522,80.0,20.0
9928,0,9928,[ 64 483 313 318 187],214,5,40665,4.095578608117635,80.0,20.0
9929,0,9929,[ 64 483 313 318 187],618,5,40670,4.095669687814703,80.0,20.0
9930,0,9930,[174 143 496 276  89],764,4,40674,4.095660054375188,0.0,0.0
9931,0,9931,[ 98 175  64 258 301],43,4,40678,4.095650422875554,20.0,20.0
9932,0,9932,[179 403   4  89   8],62,5,40683,4.0957414678344914,0.0,0.0
9933,0,9933,[ 64 483 313 318 187],618,5,40688,4.095832494463459,80.0,20.0
9934,0,9934,[ 64 483 313 318 187],214,5,40693,4.095923502767992,80.0,20.0
9935,0,9935,[ 64 483 313 318 187],618,5,40698,4.096014492753623,80.0,20.0
9936,0,9936,[318   1  98 195 238],654,5,40703,4.096105464425883,20.0,20.0
9937,0,9937,[197 111 118   4 183],805,2,40705,4.095894546186355,0.0,0.0
9938,0,9938,[100 117 144  69  79],654,4,40709,4.09588489787705,0.0,0.0
9939,0,9939,[ 64 483 313 318 187],618,5,40714,4.095975855130785,80.0,20.0
9940,0,9940,[204 234  98  12 313],588,4,40718,4.095966200583442,40.0,40.0
9941,0,9941,[ 64 483 313 318 187],214,5,40723,4.096057131361899,80.0,20.0
9942,0,9942,[ 64 483 313 318 187],618,5,40728,4.0961480438499445,80.0,20.0
9943,0,9943,[  7 318 161 118 597],588,3,40731,4.096037811745776,20.0,0.0
9944,0,9944,[  9 210 742 185 151],416,4,40735,4.096028154851684,0.0,0.0
9945,0,9945,[318  79 117  98 144],854,3,40738,4.095917956967625,20.0,20.0
9946,0,9946,[ 64 483 313 318 187],618,5,40743,4.096008846888509,80.0,20.0
9947,0,9947,[282 237 111 276 275],764,4,40747,4.095999195818255,0.0,0.0
9948,0,9948,[ 64 483 313 318 187],618,5,40752,4.096090059302442,80.0,20.0
9949,0,9949,[ 64 483 313 318 187],214,5,40757,4.096180904522613,80.0,20.0
9950,0,9950,[ 64 483 313 318 187],618,5,40762,4.096271731484273,80.0,20.0
9951,0,9951,[302 515 435  98  12],297,4,40766,4.096262057877814,20.0,20.0
9952,0,9952,[ 64 483 313 318 187],618,5,40771,4.096352858434643,80.0,20.0
9953,0,9953,[ 64 483 313 318 187],214,5,40776,4.096443640747438,80.0,20.0
9954,0,9954,[ 64 483 313 318 187],618,5,40781,4.096534404821698,80.0,20.0
9955,0,9955,[ 64 483 313 318 187],618,5,40786,4.096625150662917,80.0,20.0
9956,0,9956,[546 196   4 182 135],417,2,40788,4.096414582705634,0.0,0.0
9957,0,9957,[ 79 216 302 475 173],297,4,40792,4.0964049005824466,0.0,0.0
9958,0,9958,[ 64 483 313 318 187],618,5,40797,4.0964956320915755,80.0,20.0
9959,0,9959,[174 678  97 748 222],721,3,40800,4.096385542168675,0.0,0.0
9960,0,9960,[ 95  56 211 322  15],416,3,40803,4.096275474349965,0.0,0.0
9961,0,9961,[195 237 288 117 357],62,3,40806,4.096165428628789,0.0,20.0
9962,0,9962,[ 64 483 313 318 187],214,5,40811,4.096256147746662,80.0,20.0
9963,0,9963,[173 276 471   7 191],43,4,40815,4.096246487354476,0.0,0.0
9964,0,9964,[ 64 483 313 318 187],618,5,40820,4.0963371801304564,80.0,20.0
9965,0,9965,[ 64 483 313 318 187],618,5,40825,4.0964278547060005,80.0,20.0
9966,0,9966,[ 64 483 313 318 187],618,5,40830,4.096518511086586,80.0,20.0
9967,0,9967,[ 64 483 313 318 187],618,5,40835,4.096609149277689,80.0,20.0
9968,0,9968,[211 568  11 597  98],43,4,40839,4.096599458320794,0.0,20.0
9969,0,9969,[ 64 483 313 318 187],618,5,40844,4.096690070210632,80.0,20.0
9970,0,9970,[ 95 202 175 182 185],405,2,40846,4.096479791395046,0.0,0.0
9971,0,9971,[111 181   1 300 151],525,5,40851,4.096570397111913,0.0,20.0
9972,0,9972,[ 64 483 313 318 187],214,5,40856,4.096660984658578,80.0,20.0
9973,0,9973,[546 288  95 748 215],297,0,40856,4.0962502506516945,0.0,20.0
9974,0,9974,[ 64 483 313 318 187],618,5,40861,4.096340852130326,80.0,20.0
9975,0,9975,[ 64 483 313 318 187],214,5,40866,4.096431435445068,80.0,20.0
9976,0,9976,[168  70 176 603 181],416,5,40871,4.096522000601383,0.0,20.0
9977,0,9977,[ 64 483 313 318 187],618,5,40876,4.096612547604731,80.0,20.0
9978,0,9978,[ 64 483 313 318 187],214,5,40881,4.096703076460567,80.0,20.0
9979,0,9979,[322 215 300 268  98],416,4,40885,4.096693386773547,0.0,20.0
9980,0,9980,[ 12 144 275 333 475],588,2,40887,4.096483318304779,20.0,0.0
9981,0,9981,[ 28  69 127 176  15],416,5,40892,4.096573832899218,0.0,0.0
9982,0,9982,[286  96 111 100 143],416,5,40897,4.096664329359911,0.0,0.0
9983,0,9983,[ 64 483 313 318 187],214,5,40902,4.0967548076923075,80.0,20.0
9984,0,9984,[191 194 294 357 603],698,4,40906,4.096745117676515,0.0,0.0
9985,0,9985,[288 195 234 117 603],297,2,40908,4.096535149208893,0.0,20.0
9986,0,9986,[ 64 483 313 318 187],618,5,40913,4.096625613297286,80.0,20.0
9987,0,9987,[194 216 742 125 151],854,1,40914,4.096315578694433,0.0,0.0
9988,0,9988,[172   8 144  98   9],62,4,40918,4.096305936530183,0.0,20.0
9989,0,9989,[ 64 483 313 318 187],618,5,40923,4.096396396396396,80.0,20.0
9990,0,9990,[ 64   1 210  98 118],198,4,40927,4.096386748073266,20.0,20.0
9991,0,9991,[423 228  25 603  28],373,3,40930,4.0962770216172935,0.0,0.0
9992,0,9992,[ 64 483 313 318 187],618,5,40935,4.096367457220054,80.0,20.0
9993,0,9993,[ 64 483 313 318 187],618,5,40940,4.096457874724835,80.0,20.0
9994,0,9994,[ 64 483 313 318 187],618,5,40945,4.096548274137069,80.0,20.0
9995,0,9995,[143 185 216 435  69],405,3,40948,4.096438575430172,0.0,0.0
9996,0,9996,[286 471 211  79 435],297,2,40950,4.0962288686605985,0.0,0.0
9997,0,9997,[ 69   8 288 568 132],588,4,40954,4.09621924384877,0.0,20.0
9998,0,9998,[ 64 483 313 318 187],618,5,40959,4.096309630963097,80.0,20.0
9999,0,9999,[175 237  89 423  98],198,2,40961,4.0961,0.0,20.0
10000,1,0,[  8 127 483  71 121],62,5,5,5.0,20.0,0.0
10001,1,1,[  8 483  71 127 121],601,2,7,3.5,20.0,0.0
10002,1,2,[173 568 276 286 403],416,4,11,3.6666666666666665,0.0,0.0
10003,1,3,[127 301 121 405 258],159,3,14,3.5,0.0,0.0
10004,1,4,[403 118   1  25 143],198,2,16,3.2,0.0,0.0
10005,1,5,[179 176 183 301  12],416,4,20,3.3333333333333335,20.0,0.0
10006,1,6,[  9 588 172 151 117],618,3,23,3.2857142857142856,0.0,0.0
10007,1,7,[258  12   1 405 588],416,5,28,3.5,20.0,0.0
10008,1,8,[258  12   1 405 588],805,2,30,3.3333333333333335,20.0,0.0
10009,1,9,[127 568   1 117 286],43,5,35,3.5,0.0,0.0
10010,1,10,[127 568   1 117 286],416,5,40,3.6363636363636362,0.0,0.0
10011,1,11,[ 12 215 196   8 655],416,5,45,3.75,20.0,0.0
10012,1,12,[ 12 196 286 117 403],62,4,49,3.769230769230769,20.0,0.0
10013,1,13,[ 12 655 117 403 176],805,3,52,3.7142857142857144,20.0,0.0
10014,1,14,[216  70 187 257 357],416,4,56,3.7333333333333334,0.0,0.0
10015,1,15,[ 12 127 172 196 403],43,5,61,3.8125,20.0,0.0
10016,1,16,[ 12 127 172 196 403],373,3,64,3.764705882352941,20.0,0.0
10017,1,17,[655 216 121   4 117],198,2,66,3.6666666666666665,0.0,0.0
10018,1,18,[ 88 172 215  96 357],416,4,70,3.6842105263157894,0.0,0.0
10019,1,19,[ 12 215 202 183  98],416,5,75,3.75,20.0,20.0
10020,1,20,[ 12 173 196 172 202],43,5,80,3.8095238095238093,20.0,0.0
10021,1,21,[286 172  56 216 655],588,4,84,3.8181818181818183,0.0,0.0
10022,1,22,[ 12 173  96 196 172],416,5,89,3.869565217391304,20.0,0.0
10023,1,23,[ 69 191 289 603 237],416,3,92,3.8333333333333335,0.0,0.0
10024,1,24,[ 96   1  98 202  69],230,4,96,3.84,0.0,20.0
10025,1,25,[ 12 357 176  98 202],405,4,100,3.8461538461538463,20.0,20.0
10026,1,26,[161 174 238 483 132],417,3,103,3.814814814814815,20.0,0.0
10027,1,27,[  1 173 196 357  70],417,5,108,3.857142857142857,0.0,0.0
10028,1,28,[  1 173 196 357  70],679,4,112,3.8620689655172415,0.0,0.0
10029,1,29,[125 546 121 742 117],62,4,116,3.8666666666666667,0.0,0.0
10030,1,30,[238 173 125 191 215],62,4,120,3.870967741935484,0.0,0.0
10031,1,31,[238 173 125 191 172],417,4,124,3.875,0.0,0.0
10032,1,32,[238 132 125 191  98],618,3,127,3.8484848484848486,0.0,20.0
10033,1,33,[ 56 191  70  69  12],43,5,132,3.8823529411764706,20.0,0.0
10034,1,34,[ 56 191  70  69  12],618,4,136,3.8857142857142857,20.0,0.0
10035,1,35,[ 56 568  69  12 202],43,5,141,3.9166666666666665,20.0,0.0
10036,1,36,[ 56 568  69  12 202],416,5,146,3.945945945945946,20.0,0.0
10037,1,37,[ 56 568  69  12 202],314,4,150,3.9473684210526314,20.0,0.0
10038,1,38,[121   8  28 132 655],437,3,153,3.923076923076923,0.0,0.0
10039,1,39,[333 258  70 173  56],416,5,158,3.95,0.0,0.0
10040,1,40,[403 191  11 546 742],416,4,162,3.951219512195122,0.0,0.0
10041,1,41,[151 191 125 748 269],416,4,166,3.9523809523809526,0.0,0.0
10042,1,42,[357  12 202 173 191],417,5,171,3.9767441860465116,20.0,0.0
10043,1,43,[357  12 202 173 191],416,5,176,4.0,20.0,0.0
10044,1,44,[211 475  11 300 194],416,4,180,4.0,0.0,0.0
10045,1,45,[ 12 300 191  98 211],416,5,185,4.021739130434782,20.0,20.0
10046,1,46,[ 12 300 191  98 211],297,3,188,4.0,20.0,20.0
10047,1,47,[ 12 194 183 210 143],297,4,192,4.0,20.0,0.0
10048,1,48,[ 98 210 202  12 196],416,5,197,4.020408163265306,20.0,20.0
10049,1,49,[ 98 210 202  12 196],805,2,199,3.98,20.0,20.0
10050,1,50,[ 98 748  12 357  69],297,3,202,3.9607843137254903,20.0,20.0
10051,1,51,[168 185 151  69  95],437,3,205,3.9423076923076925,0.0,0.0
10052,1,52,[318 183 475  69 210],62,5,210,3.9622641509433962,20.0,0.0
10053,1,53,[132 568 333  98 211],416,5,215,3.9814814814814814,0.0,20.0
10054,1,54,[200 228 121  82  12],805,2,217,3.9454545454545453,20.0,0.0
10055,1,55,[210 318 405 196 300],654,5,222,3.9642857142857144,20.0,0.0
10056,1,56,[191 294 302 204  98],62,2,224,3.9298245614035086,0.0,20.0
10057,1,57,[318 265 210  70 143],618,3,227,3.913793103448276,20.0,0.0
10058,1,58,[ 50 211 176 180  70],405,1,228,3.864406779661017,0.0,20.0
10059,1,59,[322 357 168 483  15],417,4,232,3.8666666666666667,20.0,0.0
10060,1,60,[200 357  11  95 132],416,4,236,3.8688524590163933,0.0,0.0
10061,1,61,[  4   1   7 153 161],198,3,239,3.8548387096774195,0.0,0.0
10062,1,62,[597 222  12 202 186],588,3,242,3.8412698412698414,20.0,0.0
10063,1,63,[  7 483 357 318 333],854,4,246,3.84375,40.0,0.0
10064,1,64,[  7 483 357 318  98],854,5,251,3.8615384615384616,40.0,20.0
10065,1,65,[  7 483 357 318  98],62,5,256,3.878787878787879,40.0,20.0
10066,1,66,[235  82 300 173  98],49,1,257,3.8358208955223883,0.0,20.0
10067,1,67,[  7 483 318 357  98],214,5,262,3.8529411764705883,40.0,20.0
10068,1,68,[  7 483 318 357  98],854,5,267,3.869565217391304,40.0,20.0
10069,1,69,[  7 483 318 357  98],62,5,272,3.8857142857142857,40.0,20.0
10070,1,70,[318  89 161 228 176],198,3,275,3.8732394366197185,20.0,0.0
10071,1,71,[176 302 435  22 655],405,3,278,3.861111111111111,0.0,0.0
10072,1,72,[ 22 483  12   7 185],618,5,283,3.8767123287671232,40.0,0.0
10073,1,73,[546  50 655   9 273],805,1,284,3.8378378378378377,0.0,20.0
10074,1,74,[ 22 483  12   7 185],214,4,288,3.84,40.0,0.0
10075,1,75,[185 228 234  98 588],230,4,292,3.8421052631578947,0.0,20.0
10076,1,76,[172  71 435  22 357],405,3,295,3.831168831168831,0.0,0.0
10077,1,77,[  4  25  79 144  15],854,1,296,3.7948717948717947,0.0,0.0
10078,1,78,[153 568 174 288 385],654,4,300,3.7974683544303796,0.0,20.0
10079,1,79,[597 568 234 132 200],417,3,303,3.7875,0.0,0.0
10080,1,80,[153 385 185   7  11],262,2,305,3.765432098765432,0.0,0.0
10081,1,81,[ 71 191 286 318 127],24,5,310,3.7804878048780486,20.0,0.0
10082,1,82,[ 11 234 357   7 318],198,4,314,3.783132530120482,20.0,0.0
10083,1,83,[183 273  50 191 127],805,3,317,3.7738095238095237,0.0,20.0
10084,1,84,[ 79 200 195  64  96],198,3,320,3.764705882352941,20.0,0.0
10085,1,85,[168 328  88 172 269],43,5,325,3.7790697674418605,0.0,0.0
10086,1,86,[183 132   7 318  12],62,5,330,3.793103448275862,40.0,0.0
10087,1,87,[168 143 275 153  69],437,3,333,3.784090909090909,0.0,0.0
10088,1,88,[161 180  50 144 546],417,1,334,3.752808988764045,0.0,20.0
10089,1,89,[357 318  64  89  98],62,5,339,3.7666666666666666,40.0,20.0
10090,1,90,[357 318  64  89  98],854,5,344,3.78021978021978,40.0,20.0
10091,1,91,[357 318  64  89  98],62,5,349,3.7934782608695654,40.0,20.0
10092,1,92,[357 318  64  89  98],405,4,353,3.795698924731183,40.0,20.0
10093,1,93,[357 200  64  98  11],417,5,358,3.8085106382978724,20.0,20.0
10094,1,94,[357 200  64  98  11],405,4,362,3.8105263157894735,20.0,20.0
10095,1,95,[357 318  64  98  11],214,5,367,3.8229166666666665,40.0,20.0
10096,1,96,[357 318  64  98  11],214,5,372,3.8350515463917527,40.0,20.0
10097,1,97,[357 318  64  98  11],416,5,377,3.8469387755102042,40.0,20.0
10098,1,98,[357 318  64  98  11],24,5,382,3.8585858585858586,40.0,20.0
10099,1,99,[357 318  64  98  11],854,5,387,3.87,40.0,20.0
10100,1,100,[357 318  64  98  11],405,5,392,3.881188118811881,40.0,20.0
10101,1,101,[357 318  64  98  11],854,5,397,3.892156862745098,40.0,20.0
10102,1,102,[357 318  64  98  11],24,5,402,3.9029126213592233,40.0,20.0
10103,1,103,[357 318  64  98  11],198,5,407,3.9134615384615383,40.0,20.0
10104,1,104,[357 318  64  98  11],416,5,412,3.9238095238095236,40.0,20.0
10105,1,105,[357 318  64  98  11],405,5,417,3.9339622641509435,40.0,20.0
10106,1,106,[ 89 435  82 471 196],373,3,420,3.925233644859813,0.0,0.0
10107,1,107,[357 318  64  98  11],198,5,425,3.935185185185185,40.0,20.0
10108,1,108,[357 318  64  98  11],24,5,430,3.944954128440367,40.0,20.0
10109,1,109,[357 318  64  98  11],24,5,435,3.9545454545454546,40.0,20.0
10110,1,110,[235 655  69  95 273],417,2,437,3.936936936936937,0.0,0.0
10111,1,111,[357 318  64  98  11],214,5,442,3.9464285714285716,40.0,20.0
10112,1,112,[180 222 748 195 216],805,1,443,3.920353982300885,0.0,0.0
10113,1,113,[357  12 318 483 183],62,5,448,3.9298245614035086,60.0,0.0
10114,1,114,[357  12 318 483 183],62,5,453,3.9391304347826086,60.0,0.0
10115,1,115,[ 97 294 678 174 210],654,3,456,3.9310344827586206,0.0,0.0
10116,1,116,[318  28 161 173 546],43,5,461,3.9401709401709404,20.0,0.0
10117,1,117,[ 98  64   7 275 357],214,4,465,3.940677966101695,20.0,20.0
10118,1,118,[ 79 200 174   1 168],805,4,469,3.9411764705882355,0.0,0.0
10119,1,119,[ 11  64   7 357 132],198,5,474,3.95,20.0,0.0
10120,1,120,[ 11  64   7 357 132],416,5,479,3.958677685950413,20.0,0.0
10121,1,121,[ 11  64   7 357 132],854,5,484,3.9672131147540983,20.0,0.0
10122,1,122,[ 11  64   7 357 132],24,4,488,3.967479674796748,20.0,0.0
10123,1,123,[ 11  98   7 357  12],24,5,493,3.975806451612903,20.0,20.0
10124,1,124,[ 11  98   7 357  12],416,5,498,3.984,20.0,20.0
10125,1,125,[471 151 187 176 435],505,2,500,3.9682539682539684,0.0,0.0
10126,1,126,[153 294 597 235 127],43,3,503,3.9606299212598426,0.0,0.0
10127,1,127,[210 117 195 172 174],416,5,508,3.96875,0.0,0.0
10128,1,128,[302 144  79 100 265],297,2,510,3.953488372093023,0.0,0.0
10129,1,129,[117 597 427 288 132],416,4,514,3.953846153846154,0.0,20.0
10130,1,130,[100 328 427   7  64],416,5,519,3.9618320610687023,20.0,0.0
10131,1,131,[238 185  79   8  82],230,4,523,3.962121212121212,0.0,0.0
10132,1,132,[ 88 111 197 238 215],751,2,525,3.9473684210526314,0.0,0.0
10133,1,133,[275 265   1  12 211],416,5,530,3.955223880597015,20.0,0.0
10134,1,134,[678  98 427   7  12],416,4,534,3.9555555555555557,20.0,20.0
10135,1,135,[118 121 215 245  15],416,3,537,3.948529411764706,0.0,0.0
10136,1,136,[215 237 546  96 144],62,2,539,3.934306569343066,0.0,0.0
10137,1,137,[288 135 202 546  98],417,2,541,3.920289855072464,0.0,40.0
10138,1,138,[288 204  11 121 172],345,3,544,3.9136690647482015,0.0,20.0
10139,1,139,[318 427 357 483   7],214,5,549,3.9214285714285713,40.0,0.0
10140,1,140,[135 180 191 228  12],405,3,552,3.9148936170212765,20.0,0.0
10141,1,141,[ 25 173 302 427 195],416,5,557,3.9225352112676055,0.0,0.0
10142,1,142,[ 12 183 328 357 318],416,5,562,3.93006993006993,40.0,0.0
10143,1,143,[174 117 118 173   1],751,3,565,3.923611111111111,0.0,0.0
10144,1,144,[ 12  98 328  64 269],416,5,570,3.9310344827586206,40.0,20.0
10145,1,145,[ 12 423 183 357 186],405,4,574,3.9315068493150687,20.0,0.0
10146,1,146,[328  12  64 318 423],314,5,579,3.938775510204082,60.0,0.0
10147,1,147,[ 28 435 185   4 194],405,3,582,3.9324324324324325,0.0,0.0
10148,1,148,[175  12  22 144 183],297,4,586,3.9328859060402683,20.0,0.0
10149,1,149,[328  98 318 100 269],43,5,591,3.94,20.0,20.0
10150,1,150,[328  98 318 100 269],43,5,596,3.947019867549669,20.0,20.0
10151,1,151,[328  98 318 100 269],416,5,601,3.9539473684210527,20.0,20.0
10152,1,152,[194 185 215 515  22],297,3,604,3.947712418300654,0.0,0.0
10153,1,153,[ 12 515 175 423  11],405,3,607,3.9415584415584415,20.0,0.0
10154,1,154,[ 88  50 423 202 153],416,4,611,3.9419354838709677,0.0,20.0
10155,1,155,[  7  12 423 318 100],588,2,613,3.9294871794871793,40.0,0.0
10156,1,156,[196 597 257  12 204],314,4,617,3.929936305732484,20.0,0.0
10157,1,157,[423 210 174  69 655],262,3,620,3.9240506329113924,0.0,0.0
10158,1,158,[174 161 135 288 265],922,2,622,3.911949685534591,0.0,20.0
10159,1,159,[ 98 483 328  64 269],854,4,626,3.9125,40.0,20.0
10160,1,160,[258  25 268 215 678],588,4,630,3.9130434782608696,0.0,0.0
10161,1,161,[385 194 200 423 125],416,5,635,3.919753086419753,0.0,0.0
10162,1,162,[ 56 257 174 118 117],642,4,639,3.920245398773006,0.0,0.0
10163,1,163,[483  11  98 269 318],854,5,644,3.926829268292683,40.0,20.0
10164,1,164,[ 22 117 144 235 100],62,4,648,3.9272727272727272,0.0,0.0
10165,1,165,[ 11 427 357  98 269],214,4,652,3.927710843373494,0.0,20.0
10166,1,166,[ 11 268 357  98 603],297,5,657,3.934131736526946,0.0,20.0
10167,1,167,[ 11 268 357  98 603],297,5,662,3.9404761904761907,0.0,20.0
10168,1,168,[ 11 268 357  98 603],854,4,666,3.940828402366864,0.0,20.0
10169,1,169,[483 427 357  98 603],214,5,671,3.947058823529412,20.0,20.0
10170,1,170,[215 143 318 269 121],654,5,676,3.953216374269006,20.0,0.0
10171,1,171,[655 234 117 144  56],416,5,681,3.9593023255813953,0.0,0.0
10172,1,172,[ 79 179 173 204  71],373,4,685,3.959537572254335,0.0,0.0
10173,1,173,[265 172 257  70 273],417,1,686,3.942528735632184,0.0,0.0
10174,1,174,[  8 258 173 176  50],875,4,690,3.942857142857143,0.0,20.0
10175,1,175,[245 300 313  71  79],345,2,692,3.9318181818181817,20.0,20.0
10176,1,176,[  9  82  12 135 238],805,3,695,3.926553672316384,20.0,0.0
10177,1,177,[ 11 313 357  12 318],405,5,700,3.932584269662921,60.0,20.0
10178,1,178,[288 197 655 427 282],618,2,702,3.921787709497207,0.0,20.0
10179,1,179,[435  56 194 180 655],405,2,704,3.911111111111111,0.0,0.0
10180,1,180,[323 269 181  70 568],751,3,707,3.9060773480662982,0.0,20.0
10181,1,181,[313 357 318  11 603],416,5,712,3.912087912087912,40.0,20.0
10182,1,182,[ 50 172  88 603 191],373,5,717,3.918032786885246,0.0,20.0
10183,1,183,[313 483 318 603 186],354,3,720,3.9130434782608696,60.0,20.0
10184,1,184,[180 153 655 111 183],62,3,723,3.908108108108108,0.0,0.0
10185,1,185,[275 191  79 127 222],43,5,728,3.913978494623656,0.0,0.0
10186,1,186,[ 69 100   1  71 276],230,5,733,3.9197860962566846,0.0,0.0
10187,1,187,[435 186  69 748 100],437,2,735,3.9095744680851063,0.0,0.0
10188,1,188,[202  28  89 597 111],751,2,737,3.8994708994708995,0.0,0.0
10189,1,189,[127 151  50 204  11],618,3,740,3.8947368421052633,0.0,20.0
10190,1,190,[ 71 100 196 483 273],618,5,745,3.900523560209424,20.0,0.0
10191,1,191,[143 275 132 405 289],416,4,749,3.9010416666666665,0.0,0.0
10192,1,192,[181  64 603 427 357],416,5,754,3.906735751295337,20.0,20.0
10193,1,193,[515   4 191 238 403],416,5,759,3.9123711340206184,0.0,0.0
10194,1,194,[568  50  12  15 237],62,2,761,3.9025641025641025,20.0,20.0
10195,1,195,[181  64 603 357 427],405,4,765,3.9030612244897958,20.0,20.0
10196,1,196,[181  64 357 427  98],214,4,769,3.9035532994923856,20.0,40.0
10197,1,197,[127 427 216 286 176],24,5,774,3.909090909090909,0.0,0.0
10198,1,198,[118 168 423  79 385],417,4,778,3.909547738693467,0.0,0.0
10199,1,199,[168 117 202 258 286],297,4,782,3.91,0.0,0.0
10200,1,200,[597 265 210 182 215],618,4,786,3.91044776119403,0.0,0.0
10201,1,201,[405 168 111 546 742],654,5,791,3.9158415841584158,0.0,0.0
10202,1,202,[ 64 483  98 182  12],417,5,796,3.9211822660098523,60.0,20.0
10203,1,203,[ 64 483  98 182  12],62,5,801,3.926470588235294,60.0,20.0
10204,1,204,[ 64 483  98 182  12],417,5,806,3.9317073170731707,60.0,20.0
10205,1,205,[ 64 483  98 182  12],417,5,811,3.936893203883495,60.0,20.0
10206,1,206,[ 64 483  98 182  12],417,5,816,3.9420289855072466,60.0,20.0
10207,1,207,[ 64 483  98 182  12],618,5,821,3.9471153846153846,60.0,20.0
10208,1,208,[ 64 483  98 182  12],417,5,826,3.952153110047847,60.0,20.0
10209,1,209,[ 64 483  98 182  12],62,5,831,3.9571428571428573,60.0,20.0
10210,1,210,[ 64 483  98 182  12],62,5,836,3.962085308056872,60.0,20.0
10211,1,211,[ 64 483  98 182  12],417,5,841,3.9669811320754715,60.0,20.0
10212,1,212,[ 64 483  98 182  12],62,5,846,3.971830985915493,60.0,20.0
10213,1,213,[ 64 483  98 182  12],253,4,850,3.97196261682243,60.0,20.0
10214,1,214,[302 196 187  97  11],416,5,855,3.9767441860465116,0.0,0.0
10215,1,215,[ 98  64 427  11 483],214,5,860,3.9814814814814814,40.0,20.0
10216,1,216,[181 173  88  95 385],405,2,862,3.9723502304147464,0.0,20.0
10217,1,217,[ 98  64 427  11 483],618,5,867,3.977064220183486,40.0,20.0
10218,1,218,[322 403 294 100 194],416,4,871,3.9771689497716896,0.0,0.0
10219,1,219,[ 98  64 427  11 483],618,5,876,3.981818181818182,40.0,20.0
10220,1,220,[179 257 176 132 121],416,3,879,3.97737556561086,0.0,0.0
10221,1,221,[423  28 132  98 588],588,3,882,3.972972972972973,0.0,20.0
10222,1,222,[ 12  64 427  11 483],214,5,887,3.977578475336323,60.0,0.0
10223,1,223,[ 12  64 427  11 483],618,5,892,3.982142857142857,60.0,0.0
10224,1,224,[204  22 175 186 427],405,4,896,3.982222222222222,0.0,0.0
10225,1,225,[ 71 318 202   1 181],618,4,900,3.982300884955752,20.0,20.0
10226,1,226,[ 12  64 427  11 483],618,5,905,3.986784140969163,60.0,0.0
10227,1,227,[118 655  11 117  88],345,4,909,3.986842105263158,0.0,0.0
10228,1,228,[ 12 427 357  11 483],214,5,914,3.9912663755458517,40.0,0.0
10229,1,229,[ 12 427 357  11 483],214,5,919,3.9956521739130433,40.0,0.0
10230,1,230,[185 176 173 748 161],437,3,922,3.9913419913419914,0.0,0.0
10231,1,231,[ 12 427 357  11 483],342,4,926,3.9913793103448274,40.0,0.0
10232,1,232,[ 12 427  11 483  64],618,5,931,3.995708154506438,60.0,0.0
10233,1,233,[ 12 427  11 483  64],214,5,936,4.0,60.0,0.0
10234,1,234,[ 12 427  11 483  64],214,5,941,4.004255319148936,60.0,0.0
10235,1,235,[ 12 427  11 483  64],214,5,946,4.008474576271187,60.0,0.0
10236,1,236,[ 12 427  11 483  64],214,5,951,4.012658227848101,60.0,0.0
10237,1,237,[161 202 313  28 174],618,4,955,4.012605042016807,20.0,20.0
10238,1,238,[ 12  64 427 483  11],618,5,960,4.01673640167364,60.0,0.0
10239,1,239,[238 471 172 258 265],128,3,963,4.0125,0.0,0.0
10240,1,240,[ 64 427  12  11 483],618,5,968,4.016597510373444,60.0,0.0
10241,1,241,[132 302 269 118 161],416,4,972,4.016528925619835,0.0,0.0
10242,1,242,[ 64 483  12 427  11],618,5,977,4.020576131687243,60.0,0.0
10243,1,243,[ 64 483  12 427  11],214,5,982,4.024590163934426,60.0,0.0
10244,1,244,[182 276 496 202 121],230,4,986,4.024489795918368,0.0,0.0
10245,1,245,[427  64 496  11 483],618,5,991,4.028455284552845,40.0,0.0
10246,1,246,[ 95 127 172  28 273],805,1,992,4.016194331983805,0.0,0.0
10247,1,247,[427  64 496  11 483],214,5,997,4.020161290322581,40.0,0.0
10248,1,248,[427  64 496  11 483],618,5,1002,4.024096385542169,40.0,0.0
10249,1,249,[427  64 496  11 483],214,5,1007,4.028,40.0,0.0
10250,1,250,[269 135  70  89 175],373,3,1010,4.0239043824701195,0.0,0.0
10251,1,251,[ 96  97  95  50 117],198,2,1012,4.015873015873016,0.0,20.0
10252,1,252,[286 153  12 323 742],43,4,1016,4.015810276679842,20.0,0.0
10253,1,253,[496  12 483  11  64],618,5,1021,4.019685039370079,60.0,0.0
10254,1,254,[496  12 483  11  64],214,5,1026,4.023529411764706,60.0,0.0
10255,1,255,[496  12 483  11  64],175,5,1031,4.02734375,60.0,0.0
10256,1,256,[496  12 483  11  64],175,5,1036,4.031128404669261,60.0,0.0
10257,1,257,[100   1 237 423 475],588,1,1037,4.01937984496124,0.0,0.0
10258,1,258,[302 179 111  97 322],416,3,1040,4.015444015444015,0.0,0.0
10259,1,259,[151 168 196 265  97],297,3,1043,4.0115384615384615,0.0,0.0
10260,1,260,[ 12 427  64 496  11],214,5,1048,4.015325670498084,40.0,0.0
10261,1,261,[ 12 427  64 496  11],214,5,1053,4.019083969465649,40.0,0.0
10262,1,262,[ 12 427  64 496  11],214,5,1058,4.022813688212928,40.0,0.0
10263,1,263,[ 12 427  64 496  11],214,5,1063,4.026515151515151,40.0,0.0
10264,1,264,[ 12 427  64 496  11],416,5,1068,4.030188679245283,40.0,0.0
10265,1,265,[200 100  25 228 183],805,4,1072,4.030075187969925,0.0,0.0
10266,1,266,[ 12 427  64 496  11],416,5,1077,4.033707865168539,40.0,0.0
10267,1,267,[ 12 427  64 496  11],416,5,1082,4.037313432835821,40.0,0.0
10268,1,268,[200   4 176 294  79],854,2,1084,4.029739776951673,0.0,0.0
10269,1,269,[ 98 185  25 655 405],805,3,1087,4.025925925925926,0.0,20.0
10270,1,270,[228 215 111 174   7],297,2,1089,4.018450184501845,0.0,0.0
10271,1,271,[427  64 496  12  11],618,5,1094,4.022058823529412,40.0,0.0
10272,1,272,[427  64 496  12  11],416,5,1099,4.0256410256410255,40.0,0.0
10273,1,273,[202 678 235  79  50],416,3,1102,4.021897810218978,0.0,20.0
10274,1,274,[427  12  11 483 496],342,5,1107,4.025454545454545,40.0,0.0
10275,1,275,[427  12  11 483 496],342,5,1112,4.028985507246377,40.0,0.0
10276,1,276,[ 11  50 195  96 210],416,5,1117,4.0324909747292415,0.0,20.0
10277,1,277,[196 357 265  69 187],373,4,1121,4.032374100719425,0.0,0.0
10278,1,278,[427  12  64 496 483],253,5,1126,4.03584229390681,60.0,0.0
10279,1,279,[197 269 603 144 127],416,5,1131,4.039285714285715,0.0,0.0
10280,1,280,[273 313 202 588 268],416,5,1136,4.04270462633452,20.0,20.0
10281,1,281,[ 11  64 496 427 483],618,5,1141,4.046099290780142,40.0,0.0
10282,1,282,[210 258 125 135 257],417,2,1143,4.03886925795053,0.0,0.0
10283,1,283,[318  12 603 515 211],405,2,1145,4.03169014084507,40.0,0.0
10284,1,284,[ 96 228 294 210 181],505,2,1147,4.024561403508772,0.0,20.0
10285,1,285,[ 11  64 496 427 483],618,5,1152,4.027972027972028,40.0,0.0
10286,1,286,[132 235 100 176 294],887,3,1155,4.024390243902439,0.0,0.0
10287,1,287,[ 11  64 496 427 483],618,5,1160,4.027777777777778,40.0,0.0
10288,1,288,[423 222 301 271  70],297,3,1163,4.024221453287197,0.0,0.0
10289,1,289,[483  12  11 427 496],342,5,1168,4.027586206896552,40.0,0.0
10290,1,290,[186 471   7 117 151],854,2,1170,4.020618556701031,0.0,0.0
10291,1,291,[483 427  12  64  11],214,5,1175,4.023972602739726,60.0,0.0
10292,1,292,[ 12 191 318 568 302],43,5,1180,4.027303754266212,40.0,0.0
10293,1,293,[483 427  12  64  11],618,5,1185,4.030612244897959,60.0,0.0
10294,1,294,[568 216 385  82 174],922,1,1186,4.020338983050848,0.0,0.0
10295,1,295,[483 427  12  64  11],214,5,1191,4.023648648648648,60.0,0.0
10296,1,296,[483 427  12  64  11],214,5,1196,4.026936026936027,60.0,0.0
10297,1,297,[483 427  12  64  11],214,5,1201,4.030201342281879,60.0,0.0
10298,1,298,[483 427  12  64  11],214,5,1206,4.033444816053512,60.0,0.0
10299,1,299,[483 427  12  64  11],214,5,1211,4.036666666666667,60.0,0.0
10300,1,300,[427   1 215 237  79],618,5,1216,4.039867109634551,0.0,0.0
10301,1,301,[ 11 427  12 483  64],214,5,1221,4.043046357615894,60.0,0.0
10302,1,302,[405 471 322 275 294],416,4,1225,4.042904290429043,0.0,0.0
10303,1,303,[ 11 427  12 483  64],214,5,1230,4.046052631578948,60.0,0.0
10304,1,304,[ 11 427  12 483  64],214,5,1235,4.049180327868853,60.0,0.0
10305,1,305,[ 11 427  12 483  64],214,5,1240,4.052287581699346,60.0,0.0
10306,1,306,[322 111 258 143 175],805,1,1241,4.042345276872964,0.0,0.0
10307,1,307,[294   1   7  25  70],417,3,1244,4.038961038961039,0.0,0.0
10308,1,308,[127 135 238 216 179],405,3,1247,4.035598705501618,0.0,0.0
10309,1,309,[427 483  11  64 496],618,5,1252,4.038709677419355,40.0,0.0
10310,1,310,[427 483  11  64 496],214,5,1257,4.041800643086817,40.0,0.0
10311,1,311,[427 483  11  64 496],214,5,1262,4.044871794871795,40.0,0.0
10312,1,312,[435  95   8  79 215],437,3,1265,4.041533546325879,0.0,0.0
10313,1,313,[508 216 195 100 174],62,5,1270,4.044585987261146,0.0,0.0
10314,1,314,[194 282  97 168 322],416,4,1274,4.044444444444444,0.0,0.0
10315,1,315,[ 12  11 508 427 483],214,5,1279,4.0474683544303796,40.0,0.0
10316,1,316,[ 56 176 197 153 238],437,4,1283,4.047318611987381,0.0,0.0
10317,1,317,[ 64 496 483  11  12],175,5,1288,4.050314465408805,60.0,0.0
10318,1,318,[235 234  56 185 273],417,2,1290,4.043887147335423,0.0,0.0
10319,1,319,[204 597 286  56  22],416,4,1294,4.04375,0.0,0.0
10320,1,320,[196 172 174 546 100],417,1,1295,4.034267912772585,0.0,0.0
10321,1,321,[ 12  64 508 496  11],417,3,1298,4.031055900621118,40.0,0.0
10322,1,322,[100 174  12 282 118],588,2,1300,4.024767801857585,20.0,0.0
10323,1,323,[ 98  69 176 265 568],198,3,1303,4.021604938271605,0.0,20.0
10324,1,324,[228  70 235 294 483],417,3,1306,4.018461538461539,20.0,0.0
10325,1,325,[ 12  11 427  64 483],214,5,1311,4.021472392638037,60.0,0.0
10326,1,326,[ 12  11 427  64 483],214,5,1316,4.0244648318042815,60.0,0.0
10327,1,327,[197  71 161 655   1],345,2,1318,4.0182926829268295,0.0,0.0
10328,1,328,[ 12  11 427  64 483],214,5,1323,4.0212765957446805,60.0,0.0
10329,1,329,[ 12  11 427  64 483],618,5,1328,4.024242424242424,60.0,0.0
10330,1,330,[300 100  15 385  11],416,5,1333,4.027190332326284,0.0,0.0
10331,1,331,[ 12  11 427  64 483],214,5,1338,4.030120481927711,60.0,0.0
10332,1,332,[ 89 168 302 202 132],405,3,1341,4.027027027027027,0.0,0.0
10333,1,333,[515  69 216  11 118],297,3,1344,4.023952095808383,0.0,0.0
10334,1,334,[151  89 235  22  50],642,2,1346,4.017910447761194,0.0,20.0
10335,1,335,[ 12 427  64  11 483],214,5,1351,4.020833333333333,60.0,0.0
10336,1,336,[ 82   7 172 289 269],416,4,1355,4.0207715133531154,0.0,0.0
10337,1,337,[ 12 427  64  11 483],214,5,1360,4.023668639053255,60.0,0.0
10338,1,338,[ 12 427  64  11 483],618,5,1365,4.0265486725663715,60.0,0.0
10339,1,339,[237 161 301 496 289],416,3,1368,4.023529411764706,0.0,0.0
10340,1,340,[151 185 385  25 215],198,2,1370,4.0175953079178885,0.0,0.0
10341,1,341,[215 197 300  79 194],297,0,1370,4.005847953216374,0.0,0.0
10342,1,342,[ 64 427  11 483  12],214,5,1375,4.0087463556851315,60.0,0.0
10343,1,343,[ 64 427  11 483  12],618,5,1380,4.011627906976744,60.0,0.0
10344,1,344,[100 568 144 318 172],654,4,1384,4.011594202898551,20.0,0.0
10345,1,345,[168 294  79 118 111],128,4,1388,4.011560693641618,0.0,0.0
10346,1,346,[100   8  12 180 294],854,4,1392,4.011527377521614,20.0,0.0
10347,1,347,[ 11 483  64 427  12],618,5,1397,4.014367816091954,60.0,0.0
10348,1,348,[  4 135 435 144  71],373,3,1400,4.011461318051576,0.0,0.0
10349,1,349,[161 265  71  50  95],373,5,1405,4.014285714285714,0.0,20.0
10350,1,350,[483  64 427  12  11],214,5,1410,4.017094017094017,60.0,0.0
10351,1,351,[483  64 427  12  11],214,5,1415,4.019886363636363,60.0,0.0
10352,1,352,[222 268 144  95 282],297,2,1417,4.014164305949008,0.0,0.0
10353,1,353,[483  64 427  12  11],618,5,1422,4.016949152542373,60.0,0.0
10354,1,354,[258 135  64 655   1],198,5,1427,4.019718309859155,20.0,0.0
10355,1,355,[300 286 176 143 185],416,5,1432,4.022471910112359,0.0,0.0
10356,1,356,[ 12  64  11 483 427],618,5,1437,4.025210084033613,60.0,0.0
10357,1,357,[ 79 271 323  15  88],43,3,1440,4.022346368715084,0.0,0.0
10358,1,358,[288 597 257  64 143],314,5,1445,4.025069637883008,20.0,20.0
10359,1,359,[194 258 216 204 301],297,3,1448,4.022222222222222,0.0,0.0
10360,1,360,[ 11  64 483  12 427],214,5,1453,4.024930747922438,60.0,0.0
10361,1,361,[204 385  79 265 286],416,5,1458,4.027624309392265,0.0,0.0
10362,1,362,[483  64  11 427  12],618,5,1463,4.03030303030303,60.0,0.0
10363,1,363,[483  64  11 427  12],214,5,1468,4.032967032967033,60.0,0.0
10364,1,364,[483  64  11 427  12],618,5,1473,4.035616438356165,60.0,0.0
10365,1,365,[235 117 200  11  69],345,4,1477,4.03551912568306,0.0,0.0
10366,1,366,[151 173  89 294 117],642,3,1480,4.032697547683924,0.0,0.0
10367,1,367,[483  64  11 427  12],618,5,1485,4.0353260869565215,60.0,0.0
10368,1,368,[483  64  11 427  12],618,5,1490,4.0379403794037945,60.0,0.0
10369,1,369,[271 211 275  70  98],297,4,1494,4.037837837837838,0.0,20.0
10370,1,370,[405  79 300 515 403],416,5,1499,4.040431266846361,0.0,0.0
10371,1,371,[197 568 153 300  69],198,3,1502,4.037634408602151,0.0,0.0
10372,1,372,[483  11  12 427  64],214,5,1507,4.040214477211796,60.0,0.0
10373,1,373,[ 69  50 195 508  71],62,5,1512,4.042780748663102,0.0,20.0
10374,1,374,[172 655 195 257 286],705,1,1513,4.034666666666666,0.0,0.0
10375,1,375,[427 483  12  64  11],214,5,1518,4.037234042553192,60.0,0.0
10376,1,376,[427 483  12  64  11],618,5,1523,4.039787798408488,60.0,0.0
10377,1,377,[427 483  12  64  11],618,5,1528,4.042328042328043,60.0,0.0
10378,1,378,[568 216 403 100 174],588,2,1530,4.036939313984169,0.0,0.0
10379,1,379,[ 28  88 597 168 294],43,4,1534,4.036842105263158,0.0,0.0
10380,1,380,[546 176 300 111 318],416,4,1538,4.036745406824147,20.0,0.0
10381,1,381,[ 11 483 427  12  64],214,5,1543,4.039267015706806,60.0,0.0
10382,1,382,[ 11 483 427  12  64],618,5,1548,4.04177545691906,60.0,0.0
10383,1,383,[748   7 118  98  79],416,4,1552,4.041666666666667,0.0,20.0
10384,1,384,[195  97 238 100 597],416,4,1556,4.041558441558442,0.0,0.0
10385,1,385,[ 64 427 483  11  12],618,5,1561,4.044041450777202,60.0,0.0
10386,1,386,[ 82 405 496 483  96],601,2,1563,4.038759689922481,20.0,0.0
10387,1,387,[ 12  64 483  11 427],618,5,1568,4.041237113402062,60.0,0.0
10388,1,388,[194  98 195 471 151],297,1,1569,4.033419023136247,0.0,20.0
10389,1,389,[ 70 257 185 546 286],416,3,1572,4.030769230769231,0.0,0.0
10390,1,390,[216  82 125   1 121],417,3,1575,4.028132992327365,0.0,0.0
10391,1,391,[282 238 318 258  64],416,5,1580,4.030612244897959,40.0,0.0
10392,1,392,[ 12  11  64 483 427],214,5,1585,4.033078880407125,60.0,0.0
10393,1,393,[ 12  11  64 483 427],618,5,1590,4.035532994923858,60.0,0.0
10394,1,394,[228 173  69 568  98],711,1,1591,4.027848101265823,0.0,20.0
10395,1,395,[ 70 151 748 204 100],297,2,1593,4.0227272727272725,0.0,0.0
10396,1,396,[483  64  11 427  12],618,5,1598,4.025188916876575,60.0,0.0
10397,1,397,[483  64  11 427  12],214,5,1603,4.027638190954774,60.0,0.0
10398,1,398,[ 79 202 265 258 210],588,4,1607,4.027568922305765,0.0,0.0
10399,1,399,[568 143 216 269   7],751,3,1610,4.025,0.0,0.0
10400,1,400,[655 118 216 302 210],417,2,1612,4.019950124688279,0.0,0.0
10401,1,401,[ 97 121 183 655  22],705,2,1614,4.014925373134329,0.0,0.0
10402,1,402,[181 300  12 258 269],345,4,1618,4.0148883374689825,20.0,20.0
10403,1,403,[427 483  12  11  64],214,5,1623,4.017326732673268,60.0,0.0
10404,1,404,[427 483  12  11  64],618,5,1628,4.019753086419753,60.0,0.0
10405,1,405,[427 483  12  11  64],618,5,1633,4.022167487684729,60.0,0.0
10406,1,406,[ 82 423 322 588 568],417,2,1635,4.017199017199017,0.0,0.0
10407,1,407,[  7 405 234  95  70],230,4,1639,4.017156862745098,0.0,0.0
10408,1,408,[483  12 427  11  64],214,5,1644,4.019559902200489,60.0,0.0
10409,1,409,[161 135  98  89 423],198,3,1647,4.017073170731707,0.0,20.0
10410,1,410,[ 64  12 427 483  11],618,5,1652,4.019464720194647,60.0,0.0
10411,1,411,[288  56 144  98 135],854,4,1656,4.019417475728155,0.0,40.0
10412,1,412,[273 258 125 257 276],62,4,1660,4.019370460048426,0.0,0.0
10413,1,413,[153 222 471 385   8],43,4,1664,4.019323671497585,0.0,0.0
10414,1,414,[483  64  11  12 427],214,5,1669,4.021686746987951,60.0,0.0
10415,1,415,[483  64  11  12 427],214,5,1674,4.024038461538462,60.0,0.0
10416,1,416,[483  64  11  12 427],214,5,1679,4.026378896882494,60.0,0.0
10417,1,417,[483  64  11  12 427],214,5,1684,4.028708133971292,60.0,0.0
10418,1,418,[195 191 100 222   9],805,3,1687,4.026252983293556,0.0,0.0
10419,1,419,[483  64  11  12 427],214,5,1692,4.0285714285714285,60.0,0.0
10420,1,420,[483  64  11  12 427],214,5,1697,4.0308788598574825,60.0,0.0
10421,1,421,[173 179 357 172   7],198,5,1702,4.033175355450237,0.0,0.0
10422,1,422,[135  28  97 742 161],230,4,1706,4.033096926713948,0.0,0.0
10423,1,423,[427  64  12 483  11],618,5,1711,4.035377358490566,60.0,0.0
10424,1,424,[427  64  12 483  11],214,5,1716,4.03764705882353,60.0,0.0
10425,1,425,[427  64  12 483  11],618,5,1721,4.039906103286385,60.0,0.0
10426,1,426,[427  64  12 483  11],214,5,1726,4.04215456674473,60.0,0.0
10427,1,427,[175 276 323 174 216],43,3,1729,4.039719626168225,0.0,0.0
10428,1,428,[ 25  28 132  11 196],416,5,1734,4.041958041958042,0.0,0.0
10429,1,429,[ 64 427  12 483  11],618,5,1739,4.044186046511628,60.0,0.0
10430,1,430,[ 64 427  12 483  11],214,5,1744,4.046403712296984,60.0,0.0
10431,1,431,[179  96 135   4 258],805,3,1747,4.043981481481482,0.0,0.0
10432,1,432,[ 56  64 202 144 210],416,5,1752,4.046189376443418,20.0,0.0
10433,1,433,[268 216 357 496  79],214,4,1756,4.046082949308755,0.0,0.0
10434,1,434,[258  12  50 181  56],43,5,1761,4.048275862068966,20.0,40.0
10435,1,435,[ 95 179 200 117 185],417,4,1765,4.048165137614679,0.0,0.0
10436,1,436,[118  12 172 403 423],805,3,1768,4.045766590389016,20.0,0.0
10437,1,437,[ 12 483 427  11  64],618,5,1773,4.0479452054794525,60.0,0.0
10438,1,438,[265   8 288 294  22],297,2,1775,4.043280182232346,0.0,20.0
10439,1,439,[ 12 427  11 483  64],214,5,1780,4.045454545454546,60.0,0.0
10440,1,440,[ 12 427  11 483  64],214,5,1785,4.0476190476190474,60.0,0.0
10441,1,441,[ 12 427  11 483  64],214,5,1790,4.049773755656108,60.0,0.0
10442,1,442,[ 64 471 202  28 144],43,4,1794,4.049661399548532,20.0,0.0
10443,1,443,[ 12 427  11 483  64],618,5,1799,4.051801801801802,60.0,0.0
10444,1,444,[ 89 597 173  97 195],705,1,1800,4.044943820224719,0.0,0.0
10445,1,445,[204 179  70 202   8],405,3,1803,4.042600896860987,0.0,0.0
10446,1,446,[427  12  11  64 483],214,5,1808,4.0447427293064875,60.0,0.0
10447,1,447,[427  12  11  64 483],214,5,1813,4.046875,60.0,0.0
10448,1,448,[475 121   8 222 181],601,3,1816,4.044543429844098,0.0,20.0
10449,1,449,[ 69 161 257 111 286],705,3,1819,4.042222222222223,0.0,0.0
10450,1,450,[ 64 483  12  11 427],618,5,1824,4.044345898004434,60.0,0.0
10451,1,451,[ 64 483  12  11 427],618,5,1829,4.04646017699115,60.0,0.0
10452,1,452,[  9 245 228 475 195],62,3,1832,4.044150110375276,0.0,0.0
10453,1,453,[ 82 748 176 742 655],417,4,1836,4.044052863436123,0.0,0.0
10454,1,454,[210 265  12 235 194],416,4,1840,4.043956043956044,20.0,0.0
10455,1,455,[ 28 100 194 588 318],416,5,1845,4.046052631578948,20.0,0.0
10456,1,456,[ 22 515 121 302 403],416,5,1850,4.048140043763676,0.0,0.0
10457,1,457,[186 403  28 132 423],618,5,1855,4.050218340611353,0.0,0.0
10458,1,458,[427 483  12  64  11],214,5,1860,4.052287581699346,60.0,0.0
10459,1,459,[172  98 294  71  12],49,2,1862,4.047826086956522,20.0,20.0
10460,1,460,[427  12  11  64 483],214,5,1867,4.049891540130152,60.0,0.0
10461,1,461,[427  12  11  64 483],214,5,1872,4.0519480519480515,60.0,0.0
10462,1,462,[427  12  11  64 483],214,5,1877,4.053995680345572,60.0,0.0
10463,1,463,[475  22  64  50 357],62,5,1882,4.056034482758621,20.0,20.0
10464,1,464,[ 95 144 568 286  69],416,4,1886,4.055913978494623,0.0,0.0
10465,1,465,[427  11 483  12  64],214,5,1891,4.05793991416309,60.0,0.0
10466,1,466,[187 117 182 179  25],416,4,1895,4.057815845824411,0.0,0.0
10467,1,467,[323 210 215 235   7],416,3,1898,4.055555555555555,0.0,0.0
10468,1,468,[  8 185 172 151 197],437,5,1903,4.0575692963752665,0.0,0.0
10469,1,469,[ 12  64 427  11 483],214,5,1908,4.059574468085106,60.0,0.0
10470,1,470,[144   1  50  95 405],230,4,1912,4.059447983014862,0.0,20.0
10471,1,471,[ 97 161 294 435 288],721,3,1915,4.057203389830509,0.0,20.0
10472,1,472,[ 11  64  12 427 483],618,5,1920,4.059196617336152,60.0,0.0
10473,1,473,[ 11  64  12 427 483],214,5,1925,4.061181434599156,60.0,0.0
10474,1,474,[ 11  64  12 427 483],618,5,1930,4.063157894736842,60.0,0.0
10475,1,475,[ 11  64  12 427 483],618,5,1935,4.065126050420168,60.0,0.0
10476,1,476,[183  79 403 172 185],417,2,1937,4.060796645702306,0.0,0.0
10477,1,477,[ 12  64 427 483  11],214,5,1942,4.062761506276151,60.0,0.0
10478,1,478,[ 12  64 427 483  11],214,5,1947,4.064718162839249,60.0,0.0
10479,1,479,[ 12  64 427 483  11],618,5,1952,4.066666666666666,60.0,0.0
10480,1,480,[ 12  64 427 483  11],214,5,1957,4.0686070686070686,60.0,0.0
10481,1,481,[117 174  97 300  98],198,2,1959,4.064315352697095,0.0,20.0
10482,1,482,[ 64 483 427  12  11],618,5,1964,4.066252587991719,60.0,0.0
10483,1,483,[118  22 294 403 117],62,3,1967,4.06404958677686,0.0,0.0
10484,1,484,[483  12 427  11  64],618,5,1972,4.065979381443299,60.0,0.0
10485,1,485,[405 496 423 300  50],654,5,1977,4.067901234567901,0.0,20.0
10486,1,486,[742 322 215 182  79],416,4,1981,4.06776180698152,0.0,0.0
10487,1,487,[125  79  69 117 385],373,4,1985,4.067622950819672,0.0,0.0
10488,1,488,[742 191 275 423 228],297,1,1986,4.061349693251533,0.0,0.0
10489,1,489,[483  11  64  12 427],214,5,1991,4.063265306122449,60.0,0.0
10490,1,490,[483  11  64  12 427],618,5,1996,4.065173116089613,60.0,0.0
10491,1,491,[483  11  64  12 427],618,5,2001,4.067073170731708,60.0,0.0
10492,1,492,[ 98 153  11 172  70],751,4,2005,4.0669371196754565,0.0,20.0
10493,1,493,[ 12  64 483 427  11],618,5,2010,4.068825910931174,60.0,0.0
10494,1,494,[ 12  64 483 427  11],618,5,2015,4.070707070707071,60.0,0.0
10495,1,495,[294 271 403 655 200],922,1,2016,4.064516129032258,0.0,0.0
10496,1,496,[546 515  12 237 328],416,3,2019,4.062374245472837,20.0,0.0
10497,1,497,[483  64 427  12  11],214,5,2024,4.06425702811245,60.0,0.0
10498,1,498,[483  64 427  12  11],214,5,2029,4.066132264529058,60.0,0.0
10499,1,499,[ 11  97 234 385 168],416,5,2034,4.068,0.0,0.0
10500,1,500,[742 151 235  98 197],805,3,2037,4.065868263473054,0.0,20.0
10501,1,501,[195  64  82 174 173],705,3,2040,4.063745019920319,20.0,0.0
10502,1,502,[269 175 185 322  22],854,3,2043,4.061630218687872,0.0,0.0
10503,1,503,[ 64 427  12 483  11],618,5,2048,4.063492063492063,60.0,0.0
10504,1,504,[121 125 273 357 153],630,2,2050,4.0594059405940595,0.0,0.0
10505,1,505,[ 64 483 427  12  11],618,5,2055,4.061264822134388,60.0,0.0
10506,1,506,[ 64 483 427  12  11],618,5,2060,4.063116370808679,60.0,0.0
10507,1,507,[ 64 483 427  12  11],618,5,2065,4.06496062992126,60.0,0.0
10508,1,508,[  8 181  98  25 678],654,3,2068,4.06286836935167,0.0,40.0
10509,1,509,[168 172  70  95 588],618,3,2071,4.06078431372549,0.0,0.0
10510,1,510,[153 269  28 197 742],805,3,2074,4.0587084148727985,0.0,0.0
10511,1,511,[483 427  64  12  11],214,5,2079,4.060546875,60.0,0.0
10512,1,512,[483 427  64  12  11],618,5,2084,4.0623781676413255,60.0,0.0
10513,1,513,[483 427  64  12  11],618,5,2089,4.06420233463035,60.0,0.0
10514,1,514,[ 25 222 323 405 273],417,0,2089,4.05631067961165,0.0,0.0
10515,1,515,[483 427  64  12  11],214,5,2094,4.058139534883721,60.0,0.0
10516,1,516,[483 427  64  12  11],618,5,2099,4.059961315280464,60.0,0.0
10517,1,517,[483 427  64  12  11],618,5,2104,4.061776061776062,60.0,0.0
10518,1,518,[176 333  22 144 172],416,5,2109,4.063583815028902,0.0,0.0
10519,1,519,[483 427  64  12  11],214,5,2114,4.065384615384615,60.0,0.0
10520,1,520,[483 427  64  12  11],214,5,2119,4.067178502879079,60.0,0.0
10521,1,521,[483 427  64  12  11],618,5,2124,4.068965517241379,60.0,0.0
10522,1,522,[ 50 172 265  97 204],618,4,2128,4.0688336520076485,0.0,20.0
10523,1,523,[111 385 286 183   7],416,5,2133,4.070610687022901,0.0,0.0
10524,1,524,[483 427  12  64  11],214,5,2138,4.072380952380953,60.0,0.0
10525,1,525,[483 427  12  64  11],214,5,2143,4.074144486692015,60.0,0.0
10526,1,526,[483 427  12  64  11],214,5,2148,4.075901328273245,60.0,0.0
10527,1,527,[483 427  12  64  11],618,5,2153,4.077651515151516,60.0,0.0
10528,1,528,[  4 197 475  50  88],805,3,2156,4.0756143667296785,0.0,20.0
10529,1,529,[475 597 258   1 289],588,3,2159,4.073584905660377,0.0,0.0
10530,1,530,[427 483  12  64  11],214,5,2164,4.0753295668549905,60.0,0.0
10531,1,531,[427 483  12  64  11],214,5,2169,4.077067669172933,60.0,0.0
10532,1,532,[427 483  12  64  11],214,5,2174,4.078799249530957,60.0,0.0
10533,1,533,[ 22 132 215 121  12],416,5,2179,4.080524344569288,20.0,0.0
10534,1,534,[427 483  12  64  11],214,5,2184,4.082242990654206,60.0,0.0
10535,1,535,[403 111 173  56  71],618,3,2187,4.080223880597015,0.0,0.0
10536,1,536,[168 186 172   9 282],618,3,2190,4.078212290502793,0.0,0.0
10537,1,537,[185  12  79 211 111],437,4,2194,4.078066914498141,20.0,0.0
10538,1,538,[427 483  12  64  11],618,5,2199,4.079777365491651,60.0,0.0
10539,1,539,[322  11 121 235 546],416,2,2201,4.075925925925926,0.0,0.0
10540,1,540,[427 483  12  64  11],214,5,2206,4.077634011090573,60.0,0.0
10541,1,541,[748 121 403  12 135],805,3,2209,4.075645756457565,20.0,0.0
10542,1,542,[483 427  12  64  11],214,5,2214,4.077348066298343,60.0,0.0
10543,1,543,[483 427  12  64  11],618,5,2219,4.079044117647059,60.0,0.0
10544,1,544,[483 427  12  64  11],214,5,2224,4.080733944954129,60.0,0.0
10545,1,545,[161 269 185  70 483],711,5,2229,4.082417582417582,20.0,0.0
10546,1,546,[ 64 125 173  28 153],721,4,2233,4.082266910420476,20.0,0.0
10547,1,547,[ 98   7 168 603 475],854,5,2238,4.083941605839416,0.0,20.0
10548,1,548,[483  64  12 427  11],214,5,2243,4.0856102003642984,60.0,0.0
10549,1,549,[483  64  12 427  11],214,5,2248,4.087272727272727,60.0,0.0
10550,1,550,[403 423 161  56   7],49,2,2250,4.083484573502722,0.0,0.0
10551,1,551,[427  64  12 483  11],618,5,2255,4.0851449275362315,60.0,0.0
10552,1,552,[ 15 118 323  56 403],43,4,2259,4.08499095840868,0.0,0.0
10553,1,553,[588 117 216 172  98],588,4,2263,4.084837545126354,0.0,20.0
10554,1,554,[427  64  12 483  11],618,5,2268,4.0864864864864865,60.0,0.0
10555,1,555,[427  64  12 483  11],618,5,2273,4.088129496402877,60.0,0.0
10556,1,556,[176 588 197 195  50],437,2,2275,4.084380610412927,0.0,20.0
10557,1,557,[427  64  12 483  11],214,5,2280,4.086021505376344,60.0,0.0
10558,1,558,[228 385 175 288 191],922,1,2281,4.080500894454383,0.0,20.0
10559,1,559,[211 182 235 318  25],416,4,2285,4.080357142857143,20.0,0.0
10560,1,560,[546 153 197  95 117],297,2,2287,4.076648841354723,0.0,0.0
10561,1,561,[200 234 238 180 294],805,3,2290,4.074733096085409,0.0,0.0
10562,1,562,[318 186 423 748 195],642,2,2292,4.071047957371226,20.0,0.0
10563,1,563,[172 286 118   4 403],43,5,2297,4.072695035460993,0.0,0.0
10564,1,564,[302 111 191 173 655],416,5,2302,4.074336283185841,0.0,0.0
10565,1,565,[185 180 313 483 100],214,5,2307,4.075971731448763,40.0,20.0
10566,1,566,[483  64 427  12  11],618,5,2312,4.0776014109347445,60.0,0.0
10567,1,567,[483  64 427  12  11],214,5,2317,4.079225352112676,60.0,0.0
10568,1,568,[211 215 588  28 173],43,5,2322,4.080843585237258,0.0,0.0
10569,1,569,[176 228  70 191 216],405,1,2323,4.075438596491228,0.0,0.0
10570,1,570,[ 50  79 603 265 275],270,5,2328,4.077057793345009,0.0,20.0
10571,1,571,[ 12  64 427 483  11],214,5,2333,4.078671328671328,60.0,0.0
10572,1,572,[ 12  64 427 483  11],214,5,2338,4.0802792321116925,60.0,0.0
10573,1,573,[ 12  64 427 483  11],214,5,2343,4.081881533101045,60.0,0.0
10574,1,574,[180 143  70 265  25],128,3,2346,4.08,0.0,0.0
10575,1,575,[ 64  12 427 483  11],618,5,2351,4.081597222222222,60.0,0.0
10576,1,576,[ 64  12 427 483  11],618,5,2356,4.083188908145581,60.0,0.0
10577,1,577,[ 79 168 143 196 405],128,5,2361,4.08477508650519,0.0,0.0
10578,1,578,[546 328  50 181  97],416,4,2365,4.084628670120898,0.0,40.0
10579,1,579,[ 64  12 483 427  11],214,5,2370,4.086206896551724,60.0,0.0
10580,1,580,[588   4  22 238 245],416,4,2374,4.086058519793459,0.0,0.0
10581,1,581,[ 64  12 483 427  11],214,5,2379,4.087628865979381,60.0,0.0
10582,1,582,[276 135 117 204 172],62,4,2383,4.087478559176672,0.0,0.0
10583,1,583,[196 151  15 117 318],437,4,2387,4.087328767123288,20.0,0.0
10584,1,584,[ 64 483 427  12  11],214,5,2392,4.088888888888889,60.0,0.0
10585,1,585,[ 71  97  15 153 174],43,5,2397,4.090443686006826,0.0,0.0
10586,1,586,[ 64 483 427  12  11],214,5,2402,4.091993185689949,60.0,0.0
10587,1,587,[191 318  64 186 269],854,4,2406,4.091836734693878,40.0,0.0
10588,1,588,[ 50 245 173 194 322],721,4,2410,4.0916808149405774,0.0,20.0
10589,1,589,[143 318 258 196 181],601,3,2413,4.089830508474576,20.0,20.0
10590,1,590,[180 748  28 238  71],805,1,2414,4.084602368866328,0.0,0.0
10591,1,591,[151 238 258 196 216],416,4,2418,4.08445945945946,0.0,0.0
10592,1,592,[483  64  12 427  11],618,5,2423,4.086003372681281,60.0,0.0
10593,1,593,[323  50 597 127 288],416,3,2426,4.084175084175084,0.0,40.0
10594,1,594,[ 12 202 313 265 125],416,5,2431,4.085714285714285,40.0,20.0
10595,1,595,[168 186 121 191 588],601,3,2434,4.083892617449664,0.0,0.0
10596,1,596,[ 12  64 427 483  11],214,5,2439,4.085427135678392,60.0,0.0
10597,1,597,[ 12  64 427 483  11],618,5,2444,4.086956521739131,60.0,0.0
10598,1,598,[ 12  64 427 483  11],214,5,2449,4.088480801335559,60.0,0.0
10599,1,599,[ 12  64 427 483  11],618,5,2454,4.09,60.0,0.0
10600,1,600,[151 471  50  28 215],43,4,2458,4.0898502495840265,0.0,20.0
10601,1,601,[ 12  64 427 483  11],214,5,2463,4.091362126245847,60.0,0.0
10602,1,602,[204 258 568 318 125],416,5,2468,4.092868988391376,20.0,0.0
10603,1,603,[ 96 323 508 258  69],417,1,2469,4.087748344370861,0.0,0.0
10604,1,604,[ 64 427  12 483  11],618,5,2474,4.089256198347107,60.0,0.0
10605,1,605,[ 82 483 286 181 423],437,3,2477,4.087458745874588,20.0,20.0
10606,1,606,[ 70  28 268 183 176],416,5,2482,4.088962108731466,0.0,0.0
10607,1,607,[288 168  70 173 546],416,4,2486,4.088815789473684,0.0,20.0
10608,1,608,[427  64  12 483  11],618,5,2491,4.090311986863711,60.0,0.0
10609,1,609,[427  64  12 483  11],214,5,2496,4.091803278688524,60.0,0.0
10610,1,610,[237 496  56 185 151],618,4,2500,4.091653027823241,0.0,0.0
10611,1,611,[427  64  12 483  11],214,5,2505,4.0931372549019605,60.0,0.0
10612,1,612,[427  64  12 483  11],214,5,2510,4.0946166394779775,60.0,0.0
10613,1,613,[194 153 172  28 125],416,5,2515,4.096091205211726,0.0,0.0
10614,1,614,[427  64 483  12  11],214,5,2520,4.097560975609756,60.0,0.0
10615,1,615,[237  71 275 202 603],128,4,2524,4.097402597402597,0.0,0.0
10616,1,616,[427  64 483  12  11],618,5,2529,4.098865478119935,60.0,0.0
10617,1,617,[427  64 483  12  11],214,5,2534,4.100323624595469,60.0,0.0
10618,1,618,[423 180 168  15  11],437,3,2537,4.098546042003231,0.0,0.0
10619,1,619,[181 288 174 161 216],618,3,2540,4.096774193548387,0.0,40.0
10620,1,620,[483  12  64 427  11],618,5,2545,4.098228663446055,60.0,0.0
10621,1,621,[288 423  50 202 121],711,2,2547,4.094855305466238,0.0,40.0
10622,1,622,[427  64 483  12  11],618,5,2552,4.096308186195826,60.0,0.0
10623,1,623,[187   7  12 265 742],416,5,2557,4.097756410256411,20.0,0.0
10624,1,624,[427  64 483  12  11],214,5,2562,4.0992,60.0,0.0
10625,1,625,[238 475 196 186 655],198,4,2566,4.099041533546326,0.0,0.0
10626,1,626,[234 216  95  96  88],416,3,2569,4.097288676236045,0.0,0.0
10627,1,627,[235 568  56 161   9],43,4,2573,4.0971337579617835,0.0,0.0
10628,1,628,[ 15 588 121 161 186],437,1,2574,4.09220985691574,0.0,0.0
10629,1,629,[483 427  64  12  11],214,5,2579,4.093650793650793,60.0,0.0
10630,1,630,[483 427  64  12  11],618,5,2584,4.0950871632329635,60.0,0.0
10631,1,631,[313   9 100 238  70],43,4,2588,4.094936708860759,20.0,20.0
10632,1,632,[427  64 483  12  11],618,5,2593,4.096366508688783,60.0,0.0
10633,1,633,[323 328 423 187   9],416,4,2597,4.096214511041009,0.0,0.0
10634,1,634,[483 427  12  64  11],618,5,2602,4.097637795275591,60.0,0.0
10635,1,635,[483 427  12  64  11],214,5,2607,4.099056603773585,60.0,0.0
10636,1,636,[ 56  12  15 546   8],314,4,2611,4.0989010989010985,20.0,0.0
10637,1,637,[483 427  12  64  11],618,5,2616,4.100313479623824,60.0,0.0
10638,1,638,[323 132 273 100   7],764,3,2619,4.098591549295775,0.0,0.0
10639,1,639,[  8 423  22 275 100],854,4,2623,4.0984375,0.0,0.0
10640,1,640,[204  25  88 222 405],128,3,2626,4.096723868954758,0.0,0.0
10641,1,641,[176  25 322 173  89],417,3,2629,4.095015576323988,0.0,0.0
10642,1,642,[483 427  12  64  11],618,5,2634,4.096423017107309,60.0,0.0
10643,1,643,[135 111 183 185  97],297,4,2638,4.096273291925466,0.0,0.0
10644,1,644,[603 403 678 269 174],805,4,2642,4.096124031007752,0.0,0.0
10645,1,645,[161 179 200 181  79],437,4,2646,4.095975232198143,0.0,20.0
10646,1,646,[210 197 288 403   8],405,5,2651,4.097372488408037,0.0,20.0
10647,1,647,[ 12  64 483 427  11],214,5,2656,4.098765432098766,60.0,0.0
10648,1,648,[ 12  64 483 427  11],214,5,2661,4.100154083204931,60.0,0.0
10649,1,649,[603 588  89 597 202],805,2,2663,4.096923076923077,0.0,0.0
10650,1,650,[475 117  11 273 357],805,2,2665,4.093701996927804,0.0,0.0
10651,1,651,[603  95  56 568 176],805,3,2668,4.0920245398773005,0.0,0.0
10652,1,652,[603 196 176 174  98],437,4,2672,4.091883614088821,0.0,20.0
10653,1,653,[475 228 181 196 132],711,4,2676,4.091743119266055,0.0,20.0
10654,1,654,[174 200  89 475 111],417,3,2679,4.090076335877862,0.0,0.0
10655,1,655,[483  12  64 427  11],618,5,2684,4.091463414634147,60.0,0.0
10656,1,656,[483  12  64 427  11],214,5,2689,4.0928462709284625,60.0,0.0
10657,1,657,[483  12  64 427  11],214,5,2694,4.094224924012158,60.0,0.0
10658,1,658,[ 56 118 100  28 121],437,2,2696,4.091047040971168,0.0,0.0
10659,1,659,[125 655 276 742  12],416,4,2700,4.090909090909091,20.0,0.0
10660,1,660,[427 483  64  12  11],618,5,2705,4.092284417549168,60.0,0.0
10661,1,661,[427 483  64  12  11],618,5,2710,4.093655589123867,60.0,0.0
10662,1,662,[127 328 216 118  69],38,4,2714,4.093514328808446,0.0,0.0
10663,1,663,[ 64  12 427 483  11],618,5,2719,4.094879518072289,60.0,0.0
10664,1,664,[ 64  12 427 483  11],618,5,2724,4.09624060150376,60.0,0.0
10665,1,665,[ 64  12 427 483  11],618,5,2729,4.097597597597598,60.0,0.0
10666,1,666,[ 82 196 121 215  50],921,4,2733,4.097451274362818,0.0,20.0
10667,1,667,[357  56   4 271 202],805,2,2735,4.094311377245509,0.0,0.0
10668,1,668,[276 191  22 121  64],416,4,2739,4.0941704035874436,20.0,0.0
10669,1,669,[245   1 197 423  22],416,4,2743,4.094029850746269,0.0,0.0
10670,1,670,[313 234 151  12 204],416,4,2747,4.093889716840536,40.0,20.0
10671,1,671,[483 427  12  64  11],214,5,2752,4.095238095238095,60.0,0.0
10672,1,672,[ 12 182  50 132 204],62,4,2756,4.095096582466567,20.0,20.0
10673,1,673,[211 173 603 151 121],416,4,2760,4.094955489614243,0.0,0.0
10674,1,674,[475  15 144 294 175],342,3,2763,4.093333333333334,0.0,0.0
10675,1,675,[ 50 173 423 275  64],373,4,2767,4.09319526627219,20.0,20.0
10676,1,676,[200 475  12  64 294],854,4,2771,4.0930576070901035,40.0,0.0
10677,1,677,[ 12 427 483  64  11],214,5,2776,4.094395280235989,60.0,0.0
10678,1,678,[ 12 427 483  64  11],214,5,2781,4.095729013254786,60.0,0.0
10679,1,679,[179 100 175 172   4],373,2,2783,4.0926470588235295,0.0,0.0
10680,1,680,[216 132 173 475 228],711,3,2786,4.091042584434655,0.0,0.0
10681,1,681,[ 12 427 483  64  11],214,5,2791,4.092375366568915,60.0,0.0
10682,1,682,[ 12 427 483  64  11],214,5,2796,4.093704245973646,60.0,0.0
10683,1,683,[ 12 427 483  64  11],214,5,2801,4.095029239766082,60.0,0.0
10684,1,684,[ 12 427 483  64  11],214,5,2806,4.096350364963504,60.0,0.0
10685,1,685,[357  70 313  95 496],642,3,2809,4.094752186588921,20.0,20.0
10686,1,686,[144 186 385 117 151],417,4,2813,4.094614264919942,0.0,0.0
10687,1,687,[204  15  95   1 237],43,5,2818,4.09593023255814,0.0,0.0
10688,1,688,[ 12 427 483  64  11],214,5,2823,4.097242380261248,60.0,0.0
10689,1,689,[ 12 427 483  64  11],618,5,2828,4.098550724637681,60.0,0.0
10690,1,690,[357 161 215 588 265],373,4,2832,4.098408104196817,0.0,0.0
10691,1,691,[161 515  97  70 275],416,5,2837,4.0997109826589595,0.0,0.0
10692,1,692,[ 12 427 483  64  11],214,5,2842,4.101010101010101,60.0,0.0
10693,1,693,[ 12 427 483  64  11],214,5,2847,4.1023054755043225,60.0,0.0
10694,1,694,[ 12 427 483  64  11],214,5,2852,4.103597122302158,60.0,0.0
10695,1,695,[117 135 143 204  88],618,4,2856,4.103448275862069,0.0,0.0
10696,1,696,[ 12 427 483  64  11],214,5,2861,4.104734576757532,60.0,0.0
10697,1,697,[ 12 427 483  64  11],618,5,2866,4.106017191977077,60.0,0.0
10698,1,698,[ 12 427 483  64  11],618,5,2871,4.1072961373390555,60.0,0.0
10699,1,699,[ 12 427 483  64  11],618,5,2876,4.1085714285714285,60.0,0.0
10700,1,700,[ 12 427 483  64  11],214,5,2881,4.109843081312411,60.0,0.0
10701,1,701,[ 12 427 483  64  11],618,5,2886,4.111111111111111,60.0,0.0
10702,1,702,[301 483  12 185  11],437,3,2889,4.109530583214794,40.0,0.0
10703,1,703,[ 12 427 483  64  11],214,5,2894,4.110795454545454,60.0,0.0
10704,1,704,[ 12 427 483  64  11],214,5,2899,4.112056737588652,60.0,0.0
10705,1,705,[117 210 313 237 508],654,4,2903,4.111898016997167,20.0,20.0
10706,1,706,[427 483  12  64  11],214,5,2908,4.1131541725601135,60.0,0.0
10707,1,707,[427 483  12  64  11],214,5,2913,4.114406779661017,60.0,0.0
10708,1,708,[427 483  12  64  11],618,5,2918,4.115655853314528,60.0,0.0
10709,1,709,[748   1  70 323 127],417,4,2922,4.115492957746479,0.0,0.0
10710,1,710,[ 64  12 427 483  11],618,5,2927,4.1167369901547115,60.0,0.0
10711,1,711,[ 64  12 427 483  11],618,5,2932,4.117977528089888,60.0,0.0
10712,1,712,[568  96 172 276 187],618,3,2935,4.1164095371669,0.0,0.0
10713,1,713,[282 268   7 289  22],416,4,2939,4.116246498599439,0.0,0.0
10714,1,714,[496 117 176 144 210],505,4,2943,4.116083916083916,0.0,0.0
10715,1,715,[151 742 423   8 196],416,4,2947,4.115921787709497,0.0,0.0
10716,1,716,[ 64 427 483  12  11],618,5,2952,4.117154811715481,60.0,0.0
10717,1,717,[ 64 427 483  12  11],618,5,2957,4.118384401114207,60.0,0.0
10718,1,718,[ 64 427 483  12  11],618,5,2962,4.119610570236439,60.0,0.0
10719,1,719,[ 64 427 483  12  11],618,5,2967,4.120833333333334,60.0,0.0
10720,1,720,[ 64 427 483  12  11],618,5,2972,4.122052704576976,60.0,0.0
10721,1,721,[ 64 427 483  12  11],618,5,2977,4.123268698060942,60.0,0.0
10722,1,722,[182 603 118  12  97],297,3,2980,4.121715076071922,20.0,0.0
10723,1,723,[ 95 322  64 318 111],679,2,2982,4.1187845303867405,40.0,0.0
10724,1,724,[211 294 333 300 183],416,5,2987,4.12,0.0,0.0
10725,1,725,[ 98 151  50 435 475],297,3,2990,4.118457300275482,0.0,40.0
10726,1,726,[ 28 435 121 211 288],437,1,2991,4.114167812929849,0.0,20.0
10727,1,727,[483 427  64  12  11],214,5,2996,4.115384615384615,60.0,0.0
10728,1,728,[ 98 258 100 216 222],62,5,3001,4.116598079561043,0.0,20.0
10729,1,729,[483 427  64  12  11],214,5,3006,4.117808219178082,60.0,0.0
10730,1,730,[ 56 294 301   9 403],43,5,3011,4.119015047879617,0.0,0.0
10731,1,731,[269 302 328 546 153],416,4,3015,4.118852459016393,0.0,0.0
10732,1,732,[ 50 237 403   4 118],43,5,3020,4.120054570259208,0.0,20.0
10733,1,733,[215 245  98 234  64],416,4,3024,4.119891008174387,20.0,20.0
10734,1,734,[ 64 427  12 483  11],214,5,3029,4.1210884353741495,60.0,0.0
10735,1,735,[132 288 275 302 258],854,4,3033,4.1209239130434785,0.0,20.0
10736,1,736,[ 12  64 427 483  11],618,5,3038,4.122116689280868,60.0,0.0
10737,1,737,[ 12  64 427 483  11],618,5,3043,4.123306233062331,60.0,0.0
10738,1,738,[ 12  64 427 483  11],618,5,3048,4.124492557510149,60.0,0.0
10739,1,739,[144 186 328 179 172],373,3,3051,4.122972972972973,0.0,0.0
10740,1,740,[  4  15 597 191 257],43,4,3055,4.12280701754386,0.0,0.0
10741,1,741,[588  15 275 111 238],654,4,3059,4.122641509433962,0.0,0.0
10742,1,742,[ 12  64 427 483  11],214,5,3064,4.123822341857335,60.0,0.0
10743,1,743,[174 185 286 168 238],417,3,3067,4.122311827956989,0.0,0.0
10744,1,744,[427  88 185 194 211],416,4,3071,4.122147651006712,0.0,0.0
10745,1,745,[ 64 483 427  12  11],214,5,3076,4.1233243967828415,60.0,0.0
10746,1,746,[269  12 357  11  98],805,4,3080,4.123159303882195,20.0,20.0
10747,1,747,[176 117   4 282  97],416,5,3085,4.124331550802139,0.0,0.0
10748,1,748,[200 655  15 211  79],417,4,3089,4.124165554072096,0.0,0.0
10749,1,749,[ 12  64 427 483  11],214,5,3094,4.125333333333334,60.0,0.0
10750,1,750,[111 228 185 258 196],417,2,3096,4.1225033288948065,0.0,0.0
10751,1,751,[ 12  64 427 483  11],214,5,3101,4.1236702127659575,60.0,0.0
10752,1,752,[ 12  64 427 483  11],618,5,3106,4.124833997343957,60.0,0.0
10753,1,753,[271 508 475 269   8],854,5,3111,4.125994694960212,0.0,0.0
10754,1,754,[ 12  64 427 483  11],214,5,3116,4.127152317880794,60.0,0.0
10755,1,755,[302 186 216  56 117],43,4,3120,4.126984126984127,0.0,0.0
10756,1,756,[ 12  64 427 483  11],214,5,3125,4.128137384412153,60.0,0.0
10757,1,757,[118  69  95 200 111],887,4,3129,4.127968337730871,0.0,0.0
10758,1,758,[ 50 191 176 234 475],437,3,3132,4.126482213438735,0.0,20.0
10759,1,759,[161  25 597 202 294],417,2,3134,4.123684210526315,0.0,0.0
10760,1,760,[ 64 427  12 483  11],618,5,3139,4.124835742444152,60.0,0.0
10761,1,761,[216 143  82 238 546],416,4,3143,4.124671916010499,0.0,0.0
10762,1,762,[ 64 427  12 483  11],618,5,3148,4.1258191349934465,60.0,0.0
10763,1,763,[588  79 471 181 135],373,2,3150,4.12303664921466,0.0,20.0
10764,1,764,[ 64 427  12 483  11],214,5,3155,4.124183006535947,60.0,0.0
10765,1,765,[597  96 211  11 257],417,2,3157,4.1214099216710185,0.0,0.0
10766,1,766,[ 64 427  12 483  11],214,5,3162,4.122555410691004,60.0,0.0
10767,1,767,[ 71 318 153 117  79],654,4,3166,4.122395833333333,20.0,0.0
10768,1,768,[180 238 127 427  97],24,5,3171,4.123537061118335,0.0,0.0
10769,1,769,[197 288 235 176 173],854,3,3174,4.1220779220779225,0.0,20.0
10770,1,770,[ 64 427 483  12  11],214,5,3179,4.123216601815823,60.0,0.0
10771,1,771,[ 64 427 483  12  11],618,5,3184,4.124352331606218,60.0,0.0
10772,1,772,[174 180 508 289 121],854,2,3186,4.121604139715394,0.0,0.0
10773,1,773,[180 111 568 269 185],711,3,3189,4.12015503875969,0.0,0.0
10774,1,774,[ 70 385 234   4  22],405,3,3192,4.118709677419355,0.0,0.0
10775,1,775,[ 64 427 483  12  11],618,5,3197,4.119845360824742,60.0,0.0
10776,1,776,[ 64 427 483  12  11],214,5,3202,4.120978120978121,60.0,0.0
10777,1,777,[265  11 176 286 200],416,5,3207,4.122107969151671,0.0,0.0
10778,1,778,[ 12 111 143 153 125],342,3,3210,4.120667522464698,20.0,0.0
10779,1,779,[204 197 195 117 216],618,1,3211,4.116666666666666,0.0,0.0
10780,1,780,[ 56 215 238 357 496],416,5,3216,4.117797695262484,0.0,0.0
10781,1,781,[496 475 173 121 181],437,3,3219,4.116368286445013,0.0,20.0
10782,1,782,[228 118  50 748 183],417,3,3222,4.114942528735632,0.0,20.0
10783,1,783,[121 273 132 117 216],253,4,3226,4.114795918367347,0.0,0.0
10784,1,784,[483 427  12  64  11],618,5,3231,4.115923566878981,60.0,0.0
10785,1,785,[483 427  12  64  11],214,5,3236,4.11704834605598,60.0,0.0
10786,1,786,[200  70  12 117 318],437,3,3239,4.115628970775095,40.0,0.0
10787,1,787,[483 427  12  64  11],214,5,3244,4.116751269035533,60.0,0.0
10788,1,788,[483 427  12  64  11],214,5,3249,4.11787072243346,60.0,0.0
10789,1,789,[483 427  12  64  11],214,5,3254,4.118987341772152,60.0,0.0
10790,1,790,[483 427  12  64  11],618,5,3259,4.120101137800253,60.0,0.0
10791,1,791,[483 427  12  64  11],214,5,3264,4.121212121212121,60.0,0.0
10792,1,792,[196 265 151 323  50],416,3,3267,4.1197982345523325,0.0,20.0
10793,1,793,[483 427  12  64  11],214,5,3272,4.120906801007557,60.0,0.0
10794,1,794,[423 215 175 238 546],297,2,3274,4.118238993710692,0.0,0.0
10795,1,795,[ 12  64 483 427  11],214,5,3279,4.119346733668341,60.0,0.0
10796,1,796,[294 194 475 117 423],416,4,3283,4.119196988707654,0.0,0.0
10797,1,797,[ 12  64 483 427  11],214,5,3288,4.120300751879699,60.0,0.0
10798,1,798,[117 269 179  97 405],416,4,3292,4.1201501877346685,0.0,0.0
10799,1,799,[427  12 483  64  11],618,5,3297,4.12125,60.0,0.0
10800,1,800,[427  12 483  64  11],618,5,3302,4.122347066167291,60.0,0.0
10801,1,801,[427  12 483  64  11],214,5,3307,4.123441396508728,60.0,0.0
10802,1,802,[427  12 483  64  11],618,5,3312,4.12453300124533,60.0,0.0
10803,1,803,[202 176 143 265 215],405,3,3315,4.123134328358209,0.0,0.0
10804,1,804,[483  64  12 427  11],214,5,3320,4.124223602484472,60.0,0.0
10805,1,805,[427 210   4  56  82],198,3,3323,4.122828784119107,0.0,0.0
10806,1,806,[121 195 427   8 196],601,1,3324,4.118959107806692,0.0,0.0
10807,1,807,[  1 546 475 288 185],416,3,3327,4.117574257425742,0.0,20.0
10808,1,808,[273 181   1 323  22],630,3,3330,4.116192830655129,0.0,20.0
10809,1,809,[ 12 427 483  64  11],214,5,3335,4.117283950617284,60.0,0.0
10810,1,810,[ 28 282   4 257 265],416,4,3339,4.117139334155364,0.0,0.0
10811,1,811,[483 427  12  64  11],214,5,3344,4.1182266009852215,60.0,0.0
10812,1,812,[238 237 181   8 191],618,3,3347,4.116851168511685,0.0,20.0
10813,1,813,[176 245 748 435 183],297,2,3349,4.114250614250614,0.0,0.0
10814,1,814,[ 64 427 483  12  11],214,5,3354,4.115337423312884,60.0,0.0
10815,1,815,[172 204  25  97 405],128,2,3356,4.112745098039215,0.0,0.0
10816,1,816,[483  12 427  64  11],618,5,3361,4.113831089351285,60.0,0.0
10817,1,817,[ 69 180 276  95 655],198,2,3363,4.111246943765281,0.0,0.0
10818,1,818,[483  12 427  64  11],618,5,3368,4.112332112332112,60.0,0.0
10819,1,819,[216 100   7 197 588],416,5,3373,4.113414634146341,0.0,0.0
10820,1,820,[483  12 427  64  11],618,5,3378,4.1144945188794155,60.0,0.0
10821,1,821,[483  12 427  64  11],214,5,3383,4.115571776155718,60.0,0.0
10822,1,822,[183 182 655 174   1],417,4,3387,4.11543134872418,0.0,0.0
10823,1,823,[ 15 216  88 143 471],588,5,3392,4.116504854368932,0.0,0.0
10824,1,824,[483  12 427  64  11],214,5,3397,4.117575757575757,60.0,0.0
10825,1,825,[ 50 496 276   8  22],654,4,3401,4.1174334140435835,0.0,20.0
10826,1,826,[ 56 475 185 265 135],417,2,3403,4.1148730350665055,0.0,0.0
10827,1,827,[483  64 427  12  11],618,5,3408,4.115942028985507,60.0,0.0
10828,1,828,[483  64 427  12  11],618,5,3413,4.117008443908324,60.0,0.0
10829,1,829,[483  64 427  12  11],214,5,3418,4.118072289156626,60.0,0.0
10830,1,830,[483  64 427  12  11],618,5,3423,4.11913357400722,60.0,0.0
10831,1,831,[185 748 276  97 121],437,3,3426,4.117788461538462,0.0,0.0
10832,1,832,[196 216  82 289 153],416,4,3430,4.117647058823529,0.0,0.0
10833,1,833,[ 98  95 210 183 200],405,2,3432,4.115107913669065,0.0,20.0
10834,1,834,[ 64 427 483  12  11],618,5,3437,4.116167664670659,60.0,0.0
10835,1,835,[ 64 427 483  12  11],618,5,3442,4.117224880382775,60.0,0.0
10836,1,836,[ 64 427 483  12  11],618,5,3447,4.118279569892473,60.0,0.0
10837,1,837,[ 64 427 483  12  11],618,5,3452,4.119331742243436,60.0,0.0
10838,1,838,[ 64 427 483  12  11],618,5,3457,4.120381406436233,60.0,0.0
10839,1,839,[ 64 427 483  12  11],618,5,3462,4.121428571428571,60.0,0.0
10840,1,840,[ 64 427 483  12  11],214,5,3467,4.122473246135553,60.0,0.0
10841,1,841,[ 64 427 483  12  11],618,5,3472,4.123515439429929,60.0,0.0
10842,1,842,[ 64 427 483  12  11],618,5,3477,4.124555160142349,60.0,0.0
10843,1,843,[ 64 427 483  12  11],214,5,3482,4.125592417061611,60.0,0.0
10844,1,844,[215 655 385 328 289],416,4,3486,4.125443786982249,0.0,0.0
10845,1,845,[237 174 294 286  50],416,4,3490,4.125295508274232,0.0,20.0
10846,1,846,[ 64 427 483  12  11],618,5,3495,4.126328217237308,60.0,0.0
10847,1,847,[742 286   1 180 200],417,4,3499,4.126179245283019,0.0,0.0
10848,1,848,[ 89 195 183 318 172],405,3,3502,4.124852767962309,20.0,0.0
10849,1,849,[483  12  64 427  11],618,5,3507,4.125882352941177,60.0,0.0
10850,1,850,[  1 588 143 168 125],618,4,3511,4.1257344300822565,0.0,0.0
10851,1,851,[483  12  64 427  11],618,5,3516,4.126760563380282,60.0,0.0
10852,1,852,[597 385 197 238 237],618,3,3519,4.125439624853458,0.0,0.0
10853,1,853,[483 427  12  64  11],618,5,3524,4.126463700234192,60.0,0.0
10854,1,854,[ 11 127 111 237 748],416,4,3528,4.126315789473685,0.0,0.0
10855,1,855,[483 427  64  12  11],618,5,3533,4.127336448598131,60.0,0.0
10856,1,856,[257 182 588 211 153],417,3,3536,4.1260210035005835,0.0,0.0
10857,1,857,[ 12  64 483 427  11],214,5,3541,4.127039627039627,60.0,0.0
10858,1,858,[196  56  79  95 117],43,5,3546,4.128055878928987,0.0,0.0
10859,1,859,[172 496 235   4 423],642,2,3548,4.125581395348838,0.0,0.0
10860,1,860,[318 183   7 117 204],618,4,3552,4.125435540069686,20.0,0.0
10861,1,861,[483  64 427  12  11],618,5,3557,4.126450116009281,60.0,0.0
10862,1,862,[678 300 286 268 258],721,3,3560,4.125144843568946,0.0,0.0
10863,1,863,[483  64 427  12  11],618,5,3565,4.126157407407407,60.0,0.0
10864,1,864,[143 234  95 132 176],437,4,3569,4.126011560693642,0.0,0.0
10865,1,865,[153 546 216 276 405],416,3,3572,4.124711316397229,0.0,0.0
10866,1,866,[153  79 211 318  71],43,5,3577,4.125720876585929,20.0,0.0
10867,1,867,[475 118  71 117   4],62,4,3581,4.125576036866359,0.0,0.0
10868,1,868,[ 64 427  12 483  11],618,5,3586,4.1265822784810124,60.0,0.0
10869,1,869,[ 64 427  12 483  11],618,5,3591,4.127586206896551,60.0,0.0
10870,1,870,[ 64 427  12 483  11],618,5,3596,4.128587830080368,60.0,0.0
10871,1,871,[ 64 427  12 483  11],214,5,3601,4.129587155963303,60.0,0.0
10872,1,872,[  4 237  22 403 132],642,3,3604,4.128293241695304,0.0,0.0
10873,1,873,[ 64 427  12 483  11],618,5,3609,4.12929061784897,60.0,0.0
10874,1,874,[ 64 427  12 483  11],618,5,3614,4.130285714285714,60.0,0.0
10875,1,875,[ 64 427  12 483  11],214,5,3619,4.1312785388127855,60.0,0.0
10876,1,876,[182 181 185  25 168],416,5,3624,4.1322690992018245,0.0,20.0
10877,1,877,[ 64 427  12 483  11],618,5,3629,4.133257403189066,60.0,0.0
10878,1,878,[  1  28  56  50 100],345,3,3632,4.131968145620022,0.0,20.0
10879,1,879,[ 96 568 173 475 176],805,4,3636,4.131818181818182,0.0,0.0
10880,1,880,[238 132 475 174  82],416,4,3640,4.131668558456299,0.0,0.0
10881,1,881,[ 64 483 427  12  11],214,5,3645,4.13265306122449,60.0,0.0
10882,1,882,[ 64 483 427  12  11],214,5,3650,4.133635334088336,60.0,0.0
10883,1,883,[ 64 483 427  12  11],618,5,3655,4.134615384615385,60.0,0.0
10884,1,884,[ 64 483 427  12  11],214,5,3660,4.135593220338983,60.0,0.0
10885,1,885,[ 98 161 186 234 385],230,4,3664,4.135440180586907,0.0,20.0
10886,1,886,[168  11 117 202 268],49,1,3665,4.131905298759865,0.0,0.0
10887,1,887,[197 216 300 238 118],297,2,3667,4.129504504504505,0.0,0.0
10888,1,888,[275   7 172 322 403],416,4,3671,4.129358830146232,0.0,0.0
10889,1,889,[ 12 483 427  64  11],214,5,3676,4.130337078651685,60.0,0.0
10890,1,890,[678  12   7 318  98],416,4,3680,4.130190796857463,40.0,20.0
10891,1,891,[100 597 678  97 173],588,2,3682,4.12780269058296,0.0,0.0
10892,1,892,[318 286 742  56 185],416,5,3687,4.128779395296752,20.0,0.0
10893,1,893,[ 12 483 427  64  11],214,5,3692,4.1297539149888145,60.0,0.0
10894,1,894,[ 12 483 427  64  11],214,5,3697,4.13072625698324,60.0,0.0
10895,1,895,[ 12 483 427  64  11],618,5,3702,4.131696428571429,60.0,0.0
10896,1,896,[ 12 483 427  64  11],618,5,3707,4.132664437012263,60.0,0.0
10897,1,897,[181 173 127 204 276],618,2,3709,4.130289532293987,0.0,20.0
10898,1,898,[ 12  64 483 427  11],618,5,3714,4.1312569521690765,60.0,0.0
10899,1,899,[ 12  64 483 427  11],618,5,3719,4.1322222222222225,60.0,0.0
10900,1,900,[276 742  96 179  79],416,3,3722,4.130965593784683,0.0,0.0
10901,1,901,[ 12  64 427 483  11],618,5,3727,4.131929046563193,60.0,0.0
10902,1,902,[211  56  22 200 196],297,4,3731,4.131782945736434,0.0,0.0
10903,1,903,[603 328 161 268 245],416,4,3735,4.131637168141593,0.0,0.0
10904,1,904,[471 403 210 742   1],588,4,3739,4.131491712707183,0.0,0.0
10905,1,905,[678 568 204 748  82],654,5,3744,4.132450331125828,0.0,0.0
10906,1,906,[276  12 161  88 423],618,4,3748,4.132304299889746,20.0,0.0
10907,1,907,[ 12 483  64 427  11],214,5,3753,4.133259911894273,60.0,0.0
10908,1,908,[173  95 161  97 215],405,2,3755,4.1309130913091305,0.0,0.0
10909,1,909,[ 12 483  64 427  11],214,5,3760,4.131868131868132,60.0,0.0
10910,1,910,[ 12 483  64 427  11],618,5,3765,4.132821075740944,60.0,0.0
10911,1,911,[ 12 483  64 427  11],214,5,3770,4.133771929824562,60.0,0.0
10912,1,912,[132 423 238   4 125],618,2,3772,4.131434830230011,0.0,0.0
10913,1,913,[ 12 483  64 427  11],618,5,3777,4.13238512035011,60.0,0.0
10914,1,914,[ 12 483  64 427  11],214,5,3782,4.133333333333334,60.0,0.0
10915,1,915,[ 22 385 216  88 186],642,4,3786,4.133187772925764,0.0,0.0
10916,1,916,[ 12 483  64 427  11],214,5,3791,4.134133042529989,60.0,0.0
10917,1,917,[176 678 100   9 588],416,4,3795,4.133986928104576,0.0,0.0
10918,1,918,[403 185 186 405 216],417,2,3797,4.131664853101197,0.0,0.0
10919,1,919,[483 427  64  12  11],618,5,3802,4.1326086956521735,60.0,0.0
10920,1,920,[210 597 588 483 403],618,4,3806,4.132464712269273,20.0,0.0
10921,1,921,[  4  11  89 385 300],198,2,3808,4.130151843817788,0.0,0.0
10922,1,922,[483 427  64  12  11],214,5,3813,4.131094257854821,60.0,0.0
10923,1,923,[483 427  64  12  11],214,5,3818,4.132034632034632,60.0,0.0
10924,1,924,[483 427  64  12  11],618,5,3823,4.132972972972973,60.0,0.0
10925,1,925,[483 427  64  12  11],618,5,3828,4.133909287257019,60.0,0.0
10926,1,926,[  9 546 271 144 180],62,3,3831,4.132686084142395,0.0,0.0
10927,1,927,[ 64  12 483 427  11],214,5,3836,4.133620689655173,60.0,0.0
10928,1,928,[ 64  12 483 427  11],214,5,3841,4.134553283100107,60.0,0.0
10929,1,929,[179  25 405 132 655],416,4,3845,4.134408602150538,0.0,0.0
10930,1,930,[ 98 568 313 318 294],345,4,3849,4.134264232008593,40.0,40.0
10931,1,931,[288  69 143 268  79],297,2,3851,4.131974248927039,0.0,20.0
10932,1,932,[ 12  69 194 172 496],373,5,3856,4.132904608788853,20.0,0.0
10933,1,933,[ 64  12 483 427  11],618,5,3861,4.1338329764453965,60.0,0.0
10934,1,934,[181 211 268 117 603],416,5,3866,4.13475935828877,0.0,20.0
10935,1,935,[276 228 588 405 357],601,3,3869,4.1335470085470085,0.0,0.0
10936,1,936,[196  28 127 423 597],618,5,3874,4.134471718249733,0.0,0.0
10937,1,937,[603 185 143 168  97],354,3,3877,4.133262260127932,0.0,0.0
10938,1,938,[ 64 427  12 483  11],214,5,3882,4.134185303514377,60.0,0.0
10939,1,939,[ 64 427  12 483  11],618,5,3887,4.135106382978724,60.0,0.0
10940,1,940,[238 655 216  82 117],805,1,3888,4.131774707757705,0.0,0.0
10941,1,941,[ 64 427  12 483  11],214,5,3893,4.132696390658174,60.0,0.0
10942,1,942,[ 64 427  12 483  11],618,5,3898,4.133616118769884,60.0,0.0
10943,1,943,[235  95 168 546 183],417,3,3901,4.132415254237288,0.0,0.0
10944,1,944,[175 322 333 475  22],854,2,3903,4.130158730158731,0.0,0.0
10945,1,945,[ 64 427  12 483  11],214,5,3908,4.13107822410148,60.0,0.0
10946,1,946,[496 597 202 127 742],417,2,3910,4.12882787750792,0.0,0.0
10947,1,947,[742 275 302  25 168],416,5,3915,4.129746835443038,0.0,0.0
10948,1,948,[ 64  12 483 427  11],214,5,3920,4.130663856691254,60.0,0.0
10949,1,949,[322 161 196  89  97],417,3,3923,4.129473684210526,0.0,0.0
10950,1,950,[ 12  64 483 427  11],214,5,3928,4.130389064143007,60.0,0.0
10951,1,951,[ 97 276 183 403  25],618,3,3931,4.129201680672269,0.0,0.0
10952,1,952,[ 56 222 143 117 121],128,3,3934,4.128016789087093,0.0,0.0
10953,1,953,[276 257  71 286  22],416,3,3937,4.126834381551363,0.0,0.0
10954,1,954,[268 288   7  69 328],314,5,3942,4.127748691099477,0.0,20.0
10955,1,955,[ 64  12 483 427  11],618,5,3947,4.128661087866109,60.0,0.0
10956,1,956,[196 294 181  95 132],679,3,3950,4.12748171368861,0.0,20.0
10957,1,957,[ 64  12 483 427  11],618,5,3955,4.12839248434238,60.0,0.0
10958,1,958,[ 64  12 483 427  11],214,5,3960,4.129301355578728,60.0,0.0
10959,1,959,[ 64  12 483 427  11],618,5,3965,4.130208333333333,60.0,0.0
10960,1,960,[483   4 168 200 195],854,3,3968,4.129032258064516,20.0,0.0
10961,1,961,[ 64  12 483 427  11],618,5,3973,4.12993762993763,60.0,0.0
10962,1,962,[204 282 313 678 742],345,3,3976,4.128764278296988,20.0,20.0
10963,1,963,[471   7 195 588 180],887,4,3980,4.128630705394191,0.0,0.0
10964,1,964,[403 318  69  79 173],345,4,3984,4.128497409326425,20.0,0.0
10965,1,965,[245 202  64 405 423],642,2,3986,4.126293995859213,20.0,0.0
10966,1,966,[ 98 200 257 143  56],297,3,3989,4.125129265770424,0.0,20.0
10967,1,967,[187 265  88 135 186],373,3,3992,4.12396694214876,0.0,0.0
10968,1,968,[ 12  64 483 427  11],214,5,3997,4.124871001031992,60.0,0.0
10969,1,969,[ 71  95  22 185 173],416,4,4001,4.124742268041237,0.0,0.0
10970,1,970,[ 64 135 144 181 222],711,3,4004,4.123583934088568,20.0,20.0
10971,1,971,[174 385  82 245 405],642,4,4008,4.1234567901234565,0.0,0.0
10972,1,972,[ 12  64 483 427  11],214,5,4013,4.124357656731758,60.0,0.0
10973,1,973,[423  28  70  95   4],43,5,4018,4.125256673511293,0.0,0.0
10974,1,974,[215 125 235 144 181],416,4,4022,4.125128205128205,0.0,20.0
10975,1,975,[191  95 181 475  50],805,3,4025,4.123975409836065,0.0,40.0
10976,1,976,[ 12  64 483 427  11],618,5,4030,4.1248720573183215,60.0,0.0
10977,1,977,[196 403  97 568  79],43,5,4035,4.125766871165644,0.0,0.0
10978,1,978,[483  64  12 427  11],618,5,4040,4.126659856996936,60.0,0.0
10979,1,979,[318 300  64  82 742],43,5,4045,4.127551020408164,40.0,0.0
10980,1,980,[483  64  12 427  11],214,5,4050,4.128440366972477,60.0,0.0
10981,1,981,[318 496 268 179 568],416,4,4054,4.128309572301426,20.0,0.0
10982,1,982,[ 56 405 215   9 258],43,5,4059,4.129196337741607,0.0,0.0
10983,1,983,[ 64  12 427 483  11],214,5,4064,4.130081300813008,60.0,0.0
10984,1,984,[ 64  12 427 483  11],214,5,4069,4.130964467005076,60.0,0.0
10985,1,985,[202  69 153   4 423],417,3,4072,4.129817444219067,0.0,0.0
10986,1,986,[357 238 173 258 175],198,4,4076,4.12968591691996,0.0,0.0
10987,1,987,[483  12 427  64  11],214,5,4081,4.130566801619433,60.0,0.0
10988,1,988,[168   7 258  64 471],416,5,4086,4.131445904954499,20.0,0.0
10989,1,989,[483 427  64  12  11],618,5,4091,4.132323232323232,60.0,0.0
10990,1,990,[568  82 318   7 204],198,2,4093,4.130171543895056,20.0,0.0
10991,1,991,[483 427  64  12  11],618,5,4098,4.131048387096774,60.0,0.0
10992,1,992,[483 427  64  12  11],618,5,4103,4.131923464249748,60.0,0.0
10993,1,993,[483 427  64  12  11],618,5,4108,4.132796780684105,60.0,0.0
10994,1,994,[483 427  64  12  11],618,5,4113,4.1336683417085425,60.0,0.0
10995,1,995,[185 211 175 678   1],297,3,4116,4.132530120481928,0.0,0.0
10996,1,996,[153 508 546 257 597],654,4,4120,4.132397191574724,0.0,0.0
10997,1,997,[  1 185  82  50 216],417,2,4122,4.130260521042084,0.0,20.0
10998,1,998,[182  96 238 168 111],417,3,4125,4.129129129129129,0.0,0.0
10999,1,999,[117 423  95 202 268],314,5,4130,4.13,0.0,0.0
11000,1,1000,[  8 202 288 174  97],416,5,4135,4.130869130869131,0.0,20.0
11001,1,1001,[ 15 588 179  69 153],601,2,4137,4.12874251497006,0.0,0.0
11002,1,1002,[597 328   1  70  15],314,4,4141,4.128614157527418,0.0,0.0
11003,1,1003,[200 202 385 405 588],345,2,4143,4.126494023904383,0.0,0.0
11004,1,1004,[ 22 197  12 423 195],854,3,4146,4.125373134328358,20.0,0.0
11005,1,1005,[ 64  12 427 483  11],214,5,4151,4.1262425447316105,60.0,0.0
11006,1,1006,[153 194 288 282 269],416,5,4156,4.127110228401191,0.0,20.0
11007,1,1007,[ 64  12 427 483  11],214,5,4161,4.127976190476191,60.0,0.0
11008,1,1008,[ 11 288 245  64 273],416,4,4165,4.12784935579782,20.0,20.0
11009,1,1009,[483  64  12 427  11],618,5,4170,4.128712871287129,60.0,0.0
11010,1,1010,[ 11 282 182 173 179],416,4,4174,4.128585558852621,0.0,0.0
11011,1,1011,[135  12 427  22  98],214,3,4177,4.127470355731226,20.0,20.0
11012,1,1012,[216 111  15 117 200],417,3,4180,4.126357354392892,0.0,0.0
11013,1,1013,[423  25  12 151 357],416,4,4184,4.126232741617357,20.0,0.0
11014,1,1014,[ 64  12 427 483  11],214,5,4189,4.1270935960591135,60.0,0.0
11015,1,1015,[ 64  12 427 483  11],214,5,4194,4.127952755905512,60.0,0.0
11016,1,1016,[ 89 276 275  50 294],214,1,4195,4.12487708947886,0.0,20.0
11017,1,1017,[117 269 100 153 286],297,5,4200,4.12573673870334,0.0,0.0
11018,1,1018,[ 64  12 427 483  11],214,5,4205,4.126594700686948,60.0,0.0
11019,1,1019,[ 64  12 427 483  11],618,5,4210,4.127450980392157,60.0,0.0
11020,1,1020,[ 64  12 427 483  11],214,5,4215,4.128305582761998,60.0,0.0
11021,1,1021,[216 245 423  96  28],642,3,4218,4.12720156555773,0.0,0.0
11022,1,1022,[ 64  12 427 483  11],214,5,4223,4.128054740957967,60.0,0.0
11023,1,1023,[181 475 318 235  69],416,3,4226,4.126953125,20.0,20.0
11024,1,1024,[ 64  12 427 483  11],618,5,4231,4.127804878048781,60.0,0.0
11025,1,1025,[475   4 151 265 153],416,3,4234,4.1267056530214425,0.0,0.0
11026,1,1026,[ 64 427 483  12  11],618,5,4239,4.127555988315482,60.0,0.0
11027,1,1027,[168 257 588  50 172],601,3,4242,4.126459143968872,0.0,20.0
11028,1,1028,[ 22 328 603 143 161],373,4,4246,4.126336248785228,0.0,0.0
11029,1,1029,[ 95 174 258 385  12],49,1,4247,4.123300970873786,20.0,0.0
11030,1,1030,[496 117   1  82 508],417,3,4250,4.122211445198836,0.0,0.0
11031,1,1031,[  8 173 127 161  97],721,5,4255,4.123062015503876,0.0,0.0
11032,1,1032,[ 12 427  64 483  11],214,5,4260,4.1239109390125845,60.0,0.0
11033,1,1033,[ 12 427  64 483  11],618,5,4265,4.124758220502901,60.0,0.0
11034,1,1034,[ 12 427  64 483  11],618,5,4270,4.125603864734299,60.0,0.0
11035,1,1035,[173   9  64 496 269],43,5,4275,4.126447876447877,20.0,0.0
11036,1,1036,[ 12 427  64 483  11],618,5,4280,4.127290260366442,60.0,0.0
11037,1,1037,[265 144 200 143 202],437,3,4283,4.126204238921002,0.0,0.0
11038,1,1038,[ 70 742  82 117 118],62,2,4285,4.124157844080847,0.0,0.0
11039,1,1039,[132  95 237 258   7],505,2,4287,4.122115384615385,0.0,0.0
11040,1,1040,[ 28 323 174 508 302],345,3,4290,4.121037463976945,0.0,0.0
11041,1,1041,[483 427  64  12  11],618,5,4295,4.121880998080615,60.0,0.0
11042,1,1042,[ 69 288 173 568 269],214,2,4297,4.1198465963566635,0.0,20.0
11043,1,1043,[483  64  12 427  11],618,5,4302,4.120689655172414,60.0,0.0
11044,1,1044,[483  64  12 427  11],618,5,4307,4.121531100478469,60.0,0.0
11045,1,1045,[301 200 237 286 176],297,4,4311,4.121414913957935,0.0,0.0
11046,1,1046,[427 483  64  12  11],618,5,4316,4.12225405921681,60.0,0.0
11047,1,1047,[ 89 427 183 151  15],705,0,4316,4.1183206106870225,0.0,0.0
11048,1,1048,[483  64  12 427  11],214,5,4321,4.119161105815062,60.0,0.0
11049,1,1049,[483  64  12 427  11],618,5,4326,4.12,60.0,0.0
11050,1,1050,[483  64  12 427  11],214,5,4331,4.120837297811608,60.0,0.0
11051,1,1051,[118  89 222 151 302],854,3,4334,4.119771863117871,0.0,0.0
11052,1,1052,[ 12  64 483 427  11],618,5,4339,4.120607787274454,60.0,0.0
11053,1,1053,[ 12  64 483 427  11],618,5,4344,4.121442125237191,60.0,0.0
11054,1,1054,[ 25   4 216   9 121],805,1,4345,4.118483412322274,0.0,0.0
11055,1,1055,[195 151 210 161 197],618,1,4346,4.115530303030303,0.0,0.0
11056,1,1056,[ 12 483  64 427  11],214,5,4351,4.1163670766319775,60.0,0.0
11057,1,1057,[ 12 483  64 427  11],618,5,4356,4.117202268431002,60.0,0.0
11058,1,1058,[ 69  98 151 183  11],922,3,4359,4.11614730878187,0.0,20.0
11059,1,1059,[ 22  95 678 215  97],297,2,4361,4.1141509433962264,0.0,0.0
11060,1,1060,[174 210 300 328 742],128,2,4363,4.112158341187559,0.0,0.0
11061,1,1061,[483  64  12 427  11],618,5,4368,4.112994350282486,60.0,0.0
11062,1,1062,[153 333 195 125 180],854,2,4370,4.111006585136407,0.0,0.0
11063,1,1063,[  4  50 118 176 597],854,1,4371,4.1080827067669174,0.0,20.0
11064,1,1064,[508  15   8 357 318],601,3,4374,4.107042253521127,20.0,0.0
11065,1,1065,[ 12  64 483 427  11],214,5,4379,4.107879924953096,60.0,0.0
11066,1,1066,[ 12  64 483 427  11],618,5,4384,4.108716026241799,60.0,0.0
11067,1,1067,[237 183 475 471 235],297,3,4387,4.107677902621723,0.0,0.0
11068,1,1068,[204 328 323 273  82],416,4,4391,4.107577174929841,0.0,0.0
11069,1,1069,[ 70  69 588 508 191],128,4,4395,4.107476635514018,0.0,0.0
11070,1,1070,[237  15 196 117 181],43,5,4400,4.1083099906629315,0.0,20.0
11071,1,1071,[ 12 483  64 427  11],214,5,4405,4.1091417910447765,60.0,0.0
11072,1,1072,[423   1 234  79 174],417,3,4408,4.108108108108108,0.0,0.0
11073,1,1073,[ 12  64 483 427  11],214,5,4413,4.108938547486034,60.0,0.0
11074,1,1074,[197  50 268 301 471],297,3,4416,4.107906976744186,0.0,20.0
11075,1,1075,[194  95 496 237 168],416,3,4419,4.106877323420075,0.0,0.0
11076,1,1076,[568 328  15  96  88],373,5,4424,4.107706592386258,0.0,0.0
11077,1,1077,[ 12 483  64 427  11],618,5,4429,4.108534322820037,60.0,0.0
11078,1,1078,[ 12 483  64 427  11],618,5,4434,4.109360518999074,60.0,0.0
11079,1,1079,[ 12 483  64 427  11],618,5,4439,4.110185185185185,60.0,0.0
11080,1,1080,[  8 100 237 117 318],253,5,4444,4.111008325624422,20.0,0.0
11081,1,1081,[144 172  28 238  95],654,5,4449,4.111829944547135,0.0,0.0
11082,1,1082,[655 286 161 117 475],416,4,4453,4.111726685133887,0.0,0.0
11083,1,1083,[202 496 197 318  88],618,3,4456,4.11070110701107,20.0,0.0
11084,1,1084,[427 202  69 127 742],416,5,4461,4.111520737327189,0.0,0.0
11085,1,1085,[ 64  12 483 427  11],214,5,4466,4.112338858195212,60.0,0.0
11086,1,1086,[286  50 403  96 179],417,3,4469,4.111315547378105,0.0,20.0
11087,1,1087,[185   4  12 191  70],416,5,4474,4.112132352941177,20.0,0.0
11088,1,1088,[ 64  12 483 427  11],214,5,4479,4.112947658402204,60.0,0.0
11089,1,1089,[197 211 403 275 286],373,2,4481,4.111009174311927,0.0,0.0
11090,1,1090,[210 172 222 508 323],417,0,4481,4.10724106324473,0.0,0.0
11091,1,1091,[ 64  12 483 427  11],214,5,4486,4.108058608058608,60.0,0.0
11092,1,1092,[ 64  12 483 427  11],214,5,4491,4.108874656907593,60.0,0.0
11093,1,1093,[228 202  89 678  25],805,3,4494,4.107861060329068,0.0,0.0
11094,1,1094,[403 568 211  79 172],405,4,4498,4.107762557077626,0.0,0.0
11095,1,1095,[ 82  98  96 385 183],505,4,4502,4.107664233576642,0.0,20.0
11096,1,1096,[204  15 282  12 483],618,2,4504,4.105742935278031,40.0,0.0
11097,1,1097,[118 405 127  15  95],198,1,4505,4.102914389799635,0.0,0.0
11098,1,1098,[172  15  50  98 121],630,2,4507,4.101000909918107,0.0,40.0
11099,1,1099,[ 64 183 268 197 603],416,5,4512,4.101818181818182,20.0,0.0
11100,1,1100,[483  64  12 427  11],214,5,4517,4.102633969118982,60.0,0.0
11101,1,1101,[483  64  12 427  11],618,5,4522,4.103448275862069,60.0,0.0
11102,1,1102,[185  28  12 515 588],297,5,4527,4.104261106074342,20.0,0.0
11103,1,1103,[ 64 483  12 427  11],214,5,4532,4.105072463768116,60.0,0.0
11104,1,1104,[  1 235 153 183 210],297,3,4535,4.104072398190045,0.0,0.0
11105,1,1105,[ 64 483  12 427  11],618,5,4540,4.104882459312839,60.0,0.0
11106,1,1106,[181  12  28 318 172],405,5,4545,4.105691056910569,40.0,20.0
11107,1,1107,[191 179 200 258 143],416,4,4549,4.105595667870036,0.0,0.0
11108,1,1108,[ 64 483  12 427  11],618,5,4554,4.106402164111812,60.0,0.0
11109,1,1109,[ 64 483  12 427  11],214,5,4559,4.107207207207207,60.0,0.0
11110,1,1110,[ 22  82 174  28  64],262,2,4561,4.105310531053106,20.0,0.0
11111,1,1111,[ 64 483  12 427  11],618,5,4566,4.106115107913669,60.0,0.0
11112,1,1112,[ 28  56 161 143 257],43,5,4571,4.1069182389937104,0.0,0.0
11113,1,1113,[ 64 483  12 427  11],214,5,4576,4.1077199281867145,60.0,0.0
11114,1,1114,[ 64 483  12 427  11],214,5,4581,4.1085201793721975,60.0,0.0
11115,1,1115,[127 181  11  70 182],405,3,4584,4.10752688172043,0.0,20.0
11116,1,1116,[276 496 143 238 197],342,4,4588,4.107430617726052,0.0,0.0
11117,1,1117,[  8 151 117 301 132],588,5,4593,4.108228980322004,0.0,0.0
11118,1,1118,[ 64 483  12 427  11],618,5,4598,4.109025915996425,60.0,0.0
11119,1,1119,[ 64 483  12 427  11],214,5,4603,4.109821428571428,60.0,0.0
11120,1,1120,[603  56 288 300 357],297,3,4606,4.108831400535236,0.0,20.0
11121,1,1121,[172 323 322 179 405],805,3,4609,4.107843137254902,0.0,0.0
11122,1,1122,[ 64 483  12 427  11],618,5,4614,4.108637577916296,60.0,0.0
11123,1,1123,[  4  22 185 333 302],854,1,4615,4.105871886120997,0.0,0.0
11124,1,1124,[483  64  12 427  11],214,5,4620,4.1066666666666665,60.0,0.0
11125,1,1125,[483  64  12 427  11],618,5,4625,4.107460035523979,60.0,0.0
11126,1,1126,[118 182 257 603 265],416,3,4628,4.106477373558119,0.0,0.0
11127,1,1127,[202 568  50 191  96],405,4,4632,4.1063829787234045,0.0,20.0
11128,1,1128,[ 64 483  12 427  11],214,5,4637,4.107174490699734,60.0,0.0
11129,1,1129,[117 111 181 318 151],618,3,4640,4.106194690265487,20.0,20.0
11130,1,1130,[202 153  64  25 294],230,4,4644,4.106100795755968,20.0,0.0
11131,1,1131,[195 238 427 132  98],601,2,4646,4.104240282685512,0.0,20.0
11132,1,1132,[ 64 483  12 427  11],618,5,4651,4.105030891438658,60.0,0.0
11133,1,1133,[135 286 313  88   9],354,1,4652,4.102292768959436,20.0,20.0
11134,1,1134,[742 318  22  12 191],416,5,4657,4.1030837004405285,40.0,0.0
11135,1,1135,[238 132  88  28  56],618,4,4661,4.102992957746479,0.0,0.0
11136,1,1136,[ 64 483  12 427  11],618,5,4666,4.103781882145999,60.0,0.0
11137,1,1137,[ 98 322 269  28 196],805,2,4668,4.101933216168717,0.0,20.0
11138,1,1138,[211  97 185 143  50],405,3,4671,4.100965759438104,0.0,20.0
11139,1,1139,[ 89  50  96 181 183],698,3,4674,4.1,0.0,40.0
11140,1,1140,[216 237 185 588 471],297,4,4678,4.099912357581069,0.0,0.0
11141,1,1141,[483  12  64 427  11],214,5,4683,4.100700525394045,60.0,0.0
11142,1,1142,[ 95 161 179 496 276],416,2,4685,4.0988626421697285,0.0,0.0
11143,1,1143,[ 64  12 483 427  11],618,5,4690,4.09965034965035,60.0,0.0
11144,1,1144,[ 64  12 483 427  11],618,5,4695,4.100436681222708,60.0,0.0
11145,1,1145,[118  88 245 211 265],416,2,4697,4.098603839441536,0.0,0.0
11146,1,1146,[ 56 168 603 568 302],751,4,4701,4.0985178727114215,0.0,0.0
11147,1,1147,[483  12  64 427  11],214,5,4706,4.099303135888502,60.0,0.0
11148,1,1148,[ 28 302  97 121 210],62,2,4708,4.097476066144473,0.0,0.0
11149,1,1149,[180 748 403 228 143],805,1,4709,4.0947826086956525,0.0,0.0
11150,1,1150,[483  64  12 427  11],618,5,4714,4.095569070373588,60.0,0.0
11151,1,1151,[483  64  12 427  11],618,5,4719,4.096354166666667,60.0,0.0
11152,1,1152,[200 204 258  96 210],262,2,4721,4.094535993061578,0.0,0.0
11153,1,1153,[ 69  82 275  71 294],921,3,4724,4.093587521663778,0.0,0.0
11154,1,1154,[427 235  88  28 322],416,2,4726,4.091774891774892,0.0,0.0
11155,1,1155,[ 11 238 300 144 168],416,5,4731,4.092560553633218,0.0,0.0
11156,1,1156,[ 28  56  70 117 173],642,4,4735,4.092480553154711,0.0,0.0
11157,1,1157,[ 12  64 483 427  11],214,5,4740,4.0932642487046635,60.0,0.0
11158,1,1158,[ 12  64 483 427  11],214,5,4745,4.09404659188956,60.0,0.0
11159,1,1159,[286 748 275 238  70],416,5,4750,4.094827586206897,0.0,0.0
11160,1,1160,[483  12  64 427  11],214,5,4755,4.095607235142118,60.0,0.0
11161,1,1161,[483  12  64 427  11],214,5,4760,4.096385542168675,60.0,0.0
11162,1,1162,[ 22 176 678 143 288],416,4,4764,4.096302665520207,0.0,20.0
11163,1,1163,[483  12  64 427  11],618,5,4769,4.097079037800687,60.0,0.0
11164,1,1164,[423  96 216 385 275],618,2,4771,4.095278969957081,0.0,0.0
11165,1,1165,[423 546 257 215 132],62,2,4773,4.093481989708405,0.0,0.0
11166,1,1166,[302 204 568 195 168],405,4,4777,4.093401885175664,0.0,0.0
11167,1,1167,[ 12 483  64 427  11],618,5,4782,4.094178082191781,60.0,0.0
11168,1,1168,[269 268 257  12 235],854,2,4784,4.092386655260907,20.0,0.0
11169,1,1169,[135 300 153 176 185],198,3,4787,4.091452991452991,0.0,0.0
11170,1,1170,[ 12 483  64 427  11],214,5,4792,4.092228864218616,60.0,0.0
11171,1,1171,[ 12 180 100  82   8],62,5,4797,4.093003412969283,20.0,0.0
11172,1,1172,[ 12 483  64 427  11],618,5,4802,4.093776641091219,60.0,0.0
11173,1,1173,[191 302 742 210 655],417,2,4804,4.091993185689949,0.0,0.0
11174,1,1174,[ 12 483  64 427  11],618,5,4809,4.092765957446809,60.0,0.0
11175,1,1175,[ 12 483  64 427  11],214,5,4814,4.093537414965986,60.0,0.0
11176,1,1176,[ 71   9 237 269 294],43,5,4819,4.094307561597281,0.0,0.0
11177,1,1177,[  1 234 151 172 403],588,4,4823,4.094227504244482,0.0,0.0
11178,1,1178,[ 12 483  64 427  11],214,5,4828,4.0949957591178965,60.0,0.0
11179,1,1179,[ 12 483  64 427  11],214,5,4833,4.095762711864407,60.0,0.0
11180,1,1180,[ 12 483  64 427  11],214,5,4838,4.096528365791702,60.0,0.0
11181,1,1181,[ 12 483  64 427  11],618,5,4843,4.0972927241962775,60.0,0.0
11182,1,1182,[ 12 483  64 427  11],618,5,4848,4.098055790363483,60.0,0.0
11183,1,1183,[ 12 483  64 427  11],214,5,4853,4.0988175675675675,60.0,0.0
11184,1,1184,[202 174 211 588 182],297,3,4856,4.09789029535865,0.0,0.0
11185,1,1185,[ 12 483  64 427  11],214,5,4861,4.098650927487353,60.0,0.0
11186,1,1186,[176 318 546 427 748],416,4,4865,4.098567818028644,20.0,0.0
11187,1,1187,[483  12  64 427  11],214,5,4870,4.0993265993265995,60.0,0.0
11188,1,1188,[483  12  64 427  11],214,5,4875,4.100084104289318,60.0,0.0
11189,1,1189,[483  12  64 427  11],618,5,4880,4.100840336134453,60.0,0.0
11190,1,1190,[174  71 117 182 181],198,3,4883,4.099916036943744,0.0,20.0
11191,1,1191,[483  12  64 427  11],214,5,4888,4.100671140939597,60.0,0.0
11192,1,1192,[483  12  64 427  11],214,5,4893,4.101424979044426,60.0,0.0
11193,1,1193,[568  70 423 161  64],405,3,4896,4.100502512562814,20.0,0.0
11194,1,1194,[161 191  22  88 153],373,5,4901,4.101255230125523,0.0,0.0
11195,1,1195,[483  12  64 427  11],214,5,4906,4.10200668896321,60.0,0.0
11196,1,1196,[471 238 216 323  79],345,3,4909,4.101086048454469,0.0,0.0
11197,1,1197,[483  12  64 427  11],214,5,4914,4.101836393989983,60.0,0.0
11198,1,1198,[ 95 111   4 475 300],49,1,4915,4.099249374478732,0.0,0.0
11199,1,1199,[483  12  64 427  11],618,5,4920,4.1,60.0,0.0
11200,1,1200,[202 423  12 197 588],297,2,4922,4.098251457119067,20.0,0.0
11201,1,1201,[483  12  64 427  11],214,5,4927,4.099001663893511,60.0,0.0
11202,1,1202,[483  12  64 427  11],214,5,4932,4.0997506234413965,60.0,0.0
11203,1,1203,[111 333 471 143 655],588,3,4935,4.098837209302325,0.0,0.0
11204,1,1204,[222 172 238   1  25],43,4,4939,4.098755186721991,0.0,0.0
11205,1,1205,[483  64  12 427  11],618,5,4944,4.099502487562189,60.0,0.0
11206,1,1206,[483  64  12 427  11],214,5,4949,4.100248550124275,60.0,0.0
11207,1,1207,[483  64  12 427  11],618,5,4954,4.1009933774834435,60.0,0.0
11208,1,1208,[273  22 275 318  56],62,5,4959,4.101736972704715,20.0,0.0
11209,1,1209,[483  64  12 427  11],618,5,4964,4.102479338842975,60.0,0.0
11210,1,1210,[288 181 168  22  98],601,3,4967,4.101568951279934,0.0,60.0
11211,1,1211,[483  64  12 427  11],214,5,4972,4.102310231023102,60.0,0.0
11212,1,1212,[483  64  12 427  11],618,5,4977,4.103050288540808,60.0,0.0
11213,1,1213,[483  64  12 427  11],214,5,4982,4.1037891268533775,60.0,0.0
11214,1,1214,[483  64  12 427  11],618,5,4987,4.104526748971193,60.0,0.0
11215,1,1215,[483  64  12 427  11],214,5,4992,4.105263157894737,60.0,0.0
11216,1,1216,[300 423  15 237 265],416,4,4996,4.105176663927691,0.0,0.0
11217,1,1217,[483  64  12 427  11],618,5,5001,4.105911330049261,60.0,0.0
11218,1,1218,[273 210 268 483   1],417,3,5004,4.105004101722724,20.0,0.0
11219,1,1219,[483  64  12 427  11],214,5,5009,4.105737704918033,60.0,0.0
11220,1,1220,[483  64  12 427  11],214,5,5014,4.106470106470106,60.0,0.0
11221,1,1221,[197 200 403 588 742],345,3,5017,4.10556464811784,0.0,0.0
11222,1,1222,[ 50 153 403  11 235],922,3,5020,4.104660670482421,0.0,20.0
11223,1,1223,[483  64  12 427  11],214,5,5025,4.105392156862745,60.0,0.0
11224,1,1224,[483  64  12 427  11],214,5,5030,4.106122448979592,60.0,0.0
11225,1,1225,[187 117  70  28 423],416,5,5035,4.1068515497553015,0.0,0.0
11226,1,1226,[568 183 174  71   4],416,5,5040,4.10757946210269,0.0,0.0
11227,1,1227,[ 56 168 210  11 496],417,3,5043,4.106677524429967,0.0,0.0
11228,1,1228,[483  64  12 427  11],618,5,5048,4.10740439381611,60.0,0.0
11229,1,1229,[483  64  12 427  11],618,5,5053,4.108130081300813,60.0,0.0
11230,1,1230,[483  64  12 427  11],214,5,5058,4.1088545897644195,60.0,0.0
11231,1,1231,[483  64  12 427  11],214,5,5063,4.109577922077922,60.0,0.0
11232,1,1232,[191 181 172 275 265],128,4,5067,4.109489051094891,0.0,20.0
11233,1,1233,[483  64  12 427  11],214,5,5072,4.110210696920584,60.0,0.0
11234,1,1234,[483  64  12 427  11],618,5,5077,4.110931174089068,60.0,0.0
11235,1,1235,[ 12 118 135  96  25],805,4,5081,4.11084142394822,20.0,0.0
11236,1,1236,[ 95 294 258 173 196],654,4,5085,4.110751818916734,0.0,0.0
11237,1,1237,[546 127 357 475 496],417,3,5088,4.109854604200323,0.0,0.0
11238,1,1238,[483  64  12 427  11],618,5,5093,4.110573042776433,60.0,0.0
11239,1,1239,[151  97  22 127 357],62,4,5097,4.110483870967742,0.0,0.0
11240,1,1240,[257 423 211 173 496],698,1,5098,4.107977437550363,0.0,0.0
11241,1,1241,[282 125  70 742 597],764,4,5102,4.107890499194847,0.0,0.0
11242,1,1242,[496 176 742  70 301],416,5,5107,4.108608205953339,0.0,0.0
11243,1,1243,[273  89 117 237 245],764,4,5111,4.108520900321543,0.0,0.0
11244,1,1244,[ 64 483  12 427  11],618,5,5116,4.109236947791165,60.0,0.0
11245,1,1245,[301  97 748 265 173],437,2,5118,4.107544141252006,0.0,0.0
11246,1,1246,[ 64 483  12 427  11],214,5,5123,4.108259823576584,60.0,0.0
11247,1,1247,[ 64 483  12 427  11],214,5,5128,4.108974358974359,60.0,0.0
11248,1,1248,[742   7  11 423 268],416,5,5133,4.10968775020016,0.0,0.0
11249,1,1249,[ 64 483  12 427  11],214,5,5138,4.1104,60.0,0.0
11250,1,1250,[427  70  97 318  28],373,3,5141,4.10951239008793,20.0,0.0
11251,1,1251,[ 64 483  12 427  11],618,5,5146,4.110223642172524,60.0,0.0
11252,1,1252,[ 64 483  12 427  11],618,5,5151,4.110933758978452,60.0,0.0
11253,1,1253,[ 97 176 121 265 318],618,5,5156,4.11164274322169,20.0,0.0
11254,1,1254,[118 197 211 117  88],416,3,5159,4.110756972111554,0.0,0.0
11255,1,1255,[302 195 174 127   8],416,5,5164,4.111464968152866,0.0,0.0
11256,1,1256,[483  64  12 427  11],214,5,5169,4.11217183770883,60.0,0.0
11257,1,1257,[215 195 300 275 132],416,5,5174,4.112877583465819,0.0,0.0
11258,1,1258,[322 748 161 117 655],416,4,5178,4.112787926926132,0.0,0.0
11259,1,1259,[161 200 118 117  95],437,2,5180,4.111111111111111,0.0,0.0
11260,1,1260,[483  64  12 427  11],618,5,5185,4.1118160190325135,60.0,0.0
11261,1,1261,[483  64  12 427  11],214,5,5190,4.112519809825674,60.0,0.0
11262,1,1262,[173 385 597 195 228],417,3,5193,4.111638954869359,0.0,0.0
11263,1,1263,[483  64  12 427  11],214,5,5198,4.112341772151899,60.0,0.0
11264,1,1264,[483  64  12 427  11],214,5,5203,4.113043478260869,60.0,0.0
11265,1,1265,[483  64  12 427  11],618,5,5208,4.113744075829384,60.0,0.0
11266,1,1266,[403 215  15 405  28],416,5,5213,4.114443567482241,0.0,0.0
11267,1,1267,[483  64  12 427  11],618,5,5218,4.115141955835962,60.0,0.0
11268,1,1268,[ 69 322 268  50 215],416,4,5222,4.1150512214342,0.0,20.0
11269,1,1269,[268  88 245 748 427],416,3,5225,4.1141732283464565,0.0,0.0
11270,1,1270,[117 258 483 655 385],417,5,5230,4.1148701809598744,20.0,0.0
11271,1,1271,[405  71  95 151 300],416,3,5233,4.113993710691824,0.0,0.0
11272,1,1272,[483  64  12 427  11],214,5,5238,4.114689709347997,60.0,0.0
11273,1,1273,[132 289 181 197 588],416,4,5242,4.114599686028257,0.0,20.0
11274,1,1274,[ 89 318 258   7 403],198,5,5247,4.115294117647059,20.0,0.0
11275,1,1275,[588 215 678 111 235],297,1,5248,4.112852664576803,0.0,0.0
11276,1,1276,[245 257 588 143  88],642,5,5253,4.113547376664056,0.0,0.0
11277,1,1277,[483  64  12 427  11],618,5,5258,4.114241001564945,60.0,0.0
11278,1,1278,[ 98 117 318 173 333],416,5,5263,4.114933541829554,20.0,20.0
11279,1,1279,[322  98 168   4  28],416,4,5267,4.11484375,0.0,20.0
11280,1,1280,[483  64  12 427  11],618,5,5272,4.115534738485558,60.0,0.0
11281,1,1281,[483  64  12 427  11],618,5,5277,4.116224648985959,60.0,0.0
11282,1,1282,[483  64  12 427  11],618,5,5282,4.116913484021824,60.0,0.0
11283,1,1283,[483  64  12 427  11],214,5,5287,4.117601246105919,60.0,0.0
11284,1,1284,[294 228  50 405 357],601,3,5290,4.116731517509727,0.0,20.0
11285,1,1285,[191 100 202 655 568],805,2,5292,4.115085536547434,0.0,0.0
11286,1,1286,[483  64  12 427  11],618,5,5297,4.115773115773115,60.0,0.0
11287,1,1287,[483  64  12 427  11],618,5,5302,4.116459627329193,60.0,0.0
11288,1,1288,[318 294 323 183  71],416,4,5306,4.116369278510473,20.0,0.0
11289,1,1289,[483  64  12 427  11],618,5,5311,4.117054263565891,60.0,0.0
11290,1,1290,[117  70 300   4 185],416,5,5316,4.117738187451588,0.0,0.0
11291,1,1291,[328 483 258 204 405],128,3,5319,4.11687306501548,20.0,0.0
11292,1,1292,[301 234 588 508 237],297,4,5323,4.116782675947409,0.0,0.0
11293,1,1293,[143 197 568  28 403],618,4,5327,4.116692426584235,0.0,0.0
11294,1,1294,[ 12 483  64 427  11],618,5,5332,4.117374517374517,60.0,0.0
11295,1,1295,[ 12 483  64 427  11],214,5,5337,4.118055555555555,60.0,0.0
11296,1,1296,[118  69 508 179 186],601,3,5340,4.117193523515806,0.0,0.0
11297,1,1297,[257  79  50  97 191],711,4,5344,4.117103235747304,0.0,20.0
11298,1,1298,[ 12 483  64 427  11],618,5,5349,4.117782909930716,60.0,0.0
11299,1,1299,[ 12 483  64 427  11],214,5,5354,4.118461538461538,60.0,0.0
11300,1,1300,[ 12 483  64 427  11],214,5,5359,4.119139123750961,60.0,0.0
11301,1,1301,[603  82 216 175 271],805,2,5361,4.117511520737327,0.0,0.0
11302,1,1302,[237 195   1  71 423],416,4,5365,4.117421335379893,0.0,0.0
11303,1,1303,[ 64  12 483 427  11],214,5,5370,4.118098159509202,60.0,0.0
11304,1,1304,[174  22 215 288 197],618,3,5373,4.117241379310345,0.0,20.0
11305,1,1305,[ 64  12 483 427  11],618,5,5378,4.11791730474732,60.0,0.0
11306,1,1306,[ 64  12 483 427  11],214,5,5383,4.118592195868401,60.0,0.0
11307,1,1307,[ 95 202  64 238   8],711,5,5388,4.1192660550458715,20.0,0.0
11308,1,1308,[ 64  12 483 427  11],618,5,5393,4.119938884644767,60.0,0.0
11309,1,1309,[357 173  97   7 191],416,5,5398,4.120610687022901,0.0,0.0
11310,1,1310,[483  12  64 427  11],618,5,5403,4.121281464530893,60.0,0.0
11311,1,1311,[313 215 197   9  64],618,3,5406,4.120426829268292,40.0,20.0
11312,1,1312,[483  12  64 427  11],618,5,5411,4.121096725057121,60.0,0.0
11313,1,1313,[483  12  64 427  11],618,5,5416,4.121765601217656,60.0,0.0
11314,1,1314,[161  64 301 121 117],345,3,5419,4.120912547528517,20.0,0.0
11315,1,1315,[483  12  64 427  11],214,5,5424,4.121580547112462,60.0,0.0
11316,1,1316,[435 273 238 135 748],297,3,5427,4.120728929384966,0.0,0.0
11317,1,1317,[183 181  95 588  70],297,4,5431,4.120637329286798,0.0,20.0
11318,1,1318,[496 143 258 172 588],601,3,5434,4.1197877179681575,0.0,0.0
11319,1,1319,[ 25  97 265 181 125],588,3,5437,4.118939393939394,0.0,20.0
11320,1,1320,[ 12  64 483 427  11],214,5,5442,4.119606358819077,60.0,0.0
11321,1,1321,[ 12  64 483 427  11],214,5,5447,4.120272314674735,60.0,0.0
11322,1,1322,[176 117 181  56   4],805,2,5449,4.118669690098262,0.0,20.0
11323,1,1323,[ 12 483  64 427  11],214,5,5454,4.119335347432024,60.0,0.0
11324,1,1324,[ 12 483  64 427  11],618,5,5459,4.12,60.0,0.0
11325,1,1325,[  9  89 655 288 286],62,2,5461,4.1184012066365,0.0,20.0
11326,1,1326,[  8 215 313 588 237],588,4,5465,4.118311981914092,20.0,20.0
11327,1,1327,[125 127 294  70 180],62,3,5468,4.117469879518072,0.0,0.0
11328,1,1328,[196 258 301 183 603],297,5,5473,4.118133935289691,0.0,0.0
11329,1,1329,[ 12 483  64 427  11],618,5,5478,4.118796992481203,60.0,0.0
11330,1,1330,[ 12 483  64 427  11],214,5,5483,4.119459053343351,60.0,0.0
11331,1,1331,[423   8   1 174  97],654,4,5487,4.11936936936937,0.0,0.0
11332,1,1332,[ 12 483  64 427  11],214,5,5492,4.120030007501875,60.0,0.0
11333,1,1333,[ 12 483  64 427  11],214,5,5497,4.120689655172414,60.0,0.0
11334,1,1334,[210  82 508 294  70],62,3,5500,4.119850187265918,0.0,0.0
11335,1,1335,[ 12 483  64 427  11],214,5,5505,4.120508982035928,60.0,0.0
11336,1,1336,[ 12 483  64 427  11],618,5,5510,4.121166791323859,60.0,0.0
11337,1,1337,[ 12 483  64 427  11],618,5,5515,4.121823617339312,60.0,0.0
11338,1,1338,[ 12 483  64 427  11],214,5,5520,4.122479462285288,60.0,0.0
11339,1,1339,[ 95 403  98  89  82],198,3,5523,4.121641791044776,0.0,20.0
11340,1,1340,[ 12 483  64 427  11],214,5,5528,4.122296793437733,60.0,0.0
11341,1,1341,[301 179 313 151 181],49,2,5530,4.120715350223547,20.0,40.0
11342,1,1342,[143   9 195 269 111],805,1,5531,4.118391660461653,0.0,0.0
11343,1,1343,[117 288  95   7 333],416,4,5535,4.118303571428571,0.0,20.0
11344,1,1344,[176  97 187 323 603],416,4,5539,4.118215613382899,0.0,0.0
11345,1,1345,[176 603 200  96 144],805,4,5543,4.118127786032689,0.0,0.0
11346,1,1346,[ 12 483  64 427  11],618,5,5548,4.118782479584262,60.0,0.0
11347,1,1347,[202  70   7 100 185],417,2,5550,4.117210682492582,0.0,0.0
11348,1,1348,[ 12 483  64 427  11],214,5,5555,4.117865085248332,60.0,0.0
11349,1,1349,[323  15 294  69 125],345,2,5557,4.116296296296296,0.0,0.0
11350,1,1350,[568 143 172  95  69],198,2,5559,4.114729829755737,0.0,0.0
11351,1,1351,[118  96 275 144 237],618,2,5561,4.113165680473373,0.0,0.0
11352,1,1352,[483  12  64 427  11],618,5,5566,4.1138211382113825,60.0,0.0
11353,1,1353,[483  12  64 427  11],214,5,5571,4.114475627769572,60.0,0.0
11354,1,1354,[483  12  64 427  11],214,5,5576,4.115129151291513,60.0,0.0
11355,1,1355,[ 22  28 258 111 202],805,0,5576,4.112094395280236,0.0,0.0
11356,1,1356,[275 222  71   7  28],588,2,5578,4.110537951363302,0.0,0.0
11357,1,1357,[211 228 322  69 173],417,2,5580,4.108983799705449,0.0,0.0
11358,1,1358,[ 12 483  64 427  11],214,5,5585,4.109639440765268,60.0,0.0
11359,1,1359,[  9 588 151  64 196],345,4,5589,4.109558823529412,20.0,0.0
11360,1,1360,[ 12 483  64 427  11],214,5,5594,4.110213078618663,60.0,0.0
11361,1,1361,[ 12 483  64 427  11],618,5,5599,4.110866372980911,60.0,0.0
11362,1,1362,[294 179 168 111   4],416,4,5603,4.110785033015407,0.0,0.0
11363,1,1363,[405 237 174 121 210],128,4,5607,4.110703812316715,0.0,0.0
11364,1,1364,[ 12 483  64 427  11],214,5,5612,4.111355311355311,60.0,0.0
11365,1,1365,[ 12 483  64 427  11],618,5,5617,4.112005856515373,60.0,0.0
11366,1,1366,[313  15 125 268 121],907,5,5622,4.112655449890271,20.0,20.0
11367,1,1367,[121 655 185  96 161],198,2,5624,4.111111111111111,0.0,0.0
11368,1,1368,[ 12 483  64 427  11],214,5,5629,4.111760409057706,60.0,0.0
11369,1,1369,[186 427 318   1 187],198,5,5634,4.112408759124087,20.0,0.0
11370,1,1370,[179   8 143 194  22],416,4,5638,4.112326768781911,0.0,0.0
11371,1,1371,[496 111 234 385 100],618,4,5642,4.112244897959184,0.0,0.0
11372,1,1372,[ 12 483  64 427  11],618,5,5647,4.112891478514203,60.0,0.0
11373,1,1373,[ 12 483  64 427  11],618,5,5652,4.11353711790393,60.0,0.0
11374,1,1374,[483 172 185 268 125],417,3,5655,4.112727272727272,20.0,0.0
11375,1,1375,[289 302 269 288 211],416,4,5659,4.1126453488372094,0.0,20.0
11376,1,1376,[ 12  64 483 427  11],618,5,5664,4.113289760348584,60.0,0.0
11377,1,1377,[ 12  64 483 427  11],214,5,5669,4.113933236574746,60.0,0.0
11378,1,1378,[302 135 237 200 275],854,3,5672,4.113125453226976,0.0,0.0
11379,1,1379,[ 12  64 483 427  11],618,5,5677,4.113768115942029,60.0,0.0
11380,1,1380,[ 82 176 475 568 118],198,2,5679,4.112237509051412,0.0,0.0
11381,1,1381,[ 70 286 265  98 144],437,1,5680,4.109985528219971,0.0,20.0
11382,1,1382,[ 64 483  12 427  11],618,5,5685,4.110629067245119,60.0,0.0
11383,1,1383,[100 475 302 237 286],416,3,5688,4.109826589595376,0.0,0.0
11384,1,1384,[215 161 276  50 117],128,4,5692,4.109747292418772,0.0,20.0
11385,1,1385,[210  56 403  95 588],43,5,5697,4.1103896103896105,0.0,0.0
11386,1,1386,[151 748 323  28 100],416,3,5700,4.109589041095891,0.0,0.0
11387,1,1387,[ 64 483  12 427  11],618,5,5705,4.110230547550432,60.0,0.0
11388,1,1388,[ 64 483  12 427  11],618,5,5710,4.110871130309575,60.0,0.0
11389,1,1389,[182  98  97 185 357],198,3,5713,4.1100719424460435,0.0,20.0
11390,1,1390,[597 427 238   7   8],618,3,5716,4.109273903666427,0.0,0.0
11391,1,1391,[ 12 483  64 427  11],214,5,5721,4.109913793103448,60.0,0.0
11392,1,1392,[ 12 483  64 427  11],618,5,5726,4.110552763819095,60.0,0.0
11393,1,1393,[ 12 483  64 427  11],214,5,5731,4.111190817790531,60.0,0.0
11394,1,1394,[172 186 318 258 276],198,4,5735,4.111111111111111,20.0,0.0
11395,1,1395,[ 12 483  64 427  11],618,5,5740,4.111747851002866,60.0,0.0
11396,1,1396,[ 15   8  25  22 546],416,4,5744,4.111667859699356,0.0,0.0
11397,1,1397,[288 234 161 132 125],417,3,5747,4.1108726752503575,0.0,20.0
11398,1,1398,[194 185 153 588 265],297,3,5750,4.110078627591137,0.0,0.0
11399,1,1399,[ 12 483  64 427  11],618,5,5755,4.110714285714286,60.0,0.0
11400,1,1400,[ 12 483  64 427  11],214,5,5760,4.1113490364025695,60.0,0.0
11401,1,1401,[ 12 483  64 427  11],214,5,5765,4.111982881597718,60.0,0.0
11402,1,1402,[ 12 483  64 427  11],214,5,5770,4.112615823235923,60.0,0.0
11403,1,1403,[678 144  82 515  11],416,4,5774,4.112535612535613,0.0,0.0
11404,1,1404,[135  97  50 257  28],297,4,5778,4.112455516014235,0.0,20.0
11405,1,1405,[ 64  12 483 427  11],618,5,5783,4.113086770981508,60.0,0.0
11406,1,1406,[ 64  12 483 427  11],214,5,5788,4.113717128642501,60.0,0.0
11407,1,1407,[258 143 313 333 204],345,4,5792,4.113636363636363,20.0,20.0
11408,1,1408,[269 405 471 385 655],345,3,5795,4.112845990063875,0.0,0.0
11409,1,1409,[ 64  12 483 427  11],214,5,5800,4.113475177304965,60.0,0.0
11410,1,1410,[ 64  12 483 427  11],214,5,5805,4.114103472714387,60.0,0.0
11411,1,1411,[216 186 202 181  11],618,3,5808,4.113314447592068,0.0,20.0
11412,1,1412,[597 194 268 100   8],416,4,5812,4.113234253361642,0.0,0.0
11413,1,1413,[ 64  12 483 427  11],618,5,5817,4.1138613861386135,60.0,0.0
11414,1,1414,[423 748 168  82 185],416,5,5822,4.114487632508834,0.0,0.0
11415,1,1415,[ 64  12 483 427  11],618,5,5827,4.115112994350283,60.0,0.0
11416,1,1416,[153 121  95 238  98],751,4,5831,4.115031757233592,0.0,20.0
11417,1,1417,[ 95 234 174 257 118],642,3,5834,4.114245416078984,0.0,0.0
11418,1,1418,[268  28 603 265 475],297,4,5838,4.114164904862579,0.0,0.0
11419,1,1419,[172 191 173 135 111],618,3,5841,4.113380281690141,0.0,0.0
11420,1,1420,[  9  15 237 483 132],618,3,5844,4.112596762843069,20.0,0.0
11421,1,1421,[ 12  64 483 427  11],618,5,5849,4.113220815752461,60.0,0.0
11422,1,1422,[496 191  22 300 257],416,4,5853,4.113141250878426,0.0,0.0
11423,1,1423,[175 228 161 568 655],198,1,5854,4.110955056179775,0.0,0.0
11424,1,1424,[ 12 483  64 427  11],214,5,5859,4.111578947368421,60.0,0.0
11425,1,1425,[496 678 187 168 546],416,3,5862,4.110799438990182,0.0,0.0
11426,1,1426,[179  69  50 144 127],373,2,5864,4.109320252277505,0.0,20.0
11427,1,1427,[ 12 483  64 427  11],214,5,5869,4.109943977591036,60.0,0.0
11428,1,1428,[234  56 111   4 194],416,5,5874,4.110566829951015,0.0,0.0
11429,1,1429,[200  11 655 238 153],417,5,5879,4.1111888111888115,0.0,0.0
11430,1,1430,[ 12 483  64 427  11],214,5,5884,4.111809923130678,60.0,0.0
11431,1,1431,[ 12 483  64 427  11],214,5,5889,4.112430167597766,60.0,0.0
11432,1,1432,[132  50  15 588 276],416,4,5893,4.11235170969993,0.0,20.0
11433,1,1433,[ 12 483  64 427  11],618,5,5898,4.112970711297071,60.0,0.0
11434,1,1434,[ 12 483  64 427  11],214,5,5903,4.113588850174216,60.0,0.0
11435,1,1435,[257 117 197 678 125],416,3,5906,4.112813370473537,0.0,0.0
11436,1,1436,[276 202 121  71 496],416,4,5910,4.112734864300626,0.0,0.0
11437,1,1437,[313  64 204  56   8],642,5,5915,4.113351877607789,40.0,20.0
11438,1,1438,[153 294 204 100 118],62,2,5917,4.1118832522585125,0.0,0.0
11439,1,1439,[161 121   8 275 132],711,4,5921,4.111805555555556,0.0,0.0
11440,1,1440,[ 12 483  64 427  11],618,5,5926,4.112421929215822,60.0,0.0
11441,1,1441,[174   7  79 483 215],618,5,5931,4.113037447988904,20.0,0.0
11442,1,1442,[568 174 288 216 475],214,4,5935,4.112959112959113,0.0,20.0
11443,1,1443,[276 111 181 172 153],62,4,5939,4.112880886426593,0.0,20.0
11444,1,1444,[235  25 121   7 204],416,4,5943,4.11280276816609,0.0,0.0
11445,1,1445,[121  56 204 202  11],230,4,5947,4.112724757952973,0.0,0.0
11446,1,1446,[ 69  11 117 742 174],416,5,5952,4.11333794056669,0.0,0.0
11447,1,1447,[ 12  64 483 427  11],214,5,5957,4.113950276243094,60.0,0.0
11448,1,1448,[ 12  64 483 427  11],214,5,5962,4.1145617667356795,60.0,0.0
11449,1,1449,[ 12  64 483 427  11],214,5,5967,4.115172413793103,60.0,0.0
11450,1,1450,[ 12  64 483 427  11],214,5,5972,4.1157822191592,60.0,0.0
11451,1,1451,[268 282 245  12 568],345,3,5975,4.115013774104683,20.0,0.0
11452,1,1452,[ 96 423   7 153   1],262,3,5978,4.11424638678596,0.0,0.0
11453,1,1453,[ 64 483  12 427  11],618,5,5983,4.114855570839064,60.0,0.0
11454,1,1454,[ 64 483  12 427  11],214,5,5988,4.115463917525773,60.0,0.0
11455,1,1455,[ 70 286  25  71 597],416,4,5992,4.115384615384615,0.0,0.0
11456,1,1456,[  8 385 597 235 471],887,3,5995,4.11461908030199,0.0,0.0
11457,1,1457,[ 12 483  64 427  11],214,5,6000,4.11522633744856,60.0,0.0
11458,1,1458,[ 15  88 100 132 333],416,4,6004,4.115147361206306,0.0,0.0
11459,1,1459,[ 12 483  64 427  11],618,5,6009,4.115753424657535,60.0,0.0
11460,1,1460,[179 273 161 403  11],805,2,6011,4.114305270362765,0.0,0.0
11461,1,1461,[  8 423 111 172 275],654,5,6016,4.114911080711354,0.0,0.0
11462,1,1462,[ 12 483  64 427  11],618,5,6021,4.115516062884484,60.0,0.0
11463,1,1463,[174 471 237 282 176],297,3,6024,4.114754098360656,0.0,0.0
11464,1,1464,[ 12 483  64 427  11],618,5,6029,4.115358361774744,60.0,0.0
11465,1,1465,[215 496 118  88 174],618,4,6033,4.115279672578445,0.0,0.0
11466,1,1466,[216 265 127 168 176],198,4,6037,4.1152010906612135,0.0,0.0
11467,1,1467,[ 69  22 588  97 185],618,5,6042,4.115803814713897,0.0,0.0
11468,1,1468,[ 12 483  64 427  11],214,5,6047,4.1164057181756295,60.0,0.0
11469,1,1469,[153 258 215 323  82],198,3,6050,4.115646258503402,0.0,0.0
11470,1,1470,[302 168 237 196 328],62,2,6052,4.1142080217539085,0.0,0.0
11471,1,1471,[117 202 100  25 183],805,3,6055,4.1134510869565215,0.0,0.0
11472,1,1472,[121 174 173 282 151],128,2,6057,4.112016293279022,0.0,0.0
11473,1,1473,[ 12 483  64 427  11],214,5,6062,4.112618724559023,60.0,0.0
11474,1,1474,[483 179 655  12  70],437,4,6066,4.1125423728813555,40.0,0.0
11475,1,1475,[302 286  70 176  64],416,5,6071,4.113143631436315,20.0,0.0
11476,1,1476,[ 50 568 423 273 153],62,3,6074,4.112389979688558,0.0,20.0
11477,1,1477,[ 12 483  64 427  11],214,5,6079,4.112990527740189,60.0,0.0
11478,1,1478,[ 12 483  64 427  11],618,5,6084,4.113590263691684,60.0,0.0
11479,1,1479,[153 300  56 143 268],654,4,6088,4.113513513513514,0.0,0.0
11480,1,1480,[ 12 483  64 427  11],214,5,6093,4.114112086428089,60.0,0.0
11481,1,1481,[475 603 118 357 202],297,3,6096,4.113360323886639,0.0,0.0
11482,1,1482,[  1 318 294 313 385],642,4,6100,4.11328388401888,40.0,20.0
11483,1,1483,[483  12  64 427  11],618,5,6105,4.113881401617251,60.0,0.0
11484,1,1484,[151 748 288   1  71],654,3,6108,4.113131313131313,0.0,20.0
11485,1,1485,[483  12  64 427  11],214,5,6113,4.113728129205922,60.0,0.0
11486,1,1486,[234 181 546 258  82],805,1,6114,4.11163416274378,0.0,20.0
11487,1,1487,[174 210 318 597 215],416,4,6118,4.111559139784946,20.0,0.0
11488,1,1488,[181 313 265 288 194],416,5,6123,4.112155809267965,20.0,60.0
11489,1,1489,[  1  70 257  98  71],62,2,6125,4.110738255033557,0.0,20.0
11490,1,1490,[  7 202 258  22 135],297,4,6129,4.110663983903421,0.0,0.0
11491,1,1491,[483  12  64 427  11],214,5,6134,4.111260053619303,60.0,0.0
11492,1,1492,[300 228 111 286 118],297,1,6135,4.109176155391829,0.0,0.0
11493,1,1493,[301 200 333 471 118],345,2,6137,4.107764390896921,0.0,0.0
11494,1,1494,[211   4 179 385 202],417,4,6141,4.107692307692307,0.0,0.0
11495,1,1495,[204  56  12 235 222],43,4,6145,4.107620320855615,20.0,0.0
11496,1,1496,[483  12  64 427  11],214,5,6150,4.108216432865731,60.0,0.0
11497,1,1497,[483  12  64 427  11],618,5,6155,4.108811748998665,60.0,0.0
11498,1,1498,[286  11 181 228 191],297,3,6158,4.108072048032021,0.0,20.0
11499,1,1499,[100 235 258  79  82],805,2,6160,4.1066666666666665,0.0,0.0
11500,1,1500,[268 294 151 588 111],417,3,6163,4.105929380413058,0.0,0.0
11501,1,1501,[300  79  22 333  50],416,5,6168,4.1065246338215715,0.0,20.0
11502,1,1502,[ 28 655   8 181 191],705,2,6170,4.105123087159015,0.0,20.0
11503,1,1503,[ 64 294   7 202 185],230,4,6174,4.105053191489362,20.0,0.0
11504,1,1504,[ 82  22 215 121  15],416,5,6179,4.105647840531561,0.0,0.0
11505,1,1505,[427 282 568 258 496],416,5,6184,4.106241699867198,0.0,0.0
11506,1,1506,[268 182 151   1  89],297,2,6186,4.104844061048441,0.0,0.0
11507,1,1507,[202 186 588  50 405],230,5,6191,4.105437665782493,0.0,20.0
11508,1,1508,[180 288 118 182 183],62,3,6194,4.104705102717031,0.0,20.0
11509,1,1509,[273 135 268 111 405],854,3,6197,4.103973509933775,0.0,0.0
11510,1,1510,[174 568 237 282 204],416,4,6201,4.103904698874917,0.0,0.0
11511,1,1511,[ 12  64 483 427  11],618,5,6206,4.104497354497354,60.0,0.0
11512,1,1512,[216 357 100 176 403],417,3,6209,4.103767349636484,0.0,0.0
11513,1,1513,[  7 186 135 143 276],618,4,6213,4.103698811096433,0.0,0.0
11514,1,1514,[318 302 181  50 194],405,4,6217,4.103630363036304,20.0,40.0
11515,1,1515,[ 12  64 483 427  11],618,5,6222,4.104221635883905,60.0,0.0
11516,1,1516,[ 12  64 483 427  11],214,5,6227,4.104812129202373,60.0,0.0
11517,1,1517,[  7 333   1 265 328],416,5,6232,4.105401844532279,0.0,0.0
11518,1,1518,[483  12  64 427  11],214,5,6237,4.105990783410138,60.0,0.0
11519,1,1519,[111 357 475  96 405],805,3,6240,4.105263157894737,0.0,0.0
11520,1,1520,[483  12  64 427  11],618,5,6245,4.105851413543721,60.0,0.0
11521,1,1521,[ 70 174 268 238  97],354,3,6248,4.105124835742444,0.0,0.0
11522,1,1522,[471 423 269  98 313],43,4,6252,4.1050558108995405,20.0,40.0
11523,1,1523,[ 12  64 483 427  11],214,5,6257,4.1056430446194225,60.0,0.0
11524,1,1524,[748 172 179 423 197],805,3,6260,4.104918032786885,0.0,0.0
11525,1,1525,[275  71 427 568 194],373,5,6265,4.105504587155964,0.0,0.0
11526,1,1526,[127  98 173 161 748],416,5,6270,4.106090373280943,0.0,20.0
11527,1,1527,[161 172   1  70  25],751,3,6273,4.105366492146596,0.0,0.0
11528,1,1528,[216 143 655  89 318],198,4,6277,4.105297580117724,20.0,0.0
11529,1,1529,[313 117 286 742 588],43,5,6282,4.105882352941176,20.0,20.0
11530,1,1530,[ 12  64 483 427  11],214,5,6287,4.106466361854997,60.0,0.0
11531,1,1531,[172 546 275 302   7],62,4,6291,4.106396866840731,0.0,0.0
11532,1,1532,[ 64 483  12 427  11],214,5,6296,4.106979778212655,60.0,0.0
11533,1,1533,[ 11 117   8  56 427],24,5,6301,4.107561929595828,0.0,0.0
11534,1,1534,[ 64 483  12 427  11],214,5,6306,4.10814332247557,60.0,0.0
11535,1,1535,[588 215  15  71 181],588,5,6311,4.108723958333333,0.0,20.0
11536,1,1536,[ 56 273 118  95   7],618,3,6314,4.108002602472348,0.0,0.0
11537,1,1537,[ 64 483  12 427  11],618,5,6319,4.108582574772432,60.0,0.0
11538,1,1538,[357  50  25 174 215],198,4,6323,4.108512020792722,0.0,20.0
11539,1,1539,[ 64  12 483 427  11],618,5,6328,4.109090909090909,60.0,0.0
11540,1,1540,[ 56 172 153 496 748],437,5,6333,4.109669046073978,0.0,0.0
11541,1,1541,[286 258 294 204 111],297,2,6335,4.1083009079118025,0.0,0.0
11542,1,1542,[655 175  96  79 603],373,4,6339,4.108230719377835,0.0,0.0
11543,1,1543,[ 12 483  64 427  11],214,5,6344,4.108808290155441,60.0,0.0
11544,1,1544,[289  25 357  69 180],24,4,6348,4.1087378640776695,0.0,0.0
11545,1,1545,[483  12  64 427  11],618,5,6353,4.109314359637775,60.0,0.0
11546,1,1546,[ 69 275 151   8 215],416,4,6357,4.109243697478991,0.0,0.0
11547,1,1547,[ 15 222 276  82 655],128,3,6360,4.108527131782946,0.0,0.0
11548,1,1548,[238 403 237 151 276],416,2,6362,4.107165913492576,0.0,0.0
11549,1,1549,[ 22 289 117 300 194],416,4,6366,4.107096774193549,0.0,0.0
11550,1,1550,[483  64  12 427  11],618,5,6371,4.107672469374597,60.0,0.0
11551,1,1551,[483  64  12 427  11],618,5,6376,4.108247422680412,60.0,0.0
11552,1,1552,[183  50  95  25 294],297,3,6379,4.107533805537669,0.0,20.0
11553,1,1553,[125 588 196 172 496],230,5,6384,4.108108108108108,0.0,0.0
11554,1,1554,[483  64  12 427  11],618,5,6389,4.108681672025724,60.0,0.0
11555,1,1555,[204  56 301 202 435],297,2,6391,4.1073264781491,0.0,0.0
11556,1,1556,[483  64  12 427  11],214,5,6396,4.107899807321773,60.0,0.0
11557,1,1557,[483  64  12 427  11],214,5,6401,4.108472400513479,60.0,0.0
11558,1,1558,[180  11 288 235 385],417,3,6404,4.107761385503528,0.0,20.0
11559,1,1559,[483  64  12 427  11],214,5,6409,4.108333333333333,60.0,0.0
11560,1,1560,[483  64  12 427  11],618,5,6414,4.108904548366432,60.0,0.0
11561,1,1561,[483  64  12 427  11],214,5,6419,4.109475032010243,60.0,0.0
11562,1,1562,[  1 174 135 423   9],62,3,6422,4.108765195137556,0.0,0.0
11563,1,1563,[483  64  12 427  11],214,5,6427,4.109335038363171,60.0,0.0
11564,1,1564,[483  64  12 427  11],618,5,6432,4.109904153354632,60.0,0.0
11565,1,1565,[483  64  12 427  11],214,5,6437,4.110472541507025,60.0,0.0
11566,1,1566,[323 161 132 181 655],416,4,6441,4.110402042118698,0.0,20.0
11567,1,1567,[195 117 118 603 515],297,3,6444,4.10969387755102,0.0,0.0
11568,1,1568,[483  64  12 427  11],214,5,6449,4.110261312938177,60.0,0.0
11569,1,1569,[ 98  88 151 268 245],128,2,6451,4.10891719745223,0.0,20.0
11570,1,1570,[127  15 172 153 100],373,3,6454,4.108211330362826,0.0,0.0
11571,1,1571,[ 64  12 483 427  11],618,5,6459,4.108778625954199,60.0,0.0
11572,1,1572,[ 64  12 483 427  11],618,5,6464,4.109345200254291,60.0,0.0
11573,1,1573,[ 88 143 515  64 197],416,4,6468,4.109275730622618,20.0,0.0
11574,1,1574,[ 12  64 483 427  11],214,5,6473,4.10984126984127,60.0,0.0
11575,1,1575,[294 200 181 196 748],416,5,6478,4.1104060913705585,0.0,20.0
11576,1,1576,[ 12  64 483 427  11],214,5,6483,4.110970196575777,60.0,0.0
11577,1,1577,[215 286 143 202  25],297,3,6486,4.110266159695818,0.0,0.0
11578,1,1578,[121  69 172 180 318],198,3,6489,4.109563014566181,20.0,0.0
11579,1,1579,[ 12  64 483 427  11],214,5,6494,4.110126582278481,60.0,0.0
11580,1,1580,[ 12  64 483 427  11],214,5,6499,4.110689437065148,60.0,0.0
11581,1,1581,[100 143 301 258  71],49,1,6500,4.108723135271807,0.0,0.0
11582,1,1582,[ 12  64 483 427  11],618,5,6505,4.109286165508528,60.0,0.0
11583,1,1583,[202 597 153 603 121],805,2,6507,4.107954545454546,0.0,0.0
11584,1,1584,[273 655 748 185 268],417,3,6510,4.107255520504732,0.0,0.0
11585,1,1585,[ 12  64 483 427  11],618,5,6515,4.107818411097099,60.0,0.0
11586,1,1586,[174 302 180 195 508],417,2,6517,4.106490233144298,0.0,0.0
11587,1,1587,[ 12  64 483 427  11],618,5,6522,4.107052896725441,60.0,0.0
11588,1,1588,[  1 237 508  97  79],297,3,6525,4.106356198867212,0.0,0.0
11589,1,1589,[135 515  97 222 200],297,4,6529,4.106289308176101,0.0,0.0
11590,1,1590,[ 12  64 483 427  11],214,5,6534,4.106851037083596,60.0,0.0
11591,1,1591,[ 12  64 483 427  11],214,5,6539,4.107412060301508,60.0,0.0
11592,1,1592,[ 12  64 483 427  11],214,5,6544,4.10797237915882,60.0,0.0
11593,1,1593,[ 12  64 483 427  11],214,5,6549,4.108531994981179,60.0,0.0
11594,1,1594,[271  56 603 202 172],805,3,6552,4.107836990595612,0.0,0.0
11595,1,1595,[655  88 210 268 294],416,4,6556,4.1077694235588975,0.0,0.0
11596,1,1596,[  7 427 185 257 216],214,4,6560,4.107701941139637,0.0,0.0
11597,1,1597,[ 12  64 483 427  11],618,5,6565,4.108260325406758,60.0,0.0
11598,1,1598,[ 12  64 483 427  11],618,5,6570,4.108818011257036,60.0,0.0
11599,1,1599,[ 12  64 483 427  11],618,5,6575,4.109375,60.0,0.0
11600,1,1600,[ 12  64 483 427  11],618,5,6580,4.109931292941911,60.0,0.0
11601,1,1601,[ 12  64 483 427  11],618,5,6585,4.110486891385768,60.0,0.0
11602,1,1602,[183 588  28   8 196],805,1,6586,4.108546475358702,0.0,0.0
11603,1,1603,[ 12  64 483 427  11],618,5,6591,4.109102244389027,60.0,0.0
11604,1,1604,[748 125  15 237 153],721,2,6593,4.10778816199377,0.0,0.0
11605,1,1605,[ 12  64 483 427  11],214,5,6598,4.108343711083437,60.0,0.0
11606,1,1606,[435  50 235 215 546],297,1,6599,4.106409458618544,0.0,20.0
11607,1,1607,[ 12  64 483 427  11],214,5,6604,4.106965174129353,60.0,0.0
11608,1,1608,[655 568 161  79   7],618,5,6609,4.107520198881293,0.0,0.0
11609,1,1609,[ 12  64 483 427  11],214,5,6614,4.10807453416149,60.0,0.0
11610,1,1610,[ 12  64 483 427  11],618,5,6619,4.10862818125388,60.0,0.0
11611,1,1611,[ 12  64 483 427  11],618,5,6624,4.109181141439206,60.0,0.0
11612,1,1612,[ 12  64 483 427  11],214,5,6629,4.1097334159950405,60.0,0.0
11613,1,1613,[271 234 195 475  98],805,3,6632,4.1090458488228006,0.0,20.0
11614,1,1614,[ 12  64 483 427  11],214,5,6637,4.109597523219814,60.0,0.0
11615,1,1615,[ 12  64 483 427  11],214,5,6642,4.110148514851486,60.0,0.0
11616,1,1616,[318 183 403 132 186],618,5,6647,4.1106988249845395,20.0,0.0
11617,1,1617,[302  98 151 153 135],854,4,6651,4.110630407911001,0.0,20.0
11618,1,1618,[ 12  64 483 427  11],618,5,6656,4.111179740580606,60.0,0.0
11619,1,1619,[273 185   4 196 186],618,4,6660,4.111111111111111,0.0,0.0
11620,1,1620,[546  70 174 238 603],297,4,6664,4.111042566317089,0.0,0.0
11621,1,1621,[172  50  82  79 235],417,1,6665,4.109124537607891,0.0,20.0
11622,1,1622,[ 12 483  64 427  11],214,5,6670,4.109673444239063,60.0,0.0
11623,1,1623,[ 12 483  64 427  11],214,5,6675,4.110221674876847,60.0,0.0
11624,1,1624,[185   9 186 135 318],854,4,6679,4.110153846153846,20.0,0.0
11625,1,1625,[ 12 483  64 427  11],214,5,6684,4.11070110701107,60.0,0.0
11626,1,1626,[286  25 568 172 216],416,5,6689,4.111247695144438,0.0,0.0
11627,1,1627,[597 121 174  25 288],630,3,6692,4.11056511056511,0.0,20.0
11628,1,1628,[483  12  64 427  11],214,5,6697,4.111111111111111,60.0,0.0
11629,1,1629,[483  12  64 427  11],214,5,6702,4.111656441717791,60.0,0.0
11630,1,1630,[ 11 328 288  25 597],314,4,6706,4.111587982832618,0.0,20.0
11631,1,1631,[ 12 483  64 427  11],214,5,6711,4.112132352941177,60.0,0.0
11632,1,1632,[237 475 301 118   4],297,3,6714,4.111451316595224,0.0,0.0
11633,1,1633,[200 135 238 286  70],297,4,6718,4.1113831089351285,0.0,0.0
11634,1,1634,[ 12 483  64 427  11],618,5,6723,4.111926605504587,60.0,0.0
11635,1,1635,[ 96 174   7 568 427],198,4,6727,4.111858190709047,0.0,0.0
11636,1,1636,[ 12 483  64 427  11],618,5,6732,4.112400733048259,60.0,0.0
11637,1,1637,[228 508  69 237 153],297,3,6735,4.111721611721611,0.0,0.0
11638,1,1638,[183 318 210  71 385],705,4,6739,4.111653447223917,20.0,0.0
11639,1,1639,[100 475 215   1 568],416,4,6743,4.111585365853658,0.0,0.0
11640,1,1640,[ 12 483  64 427  11],618,5,6748,4.1121267519805,60.0,0.0
11641,1,1641,[288 678  79 742 748],654,4,6752,4.112058465286236,0.0,20.0
11642,1,1642,[ 12 483  64 427  11],618,5,6757,4.112598904443092,60.0,0.0
11643,1,1643,[313  56 258 289   1],49,2,6759,4.111313868613139,20.0,20.0
11644,1,1644,[ 64  12 483 427  11],618,5,6764,4.1118541033434655,60.0,0.0
11645,1,1645,[ 95 153 174 143 237],416,3,6767,4.111178614823816,0.0,0.0
11646,1,1646,[ 64  12 483 427  11],618,5,6772,4.111718275652702,60.0,0.0
11647,1,1647,[301 211 127 568 405],43,5,6777,4.112257281553398,0.0,0.0
11648,1,1648,[ 69 143 258 748 216],198,3,6780,4.111582777440873,0.0,0.0
11649,1,1649,[ 64  12 483 427  11],214,5,6785,4.112121212121212,60.0,0.0
11650,1,1650,[ 64  12 483 427  11],214,5,6790,4.112658994548759,60.0,0.0
11651,1,1651,[ 64  12 483 427  11],214,5,6795,4.11319612590799,60.0,0.0
11652,1,1652,[191 508 238  79 181],297,3,6798,4.112522686025408,0.0,20.0
11653,1,1653,[204 269 125  98  82],416,5,6803,4.113059250302298,0.0,20.0
11654,1,1654,[ 64  12 483 427  11],214,5,6808,4.113595166163142,60.0,0.0
11655,1,1655,[ 64  12 483 427  11],214,5,6813,4.114130434782608,60.0,0.0
11656,1,1656,[183  71 168  11 175],405,1,6814,4.112251056125528,0.0,0.0
11657,1,1657,[175 471 172 568 111],43,3,6817,4.111580217129071,0.0,0.0
11658,1,1658,[216 322 153 144 405],417,1,6818,4.109704641350211,0.0,0.0
11659,1,1659,[268 204  25 196 508],314,2,6820,4.108433734939759,0.0,0.0
11660,1,1660,[  4 173 132  50   9],764,2,6822,4.107164358819988,0.0,20.0
11661,1,1661,[265 568  95 222  97],711,2,6824,4.10589651022864,0.0,0.0
11662,1,1662,[475 301 245   4 568],416,3,6827,4.105231509320505,0.0,0.0
11663,1,1663,[ 12  64 483 427  11],214,5,6832,4.105769230769231,60.0,0.0
11664,1,1664,[200 742  88 121 175],805,2,6834,4.104504504504504,0.0,0.0
11665,1,1665,[ 12  64 483 427  11],214,5,6839,4.105042016806722,60.0,0.0
11666,1,1666,[ 12  64 483 427  11],618,5,6844,4.1055788842231555,60.0,0.0
11667,1,1667,[ 1 50 64 98  7],854,4,6848,4.105515587529976,20.0,40.0
11668,1,1668,[161 228 196 273 268],417,2,6850,4.104254044337927,0.0,0.0
11669,1,1669,[  8 215 172 273 186],618,4,6854,4.104191616766467,0.0,0.0
11670,1,1670,[ 12  64 483 427  11],618,5,6859,4.104727707959306,60.0,0.0
11671,1,1671,[179 357 100 269 435],373,3,6862,4.104066985645933,0.0,0.0
11672,1,1672,[194 322 282  95 127],416,3,6865,4.103407053197849,0.0,0.0
11673,1,1673,[ 15 475  71 195 186],601,2,6867,4.102150537634409,0.0,0.0
11674,1,1674,[483  12  64 427  11],214,5,6872,4.102686567164179,60.0,0.0
11675,1,1675,[423 151 678  95 222],541,3,6875,4.102028639618139,0.0,0.0
11676,1,1676,[ 12 483  64 427  11],618,5,6880,4.102564102564102,60.0,0.0
11677,1,1677,[ 12 172 181 405 294],345,4,6884,4.102502979737783,20.0,20.0
11678,1,1678,[483  64  12 427  11],618,5,6889,4.103037522334723,60.0,0.0
11679,1,1679,[748 191 222 183 175],805,4,6893,4.10297619047619,0.0,0.0
11680,1,1680,[194 121  22 273 301],416,5,6898,4.10350981558596,0.0,0.0
11681,1,1681,[ 25  50 222  56 268],854,3,6901,4.102853745541022,0.0,20.0
11682,1,1682,[ 64  12 483 427  11],214,5,6906,4.103386809269162,60.0,0.0
11683,1,1683,[496   9 194 318 357],416,5,6911,4.103919239904988,20.0,0.0
11684,1,1684,[ 64  12 483 427  11],214,5,6916,4.104451038575668,60.0,0.0
11685,1,1685,[ 64  12 483 427  11],618,5,6921,4.104982206405694,60.0,0.0
11686,1,1686,[ 64  12 483 427  11],618,5,6926,4.1055127445168935,60.0,0.0
11687,1,1687,[ 64  12 483 427  11],618,5,6931,4.106042654028436,60.0,0.0
11688,1,1688,[333 143 282 125 258],416,5,6936,4.106571936056838,0.0,0.0
11689,1,1689,[  4  82 215 288 269],416,5,6941,4.107100591715977,0.0,20.0
11690,1,1690,[ 82 222 568 323 195],198,0,6941,4.104671791839149,0.0,0.0
11691,1,1691,[202 196  89 191 435],354,3,6944,4.1040189125295505,0.0,0.0
11692,1,1692,[204  11  98 135 333],496,2,6946,4.10277613703485,0.0,20.0
11693,1,1693,[483  64  12 427  11],618,5,6951,4.103305785123967,60.0,0.0
11694,1,1694,[ 89 471 174  79 185],297,3,6954,4.102654867256637,0.0,0.0
11695,1,1695,[ 12 483  64 427  11],214,5,6959,4.103183962264151,60.0,0.0
11696,1,1696,[ 12 483  64 427  11],618,5,6964,4.103712433706541,60.0,0.0
11697,1,1697,[161 655  79 196  11],751,2,6966,4.102473498233215,0.0,0.0
11698,1,1698,[ 15  69 195 288  96],262,2,6968,4.101236021188934,0.0,20.0
11699,1,1699,[ 12 483  64 427  11],618,5,6973,4.101764705882353,60.0,0.0
11700,1,1700,[234   4 210 568 475],416,4,6977,4.101704879482657,0.0,0.0
11701,1,1701,[  1 153  28  82  88],805,2,6979,4.100470035252644,0.0,0.0
11702,1,1702,[568  70 117   4 313],618,3,6982,4.099823840281855,20.0,20.0
11703,1,1703,[275 143 268 179 302],416,4,6986,4.099765258215962,0.0,0.0
11704,1,1704,[234 748 111 153 273],417,3,6989,4.099120234604105,0.0,0.0
11705,1,1705,[ 12 483  64 427  11],214,5,6994,4.0996483001172335,60.0,0.0
11706,1,1706,[588 186  95 234 471],588,5,6999,4.100175746924429,0.0,0.0
11707,1,1707,[483  64  12 427  11],214,5,7004,4.100702576112412,60.0,0.0
11708,1,1708,[483  64  12 427  11],214,5,7009,4.10122878876536,60.0,0.0
11709,1,1709,[483  64  12 427  11],214,5,7014,4.101754385964912,60.0,0.0
11710,1,1710,[603 568 427 496  50],128,5,7019,4.102279368790181,0.0,20.0
11711,1,1711,[ 70 496 144 216   7],416,5,7024,4.102803738317757,0.0,0.0
11712,1,1712,[483  64  12 427  11],618,5,7029,4.103327495621716,60.0,0.0
11713,1,1713,[483  64  12 427  11],618,5,7034,4.103850641773629,60.0,0.0
11714,1,1714,[483  64  12 427  11],618,5,7039,4.104373177842565,60.0,0.0
11715,1,1715,[176 294 143 187 275],698,3,7042,4.103729603729604,0.0,0.0
11716,1,1716,[483  64  12 427  11],214,5,7047,4.104251601630751,60.0,0.0
11717,1,1717,[275 302 202 655   1],416,5,7052,4.104772991850989,0.0,0.0
11718,1,1718,[483  64  12 427  11],214,5,7057,4.105293775450844,60.0,0.0
11719,1,1719,[483  64  12 427  11],618,5,7062,4.105813953488372,60.0,0.0
11720,1,1720,[483  64  12 427  11],618,5,7067,4.106333527019175,60.0,0.0
11721,1,1721,[ 70  25 144 546 100],43,5,7072,4.1068524970963995,0.0,0.0
11722,1,1722,[181 161 204 125 144],416,5,7077,4.107370864770749,0.0,20.0
11723,1,1723,[ 12 483  64 427  11],618,5,7082,4.107888631090487,60.0,0.0
11724,1,1724,[435  69 385 182 175],405,1,7083,4.1060869565217395,0.0,0.0
11725,1,1725,[ 12 483  64 427  11],214,5,7088,4.106604866743917,60.0,0.0
11726,1,1726,[ 12 483  64 427  11],618,5,7093,4.107122177185872,60.0,0.0
11727,1,1727,[742  71  97 268 427],907,5,7098,4.107638888888889,0.0,0.0
11728,1,1728,[471 302 210 121 143],43,4,7102,4.107576633892424,0.0,0.0
11729,1,1729,[ 12 483  64 427  11],214,5,7107,4.1080924855491325,60.0,0.0
11730,1,1730,[151 132 183 357 182],62,5,7112,4.108607741190063,0.0,0.0
11731,1,1731,[ 12 483  64 427  11],214,5,7117,4.109122401847575,60.0,0.0
11732,1,1732,[403 135  98  95 301],711,5,7122,4.109636468551645,0.0,20.0
11733,1,1733,[ 12 483  64 427  11],214,5,7127,4.1101499423298735,60.0,0.0
11734,1,1734,[ 15  64 271 471 172],43,3,7130,4.109510086455331,20.0,0.0
11735,1,1735,[ 12 483  64 427  11],618,5,7135,4.110023041474655,60.0,0.0
11736,1,1736,[ 12 483  64 427  11],618,5,7140,4.110535405872193,60.0,0.0
11737,1,1737,[322 143 234 471  79],416,4,7144,4.110471806674338,0.0,0.0
11738,1,1738,[237 471 435 194 322],721,4,7148,4.110408280621047,0.0,0.0
11739,1,1739,[ 12 483  64 427  11],618,5,7153,4.110919540229885,60.0,0.0
11740,1,1740,[ 12 483  64 427  11],214,5,7158,4.111430212521539,60.0,0.0
11741,1,1741,[ 12 483  64 427  11],214,5,7163,4.111940298507463,60.0,0.0
11742,1,1742,[ 12 483  64 427  11],618,5,7168,4.112449799196787,60.0,0.0
11743,1,1743,[ 12 483  64 427  11],618,5,7173,4.1129587155963305,60.0,0.0
11744,1,1744,[ 82   8  15 275  50],62,4,7177,4.112893982808023,0.0,20.0
11745,1,1745,[ 22 176   8 172 143],805,2,7179,4.1116838487972505,0.0,0.0
11746,1,1746,[ 12 483  64 427  11],618,5,7184,4.112192329708071,60.0,0.0
11747,1,1747,[237  79 185  69 143],230,5,7189,4.112700228832952,0.0,0.0
11748,1,1748,[ 98  25 182 210 181],297,4,7193,4.1126357918810745,0.0,40.0
11749,1,1749,[568  69 211 181 235],43,4,7197,4.112571428571429,0.0,20.0
11750,1,1750,[ 12 483  64 427  11],214,5,7202,4.11307824100514,60.0,0.0
11751,1,1751,[ 12 483  64 427  11],214,5,7207,4.113584474885845,60.0,0.0
11752,1,1752,[ 12 483  64 427  11],214,5,7212,4.114090131203651,60.0,0.0
11753,1,1753,[ 88 216 195 127 471],416,4,7216,4.114025085518814,0.0,0.0
11754,1,1754,[196 588 300 168 748],654,5,7221,4.114529914529914,0.0,0.0
11755,1,1755,[483  12  64 427  11],214,5,7226,4.11503416856492,60.0,0.0
11756,1,1756,[  1 257 117 568 125],62,2,7228,4.1138303927148545,0.0,0.0
11757,1,1757,[483  12  64 427  11],618,5,7233,4.114334470989761,60.0,0.0
11758,1,1758,[238 508 597 276 153],654,3,7236,4.1137009664582145,0.0,0.0
11759,1,1759,[111 385 302 153 228],417,2,7238,4.1125,0.0,0.0
11760,1,1760,[ 12  64 483 427  11],618,5,7243,4.1130039750141965,60.0,0.0
11761,1,1761,[258 515 121 269 423],416,5,7248,4.113507377979569,0.0,0.0
11762,1,1762,[186  97   1 496 748],642,5,7253,4.114010209869541,0.0,0.0
11763,1,1763,[176 269 151 234 197],297,2,7255,4.11281179138322,0.0,0.0
11764,1,1764,[183 210 234  95 742],416,4,7259,4.112747875354108,0.0,0.0
11765,1,1765,[423 161 191 135 127],373,2,7261,4.111551528878822,0.0,0.0
11766,1,1766,[144  69 483 153 435],437,2,7263,4.110356536502547,20.0,0.0
11767,1,1767,[ 25   4  70 100 475],417,2,7265,4.109162895927602,0.0,0.0
11768,1,1768,[238 118 286 568 121],43,4,7269,4.109101187111363,0.0,0.0
11769,1,1769,[268 197   9  69 302],416,5,7274,4.109604519774011,0.0,0.0
11770,1,1770,[ 12  64 483 427  11],214,5,7279,4.110107284020327,60.0,0.0
11771,1,1771,[  7 742 125 117 322],314,5,7284,4.110609480812641,0.0,0.0
11772,1,1772,[258  82 180 276 174],198,2,7286,4.109419063733784,0.0,0.0
11773,1,1773,[ 12  64 483 427  11],618,5,7291,4.109921082299887,60.0,0.0
11774,1,1774,[204 186 111 211 257],43,4,7295,4.109859154929578,0.0,0.0
11775,1,1775,[ 12  64 483 427  11],618,5,7300,4.11036036036036,60.0,0.0
11776,1,1776,[ 12  64 483 427  11],214,5,7305,4.110861001688239,60.0,0.0
11777,1,1777,[ 12  64 483 427  11],618,5,7310,4.111361079865017,60.0,0.0
11778,1,1778,[143 435 288  12 588],297,3,7313,4.110736368746487,20.0,20.0
11779,1,1779,[ 64 483  12 427  11],214,5,7318,4.11123595505618,60.0,0.0
11780,1,1780,[ 64 483  12 427  11],618,5,7323,4.111734980348119,60.0,0.0
11781,1,1781,[ 79 144  69 195 151],417,2,7325,4.110549943883277,0.0,0.0
11782,1,1782,[ 64 483  12 427  11],618,5,7330,4.111048794167134,60.0,0.0
11783,1,1783,[ 95 222  22 471 546],705,4,7334,4.110986547085202,0.0,0.0
11784,1,1784,[ 64 483  12 427  11],214,5,7339,4.111484593837535,60.0,0.0
11785,1,1785,[ 82 471 176 475 603],416,4,7343,4.111422172452408,0.0,0.0
11786,1,1786,[302 197 427 748  96],416,5,7348,4.111919418019026,0.0,0.0
11787,1,1787,[ 64 483  12 427  11],214,5,7353,4.1124161073825505,60.0,0.0
11788,1,1788,[ 64 483  12 427  11],214,5,7358,4.1129122414756845,60.0,0.0
11789,1,1789,[121 323 183 265 175],198,1,7359,4.111173184357542,0.0,0.0
11790,1,1790,[ 95 135  50 153 385],922,2,7361,4.10999441652708,0.0,20.0
11791,1,1791,[ 64 483  12 427  11],618,5,7366,4.110491071428571,60.0,0.0
11792,1,1792,[161 435  88 194  69],405,1,7367,4.108756274400446,0.0,0.0
11793,1,1793,[ 64 483  12 427  11],214,5,7372,4.109253065774805,60.0,0.0
11794,1,1794,[275  88 405  97 268],416,4,7376,4.109192200557103,0.0,0.0
11795,1,1795,[ 64 483  12 427  11],214,5,7381,4.109688195991091,60.0,0.0
11796,1,1796,[172 100   1 655 403],62,3,7384,4.109070673344463,0.0,0.0
11797,1,1797,[172 748 286 144 185],416,5,7389,4.10956618464961,0.0,0.0
11798,1,1798,[ 64 483  12 427  11],618,5,7394,4.1100611450806,60.0,0.0
11799,1,1799,[  7 258 276 322 127],630,1,7395,4.108333333333333,0.0,0.0
11800,1,1800,[ 64 483  12 427  11],618,5,7400,4.1088284286507495,60.0,0.0
11801,1,1801,[ 56 300 187 313 181],505,2,7402,4.107658157602664,20.0,40.0
11802,1,1802,[403 100 118 195  88],805,2,7404,4.10648918469218,0.0,0.0
11803,1,1803,[ 25 385 194 568 172],373,4,7408,4.106430155210643,0.0,0.0
11804,1,1804,[172  96 121 496  50],642,5,7413,4.106925207756233,0.0,20.0
11805,1,1805,[237 143 211 234 385],416,4,7417,4.106866002214839,0.0,0.0
11806,1,1806,[483  64  12 427  11],618,5,7422,4.1073602656336465,60.0,0.0
11807,1,1807,[483  64  12 427  11],214,5,7427,4.107853982300885,60.0,0.0
11808,1,1808,[ 69 204  11  71  89],405,3,7430,4.107241569928137,0.0,0.0
11809,1,1809,[237 546 179 313  82],416,2,7432,4.106077348066298,20.0,20.0
11810,1,1810,[483  64  12 427  11],618,5,7437,4.106570955273329,60.0,0.0
11811,1,1811,[210 191 121  28 111],345,3,7440,4.105960264900662,0.0,0.0
11812,1,1812,[ 11 216 197  70 475],437,2,7442,4.104798676227247,0.0,0.0
11813,1,1813,[ 12 483  64 427  11],618,5,7447,4.10529217199559,60.0,0.0
11814,1,1814,[132   8 385  79  69],588,3,7450,4.104683195592287,0.0,0.0
11815,1,1815,[ 12 483  64 427  11],214,5,7455,4.1051762114537445,60.0,0.0
11816,1,1816,[ 12 483  64 427  11],214,5,7460,4.105668684645019,60.0,0.0
11817,1,1817,[ 12 483  64 427  11],618,5,7465,4.106160616061606,60.0,0.0
11818,1,1818,[100 508 515 546 265],417,1,7466,4.104452996151732,0.0,0.0
11819,1,1819,[180 228 427   1 597],887,5,7471,4.104945054945055,0.0,0.0
11820,1,1820,[ 12 483  64 427  11],214,5,7476,4.105436573311367,60.0,0.0
11821,1,1821,[180  15  25 289 197],854,2,7478,4.104281009879253,0.0,0.0
11822,1,1822,[403 286 174 282  50],588,3,7481,4.103675260559517,0.0,20.0
11823,1,1823,[655  96  25 187 132],198,4,7485,4.103618421052632,0.0,0.0
11824,1,1824,[ 12 483  64 427  11],618,5,7490,4.104109589041096,60.0,0.0
11825,1,1825,[ 25 515 302 423 181],417,2,7492,4.102957283680175,0.0,20.0
11826,1,1826,[121 655  96 143 151],805,2,7494,4.101806239737274,0.0,0.0
11827,1,1827,[ 12 483  64 427  11],618,5,7499,4.102297592997812,60.0,0.0
11828,1,1828,[117 289 405 197  15],854,2,7501,4.101148168398032,0.0,0.0
11829,1,1829,[ 12 483  64 427  11],618,5,7506,4.101639344262295,60.0,0.0
11830,1,1830,[ 12 483  64 427  11],214,5,7511,4.1021299836155105,60.0,0.0
11831,1,1831,[ 12 483  64 427  11],618,5,7516,4.102620087336245,60.0,0.0
11832,1,1832,[ 12 483  64 427  11],214,5,7521,4.103109656301146,60.0,0.0
11833,1,1833,[ 12 483  64 427  11],214,5,7526,4.103598691384951,60.0,0.0
11834,1,1834,[ 12 483  64 427  11],214,5,7531,4.10408719346049,60.0,0.0
11835,1,1835,[ 12 483  64 427  11],618,5,7536,4.104575163398692,60.0,0.0
11836,1,1836,[288 144 196 153  96],417,2,7538,4.103429504627109,0.0,20.0
11837,1,1837,[191 234 144 100 301],416,5,7543,4.103917301414581,0.0,0.0
11838,1,1838,[748  70  25 427 245],416,4,7547,4.103860793909734,0.0,0.0
11839,1,1839,[ 12 483  64 427  11],618,5,7552,4.104347826086957,60.0,0.0
11840,1,1840,[ 12 483  64 427  11],214,5,7557,4.10483432916893,60.0,0.0
11841,1,1841,[118 323 132   9  64],764,3,7560,4.1042345276872965,20.0,0.0
11842,1,1842,[185 258 195 273 183],805,2,7562,4.103092783505154,0.0,0.0
11843,1,1843,[ 88 191 288 180 273],805,1,7563,4.101409978308026,0.0,20.0
11844,1,1844,[172 603 748 427  50],416,5,7568,4.10189701897019,0.0,20.0
11845,1,1845,[483  12  64 427  11],214,5,7573,4.102383531960997,60.0,0.0
11846,1,1846,[471 237 496  82 179],128,4,7577,4.102328099621007,0.0,0.0
11847,1,1847,[483  12  64 427  11],618,5,7582,4.102813852813853,60.0,0.0
11848,1,1848,[483  12  64 427  11],618,5,7587,4.103299080584099,60.0,0.0
11849,1,1849,[483  12  64 427  11],618,5,7592,4.103783783783784,60.0,0.0
11850,1,1850,[483  12  64 427  11],214,5,7597,4.104267963263101,60.0,0.0
11851,1,1851,[118 197 357 176 258],805,3,7600,4.103671706263499,0.0,0.0
11852,1,1852,[483  12  64 427  11],618,5,7605,4.104155423637345,60.0,0.0
11853,1,1853,[125  28 318 172 151],618,3,7608,4.1035598705501615,20.0,0.0
11854,1,1854,[200 202  12 318 143],618,4,7612,4.1035040431266845,40.0,0.0
11855,1,1855,[187 197 153 234 403],198,4,7616,4.103448275862069,0.0,0.0
11856,1,1856,[483  12  64 427  11],618,5,7621,4.103931071620894,60.0,0.0
11857,1,1857,[483  12  64 427  11],214,5,7626,4.104413347685684,60.0,0.0
11858,1,1858,[471  12 423 405   8],854,4,7630,4.104357181280259,20.0,0.0
11859,1,1859,[742 496 197  50  71],128,4,7634,4.104301075268817,0.0,20.0
11860,1,1860,[748 568 385 144 288],416,5,7639,4.104782375067169,0.0,20.0
11861,1,1861,[475 294 174 117 222],297,4,7643,4.104726100966703,0.0,0.0
11862,1,1862,[168 322 288 286  12],417,3,7646,4.104133118625872,20.0,20.0
11863,1,1863,[ 12  64 483 427  11],618,5,7651,4.1046137339055795,60.0,0.0
11864,1,1864,[ 12  64 483 427  11],618,5,7656,4.105093833780161,60.0,0.0
11865,1,1865,[196 302  56 204  22],721,3,7659,4.104501607717042,0.0,0.0
11866,1,1866,[ 12  64 483 427  11],214,5,7664,4.104981253347616,60.0,0.0
11867,1,1867,[ 12  64 483 427  11],214,5,7669,4.105460385438972,60.0,0.0
11868,1,1868,[144 183 597 118 483],62,2,7671,4.104333868378812,20.0,0.0
11869,1,1869,[179  89   1 265 181],417,3,7674,4.103743315508021,0.0,20.0
11870,1,1870,[172  96 288   7 196],416,5,7679,4.104222340994121,0.0,20.0
11871,1,1871,[ 64 483  12 427  11],214,5,7684,4.104700854700854,60.0,0.0
11872,1,1872,[ 64 483  12 427  11],214,5,7689,4.105178857447944,60.0,0.0
11873,1,1873,[191 294  82 183  95],505,2,7691,4.1040554962646745,0.0,0.0
11874,1,1874,[ 64 483  12 427  11],618,5,7696,4.104533333333333,60.0,0.0
11875,1,1875,[ 64 483  12 427  11],618,5,7701,4.105010660980811,60.0,0.0
11876,1,1876,[174 228 483  97  56],496,3,7704,4.104421949920085,20.0,0.0
11877,1,1877,[  9 238   8 176 357],416,5,7709,4.104898828541001,0.0,0.0
11878,1,1878,[423  97 603 132 568],373,2,7711,4.103778605641298,0.0,0.0
11879,1,1879,[ 64 483  12 427  11],618,5,7716,4.104255319148936,60.0,0.0
11880,1,1880,[403 127 275 318  96],416,5,7721,4.104731525784158,20.0,0.0
11881,1,1881,[ 64 483  12 427  11],214,5,7726,4.105207226354942,60.0,0.0
11882,1,1882,[748 265 288 238 328],416,5,7731,4.105682421667551,0.0,20.0
11883,1,1883,[ 64 483  12 427  11],214,5,7736,4.10615711252654,60.0,0.0
11884,1,1884,[515 111 176  25 471],416,5,7741,4.106631299734748,0.0,0.0
11885,1,1885,[ 64 483  12 427  11],214,5,7746,4.107104984093319,60.0,0.0
11886,1,1886,[ 25 268   1  97 100],417,3,7749,4.106518282988871,0.0,0.0
11887,1,1887,[228 568  15 385  82],373,3,7752,4.1059322033898304,0.0,0.0
11888,1,1888,[ 64 323 301 322  25],416,3,7755,4.105346744309158,20.0,0.0
11889,1,1889,[ 64 483  12 427  11],214,5,7760,4.105820105820106,60.0,0.0
11890,1,1890,[ 64 483  12 427  11],214,5,7765,4.106292966684294,60.0,0.0
11891,1,1891,[ 64 483  12 427  11],214,5,7770,4.106765327695561,60.0,0.0
11892,1,1892,[238  15 235 322 496],417,2,7772,4.105652403592182,0.0,0.0
11893,1,1893,[ 64 483  12 427  11],618,5,7777,4.106124604012671,60.0,0.0
11894,1,1894,[ 96 195  71 204 235],887,4,7781,4.106068601583114,0.0,0.0
11895,1,1895,[181 216 173 475  69],416,4,7785,4.106012658227848,0.0,20.0
11896,1,1896,[  7 215 515 183 655],416,5,7790,4.106483921982077,0.0,0.0
11897,1,1897,[ 64 483  12 427  11],214,5,7795,4.10695468914647,60.0,0.0
11898,1,1898,[ 64 483  12 427  11],618,5,7800,4.107424960505529,60.0,0.0
11899,1,1899,[ 64 483  12 427  11],618,5,7805,4.1078947368421055,60.0,0.0
11900,1,1900,[121 238 471 427 286],416,5,7810,4.108364018937402,0.0,0.0
11901,1,1901,[ 64 483  12 427  11],214,5,7815,4.108832807570978,60.0,0.0
11902,1,1902,[275 471 269 742 237],854,2,7817,4.1077246452969,0.0,0.0
11903,1,1903,[496 161  79   1 143],416,5,7822,4.108193277310924,0.0,0.0
11904,1,1904,[ 12  64 483 427  11],618,5,7827,4.108661417322835,60.0,0.0
11905,1,1905,[ 97 191  89 168  69],711,4,7831,4.1086044071353625,0.0,0.0
11906,1,1906,[ 12  64 483 427  11],618,5,7836,4.10907184058731,60.0,0.0
11907,1,1907,[179  96  95 568 180],805,2,7838,4.1079664570230605,0.0,0.0
11908,1,1908,[ 12 483  64 427  11],214,5,7843,4.108433734939759,60.0,0.0
11909,1,1909,[ 12 483  64 427  11],618,5,7848,4.10890052356021,60.0,0.0
11910,1,1910,[276 385 174  50 496],654,4,7852,4.108843537414966,0.0,20.0
11911,1,1911,[265  56 268 191 273],417,3,7855,4.10826359832636,0.0,0.0
11912,1,1912,[333 183 222 496  22],253,4,7859,4.108207004704652,0.0,0.0
11913,1,1913,[172 273 385 202  11],416,5,7864,4.108672936259143,0.0,0.0
11914,1,1914,[ 12 483  64 427  11],618,5,7869,4.109138381201045,60.0,0.0
11915,1,1915,[265 161 257  96  50],416,4,7873,4.109081419624217,0.0,20.0
11916,1,1916,[ 12 483  64 427  11],214,5,7878,4.109546165884194,60.0,0.0
11917,1,1917,[ 50  82  88 135 318],437,3,7881,4.1089676746611055,20.0,20.0
11918,1,1918,[100  56 197  50 132],854,5,7886,4.109431995831162,0.0,20.0
11919,1,1919,[ 12 483  64 427  11],214,5,7891,4.109895833333334,60.0,0.0
11920,1,1920,[ 12 483  64 427  11],214,5,7896,4.110359187922957,60.0,0.0
11921,1,1921,[ 12 483  64 427  11],214,5,7901,4.110822060353798,60.0,0.0
11922,1,1922,[ 12 483  64 427  11],214,5,7906,4.111284451378055,60.0,0.0
11923,1,1923,[ 56 117 144 258   4],805,1,7907,4.10966735966736,0.0,0.0
11924,1,1924,[ 12 483  64 427  11],214,5,7912,4.11012987012987,60.0,0.0
11925,1,1925,[ 12 483  64 427  11],618,5,7917,4.110591900311526,60.0,0.0
11926,1,1926,[ 28 216  50   7 275],62,4,7921,4.1105345096004156,0.0,20.0
11927,1,1927,[235 385 265 210   8],416,4,7925,4.110477178423237,0.0,0.0
11928,1,1928,[179 153 168 294 655],417,5,7930,4.110938310005184,0.0,0.0
11929,1,1929,[  1  71 151 237 143],654,4,7934,4.110880829015544,0.0,0.0
11930,1,1930,[196 265 161 111 237],416,4,7938,4.110823407560849,0.0,0.0
11931,1,1931,[403 333 471 258 300],345,1,7939,4.109213250517598,0.0,0.0
11932,1,1932,[ 12 483  64 427  11],618,5,7944,4.1096740817382305,60.0,0.0
11933,1,1933,[ 12 483  64 427  11],214,5,7949,4.110134436401241,60.0,0.0
11934,1,1934,[ 12 483  64 427  11],618,5,7954,4.1105943152454785,60.0,0.0
11935,1,1935,[ 12 483  64 427  11],214,5,7959,4.1110537190082646,60.0,0.0
11936,1,1936,[435 328 275 144 194],373,4,7963,4.110996386164171,0.0,0.0
11937,1,1937,[ 64 483  12 427  11],214,5,7968,4.1114551083591335,60.0,0.0
11938,1,1938,[ 64 483  12 427  11],214,5,7973,4.111913357400722,60.0,0.0
11939,1,1939,[196  25 200 127  82],417,4,7977,4.111855670103092,0.0,0.0
11940,1,1940,[ 71  79 211 275 153],373,5,7982,4.11231324059763,0.0,0.0
11941,1,1941,[  9 655 168 175 222],805,3,7985,4.111740473738414,0.0,0.0
11942,1,1942,[182 196 185  69 357],230,4,7989,4.111682964487906,0.0,0.0
11943,1,1943,[234 183 197 588  97],297,3,7992,4.111111111111111,0.0,0.0
11944,1,1944,[748 403 357 603 117],416,5,7997,4.111568123393316,0.0,0.0
11945,1,1945,[ 12  64 483 427  11],618,5,8002,4.1120246659815,60.0,0.0
11946,1,1946,[161 121 172 234 202],588,4,8006,4.111967128916281,0.0,0.0
11947,1,1947,[ 12  64 483 427  11],214,5,8011,4.112422997946612,60.0,0.0
11948,1,1948,[ 12  64 483 427  11],618,5,8016,4.112878399179066,60.0,0.0
11949,1,1949,[427   8 117  95 168],618,3,8019,4.112307692307692,0.0,0.0
11950,1,1950,[289   1 403 294   4],345,1,8020,4.110712455151204,0.0,0.0
11951,1,1951,[ 12  64 483 427  11],618,5,8025,4.111168032786885,60.0,0.0
11952,1,1952,[ 12  64 483 427  11],618,5,8030,4.111623143881208,60.0,0.0
11953,1,1953,[ 12  64 483 427  11],214,5,8035,4.112077789150461,60.0,0.0
11954,1,1954,[  4 173  56 405 144],805,2,8037,4.110997442455243,0.0,0.0
11955,1,1955,[ 12  64 483 427  11],618,5,8042,4.1114519427402865,60.0,0.0
11956,1,1956,[ 12  64 483 427  11],214,5,8047,4.111905978538579,60.0,0.0
11957,1,1957,[ 12  64 483 427  11],618,5,8052,4.112359550561798,60.0,0.0
11958,1,1958,[ 98 471  70 258 143],297,4,8056,4.112302194997448,0.0,20.0
11959,1,1959,[ 12 475 200 179 127],416,3,8059,4.111734693877551,20.0,0.0
11960,1,1960,[275 196  25 117 269],416,5,8064,4.11218765935747,0.0,0.0
11961,1,1961,[168 197  50 195  79],618,3,8067,4.111620795107034,0.0,20.0
11962,1,1962,[ 12  64 483 427  11],618,5,8072,4.112073357106469,60.0,0.0
11963,1,1963,[ 88  96 161 228 357],405,1,8073,4.110488798370672,0.0,0.0
11964,1,1964,[176 173  96 403  64],416,5,8078,4.110941475826972,20.0,0.0
11965,1,1965,[ 89 125  22  71 132],62,5,8083,4.111393692777213,0.0,0.0
11966,1,1966,[286 597 125  95 496],417,3,8086,4.110828673106253,0.0,0.0
11967,1,1967,[265  70  11  22 238],618,3,8089,4.1102642276422765,0.0,0.0
11968,1,1968,[174 496 435 181 483],698,0,8089,4.108176739461656,20.0,20.0
11969,1,1969,[ 12  64 483 427  11],618,5,8094,4.108629441624365,60.0,0.0
11970,1,1970,[194 216 289 333 302],854,0,8094,4.106544901065449,0.0,0.0
11971,1,1971,[385 135 357 655 234],417,4,8098,4.106490872210953,0.0,0.0
11972,1,1972,[118 182 204  96 186],198,3,8101,4.105930055752661,0.0,0.0
11973,1,1973,[202  15 273 200 215],618,3,8104,4.105369807497467,0.0,0.0
11974,1,1974,[176 143 127 111 238],805,2,8106,4.104303797468354,0.0,0.0
11975,1,1975,[ 12  64 483 427  11],214,5,8111,4.104757085020243,60.0,0.0
11976,1,1976,[118 191  71 678 238],805,3,8114,4.104198280222559,0.0,0.0
11977,1,1977,[471 174  28 405 300],128,4,8118,4.1041456016177955,0.0,0.0
11978,1,1978,[ 12  64 483 427  11],618,5,8123,4.104598281960586,60.0,0.0
11979,1,1979,[111 182  79 127 161],417,2,8125,4.103535353535354,0.0,0.0
11980,1,1980,[  7  64 238 183 271],62,4,8129,4.1034830893488135,20.0,0.0
11981,1,1981,[ 12  64 483 427  11],214,5,8134,4.10393541876892,60.0,0.0
11982,1,1982,[ 12  64 483 427  11],618,5,8139,4.104387291981846,60.0,0.0
11983,1,1983,[ 12 237 183 191 168],416,4,8143,4.104334677419355,20.0,0.0
11984,1,1984,[ 12  64 483 427  11],618,5,8148,4.104785894206549,60.0,0.0
11985,1,1985,[186 269  89 125 508],854,3,8151,4.104229607250756,0.0,0.0
11986,1,1986,[ 12  64 483 427  11],618,5,8156,4.104680422747861,60.0,0.0
11987,1,1987,[ 12 546 357  89 228],297,3,8159,4.104124748490945,20.0,0.0
11988,1,1988,[ 12  64 483 427  11],214,5,8164,4.104575163398692,60.0,0.0
11989,1,1989,[185  64 318 117  15],416,5,8169,4.105025125628141,40.0,0.0
11990,1,1990,[  4 238 132  25 235],417,2,8171,4.103967855349071,0.0,0.0
11991,1,1991,[ 12  64 483 427  11],618,5,8176,4.104417670682731,60.0,0.0
11992,1,1992,[111 187 597 143 185],416,4,8180,4.104365278474662,0.0,0.0
11993,1,1993,[ 12  64 483 427  11],214,5,8185,4.10481444332999,60.0,0.0
11994,1,1994,[172 117  11 235 143],43,4,8189,4.104761904761904,0.0,0.0
11995,1,1995,[ 12  64 483 427  11],618,5,8194,4.105210420841684,60.0,0.0
11996,1,1996,[ 12  64 483 427  11],214,5,8199,4.105658487731597,60.0,0.0
11997,1,1997,[748 111  50 182 176],437,2,8201,4.104604604604605,0.0,20.0
11998,1,1998,[ 12  64 483 427  11],618,5,8206,4.105052526263131,60.0,0.0
11999,1,1999,[ 12  64 483 427  11],618,5,8211,4.1055,60.0,0.0
12000,1,2000,[174  64 289 742 172],416,4,8215,4.1054472763618195,20.0,0.0
12001,1,2001,[237   1 603 328 471],854,1,8216,4.103896103896104,0.0,0.0
12002,1,2002,[179 742 182  98 496],128,3,8219,4.1033449825262105,0.0,20.0
12003,1,2003,[271 100   9 210 196],43,4,8223,4.1032934131736525,0.0,0.0
12004,1,2004,[ 64  12 483 427  11],214,5,8228,4.103740648379052,60.0,0.0
12005,1,2005,[282 118 143 423 275],297,2,8230,4.102691924227318,0.0,0.0
12006,1,2006,[ 64  12 483 427  11],618,5,8235,4.103139013452915,60.0,0.0
12007,1,2007,[ 64  12 483 427  11],618,5,8240,4.103585657370518,60.0,0.0
12008,1,2008,[ 64  12 483 427  11],214,5,8245,4.104031856645097,60.0,0.0
12009,1,2009,[ 64  12 483 427  11],214,5,8250,4.104477611940299,60.0,0.0
12010,1,2010,[423 173 483   1 405],854,4,8254,4.104425658876181,20.0,0.0
12011,1,2011,[ 64  12 483 427  11],214,5,8259,4.104870775347912,60.0,0.0
12012,1,2012,[ 64  12 483 427  11],214,5,8264,4.105315449577745,60.0,0.0
12013,1,2013,[173 742 313 275 271],43,4,8268,4.105263157894737,20.0,20.0
12014,1,2014,[  1 238  56 275   9],618,2,8270,4.104218362282879,0.0,0.0
12015,1,2015,[196 197 117 118 597],618,3,8273,4.103670634920635,0.0,0.0
12016,1,2016,[ 12  64 483 427  11],214,5,8278,4.104115022310362,60.0,0.0
12017,1,2017,[135 185 423 588 111],805,2,8280,4.103072348860258,0.0,0.0
12018,1,2018,[132 185  70 216 143],198,2,8282,4.102030708271421,0.0,0.0
12019,1,2019,[ 12  64 483 427  11],618,5,8287,4.102475247524753,60.0,0.0
12020,1,2020,[ 12  64 483 427  11],618,5,8292,4.102919346857991,60.0,0.0
12021,1,2021,[ 12  64 483 427  11],618,5,8297,4.103363006923837,60.0,0.0
12022,1,2022,[ 12  64 483 427  11],618,5,8302,4.103806228373703,60.0,0.0
12023,1,2023,[ 12  64 483 427  11],618,5,8307,4.104249011857707,60.0,0.0
12024,1,2024,[ 12  64 483 427  11],618,5,8312,4.1046913580246915,60.0,0.0
12025,1,2025,[318  56 313 204 194],405,4,8316,4.104639684106614,40.0,20.0
12026,1,2026,[286 603 210 144 191],373,3,8319,4.104094721262951,0.0,0.0
12027,1,2027,[ 12  64 483 427  11],214,5,8324,4.104536489151874,60.0,0.0
12028,1,2028,[ 12  64 483 427  11],618,5,8329,4.1049778215869885,60.0,0.0
12029,1,2029,[ 12  64 483 427  11],214,5,8334,4.105418719211823,60.0,0.0
12030,1,2030,[ 12  64 483 427  11],618,5,8339,4.105859182668636,60.0,0.0
12031,1,2031,[403 210  96 151 318],62,5,8344,4.106299212598425,20.0,0.0
12032,1,2032,[ 12  64 483 427  11],214,5,8349,4.106738809640925,60.0,0.0
12033,1,2033,[ 12  64 483 427  11],214,5,8354,4.107177974434611,60.0,0.0
12034,1,2034,[ 12  64 483 427  11],618,5,8359,4.107616707616708,60.0,0.0
12035,1,2035,[173 204 275 273 318],62,4,8363,4.107563850687622,20.0,0.0
12036,1,2036,[ 12  64 483 427  11],214,5,8368,4.108001963672066,60.0,0.0
12037,1,2037,[385 597 313  56 276],618,4,8372,4.107948969578017,20.0,20.0
12038,1,2038,[ 28 300 568  88 237],751,2,8374,4.106915154487494,0.0,0.0
12039,1,2039,[ 12  64 483 427  11],618,5,8379,4.107352941176471,60.0,0.0
12040,1,2040,[ 12  64 483 427  11],214,5,8384,4.107790298873101,60.0,0.0
12041,1,2041,[ 12  64 483 427  11],618,5,8389,4.10822722820764,60.0,0.0
12042,1,2042,[ 12  64 483 427  11],214,5,8394,4.108663729809105,60.0,0.0
12043,1,2043,[176 180 181 301 210],437,2,8396,4.107632093933463,0.0,20.0
12044,1,2044,[  1 185 125  11  64],854,3,8399,4.107090464547677,20.0,0.0
12045,1,2045,[ 28 118 471 269 322],416,3,8402,4.106549364613881,0.0,0.0
12046,1,2046,[ 12  64 483 427  11],214,5,8407,4.106985832926234,60.0,0.0
12047,1,2047,[195 204 180 357  89],805,2,8409,4.10595703125,0.0,0.0
12048,1,2048,[118  82  50 313 385],642,4,8413,4.105905319668131,20.0,40.0
12049,1,2049,[ 12  64 483 427  11],214,5,8418,4.106341463414634,60.0,0.0
12050,1,2050,[ 12  64 483 427  11],618,5,8423,4.1067771818625065,60.0,0.0
12051,1,2051,[313 216 323 288 161],345,2,8425,4.105750487329435,20.0,40.0
12052,1,2052,[ 12  64 483 427  11],214,5,8430,4.106186069167072,60.0,0.0
12053,1,2053,[ 12  64 483 427  11],618,5,8435,4.106621226874392,60.0,0.0
12054,1,2054,[ 12  64 483 427  11],214,5,8440,4.10705596107056,60.0,0.0
12055,1,2055,[210 655 235 301 268],416,4,8444,4.107003891050583,0.0,0.0
12056,1,2056,[385   4 313 271 238],43,3,8447,4.106465726786582,20.0,20.0
12057,1,2057,[ 12  64 483 427  11],214,5,8452,4.10689990281827,60.0,0.0
12058,1,2058,[ 12  64 483 427  11],618,5,8457,4.107333657115104,60.0,0.0
12059,1,2059,[ 12  64 483 427  11],214,5,8462,4.107766990291262,60.0,0.0
12060,1,2060,[132 427 238 597 200],416,4,8466,4.107714701601164,0.0,0.0
12061,1,2061,[143 215 427 603 471],416,5,8471,4.1081474296799225,0.0,0.0
12062,1,2062,[202 496 100 289 210],43,5,8476,4.108579738245274,0.0,0.0
12063,1,2063,[286 471   7 294 405],416,5,8481,4.109011627906977,0.0,0.0
12064,1,2064,[276 258 405 496  22],416,4,8485,4.108958837772397,0.0,0.0
12065,1,2065,[ 64  12 483 427  11],214,5,8490,4.109390125847048,60.0,0.0
12066,1,2066,[508 100 678  79 300],297,2,8492,4.1083696178035805,0.0,0.0
12067,1,2067,[ 64  12 483 427  11],618,5,8497,4.108800773694391,60.0,0.0
12068,1,2068,[ 64  12 483 427  11],618,5,8502,4.10923151280812,60.0,0.0
12069,1,2069,[ 64  12 483 427  11],214,5,8507,4.109661835748792,60.0,0.0
12070,1,2070,[ 64  12 483 427  11],214,5,8512,4.110091743119266,60.0,0.0
12071,1,2071,[ 64  12 483 427  11],618,5,8517,4.110521235521236,60.0,0.0
12072,1,2072,[117 471 275  15 186],854,1,8518,4.1090207428847085,0.0,0.0
12073,1,2073,[132  12 238  50   1],854,4,8522,4.1089681774349085,20.0,20.0
12074,1,2074,[ 88 197 237  69 483],437,3,8525,4.108433734939759,20.0,0.0
12075,1,2075,[655 286 357 132 289],342,3,8528,4.107899807321773,0.0,0.0
12076,1,2076,[215 100  50 237 161],43,5,8533,4.108329321136254,0.0,20.0
12077,1,2077,[235 118 289  50 151],854,2,8535,4.107314725697786,0.0,20.0
12078,1,2078,[471 294   9  25  71],416,5,8540,4.107744107744108,0.0,0.0
12079,1,2079,[195 423 118 508 678],654,3,8543,4.107211538461539,0.0,0.0
12080,1,2080,[475 180 182 385 288],417,4,8547,4.107160019221528,0.0,20.0
12081,1,2081,[597 288   4  11  28],654,4,8551,4.107108549471662,0.0,20.0
12082,1,2082,[ 64  12 483 427  11],214,5,8556,4.107537205952952,60.0,0.0
12083,1,2083,[ 25  98 258 173 195],198,3,8559,4.107005758157389,0.0,20.0
12084,1,2084,[ 15 151  79 118 143],588,4,8563,4.106954436450839,0.0,0.0
12085,1,2085,[282 125 117 385 132],416,5,8568,4.10738255033557,0.0,0.0
12086,1,2086,[ 64  12 483 427  11],214,5,8573,4.107810253953042,60.0,0.0
12087,1,2087,[ 64  12 483 427  11],214,5,8578,4.10823754789272,60.0,0.0
12088,1,2088,[ 64  12 483 427  11],214,5,8583,4.108664432742939,60.0,0.0
12089,1,2089,[ 11 258 216 144 245],416,4,8587,4.108612440191387,0.0,0.0
12090,1,2090,[ 64  12 483 427  11],214,5,8592,4.109038737446198,60.0,0.0
12091,1,2091,[ 64  12 483 427  11],618,5,8597,4.109464627151052,60.0,0.0
12092,1,2092,[ 64  12 483 427  11],618,5,8602,4.1098901098901095,60.0,0.0
12093,1,2093,[ 56 185 174 588 195],601,2,8604,4.108882521489972,0.0,0.0
12094,1,2094,[ 64  12 483 427  11],214,5,8609,4.109307875894988,60.0,0.0
12095,1,2095,[ 64  12 483 427  11],214,5,8614,4.109732824427481,60.0,0.0
12096,1,2096,[258 475 222 603 168],297,5,8619,4.110157367668097,0.0,0.0
12097,1,2097,[194  64 742  22 257],854,1,8620,4.108674928503336,20.0,0.0
12098,1,2098,[423 132  79 289 318],588,3,8623,4.10814673654121,20.0,0.0
12099,1,2099,[197 271 282 423 135],854,4,8627,4.108095238095238,0.0,0.0
12100,1,2100,[ 28 655 176   9 323],416,4,8631,4.108043788672061,0.0,0.0
12101,1,2101,[ 12  64 483 427  11],214,5,8636,4.108468125594672,60.0,0.0
12102,1,2102,[ 12  64 483 427  11],214,5,8641,4.108892058963385,60.0,0.0
12103,1,2103,[ 12  64 483 427  11],618,5,8646,4.109315589353612,60.0,0.0
12104,1,2104,[475  12 132  71 117],437,2,8648,4.108313539192399,20.0,0.0
12105,1,2105,[588  12  71  82 269],416,5,8653,4.1087369420702755,20.0,0.0
12106,1,2106,[  7 172  71 742  69],416,5,8658,4.109159943046986,0.0,0.0
12107,1,2107,[176 234 258 196 204],297,3,8661,4.108633776091081,0.0,0.0
12108,1,2108,[ 64  12 483 427  11],618,5,8666,4.109056424845899,60.0,0.0
12109,1,2109,[ 64  12 483 427  11],618,5,8671,4.109478672985782,60.0,0.0
12110,1,2110,[ 64  12 483 427  11],618,5,8676,4.109900521080057,60.0,0.0
12111,1,2111,[ 64  12 483 427  11],214,5,8681,4.11032196969697,60.0,0.0
12112,1,2112,[275  79  97 245 301],907,5,8686,4.110743019403691,0.0,0.0
12113,1,2113,[405 132 268 655 257],417,3,8689,4.110217596972564,0.0,0.0
12114,1,2114,[313 179 181  96 216],416,4,8693,4.11016548463357,20.0,40.0
12115,1,2115,[  8  89 168 588  50],297,5,8698,4.110586011342155,0.0,20.0
12116,1,2116,[ 64  12 483 427  11],618,5,8703,4.111006140765234,60.0,0.0
12117,1,2117,[202 117 151 275  96],618,1,8704,4.109537299338999,0.0,0.0
12118,1,2118,[ 79 132 328 196 269],416,5,8709,4.109957527135442,0.0,0.0
12119,1,2119,[ 12 174  82 153 496],601,3,8712,4.109433962264151,20.0,0.0
12120,1,2120,[ 64  12 483 427  11],214,5,8717,4.10985384252711,60.0,0.0
12121,1,2121,[ 64  12 483 427  11],618,5,8722,4.110273327049953,60.0,0.0
12122,1,2122,[257 268 196  70 197],297,3,8725,4.109750353273669,0.0,0.0
12123,1,2123,[ 96 588 204  11 483],751,4,8729,4.1096986817325805,20.0,0.0
12124,1,2124,[ 64  12 483 427  11],214,5,8734,4.110117647058823,60.0,0.0
12125,1,2125,[ 64  12 483 427  11],214,5,8739,4.110536218250235,60.0,0.0
12126,1,2126,[ 28  15  98 195 121],437,2,8741,4.1095439586271745,0.0,20.0
12127,1,2127,[180 258 196 483 328],128,3,8744,4.109022556390977,20.0,0.0
12128,1,2128,[ 64  12 483 427  11],618,5,8749,4.109441052137154,60.0,0.0
12129,1,2129,[  9 288 515 185  97],416,5,8754,4.109859154929578,0.0,20.0
12130,1,2130,[12 25 97 11 28],297,5,8759,4.110276865321445,20.0,0.0
12131,1,2131,[286 265 742 200 100],416,5,8764,4.110694183864916,0.0,0.0
12132,1,2132,[ 64  12 483 427  11],214,5,8769,4.111111111111111,60.0,0.0
12133,1,2133,[ 64  12 483 427  11],618,5,8774,4.111527647610122,60.0,0.0
12134,1,2134,[ 64  12 483 427  11],214,5,8779,4.111943793911007,60.0,0.0
12135,1,2135,[111   1  12 100  69],43,5,8784,4.112359550561798,20.0,0.0
12136,1,2136,[ 64  12 483 427  11],618,5,8789,4.1127749181094995,60.0,0.0
12137,1,2137,[ 64  12 483 427  11],618,5,8794,4.113189897100094,60.0,0.0
12138,1,2138,[ 64  12 483 427  11],618,5,8799,4.113604488078542,60.0,0.0
12139,1,2139,[ 64  12 483 427  11],214,5,8804,4.114018691588785,60.0,0.0
12140,1,2140,[ 64  12 483 427  11],618,5,8809,4.114432508173751,60.0,0.0
12141,1,2141,[ 98 211  69 678 197],297,2,8811,4.11344537815126,0.0,20.0
12142,1,2142,[180  88  64  69   8],711,4,8815,4.113392440503967,20.0,0.0
12143,1,2143,[143 172 678  98  79],345,4,8819,4.113339552238806,0.0,20.0
12144,1,2144,[ 96 235  89 328 237],62,3,8822,4.112820512820512,0.0,0.0
12145,1,2145,[ 64  12 483 427  11],214,5,8827,4.113233923578751,60.0,0.0
12146,1,2146,[ 64  12 483 427  11],618,5,8832,4.1136469492314856,60.0,0.0
12147,1,2147,[ 64  12 483 427  11],618,5,8837,4.1140595903165735,60.0,0.0
12148,1,2148,[471 238  15 508 173],854,3,8840,4.113541181945091,0.0,0.0
12149,1,2149,[ 64  12 483 427  11],214,5,8845,4.113953488372093,60.0,0.0
12150,1,2150,[385 508  82  28  11],654,4,8849,4.113900511390051,0.0,0.0
12151,1,2151,[204 245 181 117 318],345,4,8853,4.113847583643123,20.0,20.0
12152,1,2152,[174 276 568 496   8],618,3,8856,4.113330236878774,0.0,0.0
12153,1,2153,[ 11 603  82 161 357],405,3,8859,4.112813370473537,0.0,0.0
12154,1,2154,[ 64  12 483 427  11],618,5,8864,4.11322505800464,60.0,0.0
12155,1,2155,[194 180 132  64  22],373,3,8867,4.112708719851577,20.0,0.0
12156,1,2156,[186 100 197 185  79],437,4,8871,4.112656467315716,0.0,0.0
12157,1,2157,[ 64  12 483 427  11],618,5,8876,4.11306765523633,60.0,0.0
12158,1,2158,[204   9  12 216 153],416,5,8881,4.1134784622510425,20.0,0.0
12159,1,2159,[ 64  12 483 427  11],214,5,8886,4.113888888888889,60.0,0.0
12160,1,2160,[ 64  12 483 427  11],618,5,8891,4.114298935677927,60.0,0.0
12161,1,2161,[228 175 186 151  89],198,3,8894,4.113783533765033,0.0,0.0
12162,1,2162,[ 64  12 483 427  11],618,5,8899,4.11419325011558,60.0,0.0
12163,1,2163,[ 64  12 483 427  11],214,5,8904,4.11460258780037,60.0,0.0
12164,1,2164,[597 111  89 211 496],417,2,8906,4.113625866050809,0.0,0.0
12165,1,2165,[294 118 423 191 181],297,1,8907,4.11218836565097,0.0,20.0
12166,1,2166,[ 64  12 483 427  11],214,5,8912,4.112598061836641,60.0,0.0
12167,1,2167,[173   7  11 301  95],297,4,8916,4.112546125461255,0.0,0.0
12168,1,2168,[302 135 153  64  25],417,2,8918,4.111572153065929,20.0,0.0
12169,1,2169,[ 64  12 483 427  11],618,5,8923,4.111981566820276,60.0,0.0
12170,1,2170,[ 64  12 483 427  11],214,5,8928,4.112390603408567,60.0,0.0
12171,1,2171,[ 64  12 483 427  11],618,5,8933,4.112799263351749,60.0,0.0
12172,1,2172,[100 194 195 403 183],416,5,8938,4.113207547169812,0.0,0.0
12173,1,2173,[191 174 318 323 153],43,4,8942,4.113155473781049,20.0,0.0
12174,1,2174,[ 64  12 483 427  11],618,5,8947,4.113563218390804,60.0,0.0
12175,1,2175,[ 64  12 483 427  11],214,5,8952,4.113970588235294,60.0,0.0
12176,1,2176,[ 64  12 483 427  11],618,5,8957,4.11437758383096,60.0,0.0
12177,1,2177,[ 64  12 483 427  11],618,5,8962,4.114784205693296,60.0,0.0
12178,1,2178,[ 96 210   1 173 121],417,2,8964,4.1138136759981645,0.0,0.0
12179,1,2179,[ 64  12 483 427  11],214,5,8969,4.114220183486238,60.0,0.0
12180,1,2180,[ 64  12 483 427  11],618,5,8974,4.114626318202659,60.0,0.0
12181,1,2181,[179 161 313 265 588],416,4,8978,4.114573785517874,20.0,20.0
12182,1,2182,[181 357 197 174 228],805,2,8980,4.113605130554283,0.0,20.0
12183,1,2183,[508 268 257 318 357],854,3,8983,4.113095238095238,20.0,0.0
12184,1,2184,[ 64  12 483 427  11],214,5,8988,4.1135011441647595,60.0,0.0
12185,1,2185,[435 234  15  89  82],437,2,8990,4.112534309240623,0.0,0.0
12186,1,2186,[568 318 125 294 168],62,3,8993,4.112025605852766,20.0,0.0
12187,1,2187,[121 235  12   7 186],854,2,8995,4.111060329067642,20.0,0.0
12188,1,2188,[322  25 302 286 222],417,1,8996,4.109639104613979,0.0,0.0
12189,1,2189,[ 69 300 118 546  88],43,5,9001,4.110045662100457,0.0,0.0
12190,1,2190,[ 64  12 483 427  11],214,5,9006,4.110451848471018,60.0,0.0
12191,1,2191,[ 96 603 597  98 289],416,3,9009,4.109945255474453,0.0,20.0
12192,1,2192,[ 64  12 483 427  11],214,5,9014,4.110351117191063,60.0,0.0
12193,1,2193,[196 143  12  79  15],618,4,9018,4.110300820419326,20.0,0.0
12194,1,2194,[ 64  12 483 427  11],214,5,9023,4.110706150341685,60.0,0.0
12195,1,2195,[ 64  12 483 427  11],214,5,9028,4.111111111111111,60.0,0.0
12196,1,2196,[ 64  12 483 427  11],618,5,9033,4.11151570323168,60.0,0.0
12197,1,2197,[ 64  12 483 427  11],618,5,9038,4.111919927206551,60.0,0.0
12198,1,2198,[ 64  12 483 427  11],214,5,9043,4.112323783537972,60.0,0.0
12199,1,2199,[ 64  12 483 427  11],618,5,9048,4.112727272727272,60.0,0.0
12200,1,2200,[ 64  12 483 427  11],214,5,9053,4.113130395274875,60.0,0.0
12201,1,2201,[ 64  12 483 427  11],618,5,9058,4.113533151680291,60.0,0.0
12202,1,2202,[ 50 118 234  96 276],618,2,9060,4.112573763050386,0.0,20.0
12203,1,2203,[ 64  12 483 427  11],214,5,9065,4.112976406533575,60.0,0.0
12204,1,2204,[ 64  12 483 427  11],214,5,9070,4.113378684807256,60.0,0.0
12205,1,2205,[ 64  12 483 427  11],618,5,9075,4.113780598368087,60.0,0.0
12206,1,2206,[183 144 153 168 117],230,3,9078,4.113275940190303,0.0,0.0
12207,1,2207,[471 427 127 273  88],618,4,9082,4.113224637681159,0.0,0.0
12208,1,2208,[288 222 357 200 176],297,3,9085,4.112720688094161,0.0,20.0
12209,1,2209,[ 64  12 483 427  11],214,5,9090,4.113122171945701,60.0,0.0
12210,1,2210,[ 64  12 483 427  11],618,5,9095,4.11352329262777,60.0,0.0
12211,1,2211,[ 64  12 483 427  11],618,5,9100,4.113924050632911,60.0,0.0
12212,1,2212,[588  56 265 245  50],128,3,9103,4.113420695887935,0.0,20.0
12213,1,2213,[ 64  12 483 427  11],618,5,9108,4.1138211382113825,60.0,0.0
12214,1,2214,[117  12 121 111  95],416,4,9112,4.1137697516930025,20.0,0.0
12215,1,2215,[ 64  12 483 427  11],618,5,9117,4.1141696750902526,60.0,0.0
12216,1,2216,[200 211  50  11 471],297,3,9120,4.113667117726657,0.0,20.0
12217,1,2217,[ 64  12 483 427  11],214,5,9125,4.114066726780884,60.0,0.0
12218,1,2218,[117  12 603 546 194],297,3,9128,4.113564668769716,20.0,0.0
12219,1,2219,[196 257 144  50 235],43,4,9132,4.113513513513514,0.0,20.0
12220,1,2220,[ 64  12 483 427  11],618,5,9137,4.113912651958577,60.0,0.0
12221,1,2221,[405  64 294 471 200],854,3,9140,4.113411341134113,20.0,0.0
12222,1,2222,[ 64  12 483 427  11],618,5,9145,4.113810166441746,60.0,0.0
12223,1,2223,[187  50 151 127  95],198,4,9149,4.113758992805756,0.0,20.0
12224,1,2224,[ 64  12 483 427  11],214,5,9154,4.114157303370787,60.0,0.0
12225,1,2225,[215 301 168 265 216],711,3,9157,4.113656783468104,0.0,0.0
12226,1,2226,[  7 546 742 237  79],416,3,9160,4.113156713066906,0.0,0.0
12227,1,2227,[427 172 423 258 211],698,1,9161,4.111759425493716,0.0,0.0
12228,1,2228,[275 186 546 258 143],43,4,9165,4.111709286675639,0.0,0.0
12229,1,2229,[ 64  12 483 427  11],214,5,9170,4.112107623318385,60.0,0.0
12230,1,2230,[ 64  12 483 427  11],618,5,9175,4.112505602868668,60.0,0.0
12231,1,2231,[ 64  12 483 427  11],214,5,9180,4.112903225806452,60.0,0.0
12232,1,2232,[121 385 228 423 173],505,3,9183,4.112404836542767,0.0,0.0
12233,1,2233,[135 210 597 117 322],417,1,9184,4.111011638316921,0.0,0.0
12234,1,2234,[289 144 286 237 111],588,1,9185,4.109619686800895,0.0,0.0
12235,1,2235,[ 64  12 483 427  11],618,5,9190,4.110017889087657,60.0,0.0
12236,1,2236,[237  15   7 204 302],43,5,9195,4.110415735359857,0.0,0.0
12237,1,2237,[ 64  12 483 427  11],214,5,9200,4.110813226094727,60.0,0.0
12238,1,2238,[ 64  12 483 427  11],214,5,9205,4.111210361768647,60.0,0.0
12239,1,2239,[ 64  12 483 427  11],618,5,9210,4.111607142857143,60.0,0.0
12240,1,2240,[ 64  12 483 427  11],618,5,9215,4.112003569834895,60.0,0.0
12241,1,2241,[483 151 655 186  98],711,4,9219,4.1119536128456735,20.0,20.0
12242,1,2242,[111  95  28 496 196],416,4,9223,4.111903700401248,0.0,0.0
12243,1,2243,[ 64  12 483 427  11],214,5,9228,4.112299465240642,60.0,0.0
12244,1,2244,[ 64  12 483 427  11],214,5,9233,4.112694877505568,60.0,0.0
12245,1,2245,[ 64  12 483 427  11],618,5,9238,4.113089937666963,60.0,0.0
12246,1,2246,[748 235 268 117 286],907,5,9243,4.113484646194927,0.0,0.0
12247,1,2247,[ 64  12 483 427  11],214,5,9248,4.1138790035587185,60.0,0.0
12248,1,2248,[ 64  12 483 427  11],214,5,9253,4.114273010226768,60.0,0.0
12249,1,2249,[ 64  12 483 427  11],214,5,9258,4.1146666666666665,60.0,0.0
12250,1,2250,[ 64  12 483 427  11],214,5,9263,4.11505997334518,60.0,0.0
12251,1,2251,[385 257  69  50  15],43,5,9268,4.1154529307282415,0.0,20.0
12252,1,2252,[357 179 180  96 172],62,5,9273,4.115845539280959,0.0,0.0
12253,1,2253,[215 197 403   1  56],198,5,9278,4.116237799467613,0.0,0.0
12254,1,2254,[216  12 173 195  50],437,4,9282,4.116186252771619,20.0,20.0
12255,1,2255,[ 64  12 483 427  11],214,5,9287,4.116578014184397,60.0,0.0
12256,1,2256,[435 238  70  79  15],437,3,9290,4.1160832964111655,0.0,0.0
12257,1,2257,[135   8   4 195 588],297,3,9293,4.115589016829052,0.0,0.0
12258,1,2258,[ 28 328 143 179 333],416,4,9297,4.115537848605578,0.0,0.0
12259,1,2259,[ 64  12 483 427  11],618,5,9302,4.115929203539823,60.0,0.0
12260,1,2260,[  9 174  98 475  25],805,3,9305,4.115435647943388,0.0,20.0
12261,1,2261,[ 64  12 483 427  11],618,5,9310,4.115826702033599,60.0,0.0
12262,1,2262,[ 70 132  22 423 322],314,4,9314,4.115775519222272,0.0,0.0
12263,1,2263,[179  70  97 333 197],416,4,9318,4.115724381625442,0.0,0.0
12264,1,2264,[117 301  98 153 151],297,4,9322,4.115673289183223,0.0,20.0
12265,1,2265,[ 64  12 483 427  11],214,5,9327,4.116063548102383,60.0,0.0
12266,1,2266,[ 64  12 483 427  11],214,5,9332,4.11645346272607,60.0,0.0
12267,1,2267,[588 174 197 153 143],805,2,9334,4.1155202821869485,0.0,0.0
12268,1,2268,[ 70 318 174  89  28],405,3,9337,4.115028646981049,20.0,0.0
12269,1,2269,[ 22  70 273 135 100],618,4,9341,4.114977973568282,0.0,0.0
12270,1,2270,[ 64  12 483 427  11],618,5,9346,4.115367679436372,60.0,0.0
12271,1,2271,[ 64  12 483 427  11],618,5,9351,4.115757042253521,60.0,0.0
12272,1,2272,[ 64  12 483 427  11],214,5,9356,4.116146062472503,60.0,0.0
12273,1,2273,[ 64  12 483 427  11],618,5,9361,4.116534740545295,60.0,0.0
12274,1,2274,[183 121 294   4  64],417,3,9364,4.116043956043956,20.0,0.0
12275,1,2275,[237 111 313  50 100],654,4,9368,4.115992970123023,20.0,40.0
12276,1,2276,[176  95 168 288 286],297,3,9371,4.11550285463329,0.0,20.0
12277,1,2277,[ 64  12 483 427  11],214,5,9376,4.115891132572432,60.0,0.0
12278,1,2278,[ 64  12 483 427  11],618,5,9381,4.116279069767442,60.0,0.0
12279,1,2279,[  1 276  56 748 195],654,4,9385,4.116228070175438,0.0,0.0
12280,1,2280,[269  95 187 515 268],416,4,9389,4.116177115300307,0.0,0.0
12281,1,2281,[ 64  12 483 427  11],214,5,9394,4.116564417177914,60.0,0.0
12282,1,2282,[ 69 228  97 568 181],198,2,9396,4.115637319316688,0.0,20.0
12283,1,2283,[174 237 210 181 403],588,2,9398,4.114711033274956,0.0,20.0
12284,1,2284,[143 191 515 289  96],416,4,9402,4.1146608315098465,0.0,0.0
12285,1,2285,[ 64  12 483 427  11],214,5,9407,4.1150481189851265,60.0,0.0
12286,1,2286,[ 64  12 483 427  11],214,5,9412,4.115435067774377,60.0,0.0
12287,1,2287,[210 403 179 127   4],62,5,9417,4.115821678321678,0.0,0.0
12288,1,2288,[194 475 301  98 197],416,4,9421,4.1157710790738316,0.0,20.0
12289,1,2289,[ 64  12 483 427  11],214,5,9426,4.1161572052401745,60.0,0.0
12290,1,2290,[118 202 742 215 588],43,5,9431,4.116542994325622,0.0,0.0
12291,1,2291,[ 64  12 483 427  11],214,5,9436,4.116928446771379,60.0,0.0
12292,1,2292,[ 64  12 483 427  11],214,5,9441,4.1173135630178805,60.0,0.0
12293,1,2293,[ 64  12 483 427  11],214,5,9446,4.117698343504795,60.0,0.0
12294,1,2294,[200 385 546 151 271],805,2,9448,4.11677559912854,0.0,0.0
12295,1,2295,[ 64  12 483 427  11],214,5,9453,4.1171602787456445,60.0,0.0
12296,1,2296,[100 603 125 508  96],854,3,9456,4.116673922507618,0.0,0.0
12297,1,2297,[ 12 151 153 275  97],297,4,9460,4.116623150565709,20.0,0.0
12298,1,2298,[ 64  12 483 427  11],618,5,9465,4.117007394519356,60.0,0.0
12299,1,2299,[111 121   1 143 100],751,3,9468,4.116521739130435,0.0,0.0
12300,1,2300,[ 64  12 483 427  11],214,5,9473,4.1169056931768795,60.0,0.0
12301,1,2301,[273 127 508 176   7],854,4,9477,4.116854908774978,0.0,0.0
12302,1,2302,[ 64  12 483 427  11],618,5,9482,4.117238384715589,60.0,0.0
12303,1,2303,[ 64  12 483 427  11],618,5,9487,4.117621527777778,60.0,0.0
12304,1,2304,[ 64  12 483 427  11],214,5,9492,4.118004338394794,60.0,0.0
12305,1,2305,[191 385  15 234 269],416,5,9497,4.1183868169991324,0.0,0.0
12306,1,2306,[228 268 237  97 117],297,4,9501,4.118335500650195,0.0,0.0
12307,1,2307,[143  97 322 181 132],128,2,9503,4.1174176776429805,0.0,20.0
12308,1,2308,[286 222  79 195 121],854,2,9505,4.116500649631876,0.0,0.0
12309,1,2309,[ 97 183 121 111 172],618,4,9509,4.116450216450216,0.0,0.0
12310,1,2310,[273 153 238 405 475],416,4,9513,4.116399826914756,0.0,0.0
12311,1,2311,[ 25 174  28 211 182],416,5,9518,4.116782006920415,0.0,0.0
12312,1,2312,[ 64  12 483 427  11],214,5,9523,4.117163856463467,60.0,0.0
12313,1,2313,[ 11 238  28   1 597],416,4,9527,4.117113223854797,0.0,0.0
12314,1,2314,[173 216 748 268 301],721,4,9531,4.1170626349892006,0.0,0.0
12315,1,2315,[ 64  12 483 427  11],618,5,9536,4.117443868739206,60.0,0.0
12316,1,2316,[153  64 143 185  11],416,5,9541,4.117824773413897,20.0,0.0
12317,1,2317,[191 655 216 202 483],354,2,9543,4.116911130284728,20.0,0.0
12318,1,2318,[ 64  12 483 427  11],214,5,9548,4.117291936179388,60.0,0.0
12319,1,2319,[ 64  12 483 427  11],618,5,9553,4.117672413793104,60.0,0.0
12320,1,2320,[ 64  12 483 427  11],214,5,9558,4.118052563550194,60.0,0.0
12321,1,2321,[ 88 301 196 121 288],416,4,9562,4.1180017226528856,0.0,20.0
12322,1,2322,[ 64  12 483 427  11],214,5,9567,4.118381403357727,60.0,0.0
12323,1,2323,[ 98 508 176  71 215],175,3,9570,4.117900172117039,0.0,20.0
12324,1,2324,[  1  95  12 172 182],416,4,9574,4.117849462365592,20.0,0.0
12325,1,2325,[603 196 423   9 265],416,5,9579,4.11822871883061,0.0,0.0
12326,1,2326,[ 64  12 483 427  11],618,5,9584,4.1186076493339066,60.0,0.0
12327,1,2327,[153 508 258 275 678],654,4,9588,4.118556701030927,0.0,0.0
12328,1,2328,[ 64  12 483 427  11],214,5,9593,4.118935165306999,60.0,0.0
12329,1,2329,[ 64  12 483 427  11],618,5,9598,4.11931330472103,60.0,0.0
12330,1,2330,[ 64  12 483 427  11],618,5,9603,4.11969111969112,60.0,0.0
12331,1,2331,[ 64  12 483 427  11],618,5,9608,4.1200686106346485,60.0,0.0
12332,1,2332,[168  98   7 748 111],417,3,9611,4.119588512644664,0.0,20.0
12333,1,2333,[195  89 286 196  71],373,4,9615,4.119537275064268,0.0,0.0
12334,1,2334,[191  69 405  28 245],345,3,9618,4.119057815845824,0.0,0.0
12335,1,2335,[ 64  12 483 427  11],618,5,9623,4.1194349315068495,60.0,0.0
12336,1,2336,[ 64  12 483 427  11],214,5,9628,4.119811724433034,60.0,0.0
12337,1,2337,[265 385 187 181 288],405,3,9631,4.119332763045338,0.0,40.0
12338,1,2338,[ 64  12 483 427  11],618,5,9636,4.119709277469004,60.0,0.0
12339,1,2339,[ 50 471 322  25 173],921,2,9638,4.118803418803418,0.0,20.0
12340,1,2340,[ 22 121  64 186  88],642,5,9643,4.1191798376762065,20.0,0.0
12341,1,2341,[ 64  12 483 427  11],618,5,9648,4.119555935098207,60.0,0.0
12342,1,2342,[176 197 427 385 135],618,4,9652,4.119504908237302,0.0,0.0
12343,1,2343,[235  28 313 168  96],642,4,9656,4.1194539249146755,20.0,20.0
12344,1,2344,[181 269 294 175 302],297,4,9660,4.119402985074627,0.0,20.0
12345,1,2345,[276  50 237 288 151],203,4,9664,4.119352088661552,0.0,40.0
12346,1,2346,[282 197 135 328 228],721,4,9668,4.1193012356199405,0.0,0.0
12347,1,2347,[271 603 403 143  96],805,3,9671,4.118824531516184,0.0,0.0
12348,1,2348,[568  11  98  79 742],345,5,9676,4.119199659429545,0.0,20.0
12349,1,2349,[121 191 475  79 215],437,2,9678,4.118297872340426,0.0,0.0
12350,1,2350,[ 64  12 483 427  11],214,5,9683,4.118672905146746,60.0,0.0
12351,1,2351,[313  82  79 125  98],588,3,9686,4.118197278911564,20.0,40.0
12352,1,2352,[ 64  12 483 427  11],214,5,9691,4.118572035699107,60.0,0.0
12353,1,2353,[ 64  12 483 427  11],618,5,9696,4.118946474086661,60.0,0.0
12354,1,2354,[ 64  12 483 427  11],214,5,9701,4.11932059447983,60.0,0.0
12355,1,2355,[ 64  12 483 427  11],618,5,9706,4.119694397283531,60.0,0.0
12356,1,2356,[153  64  95 210 269],373,5,9711,4.120067882901994,20.0,0.0
12357,1,2357,[496 151 282  25 100],654,2,9713,4.119168787107719,0.0,0.0
12358,1,2358,[568 174 603 268 333],416,5,9718,4.11954217888936,0.0,0.0
12359,1,2359,[173 294 196 237 210],43,5,9723,4.119915254237288,0.0,0.0
12360,1,2360,[ 64  12 483 427  11],618,5,9728,4.120288013553579,60.0,0.0
12361,1,2361,[ 64  12 483 427  11],618,5,9733,4.1206604572396275,60.0,0.0
12362,1,2362,[ 64  12 483 427  11],214,5,9738,4.121032585696149,60.0,0.0
12363,1,2363,[194 742 182  50 508],297,2,9740,4.120135363790186,0.0,20.0
12364,1,2364,[  1 405 216 196 222],805,2,9742,4.119238900634249,0.0,0.0
12365,1,2365,[ 64  12 483 427  11],214,5,9747,4.119611158072696,60.0,0.0
12366,1,2366,[ 50 186 185 515 496],354,2,9749,4.118715673848754,0.0,20.0
12367,1,2367,[ 64  12 483 427  11],618,5,9754,4.119087837837838,60.0,0.0
12368,1,2368,[ 25 275   9  22 132],618,2,9756,4.118193330519206,0.0,0.0
12369,1,2369,[748 302 174 228 323],721,2,9758,4.117299578059072,0.0,0.0
12370,1,2370,[ 11 385 427 174 403],922,3,9761,4.116828342471531,0.0,0.0
12371,1,2371,[ 96 238 742  22 197],416,5,9766,4.117200674536257,0.0,0.0
12372,1,2372,[333 289  56 121 300],416,4,9770,4.117151285292878,0.0,0.0
12373,1,2373,[ 50 403 111 423 313],49,0,9770,4.11541701769166,20.0,40.0
12374,1,2374,[546 237 269 515  98],416,3,9773,4.114947368421053,0.0,20.0
12375,1,2375,[ 64  12 483 427  11],214,5,9778,4.115319865319865,60.0,0.0
12376,1,2376,[144   7 403 111 546],62,3,9781,4.114850652082457,0.0,0.0
12377,1,2377,[ 64  12 483 427  11],214,5,9786,4.115222876366695,60.0,0.0
12378,1,2378,[176 174 135 546 302],417,1,9787,4.113913408995376,0.0,0.0
12379,1,2379,[405  79 237  64 357],854,4,9791,4.113865546218487,20.0,0.0
12380,1,2380,[ 64  12 483 427  11],618,5,9796,4.114237715245695,60.0,0.0
12381,1,2381,[151  28   4 100 294],654,3,9799,4.11376994122586,0.0,0.0
12382,1,2382,[118 228 235 161  71],805,0,9799,4.112043642467478,0.0,0.0
12383,1,2383,[204 161 215 195 318],416,5,9804,4.1124161073825505,20.0,0.0
12384,1,2384,[ 64  12 483 427  11],618,5,9809,4.112788259958071,60.0,0.0
12385,1,2385,[ 64  12 483 427  11],214,5,9814,4.113160100586756,60.0,0.0
12386,1,2386,[196 143  98 403 132],345,4,9818,4.113112693757855,0.0,20.0
12387,1,2387,[ 64  12 483 427  11],214,5,9823,4.113484087102178,60.0,0.0
12388,1,2388,[323 269   9 161  88],345,3,9826,4.11301799916283,0.0,0.0
12389,1,2389,[ 50  11 313 202 121],618,4,9830,4.112970711297071,20.0,40.0
12390,1,2390,[ 64  12 483 427  11],618,5,9835,4.113341698034295,60.0,0.0
12391,1,2391,[ 64  12 483 427  11],214,5,9840,4.11371237458194,60.0,0.0
12392,1,2392,[ 64  12 483 427  11],618,5,9845,4.114082741328876,60.0,0.0
12393,1,2393,[ 64  12 483 427  11],214,5,9850,4.114452798663325,60.0,0.0
12394,1,2394,[ 64  12 483 427  11],618,5,9855,4.11482254697286,60.0,0.0
12395,1,2395,[ 64  12 483 427  11],618,5,9860,4.115191986644407,60.0,0.0
12396,1,2396,[313 318 603 268 121],416,5,9865,4.115561118064247,40.0,20.0
12397,1,2397,[ 64  12 483 427  11],214,5,9870,4.115929941618015,60.0,0.0
12398,1,2398,[423 275  11 215 286],416,5,9875,4.1162984576907045,0.0,0.0
12399,1,2399,[  8 265  98 678 496],416,4,9879,4.11625,0.0,20.0
12400,1,2400,[ 69 216 238 403 276],62,5,9884,4.11661807580175,0.0,0.0
12401,1,2401,[179 568  64 191 180],62,4,9888,4.116569525395504,20.0,0.0
12402,1,2402,[ 82 435  15 179 385],373,2,9890,4.115688722430296,0.0,0.0
12403,1,2403,[ 64  12 483 427  11],618,5,9895,4.116056572379367,60.0,0.0
12404,1,2404,[ 64  12 483 427  11],618,5,9900,4.116424116424116,60.0,0.0
12405,1,2405,[ 64  12 483 427  11],618,5,9905,4.116791354945969,60.0,0.0
12406,1,2406,[127 273   8 257 111],62,3,9908,4.116327378479435,0.0,0.0
12407,1,2407,[ 64  12 483 427  11],618,5,9913,4.1166943521594686,60.0,0.0
12408,1,2408,[ 64  12 483 427  11],618,5,9918,4.11706102117061,60.0,0.0
12409,1,2409,[196 282  79  22 328],416,5,9923,4.117427385892116,0.0,0.0
12410,1,2410,[  8 228 302 211 183],405,2,9925,4.116549149730402,0.0,0.0
12411,1,2411,[ 64  12 483 427  11],618,5,9930,4.116915422885572,60.0,0.0
12412,1,2412,[228 508 655 403 475],417,3,9933,4.116452548694571,0.0,0.0
12413,1,2413,[271  89   4  98  15],854,3,9936,4.115990057995029,0.0,20.0
12414,1,2414,[ 64  12 483 427  11],618,5,9941,4.116356107660455,60.0,0.0
12415,1,2415,[ 64  12 483 427  11],618,5,9946,4.116721854304636,60.0,0.0
12416,1,2416,[172 302 568 202  28],416,5,9951,4.117087298303682,0.0,0.0
12417,1,2417,[ 64  12 483 427  11],214,5,9956,4.117452440033086,60.0,0.0
12418,1,2418,[172 151  50 179 546],416,2,9958,4.116577097974369,0.0,20.0
12419,1,2419,[216 168 111 144   1],654,5,9963,4.11694214876033,0.0,0.0
12420,1,2420,[174 588  69 385  11],654,5,9968,4.117306897976043,0.0,0.0
12421,1,2421,[ 64  12 483 427  11],214,5,9973,4.117671345995046,60.0,0.0
12422,1,2422,[ 64  12 483 427  11],618,5,9978,4.11803549319026,60.0,0.0
12423,1,2423,[ 15 215 144 174 194],416,5,9983,4.118399339933993,0.0,0.0
12424,1,2424,[  4 286 318 588   7],416,5,9988,4.118762886597938,20.0,0.0
12425,1,2425,[204 265  79  98 357],416,5,9993,4.119126133553174,0.0,20.0
12426,1,2426,[ 64  12 483 427  11],214,5,9998,4.119489081170169,60.0,0.0
12427,1,2427,[ 64  12 483 427  11],618,5,10003,4.119851729818781,60.0,0.0
12428,1,2428,[211 515  11 196   4],405,2,10005,4.1189790037052285,0.0,0.0
12429,1,2429,[288 294   7 258   8],62,3,10008,4.118518518518519,0.0,20.0
12430,1,2430,[182 161 289   7 210],416,4,10012,4.118469765528589,0.0,0.0
12431,1,2431,[ 11 678 276 328 282],416,3,10015,4.118009868421052,0.0,0.0
12432,1,2432,[204   4 174   7 318],618,3,10018,4.117550349362927,20.0,0.0
12433,1,2433,[ 56 185 179 475  95],49,4,10022,4.117502054231718,0.0,0.0
12434,1,2434,[ 64  12 483 427  11],618,5,10027,4.117864476386037,60.0,0.0
12435,1,2435,[176  50 288 435 118],437,1,10028,4.116584564860427,0.0,40.0
12436,1,2436,[ 64  12 483 427  11],214,5,10033,4.116947066064834,60.0,0.0
12437,1,2437,[301 202 173 204 300],49,0,10033,4.1152584085315835,0.0,0.0
12438,1,2438,[ 64  12 483 427  11],214,5,10038,4.115621156211562,60.0,0.0
12439,1,2439,[300 655 423  25 196],198,1,10039,4.114344262295082,0.0,0.0
12440,1,2440,[301  15 276 588 568],416,4,10043,4.114297419090537,0.0,0.0
12441,1,2441,[ 64  12 483 427  11],618,5,10048,4.114660114660115,60.0,0.0
12442,1,2442,[423   4 183 173 196],618,3,10051,4.114203847728203,0.0,0.0
12443,1,2443,[  8 191 238 475 427],711,5,10056,4.114566284779051,0.0,0.0
12444,1,2444,[ 64  12 483 427  11],618,5,10061,4.114928425357873,60.0,0.0
12445,1,2445,[ 64  12 483 427  11],618,5,10066,4.115290269828291,60.0,0.0
12446,1,2446,[ 64  12 483 427  11],618,5,10071,4.115651818553331,60.0,0.0
12447,1,2447,[ 64  12 483 427  11],618,5,10076,4.116013071895424,60.0,0.0
12448,1,2448,[237  22 118  56  70],642,3,10079,4.115557370355247,0.0,0.0
12449,1,2449,[ 64  12 483 427  11],618,5,10084,4.115918367346938,60.0,0.0
12450,1,2450,[215   1 265 191 403],198,4,10088,4.115871073031416,0.0,0.0
12451,1,2451,[127  82 237 655 153],922,2,10090,4.1150081566068515,0.0,0.0
12452,1,2452,[181 403 475 234  71],805,3,10093,4.11455360782715,0.0,20.0
12453,1,2453,[ 64 357 483 168 546],417,4,10097,4.114506927465363,40.0,0.0
12454,1,2454,[ 64  12 483 427  11],618,5,10102,4.114867617107943,60.0,0.0
12455,1,2455,[100  96 125 186 181],417,2,10104,4.11400651465798,0.0,20.0
12456,1,2456,[288 357   9 175 132],342,4,10108,4.113960113960114,0.0,20.0
12457,1,2457,[ 64  12 483 427  11],214,5,10113,4.114320585842148,60.0,0.0
12458,1,2458,[ 64  12 483 427  11],618,5,10118,4.114680764538431,60.0,0.0
12459,1,2459,[405 181 323 183  25],417,1,10119,4.113414634146341,0.0,20.0
12460,1,2460,[ 64  12 483 427  11],214,5,10124,4.113774888256806,60.0,0.0
12461,1,2461,[ 64  12 483 427  11],618,5,10129,4.114134849715678,60.0,0.0
12462,1,2462,[ 56 423 322 174 144],854,2,10131,4.113276492082826,0.0,0.0
12463,1,2463,[118 144  96 151 258],416,3,10134,4.112824675324675,0.0,0.0
12464,1,2464,[568 405 289 245 742],345,3,10137,4.11237322515213,0.0,0.0
12465,1,2465,[127 100 132 222  79],253,5,10142,4.112733171127331,0.0,0.0
12466,1,2466,[ 64  12 483 427  11],618,5,10147,4.113092825293879,60.0,0.0
12467,1,2467,[ 64  12 483 427  11],618,5,10152,4.113452188006483,60.0,0.0
12468,1,2468,[ 64  12 483 427  11],214,5,10157,4.113811259619279,60.0,0.0
12469,1,2469,[185 118 328 202 405],38,3,10160,4.113360323886639,0.0,0.0
12470,1,2470,[195   1 183 181  95],618,3,10163,4.112909753136382,0.0,20.0
12471,1,2471,[216 235 191 318 742],642,2,10165,4.1120550161812295,20.0,0.0
12472,1,2472,[ 64  12 483 427  11],214,5,10170,4.112414071977356,60.0,0.0
12473,1,2473,[ 64  12 483 427  11],618,5,10175,4.112772837510105,60.0,0.0
12474,1,2474,[187  88 238  28 275],373,3,10178,4.112323232323233,0.0,0.0
12475,1,2475,[588  88  71 173  28],437,1,10179,4.111066235864297,0.0,0.0
12476,1,2476,[515 323 475 143 423],416,3,10182,4.110617682680662,0.0,0.0
12477,1,2477,[ 98 496 143 748 265],654,5,10187,4.110976594027441,0.0,20.0
12478,1,2478,[302 100 143  79 235],345,4,10191,4.110931827349738,0.0,0.0
12479,1,2479,[748 275 127  82 187],416,5,10196,4.111290322580645,0.0,0.0
12480,1,2480,[180  56 187 135  64],405,4,10200,4.111245465538089,20.0,0.0
12481,1,2481,[ 64  12 483 427  11],618,5,10205,4.1116035455278,60.0,0.0
12482,1,2482,[153  22 427 202 405],416,5,10210,4.111961337092227,0.0,0.0
12483,1,2483,[202 275 195 194 245],297,1,10211,4.110708534621578,0.0,0.0
12484,1,2484,[143 300  70  97 301],416,5,10216,4.111066398390342,0.0,0.0
12485,1,2485,[125 313 194   9   7],416,5,10221,4.111423974255833,20.0,20.0
12486,1,2486,[ 64  12 483 427  11],618,5,10226,4.11178126256534,60.0,0.0
12487,1,2487,[ 64  12 483 427  11],618,5,10231,4.112138263665595,60.0,0.0
12488,1,2488,[ 64  12 483 427  11],214,5,10236,4.112494977902772,60.0,0.0
12489,1,2489,[ 82   1 121  95 143],416,4,10240,4.112449799196787,0.0,0.0
12490,1,2490,[ 82 100  98 173 323],198,2,10242,4.111601766358892,0.0,20.0
12491,1,2491,[508  28 385 195 100],654,3,10245,4.11115569823435,0.0,0.0
12492,1,2492,[196   4 405 655 172],62,3,10248,4.110709987966306,0.0,0.0
12493,1,2493,[ 64  12 483 427  11],214,5,10253,4.111066559743384,60.0,0.0
12494,1,2494,[ 64  12 483 427  11],618,5,10258,4.111422845691383,60.0,0.0
12495,1,2495,[276  82 216 588 403],922,1,10259,4.110176282051282,0.0,0.0
12496,1,2496,[273 322 144   9 161],805,0,10259,4.10853023628354,0.0,0.0
12497,1,2497,[588 301  88 118 151],43,5,10264,4.108887109687751,0.0,0.0
12498,1,2498,[ 64  12 483 427  11],214,5,10269,4.109243697478991,60.0,0.0
12499,1,2499,[ 64  12 483 427  11],618,5,10274,4.1096,60.0,0.0
12500,1,2500,[ 64  12 483 427  11],214,5,10279,4.109956017592963,60.0,0.0
12501,1,2501,[ 64  12 483 427  11],618,5,10284,4.110311750599521,60.0,0.0
12502,1,2502,[194 176 235 211 245],297,2,10286,4.109468637634838,0.0,0.0
12503,1,2503,[ 64  12 483 427  11],214,5,10291,4.10982428115016,60.0,0.0
12504,1,2504,[ 64  12 483 427  11],214,5,10296,4.110179640718563,60.0,0.0
12505,1,2505,[202  96 132 194 215],921,3,10299,4.109736632083001,0.0,0.0
12506,1,2506,[ 64  12 483 427  11],618,5,10304,4.110091743119266,60.0,0.0
12507,1,2507,[174 222  89  79 313],354,2,10306,4.109250398724083,20.0,20.0
12508,1,2508,[ 64  12 483 427  11],214,5,10311,4.1096054204862495,60.0,0.0
12509,1,2509,[271  25  15  70 289],43,4,10315,4.109561752988048,0.0,0.0
12510,1,2510,[ 64  12 483 427  11],618,5,10320,4.109916367980884,60.0,0.0
12511,1,2511,[ 64  12 483 427  11],214,5,10325,4.110270700636943,60.0,0.0
12512,1,2512,[588 222  95 300 182],253,4,10329,4.110226820533227,0.0,0.0
12513,1,2513,[ 64  12 483 427  11],214,5,10334,4.110580747812252,60.0,0.0
12514,1,2514,[127 568  70 174 215],618,4,10338,4.110536779324056,0.0,0.0
12515,1,2515,[195  69  50 403 258],198,4,10342,4.110492845786964,0.0,20.0
12516,1,2516,[ 64  12 483 427  11],214,5,10347,4.110846245530393,60.0,0.0
12517,1,2517,[196 265 117  12 302],417,3,10350,4.110405083399524,20.0,0.0
12518,1,2518,[294 210 318 222 257],62,3,10353,4.109964271536324,20.0,0.0
12519,1,2519,[655 204  25 117  70],314,3,10356,4.109523809523809,0.0,0.0
12520,1,2520,[ 69 273 161 151 121],417,1,10357,4.10829036096787,0.0,0.0
12521,1,2521,[276 483   4 125 257],342,2,10359,4.107454401268834,20.0,0.0
12522,1,2522,[ 64  12 483 427  11],214,5,10364,4.1078081648830755,60.0,0.0
12523,1,2523,[ 50 202  79 238 300],751,3,10367,4.107369255150554,0.0,20.0
12524,1,2524,[597 172  25 204 265],654,4,10371,4.107326732673267,0.0,0.0
12525,1,2525,[ 64  12 483 427  11],214,5,10376,4.107680126682502,60.0,0.0
12526,1,2526,[161 508  69  25 276],128,4,10380,4.107637514839731,0.0,0.0
12527,1,2527,[  1  69 135 357 655],417,3,10383,4.107199367088608,0.0,0.0
12528,1,2528,[235 172  22 405 257],642,3,10386,4.106761565836299,0.0,0.0
12529,1,2529,[  8 143 215 196 175],297,4,10390,4.106719367588933,0.0,0.0
12530,1,2530,[748  25 132 655 174],416,5,10395,4.107072303437376,0.0,0.0
12531,1,2531,[186 202 176 215 234],405,4,10399,4.107030015797788,0.0,0.0
12532,1,2532,[ 64  12 483 427  11],618,5,10404,4.10738255033557,60.0,0.0
12533,1,2533,[357 294 273  70  97],416,5,10409,4.107734806629834,0.0,0.0
12534,1,2534,[323 245 179 568 403],416,2,10411,4.1069033530571994,0.0,0.0
12535,1,2535,[182  95 238 111  50],49,1,10412,4.105678233438486,0.0,20.0
12536,1,2536,[ 64  12 483 427  11],214,5,10417,4.10603074497438,60.0,0.0
12537,1,2537,[  8 286 655  56 100],342,5,10422,4.1063829787234045,0.0,0.0
12538,1,2538,[ 64  12 483 427  11],618,5,10427,4.106734935013785,60.0,0.0
12539,1,2539,[228   4 286  70 196],297,3,10430,4.106299212598425,0.0,0.0
12540,1,2540,[ 64  12 483 427  11],618,5,10435,4.106650924832743,60.0,0.0
12541,1,2541,[742 182 276  11 215],416,4,10439,4.1066089693154995,0.0,0.0
12542,1,2542,[237 182 144 273 118],416,3,10442,4.106173810460087,0.0,0.0
12543,1,2543,[100 210 588 276  79],230,5,10447,4.106525157232705,0.0,0.0
12544,1,2544,[ 64  12 483 427  11],214,5,10452,4.106876227897839,60.0,0.0
12545,1,2545,[ 64  12 483 427  11],214,5,10457,4.107227022780832,60.0,0.0
12546,1,2546,[ 64  12 483 427  11],214,5,10462,4.107577542206517,60.0,0.0
12547,1,2547,[183 286  98 515 475],417,5,10467,4.107927786499215,0.0,20.0
12548,1,2548,[ 64  12 483 427  11],618,5,10472,4.108277755982738,60.0,0.0
12549,1,2549,[216 191 181 323  71],198,3,10475,4.107843137254902,0.0,20.0
12550,1,2550,[ 64  12 483 427  11],618,5,10480,4.108192865542924,60.0,0.0
12551,1,2551,[496 435 132  95 228],505,3,10483,4.107758620689655,0.0,0.0
12552,1,2552,[ 64  12 483 427  11],618,5,10488,4.108108108108108,60.0,0.0
12553,1,2553,[ 64  12 483 427  11],618,5,10493,4.108457321848081,60.0,0.0
12554,1,2554,[  7 204 742 496  56],314,4,10497,4.108414872798434,0.0,0.0
12555,1,2555,[237 742 271   7 385],505,3,10500,4.107981220657277,0.0,0.0
12556,1,2556,[ 64  12 483 427  11],618,5,10505,4.108330074305827,60.0,0.0
12557,1,2557,[ 11 176 183 228 210],198,4,10509,4.108287724784988,0.0,0.0
12558,1,2558,[ 64  12 483 427  11],214,5,10514,4.10863618601016,60.0,0.0
12559,1,2559,[ 25  15 265 471 118],416,4,10518,4.10859375,0.0,0.0
12560,1,2560,[  4 238 176 403 328],62,4,10522,4.108551347130027,0.0,0.0
12561,1,2561,[313 117 328 546 288],223,3,10525,4.108118657298985,20.0,40.0
12562,1,2562,[ 64  12 483 427  11],618,5,10530,4.1084666406554815,60.0,0.0
12563,1,2563,[ 64  12 483 427  11],618,5,10535,4.108814352574103,60.0,0.0
12564,1,2564,[273 153 191 245 496],417,3,10538,4.108382066276803,0.0,0.0
12565,1,2565,[ 64  12 483 427  11],214,5,10543,4.108729540140296,60.0,0.0
12566,1,2566,[ 64  12 483 427  11],618,5,10548,4.109076743280093,60.0,0.0
12567,1,2567,[161 153  69 187 471],373,3,10551,4.108644859813084,0.0,0.0
12568,1,2568,[ 64 215 144 211 258],43,5,10556,4.108991825613079,20.0,0.0
12569,1,2569,[121 117   9 427 597],618,4,10560,4.108949416342412,0.0,0.0
12570,1,2570,[ 64  12 483 427  11],214,5,10565,4.10929599377674,60.0,0.0
12571,1,2571,[471 282 210 427  56],416,5,10570,4.109642301710731,0.0,0.0
12572,1,2572,[ 64  12 483 427  11],618,5,10575,4.109988340458608,60.0,0.0
12573,1,2573,[ 64  12 483 427  11],214,5,10580,4.110334110334111,60.0,0.0
12574,1,2574,[ 89   1 288  70 168],417,4,10584,4.110291262135922,0.0,20.0
12575,1,2575,[151 328 111  56 202],314,4,10588,4.1102484472049685,0.0,0.0
12576,1,2576,[423  98  11  25 185],297,4,10592,4.110205665502522,0.0,20.0
12577,1,2577,[195 385 215 191 405],705,2,10594,4.109387121799845,0.0,0.0
12578,1,2578,[ 64  12 483 427  11],618,5,10599,4.109732454439706,60.0,0.0
12579,1,2579,[211   4 127 288 234],416,5,10604,4.110077519379845,0.0,20.0
12580,1,2580,[ 64  12 483 427  11],214,5,10609,4.110422316931422,60.0,0.0
12581,1,2581,[ 95 357 471 237 515],297,3,10612,4.109992254066615,0.0,0.0
12582,1,2582,[ 64  12 483 427  11],214,5,10617,4.110336817653891,60.0,0.0
12583,1,2583,[ 69 132  71 265 678],416,4,10621,4.110294117647059,0.0,0.0
12584,1,2584,[ 64  12 483 427  11],618,5,10626,4.110638297872341,60.0,0.0
12585,1,2585,[300 245  69 191   4],297,0,10626,4.109048723897912,0.0,0.0
12586,1,2586,[ 64  12 483 427  11],618,5,10631,4.109393119443371,60.0,0.0
12587,1,2587,[ 64  12 483 427  11],214,5,10636,4.109737248840804,60.0,0.0
12588,1,2588,[ 64  12 483 427  11],618,5,10641,4.11008111239861,60.0,0.0
12589,1,2589,[ 97 483 202  70 191],437,3,10644,4.10965250965251,20.0,0.0
12590,1,2590,[ 15  64 168 597 118],416,3,10647,4.109224237746044,20.0,0.0
12591,1,2591,[ 64  12 483 427  11],618,5,10652,4.109567901234568,60.0,0.0
12592,1,2592,[ 64  12 483 427  11],214,5,10657,4.109911299652912,60.0,0.0
12593,1,2593,[ 64  12 483 427  11],618,5,10662,4.110254433307633,60.0,0.0
12594,1,2594,[174  71 237  15 173],654,3,10665,4.109826589595376,0.0,0.0
12595,1,2595,[275 597  82  79  69],618,4,10669,4.109784283513097,0.0,0.0
12596,1,2596,[ 88  70 427 151 515],416,3,10672,4.1093569503273,0.0,0.0
12597,1,2597,[273 357 568 174 288],630,3,10675,4.1089299461123945,0.0,20.0
12598,1,2598,[186 191 195  15 173],642,4,10679,4.108888033859176,0.0,0.0
12599,1,2599,[ 64  12 483 427  11],618,5,10684,4.109230769230769,60.0,0.0
12600,1,2600,[135 202  79  88 268],354,1,10685,4.10803537101115,0.0,0.0
12601,1,2601,[  4 161 202 423 294],43,5,10690,4.1083781706379705,0.0,0.0
12602,1,2602,[211 427  64 318 161],373,5,10695,4.108720706876681,40.0,0.0
12603,1,2603,[222 300 204 118  15],128,4,10699,4.108678955453149,0.0,0.0
12604,1,2604,[427 195 143 423  98],416,5,10704,4.109021113243762,0.0,20.0
12605,1,2605,[ 64  12 483 427  11],618,5,10709,4.109363008442057,60.0,0.0
12606,1,2606,[181 597   1 318 678],654,4,10713,4.109321058688147,20.0,20.0
12607,1,2607,[ 28 168 496 161 194],373,4,10717,4.109279141104294,0.0,0.0
12608,1,2608,[ 64  12 483 427  11],214,5,10722,4.109620544269835,60.0,0.0
12609,1,2609,[ 64  12 483 427  11],618,5,10727,4.109961685823754,60.0,0.0
12610,1,2610,[301  56   1 211 245],416,4,10731,4.109919571045577,0.0,0.0
12611,1,2611,[ 64 496 258 200 403],416,5,10736,4.110260336906585,20.0,0.0
12612,1,2612,[ 64  12 483 427  11],618,5,10741,4.110600841944126,60.0,0.0
12613,1,2613,[ 64  12 483 427  11],618,5,10746,4.110941086457537,60.0,0.0
12614,1,2614,[588 174 173  97   1],588,3,10749,4.110516252390058,0.0,0.0
12615,1,2615,[143   8 318  71  97],405,3,10752,4.110091743119266,20.0,0.0
12616,1,2616,[742  79  88 174  95],505,4,10756,4.110049675200611,0.0,0.0
12617,1,2617,[318  56 265 333 258],588,5,10761,4.1103896103896105,20.0,0.0
12618,1,2618,[ 64  12 483 427  11],618,5,10766,4.110729285987018,60.0,0.0
12619,1,2619,[403 301 237 196  11],43,5,10771,4.111068702290076,0.0,0.0
12620,1,2620,[ 64  12 483 427  11],214,5,10776,4.111407859595574,60.0,0.0
12621,1,2621,[ 64  12 483 427  11],214,5,10781,4.111746758199847,60.0,0.0
12622,1,2622,[ 97  69 423 748 168],654,4,10785,4.111704155547083,0.0,0.0
12623,1,2623,[216 168  64  15 187],618,3,10788,4.111280487804878,20.0,0.0
12624,1,2624,[ 50 508 276  97  25],354,1,10789,4.110095238095238,0.0,20.0
12625,1,2625,[ 64  12 483 427  11],214,5,10794,4.1104341203351105,60.0,0.0
12626,1,2626,[ 28 289 483   7 151],588,3,10797,4.110011419870575,20.0,0.0
12627,1,2627,[333 215 294 313 276],416,4,10801,4.109969558599696,20.0,20.0
12628,1,2628,[ 64  12 483 427  11],618,5,10806,4.110308101939901,60.0,0.0
12629,1,2629,[ 64  12 483 427  11],618,5,10811,4.110646387832699,60.0,0.0
12630,1,2630,[ 64  12 483 427  11],618,5,10816,4.110984416571646,60.0,0.0
12631,1,2631,[172 496   9 475 196],601,4,10820,4.1109422492401215,0.0,0.0
12632,1,2632,[186 597   7 194 237],854,1,10821,4.109760729206228,0.0,0.0
12633,1,2633,[301 258 186  25 496],711,4,10825,4.109719058466211,0.0,0.0
12634,1,2634,[204 121 196 216 235],345,3,10828,4.1092979127134726,0.0,0.0
12635,1,2635,[678 235 273 403 180],805,2,10830,4.108497723823976,0.0,0.0
12636,1,2636,[588 275 603 238  95],297,4,10834,4.10845657944634,0.0,0.0
12637,1,2637,[271 318  28 423 275],43,4,10838,4.10841546626232,20.0,0.0
12638,1,2638,[ 64  12 483 427  11],214,5,10843,4.108753315649867,60.0,0.0
12639,1,2639,[323 161   4 173 127],198,2,10845,4.107954545454546,0.0,0.0
12640,1,2640,[  1 678 125 181 289],721,2,10847,4.10715638015903,0.0,20.0
12641,1,2641,[ 64  12 483 427  11],214,5,10852,4.107494322482967,60.0,0.0
12642,1,2642,[546  28 118 174 151],43,5,10857,4.107832009080591,0.0,0.0
12643,1,2643,[ 69 176 180 172 202],405,3,10860,4.107413010590015,0.0,0.0
12644,1,2644,[ 64  12 483 427  11],618,5,10865,4.107750472589792,60.0,0.0
12645,1,2645,[ 50 135 423 179 228],805,3,10868,4.107331821617536,0.0,20.0
12646,1,2646,[  7 228 180  50 183],417,2,10870,4.106535700793351,0.0,20.0
12647,1,2647,[ 97 508  50 483  15],417,3,10873,4.106117824773414,20.0,20.0
12648,1,2648,[471   9  95  22 496],416,4,10877,4.106077765194413,0.0,0.0
12649,1,2649,[ 98 186  64 282 100],854,3,10880,4.1056603773584905,20.0,20.0
12650,1,2650,[ 64  12 483 427  11],618,5,10885,4.105997736703131,60.0,0.0
12651,1,2651,[144 191 597 183  22],62,3,10888,4.105580693815988,0.0,0.0
12652,1,2652,[215 228 271 423 196],62,1,10889,4.104410101771579,0.0,0.0
12653,1,2653,[  1 597 282 546 245],416,2,10891,4.10361718161266,0.0,0.0
12654,1,2654,[546 191 181 143 151],416,3,10894,4.103201506591337,0.0,20.0
12655,1,2655,[ 64  12 483 427  11],618,5,10899,4.103539156626506,60.0,0.0
12656,1,2656,[265  15  79 258 215],128,3,10902,4.103123823861498,0.0,0.0
12657,1,2657,[202 294 168 742 405],805,1,10903,4.101956358164033,0.0,0.0
12658,1,2658,[385  22 471 237  79],416,4,10907,4.101918014291087,0.0,0.0
12659,1,2659,[ 82 300 655 191 234],198,2,10909,4.101127819548872,0.0,0.0
12660,1,2660,[300  64 238 282 508],345,3,10912,4.100714017286735,20.0,0.0
12661,1,2661,[ 64  12 483 427  11],618,5,10917,4.101051840721262,60.0,0.0
12662,1,2662,[508   7  22  25  56],854,3,10920,4.100638377769433,0.0,0.0
12663,1,2663,[ 64  12 483 427  11],618,5,10925,4.100975975975976,60.0,0.0
12664,1,2664,[269 276 173 268 216],416,4,10929,4.10093808630394,0.0,0.0
12665,1,2665,[197  25 202  82 301],751,4,10933,4.1009002250562645,0.0,0.0
12666,1,2666,[185 216 173 265 471],416,5,10938,4.101237345331834,0.0,0.0
12667,1,2667,[ 64  12 483 427  11],214,5,10943,4.101574212893553,60.0,0.0
12668,1,2668,[ 64  12 483 427  11],214,5,10948,4.101910828025478,60.0,0.0
12669,1,2669,[ 89 385 508 121 151],417,3,10951,4.1014981273408235,0.0,0.0
12670,1,2670,[ 64  12 483 427  11],214,5,10956,4.101834518906776,60.0,0.0
12671,1,2671,[ 64  12 483 427  11],618,5,10961,4.102170658682635,60.0,0.0
12672,1,2672,[597  12 235  22 153],805,2,10963,4.101384212495324,20.0,0.0
12673,1,2673,[195 174  15 127  82],373,3,10966,4.100972326103216,0.0,0.0
12674,1,2674,[ 64  12 483 427  11],618,5,10971,4.101308411214953,60.0,0.0
12675,1,2675,[ 64  12 483 427  11],214,5,10976,4.101644245142003,60.0,0.0
12676,1,2676,[210 228   1 118  71],805,1,10977,4.100485618229361,0.0,0.0
12677,1,2677,[174 286  28 183  88],416,4,10981,4.100448095593727,0.0,0.0
12678,1,2678,[ 22 175 603   1 471],854,2,10983,4.0996640537513995,0.0,0.0
12679,1,2679,[ 64  12 483 427  11],214,5,10988,4.1,60.0,0.0
12680,1,2680,[483 181 275  97 748],437,4,10992,4.099962700484894,20.0,20.0
12681,1,2681,[271 237  12 286 302],43,4,10996,4.0999254287844895,20.0,0.0
12682,1,2682,[180  96 175  70  79],198,1,10997,4.09877003354454,0.0,0.0
12683,1,2683,[257 318 118  28  71],223,4,11001,4.098733233979136,20.0,0.0
12684,1,2684,[ 64  12 483 427  11],618,5,11006,4.099068901303538,60.0,0.0
12685,1,2685,[ 64  12 483 427  11],214,5,11011,4.099404318689501,60.0,0.0
12686,1,2686,[ 64  12 483 427  11],214,5,11016,4.099739486416078,60.0,0.0
12687,1,2687,[ 64  12 483 427  11],618,5,11021,4.100074404761905,60.0,0.0
12688,1,2688,[ 64  12 483 427  11],618,5,11026,4.100409074005206,60.0,0.0
12689,1,2689,[ 25 151 182 313 143],416,4,11030,4.100371747211896,20.0,20.0
12690,1,2690,[228 176 161  56  15],198,2,11032,4.099591230026013,0.0,0.0
12691,1,2691,[ 64  12 483 427  11],214,5,11037,4.099925705794948,60.0,0.0
12692,1,2692,[ 64  12 483 427  11],618,5,11042,4.100259933160045,60.0,0.0
12693,1,2693,[  1 748  12 121 183],805,3,11045,4.099851521900519,20.0,0.0
12694,1,2694,[ 64  12 483 427  11],214,5,11050,4.100185528756957,60.0,0.0
12695,1,2695,[ 64  12 483 427  11],214,5,11055,4.100519287833828,60.0,0.0
12696,1,2696,[  1 143 588 168 100],43,5,11060,4.1008527994067485,0.0,0.0
12697,1,2697,[ 64  12 483 427  11],214,5,11065,4.1011860637509265,60.0,0.0
12698,1,2698,[ 64  12 483 427  11],214,5,11070,4.101519081141164,60.0,0.0
12699,1,2699,[ 64  12 483 427  11],618,5,11075,4.101851851851852,60.0,0.0
12700,1,2700,[323 258 235   4 302],345,3,11078,4.101443909663088,0.0,0.0
12701,1,2701,[ 64  12 483 427  11],214,5,11083,4.101776461880089,60.0,0.0
12702,1,2702,[168 405 215  69 202],416,5,11088,4.102108768035516,0.0,0.0
12703,1,2703,[  1 210 216 546   9],62,4,11092,4.10207100591716,0.0,0.0
12704,1,2704,[ 64  12 483 427  11],618,5,11097,4.102402957486137,60.0,0.0
12705,1,2705,[ 64  12 483 427  11],214,5,11102,4.102734663710273,60.0,0.0
12706,1,2706,[655 302 135 323 515],417,2,11104,4.101957886959734,0.0,0.0
12707,1,2707,[ 64  12 483 427  11],618,5,11109,4.102289512555392,60.0,0.0
12708,1,2708,[ 11 508 238 180 151],24,5,11114,4.1026208933185675,0.0,0.0
12709,1,2709,[275 678 322 194 385],416,3,11117,4.102214022140221,0.0,0.0
12710,1,2710,[ 64  12 483 427  11],214,5,11122,4.102545186278126,60.0,0.0
12711,1,2711,[ 88 117 313 237 111],345,5,11127,4.102876106194691,20.0,20.0
12712,1,2712,[ 64  12 483 427  11],214,5,11132,4.103206782159971,60.0,0.0
12713,1,2713,[ 64  12 483 427  11],618,5,11137,4.103537214443626,60.0,0.0
12714,1,2714,[ 22 173 111 403 597],588,3,11140,4.1031307550644565,0.0,0.0
12715,1,2715,[ 64  12 483 427  11],618,5,11145,4.103460972017673,60.0,0.0
12716,1,2716,[196 302 275 748 678],297,3,11148,4.103054839896945,0.0,0.0
12717,1,2717,[300  97 118 294 144],297,1,11149,4.1019131714495956,0.0,0.0
12718,1,2718,[210   1 403 187 143],618,4,11153,4.101875689591762,0.0,0.0
12719,1,2719,[222  69 168 144 475],854,4,11157,4.101838235294117,0.0,0.0
12720,1,2720,[475 258 215   7 333],588,3,11160,4.1014332965821385,0.0,0.0
12721,1,2721,[ 64  12 483 427  11],214,5,11165,4.101763409257899,60.0,0.0
12722,1,2722,[ 64  12 483 427  11],214,5,11170,4.1020932794711715,60.0,0.0
12723,1,2723,[ 95 271 121  11 197],805,1,11171,4.1009544787077825,0.0,0.0
12724,1,2724,[258 191  71 161 318],345,3,11174,4.100550458715596,20.0,0.0
12725,1,2725,[ 64  12 483 427  11],618,5,11179,4.100880410858401,60.0,0.0
12726,1,2726,[ 64  12 483 427  11],214,5,11184,4.101210121012101,60.0,0.0
12727,1,2727,[215 471  28 211 127],43,4,11188,4.10117302052786,0.0,0.0
12728,1,2728,[471  25 143 403 286],373,1,11189,4.100036643459142,0.0,0.0
12729,1,2729,[185   1 403 181   4],49,1,11190,4.0989010989010985,0.0,20.0
12730,1,2730,[182 168 515 118 237],416,3,11193,4.098498718418162,0.0,0.0
12731,1,2731,[ 64  12 483 427  11],618,5,11198,4.098828696925329,60.0,0.0
12732,1,2732,[161  82 655 197 568],751,1,11199,4.097694840834248,0.0,0.0
12733,1,2733,[ 82 286  70 202 435],373,2,11201,4.096927578639356,0.0,0.0
12734,1,2734,[323 282 195 174 258],630,2,11203,4.096160877513711,0.0,0.0
12735,1,2735,[ 64  12 483 427  11],618,5,11208,4.0964912280701755,60.0,0.0
12736,1,2736,[ 64  12 483 427  11],214,5,11213,4.096821337230544,60.0,0.0
12737,1,2737,[ 64  12 483 427  11],214,5,11218,4.097151205259314,60.0,0.0
12738,1,2738,[ 64  12 483 427  11],618,5,11223,4.097480832420591,60.0,0.0
12739,1,2739,[ 64  12 483 427  11],618,5,11228,4.097810218978102,60.0,0.0
12740,1,2740,[ 64  12 483 427  11],618,5,11233,4.098139365195184,60.0,0.0
12741,1,2741,[153 302 173 655 118],416,4,11237,4.098103574033552,0.0,0.0
12742,1,2742,[ 64  12 483 427  11],618,5,11242,4.09843237331389,60.0,0.0
12743,1,2743,[174  25 288 211 258],417,2,11244,4.097667638483965,0.0,20.0
12744,1,2744,[  8 210  56 568 475],416,4,11248,4.097632058287796,0.0,0.0
12745,1,2745,[ 64 176  12 328   7],62,4,11252,4.097596504005827,40.0,0.0
12746,1,2746,[183 179 483  71  82],601,3,11255,4.097196942118675,20.0,0.0
12747,1,2747,[ 98  28  69  64 423],405,5,11260,4.097525473071324,20.0,20.0
12748,1,2748,[ 64  12 483 427  11],618,5,11265,4.097853765005457,60.0,0.0
12749,1,2749,[ 12 181 245  95 268],417,4,11269,4.097818181818182,20.0,20.0
12750,1,2750,[  4 117 357 323 153],416,4,11273,4.097782624500182,0.0,0.0
12751,1,2751,[ 64  12 483 427  11],618,5,11278,4.098110465116279,60.0,0.0
12752,1,2752,[  1 289 174 588 132],345,2,11280,4.097348347257538,0.0,0.0
12753,1,2753,[ 64  12 483 427  11],214,5,11285,4.097676107480029,60.0,0.0
12754,1,2754,[ 64  12 483 427  11],618,5,11290,4.098003629764065,60.0,0.0
12755,1,2755,[174 127 228 204 403],805,1,11291,4.096879535558781,0.0,0.0
12756,1,2756,[ 64  12 483 427  11],214,5,11296,4.097207109176641,60.0,0.0
12757,1,2757,[ 64  12 483 427  11],618,5,11301,4.097534445250181,60.0,0.0
12758,1,2758,[ 64  12 483 427  11],618,5,11306,4.097861544037695,60.0,0.0
12759,1,2759,[ 64  12 483 427  11],618,5,11311,4.098188405797101,60.0,0.0
12760,1,2760,[ 64  12 483 427  11],618,5,11316,4.098515030785947,60.0,0.0
12761,1,2761,[195 181  15 288 282],618,1,11317,4.097393193338161,0.0,40.0
12762,1,2762,[ 64  12 483 427  11],214,5,11322,4.09771986970684,60.0,0.0
12763,1,2763,[ 64  12 483 427  11],214,5,11327,4.098046309696093,60.0,0.0
12764,1,2764,[ 71 323 742  22 172],805,2,11329,4.097287522603978,0.0,0.0
12765,1,2765,[294 195 385 234  25],416,5,11334,4.097613882863341,0.0,0.0
12766,1,2766,[ 82   4 185 176 125],417,3,11337,4.097217202746657,0.0,0.0
12767,1,2767,[173 288 151 273  79],805,3,11340,4.0968208092485545,0.0,20.0
12768,1,2768,[196 121 323 276  98],43,4,11344,4.096785843264716,0.0,20.0
12769,1,2769,[289  50 301 508 286],324,5,11349,4.0971119133574,0.0,20.0
12770,1,2770,[234 302   4  15 121],345,4,11353,4.097076867556838,0.0,0.0
12771,1,2771,[144 161 385 173 258],805,1,11354,4.095959595959596,0.0,0.0
12772,1,2772,[ 64  12 483 427  11],214,5,11359,4.096285611251353,60.0,0.0
12773,1,2773,[268  11 181 175  89],297,5,11364,4.09661139149243,0.0,20.0
12774,1,2774,[ 64  12 483 427  11],214,5,11369,4.096936936936937,60.0,0.0
12775,1,2775,[ 64  12 483 427  11],214,5,11374,4.097262247838617,60.0,0.0
12776,1,2776,[ 64  12 483 427  11],618,5,11379,4.0975873244508465,60.0,0.0
12777,1,2777,[313 117 588 333 301],416,5,11384,4.097912167026638,20.0,20.0
12778,1,2778,[ 82  79 181 196 286],437,3,11387,4.097517092479309,0.0,20.0
12779,1,2779,[182 302 185 655 111],416,5,11392,4.097841726618705,0.0,0.0
12780,1,2780,[ 64  12 483 427  11],618,5,11397,4.098166127292341,60.0,0.0
12781,1,2781,[161 127 483 405 118],417,3,11400,4.097771387491013,20.0,0.0
12782,1,2782,[168 475  22 183 471],416,4,11404,4.097736255839022,0.0,0.0
12783,1,2783,[ 50 257 268 144  97],416,4,11408,4.097701149425287,0.0,20.0
12784,1,2784,[678 294 483 496 125],588,2,11410,4.096947935368043,20.0,0.0
12785,1,2785,[ 15 515  12 180  25],417,4,11414,4.096913137114142,20.0,0.0
12786,1,2786,[ 71 483 288  97  88],588,4,11418,4.096878363832078,20.0,20.0
12787,1,2787,[100  28 174 313 111],751,3,11421,4.09648493543759,20.0,20.0
12788,1,2788,[302 117 313  56 185],416,5,11426,4.096808892076013,20.0,20.0
12789,1,2789,[313 216  82   8 121],416,5,11431,4.097132616487455,20.0,20.0
12790,1,2790,[ 25 117 191 546  64],417,3,11434,4.096739519885346,20.0,0.0
12791,1,2791,[ 64  12 483 427  11],618,5,11439,4.097063037249284,60.0,0.0
12792,1,2792,[ 64  12 483 427  11],214,5,11444,4.097386322950233,60.0,0.0
12793,1,2793,[ 64  12 483 427  11],618,5,11449,4.097709377236936,60.0,0.0
12794,1,2794,[125   4 483  96  56],62,5,11454,4.098032200357782,20.0,0.0
12795,1,2795,[ 64  12 483 427  11],214,5,11459,4.0983547925608015,60.0,0.0
12796,1,2796,[ 64  12 483 427  11],618,5,11464,4.0986771540936715,60.0,0.0
12797,1,2797,[111 118 546  56 215],654,4,11468,4.098641887062187,0.0,0.0
12798,1,2798,[ 88  28 265 597  97],588,4,11472,4.098606645230439,0.0,0.0
12799,1,2799,[ 64  12 483 427  11],618,5,11477,4.098928571428571,60.0,0.0
12800,1,2800,[ 64  12 483 427  11],618,5,11482,4.099250267761514,60.0,0.0
12801,1,2801,[288 301  69 197 204],711,2,11484,4.098501070663811,0.0,20.0
12802,1,2802,[202 748 234 597 742],805,1,11485,4.097395647520513,0.0,0.0
12803,1,2803,[ 95 403 597 655 475],416,2,11487,4.096647646219687,0.0,0.0
12804,1,2804,[257  56 234 282 118],270,3,11490,4.096256684491979,0.0,0.0
12805,1,2805,[ 64  12 483 427  11],618,5,11495,4.096578759800428,60.0,0.0
12806,1,2806,[ 82 294 748 423  97],642,4,11499,4.096544353402209,0.0,0.0
12807,1,2807,[ 64  12 483 427  11],214,5,11504,4.096866096866097,60.0,0.0
12808,1,2808,[423 234  98 238  97],405,4,11508,4.096831612673549,0.0,20.0
12809,1,2809,[ 50 234 216 185  22],618,4,11512,4.096797153024911,0.0,20.0
12810,1,2810,[323 273  70 176 191],417,3,11515,4.096406972607613,0.0,0.0
12811,1,2811,[135 187  28  25  79],618,4,11519,4.096372688477952,0.0,0.0
12812,1,2812,[ 64  12 483 427  11],214,5,11524,4.096693921080697,60.0,0.0
12813,1,2813,[ 64  12 483 427  11],618,5,11529,4.097014925373134,60.0,0.0
12814,1,2814,[ 64  12 483 427  11],214,5,11534,4.097335701598579,60.0,0.0
12815,1,2815,[111 238 132  82 204],62,3,11537,4.0969460227272725,0.0,0.0
12816,1,2816,[403   8 222 568  70],43,5,11542,4.097266595669152,0.0,0.0
12817,1,2817,[ 64  12 483 427  11],618,5,11547,4.097586941092974,60.0,0.0
12818,1,2818,[ 64  12 483 427  11],618,5,11552,4.097907059240866,60.0,0.0
12819,1,2819,[385  12 328 403 597],43,4,11556,4.097872340425532,20.0,0.0
12820,1,2820,[ 89 568 210 161 173],417,2,11558,4.097128677773839,0.0,0.0
12821,1,2821,[427 288 118 385 197],618,2,11560,4.096385542168675,0.0,20.0
12822,1,2822,[ 64  12 483 427  11],214,5,11565,4.096705632306057,60.0,0.0
12823,1,2823,[423 357  96  22 235],854,2,11567,4.095963172804533,0.0,0.0
12824,1,2824,[ 50 181 211 125  15],416,5,11572,4.096283185840708,0.0,40.0
12825,1,2825,[ 28  25 202 269 144],416,5,11577,4.09660297239915,0.0,0.0
12826,1,2826,[ 64  12 483 427  11],214,5,11582,4.096922532720198,60.0,0.0
12827,1,2827,[ 64  12 483 427  11],214,5,11587,4.097241867043847,60.0,0.0
12828,1,2828,[471 257 132 222 405],854,3,11590,4.096854012018381,0.0,0.0
12829,1,2829,[288 271 179 294 597],805,1,11591,4.095759717314488,0.0,20.0
12830,1,2830,[275 568 111 187 176],416,5,11596,4.096079123984458,0.0,0.0
12831,1,2831,[ 25 143 173 294 678],588,4,11600,4.096045197740113,0.0,0.0
12832,1,2832,[ 64  12 483 427  11],618,5,11605,4.096364278150371,60.0,0.0
12833,1,2833,[182 222  97  89 423],62,3,11608,4.095977417078334,0.0,0.0
12834,1,2834,[ 28 588 288 183 118],618,3,11611,4.095590828924162,0.0,20.0
12835,1,2835,[143 215 228 588  56],405,3,11614,4.095204513399154,0.0,0.0
12836,1,2836,[222 323 117 179  11],805,3,11617,4.094818470215015,0.0,0.0
12837,1,2837,[403 289 333 187  56],416,4,11621,4.094785059901339,0.0,0.0
12838,1,2838,[ 64  12 483 427  11],214,5,11626,4.095103909827404,60.0,0.0
12839,1,2839,[655 258  12 180 588],417,4,11630,4.095070422535211,20.0,0.0
12840,1,2840,[328 200 318 180 268],854,3,11633,4.094684970080958,20.0,0.0
12841,1,2841,[  9 117  11 180 286],24,5,11638,4.095003518648839,0.0,0.0
12842,1,2842,[ 11  56 245 121  64],416,4,11642,4.0949701020049245,20.0,0.0
12843,1,2843,[ 64  12 483 427  11],214,5,11647,4.0952883263009845,60.0,0.0
12844,1,2844,[  8 471 100 475 191],854,4,11651,4.095254833040422,0.0,0.0
12845,1,2845,[ 28  88 275 200 215],437,2,11653,4.09451862262825,0.0,0.0
12846,1,2846,[215 117 597  64 568],43,4,11657,4.0944854232525465,20.0,0.0
12847,1,2847,[168 197  12 275 144],437,3,11660,4.094101123595506,20.0,0.0
12848,1,2848,[ 64  12 483 427  11],214,5,11665,4.094419094419094,60.0,0.0
12849,1,2849,[211 301 180 286 172],437,3,11668,4.094035087719298,0.0,0.0
12850,1,2850,[ 64  12 483 427  11],214,5,11673,4.094352858646089,60.0,0.0
12851,1,2851,[ 64  12 483 427  11],618,5,11678,4.094670406732118,60.0,0.0
12852,1,2852,[ 64  12 483 427  11],214,5,11683,4.094987732211707,60.0,0.0
12853,1,2853,[286 144 603 176 405],854,2,11685,4.094253679046951,0.0,0.0
12854,1,2854,[ 71 385 215  50  95],416,4,11689,4.094220665499124,0.0,20.0
12855,1,2855,[172 127 181 117 174],805,1,11690,4.0931372549019605,0.0,20.0
12856,1,2856,[191 173 125 151  28],416,4,11694,4.093104655232762,0.0,0.0
12857,1,2857,[111 151 118  79 515],297,1,11695,4.092022393282015,0.0,0.0
12858,1,2858,[ 64  12 483 427  11],214,5,11700,4.092339979013641,60.0,0.0
12859,1,2859,[ 64  12 483 427  11],214,5,11705,4.0926573426573425,60.0,0.0
12860,1,2860,[175  15  79  64 185],854,4,11709,4.092624956308983,20.0,0.0
12861,1,2861,[172  22 427 191 385],642,4,11713,4.092592592592593,0.0,0.0
12862,1,2862,[ 64  12 483 427  11],214,5,11718,4.092909535452323,60.0,0.0
12863,1,2863,[ 15 186 202 423 234],642,2,11720,4.092178770949721,0.0,0.0
12864,1,2864,[318 111  79  15  25],345,4,11724,4.092146596858639,20.0,0.0
12865,1,2865,[ 82 143 111  56  97],654,4,11728,4.092114445219819,0.0,0.0
12866,1,2866,[ 64  12 483 427  11],618,5,11733,4.092431112661319,60.0,0.0
12867,1,2867,[597 273 210 125 322],417,1,11734,4.091352859135286,0.0,0.0
12868,1,2868,[ 64  12 483 427  11],214,5,11739,4.0916695712791915,60.0,0.0
12869,1,2869,[294 121 127 568 179],214,4,11743,4.091637630662021,0.0,0.0
12870,1,2870,[175   1 289  15 403],43,4,11747,4.091605712295367,0.0,0.0
12871,1,2871,[187 483 302  12 100],214,5,11752,4.091922005571031,40.0,0.0
12872,1,2872,[ 64  12 483 427  11],618,5,11757,4.092238078663418,60.0,0.0
12873,1,2873,[153 357 475 143 483],601,4,11761,4.092205984690327,20.0,0.0
12874,1,2874,[202 471 161  98 423],128,4,11765,4.092173913043478,0.0,20.0
12875,1,2875,[186 313 173 185  69],711,2,11767,4.09144645340751,20.0,20.0
12876,1,2876,[ 64  12 483 427  11],618,5,11772,4.091762252346194,60.0,0.0
12877,1,2877,[ 64  12 483 427  11],214,5,11777,4.092077831827658,60.0,0.0
12878,1,2878,[  8 202 144 496  15],437,4,11781,4.092045849253213,0.0,0.0
12879,1,2879,[121 211 289  15 153],416,4,11785,4.092013888888889,0.0,0.0
12880,1,2880,[ 64  12 483 427  11],618,5,11790,4.092329052412357,60.0,0.0
12881,1,2881,[ 64  12 483 427  11],214,5,11795,4.09264399722415,60.0,0.0
12882,1,2882,[ 64  12 483 427  11],214,5,11800,4.092958723551856,60.0,0.0
12883,1,2883,[ 50 257 228 173 175],297,3,11803,4.092579750346741,0.0,20.0
12884,1,2884,[ 64  12 483 427  11],618,5,11808,4.092894280762565,60.0,0.0
12885,1,2885,[181 265  28 234 117],618,5,11813,4.093208593208593,0.0,20.0
12886,1,2886,[200 191 100  69 568],262,2,11815,4.092483546934534,0.0,0.0
12887,1,2887,[ 64  12 483 427  11],214,5,11820,4.092797783933518,60.0,0.0
12888,1,2888,[ 64  12 483 427  11],214,5,11825,4.093111803392177,60.0,0.0
12889,1,2889,[ 15 181 179 186 483],601,4,11829,4.0930795847750865,20.0,20.0
12890,1,2890,[185 151 172  12 173],805,5,11834,4.093393289519198,20.0,0.0
12891,1,2891,[183   7 273  69 117],417,2,11836,4.092669432918395,0.0,0.0
12892,1,2892,[597 385 127 286  28],416,4,11840,4.092637400622191,0.0,0.0
12893,1,2893,[ 12 168  97 179 200],417,5,11845,4.092950932964754,20.0,0.0
12894,1,2894,[ 64  12 483 427  11],214,5,11850,4.0932642487046635,60.0,0.0
12895,1,2895,[ 64  12 483 427  11],618,5,11855,4.093577348066298,60.0,0.0
12896,1,2896,[202 276 151 118  25],764,2,11857,4.09285467725233,0.0,0.0
12897,1,2897,[ 64  12 483 427  11],214,5,11862,4.093167701863354,60.0,0.0
12898,1,2898,[211 496 471 181 204],43,4,11866,4.093135563987582,0.0,20.0
12899,1,2899,[282 100 235 121   7],416,4,11870,4.093103448275862,0.0,0.0
12900,1,2900,[ 25 144  71 173 258],588,4,11874,4.093071354705274,0.0,0.0
12901,1,2901,[ 64  12 483 427  11],618,5,11879,4.093383873190903,60.0,0.0
12902,1,2902,[182  50 385 215  88],416,4,11883,4.093351705132622,0.0,20.0
12903,1,2903,[ 64  12 483 427  11],214,5,11888,4.09366391184573,60.0,0.0
12904,1,2904,[ 64  12 483 427  11],618,5,11893,4.093975903614457,60.0,0.0
12905,1,2905,[ 64  12 483 427  11],618,5,11898,4.094287680660702,60.0,0.0
12906,1,2906,[ 64  12 483 427  11],618,5,11903,4.094599243206054,60.0,0.0
12907,1,2907,[ 11 405 187   7 196],416,5,11908,4.094910591471802,0.0,0.0
12908,1,2908,[174 333 742 197 185],416,5,11913,4.095221725678927,0.0,0.0
12909,1,2909,[ 64  12 483 427  11],214,5,11918,4.09553264604811,60.0,0.0
12910,1,2910,[180 161  79 258 153],417,3,11921,4.095156303675712,0.0,0.0
12911,1,2911,[ 69 216  79 235 288],416,4,11925,4.095123626373627,0.0,20.0
12912,1,2912,[175 235 176   8 269],930,1,11926,4.094061105389633,0.0,0.0
12913,1,2913,[ 64  12 483 427  11],618,5,11931,4.094371997254632,60.0,0.0
12914,1,2914,[ 64  12 483 427  11],214,5,11936,4.094682675814751,60.0,0.0
12915,1,2915,[ 64  12 483 427  11],618,5,11941,4.094993141289438,60.0,0.0
12916,1,2916,[ 64  12 483 427  11],214,5,11946,4.09530339389784,60.0,0.0
12917,1,2917,[ 64  12 483 427  11],214,5,11951,4.095613433858808,60.0,0.0
12918,1,2918,[211 200  97 197 191],437,4,11955,4.095580678314492,0.0,0.0
12919,1,2919,[204 475 210 294 282],297,2,11957,4.09486301369863,0.0,0.0
12920,1,2920,[ 64  12 483 427  11],214,5,11962,4.095172885997946,60.0,0.0
12921,1,2921,[ 64  12 483 427  11],618,5,11967,4.095482546201232,60.0,0.0
12922,1,2922,[ 64  12 483 427  11],618,5,11972,4.095791994526172,60.0,0.0
12923,1,2923,[ 64  12 483 427  11],618,5,11977,4.096101231190151,60.0,0.0
12924,1,2924,[173 427 117 168 275],618,3,11980,4.095726495726495,0.0,0.0
12925,1,2925,[ 64  12 483 427  11],214,5,11985,4.096035543403964,60.0,0.0
12926,1,2926,[118 515 288 286 196],417,4,11989,4.096002733173898,0.0,20.0
12927,1,2927,[ 64  12 483 427  11],618,5,11994,4.096311475409836,60.0,0.0
12928,1,2928,[132 423 318 294 289],887,4,11998,4.096278593376579,20.0,0.0
12929,1,2929,[ 28  64 118 300  12],345,2,12000,4.09556313993174,40.0,0.0
12930,1,2930,[ 64  12 483 427  11],214,5,12005,4.095871716137837,60.0,0.0
12931,1,2931,[ 64  12 483 427  11],214,5,12010,4.096180081855389,60.0,0.0
12932,1,2932,[ 64  12 483 427  11],618,5,12015,4.096488237299694,60.0,0.0
12933,1,2933,[483 121  12 135 286],417,3,12018,4.0961145194274025,40.0,0.0
12934,1,2934,[  1  11 121  25 588],230,4,12022,4.0960817717206135,0.0,0.0
12935,1,2935,[ 64  12 483 427  11],214,5,12027,4.096389645776567,60.0,0.0
12936,1,2936,[ 64  12 483 427  11],214,5,12032,4.096697310180456,60.0,0.0
12937,1,2937,[ 64  12 483 427  11],214,5,12037,4.097004765146358,60.0,0.0
12938,1,2938,[222  95 210 288 228],922,2,12039,4.096291255529091,0.0,20.0
12939,1,2939,[195 118 200 403 127],618,3,12042,4.095918367346939,0.0,0.0
12940,1,2940,[100 168 471 202  79],618,3,12045,4.095545732743965,0.0,0.0
12941,1,2941,[ 64  12 483 427  11],214,5,12050,4.095853161114888,60.0,0.0
12942,1,2942,[ 25 215 216 204  69],654,4,12054,4.095820591233435,0.0,0.0
12943,1,2943,[268 127 282 153 186],854,2,12056,4.095108695652174,0.0,0.0
12944,1,2944,[191 276 423  96 135],618,3,12059,4.094736842105263,0.0,0.0
12945,1,2945,[197 174 211 194 186],405,3,12062,4.094365241004752,0.0,0.0
12946,1,2946,[216 273 174 181  25],630,2,12064,4.093654563963352,0.0,20.0
12947,1,2947,[ 64  12 483 427  11],214,5,12069,4.093962008141113,60.0,0.0
12948,1,2948,[181 403  96 294 216],642,4,12073,4.0939301458121395,0.0,20.0
12949,1,2949,[161  79  97  15 195],705,2,12075,4.093220338983051,0.0,0.0
12950,1,2950,[ 64  12 483 427  11],618,5,12080,4.093527617756693,60.0,0.0
12951,1,2951,[289 100 216 117 144],416,4,12084,4.09349593495935,0.0,0.0
12952,1,2952,[302 210  56 515 568],416,5,12089,4.093802912292584,0.0,0.0
12953,1,2953,[ 64  12 483 427  11],618,5,12094,4.0941096817874065,60.0,0.0
12954,1,2954,[423  11 174 328 175],49,1,12095,4.093062605752961,0.0,0.0
12955,1,2955,[  9  15 117 300  96],630,3,12098,4.092692828146143,0.0,0.0
12956,1,2956,[215 121 238 195 185],618,3,12101,4.092323300642543,0.0,0.0
12957,1,2957,[ 64  12 483 427  11],214,5,12106,4.09263015551048,60.0,0.0
12958,1,2958,[235  82 403 238   4],62,5,12111,4.092936802973978,0.0,0.0
12959,1,2959,[  8 282 588 144 174],588,3,12114,4.092567567567568,0.0,0.0
12960,1,2960,[237  82  71  22 172],654,4,12118,4.0925363053022625,0.0,0.0
12961,1,2961,[ 64  12 483 427  11],214,5,12123,4.092842673869008,60.0,0.0
12962,1,2962,[ 64  12 483 427  11],618,5,12128,4.093148835639554,60.0,0.0
12963,1,2963,[ 64  12 483 427  11],214,5,12133,4.093454790823212,60.0,0.0
12964,1,2964,[168 385 100 191   1],698,2,12135,4.09274873524452,0.0,0.0
12965,1,2965,[ 64  12 483 427  11],618,5,12140,4.0930546190155095,60.0,0.0
12966,1,2966,[ 64  12 483 427  11],618,5,12145,4.093360296595888,60.0,0.0
12967,1,2967,[ 64  12 483 427  11],618,5,12150,4.09366576819407,60.0,0.0
12968,1,2968,[183 403 234 127 238],416,5,12155,4.093971034018188,0.0,0.0
12969,1,2969,[ 64  12 483 427  11],214,5,12160,4.094276094276094,60.0,0.0
12970,1,2970,[ 64  12 483 427  11],214,5,12165,4.094580949175362,60.0,0.0
12971,1,2971,[ 64  12 483 427  11],618,5,12170,4.094885598923284,60.0,0.0
12972,1,2972,[748 268 597  12 603],416,4,12174,4.094853683148335,20.0,0.0
12973,1,2973,[ 64  12 483 427  11],214,5,12179,4.095158036314728,60.0,0.0
12974,1,2974,[182 210 238 276  11],198,4,12183,4.095126050420168,0.0,0.0
12975,1,2975,[ 64  12 483 427  11],214,5,12188,4.095430107526882,60.0,0.0
12976,1,2976,[328 168 234 100 318],253,4,12192,4.095398051729929,20.0,0.0
12977,1,2977,[210 276 168 568 151],198,3,12195,4.095030221625252,0.0,0.0
12978,1,2978,[196  95  97 282  88],618,3,12198,4.094662638469285,0.0,0.0
12979,1,2979,[ 64  12 483 427  11],214,5,12203,4.09496644295302,60.0,0.0
12980,1,2980,[ 64  12 483 427  11],618,5,12208,4.095270043609527,60.0,0.0
12981,1,2981,[333 161 181 300 204],721,4,12212,4.095238095238095,0.0,20.0
12982,1,2982,[357 475 216 237 268],416,3,12215,4.094870935300033,0.0,0.0
12983,1,2983,[ 64  12 483 427  11],214,5,12220,4.095174262734584,60.0,0.0
12984,1,2984,[ 28 588  71 258  97],416,5,12225,4.0954773869346734,0.0,0.0
12985,1,2985,[ 64  12 483 427  11],214,5,12230,4.095780308104487,60.0,0.0
12986,1,2986,[ 28 216 173 121 222],764,4,12234,4.095748242383663,0.0,0.0
12987,1,2987,[ 64  12 483 427  11],214,5,12239,4.0960508701472556,60.0,0.0
12988,1,2988,[ 64  12 483 427  11],214,5,12244,4.096353295416527,60.0,0.0
12989,1,2989,[258  70 289 235  98],345,3,12247,4.095986622073578,0.0,20.0
12990,1,2990,[234 187 275  96  56],416,5,12252,4.096288866599799,0.0,0.0
12991,1,2991,[276  69 269  70 204],416,4,12256,4.096256684491979,0.0,0.0
12992,1,2992,[228 588 286 313 318],711,4,12260,4.096224523889075,40.0,20.0
12993,1,2993,[403  50  88 268 289],416,3,12263,4.095858383433534,0.0,20.0
12994,1,2994,[168 471 475 222 176],297,4,12267,4.095826377295492,0.0,0.0
12995,1,2995,[282 742 588 313  98],654,4,12271,4.095794392523365,20.0,40.0
12996,1,2996,[ 64  12 483 427  11],214,5,12276,4.096096096096096,60.0,0.0
12997,1,2997,[286  64 302   9 300],43,5,12281,4.096397598398933,20.0,0.0
12998,1,2998,[385 294 196 100 215],416,5,12286,4.096698899633211,0.0,0.0
12999,1,2999,[ 64  12 483 427  11],618,5,12291,4.097,60.0,0.0
13000,1,3000,[202 172 228 257   8],921,2,12293,4.096301232922359,0.0,0.0
13001,1,3001,[265 186 405 403 655],417,3,12296,4.095936042638241,0.0,0.0
13002,1,3002,[234 603 655 423 186],405,4,12300,4.095904095904096,0.0,0.0
13003,1,3003,[475 471 194 185 508],297,3,12303,4.095539280958722,0.0,0.0
13004,1,3004,[ 64  12 483 427  11],214,5,12308,4.095840266222962,60.0,0.0
13005,1,3005,[ 64  12 483 427  11],214,5,12313,4.096141051230871,60.0,0.0
13006,1,3006,[403 125 211 318 385],416,5,12318,4.0964416361822416,20.0,0.0
13007,1,3007,[294  97 568  98  95],654,3,12321,4.096077127659575,0.0,20.0
13008,1,3008,[302 200 202 211  50],405,3,12324,4.095712861415753,0.0,20.0
13009,1,3009,[  9 275 185  22 405],854,4,12328,4.095681063122924,0.0,0.0
13010,1,3010,[ 64  12 483 427  11],214,5,12333,4.095981401527732,60.0,0.0
13011,1,3011,[ 64  12 483 427  11],618,5,12338,4.096281540504648,60.0,0.0
13012,1,3012,[ 64  12 483 427  11],618,5,12343,4.09658148025224,60.0,0.0
13013,1,3013,[ 64  12 483 427  11],618,5,12348,4.096881220968812,60.0,0.0
13014,1,3014,[235 318 210 588 427],887,4,12352,4.096849087893864,20.0,0.0
13015,1,3015,[ 64 127 508 210 273],62,5,12357,4.097148541114058,20.0,0.0
13016,1,3016,[ 64  12 483 427  11],618,5,12362,4.0974477958236655,60.0,0.0
13017,1,3017,[ 64  12 483 427  11],618,5,12367,4.097746852220014,60.0,0.0
13018,1,3018,[423 294 181 300 202],128,4,12371,4.097714474991719,0.0,20.0
13019,1,3019,[ 71 588 245 168 202],416,4,12375,4.097682119205298,0.0,0.0
13020,1,3020,[301  12 275 286 496],437,3,12378,4.097318768619663,20.0,0.0
13021,1,3021,[237 271 405 597 318],43,3,12381,4.096955658504302,20.0,0.0
13022,1,3022,[588  15 111  56  69],437,2,12383,4.096261991399272,0.0,0.0
13023,1,3023,[118 216  28   4 168],805,1,12384,4.095238095238095,0.0,0.0
13024,1,3024,[427  70  71  95 200],262,3,12387,4.094876033057851,0.0,0.0
13025,1,3025,[185 333 196 125  95],416,4,12391,4.094844679444812,0.0,0.0
13026,1,3026,[ 50  97 191  89 318],496,4,12395,4.094813346547737,20.0,20.0
13027,1,3027,[ 64  12 483 427  11],214,5,12400,4.095112285336856,60.0,0.0
13028,1,3028,[ 64  12 483 427  11],618,5,12405,4.095411026741499,60.0,0.0
13029,1,3029,[276  70 748 151 204],654,4,12409,4.095379537953796,0.0,0.0
13030,1,3030,[423 269 127  15 173],373,3,12412,4.09501814582646,0.0,0.0
13031,1,3031,[ 97  28 423 197  89],405,3,12415,4.094656992084433,0.0,0.0
13032,1,3032,[ 64  12 483 427  11],214,5,12420,4.094955489614243,60.0,0.0
13033,1,3033,[ 64  12 483 427  11],214,5,12425,4.095253790375741,60.0,0.0
13034,1,3034,[ 64  12 483 427  11],618,5,12430,4.095551894563426,60.0,0.0
13035,1,3035,[  7 111 333 200  11],854,3,12433,4.095191040843215,0.0,0.0
13036,1,3036,[282 210 173 471 403],345,2,12435,4.094501152453079,0.0,0.0
13037,1,3037,[ 64  12 483 427  11],618,5,12440,4.094799210006583,60.0,0.0
13038,1,3038,[302 275 258 117 427],52,5,12445,4.095097071405068,0.0,0.0
13039,1,3039,[ 64  12 483 427  11],618,5,12450,4.095394736842105,60.0,0.0
13040,1,3040,[496 211 183 323 185],416,4,12454,4.095363367313384,0.0,0.0
13041,1,3041,[117 258 748 183  50],297,4,12458,4.095332018408942,0.0,20.0
13042,1,3042,[ 64  12 483 427  11],214,5,12463,4.095629313177785,60.0,0.0
13043,1,3043,[313   1 125  56 301],345,3,12466,4.09526938239159,20.0,20.0
13044,1,3044,[ 64  12 483 427  11],618,5,12471,4.095566502463054,60.0,0.0
13045,1,3045,[245 301 176 294  56],297,3,12474,4.095206828627709,0.0,0.0
13046,1,3046,[ 64  12 483 427  11],214,5,12479,4.095503774204135,60.0,0.0
13047,1,3047,[143 302   1 508 117],297,4,12483,4.0954724409448815,0.0,0.0
13048,1,3048,[289   8 568 294 173],416,4,12487,4.095441128238766,0.0,0.0
13049,1,3049,[ 64  12 483 427  11],214,5,12492,4.095737704918033,60.0,0.0
13050,1,3050,[423 496  70 655 257],416,4,12496,4.095706325794821,0.0,0.0
13051,1,3051,[258  69 151 222  11],43,5,12501,4.096002621231979,0.0,0.0
13052,1,3052,[ 64  12 483 427  11],618,5,12506,4.096298722567966,60.0,0.0
13053,1,3053,[ 64  12 483 427  11],618,5,12511,4.096594629993451,60.0,0.0
13054,1,3054,[238 144   7 135 143],297,4,12515,4.096563011456628,0.0,0.0
13055,1,3055,[161 117 181 588 475],416,4,12519,4.096531413612565,0.0,20.0
13056,1,3056,[ 64  12 483 427  11],618,5,12524,4.096826954530585,60.0,0.0
13057,1,3057,[ 64  12 483 427  11],214,5,12529,4.097122302158273,60.0,0.0
13058,1,3058,[ 64  12 483 427  11],618,5,12534,4.097417456685191,60.0,0.0
13059,1,3059,[228 204 655 405  89],805,1,12535,4.09640522875817,0.0,0.0
13060,1,3060,[ 15 423 211 204 301],437,4,12539,4.096373734073832,0.0,0.0
13061,1,3061,[135  12  22  50 471],373,3,12542,4.096015676028739,20.0,20.0
13062,1,3062,[195 282  25 742 257],630,2,12544,4.095331374469474,0.0,0.0
13063,1,3063,[  1  95  71 202  56],805,2,12546,4.094647519582246,0.0,0.0
13064,1,3064,[496 202 235 194   9],416,4,12550,4.0946166394779775,0.0,0.0
13065,1,3065,[ 64  12 483 427  11],214,5,12555,4.094911937377691,60.0,0.0
13066,1,3066,[ 64  12 483 427  11],214,5,12560,4.095207042712748,60.0,0.0
13067,1,3067,[ 64  12 483 427  11],618,5,12565,4.095501955671447,60.0,0.0
13068,1,3068,[ 64  12 483 427  11],618,5,12570,4.095796676441838,60.0,0.0
13069,1,3069,[ 64  12 483 427  11],214,5,12575,4.096091205211726,60.0,0.0
13070,1,3070,[ 64  12 483 427  11],618,5,12580,4.096385542168675,60.0,0.0
13071,1,3071,[ 64  12 483 427  11],618,5,12585,4.0966796875,60.0,0.0
13072,1,3072,[ 64   8 118 471  82],705,4,12589,4.096648226488774,20.0,0.0
13073,1,3073,[ 79 742 196  96 132],417,2,12591,4.0959661678594665,0.0,0.0
13074,1,3074,[ 64  12 483 427  11],214,5,12596,4.096260162601626,60.0,0.0
13075,1,3075,[ 64  12 483 427  11],618,5,12601,4.096553966189857,60.0,0.0
13076,1,3076,[ 64  12 483 427  11],214,5,12606,4.09684757881053,60.0,0.0
13077,1,3077,[ 64  12 483 427  11],618,5,12611,4.097141000649772,60.0,0.0
13078,1,3078,[ 64  12 483 427  11],618,5,12616,4.097434231893472,60.0,0.0
13079,1,3079,[ 64  12 483 427  11],618,5,12621,4.097727272727273,60.0,0.0
13080,1,3080,[ 64  12 483 427  11],618,5,12626,4.098020123336579,60.0,0.0
13081,1,3081,[318  89 118 385 427],705,3,12629,4.097663854639844,20.0,0.0
13082,1,3082,[435 423 196 655 173],437,4,12633,4.0976321764515085,0.0,0.0
13083,1,3083,[ 64  12 483 427  11],214,5,12638,4.097924773022049,60.0,0.0
13084,1,3084,[257  64 273 322 483],854,3,12641,4.097568881685575,40.0,0.0
13085,1,3085,[ 64  12 483 427  11],214,5,12646,4.097861309138043,60.0,0.0
13086,1,3086,[ 64  12 483 427  11],214,5,12651,4.098153547133139,60.0,0.0
13087,1,3087,[ 64  12 483 427  11],214,5,12656,4.098445595854923,60.0,0.0
13088,1,3088,[ 64  12 483 427  11],214,5,12661,4.098737455487213,60.0,0.0
13089,1,3089,[ 64  12 483 427  11],214,5,12666,4.099029126213592,60.0,0.0
13090,1,3090,[ 64  12 483 427  11],618,5,12671,4.099320608217405,60.0,0.0
13091,1,3091,[ 89 174 182 183 423],198,4,12675,4.099288486416559,0.0,0.0
13092,1,3092,[ 64  12 483 427  11],618,5,12680,4.0995796960879405,60.0,0.0
13093,1,3093,[ 64  12 483 427  11],214,5,12685,4.099870717517776,60.0,0.0
13094,1,3094,[655 196 111 748 161],721,3,12688,4.09951534733441,0.0,0.0
13095,1,3095,[ 64  12 483 427  11],618,5,12693,4.099806201550388,60.0,0.0
13096,1,3096,[ 71 385 483 301  82],588,4,12697,4.099773974814337,20.0,0.0
13097,1,3097,[ 64  12 483 427  11],618,5,12702,4.100064557779213,60.0,0.0
13098,1,3098,[215 168 179 275 194],373,4,12706,4.100032268473702,0.0,0.0
13099,1,3099,[  7 471  50 175 211],297,4,12710,4.1,0.0,20.0
13100,1,3100,[117 301  88 588  79],416,4,12714,4.099967752337956,0.0,0.0
13101,1,3101,[ 64  12 483 427  11],618,5,12719,4.100257898130239,60.0,0.0
13102,1,3102,[196 191 238  95 204],437,5,12724,4.100547856912665,0.0,0.0
13103,1,3103,[ 64  12 483 427  11],618,5,12729,4.100837628865979,60.0,0.0
13104,1,3104,[ 95 265 237 125   8],416,3,12732,4.1004830917874395,0.0,0.0
13105,1,3105,[ 64  12 483 427  11],618,5,12737,4.100772698003864,60.0,0.0
13106,1,3106,[ 56 289 185 117 132],854,3,12740,4.100418410041841,0.0,0.0
13107,1,3107,[ 64  12 483 427  11],214,5,12745,4.100707850707851,60.0,0.0
13108,1,3108,[ 64  12 483 427  11],214,5,12750,4.100997105178514,60.0,0.0
13109,1,3109,[173 117  15 405 215],198,2,12752,4.10032154340836,0.0,0.0
13110,1,3110,[427 143  69 144  71],373,3,12755,4.099967855994857,0.0,0.0
13111,1,3111,[111 268  95 286 181],416,4,12759,4.099935732647815,0.0,20.0
13112,1,3112,[ 64  12 483 427  11],618,5,12764,4.100224863475747,60.0,0.0
13113,1,3113,[568 204 161 202 215],405,4,12768,4.10019267822736,0.0,0.0
13114,1,3114,[385 196 222 235 269],805,2,12770,4.099518459069021,0.0,0.0
13115,1,3115,[ 64  12 483 427  11],618,5,12775,4.099807445442876,60.0,0.0
13116,1,3116,[435  71  56 568 185],230,3,12778,4.099454603785691,0.0,0.0
13117,1,3117,[ 64  12 483 427  11],214,5,12783,4.099743425272611,60.0,0.0
13118,1,3118,[111 125 333 181 496],416,5,12788,4.100032061558192,0.0,20.0
13119,1,3119,[ 15 151 288  28 234],416,4,12792,4.1,0.0,20.0
13120,1,3120,[191 196 508 132 176],62,5,12797,4.100288369112464,0.0,0.0
13121,1,3121,[ 64  12 483 427  11],618,5,12802,4.100576553491352,60.0,0.0
13122,1,3122,[ 98 234  88  25 161],345,3,12805,4.100224143451809,0.0,20.0
13123,1,3123,[234  71 211 121 300],416,5,12810,4.1005121638924455,0.0,0.0
13124,1,3124,[ 98 197 597  25 385],416,4,12814,4.10048,0.0,20.0
13125,1,3125,[161   7  25 186  98],198,3,12817,4.100127959053103,0.0,20.0
13126,1,3126,[ 64  12 483 427  11],618,5,12822,4.1004157339302845,60.0,0.0
13127,1,3127,[508 222 235  96  25],854,2,12824,4.099744245524296,0.0,0.0
13128,1,3128,[168  64 216 257 117],62,4,12828,4.099712368168744,20.0,0.0
13129,1,3129,[ 64  12 483 427  11],618,5,12833,4.1,60.0,0.0
13130,1,3130,[ 64  12 483 427  11],618,5,12838,4.100287448099649,60.0,0.0
13131,1,3131,[180 588 125 322 186],417,3,12841,4.099936143039591,0.0,0.0
13132,1,3132,[678 403 174 215 111],541,3,12844,4.0995850622406635,0.0,0.0
13133,1,3133,[215 172 328 333  50],721,4,12848,4.09955328653478,0.0,20.0
13134,1,3134,[ 64  12 483 427  11],214,5,12853,4.0998405103668265,60.0,0.0
13135,1,3135,[235 173 423 174   7],43,4,12857,4.099808673469388,0.0,0.0
13136,1,3136,[ 56 313 238 302 175],617,2,12859,4.099139305068537,20.0,20.0
13137,1,3137,[ 15 655 144 127 125],417,4,12863,4.099107711918419,0.0,0.0
13138,1,3138,[357   1 117 475 210],297,4,12867,4.099076138897738,0.0,0.0
13139,1,3139,[ 64  12 483 427  11],618,5,12872,4.099363057324841,60.0,0.0
13140,1,3140,[202 289 275 121 181],588,2,12874,4.098694683221904,0.0,20.0
13141,1,3141,[ 11 132 318   8 357],854,5,12879,4.098981540420114,20.0,0.0
13142,1,3142,[181 568 405 179 678],805,2,12881,4.098313713013045,0.0,20.0
13143,1,3143,[ 69 568 151 195 655],198,3,12884,4.097964376590331,0.0,0.0
13144,1,3144,[ 64  12 483 427  11],214,5,12889,4.098251192368839,60.0,0.0
13145,1,3145,[ 64  12 483 427  11],618,5,12894,4.098537825810553,60.0,0.0
13146,1,3146,[235 508 546  98  56],297,3,12897,4.098188751191611,0.0,20.0
13147,1,3147,[ 64  12 483 427  11],618,5,12902,4.098475222363406,60.0,0.0
13148,1,3148,[ 98 322 144 269 423],416,4,12906,4.098443950460464,0.0,20.0
13149,1,3149,[195 183 118 423 153],437,2,12908,4.097777777777778,0.0,0.0
13150,1,3150,[ 64  12 483 427  11],618,5,12913,4.098064106632815,60.0,0.0
13151,1,3151,[238  25 471 496  56],416,5,12918,4.098350253807107,0.0,0.0
13152,1,3152,[ 69  97 117  11 153],654,4,12922,4.098319061211544,0.0,0.0
13153,1,3153,[328   7 237 151  56],505,1,12923,4.097336715282181,0.0,0.0
13154,1,3154,[322 210 118 275 276],128,4,12927,4.097305863708399,0.0,0.0
13155,1,3155,[ 64  12 483 427  11],214,5,12932,4.097591888466413,60.0,0.0
13156,1,3156,[197 245 175 117 286],297,3,12935,4.097244219195439,0.0,0.0
13157,1,3157,[ 64  12 483 427  11],618,5,12940,4.097530082330589,60.0,0.0
13158,1,3158,[ 64  12 483 427  11],214,5,12945,4.097815764482431,60.0,0.0
13159,1,3159,[ 64  12 483 427  11],618,5,12950,4.098101265822785,60.0,0.0
13160,1,3160,[302 197 289 323 211],416,3,12953,4.0977538753559,0.0,0.0
13161,1,3161,[132 301  11 313 289],345,4,12957,4.097722960151803,20.0,20.0
13162,1,3162,[ 64  12 483 427  11],618,5,12962,4.098008220044262,60.0,0.0
13163,1,3163,[179 238 328 180 427],128,3,12965,4.097661188369153,0.0,0.0
13164,1,3164,[ 64  12 483 427  11],214,5,12970,4.097946287519747,60.0,0.0
13165,1,3165,[204  89 568 196 180],373,4,12974,4.097915350600126,0.0,0.0
13166,1,3166,[191 405  95 132 275],764,4,12978,4.097884433217556,0.0,0.0
13167,1,3167,[ 64  12 483 427  11],214,5,12983,4.098169191919192,60.0,0.0
13168,1,3168,[183 175 271  82 127],805,2,12985,4.097507100031556,0.0,0.0
13169,1,3169,[100  95  12 173 597],417,3,12988,4.097160883280757,20.0,0.0
13170,1,3170,[ 64  12 483 427  11],618,5,12993,4.097445600756859,60.0,0.0
13171,1,3171,[ 64  12 483 427  11],618,5,12998,4.097730138713746,60.0,0.0
13172,1,3172,[ 64  12 483 427  11],214,5,13003,4.098014497321147,60.0,0.0
13173,1,3173,[471  15 258  50 181],708,4,13007,4.097983616887208,0.0,40.0
13174,1,3174,[257   7 405 273 204],416,4,13011,4.097952755905512,0.0,0.0
13175,1,3175,[ 64  12 483 427  11],618,5,13016,4.0982367758186395,60.0,0.0
13176,1,3176,[234 202 496 196 127],416,5,13021,4.0985206169342145,0.0,0.0
13177,1,3177,[ 64  12 483 427  11],214,5,13026,4.098804279421019,60.0,0.0
13178,1,3178,[ 64  12 483 427  11],618,5,13031,4.099087763447625,60.0,0.0
13179,1,3179,[ 64  12 483 427  11],618,5,13036,4.09937106918239,60.0,0.0
13180,1,3180,[ 64  12 483 427  11],618,5,13041,4.099654196793461,60.0,0.0
13181,1,3181,[ 64  12 483 427  11],214,5,13046,4.099937146448775,60.0,0.0
13182,1,3182,[328 655 196  56 313],416,5,13051,4.100219918316054,20.0,20.0
13183,1,3183,[ 64  12 483 427  11],618,5,13056,4.100502512562814,60.0,0.0
13184,1,3184,[ 64  12 483 427  11],618,5,13061,4.100784929356358,60.0,0.0
13185,1,3185,[111 182 211 238  82],417,4,13065,4.10075329566855,0.0,0.0
13186,1,3186,[ 64  12 483 427  11],214,5,13070,4.101035456542203,60.0,0.0
13187,1,3187,[235  71 588 168 100],887,3,13073,4.10069008782936,0.0,0.0
13188,1,3188,[588 202 173  28 748],751,4,13077,4.1006585136406395,0.0,0.0
13189,1,3189,[ 64  12 483 427  11],618,5,13082,4.100940438871473,60.0,0.0
13190,1,3190,[403 245  88  50 118],642,4,13086,4.100908806016923,0.0,20.0
13191,1,3191,[161 204 597 235  79],805,1,13087,4.099937343358396,0.0,0.0
13192,1,3192,[ 69 333 742 258 125],588,3,13090,4.099592859379894,0.0,0.0
13193,1,3193,[ 95 588 118 405 742],642,3,13093,4.099248591108328,0.0,0.0
13194,1,3194,[182  70 273 196 210],618,3,13096,4.098904538341158,0.0,0.0
13195,1,3195,[ 64 475 294 508 181],417,3,13099,4.098560700876095,20.0,20.0
13196,1,3196,[194 496  15 216 144],416,5,13104,4.098842664998436,0.0,0.0
13197,1,3197,[ 64  12 483 427  11],618,5,13109,4.0991244527829895,60.0,0.0
13198,1,3198,[ 64  12 483 427  11],618,5,13114,4.099406064395123,60.0,0.0
13199,1,3199,[222  97 385 328  25],43,5,13119,4.0996875,0.0,0.0
13200,1,3200,[ 69 655  98 257   4],416,4,13123,4.099656357388316,0.0,20.0
13201,1,3201,[ 50  97  64 318  71],711,4,13127,4.099625234228607,40.0,20.0
13202,1,3202,[ 64  12 483 427  11],618,5,13132,4.099906337808305,60.0,0.0
13203,1,3203,[ 64  12 483 427  11],214,5,13137,4.100187265917603,60.0,0.0
13204,1,3204,[ 64  12 483 427  11],618,5,13142,4.100468018720749,60.0,0.0
13205,1,3205,[125 237  69 385  82],230,4,13146,4.100436681222708,0.0,0.0
13206,1,3206,[194  82  79 427  25],373,4,13150,4.100405363267852,0.0,0.0
13207,1,3207,[ 64  12 483 427  11],214,5,13155,4.10068578553616,60.0,0.0
13208,1,3208,[333   9 546 288 322],416,3,13158,4.1003427859146155,0.0,20.0
13209,1,3209,[ 22 328 286 603 742],854,1,13159,4.099376947040499,0.0,0.0
13210,1,3210,[100 215 471 238 151],297,2,13161,4.098723139208969,0.0,0.0
13211,1,3211,[ 71  56 568 172 588],345,3,13164,4.098381070983811,0.0,0.0
13212,1,3212,[ 64  12 483 427  11],214,5,13169,4.098661686896981,60.0,0.0
13213,1,3213,[568 183  96  56  22],618,4,13173,4.098630989421282,0.0,0.0
13214,1,3214,[168   1 179  25  95],751,4,13177,4.098600311041991,0.0,0.0
13215,1,3215,[168  82 276 301  98],437,2,13179,4.09794776119403,0.0,20.0
13216,1,3216,[197 427 275 268 328],128,3,13182,4.097606465651228,0.0,0.0
13217,1,3217,[143 215 132 174 175],198,3,13185,4.097265382224984,0.0,0.0
13218,1,3218,[ 97  25  56 286  82],416,5,13190,4.097545821683752,0.0,0.0
13219,1,3219,[ 56 216   4 196 286],417,3,13193,4.0972049689441,0.0,0.0
13220,1,3220,[176 121 265 385 215],618,5,13198,4.09748525302701,0.0,0.0
13221,1,3221,[ 97 288 435 195 191],437,1,13199,4.096523898199876,0.0,20.0
13222,1,3222,[ 64  12 483 427  11],618,5,13204,4.096804219671114,60.0,0.0
13223,1,3223,[269 195 204   7 597],416,4,13208,4.096774193548387,0.0,0.0
13224,1,3224,[ 50   7 174 172 216],230,4,13212,4.096744186046512,0.0,20.0
13225,1,3225,[328 168 143 276 237],43,5,13217,4.097024178549287,0.0,0.0
13226,1,3226,[ 64  12 483 427  11],214,5,13222,4.097303997520918,60.0,0.0
13227,1,3227,[ 79 153 655 200 176],24,5,13227,4.097583643122676,0.0,0.0
13228,1,3228,[216 405 100 294 603],854,3,13230,4.097243728708579,0.0,0.0
13229,1,3229,[ 95 288 182 132 143],405,3,13233,4.0969040247678015,0.0,20.0
13230,1,3230,[179 173 546  15 302],62,3,13236,4.096564531104921,0.0,0.0
13231,1,3231,[302  95  25  98  28],654,4,13240,4.096534653465347,0.0,20.0
13232,1,3232,[ 70 173 496 216 118],618,1,13241,4.095576863594185,0.0,0.0
13233,1,3233,[204   1 181 215 257],416,4,13245,4.095547309833024,0.0,20.0
13234,1,3234,[ 64  12 483 427  11],214,5,13250,4.095826893353942,60.0,0.0
13235,1,3235,[ 64  12 483 427  11],214,5,13255,4.09610630407911,60.0,0.0
13236,1,3236,[ 64  12 483 427  11],618,5,13260,4.096385542168675,60.0,0.0
13237,1,3237,[216 300 268 127 258],721,4,13264,4.096355775169858,0.0,0.0
13238,1,3238,[ 64  12 483 427  11],214,5,13269,4.096634763815993,60.0,0.0
13239,1,3239,[ 64  12 483 427  11],618,5,13274,4.096913580246913,60.0,0.0
13240,1,3240,[100  98 313 286 300],416,5,13279,4.09719222462203,20.0,40.0
13241,1,3241,[ 64  12 483 427  11],618,5,13284,4.0974706971005554,60.0,0.0
13242,1,3242,[ 64  12 483 427  11],214,5,13289,4.097748997841505,60.0,0.0
13243,1,3243,[ 64  12 483 427  11],214,5,13294,4.098027127003699,60.0,0.0
13244,1,3244,[ 82 318  89  28 742],642,3,13297,4.09768875192604,20.0,0.0
13245,1,3245,[318 195 237 153 174],854,2,13299,4.097042513863216,20.0,0.0
13246,1,3246,[286  11 173 204 508],345,4,13303,4.097012627040345,0.0,0.0
13247,1,3247,[ 64  12 483 427  11],618,5,13308,4.097290640394089,60.0,0.0
13248,1,3248,[ 64  12 483 427  11],214,5,13313,4.097568482610034,60.0,0.0
13249,1,3249,[471 294 546 496  70],630,2,13315,4.096923076923077,0.0,0.0
13250,1,3250,[ 64  12 483 427  11],214,5,13320,4.097200861273454,60.0,0.0
13251,1,3251,[ 56  50 357 111  97],297,4,13324,4.097170971709717,0.0,20.0
13252,1,3252,[ 97  11 237  28 282],297,4,13328,4.097141100522594,0.0,0.0
13253,1,3253,[ 96 180 174  89  82],198,3,13331,4.096803933620159,0.0,0.0
13254,1,3254,[ 64  12 483 427  11],214,5,13336,4.097081413210446,60.0,0.0
13255,1,3255,[ 64  12 483 427  11],618,5,13341,4.097358722358722,60.0,0.0
13256,1,3256,[427 275  25  82 216],128,4,13345,4.097328830211851,0.0,0.0
13257,1,3257,[ 64  12 483 427  11],214,5,13350,4.097605893186004,60.0,0.0
13258,1,3258,[678 196  71 323 282],416,3,13353,4.097269100951212,0.0,0.0
13259,1,3259,[ 64  12 483 427  11],618,5,13358,4.097546012269938,60.0,0.0
13260,1,3260,[275 234 597 100 286],416,4,13362,4.097516099356025,0.0,0.0
13261,1,3261,[ 71 302 288   9 181],62,3,13365,4.097179644389945,0.0,40.0
13262,1,3262,[  1 196  12 271 257],43,4,13369,4.0971498620901015,20.0,0.0
13263,1,3263,[186 302 318 117 405],43,4,13373,4.097120098039215,20.0,0.0
13264,1,3264,[ 15 121 111  79 216],416,5,13378,4.09739663093415,0.0,0.0
13265,1,3265,[ 64  12 483 427  11],618,5,13383,4.097672994488671,60.0,0.0
13266,1,3266,[ 64  12 483 427  11],618,5,13388,4.09794918885828,60.0,0.0
13267,1,3267,[ 64  12 483 427  11],214,5,13393,4.098225214198286,60.0,0.0
13268,1,3268,[ 64  22 180 286 282],854,2,13395,4.097583358825329,20.0,0.0
13269,1,3269,[748 268 427 132 216],416,5,13400,4.097859327217125,0.0,0.0
13270,1,3270,[ 64  12 483 427  11],618,5,13405,4.098135126872516,60.0,0.0
13271,1,3271,[ 64  12 483 427  11],214,5,13410,4.09841075794621,60.0,0.0
13272,1,3272,[ 64 144 117 289 186],854,1,13411,4.097464100213871,20.0,0.0
13273,1,3273,[197  88  15 161 403],373,3,13414,4.097128894318876,0.0,0.0
13274,1,3274,[197  28 294 153 276],342,2,13416,4.0964885496183205,0.0,0.0
13275,1,3275,[ 64  12 483 427  11],214,5,13421,4.096764346764346,60.0,0.0
13276,1,3276,[ 64  12 483 427  11],214,5,13426,4.097039975587427,60.0,0.0
13277,1,3277,[423 403  56 322   8],416,4,13430,4.097010372178158,0.0,0.0
13278,1,3278,[ 64  12 483 427  11],214,5,13435,4.097285757853004,60.0,0.0
13279,1,3279,[173 288 276  56 597],62,3,13438,4.096951219512195,0.0,20.0
13280,1,3280,[313 265  69  97 301],416,5,13443,4.097226455348979,20.0,20.0
13281,1,3281,[ 64  12 483 427  11],214,5,13448,4.097501523461304,60.0,0.0
13282,1,3282,[ 64  12 483 427  11],214,5,13453,4.097776424002436,60.0,0.0
13283,1,3283,[ 64  12 483 427  11],618,5,13458,4.0980511571254565,60.0,0.0
13284,1,3284,[234  50 286 100 301],345,4,13462,4.098021308980213,0.0,20.0
13285,1,3285,[173  25 300  50   4],49,0,13462,4.096774193548387,0.0,20.0
13286,1,3286,[496  15   4 588 603],373,4,13466,4.096744752053544,0.0,0.0
13287,1,3287,[ 64  12 483 427  11],618,5,13471,4.097019464720194,60.0,0.0
13288,1,3288,[172  15 132 237 655],345,5,13476,4.097294010337489,0.0,0.0
13289,1,3289,[302 235  11 546 228],297,2,13478,4.096656534954407,0.0,0.0
13290,1,3290,[ 64  12 483 427  11],214,5,13483,4.096931024004862,60.0,0.0
13291,1,3291,[ 64  12 483 427  11],618,5,13488,4.0972053462940465,60.0,0.0
13292,1,3292,[ 15 282  12 187  96],416,5,13493,4.097479501973884,20.0,0.0
13293,1,3293,[546  95 385 597 603],805,1,13494,4.096539162112933,0.0,0.0
13294,1,3294,[ 64  12 483 427  11],618,5,13499,4.096813353566009,60.0,0.0
13295,1,3295,[121 257 235 269 597],43,3,13502,4.096480582524272,0.0,0.0
13296,1,3296,[ 64  12 483 427  11],214,5,13507,4.096754625417046,60.0,0.0
13297,1,3297,[ 64  12 483 427  11],618,5,13512,4.097028502122498,60.0,0.0
13298,1,3298,[678 111 204 385  28],805,1,13513,4.096089724158836,0.0,0.0
13299,1,3299,[195 748 111 273 300],416,5,13518,4.096363636363637,0.0,0.0
13300,1,3300,[ 89  98  70 117 174],62,4,13522,4.096334444107846,0.0,20.0
13301,1,3301,[ 89 210 197  25  70],354,2,13524,4.095699576014536,0.0,0.0
13302,1,3302,[ 64  12 483 427  11],618,5,13529,4.095973357553739,60.0,0.0
13303,1,3303,[ 12 288 597 117 191],417,3,13532,4.095641646489105,20.0,20.0
13304,1,3304,[ 64  12 483 427  11],214,5,13537,4.095915279878971,60.0,0.0
13305,1,3305,[ 64  12 483 427  11],214,5,13542,4.096188747731397,60.0,0.0
13306,1,3306,[313  98 405  71  64],345,4,13546,4.096159661324463,40.0,40.0
13307,1,3307,[ 64  12 483 427  11],214,5,13551,4.096432889963724,60.0,0.0
13308,1,3308,[301 118 546 215 289],416,2,13553,4.09579933514657,0.0,0.0
13309,1,3309,[186 597 276   1 185],618,4,13557,4.095770392749245,0.0,0.0
13310,1,3310,[515 161 211 294 282],416,5,13562,4.0960434913923285,0.0,0.0
13311,1,3311,[ 64  12 483 427  11],618,5,13567,4.096316425120773,60.0,0.0
13312,1,3312,[ 64  12 483 427  11],214,5,13572,4.096589194083911,60.0,0.0
13313,1,3313,[ 64  12 483 427  11],618,5,13577,4.096861798430899,60.0,0.0
13314,1,3314,[ 64  12 483 427  11],214,5,13582,4.0971342383107086,60.0,0.0
13315,1,3315,[234 210 186  96  28],642,4,13586,4.097104945717732,0.0,0.0
13316,1,3316,[237 265  97 186 508],128,4,13590,4.097075670786856,0.0,0.0
13317,1,3317,[ 64  12 483 427  11],618,5,13595,4.097347799879445,60.0,0.0
13318,1,3318,[ 64  12 483 427  11],214,5,13600,4.097619764989455,60.0,0.0
13319,1,3319,[ 64  12 483 427  11],214,5,13605,4.09789156626506,60.0,0.0
13320,1,3320,[ 95 216 289   8 235],416,2,13607,4.097259861487504,0.0,0.0
13321,1,3321,[ 64  12 483 427  11],214,5,13612,4.097531607465382,60.0,0.0
13322,1,3322,[ 64  12 483 427  11],618,5,13617,4.097803189888655,60.0,0.0
13323,1,3323,[282  12 216  71 172],588,5,13622,4.098074608904934,20.0,0.0
13324,1,3324,[151 185 182 195 161],618,3,13625,4.097744360902255,0.0,0.0
13325,1,3325,[121 496 111 118  11],416,4,13629,4.097714972940469,0.0,0.0
13326,1,3326,[222  69 210 111 118],417,1,13630,4.09678388938984,0.0,0.0
13327,1,3327,[ 64  12 483 427  11],618,5,13635,4.097055288461538,60.0,0.0
13328,1,3328,[181 475  11 151 228],198,4,13639,4.0970261339741665,0.0,20.0
13329,1,3329,[ 64  12 483 427  11],214,5,13644,4.097297297297297,60.0,0.0
13330,1,3330,[168  25  97 234 475],588,3,13647,4.09696787751426,0.0,0.0
13331,1,3331,[ 64  12 483 427  11],214,5,13652,4.097238895558223,60.0,0.0
13332,1,3332,[168 176 588 357 238],805,4,13656,4.0972097209720975,0.0,0.0
13333,1,3333,[153 265 181  95 216],416,4,13660,4.097180563887223,0.0,20.0
13334,1,3334,[238 471   8 435   7],297,3,13663,4.096851574212893,0.0,0.0
13335,1,3335,[ 64  12 483 427  11],214,5,13668,4.097122302158273,60.0,0.0
13336,1,3336,[118 235 211 313 176],416,3,13671,4.096793527120168,20.0,20.0
13337,1,3337,[ 64  12 483 427  11],618,5,13676,4.097064110245656,60.0,0.0
13338,1,3338,[405 294  56 216 427],230,4,13680,4.097035040431267,0.0,0.0
13339,1,3339,[ 64  12 483 427  11],214,5,13685,4.097305389221557,60.0,0.0
13340,1,3340,[496 268 313 269 405],654,4,13689,4.097276264591439,20.0,20.0
13341,1,3341,[475 181  25 273 200],416,4,13693,4.097247157390784,0.0,20.0
13342,1,3342,[ 64  12 483 427  11],618,5,13698,4.097517200119653,60.0,0.0
13343,1,3343,[515  79 257 435 275],297,2,13700,4.09688995215311,0.0,0.0
13344,1,3344,[ 64  12 483 427  11],214,5,13705,4.097159940209267,60.0,0.0
13345,1,3345,[ 88 301 202 483 173],907,5,13710,4.097429766885834,20.0,0.0
13346,1,3346,[ 64  12 483 427  11],214,5,13715,4.097699432327458,60.0,0.0
13347,1,3347,[ 64  12 483 427  11],214,5,13720,4.0979689366786145,60.0,0.0
13348,1,3348,[ 64  12 483 427  11],214,5,13725,4.098238280083607,60.0,0.0
13349,1,3349,[ 25  15  79  71 588],128,4,13729,4.098208955223881,0.0,0.0
13350,1,3350,[ 64  12 483 427  11],214,5,13734,4.098478066248881,60.0,0.0
13351,1,3351,[ 88 423 222  98 168],43,5,13739,4.098747016706444,0.0,20.0
13352,1,3352,[ 64  12 483 427  11],214,5,13744,4.0990158067402325,60.0,0.0
13353,1,3353,[ 64  12 483 427  11],214,5,13749,4.099284436493739,60.0,0.0
13354,1,3354,[210 275 215 181 423],618,3,13752,4.098956780923994,0.0,20.0
13355,1,3355,[ 64  12 483 427  11],618,5,13757,4.099225268176401,60.0,0.0
13356,1,3356,[  4 597 237  28  71],416,3,13760,4.09889782543938,0.0,0.0
13357,1,3357,[ 64  12 483 427  11],618,5,13765,4.099166170339488,60.0,0.0
13358,1,3358,[ 64  12 483 427  11],618,5,13770,4.099434355462935,60.0,0.0
13359,1,3359,[302  15 196   7 153],43,5,13775,4.099702380952381,0.0,0.0
13360,1,3360,[742 508 172 181 294],128,3,13778,4.099375185956561,0.0,20.0
13361,1,3361,[238 588 318 151 117],416,4,13782,4.0993456276026174,20.0,0.0
13362,1,3362,[ 64  12 483 427  11],618,5,13787,4.099613440380613,60.0,0.0
13363,1,3363,[ 64  12 483 427  11],214,5,13792,4.099881093935791,60.0,0.0
13364,1,3364,[403 191 121   7 257],417,2,13794,4.09925705794948,0.0,0.0
13365,1,3365,[ 64  12 483 427  11],618,5,13799,4.099524658348188,60.0,0.0
13366,1,3366,[173  56  98 191  88],416,4,13803,4.099495099495099,0.0,20.0
13367,1,3367,[ 79 173  88 276 195],416,3,13806,4.09916864608076,0.0,0.0
13368,1,3368,[ 64  12 483 427  11],618,5,13811,4.099436034431582,60.0,0.0
13369,1,3369,[ 64  12 483 427  11],618,5,13816,4.099703264094956,60.0,0.0
13370,1,3370,[ 64  12 483 427  11],618,5,13821,4.099970335212103,60.0,0.0
13371,1,3371,[ 96 405   1  11 385],751,2,13823,4.0993475682087785,0.0,0.0
13372,1,3372,[ 64  12 483 427  11],214,5,13828,4.099614586421583,60.0,0.0
13373,1,3373,[265 125 276  79 143],618,3,13831,4.099288678126852,0.0,0.0
13374,1,3374,[ 64  12 483 427  11],214,5,13836,4.099555555555556,60.0,0.0
13375,1,3375,[238 471 403 323  22],416,4,13840,4.099526066350711,0.0,0.0
13376,1,3376,[273  95 204 174 151],805,1,13841,4.098608232158721,0.0,0.0
13377,1,3377,[271  70 215   7  95],43,4,13845,4.0985790408525755,0.0,0.0
13378,1,3378,[275 265 405 196 234],416,5,13850,4.098845812370524,0.0,0.0
13379,1,3379,[318 282 300 245  79],416,4,13854,4.098816568047337,20.0,0.0
13380,1,3380,[ 64  12 483 427  11],214,5,13859,4.099083111505472,60.0,0.0
13381,1,3381,[ 28 245  79 202 153],297,2,13861,4.098462448255471,0.0,0.0
13382,1,3382,[ 69  96 181 153 403],198,5,13866,4.098728938811705,0.0,20.0
13383,1,3383,[ 64  12 483 427  11],618,5,13871,4.098995271867612,60.0,0.0
13384,1,3384,[ 64  12 483 427  11],618,5,13876,4.099261447562777,60.0,0.0
13385,1,3385,[216 196  15 258 748],721,3,13879,4.098936798582398,0.0,0.0
13386,1,3386,[151 238 271 174 153],854,4,13883,4.098907587835843,0.0,0.0
13387,1,3387,[118 168  50 202  56],417,4,13887,4.09887839433294,0.0,20.0
13388,1,3388,[ 64  12 483 427  11],214,5,13892,4.099144290351136,60.0,0.0
13389,1,3389,[318 185  95 202 180],437,5,13897,4.099410029498525,20.0,0.0
13390,1,3390,[ 64  12 483 427  11],618,5,13902,4.09967561191389,60.0,0.0
13391,1,3391,[ 64  12 483 427  11],618,5,13907,4.099941037735849,60.0,0.0
13392,1,3392,[191 173 182 427  50],416,5,13912,4.100206307102859,0.0,20.0
13393,1,3393,[ 64  12 483 427  11],214,5,13917,4.1004714201532115,60.0,0.0
13394,1,3394,[121  88  71 276 483],437,2,13919,4.099852724594992,20.0,0.0
13395,1,3395,[  9 289  79 269 318],345,4,13923,4.09982332155477,20.0,0.0
13396,1,3396,[  1 179  22 318 174],721,5,13928,4.100088313217545,20.0,0.0
13397,1,3397,[ 98 678 357 196 496],416,4,13932,4.100058858151854,0.0,20.0
13398,1,3398,[ 64  12 483 427  11],618,5,13937,4.100323624595469,60.0,0.0
13399,1,3399,[300  50 435 174 210],297,3,13940,4.1,0.0,20.0
13400,1,3400,[546 475 144 228  50],62,3,13943,4.099676565715966,0.0,20.0
13401,1,3401,[ 64  12 483 427  11],618,5,13948,4.099941211052323,60.0,0.0
13402,1,3402,[ 98 288   9 405 323],345,3,13951,4.0996179841316485,0.0,40.0
13403,1,3403,[323 475 288 268   1],416,3,13954,4.0992949471210345,0.0,20.0
13404,1,3404,[144 183 496  28 202],416,5,13959,4.099559471365639,0.0,0.0
13405,1,3405,[ 64  12 483 427  11],618,5,13964,4.099823840281855,60.0,0.0
13406,1,3406,[ 95 117 185  25 742],297,3,13967,4.099501027296742,0.0,0.0
13407,1,3407,[ 64  12 483 427  11],618,5,13972,4.099765258215962,60.0,0.0
13408,1,3408,[ 12 403 328 289 294],43,5,13977,4.100029334115576,20.0,0.0
13409,1,3409,[ 64  12 483 427  11],214,5,13982,4.100293255131965,60.0,0.0
13410,1,3410,[ 64  12 483 427  11],214,5,13987,4.1005570214013485,60.0,0.0
13411,1,3411,[475 182 318 180  12],214,5,13992,4.100820633059789,40.0,0.0
13412,1,3412,[271  50  56 471  11],922,2,13994,4.100205098154117,0.0,20.0
13413,1,3413,[ 70 515 153 265  97],416,5,13999,4.100468658465144,0.0,0.0
13414,1,3414,[318 300  98 174  97],654,4,14003,4.100439238653001,20.0,20.0
13415,1,3415,[257 508 483 427 269],214,3,14006,4.100117096018735,20.0,0.0
13416,1,3416,[ 64  12 483 427  11],214,5,14011,4.100380450687738,60.0,0.0
13417,1,3417,[ 64  12 483 427  11],214,5,14016,4.1006436512580455,60.0,0.0
13418,1,3418,[ 64  12 483 427  11],618,5,14021,4.100906697864873,60.0,0.0
13419,1,3419,[475  96 300 153 427],416,4,14025,4.100877192982456,0.0,0.0
13420,1,3420,[ 64  12 483 427  11],618,5,14030,4.101140017538731,60.0,0.0
13421,1,3421,[ 64  12 483 427  11],214,5,14035,4.1014026884862655,60.0,0.0
13422,1,3422,[ 64  12 483 427  11],618,5,14040,4.1016652059596845,60.0,0.0
13423,1,3423,[144 181 423 173 183],618,4,14044,4.1016355140186915,0.0,20.0
13424,1,3424,[ 64  12 483 427  11],214,5,14049,4.101897810218978,60.0,0.0
13425,1,3425,[  7 127 288 186 222],854,4,14053,4.101868067717454,0.0,20.0
13426,1,3426,[588 127 268 678  50],416,4,14057,4.1018383425736795,0.0,20.0
13427,1,3427,[ 64  12 483 427  11],214,5,14062,4.102100350058343,60.0,0.0
13428,1,3428,[ 11  88 111 269 313],751,2,14064,4.101487314085739,20.0,20.0
13429,1,3429,[216 179  22 405 275],62,4,14068,4.101457725947522,0.0,0.0
13430,1,3430,[151   8  79 748 238],416,4,14072,4.101428155056834,0.0,0.0
13431,1,3431,[ 64  12 483 427  11],214,5,14077,4.101689976689976,60.0,0.0
13432,1,3432,[ 15  12 385 174 288],618,3,14080,4.101369064957763,20.0,20.0
13433,1,3433,[161  11 257 269  96],751,3,14083,4.101048340128131,0.0,0.0
13434,1,3434,[174 111  25 200  96],854,1,14084,4.100145560407569,0.0,0.0
13435,1,3435,[  4 172 302  28 180],405,4,14088,4.10011641443539,0.0,0.0
13436,1,3436,[ 64  12 483 427  11],618,5,14093,4.100378236834449,60.0,0.0
13437,1,3437,[ 64  12 483 427  11],618,5,14098,4.10063990692263,60.0,0.0
13438,1,3438,[ 64  12 483 427  11],214,5,14103,4.1009014248328,60.0,0.0
13439,1,3439,[ 64  12 483 427  11],214,5,14108,4.101162790697674,60.0,0.0
13440,1,3440,[ 64  12 483 427  11],618,5,14113,4.101424004649811,60.0,0.0
13441,1,3441,[ 64  12 483 427  11],214,5,14118,4.101685066821616,60.0,0.0
13442,1,3442,[294 273 222  95 100],805,2,14120,4.101074644205634,0.0,0.0
13443,1,3443,[302 118 258 127 111],43,5,14125,4.101335656213705,0.0,0.0
13444,1,3444,[ 64  12 483 427  11],618,5,14130,4.101596516690856,60.0,0.0
13445,1,3445,[ 64  12 483 427  11],618,5,14135,4.101857225769008,60.0,0.0
13446,1,3446,[ 56 211 185 237   4],297,4,14139,4.101827676240209,0.0,0.0
13447,1,3447,[179 228 191 289 125],721,2,14141,4.101218097447796,0.0,0.0
13448,1,3448,[ 64  12 483 427  11],214,5,14146,4.10147868947521,60.0,0.0
13449,1,3449,[ 64  12 483 427  11],214,5,14151,4.101739130434782,60.0,0.0
13450,1,3450,[ 64  12 483 427  11],214,5,14156,4.1019994204578385,60.0,0.0
13451,1,3451,[ 64  12 483 427  11],214,5,14161,4.1022595596755504,60.0,0.0
13452,1,3452,[ 69 172 211  28 153],43,5,14166,4.1025195482189405,0.0,0.0
13453,1,3453,[271  15 143 153  28],43,4,14170,4.102489866821077,0.0,0.0
13454,1,3454,[210 238 286 204 174],62,3,14173,4.102170767004342,0.0,0.0
13455,1,3455,[211 172   9 313 282],416,5,14178,4.102430555555555,20.0,20.0
13456,1,3456,[471 191 237 288 182],416,4,14182,4.102400925658085,0.0,20.0
13457,1,3457,[483 172 100 118   8],618,3,14185,4.102082128397918,20.0,0.0
13458,1,3458,[ 64  12 483 427  11],618,5,14190,4.102341717259323,60.0,0.0
13459,1,3459,[ 64  12 483 427  11],618,5,14195,4.1026011560693645,60.0,0.0
13460,1,3460,[357 257 483 294  50],214,2,14197,4.101993643455649,20.0,20.0
13461,1,3461,[403 183 185 423 196],416,5,14202,4.102253032928942,0.0,0.0
13462,1,3462,[161 195 471 655  69],922,0,14202,4.101068437770719,0.0,0.0
13463,1,3463,[ 64  12 483 427  11],214,5,14207,4.101327944572748,60.0,0.0
13464,1,3464,[ 12 194 318 269 211],416,5,14212,4.101587301587301,40.0,0.0
13465,1,3465,[118 186 117 294  50],417,4,14216,4.101557991921523,0.0,20.0
13466,1,3466,[ 64  12 483 427  11],214,5,14221,4.101817132967984,60.0,0.0
13467,1,3467,[ 64  12 483 427  11],618,5,14226,4.102076124567474,60.0,0.0
13468,1,3468,[ 64  12 483 427  11],214,5,14231,4.102334966849236,60.0,0.0
13469,1,3469,[  7   1 197 265 121],618,4,14235,4.1023054755043225,0.0,0.0
13470,1,3470,[ 64  12 483 427  11],214,5,14240,4.102564102564102,60.0,0.0
13471,1,3471,[ 64  12 483 427  11],214,5,14245,4.102822580645161,60.0,0.0
13472,1,3472,[ 64  12 483 427  11],214,5,14250,4.103080909876188,60.0,0.0
13473,1,3473,[257 301 258  50  88],711,4,14254,4.103051237766263,0.0,20.0
13474,1,3474,[  1 191 597 300 282],630,3,14257,4.102733812949641,0.0,0.0
13475,1,3475,[161  69  56 173 216],43,5,14262,4.102991944764097,0.0,0.0
13476,1,3476,[ 64  12 483 427  11],618,5,14267,4.103249928098936,60.0,0.0
13477,1,3477,[ 64  12 483 427  11],618,5,14272,4.103507763082231,60.0,0.0
13478,1,3478,[ 82 276 275  69 143],416,4,14276,4.103478010922679,0.0,0.0
13479,1,3479,[ 64  12 483 427  11],214,5,14281,4.103735632183908,60.0,0.0
13480,1,3480,[ 64  12 483 427  11],618,5,14286,4.103993105429474,60.0,0.0
13481,1,3481,[ 64  12 483 427  11],618,5,14291,4.104250430786904,60.0,0.0
13482,1,3482,[ 64  12 483 427  11],618,5,14296,4.104507608383577,60.0,0.0
13483,1,3483,[742 300  98   1 182],128,4,14300,4.104477611940299,0.0,20.0
13484,1,3484,[ 64  12 483 427  11],214,5,14305,4.104734576757532,60.0,0.0
13485,1,3485,[ 64  12 483 427  11],618,5,14310,4.104991394148021,60.0,0.0
13486,1,3486,[ 64  12 483 427  11],618,5,14315,4.105248064238601,60.0,0.0
13487,1,3487,[182  89 238 187  70],405,2,14317,4.104644495412844,0.0,0.0
13488,1,3488,[273 200 496 245  79],417,2,14319,4.104041272570937,0.0,0.0
13489,1,3489,[385  71  79 196 333],416,5,14324,4.104297994269341,0.0,0.0
13490,1,3490,[ 64  12 483 427  11],618,5,14329,4.1045545688914356,60.0,0.0
13491,1,3491,[ 64  12 483 427  11],618,5,14334,4.1048109965635735,60.0,0.0
13492,1,3492,[ 64  12 483 427  11],214,5,14339,4.105067277411967,60.0,0.0
13493,1,3493,[ 64  12 483 427  11],214,5,14344,4.105323411562678,60.0,0.0
13494,1,3494,[ 64  12 483 427  11],214,5,14349,4.1055793991416305,60.0,0.0
13495,1,3495,[ 64  12 483 427  11],214,5,14354,4.105835240274599,60.0,0.0
13496,1,3496,[ 64  12 483 427  11],618,5,14359,4.1060909350872175,60.0,0.0
13497,1,3497,[  8 302  50 289 328],49,2,14361,4.105488850771869,0.0,20.0
13498,1,3498,[ 64  12 483 427  11],618,5,14366,4.105744498428122,60.0,0.0
13499,1,3499,[196 195 216   4  96],198,2,14368,4.105142857142857,0.0,0.0
13500,1,3500,[195 269 234 268 200],297,2,14370,4.104541559554413,0.0,0.0
13501,1,3501,[173 117 151  12  97],62,4,14374,4.10451170759566,20.0,0.0
13502,1,3502,[ 64  12 483 427  11],618,5,14379,4.1047673422780475,60.0,0.0
13503,1,3503,[ 64  12 483 427  11],214,5,14384,4.105022831050229,60.0,0.0
13504,1,3504,[ 64  12 483 427  11],214,5,14389,4.10527817403709,60.0,0.0
13505,1,3505,[117  12  69 215  70],297,3,14392,4.104962920707359,20.0,0.0
13506,1,3506,[181 282 172 483 496],588,4,14396,4.104932991160536,20.0,20.0
13507,1,3507,[ 64  12 483 427  11],618,5,14401,4.105188141391106,60.0,0.0
13508,1,3508,[ 11  64 144 234 268],417,4,14405,4.105158164719294,20.0,0.0
13509,1,3509,[282  22 234 588 237],416,4,14409,4.105128205128205,0.0,0.0
13510,1,3510,[ 64  12 483 427  11],618,5,14414,4.105383081743093,60.0,0.0
13511,1,3511,[405 210 153 302  97],654,4,14418,4.105353075170843,0.0,0.0
13512,1,3512,[111  28 168 132 597],416,4,14422,4.1053230856817535,0.0,0.0
13513,1,3513,[ 64  12 483 427  11],618,5,14427,4.105577689243028,60.0,0.0
13514,1,3514,[135  11 423 200 322],417,3,14430,4.105263157894737,0.0,0.0
13515,1,3515,[318 200 125 471 258],274,5,14435,4.10551763367463,20.0,0.0
13516,1,3516,[276 185 161 318 235],416,3,14438,4.105203298265567,20.0,0.0
13517,1,3517,[ 64  12 483 427  11],214,5,14443,4.105457646389994,60.0,0.0
13518,1,3518,[ 64  12 483 427  11],618,5,14448,4.105711849957374,60.0,0.0
13519,1,3519,[568 215 111  70 483],618,3,14451,4.105397727272727,20.0,0.0
13520,1,3520,[ 64  12 483 427  11],214,5,14456,4.105651803464925,60.0,0.0
13521,1,3521,[216  69  64 405 197],198,4,14460,4.105621805792164,20.0,0.0
13522,1,3522,[ 64  12 483 427  11],618,5,14465,4.105875674141357,60.0,0.0
13523,1,3523,[ 71 204  25 175  50],805,3,14468,4.105561861520999,0.0,20.0
13524,1,3524,[ 64  12 483 427  11],214,5,14473,4.10581560283688,60.0,0.0
13525,1,3525,[234 121 183   1  98],198,3,14476,4.105501985252411,0.0,20.0
13526,1,3526,[294  97  50 385 196],417,4,14480,4.1054720725829315,0.0,20.0
13527,1,3527,[174  71  98  22 269],416,5,14485,4.105725623582766,0.0,20.0
13528,1,3528,[ 64  12 483 427  11],618,5,14490,4.105979030886937,60.0,0.0
13529,1,3529,[ 64  12 483 427  11],214,5,14495,4.106232294617564,60.0,0.0
13530,1,3530,[275 111  96 121 172],921,4,14499,4.106202209005947,0.0,0.0
13531,1,3531,[117 204  82 195 405],416,5,14504,4.106455266138165,0.0,0.0
13532,1,3532,[204 144 161 742  69],505,1,14505,4.105575997735635,0.0,0.0
13533,1,3533,[100 181 302  50 216],43,5,14510,4.10582908885116,0.0,40.0
13534,1,3534,[222 180 151 216 111],417,2,14512,4.105233380480906,0.0,0.0
13535,1,3535,[183  89 121  28 173],705,2,14514,4.104638009049774,0.0,0.0
13536,1,3536,[323 403  82 245 588],417,3,14517,4.104325699745547,0.0,0.0
13537,1,3537,[185   4 100 423 215],618,4,14521,4.104296212549463,0.0,0.0
13538,1,3538,[ 64  12 483 427  11],618,5,14526,4.104549307714043,60.0,0.0
13539,1,3539,[403 300  79 318  82],198,2,14528,4.103954802259887,20.0,0.0
13540,1,3540,[174  95   8 265 228],297,2,14530,4.103360632589664,0.0,0.0
13541,1,3541,[313 258 204 186  98],711,3,14533,4.103049124788255,20.0,40.0
13542,1,3542,[269 174 153  64 322],721,5,14538,4.103302286198137,20.0,0.0
13543,1,3543,[ 64  12 483 427  11],214,5,14543,4.103555304740406,60.0,0.0
13544,1,3544,[ 64  12 483 427  11],618,5,14548,4.1038081805359665,60.0,0.0
13545,1,3545,[132 151 257  71 202],416,3,14551,4.103496897913142,0.0,0.0
13546,1,3546,[210 100 258 185 151],417,2,14553,4.102903862418946,0.0,0.0
13547,1,3547,[ 22 276 151 117 265],654,4,14557,4.102874859075536,0.0,0.0
13548,1,3548,[ 64  12 483 427  11],214,5,14562,4.10312764158918,60.0,0.0
13549,1,3549,[ 64  12 483 427  11],618,5,14567,4.103380281690141,60.0,0.0
13550,1,3550,[ 64  12 483 427  11],214,5,14572,4.103632779498732,60.0,0.0
13551,1,3551,[ 64  12 483 427  11],618,5,14577,4.103885135135135,60.0,0.0
13552,1,3552,[ 28 210 222 258 403],805,2,14579,4.1032929918378835,0.0,0.0
13553,1,3553,[ 64  12 483 427  11],618,5,14584,4.103545301069218,60.0,0.0
13554,1,3554,[172 168   4  97 121],618,4,14588,4.10351617440225,0.0,0.0
13555,1,3555,[ 64  12 483 427  11],214,5,14593,4.10376827896513,60.0,0.0
13556,1,3556,[ 64  12 483 427  11],618,5,14598,4.104020241776778,60.0,0.0
13557,1,3557,[ 64  12 483 427  11],214,5,14603,4.104272062956717,60.0,0.0
13558,1,3558,[ 64  12 483 427  11],618,5,14608,4.104523742624333,60.0,0.0
13559,1,3559,[ 64  12 483 427  11],214,5,14613,4.104775280898877,60.0,0.0
13560,1,3560,[ 64  12 483 427  11],214,5,14618,4.105026677899467,60.0,0.0
13561,1,3561,[ 64  12 483 427  11],618,5,14623,4.105277933745087,60.0,0.0
13562,1,3562,[288 111 186 187 385],618,3,14626,4.104967723828235,0.0,20.0
13563,1,3563,[ 64  12 483 427  11],618,5,14631,4.1052188552188555,60.0,0.0
13564,1,3564,[235 257  11 200   1],922,3,14634,4.104908835904628,0.0,0.0
13565,1,3565,[216 153 151 748  15],373,5,14639,4.105159842961301,0.0,0.0
13566,1,3566,[322 111 117  70  28],314,4,14643,4.1051303616484445,0.0,0.0
13567,1,3567,[216  95 195  11 144],437,2,14645,4.104540358744394,0.0,0.0
13568,1,3568,[ 64  12 483 427  11],618,5,14650,4.104791258055478,60.0,0.0
13569,1,3569,[174 202  71 197 275],373,3,14653,4.1044817927170865,0.0,0.0
13570,1,3570,[ 64  12 483 427  11],214,5,14658,4.104732567908149,60.0,0.0
13571,1,3571,[423 234 202 568 194],405,4,14662,4.104703247480403,0.0,0.0
13572,1,3572,[328 257 237 216 300],43,5,14667,4.10495382031906,0.0,0.0
13573,1,3573,[222 121 174 423 210],128,3,14670,4.10464465584779,0.0,0.0
13574,1,3574,[ 64  12 483 427  11],214,5,14675,4.104895104895105,60.0,0.0
13575,1,3575,[ 64  12 483 427  11],618,5,14680,4.105145413870246,60.0,0.0
13576,1,3576,[ 69 204 496 196 405],654,5,14685,4.105395582890691,0.0,0.0
13577,1,3577,[ 64  12 483 427  11],618,5,14690,4.1056456120737845,60.0,0.0
13578,1,3578,[ 64  12 483 427  11],214,5,14695,4.105895501536742,60.0,0.0
13579,1,3579,[204 100 174 257 238],43,4,14699,4.10586592178771,0.0,0.0
13580,1,3580,[ 64  12 483 427  11],618,5,14704,4.106115610164759,60.0,0.0
13581,1,3581,[168 588 742 174 748],642,5,14709,4.106365159128978,0.0,0.0
13582,1,3582,[ 64  12 483 427  11],618,5,14714,4.106614568797097,60.0,0.0
13583,1,3583,[282 111 238 215   8],416,5,14719,4.106863839285714,0.0,0.0
13584,1,3584,[ 95 202   7 181 121],618,3,14722,4.106555090655509,0.0,20.0
13585,1,3585,[268 508 168 121  88],128,4,14726,4.106525376464027,0.0,0.0
13586,1,3586,[ 64  12 483 427  11],214,5,14731,4.106774463339838,60.0,0.0
13587,1,3587,[238 210 423 742 427],416,5,14736,4.107023411371237,0.0,0.0
13588,1,3588,[ 69 265   4 117  12],618,4,14740,4.106993591529674,20.0,0.0
13589,1,3589,[  1 182 294  97   7],505,1,14741,4.106128133704735,0.0,0.0
13590,1,3590,[ 64  12 483 427  11],214,5,14746,4.106377053745475,60.0,0.0
13591,1,3591,[294 179 357 333 288],875,4,14750,4.106347438752784,0.0,20.0
13592,1,3592,[405 282 423 196 144],654,4,14754,4.1063178402449205,0.0,0.0
13593,1,3593,[ 64  12 483 427  11],214,5,14759,4.106566499721758,60.0,0.0
13594,1,3594,[302 174   4  15   1],416,5,14764,4.106815020862308,0.0,0.0
13595,1,3595,[ 64  12 483 427  11],214,5,14769,4.1070634037819795,60.0,0.0
13596,1,3596,[ 64  12 483 427  11],214,5,14774,4.107311648596053,60.0,0.0
13597,1,3597,[168   4 228  70 174],62,3,14777,4.107003891050583,0.0,0.0
13598,1,3598,[  7 269  71 258 153],805,3,14780,4.106696304529036,0.0,0.0
13599,1,3599,[ 12 275  88 435 475],437,2,14782,4.106111111111111,20.0,0.0
13600,1,3600,[ 88  56  22  79 271],805,2,14784,4.105526242710358,0.0,0.0
13601,1,3601,[ 64  12 483 427  11],618,5,14789,4.1057745696835095,60.0,0.0
13602,1,3602,[118  88 179 204 197],437,3,14792,4.105467665834027,0.0,0.0
13603,1,3603,[546 288 748 245 222],417,2,14794,4.10488346281909,0.0,20.0
13604,1,3604,[ 64  12 483 427  11],618,5,14799,4.105131761442441,60.0,0.0
13605,1,3605,[ 64  12 483 427  11],618,5,14804,4.105379922351636,60.0,0.0
13606,1,3606,[ 64  12 483 427  11],214,5,14809,4.105627945661214,60.0,0.0
13607,1,3607,[  7  79 483 603 111],751,3,14812,4.105321507760532,20.0,0.0
13608,1,3608,[483 234 318  70 132],437,4,14816,4.105292324743696,40.0,0.0
13609,1,3609,[ 15 172 161 258 187],416,5,14821,4.105540166204986,0.0,0.0
13610,1,3610,[603  25 258 153  12],805,4,14825,4.105510938798117,20.0,0.0
13611,1,3611,[ 64  12 483 427  11],618,5,14830,4.1057585825027685,60.0,0.0
13612,1,3612,[ 64  12 483 427  11],214,5,14835,4.106006089122613,60.0,0.0
13613,1,3613,[174 257 173  98 265],416,4,14839,4.105976757055894,0.0,20.0
13614,1,3614,[ 56 196  70  22 153],721,3,14842,4.10567081604426,0.0,0.0
13615,1,3615,[179 228 168 294 655],805,2,14844,4.105088495575221,0.0,0.0
13616,1,3616,[ 64  12 483 427  11],618,5,14849,4.105335913740669,60.0,0.0
13617,1,3617,[ 69 265  70 234 200],198,2,14851,4.104754007739082,0.0,0.0
13618,1,3618,[ 64  12 483 427  11],618,5,14856,4.105001381597126,60.0,0.0
13619,1,3619,[215 265 181 742 118],416,4,14860,4.104972375690608,0.0,20.0
13620,1,3620,[168 234 132  82 181],416,5,14865,4.105219552609777,0.0,20.0
13621,1,3621,[168 181 186 234 302],417,3,14868,4.104914411927112,0.0,20.0
13622,1,3622,[ 64  12 483 427  11],214,5,14873,4.105161468396356,60.0,0.0
13623,1,3623,[ 64  12 483 427  11],618,5,14878,4.105408388520972,60.0,0.0
13624,1,3624,[118 135  71 117  82],618,4,14882,4.105379310344827,0.0,0.0
13625,1,3625,[ 64  12 483 427  11],618,5,14887,4.105626034197463,60.0,0.0
13626,1,3626,[195 151 200 118 427],887,4,14891,4.105596912048525,0.0,0.0
13627,1,3627,[ 64  12 483 427  11],214,5,14896,4.105843439911797,60.0,0.0
13628,1,3628,[ 64  12 483 427  11],618,5,14901,4.106089831909617,60.0,0.0
13629,1,3629,[ 82 181  56 127   7],805,2,14903,4.105509641873279,0.0,20.0
13630,1,3630,[ 64  12 483 427  11],618,5,14908,4.105755990085376,60.0,0.0
13631,1,3631,[ 64  12 483 427  11],214,5,14913,4.106002202643172,60.0,0.0
13632,1,3632,[ 64  12 483 427  11],618,5,14918,4.1062482796586846,60.0,0.0
13633,1,3633,[117  25 294 483 111],417,3,14921,4.105943863511282,20.0,0.0
13634,1,3634,[ 64  12 483 427  11],618,5,14926,4.1061898211829435,60.0,0.0
13635,1,3635,[ 64  12 483 427  11],618,5,14931,4.106435643564357,60.0,0.0
13636,1,3636,[168 135  25 151 275],297,4,14935,4.106406378883696,0.0,0.0
13637,1,3637,[ 64  12 483 427  11],618,5,14940,4.106652006597032,60.0,0.0
13638,1,3638,[  4  22 508 153  11],654,4,14944,4.106622698543556,0.0,0.0
13639,1,3639,[603 235 210  79 174],416,4,14948,4.106593406593406,0.0,0.0
13640,1,3640,[ 64  12 483 427  11],214,5,14953,4.106838780554793,60.0,0.0
13641,1,3641,[742 111  28 294  56],345,3,14956,4.106534870950028,0.0,0.0
13642,1,3642,[ 64  12 483 427  11],618,5,14961,4.106780126269558,60.0,0.0
13643,1,3643,[275 235 211 603 357],416,4,14965,4.10675082327113,0.0,0.0
13644,1,3644,[357 496 172 385   8],230,4,14969,4.1067215363511655,0.0,0.0
13645,1,3645,[ 64  12 483 427  11],618,5,14974,4.106966538672518,60.0,0.0
13646,1,3646,[ 64  12 483 427  11],214,5,14979,4.1072114066355905,60.0,0.0
13647,1,3647,[  7 222 257  11   9],630,3,14982,4.1069078947368425,0.0,0.0
13648,1,3648,[322 202 275  50 179],416,3,14985,4.10660454919156,0.0,20.0
13649,1,3649,[ 25  15  96 269 333],854,1,14986,4.105753424657534,0.0,0.0
13650,1,3650,[161  70 210  22 238],416,5,14991,4.105998356614626,0.0,0.0
13651,1,3651,[ 50 100 118 117 357],62,4,14995,4.105969331872946,0.0,20.0
13652,1,3652,[ 64  12 483 427  11],214,5,15000,4.106214070626882,60.0,0.0
13653,1,3653,[ 64  12 483 427  11],214,5,15005,4.106458675424193,60.0,0.0
13654,1,3654,[655 197 175 191  12],373,3,15008,4.106155950752394,20.0,0.0
13655,1,3655,[ 64  12 483 427  11],214,5,15013,4.106400437636761,60.0,0.0
13656,1,3656,[257 185  11 194 294],297,2,15015,4.105824446267432,0.0,0.0
13657,1,3657,[ 64  12 483 427  11],214,5,15020,4.106068890103882,60.0,0.0
13658,1,3658,[ 95  22  82  98 191],505,4,15024,4.106039901612462,0.0,20.0
13659,1,3659,[ 64  12 483 427  11],214,5,15029,4.106284153005465,60.0,0.0
13660,1,3660,[322 748 245 483 151],907,5,15034,4.106528270964217,20.0,0.0
13661,1,3661,[ 22 546 194 121  96],416,4,15038,4.106499180775533,0.0,0.0
13662,1,3662,[ 64  12 483 427  11],214,5,15043,4.106743106743107,60.0,0.0
13663,1,3663,[ 64  12 483 427  11],214,5,15048,4.106986899563319,60.0,0.0
13664,1,3664,[ 64  12 483 427  11],618,5,15053,4.107230559345157,60.0,0.0
13665,1,3665,[427  89  25  69 265],373,5,15058,4.107474086197491,0.0,0.0
13666,1,3666,[ 64  12 483 427  11],214,5,15063,4.10771748022907,60.0,0.0
13667,1,3667,[ 64  12 483 427  11],214,5,15068,4.107960741548528,60.0,0.0
13668,1,3668,[ 64  12 483 427  11],214,5,15073,4.1082038702643775,60.0,0.0
13669,1,3669,[ 64  12 483 427  11],618,5,15078,4.108446866485013,60.0,0.0
13670,1,3670,[ 15 318  22 483  96],601,3,15081,4.108144919640425,40.0,0.0
13671,1,3671,[216 195 427 568 181],642,2,15083,4.107570806100218,0.0,20.0
13672,1,3672,[179 276 301  79 603],437,4,15087,4.107541519194119,0.0,0.0
13673,1,3673,[ 64  12 483 427  11],618,5,15092,4.107784431137724,60.0,0.0
13674,1,3674,[174  22 286 132   8],62,4,15096,4.107755102040817,0.0,0.0
13675,1,3675,[ 96 191 174 173 196],618,3,15099,4.107453754080522,0.0,0.0
13676,1,3676,[ 64  12 483 427  11],214,5,15104,4.107696491705195,60.0,0.0
13677,1,3677,[222 143 357 132 204],698,3,15107,4.107395323545405,0.0,0.0
13678,1,3678,[191 185 172 385  95],417,3,15110,4.1070943191084535,0.0,0.0
13679,1,3679,[ 12 471 185 127 153],416,5,15115,4.107336956521739,20.0,0.0
13680,1,3680,[ 64  12 483 427  11],214,5,15120,4.10757946210269,60.0,0.0
13681,1,3681,[ 95 742 174  25 210],751,4,15124,4.107550244432374,0.0,0.0
13682,1,3682,[ 64  12 483 427  11],214,5,15129,4.107792560412707,60.0,0.0
13683,1,3683,[294 475 132 216 144],62,3,15132,4.107491856677524,0.0,0.0
13684,1,3684,[100 135 173 475 483],214,4,15136,4.107462686567164,20.0,0.0
13685,1,3685,[ 64  12 483 427  11],214,5,15141,4.1077048290830165,60.0,0.0
13686,1,3686,[ 64  12 483 427  11],618,5,15146,4.107946840249525,60.0,0.0
13687,1,3687,[ 64  12 483 427  11],618,5,15151,4.108188720173536,60.0,0.0
13688,1,3688,[ 98 143 282 265 268],297,3,15154,4.107888316616969,0.0,20.0
13689,1,3689,[ 64  12 483 427  11],618,5,15159,4.108130081300813,60.0,0.0
13690,1,3690,[173 483 357 153 127],854,5,15164,4.10837171498239,20.0,0.0
13691,1,3691,[603 185 423  28 215],416,5,15169,4.108613217768148,0.0,0.0
13692,1,3692,[151 313 144 294 300],505,2,15171,4.10804224207961,20.0,20.0
13693,1,3693,[117   7 222 200   4],297,3,15174,4.10774228478614,0.0,0.0
13694,1,3694,[ 64  12 483 427  11],618,5,15179,4.107983761840325,60.0,0.0
13695,1,3695,[ 64  12 483 427  11],618,5,15184,4.108225108225108,60.0,0.0
13696,1,3696,[202 174 117 237 269],297,4,15188,4.108195834460373,0.0,0.0
13697,1,3697,[403 568  69   1 258],43,5,15193,4.108436992969173,0.0,0.0
13698,1,3698,[ 64  12 483 427  11],618,5,15198,4.108678021086781,60.0,0.0
13699,1,3699,[176 118  97 121 546],270,4,15202,4.108648648648648,0.0,0.0
13700,1,3700,[ 64  12 483 427  11],618,5,15207,4.1088894893272085,60.0,0.0
13701,1,3701,[216 288  98  79 258],588,4,15211,4.108860075634792,0.0,40.0
13702,1,3702,[ 64  12 483 427  11],214,5,15216,4.109100729138536,60.0,0.0
13703,1,3703,[ 96 210 196   4 172],712,5,15221,4.109341252699784,0.0,0.0
13704,1,3704,[ 64  12 483 427  11],214,5,15226,4.109581646423751,60.0,0.0
13705,1,3705,[  4  28 235 271   7],43,3,15229,4.109282245008095,0.0,0.0
13706,1,3706,[183 300  28  25  56],416,5,15234,4.109522524952792,0.0,0.0
13707,1,3707,[ 64  12 483 427  11],214,5,15239,4.109762675296656,60.0,0.0
13708,1,3708,[ 64  12 483 427  11],618,5,15244,4.110002696144513,60.0,0.0
13709,1,3709,[ 64  12 483 427  11],618,5,15249,4.110242587601078,60.0,0.0
13710,1,3710,[ 64  12 483 427  11],214,5,15254,4.110482349770951,60.0,0.0
13711,1,3711,[ 64  12 483 427  11],618,5,15259,4.110721982758621,60.0,0.0
13712,1,3712,[ 88 100 588 117 125],618,4,15263,4.110692162671694,0.0,0.0
13713,1,3713,[ 64  12 483 427  11],214,5,15268,4.110931610123855,60.0,0.0
13714,1,3714,[385 588  56 127 238],805,2,15270,4.110363391655451,0.0,0.0
13715,1,3715,[100 202   9 748 322],805,1,15271,4.109526372443487,0.0,0.0
13716,1,3716,[235  28 121 245 301],416,3,15274,4.109227871939736,0.0,0.0
13717,1,3717,[ 64  12 483 427  11],618,5,15279,4.109467455621302,60.0,0.0
13718,1,3718,[ 64  12 483 427  11],214,5,15284,4.109706910459801,60.0,0.0
13719,1,3719,[ 64  12 483 427  11],618,5,15289,4.10994623655914,60.0,0.0
13720,1,3720,[ 64  12 483 427  11],214,5,15294,4.110185434023112,60.0,0.0
13721,1,3721,[ 64  12 483 427  11],214,5,15299,4.1104245029554,60.0,0.0
13722,1,3722,[603 117 211  69 179],373,4,15303,4.110394842868654,0.0,0.0
13723,1,3723,[357 200  79   9 132],416,5,15308,4.11063372717508,0.0,0.0
13724,1,3724,[742 515 748   7  64],417,3,15311,4.110335570469799,20.0,0.0
13725,1,3725,[176 588  50 151 173],601,2,15313,4.1097691894793345,0.0,20.0
13726,1,3726,[ 64  12 483 427  11],618,5,15318,4.110008049369466,60.0,0.0
13727,1,3727,[ 64  12 483 427  11],214,5,15323,4.11024678111588,60.0,0.0
13728,1,3728,[ 64  12 483 427  11],214,5,15328,4.110485384821668,60.0,0.0
13729,1,3729,[196 588 173  56 135],618,4,15332,4.110455764075067,0.0,0.0
13730,1,3730,[ 64  12 483 427  11],214,5,15337,4.110694183864916,60.0,0.0
13731,1,3731,[202 655  56 176  96],887,4,15341,4.110664523043944,0.0,0.0
13732,1,3732,[ 64  12 483 427  11],214,5,15346,4.110902759174927,60.0,0.0
13733,1,3733,[ 64  12 483 427  11],618,5,15351,4.111140867702196,60.0,0.0
13734,1,3734,[588 357 143  11  95],230,5,15356,4.111378848728246,0.0,0.0
13735,1,3735,[427 234 228 182 313],405,3,15359,4.1110813704496785,20.0,20.0
13736,1,3736,[ 95 176 191 172  97],417,4,15363,4.111051645705111,0.0,0.0
13737,1,3737,[234 568  56 182 196],618,5,15368,4.111289459604066,0.0,0.0
13738,1,3738,[ 64  12 483 427  11],214,5,15373,4.111527146295801,60.0,0.0
13739,1,3739,[200 211  79 176 118],297,2,15375,4.11096256684492,0.0,0.0
13740,1,3740,[273   7  25 423  56],854,4,15379,4.110932905640203,0.0,0.0
13741,1,3741,[ 64  12 483 427  11],214,5,15384,4.111170497060396,60.0,0.0
13742,1,3742,[ 64  12 483 427  11],214,5,15389,4.111407961528186,60.0,0.0
13743,1,3743,[568  82  96 323 276],416,3,15392,4.111111111111111,0.0,0.0
13744,1,3744,[ 64  12 483 427  11],214,5,15397,4.111348464619493,60.0,0.0
13745,1,3745,[ 64  12 483 427  11],214,5,15402,4.111585691404165,60.0,0.0
13746,1,3746,[ 64  12 483 427  11],618,5,15407,4.111822791566587,60.0,0.0
13747,1,3747,[151 216 173  70  22],642,2,15409,4.111259338313768,0.0,0.0
13748,1,3748,[289 385 118   8 191],43,5,15414,4.111496399039744,0.0,0.0
13749,1,3749,[187 125 423 182 301],416,5,15419,4.1117333333333335,0.0,0.0
13750,1,3750,[245 179 180  79 121],128,3,15422,4.1114369501466275,0.0,0.0
13751,1,3751,[ 12 323 257 597 276],416,1,15423,4.110607675906183,20.0,0.0
13752,1,3752,[ 15 403 323 302 282],721,3,15426,4.110311750599521,0.0,0.0
13753,1,3753,[ 64  12 483 427  11],214,5,15431,4.110548748002131,60.0,0.0
13754,1,3754,[ 64  12 483 427  11],214,5,15436,4.110785619174434,60.0,0.0
13755,1,3755,[183  98  96 202 191],505,2,15438,4.110223642172524,0.0,20.0
13756,1,3756,[ 64  12 483 427  11],214,5,15443,4.110460473782273,60.0,0.0
13757,1,3757,[ 50 748 173 282 427],416,5,15448,4.110697179350718,0.0,20.0
13758,1,3758,[ 64  12 483 427  11],214,5,15453,4.110933758978452,60.0,0.0
13759,1,3759,[175 211 196  89 153],373,4,15457,4.110904255319149,0.0,0.0
13760,1,3760,[ 64  12 483 427  11],618,5,15462,4.111140654081361,60.0,0.0
13761,1,3761,[ 64  12 483 427  11],214,5,15467,4.1113769271664005,60.0,0.0
13762,1,3762,[ 64  12 483 427  11],214,5,15472,4.1116130746744615,60.0,0.0
13763,1,3763,[179 143 183 175   8],405,2,15474,4.11105207226355,0.0,0.0
13764,1,3764,[228 143 127  69 172],405,4,15478,4.111022576361222,0.0,0.0
13765,1,3765,[117 496 234 742 143],230,5,15483,4.111258629845991,0.0,0.0
13766,1,3766,[ 64  12 483 427  11],618,5,15488,4.1114945580037165,60.0,0.0
13767,1,3767,[151  82 191  79 423],437,4,15492,4.111464968152866,0.0,0.0
13768,1,3768,[ 64  12 483 427  11],214,5,15497,4.11170071637039,60.0,0.0
13769,1,3769,[ 64  12 483 427  11],214,5,15502,4.111936339522546,60.0,0.0
13770,1,3770,[ 64  12 483 427  11],618,5,15507,4.11217183770883,60.0,0.0
13771,1,3771,[ 64  12 483 427  11],618,5,15512,4.112407211028632,60.0,0.0
13772,1,3772,[ 64  12 483 427  11],214,5,15517,4.112642459581235,60.0,0.0
13773,1,3773,[273 257 168 302 153],416,4,15521,4.112612612612613,0.0,0.0
13774,1,3774,[318 742 655 403 427],416,5,15526,4.112847682119205,20.0,0.0
13775,1,3775,[546 168 144  12 403],62,4,15530,4.1128177966101696,20.0,0.0
13776,1,3776,[ 64  12 483 427  11],618,5,15535,4.113052687317977,60.0,0.0
13777,1,3777,[182 186  25 275 238],128,4,15539,4.11302276336686,0.0,0.0
13778,1,3778,[403 100 172 174  22],618,5,15544,4.113257475522625,0.0,0.0
13779,1,3779,[ 64  12 483 427  11],214,5,15549,4.113492063492063,60.0,0.0
13780,1,3780,[318  97  89 143 237],437,3,15552,4.113197566781275,20.0,0.0
13781,1,3781,[121   7 125 151 235],416,3,15555,4.112903225806452,0.0,0.0
13782,1,3782,[ 22 182 333 127 748],416,5,15560,4.113137721385144,0.0,0.0
13783,1,3783,[132 276 194 117 168],416,4,15564,4.113107822410148,0.0,0.0
13784,1,3784,[235 655 132  69 302],345,4,15568,4.1130779392338175,0.0,0.0
13785,1,3785,[ 64  12 483 427  11],214,5,15573,4.113312202852615,60.0,0.0
13786,1,3786,[258 403 196  50 475],417,4,15577,4.1132822814893055,0.0,20.0
13787,1,3787,[228 196 597 180 181],805,0,15577,4.1121964097148895,0.0,20.0
13788,1,3788,[ 64  12 483 427  11],618,5,15582,4.11243072050673,60.0,0.0
13789,1,3789,[  1  79  97 282 258],128,2,15584,4.111873350923483,0.0,0.0
13790,1,3790,[ 50 234  96 294 216],417,2,15586,4.111316275389079,0.0,20.0
13791,1,3791,[ 64  12 483 427  11],618,5,15591,4.111550632911392,60.0,0.0
13792,1,3792,[ 64 405  98 288 257],854,4,15595,4.11152122330609,20.0,40.0
13793,1,3793,[ 64  12 483 427  11],214,5,15600,4.111755403268319,60.0,0.0
13794,1,3794,[405 496 357 174 127],601,4,15604,4.111725955204216,0.0,0.0
13795,1,3795,[196 403  95 385  64],705,5,15609,4.1119599578503685,20.0,0.0
13796,1,3796,[ 64  12 483 427  11],618,5,15614,4.112193837239926,60.0,0.0
13797,1,3797,[197 286  88 125 132],373,2,15616,4.111637704054766,0.0,0.0
13798,1,3798,[257 222  15 202 294],417,3,15619,4.111345090813372,0.0,0.0
13799,1,3799,[ 64  12 483 427  11],214,5,15624,4.111578947368421,60.0,0.0
13800,1,3800,[194 211 245 196 181],416,4,15628,4.111549592212576,0.0,20.0
13801,1,3801,[132  79 237 183  96],198,3,15631,4.111257233035245,0.0,0.0
13802,1,3802,[204 302 168 181 385],49,2,15633,4.110702077307389,0.0,20.0
13803,1,3803,[ 64  12 483 427  11],214,5,15638,4.110935856992639,60.0,0.0
13804,1,3804,[300 202 546  12 173],43,5,15643,4.111169513797635,20.0,0.0
13805,1,3805,[ 64  12 483 427  11],618,5,15648,4.111403047819233,60.0,0.0
13806,1,3806,[268 121  97 181 185],270,5,15653,4.11163645915419,0.0,20.0
13807,1,3807,[211 313 276  15 323],43,4,15657,4.111607142857143,20.0,20.0
13808,1,3808,[  7 143  69 228 204],297,2,15659,4.111052769755841,0.0,0.0
13809,1,3809,[ 64  12 483 427  11],618,5,15664,4.111286089238845,60.0,0.0
13810,1,3810,[ 64  12 483 427  11],618,5,15669,4.111519286276568,60.0,0.0
13811,1,3811,[ 88 742  15   8 210],642,5,15674,4.111752360965372,0.0,0.0
13812,1,3812,[202 179 153 742 603],751,4,15678,4.111723052714398,0.0,0.0
13813,1,3813,[ 64  12 483 427  11],618,5,15683,4.111955951756686,60.0,0.0
13814,1,3814,[ 64  12 483 427  11],618,5,15688,4.11218872870249,60.0,0.0
13815,1,3815,[318 238  69  50   4],43,4,15692,4.112159329140461,20.0,20.0
13816,1,3816,[ 64  12 483 427  11],214,5,15697,4.112391930835735,60.0,0.0
13817,1,3817,[ 12 153 496 237   1],416,4,15701,4.1123624934520695,20.0,0.0
13818,1,3818,[ 64  12 483 427  11],214,5,15706,4.112594920136162,60.0,0.0
13819,1,3819,[ 88  11 588  95 111],805,0,15706,4.11151832460733,0.0,0.0
13820,1,3820,[ 64  12 483 427  11],214,5,15711,4.11175085056268,60.0,0.0
13821,1,3821,[125 197 603 475  15],854,3,15714,4.1114599686028255,0.0,0.0
13822,1,3822,[294 118  98 204  95],588,3,15717,4.111169238817682,0.0,20.0
13823,1,3823,[333 323 210 127 515],416,4,15721,4.111140167364017,0.0,0.0
13824,1,3824,[271 181   7   1 135],62,3,15724,4.1108496732026145,0.0,20.0
13825,1,3825,[282 403 100   4 132],618,3,15727,4.110559330893884,0.0,0.0
13826,1,3826,[273  88  50   7 151],416,3,15730,4.110269140318787,0.0,20.0
13827,1,3827,[ 64  12 483 427  11],214,5,15735,4.110501567398119,60.0,0.0
13828,1,3828,[ 64  12 483 427  11],214,5,15740,4.11073387307391,60.0,0.0
13829,1,3829,[ 64  12 483 427  11],214,5,15745,4.110966057441253,60.0,0.0
13830,1,3830,[195 603 215 333 322],416,4,15749,4.110937092143043,0.0,0.0
13831,1,3831,[238   7 197 185 269],854,5,15754,4.111169102296451,0.0,0.0
13832,1,3832,[ 64  12 483 427  11],214,5,15759,4.111400991390556,60.0,0.0
13833,1,3833,[183 176 174 237 197],618,4,15763,4.1113719353155975,0.0,0.0
13834,1,3834,[  8 196 168 216 357],297,5,15768,4.1116036505867015,0.0,0.0
13835,1,3835,[ 64  12 483 427  11],618,5,15773,4.111835245046924,60.0,0.0
13836,1,3836,[ 64  12 483 427  11],618,5,15778,4.112066718790722,60.0,0.0
13837,1,3837,[191   1  56 288 182],297,1,15779,4.111255862428348,0.0,20.0
13838,1,3838,[ 64  12 483 427  11],214,5,15784,4.111487366501693,60.0,0.0
13839,1,3839,[ 64  12 483 427  11],618,5,15789,4.11171875,60.0,0.0
13840,1,3840,[ 64  12 483 427  11],618,5,15794,4.111950013017443,60.0,0.0
13841,1,3841,[ 64  12 483 427  11],618,5,15799,4.1121811556481,60.0,0.0
13842,1,3842,[258 191 313 100 286],43,5,15804,4.112412177985949,20.0,20.0
13843,1,3843,[403  88 568 483 196],618,5,15809,4.11264308012487,20.0,0.0
13844,1,3844,[ 64  12 483 427  11],214,5,15814,4.112873862158648,60.0,0.0
13845,1,3845,[403   4  95 181 742],805,1,15815,4.112064482579303,0.0,20.0
13846,1,3846,[144 357 286 546 302],417,2,15817,4.111515466597349,0.0,0.0
13847,1,3847,[182 121 742   8 275],416,5,15822,4.111746361746362,0.0,0.0
13848,1,3848,[ 98 216  12 655  11],345,5,15827,4.11197713691868,20.0,20.0
13849,1,3849,[ 64  12 483 427  11],618,5,15832,4.112207792207792,60.0,0.0
13850,1,3850,[ 64  12 483 427  11],214,5,15837,4.112438327707089,60.0,0.0
13851,1,3851,[ 64  12 483 427  11],214,5,15842,4.112668743509865,60.0,0.0
13852,1,3852,[196 127 546 286 357],417,4,15846,4.112639501686997,0.0,0.0
13853,1,3853,[ 64  12 483 427  11],214,5,15851,4.112869745718734,60.0,0.0
13854,1,3854,[ 64  12 483 427  11],618,5,15856,4.1130998702983135,60.0,0.0
13855,1,3855,[ 64  12 483 427  11],214,5,15861,4.113329875518672,60.0,0.0
13856,1,3856,[483   4 117  25 271],854,2,15863,4.112781954887218,20.0,0.0
13857,1,3857,[276 100 173  25 268],354,2,15865,4.112234318299637,0.0,0.0
13858,1,3858,[173  50  25 151   1],416,4,15869,4.112205234516714,0.0,20.0
13859,1,3859,[  8 603 143 655 216],416,5,15874,4.112435233160622,0.0,0.0
13860,1,3860,[ 71 202 328 174 111],921,5,15879,4.112665112665113,0.0,0.0
13861,1,3861,[318 187 288 117 182],214,4,15883,4.1126359399274985,20.0,20.0
13862,1,3862,[ 64  12 483 427  11],618,5,15888,4.112865648459747,60.0,0.0
13863,1,3863,[194 405 301 313  25],751,3,15891,4.112577639751553,20.0,20.0
13864,1,3864,[185 175  28 200 183],805,4,15895,4.11254851228978,0.0,0.0
13865,1,3865,[ 82 568 313 196 168],711,3,15898,4.112260734609415,20.0,20.0
13866,1,3866,[204  79 191 258 118],43,5,15903,4.112490302560124,0.0,0.0
13867,1,3867,[265  50 405 161 222],417,0,15903,4.111427094105481,0.0,20.0
13868,1,3868,[313  82 323  97 235],416,3,15906,4.111139829413285,20.0,20.0
13869,1,3869,[185  22 655 161 168],416,5,15911,4.111369509043928,0.0,0.0
13870,1,3870,[222 276 322  15 323],921,3,15914,4.111082407646603,0.0,0.0
13871,1,3871,[ 64  12 483 427  11],214,5,15919,4.111311983471074,60.0,0.0
13872,1,3872,[ 64  12 483 427  11],214,5,15924,4.1115414407436095,60.0,0.0
13873,1,3873,[ 64  12 483 427  11],618,5,15929,4.111770779556014,60.0,0.0
13874,1,3874,[ 64  12 483 427  11],618,5,15934,4.112,60.0,0.0
13875,1,3875,[ 64  12 483 427  11],618,5,15939,4.112229102167182,60.0,0.0
13876,1,3876,[  9 275 300 100   1],43,5,15944,4.1124580861490845,0.0,0.0
13877,1,3877,[588  22  11  56 423],262,5,15949,4.112686952037133,0.0,0.0
13878,1,3878,[ 64  12 483 427  11],618,5,15954,4.11291569992266,60.0,0.0
13879,1,3879,[ 71 238 211 191 588],43,4,15958,4.112886597938144,0.0,0.0
13880,1,3880,[603 322 185 300 187],416,4,15962,4.112857510950786,0.0,0.0
13881,1,3881,[ 71 174 423 597 173],642,4,15966,4.112828438948996,0.0,0.0
13882,1,3882,[ 64 111 603  50 286],416,5,15971,4.113056914756632,20.0,20.0
13883,1,3883,[ 56 275   8 508  12],62,5,15976,4.1132852729145215,20.0,0.0
13884,1,3884,[111  22 245 333  64],416,4,15980,4.113256113256114,20.0,0.0
13885,1,3885,[ 64  12 483 427  11],618,5,15985,4.113484302624807,60.0,0.0
13886,1,3886,[ 64  12 483 427  11],214,5,15990,4.11371237458194,60.0,0.0
13887,1,3887,[ 64  12 483 427  11],618,5,15995,4.113940329218107,60.0,0.0
13888,1,3888,[ 64  12 483 427  11],214,5,16000,4.114168166623811,60.0,0.0
13889,1,3889,[318 275 234  56 143],416,5,16005,4.114395886889461,20.0,0.0
13890,1,3890,[588 100  28 288  71],345,1,16006,4.113595476741198,0.0,20.0
13891,1,3891,[ 64  12 483 427  11],214,5,16011,4.113823227132579,60.0,0.0
13892,1,3892,[ 64  12 483 427  11],214,5,16016,4.11405086051888,60.0,0.0
13893,1,3893,[118 271 238 405 175],805,2,16018,4.113507960965588,0.0,0.0
13894,1,3894,[ 64  12 483 427  11],214,5,16023,4.113735558408216,60.0,0.0
13895,1,3895,[174 100 191 237 168],416,4,16027,4.11370636550308,0.0,0.0
13896,1,3896,[405  15   1 588 144],654,4,16031,4.11367718758019,0.0,0.0
13897,1,3897,[ 50 200  82 161  28],805,2,16033,4.113134940995383,0.0,20.0
13898,1,3898,[245 234 568 228  50],417,2,16035,4.112592972557066,0.0,20.0
13899,1,3899,[423   1 237 118 222],297,2,16037,4.112051282051282,0.0,0.0
13900,1,3900,[ 64  12 483 427  11],214,5,16042,4.112278902845424,60.0,0.0
13901,1,3901,[200  56 655 483 423],417,5,16047,4.112506406970784,20.0,0.0
13902,1,3902,[197  82 118 427 185],416,4,16051,4.112477581347681,0.0,0.0
13903,1,3903,[282   7 183 210 175],297,4,16055,4.112448770491803,0.0,0.0
13904,1,3904,[172 127 238 181 216],618,3,16058,4.112163892445583,0.0,20.0
13905,1,3905,[ 64  12 483 427  11],214,5,16063,4.112391193036355,60.0,0.0
13906,1,3906,[ 95 265 508 181 161],417,1,16064,4.111594573841822,0.0,20.0
13907,1,3907,[  4 318 215 210  98],654,5,16069,4.111821903787104,20.0,20.0
13908,1,3908,[257  11 111 204  71],416,4,16073,4.111793297518547,0.0,0.0
13909,1,3909,[ 64  12 483 427  11],214,5,16078,4.112020460358056,60.0,0.0
13910,1,3910,[ 64  12 483 427  11],618,5,16083,4.11224750703145,60.0,0.0
13911,1,3911,[  4 508  64 197 742],345,5,16088,4.112474437627812,20.0,0.0
13912,1,3912,[ 64  12 483 427  11],214,5,16093,4.112701252236136,60.0,0.0
13913,1,3913,[245 175   1 100 168],297,3,16096,4.112416964741952,0.0,0.0
13914,1,3914,[100  96 191 423 195],805,3,16099,4.11213282247765,0.0,0.0
13915,1,3915,[ 71 318 471 215 313],588,5,16104,4.112359550561798,40.0,20.0
13916,1,3916,[ 64  12 483 427  11],214,5,16109,4.112586162879755,60.0,0.0
13917,1,3917,[ 64  12 483 427  11],214,5,16114,4.112812659520164,60.0,0.0
13918,1,3918,[ 69 195 546 273 118],417,2,16116,4.1122735391681555,0.0,0.0
13919,1,3919,[275 132  69 172  22],62,5,16121,4.1125,0.0,0.0
13920,1,3920,[100 403 475 568  15],416,4,16125,4.1124713083397095,0.0,0.0
13921,1,3921,[ 15 238 568 235 333],416,4,16129,4.1124426313105555,0.0,0.0
13922,1,3922,[ 64  12 483 427  11],618,5,16134,4.112668875860311,60.0,0.0
13923,1,3923,[748  95 268 273  98],417,4,16138,4.112640163098878,0.0,20.0
13924,1,3924,[215 328 313 125 276],416,4,16142,4.112611464968153,20.0,20.0
13925,1,3925,[204 322 300 318  96],416,4,16146,4.112582781456954,20.0,0.0
13926,1,3926,[168 357  70 125  98],230,5,16151,4.112808759867583,0.0,20.0
13927,1,3927,[ 64  12 483 427  11],618,5,16156,4.1130346232179225,60.0,0.0
13928,1,3928,[313  70 111 403 100],416,5,16161,4.113260371595826,20.0,20.0
13929,1,3929,[ 64  12 483 427  11],214,5,16166,4.113486005089059,60.0,0.0
13930,1,3930,[ 64  12 483 427  11],214,5,16171,4.113711523785296,60.0,0.0
13931,1,3931,[210 282  82   8 471],618,1,16172,4.112919633774161,0.0,0.0
13932,1,3932,[ 64  12 483 427  11],618,5,16177,4.113145181795067,60.0,0.0
13933,1,3933,[ 64  12 483 427  11],214,5,16182,4.113370615149974,60.0,0.0
13934,1,3934,[385  64 403 111 257],705,5,16187,4.113595933926303,20.0,0.0
13935,1,3935,[ 64  12 483 427  11],214,5,16192,4.1138211382113825,60.0,0.0
13936,1,3936,[ 64  12 483 427  11],618,5,16197,4.114046228092456,60.0,0.0
13937,1,3937,[471 238  50 282  71],345,2,16199,4.113509395632301,0.0,20.0
13938,1,3938,[ 64  12 483 427  11],214,5,16204,4.1137344503681135,60.0,0.0
13939,1,3939,[ 64  12 483 427  11],214,5,16209,4.113959390862944,60.0,0.0
13940,1,3940,[216 603 168 515 195],416,5,16214,4.114184217203755,0.0,0.0
13941,1,3941,[ 64  12 483 427  11],618,5,16219,4.114408929477422,60.0,0.0
13942,1,3942,[125 187 269 172 194],416,5,16224,4.114633527770733,0.0,0.0
13943,1,3943,[161  69 385 127 302],417,2,16226,4.1140973630831645,0.0,0.0
13944,1,3944,[168 204 186   9 196],618,3,16229,4.11381495564005,0.0,0.0
13945,1,3945,[222 546 275 471 475],270,5,16234,4.114039533705018,0.0,0.0
13946,1,3946,[ 64  12 483 427  11],214,5,16239,4.114263997973144,60.0,0.0
13947,1,3947,[ 64  12 483 427  11],618,5,16244,4.114488348530902,60.0,0.0
13948,1,3948,[ 64  12 483 427  11],618,5,16249,4.114712585464675,60.0,0.0
13949,1,3949,[269 151   8  25 183],416,4,16253,4.114683544303798,0.0,0.0
13950,1,3950,[ 64  12 483 427  11],618,5,16258,4.114907618324475,60.0,0.0
13951,1,3951,[ 64  12 483 427  11],214,5,16263,4.115131578947368,60.0,0.0
13952,1,3952,[  1 121 385  98 655],887,3,16266,4.114849481406527,0.0,20.0
13953,1,3953,[ 64  12 483 427  11],214,5,16271,4.115073343449671,60.0,0.0
13954,1,3954,[678 289 191  25 423],416,3,16274,4.114791403286978,0.0,0.0
13955,1,3955,[ 64  12 483 427  11],214,5,16279,4.115015166835187,60.0,0.0
13956,1,3956,[200  98  22 238  56],854,4,16283,4.114986100581248,0.0,20.0
13957,1,3957,[ 64  12 483 427  11],618,5,16288,4.115209701869631,60.0,0.0
13958,1,3958,[  7  69  97 215 678],588,1,16289,4.1144228340490026,0.0,0.0
13959,1,3959,[ 64  12 483 427  11],618,5,16294,4.114646464646465,60.0,0.0
13960,1,3960,[ 64  12 483 427  11],214,5,16299,4.114869982327695,60.0,0.0
13961,1,3961,[258   7  95 333 191],416,4,16303,4.114840989399293,0.0,0.0
13962,1,3962,[423 216 211 174 238],230,4,16307,4.1148120111027,0.0,0.0
13963,1,3963,[546 118   4 323 301],416,2,16309,4.114278506559032,0.0,0.0
13964,1,3964,[ 64  12 483 427  11],618,5,16314,4.114501891551072,60.0,0.0
13965,1,3965,[ 64  12 483 427  11],618,5,16319,4.114725163893091,60.0,0.0
13966,1,3966,[ 64  12 483 427  11],214,5,16324,4.11494832367028,60.0,0.0
13967,1,3967,[ 64  12 483 427  11],618,5,16329,4.115171370967742,60.0,0.0
13968,1,3968,[588 568 222  71 191],711,2,16331,4.114638447971782,0.0,0.0
13969,1,3969,[ 64  12 483 427  11],214,5,16336,4.1148614609571785,60.0,0.0
13970,1,3970,[ 64  12 483 427  11],214,5,16341,4.115084361621758,60.0,0.0
13971,1,3971,[ 64  12 483 427  11],618,5,16346,4.115307150050352,60.0,0.0
13972,1,3972,[597 111 235 289 197],854,1,16347,4.114523030455575,0.0,0.0
13973,1,3973,[ 64  12 483 427  11],618,5,16352,4.114745848012078,60.0,0.0
13974,1,3974,[ 64  12 483 427  11],214,5,16357,4.11496855345912,60.0,0.0
13975,1,3975,[100   1 257 423 174],297,2,16359,4.11443661971831,0.0,0.0
13976,1,3976,[405  56 132 185 143],230,4,16363,4.114407845109379,0.0,0.0
13977,1,3977,[276  11 151 127 423],43,5,16368,4.114630467571644,0.0,0.0
13978,1,3978,[ 64 121  89 288 423],854,4,16372,4.114601658708218,20.0,20.0
13979,1,3979,[403 183 301 546 172],416,4,16376,4.114572864321608,0.0,0.0
13980,1,3980,[151 568   8 269 222],654,5,16381,4.11479527756845,0.0,0.0
13981,1,3981,[ 56 288  98 180 111],887,4,16385,4.114766449020593,0.0,40.0
13982,1,3982,[655  28 186  70 228],128,2,16387,4.114235500878735,0.0,0.0
13983,1,3983,[318  50 235  28 265],416,4,16391,4.114206827309237,20.0,20.0
13984,1,3984,[289 210 117 153 568],43,5,16396,4.114429109159348,0.0,0.0
13985,1,3985,[286 222 546  97  69],43,5,16401,4.114651279478173,0.0,0.0
13986,1,3986,[258 323  82  15 496],417,3,16404,4.114371708051166,0.0,0.0
13987,1,3987,[546  50 195 245 357],62,4,16408,4.114343029087261,0.0,20.0
13988,1,3988,[385 117  97 182 276],416,4,16412,4.114314364502381,0.0,0.0
13989,1,3989,[235 168   1 257  12],62,3,16415,4.114035087719298,20.0,0.0
13990,1,3990,[ 64  12 483 427  11],214,5,16420,4.114257078426459,60.0,0.0
13991,1,3991,[435 546 301 288 174],297,2,16422,4.11372745490982,0.0,20.0
13992,1,3992,[ 64  12 483 427  11],214,5,16427,4.113949411470073,60.0,0.0
13993,1,3993,[ 64  12 483 427  11],214,5,16432,4.114171256885328,60.0,0.0
13994,1,3994,[153 471 300 302 288],297,2,16434,4.113642052565707,0.0,20.0
13995,1,3995,[ 64  12 483 427  11],618,5,16439,4.113863863863864,60.0,0.0
13996,1,3996,[ 12 276  88 301 385],416,3,16442,4.113585188891669,20.0,0.0
13997,1,3997,[357 132  64  89 125],642,2,16444,4.113056528264132,20.0,0.0
13998,1,3998,[ 64  12 483 427  11],214,5,16449,4.113278319579895,60.0,0.0
13999,1,3999,[ 15 328 168 235 294],62,2,16451,4.11275,0.0,0.0
14000,1,4000,[181 301  12 228 144],297,3,16454,4.112471882029492,20.0,20.0
14001,1,4001,[ 64  12 483 427  11],214,5,16459,4.112693653173413,60.0,0.0
14002,1,4002,[181 222 275 228 282],128,2,16461,4.112165875593305,0.0,20.0
14003,1,4003,[172 235 475 423 174],416,3,16464,4.111888111888112,0.0,0.0
14004,1,4004,[151 265 276  12 195],618,2,16466,4.111360799001249,20.0,0.0
14005,1,4005,[ 69 268 216 135 300],721,4,16470,4.111333000499251,0.0,0.0
14006,1,4006,[423 181  79  95 175],373,3,16473,4.111055652607936,0.0,20.0
14007,1,4007,[ 64  12 483 427  11],618,5,16478,4.11127744510978,60.0,0.0
14008,1,4008,[ 11 111 496 568   1],262,3,16481,4.111000249438763,0.0,0.0
14009,1,4009,[ 64  12 483 427  11],214,5,16486,4.111221945137157,60.0,0.0
14010,1,4010,[ 64  12 483 427  11],618,5,16491,4.111443530291698,60.0,0.0
14011,1,4011,[597  56 282 655 194],416,4,16495,4.111415752741775,0.0,0.0
14012,1,4012,[  4 168 282 268  95],654,3,16498,4.111138798903563,0.0,0.0
14013,1,4013,[135 176 237  22 597],854,1,16499,4.110363726955655,0.0,0.0
14014,1,4014,[ 15 196 258 313  71],345,4,16503,4.110336239103362,20.0,20.0
14015,1,4015,[ 64  12 483 427  11],214,5,16508,4.110557768924303,60.0,0.0
14016,1,4016,[174 475   8 151 182],62,5,16513,4.110779188449091,0.0,0.0
14017,1,4017,[185 127 121 597 294],854,2,16515,4.110253857640617,0.0,0.0
14018,1,4018,[ 95 496 403 151 197],711,5,16520,4.110475242597661,0.0,0.0
14019,1,4019,[ 64  12 483 427  11],618,5,16525,4.1106965174129355,60.0,0.0
14020,1,4020,[ 64  12 483 427  11],618,5,16530,4.110917682168615,60.0,0.0
14021,1,4021,[ 64  12 483 427  11],214,5,16535,4.111138736946793,60.0,0.0
14022,1,4022,[ 64  12 483 427  11],618,5,16540,4.11135968182948,60.0,0.0
14023,1,4023,[ 64  12 483 427  11],214,5,16545,4.111580516898608,60.0,0.0
14024,1,4024,[ 64  12 483 427  11],214,5,16550,4.111801242236025,60.0,0.0
14025,1,4025,[ 64  12 483 427  11],618,5,16555,4.112021857923497,60.0,0.0
14026,1,4026,[ 69 187  22 204 182],618,4,16559,4.111994040228458,0.0,0.0
14027,1,4027,[268 172 235  88 282],907,5,16564,4.112214498510427,0.0,0.0
14028,1,4028,[405 286  22  98 357],416,5,16569,4.112434847356664,0.0,20.0
14029,1,4029,[ 64  12 483 427  11],214,5,16574,4.112655086848635,60.0,0.0
14030,1,4030,[118 151  97  88 181],642,3,16577,4.112379062267427,0.0,20.0
14031,1,4031,[ 64  12 483 427  11],214,5,16582,4.1125992063492065,60.0,0.0
14032,1,4032,[202 173 288 568 323],805,2,16584,4.112075378130424,0.0,20.0
14033,1,4033,[ 64  12 483 427  11],618,5,16589,4.112295488349033,60.0,0.0
14034,1,4034,[ 64  12 483 427  11],618,5,16594,4.112515489467162,60.0,0.0
14035,1,4035,[ 64  12 483 427  11],618,5,16599,4.112735381565907,60.0,0.0
14036,1,4036,[100 196 135 176 172],601,3,16602,4.112459747337131,0.0,0.0
14037,1,4037,[ 64  12 483 427  11],618,5,16607,4.112679544328875,60.0,0.0
14038,1,4038,[678 111 174 289  56],721,2,16609,4.112156474374845,0.0,0.0
14039,1,4039,[ 64  12 483 427  11],214,5,16614,4.112376237623763,60.0,0.0
14040,1,4040,[125 194 197 121 748],416,5,16619,4.112595892105914,0.0,0.0
14041,1,4041,[197 238 597 161 187],416,4,16623,4.1125680356259275,0.0,0.0
14042,1,4042,[322 515 275 195 286],416,4,16627,4.112540192926045,0.0,0.0
14043,1,4043,[173 289  25 175 294],854,2,16629,4.112017804154303,0.0,0.0
14044,1,4044,[ 64  12 483 427  11],618,5,16634,4.1122373300370825,60.0,0.0
14045,1,4045,[195  11  25 161  82],805,1,16635,4.111468116658428,0.0,0.0
14046,1,4046,[ 64  12 483 427  11],214,5,16640,4.111687669878923,60.0,0.0
14047,1,4047,[265 153 423 172 748],417,3,16643,4.111413043478261,0.0,0.0
14048,1,4048,[ 64  12 483 427  11],214,5,16648,4.111632501852309,60.0,0.0
14049,1,4049,[ 28 258 182 294  15],128,4,16652,4.111604938271605,0.0,0.0
14050,1,4050,[ 64  12 483 427  11],618,5,16657,4.111824240928166,60.0,0.0
14051,1,4051,[ 64  12 483 427  11],214,5,16662,4.112043435340572,60.0,0.0
14052,1,4052,[258   7 301 132 194],416,5,16667,4.112262521588947,0.0,0.0
14053,1,4053,[ 98 288 273 286 174],62,3,16670,4.111988159842131,0.0,40.0
14054,1,4054,[385 197 195 180 435],405,2,16672,4.111467324290999,0.0,0.0
14055,1,4055,[ 64  12 483 427  11],214,5,16677,4.111686390532545,60.0,0.0
14056,1,4056,[ 64  12 483 427  11],618,5,16682,4.111905348779887,60.0,0.0
14057,1,4057,[ 64  12 483 427  11],214,5,16687,4.112124199112864,60.0,0.0
14058,1,4058,[ 64  12 483 427  11],618,5,16692,4.112342941611234,60.0,0.0
14059,1,4059,[ 64  12 483 427  11],214,5,16697,4.11256157635468,60.0,0.0
14060,1,4060,[ 64  12 483 427  11],618,5,16702,4.112780103422803,60.0,0.0
14061,1,4061,[475 603 258 191 235],805,3,16705,4.112506154603643,0.0,0.0
14062,1,4062,[ 64  12 483 427  11],214,5,16710,4.112724587743047,60.0,0.0
14063,1,4063,[175 181 168 195  25],698,1,16711,4.111958661417323,0.0,20.0
14064,1,4064,[ 64  12 483 427  11],214,5,16716,4.112177121771218,60.0,0.0
14065,1,4065,[125 235 742   1 483],907,5,16721,4.112395474667978,20.0,0.0
14066,1,4066,[603 197 216   7 183],805,4,16725,4.112367838701746,0.0,0.0
14067,1,4067,[313 174 117 211 275],43,5,16730,4.112586037364799,20.0,20.0
14068,1,4068,[215 294 483 357   4],62,3,16733,4.112312607520275,20.0,0.0
14069,1,4069,[ 64  12 483 427  11],214,5,16738,4.112530712530712,60.0,0.0
14070,1,4070,[  4 403  15 181 200],618,3,16741,4.11225743060673,0.0,20.0
14071,1,4071,[161   7 323 333 257],416,3,16744,4.111984282907662,0.0,0.0
14072,1,4072,[ 96  95 111  79  25],751,4,16748,4.111956788607905,0.0,0.0
14073,1,4073,[323 151 405 111 313],674,3,16751,4.1116838487972505,20.0,20.0
14074,1,4074,[183  98 179 172 405],198,4,16755,4.111656441717791,0.0,20.0
14075,1,4075,[ 64  12 483 427  11],214,5,16760,4.111874386653582,60.0,0.0
14076,1,4076,[269 273 182 234 294],416,5,16765,4.112092224675006,0.0,0.0
14077,1,4077,[273 135 180 100 151],854,5,16770,4.112309955860716,0.0,0.0
14078,1,4078,[ 56 132 235 286 496],416,4,16774,4.112282422162295,0.0,0.0
14079,1,4079,[ 64  12 483 427  11],618,5,16779,4.1125,60.0,0.0
14080,1,4080,[275 143  98  50 216],262,2,16781,4.111982357265376,0.0,40.0
14081,1,4081,[ 64  12 483 427  11],214,5,16786,4.112199902008819,60.0,0.0
14082,1,4082,[ 64  12 483 427  11],618,5,16791,4.112417340191036,60.0,0.0
14083,1,4083,[403  70 161 257  64],43,5,16796,4.112634671890303,20.0,0.0
14084,1,4084,[ 64  12 483 427  11],214,5,16801,4.1128518971848225,60.0,0.0
14085,1,4085,[211   4 742 144 151],416,4,16805,4.112824278022516,0.0,0.0
14086,1,4086,[ 64  12 483 427  11],214,5,16810,4.11304135062393,60.0,0.0
14087,1,4087,[ 64  12 483 427  11],618,5,16815,4.113258317025441,60.0,0.0
14088,1,4088,[ 82 748  79 187 234],198,1,16816,4.112496943017852,0.0,0.0
14089,1,4089,[ 25 168 216 127 238],43,4,16820,4.112469437652812,0.0,0.0
14090,1,4090,[222 144  22 288 496],588,2,16822,4.111953067709607,0.0,20.0
14091,1,4091,[ 64  12 483 427  11],618,5,16827,4.11217008797654,60.0,0.0
14092,1,4092,[ 64  12 483 427  11],618,5,16832,4.112387002198876,60.0,0.0
14093,1,4093,[  7 333 161  12  88],416,4,16836,4.112359550561798,20.0,0.0
14094,1,4094,[222 258 173 475 179],198,4,16840,4.112332112332112,0.0,0.0
14095,1,4095,[ 64  12 483 427  11],214,5,16845,4.112548828125,60.0,0.0
14096,1,4096,[ 64  12 483 427  11],618,5,16850,4.112765438125457,60.0,0.0
14097,1,4097,[ 96  11 328 194 294],854,1,16851,4.112005856515373,0.0,0.0
14098,1,4098,[168 153  95  25 195],416,4,16855,4.111978531349109,0.0,0.0
14099,1,4099,[196 183 302 216 127],62,4,16859,4.111951219512195,0.0,0.0
14100,1,4100,[289 161 168 328  82],416,4,16863,4.1119239209948795,0.0,0.0
14101,1,4101,[  8 655 496 210   7],588,2,16865,4.111409068746953,0.0,0.0
14102,1,4102,[385 215  96 173 655],405,3,16868,4.111138191567146,0.0,0.0
14103,1,4103,[143 210 204 300 568],698,2,16870,4.110623781676413,0.0,0.0
14104,1,4104,[322 300 202 269 125],416,4,16874,4.110596833130329,0.0,0.0
14105,1,4105,[200 180 475  71 153],24,5,16879,4.110813443740867,0.0,0.0
14106,1,4106,[  4 153 276  28 294],62,3,16882,4.11054297540784,0.0,0.0
14107,1,4107,[742 196 215 588 302],416,5,16887,4.110759493670886,0.0,0.0
14108,1,4108,[ 69 313 269  98  25],654,4,16891,4.1107325383304945,20.0,40.0
14109,1,4109,[ 64  12 483 427  11],618,5,16896,4.110948905109489,60.0,0.0
14110,1,4110,[ 64  12 483 427  11],618,5,16901,4.111165166626125,60.0,0.0
14111,1,4111,[ 64  12 483 427  11],214,5,16906,4.1113813229571985,60.0,0.0
14112,1,4112,[ 70 186 197 151 196],618,2,16908,4.110867979576951,0.0,0.0
14113,1,4113,[742 174  71 191 258],630,1,16909,4.110111813320369,0.0,0.0
14114,1,4114,[ 64  12 483 427  11],214,5,16914,4.110328068043742,60.0,0.0
14115,1,4115,[ 64  12 483 427  11],618,5,16919,4.110544217687075,60.0,0.0
14116,1,4116,[197 211 176 238  28],437,3,16922,4.110274471702696,0.0,0.0
14117,1,4117,[235 742 100 197 234],297,1,16923,4.109519184069937,0.0,0.0
14118,1,4118,[ 88 318 483 185  25],711,5,16928,4.109735372663268,40.0,0.0
14119,1,4119,[ 64  12 483 427  11],214,5,16933,4.10995145631068,60.0,0.0
14120,1,4120,[ 64  12 483 427  11],214,5,16938,4.110167435088571,60.0,0.0
14121,1,4121,[ 28 144 195 357  96],416,5,16943,4.110383309073265,0.0,0.0
14122,1,4122,[ 64  12 483 427  11],618,5,16948,4.110599078341014,60.0,0.0
14123,1,4123,[ 64  12 483 427  11],618,5,16953,4.110814742967992,60.0,0.0
14124,1,4124,[ 64  12 483 427  11],214,5,16958,4.111030303030303,60.0,0.0
14125,1,4125,[ 64  12 483 427  11],214,5,16963,4.111245758603975,60.0,0.0
14126,1,4126,[183 195 748 475  64],198,3,16966,4.110976496244245,20.0,0.0
14127,1,4127,[235 238 546  70 118],416,2,16968,4.1104651162790695,0.0,0.0
14128,1,4128,[ 64  12 483 427  11],618,5,16973,4.110680552191814,60.0,0.0
14129,1,4129,[187 181 475 204 238],198,4,16977,4.110653753026634,0.0,20.0
14130,1,4130,[ 64  12 483 427  11],214,5,16982,4.110869038973614,60.0,0.0
14131,1,4131,[ 64  12 483 427  11],214,5,16987,4.11108422071636,60.0,0.0
14132,1,4132,[111  56 588 118 568],416,4,16991,4.1110573433341395,0.0,0.0
14133,1,4133,[ 64  12 483 427  11],214,5,16996,4.111272375423319,60.0,0.0
14134,1,4134,[ 64  12 483 427  11],618,5,17001,4.11148730350665,60.0,0.0
14135,1,4135,[ 64  12 483 427  11],618,5,17006,4.111702127659575,60.0,0.0
14136,1,4136,[  1 187  96 655 301],416,5,17011,4.111916847957457,0.0,0.0
14137,1,4137,[ 64  12 483 427  11],618,5,17016,4.112131464475592,60.0,0.0
14138,1,4138,[161 228 423 186  69],230,4,17020,4.112104373036965,0.0,0.0
14139,1,4139,[181 403 202  97 276],43,5,17025,4.11231884057971,0.0,20.0
14140,1,4140,[ 64  12 483 427  11],618,5,17030,4.112533204539966,60.0,0.0
14141,1,4141,[ 64  12 483 427  11],214,5,17035,4.112747464992757,60.0,0.0
14142,1,4142,[210 183 121 322  88],805,1,17036,4.111996138064205,0.0,0.0
14143,1,4143,[ 64  12 483 427  11],214,5,17041,4.112210424710424,60.0,0.0
14144,1,4144,[234 202  69 237  71],230,5,17046,4.112424607961399,0.0,0.0
14145,1,4145,[  7 603 191 174 288],416,5,17051,4.112638687891944,0.0,20.0
14146,1,4146,[ 64  12 483 427  11],618,5,17056,4.112852664576803,60.0,0.0
14147,1,4147,[ 64  12 483 427  11],214,5,17061,4.113066538090646,60.0,0.0
14148,1,4148,[328 427 357 132  11],416,5,17066,4.113280308508074,0.0,0.0
14149,1,4149,[ 64  12 483 427  11],618,5,17071,4.113493975903615,60.0,0.0
14150,1,4150,[172  82 333 313 496],588,4,17075,4.113466634545892,20.0,20.0
14151,1,4151,[546  97 475 185  98],417,3,17078,4.113198458574181,0.0,20.0
14152,1,4152,[603 282 435 288 588],297,2,17080,4.112689621960029,0.0,20.0
14153,1,4153,[ 64  12 483 427  11],618,5,17085,4.112903225806452,60.0,0.0
14154,1,4154,[655  79  96 202 135],805,3,17088,4.112635379061372,0.0,0.0
14155,1,4155,[423 168 483 258 151],588,4,17092,4.112608277189605,20.0,0.0
14156,1,4156,[301  71 194  70 258],416,5,17097,4.112821746451768,0.0,0.0
14157,1,4157,[ 64  12 483 427  11],618,5,17102,4.113035113035113,60.0,0.0
14158,1,4158,[385  95  89 180 423],805,1,17103,4.112286607357538,0.0,0.0
14159,1,4159,[ 64  12 483 427  11],214,5,17108,4.1125,60.0,0.0
14160,1,4160,[ 12 202 483   8 144],618,3,17111,4.112232636385484,40.0,0.0
14161,1,4161,[ 11  95 385 323 423],805,1,17112,4.111484863046612,0.0,0.0
14162,1,4162,[196 200 183 211 588],417,4,17116,4.111458083113139,0.0,0.0
14163,1,4163,[ 64  12 483 427  11],618,5,17121,4.111671469740634,60.0,0.0
14164,1,4164,[172 258 153 175 333],721,3,17124,4.11140456182473,0.0,0.0
14165,1,4165,[ 64  12 483 427  11],618,5,17129,4.111617858857417,60.0,0.0
14166,1,4166,[121 196 222 144 204],711,1,17130,4.110871130309575,0.0,0.0
14167,1,4167,[111 132 238 328  89],854,3,17133,4.110604606525912,0.0,0.0
14168,1,4168,[179  28 323 475 568],416,2,17135,4.110098344926841,0.0,0.0
14169,1,4169,[ 64  12 483 427  11],214,5,17140,4.110311750599521,60.0,0.0
14170,1,4170,[ 64  12 483 427  11],618,5,17145,4.110525053943898,60.0,0.0
14171,1,4171,[ 28 153 318 742 588],654,5,17150,4.110738255033557,20.0,0.0
14172,1,4172,[ 64  12 483 427  11],618,5,17155,4.110951353942008,60.0,0.0
14173,1,4173,[ 64  12 483 427  11],618,5,17160,4.111164350742693,60.0,0.0
14174,1,4174,[ 79  95 282 196 318],416,4,17164,4.111137724550898,20.0,0.0
14175,1,4175,[ 64  12 483 427  11],214,5,17169,4.1113505747126435,60.0,0.0
14176,1,4176,[ 56 168 276 475 187],198,4,17173,4.111323916686617,0.0,0.0
14177,1,4177,[186 144  98 483 655],711,3,17176,4.111057922450933,20.0,20.0
14178,1,4178,[ 64  12 483 427  11],618,5,17181,4.11127063890883,60.0,0.0
14179,1,4179,[ 56 180 265 603  12],405,2,17183,4.110765550239234,20.0,0.0
14180,1,4180,[ 79 127   7 176 238],854,4,17187,4.110739057641712,0.0,0.0
14181,1,4181,[ 64  12 483 427  11],618,5,17192,4.110951697752272,60.0,0.0
14182,1,4182,[ 64  12 483 427  11],618,5,17197,4.111164236194119,60.0,0.0
14183,1,4183,[ 64  12 483 427  11],214,5,17202,4.111376673040153,60.0,0.0
14184,1,4184,[588  12 117  88  69],437,1,17203,4.11063321385902,20.0,0.0
14185,1,4185,[ 64  12 483 427  11],618,5,17208,4.110845676063067,60.0,0.0
14186,1,4186,[238  71  69 179 204],601,1,17209,4.110102698829711,0.0,0.0
14187,1,4187,[ 64  12 483 427  11],214,5,17214,4.110315186246418,60.0,0.0
14188,1,4188,[ 28 655 238  12 286],342,4,17218,4.1102888517545955,20.0,0.0
14189,1,4189,[427  98 313 328 237],416,4,17222,4.110262529832935,20.0,40.0
14190,1,4190,[ 70 597 238 100 202],43,3,17225,4.109997613934622,0.0,0.0
14191,1,4191,[ 64  12 483 427  11],214,5,17230,4.110209923664122,60.0,0.0
14192,1,4192,[216 204 180  97 196],198,1,17231,4.109468161221082,0.0,0.0
14193,1,4193,[ 64  12 483 427  11],214,5,17236,4.1096804959465905,60.0,0.0
14194,1,4194,[ 64  12 483 427  11],618,5,17241,4.109892729439809,60.0,0.0
14195,1,4195,[328 276  97 197 237],128,3,17244,4.109628217349857,0.0,0.0
14196,1,4196,[ 64  12 483 427  11],618,5,17249,4.1098403621634505,60.0,0.0
14197,1,4197,[161 111  69 301 275],437,1,17250,4.109099571224393,0.0,0.0
14198,1,4198,[ 12   8 179 323  96],805,4,17254,4.10907358894975,20.0,0.0
14199,1,4199,[ 64  12 483 427  11],214,5,17259,4.109285714285714,60.0,0.0
14200,1,4200,[173 118  25 186 174],128,3,17262,4.109021661509164,0.0,0.0
14201,1,4201,[ 64  12 483 427  11],214,5,17267,4.109233698238934,60.0,0.0
14202,1,4202,[ 64  12 483 427  11],214,5,17272,4.109445634070902,60.0,0.0
14203,1,4203,[210 127 273 276 568],62,4,17276,4.10941960038059,0.0,0.0
14204,1,4204,[ 64  12 483 427  11],214,5,17281,4.109631391200951,60.0,0.0
14205,1,4205,[127 235  98 197 125],416,4,17285,4.109605325725155,0.0,20.0
14206,1,4206,[ 64  12 483 427  11],214,5,17290,4.10981697171381,60.0,0.0
14207,1,4207,[ 64  12 483 427  11],214,5,17295,4.110028517110266,60.0,0.0
14208,1,4208,[ 64  12 483 427  11],214,5,17300,4.11023996198622,60.0,0.0
14209,1,4209,[ 64  12 483 427  11],214,5,17305,4.110451306413301,60.0,0.0
14210,1,4210,[ 64  12 483 427  11],618,5,17310,4.110662550463073,60.0,0.0
14211,1,4211,[276 153 182 237 195],62,4,17314,4.110636277302944,0.0,0.0
14212,1,4212,[ 64  12 483 427  11],618,5,17319,4.110847377165915,60.0,0.0
14213,1,4213,[286 118 200  98 655],437,3,17322,4.110583768391077,0.0,20.0
14214,1,4214,[ 96 216  71 132 269],373,4,17326,4.1105575326215895,0.0,0.0
14215,1,4215,[237   9 174 323 318],764,4,17330,4.1105313092979125,20.0,0.0
14216,1,4216,[546 168 204  50 423],416,4,17334,4.110505098411193,0.0,20.0
14217,1,4217,[ 64  12 483 427  11],618,5,17339,4.110715979137032,60.0,0.0
14218,1,4218,[ 64  12 483 427  11],618,5,17344,4.11092675989571,60.0,0.0
14219,1,4219,[ 69  97 111 121 191],62,3,17347,4.110663507109004,0.0,0.0
14220,1,4220,[748 258   7 235 403],417,3,17350,4.110400379057095,0.0,0.0
14221,1,4221,[ 64  12 483 427  11],214,5,17355,4.110611084793937,60.0,0.0
14222,1,4222,[269  96 275 186 135],854,3,17358,4.1103480937722,0.0,0.0
14223,1,4223,[ 64  12 483 427  11],618,5,17363,4.110558712121212,60.0,0.0
14224,1,4224,[ 64  12 483 427  11],618,5,17368,4.110769230769231,60.0,0.0
14225,1,4225,[ 64  12 483 427  11],214,5,17373,4.110979649787033,60.0,0.0
14226,1,4226,[173 179 302 288 323],416,3,17376,4.110716820440028,0.0,20.0
14227,1,4227,[313 202   4  79 186],43,4,17380,4.110690633869442,20.0,20.0
14228,1,4228,[ 64  12 483 427  11],618,5,17385,4.110900922203831,60.0,0.0
14229,1,4229,[125  82 168 588 222],588,3,17388,4.110638297872341,0.0,0.0
14230,1,4230,[111  98 257 588  71],43,5,17393,4.110848499172772,0.0,20.0
14231,1,4231,[ 64  12 483 427  11],618,5,17398,4.111058601134215,60.0,0.0
14232,1,4232,[ 64  12 483 427  11],618,5,17403,4.111268603827073,60.0,0.0
14233,1,4233,[ 64  12 483 427  11],618,5,17408,4.1114785073216815,60.0,0.0
14234,1,4234,[ 79 423 237  64  11],198,2,17410,4.110979929161747,20.0,0.0
14235,1,4235,[ 64  12 483 427  11],214,5,17415,4.111189801699717,60.0,0.0
14236,1,4236,[655  89 185 603 143],805,3,17418,4.110927543072929,0.0,0.0
14237,1,4237,[151  97  25  95 546],654,3,17421,4.11066540821142,0.0,0.0
14238,1,4238,[ 64  12 483 427  11],214,5,17426,4.110875206416607,60.0,0.0
14239,1,4239,[ 64  12 483 427  11],618,5,17431,4.111084905660378,60.0,0.0
14240,1,4240,[ 64  12 483 427  11],214,5,17436,4.111294506012733,60.0,0.0
14241,1,4241,[200 191  97 194 427],416,5,17441,4.111504007543611,0.0,0.0
14242,1,4242,[ 64  12 483 427  11],214,5,17446,4.111713410322885,60.0,0.0
14243,1,4243,[118  98  95 333 678],416,2,17448,4.111215834118756,0.0,20.0
14244,1,4244,[  7 144  50 186 318],588,3,17451,4.1109540636042405,20.0,20.0
14245,1,4245,[ 96 174 323 302 200],416,4,17455,4.110927932171456,0.0,0.0
14246,1,4246,[186 100 258 423 185],854,4,17459,4.110901813044502,0.0,0.0
14247,1,4247,[ 22 385   9 175 187],698,1,17460,4.110169491525424,0.0,0.0
14248,1,4248,[ 64  12 483 427  11],618,5,17465,4.110378912685338,60.0,0.0
14249,1,4249,[288 282 118 111 174],297,1,17466,4.109647058823529,0.0,20.0
14250,1,4250,[ 64  12 483 427  11],618,5,17471,4.109856504351917,60.0,0.0
14251,1,4251,[ 64  12 483 427  11],618,5,17476,4.110065851364064,60.0,0.0
14252,1,4252,[ 64  12 483 427  11],214,5,17481,4.110275099929462,60.0,0.0
14253,1,4253,[423  89  11 588 183],805,2,17483,4.109779031499765,0.0,0.0
14254,1,4254,[655 235   1 176  22],62,3,17486,4.10951821386604,0.0,0.0
14255,1,4255,[ 64  12 483 427  11],618,5,17491,4.109727443609023,60.0,0.0
14256,1,4256,[117 135 185 286 423],854,3,17494,4.109466760629552,0.0,0.0
14257,1,4257,[ 64  12 483 427  11],214,5,17499,4.109675904180366,60.0,0.0
14258,1,4258,[ 64  12 483 427  11],618,5,17504,4.1098849495186665,60.0,0.0
14259,1,4259,[  9 655 183 275 185],618,3,17507,4.10962441314554,0.0,0.0
14260,1,4260,[ 64  12 483 427  11],618,5,17512,4.109833372447782,60.0,0.0
14261,1,4261,[ 64  12 483 427  11],618,5,17517,4.110042233693102,60.0,0.0
14262,1,4262,[117  12  11 202 125],314,5,17522,4.110250996950504,20.0,0.0
14263,1,4263,[ 64  12 483 427  11],618,5,17527,4.110459662288931,60.0,0.0
14264,1,4264,[603 403 161 216 196],805,2,17529,4.109964830011723,0.0,0.0
14265,1,4265,[ 64  12 483 427  11],214,5,17534,4.110173464603844,60.0,0.0
14266,1,4266,[ 64  12 483 427  11],214,5,17539,4.1103820014061405,60.0,0.0
14267,1,4267,[ 64  12 483 427  11],214,5,17544,4.110590440487348,60.0,0.0
14268,1,4268,[ 64  12 483 427  11],618,5,17549,4.11079878191614,60.0,0.0
14269,1,4269,[475 211 181 322 496],416,3,17552,4.110538641686182,0.0,20.0
14270,1,4270,[ 64  12 483 427  11],618,5,17557,4.110746897682041,60.0,0.0
14271,1,4271,[143 216  64 423 197],405,4,17561,4.1107209737827715,20.0,0.0
14272,1,4272,[ 64  12 483 427  11],618,5,17566,4.1109290896325765,60.0,0.0
14273,1,4273,[ 64  12 483 427  11],618,5,17571,4.111137108095461,60.0,0.0
14274,1,4274,[117 328 289 269  98],43,5,17576,4.111345029239766,0.0,20.0
14275,1,4275,[181 173  95   1 275],618,2,17578,4.1108512628624885,0.0,20.0
14276,1,4276,[403 322 597 245  88],416,1,17579,4.110123918634557,0.0,0.0
14277,1,4277,[496 655 282  28  25],416,5,17584,4.11033193080879,0.0,0.0
14278,1,4278,[ 64  12 483 427  11],618,5,17589,4.110539845758355,60.0,0.0
14279,1,4279,[ 64  12 483 427  11],618,5,17594,4.110747663551402,60.0,0.0
14280,1,4280,[ 64  12 483 427  11],618,5,17599,4.110955384256015,60.0,0.0
14281,1,4281,[180 328 172 143 197],128,3,17602,4.110695936478281,0.0,0.0
14282,1,4282,[204 117 196 228 161],128,4,17606,4.11067009105767,0.0,0.0
14283,1,4283,[ 64  12 483 427  11],618,5,17611,4.110877684407096,60.0,0.0
14284,1,4284,[ 12 301 678 161 597],588,4,17615,4.110851808634773,20.0,0.0
14285,1,4285,[175 191  15 403 475],198,3,17618,4.11059262715819,0.0,0.0
14286,1,4286,[403 204  88  22 357],405,4,17622,4.110566829951015,0.0,0.0
14287,1,4287,[568 245 282 269 313],416,4,17626,4.110541044776119,20.0,20.0
14288,1,4288,[ 64  12 483 427  11],214,5,17631,4.110748426206575,60.0,0.0
14289,1,4289,[  1 273 300 173 172],416,5,17636,4.110955710955711,0.0,0.0
14290,1,4290,[323 328 333  12 182],416,4,17640,4.1109298531810765,20.0,0.0
14291,1,4291,[403 328 204 211 357],416,5,17645,4.111136999068034,0.0,0.0
14292,1,4292,[302 174 471 323  28],721,3,17648,4.110878173771256,0.0,0.0
14293,1,4293,[161 288 182 318  50],405,3,17651,4.110619469026549,20.0,40.0
14294,1,4294,[ 98  25 117 132 300],128,3,17654,4.110360884749709,0.0,20.0
14295,1,4295,[  9 333 185   8 111],416,5,17659,4.110567970204841,0.0,0.0
14296,1,4296,[144  56 275  50   8],588,3,17662,4.11030951826856,0.0,20.0
14297,1,4297,[ 64  12 483 427  11],618,5,17667,4.110516519311307,60.0,0.0
14298,1,4298,[ 64  12 483 427  11],618,5,17672,4.110723424052106,60.0,0.0
14299,1,4299,[ 64  12 483 427  11],214,5,17677,4.11093023255814,60.0,0.0
14300,1,4300,[ 64  12 483 427  11],214,5,17682,4.111136944896535,60.0,0.0
14301,1,4301,[200  96 282  79 385],416,5,17687,4.1113435611343565,0.0,0.0
14302,1,4302,[ 64  12 483 427  11],214,5,17692,4.111550081338601,60.0,0.0
14303,1,4303,[ 64  12 483 427  11],618,5,17697,4.111756505576208,60.0,0.0
14304,1,4304,[ 64  12 483 427  11],618,5,17702,4.1119628339140535,60.0,0.0
14305,1,4305,[ 28 257 204 143  95],887,5,17707,4.11216906641895,0.0,0.0
14306,1,4306,[143 423 161 181  25],416,5,17712,4.11237520315765,0.0,20.0
14307,1,4307,[216 294   4 588  97],416,5,17717,4.112581244196843,0.0,0.0
14308,1,4308,[405 322 300 496  28],128,4,17721,4.112555117196566,0.0,0.0
14309,1,4309,[ 64  12 483 427  11],618,5,17726,4.1127610208816705,60.0,0.0
14310,1,4310,[ 28   8 568 144 475],62,2,17728,4.112270934817908,0.0,0.0
14311,1,4311,[ 71 168 215 318 182],618,5,17733,4.11247680890538,20.0,0.0
14312,1,4312,[174 168 187 427 185],618,5,17738,4.112682587526084,0.0,0.0
14313,1,4313,[173   8 323 153 216],805,3,17741,4.112424663885026,0.0,0.0
14314,1,4314,[268 568 191 151 588],417,3,17744,4.112166859791425,0.0,0.0
14315,1,4315,[ 64  12 483 427  11],214,5,17749,4.112372567191844,60.0,0.0
14316,1,4316,[ 64  12 483 427  11],214,5,17754,4.112578179291175,60.0,0.0
14317,1,4317,[ 64  12 483 427  11],618,5,17759,4.112783696155628,60.0,0.0
14318,1,4318,[ 64  12 483 427  11],214,5,17764,4.112989117851354,60.0,0.0
14319,1,4319,[ 64  12 483 427  11],214,5,17769,4.113194444444445,60.0,0.0
14320,1,4320,[ 64  12 483 427  11],214,5,17774,4.113399676000926,60.0,0.0
14321,1,4321,[ 64  12 483 427  11],214,5,17779,4.1136048125867655,60.0,0.0
14322,1,4322,[222  28 100 273  15],764,4,17783,4.113578533425862,0.0,0.0
14323,1,4323,[ 64  12 483 427  11],618,5,17788,4.113783533765033,60.0,0.0
14324,1,4324,[  4 385   1 237 117],618,4,17792,4.113757225433526,0.0,0.0
14325,1,4325,[ 64  12 483 427  11],618,5,17797,4.113962089690245,60.0,0.0
14326,1,4326,[508  69 151 678 748],345,3,17800,4.113704645250751,0.0,0.0
14327,1,4327,[588 313 143  70   4],642,3,17803,4.113447319778189,20.0,20.0
14328,1,4328,[597 179 195 245  22],62,3,17806,4.113190113190114,0.0,0.0
14329,1,4329,[269 588 210 194 245],416,4,17810,4.113163972286374,0.0,0.0
14330,1,4330,[ 88 216 118  64 288],618,2,17812,4.112676056338028,20.0,20.0
14331,1,4331,[234 471 588 475 187],416,4,17816,4.112650046168052,0.0,0.0
14332,1,4332,[ 64  12 483 427  11],618,5,17821,4.112854834987306,60.0,0.0
14333,1,4333,[185 153  71 323 597],805,3,17824,4.112598061836641,0.0,0.0
14334,1,4334,[ 64  12 483 427  11],618,5,17829,4.11280276816609,60.0,0.0
14335,1,4335,[268 168 235 546  98],297,3,17832,4.112546125461255,0.0,20.0
14336,1,4336,[ 64  12 483 427  11],214,5,17837,4.112750749365921,60.0,0.0
14337,1,4337,[ 79 191 238 168 258],417,4,17841,4.112724757952973,0.0,0.0
14338,1,4338,[174 215 289 655 196],416,4,17845,4.112698778520397,0.0,0.0
14339,1,4339,[ 98 258 328  11 195],416,5,17850,4.112903225806452,0.0,20.0
14340,1,4340,[ 64  12 483 427  11],214,5,17855,4.113107578898871,60.0,0.0
14341,1,4341,[ 64  12 483 427  11],618,5,17860,4.113311837862736,60.0,0.0
14342,1,4342,[  4 568 202 144 588],373,2,17862,4.1128252360119735,0.0,0.0
14343,1,4343,[ 64  12 483 427  11],214,5,17867,4.113029465930018,60.0,0.0
14344,1,4344,[ 22 132 125 117 271],505,4,17871,4.113003452243959,0.0,0.0
14345,1,4345,[ 64  12 483 427  11],618,5,17876,4.113207547169812,60.0,0.0
14346,1,4346,[ 64  12 483 427  11],214,5,17881,4.113411548194157,60.0,0.0
14347,1,4347,[121 276 257 597 117],43,4,17885,4.113385464581417,0.0,0.0
14348,1,4348,[ 64  12 483 427  11],618,5,17890,4.113589330880663,60.0,0.0
14349,1,4349,[742 228 175 234 275],297,2,17892,4.113103448275862,0.0,0.0
14350,1,4350,[235 238   9 121 191],43,3,17895,4.112847621236497,0.0,0.0
14351,1,4351,[ 64  12 483 427  11],618,5,17900,4.1130514705882355,60.0,0.0
14352,1,4352,[ 64  12 483 427  11],214,5,17905,4.113255226280726,60.0,0.0
14353,1,4353,[427 568 318 423 181],705,3,17908,4.1129995406522735,20.0,20.0
14354,1,4354,[318 357 655  56   7],24,5,17913,4.113203214695752,20.0,0.0
14355,1,4355,[173 174 100 588 181],618,4,17917,4.11317722681359,0.0,20.0
14356,1,4356,[288 282 125 111 475],342,2,17919,4.11269221941703,0.0,20.0
14357,1,4357,[ 64  12 483 427  11],214,5,17924,4.112895823772373,60.0,0.0
14358,1,4358,[ 64  12 483 427  11],618,5,17929,4.113099334709796,60.0,0.0
14359,1,4359,[ 64  12 483 427  11],618,5,17934,4.113302752293578,60.0,0.0
14360,1,4360,[302 210 176 174   7],416,5,17939,4.113506076587939,0.0,0.0
14361,1,4361,[ 97 174 195 238  88],712,3,17942,4.113250802384227,0.0,0.0
14362,1,4362,[222  98  56   7 135],62,5,17947,4.113454045381618,0.0,20.0
14363,1,4363,[175 168  25 183  79],297,4,17951,4.113428047662695,0.0,0.0
14364,1,4364,[ 64  12 483 427  11],214,5,17956,4.113631156930126,60.0,0.0
14365,1,4365,[ 64  12 483 427  11],618,5,17961,4.113834173156207,60.0,0.0
14366,1,4366,[ 64  12 483 427  11],214,5,17966,4.1140370964048545,60.0,0.0
14367,1,4367,[ 64  12 483 427  11],214,5,17971,4.114239926739927,60.0,0.0
14368,1,4368,[ 95 289 210  88 313],416,2,17973,4.113756008239871,20.0,20.0
14369,1,4369,[ 64  12 483 427  11],214,5,17978,4.11395881006865,60.0,0.0
14370,1,4370,[ 64  12 483 427  11],214,5,17983,4.11416151910318,60.0,0.0
14371,1,4371,[ 64 132 300   9 655],416,5,17988,4.114364135407136,20.0,0.0
14372,1,4372,[333  56 173  69 204],345,4,17992,4.114337983077979,0.0,0.0
14373,1,4373,[ 64  12 483 427  11],214,5,17997,4.114540466392318,60.0,0.0
14374,1,4374,[ 64  12 483 427  11],214,5,18002,4.114742857142857,60.0,0.0
14375,1,4375,[ 64  12 483 427  11],618,5,18007,4.114945155393053,60.0,0.0
14376,1,4376,[ 64  12 483 427  11],214,5,18012,4.115147361206306,60.0,0.0
14377,1,4377,[  7  79 180 237  64],198,2,18014,4.11466423024212,20.0,0.0
14378,1,4378,[ 64  12 483 427  11],618,5,18019,4.114866407855675,60.0,0.0
14379,1,4379,[ 64  12 483 427  11],214,5,18024,4.115068493150685,60.0,0.0
14380,1,4380,[ 64  12 483 427  11],618,5,18029,4.115270486190368,60.0,0.0
14381,1,4381,[322 234 179 187 111],416,3,18032,4.115015974440895,0.0,0.0
14382,1,4382,[ 64  12 483 427  11],618,5,18037,4.115217887291809,60.0,0.0
14383,1,4383,[238 143 483  25 268],128,3,18040,4.114963503649635,20.0,0.0
14384,1,4384,[ 64  12 483 427  11],214,5,18045,4.115165336374003,60.0,0.0
14385,1,4385,[282 273 289 318 200],416,4,18049,4.115139078887369,20.0,0.0
14386,1,4386,[ 64  12 483 427  11],214,5,18054,4.11534077957602,60.0,0.0
14387,1,4387,[144 197 655 132 286],437,3,18057,4.115086599817684,0.0,0.0
14388,1,4388,[ 64  12 483 427  11],618,5,18062,4.1152882205513786,60.0,0.0
14389,1,4389,[173 508   8 182  79],214,5,18067,4.115489749430524,0.0,0.0
14390,1,4390,[475  22  11  69   1],854,3,18070,4.115235709405602,0.0,0.0
14391,1,4391,[ 64  12 483 427  11],618,5,18075,4.115437158469946,60.0,0.0
14392,1,4392,[ 22 127  98 265  12],405,4,18079,4.115410880946961,20.0,20.0
14393,1,4393,[ 64  12 483 427  11],618,5,18084,4.115612198452435,60.0,0.0
14394,1,4394,[222 143 742 597 546],43,4,18088,4.115585893060296,0.0,0.0
14395,1,4395,[ 64  12 483 427  11],214,5,18093,4.1157870791628755,60.0,0.0
14396,1,4396,[ 50 301 546 328 302],49,1,18094,4.115078462588128,0.0,20.0
14397,1,4397,[ 64  12 483 427  11],214,5,18099,4.115279672578445,60.0,0.0
14398,1,4398,[ 64  12 483 427  11],214,5,18104,4.115480791088884,60.0,0.0
14399,1,4399,[ 64  12 483 427  11],618,5,18109,4.115681818181818,60.0,0.0
14400,1,4400,[748 125 100  15 143],345,3,18112,4.11542831174733,0.0,0.0
14401,1,4401,[423 204 269 234 546],805,2,18114,4.114947751022263,0.0,0.0
14402,1,4402,[ 64  12 483 427  11],214,5,18119,4.1151487622075855,60.0,0.0
14403,1,4403,[ 64  12 483 427  11],618,5,18124,4.115349682107175,60.0,0.0
14404,1,4404,[ 64  12 483 427  11],214,5,18129,4.115550510783201,60.0,0.0
14405,1,4405,[282 234 182 196  98],297,2,18131,4.115070358601907,0.0,20.0
14406,1,4406,[ 64  12 483 427  11],618,5,18136,4.115271159518947,60.0,0.0
14407,1,4407,[183 302 210 258 151],417,3,18139,4.115018148820327,0.0,0.0
14408,1,4408,[ 82 385 111 195 196],416,5,18144,4.115218870492175,0.0,0.0
14409,1,4409,[ 64  12 483 427  11],618,5,18149,4.115419501133787,60.0,0.0
14410,1,4410,[ 64  12 483 427  11],214,5,18154,4.115620040807073,60.0,0.0
14411,1,4411,[294  50 603 180 273],805,2,18156,4.115140525838622,0.0,20.0
14412,1,4412,[211 294 403  79 151],416,4,18160,4.115114434624972,0.0,0.0
14413,1,4413,[191  56  88 588   4],43,5,18165,4.115314907113729,0.0,0.0
14414,1,4414,[ 64  12 483 427  11],214,5,18170,4.115515288788222,60.0,0.0
14415,1,4415,[ 64  12 483 427  11],214,5,18175,4.115715579710145,60.0,0.0
14416,1,4416,[268 258   1 210 257],416,4,18179,4.115689381933439,0.0,0.0
14417,1,4417,[ 25 202 179  98 300],128,2,18181,4.1152105024898145,0.0,20.0
14418,1,4418,[ 64  12 483 427  11],214,5,18186,4.115410726408689,60.0,0.0
14419,1,4419,[ 64  12 483 427  11],214,5,18191,4.115610859728506,60.0,0.0
14420,1,4420,[294 196 238 403 568],345,3,18194,4.115358516172812,0.0,0.0
14421,1,4421,[ 82 405  69   1  95],262,1,18195,4.114654002713705,0.0,0.0
14422,1,4422,[276 423 275  97 200],416,4,18199,4.114628080488356,0.0,0.0
14423,1,4423,[ 64  12 483 427  11],214,5,18204,4.1148282097649185,60.0,0.0
14424,1,4424,[135   7 117 121 496],417,1,18205,4.114124293785311,0.0,0.0
14425,1,4425,[ 64 427  50  70 121],262,3,18208,4.113872571170357,20.0,20.0
14426,1,4426,[ 11 300 121  98  25],49,1,18209,4.113169189067088,0.0,20.0
14427,1,4427,[ 64  12 483 427  11],618,5,18214,4.113369467028003,60.0,0.0
14428,1,4428,[385 238  69 179 318],416,4,18218,4.1133438699480696,20.0,0.0
14429,1,4429,[ 64  12 483 427  11],214,5,18223,4.113544018058691,60.0,0.0
14430,1,4430,[ 89   7 273 216 508],297,5,18228,4.113744075829384,0.0,0.0
14431,1,4431,[ 12 168 328 403 174],416,5,18233,4.1139440433212995,20.0,0.0
14432,1,4432,[ 64  12 483 427  11],618,5,18238,4.1141439205955335,60.0,0.0
14433,1,4433,[ 64  12 483 427  11],618,5,18243,4.114343707713126,60.0,0.0
14434,1,4434,[100 202 168 176   7],230,4,18247,4.114317925591883,0.0,0.0
14435,1,4435,[ 64  12 483 427  11],214,5,18252,4.114517583408476,60.0,0.0
14436,1,4436,[ 64  12 483 427  11],618,5,18257,4.114717151228308,60.0,0.0
14437,1,4437,[ 64  12 483 427  11],618,5,18262,4.114916629112213,60.0,0.0
14438,1,4438,[ 64  12 483 427  11],618,5,18267,4.1151160171209735,60.0,0.0
14439,1,4439,[125 546   7  64 294],417,3,18270,4.114864864864865,20.0,0.0
14440,1,4440,[318 357  50  82  11],198,4,18274,4.1148390002251745,20.0,20.0
14441,1,4441,[  7 176 117 100  71],24,5,18279,4.115038271049077,0.0,0.0
14442,1,4442,[216 151 655 678 235],345,3,18282,4.114787305874409,0.0,0.0
14443,1,4443,[ 64  12 483 427  11],618,5,18287,4.1149864986498645,60.0,0.0
14444,1,4444,[269 328 301 597 258],416,4,18291,4.11496062992126,0.0,0.0
14445,1,4445,[ 64  12 483 427  11],618,5,18296,4.115159694107063,60.0,0.0
14446,1,4446,[ 64  12 483 427  11],214,5,18301,4.1153586687654595,60.0,0.0
14447,1,4447,[  1 286 125 186 100],417,4,18305,4.1153327338129495,0.0,0.0
14448,1,4448,[195  28 211 234 168],437,2,18307,4.114857271296921,0.0,0.0
14449,1,4449,[ 64  12 483 427  11],618,5,18312,4.115056179775281,60.0,0.0
14450,1,4450,[180 191 153 269 176],854,4,18316,4.115030330262862,0.0,0.0
14451,1,4451,[237 111 100 176 211],297,4,18320,4.115004492362983,0.0,0.0
14452,1,4452,[ 64  12 483 427  11],618,5,18325,4.1152032337749835,60.0,0.0
14453,1,4453,[179  12 597 191 748],416,3,18328,4.114952851369555,20.0,0.0
14454,1,4454,[ 64  12 483 427  11],214,5,18333,4.115151515151515,60.0,0.0
14455,1,4455,[ 64  12 483 427  11],618,5,18338,4.115350089766607,60.0,0.0
14456,1,4456,[172 403 182  15 568],198,3,18341,4.1150998429436845,0.0,0.0
14457,1,4457,[ 64  12 483 427  11],618,5,18346,4.115298340062808,60.0,0.0
14458,1,4458,[117  70 202 265   7],417,3,18349,4.115048217089034,0.0,0.0
14459,1,4459,[ 64  12 483 427  11],214,5,18354,4.1152466367713005,60.0,0.0
14460,1,4460,[ 64  12 483 427  11],618,5,18359,4.115444967496077,60.0,0.0
14461,1,4461,[ 79  95 118 216 333],588,4,18363,4.115419094576423,0.0,0.0
14462,1,4462,[ 64  12 483 427  11],618,5,18368,4.115617297781761,60.0,0.0
14463,1,4463,[215 135 275 357 435],297,3,18371,4.115367383512544,0.0,0.0
14464,1,4464,[ 64  12 483 427  11],618,5,18376,4.115565509518477,60.0,0.0
14465,1,4465,[ 64  12 483 427  11],618,5,18381,4.115763546798029,60.0,0.0
14466,1,4466,[ 64  12 483 427  11],618,5,18386,4.11596149541079,60.0,0.0
14467,1,4467,[ 82  12 257 168 195],654,5,18391,4.116159355416293,20.0,0.0
14468,1,4468,[ 28 151 597  71 182],62,3,18394,4.1159095994629675,0.0,0.0
14469,1,4469,[ 64  12 483 427  11],618,5,18399,4.116107382550336,60.0,0.0
14470,1,4470,[ 64  12 483 427  11],618,5,18404,4.116305077163945,60.0,0.0
14471,1,4471,[216 181 197 483 143],751,4,18408,4.116279069767442,20.0,20.0
14472,1,4472,[742  11 200 196 245],417,4,18412,4.116253073999553,0.0,0.0
14473,1,4473,[ 64  12 483 427  11],214,5,18417,4.116450603486813,60.0,0.0
14474,1,4474,[173 153  96 294 196],416,5,18422,4.116648044692737,0.0,0.0
14475,1,4475,[ 64  12 483 427  11],618,5,18427,4.116845397676497,60.0,0.0
14476,1,4476,[496  97 427 179 748],373,3,18430,4.116595934777753,0.0,0.0
14477,1,4477,[  9 655  96 237 568],62,2,18432,4.11612326931666,0.0,0.0
14478,1,4478,[ 64  12 483 427  11],618,5,18437,4.116320607278411,60.0,0.0
14479,1,4479,[588  11 508 191   4],297,3,18440,4.116071428571429,0.0,0.0
14480,1,4480,[ 28 742 245 234   4],297,1,18441,4.115376032135684,0.0,0.0
14481,1,4481,[238 483  69 302 294],854,3,18444,4.115127175368139,20.0,0.0
14482,1,4482,[222  50 118 117 257],62,3,18447,4.11487842962302,0.0,20.0
14483,1,4483,[143 191 282 318  96],12,5,18452,4.115075825156111,20.0,0.0
14484,1,4484,[ 64  12 483 427  11],214,5,18457,4.115273132664437,60.0,0.0
14485,1,4485,[597   1 172 127  50],416,4,18461,4.115247436469015,0.0,20.0
14486,1,4486,[ 64  12 483 427  11],618,5,18466,4.1154446177847115,60.0,0.0
14487,1,4487,[ 64  12 483 427  11],618,5,18471,4.115641711229946,60.0,0.0
14488,1,4488,[ 64  12 483 427  11],214,5,18476,4.115838716863444,60.0,0.0
14489,1,4489,[ 70  98 197  95 222],198,2,18478,4.115367483296214,0.0,20.0
14490,1,4490,[508 175 385 168 313],49,2,18480,4.114896459585839,20.0,20.0
14491,1,4491,[ 64  12 483 427  11],214,5,18485,4.115093499554764,60.0,0.0
14492,1,4492,[ 64  12 483 427  11],214,5,18490,4.115290451813933,60.0,0.0
14493,1,4493,[211 655 181 748 144],417,3,18493,4.11504227859368,0.0,20.0
14494,1,4494,[ 64  12 483 427  11],618,5,18498,4.115239154616241,60.0,0.0
14495,1,4495,[ 64  12 483 427  11],214,5,18503,4.115435943060498,60.0,0.0
14496,1,4496,[ 64  12 483 427  11],214,5,18508,4.1156326439848785,60.0,0.0
14497,1,4497,[ 64  12 483 427  11],214,5,18513,4.115829257447754,60.0,0.0
14498,1,4498,[ 64  12 483 427  11],214,5,18518,4.116025783507446,60.0,0.0
14499,1,4499,[ 64  12 483 427  11],214,5,18523,4.1162222222222224,60.0,0.0
14500,1,4500,[268 132 405 151 294],854,3,18526,4.115974227949344,0.0,0.0
14501,1,4501,[273 121  71  97 275],618,4,18530,4.115948467347845,0.0,0.0
14502,1,4502,[  4 742  69 318 195],854,2,18532,4.1154785698423275,20.0,0.0
14503,1,4503,[ 64  12 483 427  11],618,5,18537,4.1156749555950265,60.0,0.0
14504,1,4504,[ 11 200 678 173 322],416,3,18540,4.11542730299667,0.0,0.0
14505,1,4505,[ 64  12 483 427  11],618,5,18545,4.115623612960497,60.0,0.0
14506,1,4506,[216 427 100 191  79],618,4,18549,4.115597958730863,0.0,0.0
14507,1,4507,[  4  56  28 288 546],297,2,18551,4.115128660159716,0.0,20.0
14508,1,4508,[132 318 238   1 172],262,2,18553,4.11465956974939,20.0,0.0
14509,1,4509,[ 64  12 483 427  11],618,5,18558,4.114855875831486,60.0,0.0
14510,1,4510,[ 64  12 483 427  11],214,5,18563,4.115052094879184,60.0,0.0
14511,1,4511,[117  98 204 161  56],416,5,18568,4.115248226950355,0.0,20.0
14512,1,4512,[603 275 202  64  28],373,3,18571,4.115001107910481,20.0,0.0
14513,1,4513,[210   4 180 228 269],373,4,18575,4.114975631369074,0.0,0.0
14514,1,4514,[ 64  12 483 427  11],214,5,18580,4.1151716500553706,60.0,0.0
14515,1,4515,[ 97  70 216  64 211],416,5,18585,4.115367581930912,20.0,0.0
14516,1,4516,[ 64  12 483 427  11],214,5,18590,4.115563427053354,60.0,0.0
14517,1,4517,[117  56 143  88 678],345,4,18594,4.115537848605578,0.0,0.0
14518,1,4518,[174 435   7  79 496],505,2,18596,4.115069705687099,0.0,0.0
14519,1,4519,[655 153 197 302 301],721,3,18599,4.114823008849558,0.0,0.0
14520,1,4520,[143 210 385 288 427],262,1,18600,4.11413404114134,0.0,20.0
14521,1,4521,[294  56  22   1 276],62,3,18603,4.113887660327289,0.0,0.0
14522,1,4522,[ 64  12 483 427  11],214,5,18608,4.114083572849879,60.0,0.0
14523,1,4523,[ 64  12 483 427  11],214,5,18613,4.114279398762157,60.0,0.0
14524,1,4524,[ 64  12 483 427  11],214,5,18618,4.114475138121547,60.0,0.0
14525,1,4525,[ 64  12 483 427  11],214,5,18623,4.114670790985418,60.0,0.0
14526,1,4526,[ 64  12 483 427  11],214,5,18628,4.114866357411089,60.0,0.0
14527,1,4527,[ 64  12 483 427  11],618,5,18633,4.115061837455831,60.0,0.0
14528,1,4528,[ 64  12 483 427  11],618,5,18638,4.1152572311768605,60.0,0.0
14529,1,4529,[588 172 100 125 328],373,3,18641,4.1150110375275935,0.0,0.0
14530,1,4530,[ 64  12 483 427  11],214,5,18646,4.115206356212757,60.0,0.0
14531,1,4531,[ 64  12 483 427  11],618,5,18651,4.11540158870256,60.0,0.0
14532,1,4532,[ 64  12 483 427  11],214,5,18656,4.115596735054048,60.0,0.0
14533,1,4533,[ 12  15 111 323  56],43,4,18660,4.115571239523599,20.0,0.0
14534,1,4534,[ 56 403  96 181   9],618,3,18663,4.115325248070563,0.0,20.0
14535,1,4535,[568 234 185 172   1],262,0,18663,4.11441798941799,0.0,0.0
14536,1,4536,[ 64  12 483 427  11],618,5,18668,4.114613180515759,60.0,0.0
14537,1,4537,[ 64  12 483 427  11],618,5,18673,4.1148082855883645,60.0,0.0
14538,1,4538,[144 258 546 215 269],654,5,18678,4.115003304692664,0.0,0.0
14539,1,4539,[294 202 282 238 301],297,2,18680,4.11453744493392,0.0,0.0
14540,1,4540,[ 64  12 483 427  11],618,5,18685,4.1147324377890335,60.0,0.0
14541,1,4541,[204 187 173 153 196],373,4,18689,4.114707177454866,0.0,0.0
14542,1,4542,[ 64  12 483 427  11],618,5,18694,4.114902047105437,60.0,0.0
14543,1,4543,[237 125 118 323 238],416,2,18696,4.11443661971831,0.0,0.0
14544,1,4544,[ 64  12 483 427  11],214,5,18701,4.114631463146314,60.0,0.0
14545,1,4545,[357  82 181 153  50],642,3,18704,4.114386273647162,0.0,40.0
14546,1,4546,[ 64  12 483 427  11],214,5,18709,4.114581042445568,60.0,0.0
14547,1,4547,[ 79 183 135 100 427],198,3,18712,4.114335971855761,0.0,0.0
14548,1,4548,[748 161 323 176 423],805,2,18714,4.113871180479226,0.0,0.0
14549,1,4549,[ 64  12 483 427  11],214,5,18719,4.114065934065934,60.0,0.0
14550,1,4550,[ 64  12 483 427  11],618,5,18724,4.11426060206548,60.0,0.0
14551,1,4551,[ 98 235 302 182   7],49,3,18727,4.114015817223199,0.0,20.0
14552,1,4552,[ 64  12 483 427  11],618,5,18732,4.114210410718208,60.0,0.0
14553,1,4553,[195 111 423 191 748],437,3,18735,4.113965744400527,0.0,0.0
14554,1,4554,[ 64  12 483 427  11],618,5,18740,4.114160263446762,60.0,0.0
14555,1,4555,[168 286   1 117  69],297,3,18743,4.113915715539948,0.0,0.0
14556,1,4556,[ 64  12 483 427  11],214,5,18748,4.11411016019311,60.0,0.0
14557,1,4557,[  7 435 197 603   8],354,5,18753,4.114304519526108,0.0,0.0
14558,1,4558,[ 64  12 483 427  11],214,5,18758,4.114498793595087,60.0,0.0
14559,1,4559,[ 64  12 483 427  11],618,5,18763,4.11469298245614,60.0,0.0
14560,1,4560,[265   8  71 222 748],654,4,18767,4.114667836000877,0.0,0.0
14561,1,4561,[ 64  12 483 427  11],214,5,18772,4.114861902674265,60.0,0.0
14562,1,4562,[ 28 172   9 483 202],698,1,18773,4.114179268025421,20.0,0.0
14563,1,4563,[ 64  12 483 427  11],618,5,18778,4.114373356704645,60.0,0.0
14564,1,4564,[ 64  12 483 427  11],618,5,18783,4.114567360350493,60.0,0.0
14565,1,4565,[ 64  12 483 427  11],618,5,18788,4.114761279018835,60.0,0.0
14566,1,4566,[748 143 174 111  70],437,3,18791,4.114517188526385,0.0,0.0
14567,1,4567,[ 11  79 423 568  71],805,1,18792,4.113835376532399,0.0,0.0
14568,1,4568,[ 64  12 483 427  11],618,5,18797,4.114029328080543,60.0,0.0
14569,1,4569,[475 655 302 235 204],416,3,18800,4.113785557986871,0.0,0.0
14570,1,4570,[237 275 245 508  69],62,3,18803,4.113541894552614,0.0,0.0
14571,1,4571,[238 215 216 204   8],416,5,18808,4.1137357830271215,0.0,0.0
14572,1,4572,[ 64  12 483 427  11],618,5,18813,4.11392958670457,60.0,0.0
14573,1,4573,[ 82 245 144 182 427],416,4,18817,4.113904678618277,0.0,0.0
14574,1,4574,[216 301 234 475 423],416,4,18821,4.113879781420765,0.0,0.0
14575,1,4575,[118   8 235  98 568],887,2,18823,4.1134178321678325,0.0,20.0
14576,1,4576,[ 64  12 483 427  11],618,5,18828,4.1136115359405725,60.0,0.0
14577,1,4577,[ 64  12 483 427  11],214,5,18833,4.113805155089559,60.0,0.0
14578,1,4578,[ 64  12 483 427  11],618,5,18838,4.113998689670233,60.0,0.0
14579,1,4579,[748  89 182 294 323],417,4,18842,4.113973799126637,0.0,0.0
14580,1,4580,[ 64  12 483 427  11],214,5,18847,4.11416721239904,60.0,0.0
14581,1,4581,[301  25 496  28 318],43,5,18852,4.114360541248363,20.0,0.0
14582,1,4582,[168 471 234 153 245],416,4,18856,4.114335588042767,0.0,0.0
14583,1,4583,[121 238  64 117  96],417,3,18859,4.114092495636998,20.0,0.0
14584,1,4584,[ 64  12 483 427  11],618,5,18864,4.114285714285714,60.0,0.0
14585,1,4585,[168 173  25 153 471],43,4,18868,4.1142607937200175,0.0,0.0
14586,1,4586,[168 181 187 127 515],698,2,18870,4.113799869195553,0.0,20.0
14587,1,4587,[ 64  12 483 427  11],214,5,18875,4.113993025283348,60.0,0.0
14588,1,4588,[435 151  28 475 258],297,3,18878,4.113750272390499,0.0,0.0
14589,1,4589,[125 186 202 168 117],642,4,18882,4.113725490196078,0.0,0.0
14590,1,4590,[328 195 286 222  69],62,3,18885,4.113482901328687,0.0,0.0
14591,1,4591,[ 64  12 483 427  11],618,5,18890,4.1136759581881535,60.0,0.0
14592,1,4592,[ 64  12 483 427  11],214,5,18895,4.113868930981929,60.0,0.0
14593,1,4593,[211  95 196 100 153],43,5,18900,4.114061819764911,0.0,0.0
14594,1,4594,[ 64  12 483 427  11],618,5,18905,4.114254624591948,60.0,0.0
14595,1,4595,[ 64  12 483 427  11],618,5,18910,4.114447345517841,60.0,0.0
14596,1,4596,[405 258  25 271 288],805,1,18911,4.11376984990211,0.0,20.0
14597,1,4597,[ 64  12 483 427  11],214,5,18916,4.113962592431492,60.0,0.0
14598,1,4598,[257 168 195 515  28],297,3,18919,4.113720373994346,0.0,0.0
14599,1,4599,[ 56  25 323 153 143],805,4,18923,4.113695652173913,0.0,0.0
14600,1,4600,[135  70 127 200  98],405,3,18926,4.113453597044121,0.0,20.0
14601,1,4601,[121  56 111  89 483],854,3,18929,4.113211647109952,20.0,0.0
14602,1,4602,[313  22 238  12 496],618,4,18933,4.113187051922659,40.0,20.0
14603,1,4603,[ 12  15  97  96 202],373,3,18936,4.112945264986968,20.0,0.0
14604,1,4604,[ 64  12 483 427  11],618,5,18941,4.11313789359392,60.0,0.0
14605,1,4605,[ 64  12 483 427  11],214,5,18946,4.113330438558402,60.0,0.0
14606,1,4606,[655 200  64  11 127],416,5,18951,4.113522899934882,20.0,0.0
14607,1,4607,[  1  98 427 182  79],253,4,18955,4.113498263888889,0.0,20.0
14608,1,4608,[100 238  69 237 286],416,4,18959,4.113473638533304,0.0,0.0
14609,1,4609,[ 64  12 483 427  11],214,5,18964,4.113665943600868,60.0,0.0
14610,1,4610,[ 64  12 483 427  11],618,5,18969,4.113858165256994,60.0,0.0
14611,1,4611,[ 64  12 483 427  11],214,5,18974,4.114050303555941,60.0,0.0
14612,1,4612,[ 64  12 483 427  11],618,5,18979,4.114242358551919,60.0,0.0
14613,1,4613,[603  25 318 405 508],854,4,18983,4.1142175986129175,20.0,0.0
14614,1,4614,[269   4  79 427  22],416,5,18988,4.114409534127844,0.0,0.0
14615,1,4615,[ 82 215 483 237 423],618,5,18993,4.1146013864818025,20.0,0.0
14616,1,4616,[ 64  12 483 427  11],214,5,18998,4.114793155728829,60.0,0.0
14617,1,4617,[ 64  12 483 427  11],214,5,19003,4.114984841922911,60.0,0.0
14618,1,4618,[ 64  12 483 427  11],214,5,19008,4.115176445117991,60.0,0.0
14619,1,4619,[385  69 258 257  64],43,5,19013,4.115367965367965,20.0,0.0
14620,1,4620,[191 196   4 405 179],198,2,19015,4.114910192599004,0.0,0.0
14621,1,4621,[ 64  12 483 427  11],618,5,19020,4.1151016875811335,60.0,0.0
14622,1,4622,[405  88 151 181 748],805,1,19021,4.114427860696518,0.0,20.0
14623,1,4623,[ 96  71 211   4 328],373,5,19026,4.114619377162629,0.0,0.0
14624,1,4624,[ 64  12 483 427  11],214,5,19031,4.114810810810811,60.0,0.0
14625,1,4625,[ 64  12 483 427  11],618,5,19036,4.115002161694768,60.0,0.0
14626,1,4626,[ 64  12 483 427  11],214,5,19041,4.115193429868165,60.0,0.0
14627,1,4627,[ 64  12 483 427  11],618,5,19046,4.115384615384615,60.0,0.0
14628,1,4628,[ 82  12  15 475 228],417,4,19050,4.115359688917692,20.0,0.0
14629,1,4629,[496 568 405 200 245],417,2,19052,4.114902807775378,0.0,0.0
14630,1,4630,[ 56 172 265  22 435],405,3,19055,4.1146620600302315,0.0,0.0
14631,1,4631,[ 64  12 483 427  11],618,5,19060,4.114853195164076,60.0,0.0
14632,1,4632,[588 153 597 546 357],417,2,19062,4.114396719188431,0.0,0.0
14633,1,4633,[143 151 228  88 210],373,4,19066,4.114372032801036,0.0,0.0
14634,1,4634,[210  28  98 286   1],62,2,19068,4.113915857605178,0.0,20.0
14635,1,4635,[ 56  79 179 187 328],416,4,19072,4.113891285591027,0.0,0.0
14636,1,4636,[ 64  12 483 427  11],214,5,19077,4.114082380849688,60.0,0.0
14637,1,4637,[ 64  12 483 427  11],214,5,19082,4.114273393704183,60.0,0.0
14638,1,4638,[ 98 151 294  15 174],654,3,19085,4.1140331968096575,0.0,20.0
14639,1,4639,[ 70  11 471 191  71],630,2,19087,4.113577586206897,0.0,0.0
14640,1,4640,[ 64  12 483 427  11],618,5,19092,4.113768584356819,60.0,0.0
14641,1,4641,[471 135 181 215 655],373,3,19095,4.113528651443343,0.0,20.0
14642,1,4642,[ 64  12 483 427  11],214,5,19100,4.113719577859142,60.0,0.0
14643,1,4643,[273  11 322 258  98],630,3,19103,4.113479758828596,0.0,20.0
14644,1,4644,[276  64 181 121  69],128,5,19108,4.113670613562971,20.0,20.0
14645,1,4645,[ 64  12 483 427  11],214,5,19113,4.1138613861386135,60.0,0.0
14646,1,4646,[ 64  12 483 427  11],618,5,19118,4.114052076608565,60.0,0.0
14647,1,4647,[313   8  25 405  97],907,4,19122,4.114027538726334,20.0,20.0
14648,1,4648,[ 64  12 483 427  11],214,5,19127,4.1142181114218115,60.0,0.0
14649,1,4649,[ 64  12 483 427  11],214,5,19132,4.1144086021505375,60.0,0.0
14650,1,4650,[ 64  12 483 427  11],214,5,19137,4.114599010965383,60.0,0.0
14651,1,4651,[357  28 222 603  22],297,5,19142,4.1147893379191745,0.0,0.0
14652,1,4652,[100 588   4  79 179],805,3,19145,4.114549752847625,0.0,0.0
14653,1,4653,[ 64  12 483 427  11],214,5,19150,4.114740008594757,60.0,0.0
14654,1,4654,[ 64  12 483 427  11],618,5,19155,4.114930182599355,60.0,0.0
14655,1,4655,[ 64  12 483 427  11],618,5,19160,4.115120274914089,60.0,0.0
14656,1,4656,[258 603 294  98 111],805,2,19162,4.114666094051965,0.0,20.0
14657,1,4657,[ 64  12 483 427  11],214,5,19167,4.114856161442679,60.0,0.0
14658,1,4658,[269 196 235 603 174],805,2,19169,4.114402232238678,0.0,0.0
14659,1,4659,[ 64  12 483 427  11],618,5,19174,4.114592274678111,60.0,0.0
14660,1,4660,[ 64  12 483 427  11],214,5,19179,4.114782235571766,60.0,0.0
14661,1,4661,[ 15 202 257  56 742],43,5,19184,4.114972114972115,0.0,0.0
14662,1,4662,[294 742 300   8 175],43,4,19188,4.114947458717563,0.0,0.0
14663,1,4663,[ 64  12 483 427  11],214,5,19193,4.115137221269297,60.0,0.0
14664,1,4664,[ 64  12 483 427  11],618,5,19198,4.115326902465166,60.0,0.0
14665,1,4665,[ 12 153 118 210  70],416,4,19202,4.115302186026575,20.0,0.0
14666,1,4666,[328 187 182  71 183],505,2,19204,4.114848939361474,0.0,0.0
14667,1,4667,[151  71 655 111 172],887,4,19208,4.114824335904028,0.0,0.0
14668,1,4668,[ 64  12 483 427  11],214,5,19213,4.115013921610624,60.0,0.0
14669,1,4669,[ 64  12 483 427  11],214,5,19218,4.115203426124197,60.0,0.0
14670,1,4670,[471 195 197  15  64],854,2,19220,4.114750588739028,20.0,0.0
14671,1,4671,[ 64  12 483 427  11],214,5,19225,4.1149400684931505,60.0,0.0
14672,1,4672,[127  12 475 302 483],214,5,19230,4.115129467151722,40.0,0.0
14673,1,4673,[ 64  12 483 427  11],618,5,19235,4.115318784766795,60.0,0.0
14674,1,4674,[ 64  12 483 427  11],214,5,19240,4.115508021390374,60.0,0.0
14675,1,4675,[ 15 185 161 427 175],198,1,19241,4.114841745081266,0.0,0.0
14676,1,4676,[ 22 423  50  11 211],297,4,19245,4.114817190506735,0.0,20.0
14677,1,4677,[ 25 185 273 144 211],297,4,19249,4.114792646430098,0.0,0.0
14678,1,4678,[ 95  28 257   1  97],416,3,19252,4.114554391964095,0.0,0.0
14679,1,4679,[121 603  56 475  50],805,4,19256,4.114529914529914,0.0,20.0
14680,1,4680,[210 197  82 132  56],618,3,19259,4.11429181798761,0.0,0.0
14681,1,4681,[ 64  12 483 427  11],214,5,19264,4.114480991029475,60.0,0.0
14682,1,4682,[475 289 172 173 117],49,2,19266,4.114029468289558,0.0,0.0
14683,1,4683,[215 265 294 288 423],297,0,19266,4.1131511528608025,0.0,20.0
14684,1,4684,[ 64  12 483 427  11],214,5,19271,4.113340448239061,60.0,0.0
14685,1,4685,[286  79 117 183 185],417,3,19274,4.1131028595817325,0.0,0.0
14686,1,4686,[117 161 655 515 100],417,3,19277,4.11286537230638,0.0,0.0
14687,1,4687,[117 237 174   8 216],654,5,19282,4.113054607508532,0.0,0.0
14688,1,4688,[182 179 508 269 496],214,4,19286,4.1130304969076565,0.0,0.0
14689,1,4689,[322 143 328  28  25],223,3,19289,4.112793176972281,0.0,0.0
14690,1,4690,[427 268 333 153 496],416,5,19294,4.112982306544446,0.0,0.0
14691,1,4691,[ 64  12 483 427  11],618,5,19299,4.1131713554987215,60.0,0.0
14692,1,4692,[515 678 182 423 161],416,4,19303,4.113147240571063,0.0,0.0
14693,1,4693,[302 276 127 111 191],416,4,19307,4.113123135918193,0.0,0.0
14694,1,4694,[228  15 175 655 238],198,2,19309,4.1126730564430245,0.0,0.0
14695,1,4695,[ 64  12 483 427  11],618,5,19314,4.112862010221465,60.0,0.0
14696,1,4696,[ 64  12 483 427  11],618,5,19319,4.113050883542686,60.0,0.0
14697,1,4697,[475 196  12 597 275],416,3,19322,4.112813963388676,20.0,0.0
14698,1,4698,[ 64  12 483 427  11],618,5,19327,4.1130027665460736,60.0,0.0
14699,1,4699,[ 64  12 483 427  11],214,5,19332,4.113191489361702,60.0,0.0
14700,1,4700,[ 64  12 483 427  11],214,5,19337,4.113380131886832,60.0,0.0
14701,1,4701,[ 64  12 483 427  11],214,5,19342,4.1135686941726926,60.0,0.0
14702,1,4702,[ 95 238  96 182 235],49,1,19343,4.1129066553263876,0.0,0.0
14703,1,4703,[ 64  12 483 427  11],618,5,19348,4.113095238095238,60.0,0.0
14704,1,4704,[ 64  12 483 427  11],618,5,19353,4.113283740701381,60.0,0.0
14705,1,4705,[ 64  12 483 427  11],618,5,19358,4.11347216319592,60.0,0.0
14706,1,4706,[181 215 237 475  96],62,3,19361,4.113235606543446,0.0,20.0
14707,1,4707,[ 64  12 483 427  11],618,5,19366,4.113423959218352,60.0,0.0
14708,1,4708,[ 64  12 483 427  11],618,5,19371,4.113612231896369,60.0,0.0
14709,1,4709,[ 64  12 483 427  11],214,5,19376,4.11380042462845,60.0,0.0
14710,1,4710,[302 173 172  88  70],405,3,19379,4.113563999150923,0.0,0.0
14711,1,4711,[515 496 143 322 302],416,4,19383,4.113539898132428,0.0,0.0
14712,1,4712,[ 64  12 483 427  11],618,5,19388,4.113727986420539,60.0,0.0
14713,1,4713,[ 64  12 483 427  11],618,5,19393,4.1139159949087825,60.0,0.0
14714,1,4714,[ 64  12 483 427  11],214,5,19398,4.114103923647932,60.0,0.0
14715,1,4715,[ 64  12 483 427  11],214,5,19403,4.114291772688719,60.0,0.0
14716,1,4716,[ 64  12 483 427  11],214,5,19408,4.114479542081832,60.0,0.0
14717,1,4717,[302 475 245 333 125],416,3,19411,4.114243323442136,0.0,0.0
14718,1,4718,[588 210  69  95 678],297,2,19413,4.113795295613477,0.0,0.0
14719,1,4719,[187 286 515  79  25],416,5,19418,4.113983050847458,0.0,0.0
14720,1,4720,[127  71  11 111 132],175,4,19422,4.113958907011226,0.0,0.0
14721,1,4721,[ 64  12 483 427  11],214,5,19427,4.11414654807285,60.0,0.0
14722,1,4722,[100  89  71  25  69],373,4,19431,4.1141223798433195,0.0,0.0
14723,1,4723,[257 235 265 161 423],417,1,19432,4.11346316680779,0.0,0.0
14724,1,4724,[ 64  12 483 427  11],618,5,19437,4.113650793650794,60.0,0.0
14725,1,4725,[ 64  12 483 427  11],214,5,19442,4.113838341091832,60.0,0.0
14726,1,4726,[ 64  12 483 427  11],618,5,19447,4.114025809181299,60.0,0.0
14727,1,4727,[ 64  12 483 427  11],618,5,19452,4.114213197969543,60.0,0.0
14728,1,4728,[ 64  12 483 427  11],618,5,19457,4.114400507506873,60.0,0.0
14729,1,4729,[655 161 301 423 385],588,2,19459,4.113953488372093,0.0,0.0
14730,1,4730,[ 64  12 483 427  11],618,5,19464,4.114140773620799,60.0,0.0
14731,1,4731,[ 64  12 483 427  11],214,5,19469,4.114327979712595,60.0,0.0
14732,1,4732,[ 64  12 483 427  11],618,5,19474,4.114515106697655,60.0,0.0
14733,1,4733,[144 117 748 300 172],416,5,19479,4.114702154626109,0.0,0.0
14734,1,4734,[405 289 269 121  11],416,4,19483,4.114677930306231,0.0,0.0
14735,1,4735,[ 82 323  69 187 268],416,4,19487,4.114653716216216,0.0,0.0
14736,1,4736,[318  15  88 403  69],642,4,19491,4.114629512349588,20.0,0.0
14737,1,4737,[423 183 118 185 186],198,2,19493,4.114183199662305,0.0,0.0
14738,1,4738,[135 496  50  88  28],437,3,19496,4.1139480903144126,0.0,20.0
14739,1,4739,[216  98 234 597 313],618,4,19500,4.113924050632911,20.0,40.0
14740,1,4740,[ 64  12 483 427  11],618,5,19505,4.114110947057583,60.0,0.0
14741,1,4741,[245  12 273 333  79],416,4,19509,4.114086883171658,20.0,0.0
14742,1,4742,[ 64  12 483 427  11],618,5,19514,4.11427366645583,60.0,0.0
14743,1,4743,[151  69  25 508 125],345,3,19517,4.1140387858347385,0.0,0.0
14744,1,4744,[237 323 143 153 185],198,1,19518,4.113382507903056,0.0,0.0
14745,1,4745,[ 64  12 483 427  11],618,5,19523,4.113569321533923,60.0,0.0
14746,1,4746,[ 64  12 483 427  11],214,5,19528,4.11375605645671,60.0,0.0
14747,1,4747,[ 64  12 483 427  11],618,5,19533,4.113942712721146,60.0,0.0
14748,1,4748,[ 64  12 483 427  11],618,5,19538,4.114129290376922,60.0,0.0
14749,1,4749,[ 64  12 483 427  11],618,5,19543,4.114315789473684,60.0,0.0
14750,1,4750,[427 423 135 257  22],698,0,19543,4.113449800042097,0.0,0.0
14751,1,4751,[ 64  12 483 427  11],618,5,19548,4.113636363636363,60.0,0.0
14752,1,4752,[ 64  12 483 427  11],618,5,19553,4.11382284872712,60.0,0.0
14753,1,4753,[117  15 127 191 300],630,2,19555,4.113378207824989,0.0,0.0
14754,1,4754,[294 588 357 271 216],297,3,19558,4.113144058885384,0.0,0.0
14755,1,4755,[ 64  12 483 427  11],618,5,19563,4.113330529857023,60.0,0.0
14756,1,4756,[ 64  12 483 427  11],618,5,19568,4.113516922430103,60.0,0.0
14757,1,4757,[143  25 197 597 211],416,4,19572,4.1134930643127365,0.0,0.0
14758,1,4758,[ 79 216 275  56  97],43,5,19577,4.113679344400084,0.0,0.0
14759,1,4759,[ 64  12 483 427  11],618,5,19582,4.113865546218487,60.0,0.0
14760,1,4760,[313  28 742 483  15],588,5,19587,4.1140516698172656,40.0,20.0
14761,1,4761,[ 64  12 483 427  11],214,5,19592,4.114237715245695,60.0,0.0
14762,1,4762,[475 181 496 185 300],416,4,19596,4.1142137308419064,0.0,20.0
14763,1,4763,[ 64  12 483 427  11],214,5,19601,4.114399664147775,60.0,0.0
14764,1,4764,[ 64  12 483 427  11],214,5,19606,4.114585519412382,60.0,0.0
14765,1,4765,[269  25 275  95 313],416,4,19610,4.114561477129668,20.0,20.0
14766,1,4766,[475  97  82  25 302],417,3,19613,4.114327669393749,0.0,0.0
14767,1,4767,[173 185   7 302 117],214,5,19618,4.114513422818792,0.0,0.0
14768,1,4768,[238 546  15  97 515],417,4,19622,4.114489410777941,0.0,0.0
14769,1,4769,[ 79 427 588 300 117],253,5,19627,4.1146750524109015,0.0,0.0
14770,1,4770,[323   8 117 197 235],416,3,19630,4.114441416893733,0.0,0.0
14771,1,4771,[ 71 403 302 568   9],43,5,19635,4.114626990779548,0.0,0.0
14772,1,4772,[ 12 161 423 173 475],417,4,19639,4.114602975068092,20.0,0.0
14773,1,4773,[ 64  12 483 427  11],214,5,19644,4.114788437369082,60.0,0.0
14774,1,4774,[ 22 135 196 475 100],62,5,19649,4.114973821989529,0.0,0.0
14775,1,4775,[  1 405  50 153 423],262,1,19650,4.114321608040201,0.0,20.0
14776,1,4776,[ 98 496 111 588  79],417,1,19651,4.1136696671551185,0.0,20.0
14777,1,4777,[ 64  12 483 427  11],618,5,19656,4.113855169526999,60.0,0.0
14778,1,4778,[ 64  12 483 427  11],214,5,19661,4.114040594266583,60.0,0.0
14779,1,4779,[ 64  12 483 427  11],618,5,19666,4.114225941422594,60.0,0.0
14780,1,4780,[ 64  12 483 427  11],618,5,19671,4.1144112110437145,60.0,0.0
14781,1,4781,[328  12 228 294  97],62,1,19672,4.113759933082393,20.0,0.0
14782,1,4782,[194  22 181 603 515],416,5,19677,4.113945222663601,0.0,20.0
14783,1,4783,[655 471 117  11 100],618,4,19681,4.113921404682274,0.0,0.0
14784,1,4784,[403 173  95 288  28],805,2,19683,4.1134796238244515,0.0,20.0
14785,1,4785,[ 71 181 182   7 423],49,1,19684,4.112829084830756,0.0,20.0
14786,1,4786,[508 268  97   7  22],297,5,19689,4.11301441403802,0.0,0.0
14787,1,4787,[125 588 210  25 318],618,2,19691,4.112573099415204,20.0,0.0
14788,1,4788,[194 475 195 748 245],416,3,19694,4.112340780956358,0.0,0.0
14789,1,4789,[ 64  12 483 427  11],618,5,19699,4.112526096033403,60.0,0.0
14790,1,4790,[ 64  12 483 427  11],618,5,19704,4.112711333750783,60.0,0.0
14791,1,4791,[568 153  71 125  64],630,2,19706,4.112270450751252,20.0,0.0
14792,1,4792,[ 64  12 483 427  11],618,5,19711,4.112455664510745,60.0,0.0
14793,1,4793,[286 423  64 235  82],417,4,19715,4.112432206925323,20.0,0.0
14794,1,4794,[ 64  12 483 427  11],214,5,19720,4.112617309697602,60.0,0.0
14795,1,4795,[161  79  22 603 151],805,3,19723,4.112385321100917,0.0,0.0
14796,1,4796,[118  70   7 195 182],62,3,19726,4.1121534292266,0.0,0.0
14797,1,4797,[257  56 357 655 204],342,3,19729,4.111921634014172,0.0,0.0
14798,1,4798,[ 64  12 483 427  11],618,5,19734,4.11210668889352,60.0,0.0
14799,1,4799,[322 185 238 111  79],416,4,19738,4.1120833333333335,0.0,0.0
14800,1,4800,[ 64  12 483 427  11],618,5,19743,4.112268277442199,60.0,0.0
14801,1,4801,[ 64  12 483 427  11],618,5,19748,4.112453144523116,60.0,0.0
14802,1,4802,[ 64  12 483 427  11],214,5,19753,4.1126379346241935,60.0,0.0
14803,1,4803,[ 64  12 483 427  11],214,5,19758,4.1128226477935055,60.0,0.0
14804,1,4804,[ 64  12 483 427  11],214,5,19763,4.113007284079084,60.0,0.0
14805,1,4805,[ 71 318 216 200  88],711,4,19767,4.1129837702871415,20.0,0.0
14806,1,4806,[ 64  12 483 427  11],618,5,19772,4.113168296234658,60.0,0.0
14807,1,4807,[ 64  12 483 427  11],618,5,19777,4.113352745424293,60.0,0.0
14808,1,4808,[ 64  12 483 427  11],618,5,19782,4.11353711790393,60.0,0.0
14809,1,4809,[ 64  12 483 427  11],618,5,19787,4.1137214137214135,60.0,0.0
14810,1,4810,[568 196 195 257 153],62,3,19790,4.113489918935772,0.0,0.0
14811,1,4811,[ 64  12 483 427  11],214,5,19795,4.113674147963425,60.0,0.0
14812,1,4812,[ 64  12 483 427  11],214,5,19800,4.113858300436318,60.0,0.0
14813,1,4813,[ 64  12 483 427  11],618,5,19805,4.1140423764021605,60.0,0.0
14814,1,4814,[ 64  12 483 427  11],618,5,19810,4.114226375908619,60.0,0.0
14815,1,4815,[ 64  12 483 427  11],618,5,19815,4.114410299003322,60.0,0.0
14816,1,4816,[302 111 333  70 403],416,5,19820,4.114594145733859,0.0,0.0
14817,1,4817,[ 64  12 483 427  11],214,5,19825,4.114777916147779,60.0,0.0
14818,1,4818,[144 235 197 151  28],805,2,19827,4.114339074496783,0.0,0.0
14819,1,4819,[118 180 183 121 322],805,1,19828,4.113692946058091,0.0,0.0
14820,1,4820,[748  56 118 568  88],345,3,19831,4.113461937357394,0.0,0.0
14821,1,4821,[ 64  12 483 427  11],618,5,19836,4.113645790128578,60.0,0.0
14822,1,4822,[ 64  12 483 427  11],618,5,19841,4.1138295666597555,60.0,0.0
14823,1,4823,[ 64  12 483 427  11],618,5,19846,4.114013266998342,60.0,0.0
14824,1,4824,[ 64  12 483 427  11],618,5,19851,4.1141968911917095,60.0,0.0
14825,1,4825,[183  56 471 204  95],618,2,19853,4.113758806464982,0.0,0.0
14826,1,4826,[222 357  64 216 568],417,2,19855,4.1133209032525375,20.0,0.0
14827,1,4827,[181 210 405 161 655],345,4,19859,4.113297431648716,0.0,20.0
14828,1,4828,[168 228 172  15 265],198,2,19861,4.112859805342721,0.0,0.0
14829,1,4829,[222  11  98 180 588],805,2,19863,4.1124223602484475,0.0,20.0
14830,1,4830,[ 64  12 483 427  11],214,5,19868,4.112606085696543,60.0,0.0
14831,1,4831,[216  28 181   8 289],416,4,19872,4.112582781456954,0.0,20.0
14832,1,4832,[323 172  22  98 423],805,3,19875,4.112352576039727,0.0,20.0
14833,1,4833,[ 64  12 483 427  11],214,5,19880,4.112536201903186,60.0,0.0
14834,1,4834,[427  69 200 271  82],922,1,19881,4.111892450879007,0.0,0.0
14835,1,4835,[117 301  97 258  15],416,5,19886,4.112076095947064,0.0,0.0
14836,1,4836,[ 64  12 483 427  11],618,5,19891,4.1122596650816625,60.0,0.0
14837,1,4837,[ 64  12 483 427  11],214,5,19896,4.112443158329889,60.0,0.0
14838,1,4838,[ 64  12 483 427  11],618,5,19901,4.112626575738789,60.0,0.0
14839,1,4839,[ 64  12 483 427  11],618,5,19906,4.112809917355372,60.0,0.0
14840,1,4840,[268 588  82 655 294],416,5,19911,4.112993183226606,0.0,0.0
14841,1,4841,[ 64  12 483 427  11],214,5,19916,4.113176373399422,60.0,0.0
14842,1,4842,[196  97 202 318  50],618,4,19920,4.113153004336155,20.0,20.0
14843,1,4843,[ 64  12 483 427  11],214,5,19925,4.113336085879438,60.0,0.0
14844,1,4844,[187 313 385  56  28],416,5,19930,4.113519091847265,20.0,20.0
14845,1,4845,[ 64  12 483 427  11],618,5,19935,4.113702022286422,60.0,0.0
14846,1,4846,[195  28 269 427  22],262,2,19937,4.113265937693418,0.0,0.0
14847,1,4847,[ 15 185 483   8 471],907,4,19941,4.113242574257426,20.0,0.0
14848,1,4848,[143 215 172 222 288],922,3,19944,4.113012992369561,0.0,20.0
14849,1,4849,[ 64  12 483 427  11],214,5,19949,4.11319587628866,60.0,0.0
14850,1,4850,[ 64  12 483 427  11],618,5,19954,4.113378684807256,60.0,0.0
14851,1,4851,[ 88 183 276  69 301],416,3,19957,4.113149216817807,0.0,0.0
14852,1,4852,[ 64  12 483 427  11],214,5,19962,4.11333195961261,60.0,0.0
14853,1,4853,[ 64  12 483 427  11],214,5,19967,4.113514627111661,60.0,0.0
14854,1,4854,[ 64  12 483 427  11],618,5,19972,4.113697219361483,60.0,0.0
14855,1,4855,[ 64  12 483 427  11],214,5,19977,4.113879736408567,60.0,0.0
14856,1,4856,[ 64  12 483 427  11],214,5,19982,4.114062178299362,60.0,0.0
14857,1,4857,[282 195 265 301 153],416,5,19987,4.11424454508028,0.0,0.0
14858,1,4858,[118  79 508  11 294],654,2,19989,4.113809425807779,0.0,0.0
14859,1,4859,[  7 191 180 655 216],62,4,19993,4.113786008230453,0.0,0.0
14860,1,4860,[179 143 258 276 168],601,4,19997,4.113762600288006,0.0,0.0
14861,1,4861,[ 64  12 483 427  11],214,5,20002,4.113944878650761,60.0,0.0
14862,1,4862,[ 56 258  96 216 210],417,2,20004,4.113510178901913,0.0,0.0
14863,1,4863,[ 64  12 483 427  11],618,5,20009,4.1136924342105265,60.0,0.0
14864,1,4864,[ 64  12 483 427  11],214,5,20014,4.113874614594039,60.0,0.0
14865,1,4865,[ 64  12 483 427  11],214,5,20019,4.1140567200986435,60.0,0.0
14866,1,4866,[  7 234 183  28 282],618,4,20023,4.114033285391412,0.0,0.0
14867,1,4867,[ 64  12 483 427  11],214,5,20028,4.114215283483977,60.0,0.0
14868,1,4868,[ 64  12 483 427  11],214,5,20033,4.114397206818649,60.0,0.0
14869,1,4869,[172 234 568 181 222],417,1,20034,4.113757700205339,0.0,20.0
14870,1,4870,[294 196  50 275 151],297,3,20037,4.113529049476494,0.0,20.0
14871,1,4871,[234  79 276 187 161],416,4,20041,4.113505747126437,0.0,0.0
14872,1,4872,[161  97 179 173 182],405,1,20042,4.112866817155756,0.0,0.0
14873,1,4873,[ 64  12 483 427  11],618,5,20047,4.11304883052934,60.0,0.0
14874,1,4874,[ 64  12 483 427  11],214,5,20052,4.1132307692307695,60.0,0.0
14875,1,4875,[ 64  12 483 427  11],214,5,20057,4.113412633305988,60.0,0.0
14876,1,4876,[ 64  12 483 427  11],214,5,20062,4.113594422800902,60.0,0.0
14877,1,4877,[ 64  12 483 427  11],618,5,20067,4.113776137761378,60.0,0.0
14878,1,4878,[ 64  12 483 427  11],214,5,20072,4.113957778233244,60.0,0.0
14879,1,4879,[ 82 153 603 132 237],416,4,20076,4.113934426229508,0.0,0.0
14880,1,4880,[ 89  64 186 132  82],198,4,20080,4.113911083794305,20.0,0.0
14881,1,4881,[ 71 216 286 294 121],764,4,20084,4.113887750921753,0.0,0.0
14882,1,4882,[ 64  12 483 427  11],618,5,20089,4.114069219741962,60.0,0.0
14883,1,4883,[ 64  12 483 427  11],214,5,20094,4.114250614250614,60.0,0.0
14884,1,4884,[ 64  12 483 427  11],618,5,20099,4.114431934493347,60.0,0.0
14885,1,4885,[ 64  12 483 427  11],214,5,20104,4.114613180515759,60.0,0.0
14886,1,4886,[143 183 588 168 187],405,2,20106,4.114180478821363,0.0,0.0
14887,1,4887,[  8 143 286 172  88],907,4,20110,4.1141571194762685,0.0,0.0
14888,1,4888,[ 64  12 483 427  11],618,5,20115,4.114338310492943,60.0,0.0
14889,1,4889,[258 235 357 265  50],297,3,20118,4.1141104294478525,0.0,20.0
14890,1,4890,[174  15   7 215 151],416,4,20122,4.114087098752811,0.0,0.0
14891,1,4891,[161 318 174  28 268],416,5,20127,4.114268192968111,20.0,0.0
14892,1,4892,[655 515 185 183 269],416,5,20132,4.1144492131616595,0.0,0.0
14893,1,4893,[202 742 197 322 194],416,4,20136,4.114425827543931,0.0,0.0
14894,1,4894,[427 175 357  95  88],342,3,20139,4.114198161389172,0.0,0.0
14895,1,4895,[294 238   7 258 127],417,4,20143,4.114174836601308,0.0,0.0
14896,1,4896,[235   7  28 117   1],805,2,20145,4.1137431080253215,0.0,0.0
14897,1,4897,[ 64  12 483 427  11],214,5,20150,4.113924050632911,60.0,0.0
14898,1,4898,[180  28  56  95 197],805,2,20152,4.113492549499898,0.0,0.0
14899,1,4899,[588 210  71 173  28],405,3,20155,4.113265306122449,0.0,0.0
14900,1,4900,[ 64  12 483 427  11],618,5,20160,4.113446235462151,60.0,0.0
14901,1,4901,[ 64  12 483 427  11],618,5,20165,4.113627090983272,60.0,0.0
14902,1,4902,[ 64  12 483 427  11],214,5,20170,4.113807872730981,60.0,0.0
14903,1,4903,[546 597  79 180 268],417,2,20172,4.113376835236542,0.0,0.0
14904,1,4904,[508  64 196 161 328],314,3,20175,4.113149847094801,20.0,0.0
14905,1,4905,[ 64  12 483 427  11],214,5,20180,4.113330615572768,60.0,0.0
14906,1,4906,[ 64  12 483 427  11],618,5,20185,4.113511310372937,60.0,0.0
14907,1,4907,[ 70 125 168 182 276],416,4,20189,4.113488182559087,0.0,0.0
14908,1,4908,[ 64  12 483 427  11],214,5,20194,4.113668771643919,60.0,0.0
14909,1,4909,[403  82 405  22 546],705,4,20198,4.113645621181263,0.0,0.0
14910,1,4910,[118 161 117 475 125],417,4,20202,4.11362248014661,0.0,0.0
14911,1,4911,[ 64  12 483 427  11],214,5,20207,4.113802931596092,60.0,0.0
14912,1,4912,[ 28 257 258 121 132],642,3,20210,4.113576226338286,0.0,0.0
14913,1,4913,[ 64  12 483 427  11],214,5,20215,4.113756613756614,60.0,0.0
14914,1,4914,[ 64  12 483 427  11],214,5,20220,4.1139369277721265,60.0,0.0
14915,1,4915,[228 215 265 655  50],405,3,20223,4.113710333604557,0.0,20.0
14916,1,4916,[ 64  12 483 427  11],214,5,20228,4.113890583689241,60.0,0.0
14917,1,4917,[ 64  12 483 427  11],618,5,20233,4.114070760471736,60.0,0.0
14918,1,4918,[181 423  28  22 603],805,1,20234,4.113437690587518,0.0,20.0
14919,1,4919,[ 15 655 111 179 301],437,3,20237,4.113211382113821,0.0,0.0
14920,1,4920,[ 64  12 483 427  11],214,5,20242,4.113391587075798,60.0,0.0
14921,1,4921,[ 88 268 195 323 187],416,3,20245,4.113165379926859,0.0,0.0
14922,1,4922,[ 64  12 483 427  11],214,5,20250,4.113345521023766,60.0,0.0
14923,1,4923,[179 191 403 496 265],417,3,20253,4.113119415109667,0.0,0.0
14924,1,4924,[181   1 655 328 216],416,5,20258,4.113299492385787,0.0,20.0
14925,1,4925,[268   9 322 127  50],708,1,20259,4.112667478684531,0.0,20.0
14926,1,4926,[ 64  12 483 427  11],618,5,20264,4.112847574588999,60.0,0.0
14927,1,4927,[135 235 144 597 302],62,2,20266,4.1124188311688314,0.0,0.0
14928,1,4928,[228 238  98 423 435],230,3,20269,4.112193142625279,0.0,20.0
14929,1,4929,[153 568   7 385 748],198,2,20271,4.1117647058823525,0.0,0.0
14930,1,4930,[ 64  12 483 427  11],214,5,20276,4.111944838775097,60.0,0.0
14931,1,4931,[ 64  12 483 427  11],214,5,20281,4.112124898621249,60.0,0.0
14932,1,4932,[ 64  12 483 427  11],214,5,20286,4.112304885465234,60.0,0.0
14933,1,4933,[151 294 185  70  69],417,3,20289,4.112079448723145,0.0,0.0
14934,1,4934,[333   9 286 276 265],416,4,20293,4.112056737588652,0.0,0.0
14935,1,4935,[546 181  97 235 265],297,2,20295,4.111628849270664,0.0,20.0
14936,1,4936,[ 64  12 483 427  11],618,5,20300,4.111808790763622,60.0,0.0
14937,1,4937,[273 333  97 210 216],416,5,20305,4.111988659376266,0.0,0.0
14938,1,4938,[ 69 161 121 588 245],505,3,20308,4.111763514881555,0.0,0.0
14939,1,4939,[202 742  97 196 180],417,4,20312,4.111740890688259,0.0,0.0
14940,1,4940,[ 64  12 483 427  11],214,5,20317,4.111920663833232,60.0,0.0
14941,1,4941,[ 64  12 483 427  11],214,5,20322,4.11210036422501,60.0,0.0
14942,1,4942,[ 64  12 483 427  11],214,5,20327,4.112279991907748,60.0,0.0
14943,1,4943,[ 64  12 483 427  11],618,5,20332,4.1124595469255665,60.0,0.0
14944,1,4944,[405  12 194 196 168],416,5,20337,4.112639029322548,20.0,0.0
14945,1,4945,[121  11 216 435  28],230,5,20342,4.112818439142742,0.0,0.0
14946,1,4946,[ 64  12 483 427  11],214,5,20347,4.112997776430159,60.0,0.0
14947,1,4947,[ 64  12 483 427  11],214,5,20352,4.113177041228779,60.0,0.0
14948,1,4948,[ 64 143 180 515   4],405,3,20355,4.112952111537685,20.0,0.0
14949,1,4949,[202 174 100   9 215],43,5,20360,4.113131313131313,0.0,0.0
14950,1,4950,[ 64  12 483 427  11],618,5,20365,4.113310442334882,60.0,0.0
14951,1,4951,[117 508 237 204 182],62,3,20368,4.113085621970921,0.0,0.0
14952,1,4952,[515 423 111 197 269],297,2,20370,4.112658994548759,0.0,0.0
14953,1,4953,[ 64  12 483 427  11],214,5,20375,4.112838110617683,60.0,0.0
14954,1,4954,[228 197 172  28 748],721,4,20379,4.112815338042381,0.0,0.0
14955,1,4955,[ 64  12 483 427  11],214,5,20384,4.112994350282486,60.0,0.0
14956,1,4956,[ 64  12 483 427  11],214,5,20389,4.11317329029655,60.0,0.0
14957,1,4957,[ 64  12 483 427  11],214,5,20394,4.1133521581282775,60.0,0.0
14958,1,4958,[ 64  12 483 427  11],618,5,20399,4.113530953821335,60.0,0.0
14959,1,4959,[ 64  12 483 427  11],214,5,20404,4.1137096774193544,60.0,0.0
14960,1,4960,[ 64  12 483 427  11],618,5,20409,4.113888328965935,60.0,0.0
14961,1,4961,[183  56  70 174 185],417,3,20412,4.1136638452237,0.0,0.0
14962,1,4962,[ 64  12 483 427  11],214,5,20417,4.113842434011686,60.0,0.0
14963,1,4963,[ 64  12 483 427  11],618,5,20422,4.114020950846092,60.0,0.0
14964,1,4964,[ 64  12 483 427  11],214,5,20427,4.114199395770393,60.0,0.0
14965,1,4965,[216 234 588  96 172],230,4,20431,4.1141763995167135,0.0,0.0
14966,1,4966,[ 97 322 234  79 427],416,4,20435,4.11415341252265,0.0,0.0
14967,1,4967,[ 64  12 483 427  11],618,5,20440,4.114331723027375,60.0,0.0
14968,1,4968,[ 64  12 483 427  11],618,5,20445,4.114509961762931,60.0,0.0
14969,1,4969,[ 64  12 483 427  11],618,5,20450,4.114688128772636,60.0,0.0
14970,1,4970,[ 64  12 483 427  11],618,5,20455,4.114866224099779,60.0,0.0
14971,1,4971,[508 172 161 288 286],345,2,20457,4.114440868865648,0.0,20.0
14972,1,4972,[ 79 204 313 175  11],405,4,20461,4.114417856424693,20.0,20.0
14973,1,4973,[275   4 655 191 328],416,5,20466,4.1145958986731,0.0,0.0
14974,1,4974,[ 64  12 483 427  11],618,5,20471,4.114773869346734,60.0,0.0
14975,1,4975,[ 64  12 483 427  11],214,5,20476,4.114951768488746,60.0,0.0
14976,1,4976,[ 64  12 483 427  11],214,5,20481,4.115129596142254,60.0,0.0
14977,1,4977,[ 64  12 483 427  11],214,5,20486,4.115307352350341,60.0,0.0
14978,1,4978,[173 423 144 185 195],437,3,20489,4.115083350070295,0.0,0.0
14979,1,4979,[302 597  96  97   8],416,4,20493,4.115060240963856,0.0,0.0
14980,1,4980,[ 64  12 483 427  11],214,5,20498,4.115237904035334,60.0,0.0
14981,1,4981,[ 64  12 483 427  11],618,5,20503,4.115415495784825,60.0,0.0
14982,1,4982,[313 508 210 568  12],654,4,20507,4.115392333935381,40.0,20.0
14983,1,4983,[ 64  12 483 427  11],214,5,20512,4.115569823434992,60.0,0.0
14984,1,4984,[ 64  12 483 427  11],214,5,20517,4.115747241725176,60.0,0.0
14985,1,4985,[515   4 258 237  25],416,4,20521,4.115724027276374,0.0,0.0
14986,1,4986,[175 271 483  11 258],854,5,20526,4.115901343493082,20.0,0.0
14987,1,4987,[ 64  12 483 427  11],214,5,20531,4.1160785886126705,60.0,0.0
14988,1,4988,[ 64  12 483 427  11],214,5,20536,4.116255762677891,60.0,0.0
14989,1,4989,[196   9 100   8 202],43,5,20541,4.116432865731463,0.0,0.0
14990,1,4990,[191  22  70 568 423],711,3,20544,4.1162091765177315,0.0,0.0
14991,1,4991,[ 71 151 234  28 678],416,3,20547,4.115985576923077,0.0,0.0
14992,1,4992,[200 588 118   8 185],805,2,20549,4.115561786501101,0.0,0.0
14993,1,4993,[ 64  12 483 427  11],618,5,20554,4.115738886663997,60.0,0.0
14994,1,4994,[ 64  12 483 427  11],618,5,20559,4.115915915915916,60.0,0.0
14995,1,4995,[ 64  12 483 427  11],618,5,20564,4.116092874299439,60.0,0.0
14996,1,4996,[ 64  12 483 427  11],618,5,20569,4.116269761857114,60.0,0.0
14997,1,4997,[ 64  12 483 427  11],214,5,20574,4.116446578631453,60.0,0.0
14998,1,4998,[302 216 151 125  89],417,3,20577,4.11622324464893,0.0,0.0
14999,1,4999,[ 64  12 483 427  11],214,5,20582,4.1164,60.0,0.0
15000,1,5000,[195 180  97 132 286],373,1,20583,4.115776844631074,0.0,0.0
15001,1,5001,[748 597 168 318   1],654,5,20588,4.115953618552579,20.0,0.0
15002,1,5002,[237  79 182  25  98],907,5,20593,4.116130321806916,0.0,20.0
15003,1,5003,[ 64  12 483 427  11],618,5,20598,4.116306954436451,60.0,0.0
15004,1,5004,[ 64  12 483 427  11],214,5,20603,4.116483516483516,60.0,0.0
15005,1,5005,[ 64  12 483 427  11],214,5,20608,4.116660007990411,60.0,0.0
15006,1,5006,[748 153 210  95  96],417,3,20611,4.116436988216497,0.0,0.0
15007,1,5007,[117 185 427  56 144],230,3,20614,4.116214057507987,0.0,0.0
15008,1,5008,[257   4  28  96  95],642,4,20618,4.116190856458375,0.0,0.0
15009,1,5009,[ 64  12 483 427  11],214,5,20623,4.116367265469062,60.0,0.0
15010,1,5010,[ 64  12 483 427  11],618,5,20628,4.116543604071044,60.0,0.0
15011,1,5011,[ 64  12 483 427  11],618,5,20633,4.116719872306464,60.0,0.0
15012,1,5012,[ 64  12 483 427  11],618,5,20638,4.116896070217435,60.0,0.0
15013,1,5013,[215 357 117 403 172],62,4,20642,4.116872756282409,0.0,0.0
15014,1,5014,[ 64  12 483 427  11],618,5,20647,4.117048853439681,60.0,0.0
15015,1,5015,[168  15 202 197 427],128,4,20651,4.117025518341308,0.0,0.0
15016,1,5016,[294 257 151  98  12],854,3,20654,4.11680287024118,20.0,20.0
15017,1,5017,[132  96 144   9 100],416,5,20659,4.116978876046233,0.0,0.0
15018,1,5018,[427 183  95 100  11],416,4,20663,4.116955568838414,0.0,0.0
15019,1,5019,[237 603 475 117 423],437,3,20666,4.116733067729084,0.0,0.0
15020,1,5020,[ 64  12 483 427  11],214,5,20671,4.116908982274447,60.0,0.0
15021,1,5021,[174 678 202 234 385],588,1,20672,4.116288331342095,0.0,0.0
15022,1,5022,[ 64  12 483 427  11],214,5,20677,4.1164642643838345,60.0,0.0
15023,1,5023,[ 64  12 483 427  11],618,5,20682,4.116640127388535,60.0,0.0
15024,1,5024,[ 64  12 483 427  11],214,5,20687,4.11681592039801,60.0,0.0
15025,1,5025,[ 64  12 483 427  11],214,5,20692,4.116991643454039,60.0,0.0
15026,1,5026,[403 276 313 111 117],43,5,20697,4.117167296598369,20.0,20.0
15027,1,5027,[151  50 235 183 180],62,5,20702,4.117342879872713,0.0,20.0
15028,1,5028,[211 294  56   4 215],43,5,20707,4.117518393318751,0.0,0.0
15029,1,5029,[357 302 168 200 238],416,5,20712,4.117693836978131,0.0,0.0
15030,1,5030,[125 183  88  15 185],416,4,20716,4.117670443251838,0.0,0.0
15031,1,5031,[427 496 269 175  11],214,4,20720,4.117647058823529,0.0,0.0
15032,1,5032,[ 64  12 483 427  11],214,5,20725,4.117822372342539,60.0,0.0
15033,1,5033,[173 282  69 174 168],618,3,20728,4.117600317838697,0.0,0.0
15034,1,5034,[269 117 286 111  79],297,3,20731,4.117378351539226,0.0,0.0
15035,1,5035,[210 176 357 216 258],297,5,20736,4.117553613979348,0.0,0.0
15036,1,5036,[228  25 483 286 180],417,3,20739,4.117331745086361,20.0,0.0
15037,1,5037,[185 196 127 603  89],405,2,20741,4.116911472806669,0.0,0.0
15038,1,5038,[286 195 655 276 275],62,3,20744,4.116689819408613,0.0,0.0
15039,1,5039,[173  28 211 475 435],437,2,20746,4.116269841269841,0.0,0.0
15040,1,5040,[301  98 185 144 143],297,4,20750,4.116246776433248,0.0,20.0
15041,1,5041,[  9 204 100 357 176],698,2,20752,4.115827052756843,0.0,0.0
15042,1,5042,[ 64  12 483 427  11],214,5,20757,4.11600237953599,60.0,0.0
15043,1,5043,[216 127 210  96 173],416,5,20762,4.116177636796193,0.0,0.0
15044,1,5044,[496 568 235  97 748],642,4,20766,4.11615460852329,0.0,0.0
15045,1,5045,[ 64  12 483 427  11],214,5,20771,4.116329766151407,60.0,0.0
15046,1,5046,[597 273 568   7 172],630,4,20775,4.1163067168615015,0.0,0.0
15047,1,5047,[357 210 172 183 265],198,4,20779,4.116283676703645,0.0,0.0
15048,1,5048,[ 64  12 483 427  11],214,5,20784,4.116458704693999,60.0,0.0
15049,1,5049,[117 300 176 748  88],505,4,20788,4.1164356435643565,0.0,0.0
15050,1,5050,[182 328 271 100 196],62,3,20791,4.116214610968125,0.0,0.0
15051,1,5051,[ 28 187 204 179 603],405,3,20794,4.1159936658749015,0.0,0.0
15052,1,5052,[ 64  12 483 427  11],214,5,20799,4.116168612705324,60.0,0.0
15053,1,5053,[496 245 121 515 265],417,2,20801,4.115749901068461,0.0,0.0
15054,1,5054,[ 64  12 483 427  11],618,5,20806,4.115924826904055,60.0,0.0
15055,1,5055,[ 64  12 483 427  11],214,5,20811,4.116099683544304,60.0,0.0
15056,1,5056,[ 64  12 483 427  11],214,5,20816,4.1162744710302555,60.0,0.0
15057,1,5057,[185 588 282 211 235],297,3,20819,4.116053776196125,0.0,0.0
15058,1,5058,[ 56 118 111  71 742],805,1,20820,4.115437833563946,0.0,0.0
15059,1,5059,[597 132 294 216 302],62,2,20822,4.11501976284585,0.0,0.0
15060,1,5060,[172 245  15 742 174],642,5,20827,4.115194625568069,0.0,0.0
15061,1,5061,[ 64  12 483 427  11],214,5,20832,4.115369419201897,60.0,0.0
15062,1,5062,[ 69 423 196 200  25],198,2,20834,4.114951609717559,0.0,0.0
15063,1,5063,[238 168 143  50 194],297,4,20838,4.1149289099526065,0.0,20.0
15064,1,5064,[ 50 204  70 215  95],43,5,20843,4.115103652517275,0.0,20.0
15065,1,5065,[204 200  25  82  22],805,2,20845,4.114686142913541,0.0,0.0
15066,1,5066,[151 483 508 135 195],417,3,20848,4.11446615354253,20.0,0.0
15067,1,5067,[301 237 742 385 210],345,4,20852,4.114443567482241,0.0,0.0
15068,1,5068,[427 237 185  64 202],230,5,20857,4.114618267902939,20.0,0.0
15069,1,5069,[ 64  12 483 427  11],214,5,20862,4.114792899408284,60.0,0.0
15070,1,5070,[ 64  12 483 427  11],618,5,20867,4.114967462039045,60.0,0.0
15071,1,5071,[ 64 195 515  88 117],416,4,20871,4.114944794952681,20.0,0.0
15072,1,5072,[ 64  12 483 427  11],214,5,20876,4.115119258821211,60.0,0.0
15073,1,5073,[ 64  12 483 427  11],618,5,20881,4.115293653921955,60.0,0.0
15074,1,5074,[588   1 318 423 151],654,5,20886,4.115467980295566,20.0,0.0
15075,1,5075,[  8 185 187 568 357],405,5,20891,4.115642237982663,0.0,0.0
15076,1,5076,[ 28 168 273 182 328],62,3,20894,4.115422493598582,0.0,0.0
15077,1,5077,[  8  96 215 195 323],416,4,20898,4.115399763686491,0.0,0.0
15078,1,5078,[275   8 175 588 257],297,4,20902,4.115377042724946,0.0,0.0
15079,1,5079,[405  82  70 121 144],416,5,20907,4.115551181102362,0.0,0.0
15080,1,5080,[186 597  95 265 135],417,2,20909,4.115134815981106,0.0,0.0
15081,1,5081,[235 174  22 286 222],854,1,20910,4.114521841794569,0.0,0.0
15082,1,5082,[ 64  12 483 427  11],618,5,20915,4.114696045642337,60.0,0.0
15083,1,5083,[ 28 161 471 132 216],416,5,20920,4.1148701809598744,0.0,0.0
15084,1,5084,[ 64  12 483 427  11],214,5,20925,4.115044247787611,60.0,0.0
15085,1,5085,[182 196 294 357 197],342,2,20927,4.1146283916633895,0.0,0.0
15086,1,5086,[173 276 385 186   8],618,2,20929,4.11421269903676,0.0,0.0
15087,1,5087,[216 286  89 405 143],764,5,20934,4.11438679245283,0.0,0.0
15088,1,5088,[ 64  12 483 427  11],618,5,20939,4.114560817449401,60.0,0.0
15089,1,5089,[ 64  12 483 427  11],618,5,20944,4.114734774066798,60.0,0.0
15090,1,5090,[ 64  12 483 427  11],214,5,20949,4.114908662345315,60.0,0.0
15091,1,5091,[ 64  12 483 427  11],618,5,20954,4.115082482325216,60.0,0.0
15092,1,5092,[ 64  12 483 427  11],214,5,20959,4.115256234046731,60.0,0.0
15093,1,5093,[ 64  12 483 427  11],214,5,20964,4.115429917550059,60.0,0.0
15094,1,5094,[181 132  82 288  69],437,2,20966,4.115014720314034,0.0,40.0
15095,1,5095,[ 64  12 483 427  11],618,5,20971,4.115188383045526,60.0,0.0
15096,1,5096,[238 180 168 161 200],711,5,20976,4.115361977633902,0.0,0.0
15097,1,5097,[ 64  12 483 427  11],618,5,20981,4.115535504119262,60.0,0.0
15098,1,5098,[ 64  12 483 427  11],618,5,20986,4.1157089625416745,60.0,0.0
15099,1,5099,[ 64  12 483 427  11],618,5,20991,4.115882352941177,60.0,0.0
15100,1,5100,[ 64  12 483 427  11],618,5,20996,4.116055675357773,60.0,0.0
15101,1,5101,[ 64  12 483 427  11],618,5,21001,4.116228929831439,60.0,0.0
15102,1,5102,[301 179 245  12 161],416,3,21004,4.116010190084264,20.0,0.0
15103,1,5103,[143 496 186 222  98],496,2,21006,4.115595611285267,0.0,20.0
15104,1,5104,[ 64  12 483 427  11],618,5,21011,4.115768854064642,60.0,0.0
15105,1,5105,[ 64  12 483 427  11],618,5,21016,4.115942028985507,60.0,0.0
15106,1,5106,[181 357 173  82 427],373,4,21020,4.1159193264147245,0.0,20.0
15107,1,5107,[ 64  12 483 427  11],618,5,21025,4.1160924040720435,60.0,0.0
15108,1,5108,[ 79  12 235  95 216],297,2,21027,4.1156782149148565,20.0,0.0
15109,1,5109,[132 496 568 237 273],253,4,21031,4.115655577299413,0.0,0.0
15110,1,5110,[427 655 258  98 168],198,5,21036,4.115828604969673,0.0,20.0
15111,1,5111,[ 64  12 483 427  11],214,5,21041,4.116001564945227,60.0,0.0
15112,1,5112,[144 153 385 357 211],416,5,21046,4.116174457265793,0.0,0.0
15113,1,5113,[ 64  12 483 427  11],618,5,21051,4.11634728197106,60.0,0.0
15114,1,5114,[ 64  12 483 427  11],214,5,21056,4.116520039100684,60.0,0.0
15115,1,5115,[127  79 197 173 118],416,4,21060,4.1164972634870995,0.0,0.0
15116,1,5116,[215 265  15  79 603],128,4,21064,4.116474496775455,0.0,0.0
15117,1,5117,[ 64  12 483 427  11],618,5,21069,4.116647127784291,60.0,0.0
15118,1,5118,[ 95 603 258 282 222],297,3,21072,4.116428990037116,0.0,0.0
15119,1,5119,[ 64  12 483 427  11],618,5,21077,4.1166015625,60.0,0.0
15120,1,5120,[215 111 176 172   7],62,3,21080,4.116383518843976,0.0,0.0
15121,1,5121,[215 475 405 546 238],416,3,21083,4.116165560327997,0.0,0.0
15122,1,5122,[385  64  82 195 245],417,5,21088,4.116338083154401,20.0,0.0
15123,1,5123,[282 603 168  97 202],297,3,21091,4.116120218579235,0.0,0.0
15124,1,5124,[ 64  12 483 427  11],214,5,21096,4.116292682926829,60.0,0.0
15125,1,5125,[ 64  12 483 427  11],214,5,21101,4.116465079984393,60.0,0.0
15126,1,5126,[180 588 195  96 322],805,1,21102,4.115857226448215,0.0,0.0
15127,1,5127,[742  69 111  12 135],854,3,21105,4.115639625585024,20.0,0.0
15128,1,5128,[  7 111 302 100 195],297,3,21108,4.115422109573016,0.0,0.0
15129,1,5129,[385 238   4 603  95],805,2,21110,4.115009746588694,0.0,0.0
15130,1,5130,[403 179 174  50   4],417,2,21112,4.114597544338336,0.0,20.0
15131,1,5131,[ 64  12 483 427  11],214,5,21117,4.11477007014809,60.0,0.0
15132,1,5132,[237 323 117  95 257],416,1,21118,4.114163257354374,0.0,0.0
15133,1,5133,[ 95  50 211 588  98],230,5,21123,4.114335800545383,0.0,40.0
15134,1,5134,[174 179 294 423  56],617,1,21124,4.113729308666017,0.0,0.0
15135,1,5135,[ 64  12 483 427  11],618,5,21129,4.1139018691588785,60.0,0.0
15136,1,5136,[ 69 127  71 423 210],43,5,21134,4.114074362468367,0.0,0.0
15137,1,5137,[ 64  12 483 427  11],618,5,21139,4.11424678863371,60.0,0.0
15138,1,5138,[ 64  12 483 427  11],214,5,21144,4.114419147694104,60.0,0.0
15139,1,5139,[ 64  12 483 427  11],618,5,21149,4.1145914396887155,60.0,0.0
15140,1,5140,[508 282  95 496 144],342,3,21152,4.114374635284964,0.0,0.0
15141,1,5141,[204 174   8 546 603],805,1,21153,4.113768961493582,0.0,0.0
15142,1,5142,[173 117 180 210 405],62,4,21157,4.113746840365545,0.0,0.0
15143,1,5143,[161 423 588  22 200],405,2,21159,4.113335925349922,0.0,0.0
15144,1,5144,[257  71 742 181   8],62,3,21162,4.113119533527697,0.0,20.0
15145,1,5145,[ 95 175  28 678   4],805,2,21164,4.112708900116595,0.0,0.0
15146,1,5146,[ 64  12 483 427  11],214,5,21169,4.112881290071886,60.0,0.0
15147,1,5147,[ 64  12 483 427  11],214,5,21174,4.113053613053613,60.0,0.0
15148,1,5148,[ 64  12 483 427  11],214,5,21179,4.113225869100797,60.0,0.0
15149,1,5149,[300 357 211 423 118],416,4,21183,4.113203883495146,0.0,0.0
15150,1,5150,[ 64  12 483 427  11],214,5,21188,4.113376043486702,60.0,0.0
15151,1,5151,[ 64  12 483 427  11],618,5,21193,4.113548136645963,60.0,0.0
15152,1,5152,[ 64  12 483 427  11],618,5,21198,4.113720163011838,60.0,0.0
15153,1,5153,[ 56 302   9 265 179],416,4,21202,4.113698098564222,0.0,0.0
15154,1,5154,[216 323 357 258 238],416,4,21206,4.113676042677013,0.0,0.0
15155,1,5155,[125 117 127 288 655],62,3,21209,4.113460046547711,0.0,20.0
15156,1,5156,[301 289 127 235  97],416,3,21212,4.113244134186543,0.0,0.0
15157,1,5157,[ 64 318 405 172 173],642,3,21215,4.113028305544785,40.0,0.0
15158,1,5158,[ 64  12 483 427  11],618,5,21220,4.1132002326032175,60.0,0.0
15159,1,5159,[ 64  12 483 427  11],618,5,21225,4.113372093023256,60.0,0.0
15160,1,5160,[ 97 216 286 515  89],417,4,21229,4.113350125944584,0.0,0.0
15161,1,5161,[172 435  15 202  97],373,3,21232,4.113134444013948,0.0,0.0
15162,1,5162,[ 64  12 483 427  11],214,5,21237,4.113306217315515,60.0,0.0
15163,1,5163,[269  88 200 202 196],416,4,21241,4.113284275755229,0.0,0.0
15164,1,5164,[546  69 269 235 475],416,2,21243,4.112875121006776,0.0,0.0
15165,1,5165,[172 237 328 173 180],128,3,21246,4.112659698025552,0.0,0.0
15166,1,5166,[ 64  12 483 427  11],618,5,21251,4.112831430230307,60.0,0.0
15167,1,5167,[211  69 168 258 117],417,4,21255,4.11280959752322,0.0,0.0
15168,1,5168,[ 64  12 483 427  11],214,5,21260,4.112981234281293,60.0,0.0
15169,1,5169,[268 289   7 174  28],588,2,21262,4.1125725338491295,0.0,0.0
15170,1,5170,[ 64  12 483 427  11],618,5,21267,4.112744150067686,60.0,0.0
15171,1,5171,[ 64  12 483 427  11],618,5,21272,4.11291569992266,60.0,0.0
15172,1,5172,[357 238 172  15   9],416,5,21277,4.113087183452542,0.0,0.0
15173,1,5173,[ 64  12 483 427  11],214,5,21282,4.1132586006957865,60.0,0.0
15174,1,5174,[174 258 288 168  56],601,3,21285,4.113043478260869,0.0,20.0
15175,1,5175,[ 64  12 483 427  11],618,5,21290,4.113214837712519,60.0,0.0
15176,1,5176,[194 127 173 333 151],854,3,21293,4.112999806837937,0.0,0.0
15177,1,5177,[ 28 118  25 168 172],751,4,21297,4.112977983777521,0.0,0.0
15178,1,5178,[ 64  12 483 427  11],214,5,21302,4.113149256613246,60.0,0.0
15179,1,5179,[ 64  12 483 427  11],214,5,21307,4.113320463320464,60.0,0.0
15180,1,5180,[197 357 161  82 151],805,3,21310,4.113105578073731,0.0,0.0
15181,1,5181,[ 64  12 483 427  11],618,5,21315,4.113276727132381,60.0,0.0
15182,1,5182,[118 568 172 180  12],62,3,21318,4.113061933243295,20.0,0.0
15183,1,5183,[ 64  12 483 427  11],618,5,21323,4.113233024691358,60.0,0.0
15184,1,5184,[748  69 132  28 100],345,3,21326,4.113018322082931,0.0,0.0
15185,1,5185,[161 471 301 333 403],416,5,21331,4.113189355958349,0.0,0.0
15186,1,5186,[ 25 273 322 235  22],416,3,21334,4.112974744553692,0.0,0.0
15187,1,5187,[ 64  12 483 427  11],214,5,21339,4.113145720894372,60.0,0.0
15188,1,5188,[ 64  12 483 427  11],214,5,21344,4.113316631335517,60.0,0.0
15189,1,5189,[222  70 258 180 143],711,4,21348,4.113294797687861,0.0,0.0
15190,1,5190,[ 69 210  98 135 143],922,2,21350,4.112887690233095,0.0,20.0
15191,1,5191,[ 64  12 483 427  11],618,5,21355,4.113058551617874,60.0,0.0
15192,1,5192,[ 64  12 483 427  11],214,5,21360,4.113229347198152,60.0,0.0
15193,1,5193,[ 64  12 483 427  11],618,5,21365,4.113400077011937,60.0,0.0
15194,1,5194,[172 121 111 228  79],417,0,21365,4.112608277189605,0.0,0.0
15195,1,5195,[ 64  12 483 427  11],214,5,21370,4.112779060816012,60.0,0.0
15196,1,5196,[216  79 210 135  12],618,3,21373,4.1125649413122956,20.0,0.0
15197,1,5197,[403 118 546 210  82],43,5,21378,4.112735667564448,0.0,0.0
15198,1,5198,[143  56 301 265  95],297,3,21381,4.112521638776688,0.0,0.0
15199,1,5199,[385 185 403 655 238],405,4,21385,4.1125,0.0,0.0
15200,1,5200,[ 64  12 483 427  11],618,5,21390,4.112670640261488,60.0,0.0
15201,1,5201,[  9  82 588   1 222],805,2,21392,4.112264513648597,0.0,0.0
15202,1,5202,[268 194 132 161 427],416,5,21397,4.112435133576783,0.0,0.0
15203,1,5203,[100 118 288 117 318],654,2,21399,4.112029208301307,20.0,20.0
15204,1,5204,[ 64  12 483 427  11],618,5,21404,4.112199807877041,60.0,0.0
15205,1,5205,[117  98   7  79 197],297,3,21407,4.111986169804072,0.0,20.0
15206,1,5206,[ 64  12 483 427  11],618,5,21412,4.112156712118303,60.0,0.0
15207,1,5207,[258  25 328   1  11],416,5,21417,4.1123271889400925,0.0,0.0
15208,1,5208,[ 71 215 100 238 588],43,4,21421,4.112305624880015,0.0,0.0
15209,1,5209,[127 161 300 357 222],198,2,21423,4.11190019193858,0.0,0.0
15210,1,5210,[185 211 748 294 678],297,2,21425,4.111494914603723,0.0,0.0
15211,1,5211,[210 357  88 175 153],373,4,21429,4.111473522640061,0.0,0.0
15212,1,5212,[597 258 546 475  12],417,3,21432,4.1112603107615575,20.0,0.0
15213,1,5213,[ 64  12 483 427  11],618,5,21437,4.111430763329498,60.0,0.0
15214,1,5214,[215 200  50 111 168],711,3,21440,4.111217641418984,0.0,20.0
15215,1,5215,[300 742 435  11  22],297,2,21442,4.110812883435583,0.0,0.0
15216,1,5216,[ 64  12 483 427  11],214,5,21447,4.110983323749281,60.0,0.0
15217,1,5217,[185  71 238  11 210],262,3,21450,4.110770410118819,0.0,0.0
15218,1,5218,[268 215 323  15 179],721,4,21454,4.1107491856677525,0.0,0.0
15219,1,5219,[597 202 328 403 111],416,4,21458,4.110727969348659,0.0,0.0
15220,1,5220,[289 302 245 322 323],126,1,21459,4.110132158590308,0.0,0.0
15221,1,5221,[245  71 385 258 515],416,4,21463,4.110111068556109,0.0,0.0
15222,1,5222,[ 64  12 483 427  11],214,5,21468,4.110281447443998,60.0,0.0
15223,1,5223,[ 64  12 483 427  11],214,5,21473,4.1104517611026035,60.0,0.0
15224,1,5224,[118 168  70 496 328],43,5,21478,4.110622009569378,0.0,0.0
15225,1,5225,[ 64  12 483 427  11],214,5,21483,4.110792192881745,60.0,0.0
15226,1,5226,[ 64  12 483 427  11],618,5,21488,4.1109623110771,60.0,0.0
15227,1,5227,[168 117 215 423 172],43,5,21493,4.111132364192808,0.0,0.0
15228,1,5228,[ 64  12 483 427  11],618,5,21498,4.1113023522662075,60.0,0.0
15229,1,5229,[ 64  12 483 427  11],214,5,21503,4.1114722753346085,60.0,0.0
15230,1,5230,[ 25  28  98 588 202],764,4,21507,4.111450965398586,0.0,20.0
15231,1,5231,[ 64  12 483 427  11],618,5,21512,4.111620795107034,60.0,0.0
15232,1,5232,[427 265  95  96  79],618,3,21515,4.11140836995987,0.0,0.0
15233,1,5233,[132 143 186 318 215],588,5,21520,4.111578142911731,20.0,0.0
15234,1,5234,[195 483 301 197 435],437,2,21522,4.111174785100286,20.0,0.0
15235,1,5235,[174 294 161 235 238],417,2,21524,4.110771581359817,0.0,0.0
15236,1,5236,[ 64  12 483 427  11],618,5,21529,4.1109413786519,60.0,0.0
15237,1,5237,[ 64  12 483 427  11],214,5,21534,4.111111111111111,60.0,0.0
15238,1,5238,[ 96 196  50 153 300],751,4,21538,4.111089902653178,0.0,20.0
15239,1,5239,[ 64  12 483 427  11],214,5,21543,4.111259541984733,60.0,0.0
15240,1,5240,[ 64  12 483 427  11],618,5,21548,4.111429116580805,60.0,0.0
15241,1,5241,[182 118 228 568 179],417,3,21551,4.111217092712705,0.0,0.0
15242,1,5242,[568 117  89 257   1],62,2,21553,4.110814419225634,0.0,0.0
15243,1,5243,[ 64  12 483 427  11],618,5,21558,4.110983981693364,60.0,0.0
15244,1,5244,[ 64  12 483 427  11],618,5,21563,4.111153479504289,60.0,0.0
15245,1,5245,[ 64  12 483 427  11],214,5,21568,4.111322912695387,60.0,0.0
15246,1,5246,[ 64  12 483 427  11],618,5,21573,4.111492281303602,60.0,0.0
15247,1,5247,[ 64  12 483 427  11],618,5,21578,4.111661585365853,60.0,0.0
15248,1,5248,[427  96 183 168 294],887,4,21582,4.111640312440465,0.0,0.0
15249,1,5249,[ 12 200 195 176  95],297,2,21584,4.111238095238095,20.0,0.0
15250,1,5250,[ 64  12 483 427  11],214,5,21589,4.111407350980765,60.0,0.0
15251,1,5251,[275 153  82  50 282],416,5,21594,4.111576542269612,0.0,20.0
15252,1,5252,[ 64  12 483 427  11],214,5,21599,4.111745669141443,60.0,0.0
15253,1,5253,[118  96 174 197 187],618,2,21601,4.111343738104302,0.0,0.0
15254,1,5254,[216 322 111 568 117],417,1,21602,4.110751665080875,0.0,0.0
15255,1,5255,[234 191 742  64 318],416,5,21607,4.110920852359208,40.0,0.0
15256,1,5256,[ 64  12 483 427  11],618,5,21612,4.111089975271067,60.0,0.0
15257,1,5257,[185 300 187 328 211],416,5,21617,4.111259033853176,0.0,0.0
15258,1,5258,[ 64  12 483 427  11],618,5,21622,4.111428028142233,60.0,0.0
15259,1,5259,[ 64  12 483 427  11],618,5,21627,4.111596958174905,60.0,0.0
15260,1,5260,[ 64  12 483 427  11],618,5,21632,4.111765823987835,60.0,0.0
15261,1,5261,[ 64  12 483 427  11],618,5,21637,4.111934625617636,60.0,0.0
15262,1,5262,[ 64  12 483 427  11],214,5,21642,4.112103363100893,60.0,0.0
15263,1,5263,[235 323 204 216 161],805,1,21643,4.111512158054711,0.0,0.0
15264,1,5264,[195 288 132 181 302],62,3,21646,4.111301044634378,0.0,40.0
15265,1,5265,[ 64  12 483 427  11],214,5,21651,4.111469806304595,60.0,0.0
15266,1,5266,[ 64  12 483 427  11],618,5,21656,4.111638503892158,60.0,0.0
15267,1,5267,[ 64  12 483 427  11],618,5,21661,4.111807137433561,60.0,0.0
15268,1,5268,[ 64  12 483 427  11],214,5,21666,4.111975706965269,60.0,0.0
15269,1,5269,[471  56 546 215 197],297,1,21667,4.111385199240987,0.0,0.0
15270,1,5270,[ 22 257   9   7 204],887,4,21671,4.111364067539366,0.0,0.0
15271,1,5271,[ 64  12 483 427  11],618,5,21676,4.111532625189682,60.0,0.0
15272,1,5272,[ 64  12 483 427  11],618,5,21681,4.111701118907643,60.0,0.0
15273,1,5273,[121 180  82 143 258],128,4,21685,4.111679939324991,0.0,0.0
15274,1,5274,[ 64  12 483 427  11],214,5,21690,4.1118483412322275,60.0,0.0
15275,1,5275,[288 405  79 181 508],654,2,21692,4.11144806671721,0.0,40.0
15276,1,5276,[161 258 204 121 286],345,2,21694,4.111047943907523,0.0,0.0
15277,1,5277,[ 64  12 483 427  11],214,5,21699,4.111216369837059,60.0,0.0
15278,1,5278,[237 180  15 121  12],62,3,21702,4.111005872324304,20.0,0.0
15279,1,5279,[357  82   4 748 197],805,2,21704,4.11060606060606,0.0,0.0
15280,1,5280,[100 228 202 216 357],417,2,21706,4.110206400302973,0.0,0.0
15281,1,5281,[121 197 269 174 196],805,2,21708,4.109806891329042,0.0,0.0
15282,1,5282,[ 64  12 483 427  11],618,5,21713,4.10997539276926,60.0,0.0
15283,1,5283,[ 64  12 483 427  11],214,5,21718,4.1101438304314915,60.0,0.0
15284,1,5284,[194  97 245 748 235],416,3,21721,4.109933774834437,0.0,0.0
15285,1,5285,[ 64  12 483 427  11],618,5,21726,4.110102156640181,60.0,0.0
15286,1,5286,[200 100  56 168 323],198,3,21729,4.109892188386609,0.0,0.0
15287,1,5287,[273 135 475 318  69],62,5,21734,4.110060514372163,20.0,0.0
15288,1,5288,[100  25 143  56  50],43,5,21739,4.110228776706371,0.0,20.0
15289,1,5289,[ 64  12 483 427  11],214,5,21744,4.1103969754253304,60.0,0.0
15290,1,5290,[ 64  12 483 427  11],618,5,21749,4.11056511056511,60.0,0.0
15291,1,5291,[ 64  12 483 427  11],214,5,21754,4.110733182161754,60.0,0.0
15292,1,5292,[265 204 496   8 196],618,3,21757,4.110523332703571,0.0,0.0
15293,1,5293,[269  98 187  22 678],416,4,21761,4.110502455610125,0.0,20.0
15294,1,5294,[ 64  12 483 427  11],618,5,21766,4.11067044381492,60.0,0.0
15295,1,5295,[237 427 125  50 211],230,5,21771,4.11083836858006,0.0,20.0
15296,1,5296,[ 56 288  15 197  82],721,3,21774,4.110628657730791,0.0,20.0
15297,1,5297,[ 25 483  98 174 196],354,2,21776,4.110230275575689,20.0,20.0
15298,1,5298,[268 333 471 161 181],721,4,21780,4.110209473485563,0.0,20.0
15299,1,5299,[ 64  12 483 427  11],618,5,21785,4.110377358490566,60.0,0.0
15300,1,5300,[237 210  79 179 288],437,3,21788,4.110167892850406,0.0,20.0
15301,1,5301,[204 186 471   1   8],43,3,21791,4.109958506224066,0.0,0.0
15302,1,5302,[ 64  12 483 427  11],618,5,21796,4.110126343579106,60.0,0.0
15303,1,5303,[180 508 111 132 323],417,2,21798,4.10972850678733,0.0,0.0
15304,1,5304,[ 64  12 483 427  11],214,5,21803,4.109896324222432,60.0,0.0
15305,1,5305,[403 179 132 323 273],416,3,21806,4.10968714662646,0.0,0.0
15306,1,5306,[ 64  12 483 427  11],214,5,21811,4.109854908611268,60.0,0.0
15307,1,5307,[ 64  12 483 427  11],618,5,21816,4.110022607385079,60.0,0.0
15308,1,5308,[ 64  12 483 427  11],214,5,21821,4.110190242983613,60.0,0.0
15309,1,5309,[357 135 118  97   4],62,3,21824,4.109981167608287,0.0,0.0
15310,1,5310,[ 64  12 483 427  11],214,5,21829,4.110148747881754,60.0,0.0
15311,1,5311,[265 275 546 216  15],416,4,21833,4.110128012048193,0.0,0.0
15312,1,5312,[ 64  12 483 427  11],214,5,21838,4.1102955015998495,60.0,0.0
15313,1,5313,[257   7 237 286 144],62,1,21839,4.10971019947309,0.0,0.0
15314,1,5314,[ 64  12 483 427  11],214,5,21844,4.109877704609596,60.0,0.0
15315,1,5315,[471   8 276 204   1],43,4,21848,4.109857035364936,0.0,0.0
15316,1,5316,[568 238 191  25 144],618,3,21851,4.109648297912357,0.0,0.0
15317,1,5317,[257 216 475 173   7],62,4,21855,4.109627679578789,0.0,0.0
15318,1,5318,[179 125  56 496 200],416,4,21859,4.109607068997932,0.0,0.0
15319,1,5319,[423  15   1  79 111],417,3,21862,4.109398496240601,0.0,0.0
15320,1,5320,[ 64  12 483 427  11],214,5,21867,4.109565871076866,60.0,0.0
15321,1,5321,[427 195 153  98  56],416,5,21872,4.109733183013905,0.0,20.0
15322,1,5322,[ 64  12 483 427  11],618,5,21877,4.109900432087169,60.0,0.0
15323,1,5323,[300  50 678 603 302],297,3,21880,4.10969196093163,0.0,20.0
15324,1,5324,[ 64  12 483 427  11],618,5,21885,4.109859154929578,60.0,0.0
15325,1,5325,[ 64  12 483 427  11],618,5,21890,4.110026286143447,60.0,0.0
15326,1,5326,[ 64  12 483 427  11],618,5,21895,4.110193354608597,60.0,0.0
15327,1,5327,[245   7 588 515  50],297,4,21899,4.110172672672673,0.0,20.0
15328,1,5328,[655  64 187 153 173],373,4,21903,4.110151998498781,20.0,0.0
15329,1,5329,[ 64  12 483 427  11],618,5,21908,4.110318949343339,60.0,0.0
15330,1,5330,[273 186 234  70   7],417,3,21911,4.110110673419621,0.0,0.0
15331,1,5331,[ 64  12 483 427  11],214,5,21916,4.110277569392348,60.0,0.0
15332,1,5332,[568 265 275  96 117],618,3,21919,4.110069379336209,0.0,0.0
15333,1,5333,[ 64  12 483 427  11],214,5,21924,4.110236220472441,60.0,0.0
15334,1,5334,[403   7  50  96 289],49,2,21926,4.109840674789129,0.0,20.0
15335,1,5335,[273 588 187 385  98],618,5,21931,4.110007496251874,0.0,20.0
15336,1,5336,[191 125 318 302 194],854,2,21933,4.1096121416526135,20.0,0.0
15337,1,5337,[ 64  12 483 427  11],214,5,21938,4.109778943424503,60.0,0.0
15338,1,5338,[678 191 161 100 185],416,4,21942,4.109758381719423,0.0,0.0
15339,1,5339,[ 64  12 483 427  11],214,5,21947,4.109925093632959,60.0,0.0
15340,1,5340,[187 742 121  64 210],416,5,21952,4.110091743119266,20.0,0.0
15341,1,5341,[ 64  12 483 427  11],214,5,21957,4.110258330213403,60.0,0.0
15342,1,5342,[ 64  12 483 427  11],618,5,21962,4.110424854950402,60.0,0.0
15343,1,5343,[ 64  12 483 427  11],214,5,21967,4.1105913173652695,60.0,0.0
15344,1,5344,[125 423 195 302 328],62,2,21969,4.1101964452759585,0.0,0.0
15345,1,5345,[  8 186 132 275 258],854,4,21973,4.110175832398054,0.0,0.0
15346,1,5346,[ 64  12 483 427  11],214,5,21978,4.110342247989527,60.0,0.0
15347,1,5347,[ 64  12 483 427  11],618,5,21983,4.1105086013462975,60.0,0.0
15348,1,5348,[ 64  12 483 427  11],214,5,21988,4.110674892503272,60.0,0.0
15349,1,5349,[ 64  12 483 427  11],214,5,21993,4.110841121495327,60.0,0.0
15350,1,5350,[ 64  12 483 427  11],214,5,21998,4.1110072883573165,60.0,0.0
15351,1,5351,[ 98 153 322 302  97],417,3,22001,4.1107997010463375,0.0,20.0
15352,1,5352,[100 568 405  56 153],230,3,22004,4.110592191294601,0.0,0.0
15353,1,5353,[ 64  12 483 427  11],214,5,22009,4.110758311542772,60.0,0.0
15354,1,5354,[748  88 405 385  98],416,4,22013,4.110737628384687,0.0,20.0
15355,1,5355,[257  50 245 216 173],62,3,22016,4.110530246452576,0.0,20.0
15356,1,5356,[ 64  12 483 427  11],618,5,22021,4.1106962852342726,60.0,0.0
15357,1,5357,[197  96 269 222 186],854,3,22024,4.110488988428518,0.0,0.0
15358,1,5358,[151  50  98 245 235],297,2,22026,4.110095167008771,0.0,40.0
15359,1,5359,[ 64  12 483 427  11],618,5,22031,4.11026119402985,60.0,0.0
15360,1,5360,[ 64  12 483 427  11],618,5,22036,4.110427159112106,60.0,0.0
15361,1,5361,[265  79 275 222 117],588,3,22039,4.110220067139127,0.0,0.0
15362,1,5362,[ 64  12 483 427  11],618,5,22044,4.11038597799739,60.0,0.0
15363,1,5363,[ 64  12 483 427  11],214,5,22049,4.11055182699478,60.0,0.0
15364,1,5364,[ 95 257  12 471 385],416,3,22052,4.110344827586207,20.0,0.0
15365,1,5365,[  1 216 204  12 238],805,3,22055,4.110137905329855,20.0,0.0
15366,1,5366,[132 742  25 515 195],230,3,22058,4.109931060182597,0.0,0.0
15367,1,5367,[215 173 403 294 288],588,4,22062,4.109910581222056,0.0,20.0
15368,1,5368,[294 273 597  88 176],805,1,22063,4.1093313466194825,0.0,0.0
15369,1,5369,[ 64  12 483 427  11],618,5,22068,4.109497206703911,60.0,0.0
15370,1,5370,[ 64  12 483 427  11],618,5,22073,4.109663005026997,60.0,0.0
15371,1,5371,[196 357 257 176 258],62,4,22077,4.1096425912137,0.0,0.0
15372,1,5372,[ 64  12 483 427  11],618,5,22082,4.109808300763075,60.0,0.0
15373,1,5373,[ 64  12 483 427  11],214,5,22087,4.109973948641608,60.0,0.0
15374,1,5374,[168 186  25 117 742],230,4,22091,4.109953488372093,0.0,0.0
15375,1,5375,[323   7  82  70 182],198,2,22093,4.109561011904762,0.0,0.0
15376,1,5376,[186 238   9 318 191],43,3,22096,4.109354658731634,20.0,0.0
15377,1,5377,[ 64  12 483 427  11],618,5,22101,4.109520267757531,60.0,0.0
15378,1,5378,[ 64  12 483 427  11],214,5,22106,4.109685815207287,60.0,0.0
15379,1,5379,[ 64  12 483 427  11],618,5,22111,4.109851301115242,60.0,0.0
15380,1,5380,[403  69  15 742  95],588,3,22114,4.109645047388961,0.0,0.0
15381,1,5381,[125 423 117 265  97],230,5,22119,4.109810479375697,0.0,0.0
15382,1,5382,[ 64  12 483 427  11],214,5,22124,4.109975849897826,60.0,0.0
15383,1,5383,[194 588 237 265 403],416,4,22128,4.109955423476968,0.0,0.0
15384,1,5384,[ 64  12 483 427  11],618,5,22133,4.110120705663881,60.0,0.0
15385,1,5385,[ 64  12 483 427  11],214,5,22138,4.110285926476049,60.0,0.0
15386,1,5386,[ 64  12 483 427  11],618,5,22143,4.110451085947652,60.0,0.0
15387,1,5387,[ 64  12 483 427  11],214,5,22148,4.1106161841128435,60.0,0.0
15388,1,5388,[ 64  12 483 427  11],214,5,22153,4.110781221005753,60.0,0.0
15389,1,5389,[ 11  97 273 161 257],417,2,22155,4.1103896103896105,0.0,0.0
15390,1,5390,[475 173 234 151 121],588,4,22159,4.110369133741421,0.0,0.0
15391,1,5391,[ 64  12 483 427  11],214,5,22164,4.11053412462908,60.0,0.0
15392,1,5392,[ 64  12 483 427  11],214,5,22169,4.110699054329687,60.0,0.0
15393,1,5393,[ 64  12 483 427  11],618,5,22174,4.110863922877271,60.0,0.0
15394,1,5394,[ 64  12 483 427  11],618,5,22179,4.111028730305839,60.0,0.0
15395,1,5395,[132  12 179 405 197],416,4,22183,4.111008154188288,20.0,0.0
15396,1,5396,[151 127 118 183 168],601,3,22186,4.110802297572725,0.0,0.0
15397,1,5397,[288 118 235 475 282],907,4,22190,4.110781771026306,0.0,20.0
15398,1,5398,[ 71 258 215 568 294],416,5,22195,4.110946471568809,0.0,0.0
15399,1,5399,[153 238 143 546  28],43,4,22199,4.110925925925926,0.0,0.0
15400,1,5400,[301  12 245 258 678],416,3,22202,4.110720236993149,20.0,0.0
15401,1,5401,[ 12 127 161 215 200],405,3,22205,4.110514624213255,20.0,0.0
15402,1,5402,[496 427 172 100 216],214,4,22209,4.110494169905608,0.0,0.0
15403,1,5403,[ 64  12 483 427  11],618,5,22214,4.110658771280533,60.0,0.0
15404,1,5404,[546 678  97 174 197],297,2,22216,4.110268270120259,0.0,0.0
15405,1,5405,[ 64  12 483 427  11],214,5,22221,4.1104328523862375,60.0,0.0
15406,1,5406,[357  28  69 257 153],642,3,22224,4.1102274828925465,0.0,0.0
15407,1,5407,[181 268 322  28  56],128,2,22226,4.109837278106509,0.0,20.0
15408,1,5408,[ 64  12 483 427  11],214,5,22231,4.110001848770567,60.0,0.0
15409,1,5409,[161 183 228  95 603],405,0,22231,4.10924214417745,0.0,0.0
15410,1,5410,[403 174 186 182 211],405,3,22234,4.109037146553318,0.0,0.0
15411,1,5411,[ 64  12 483 427  11],214,5,22239,4.10920177383592,60.0,0.0
15412,1,5412,[ 64  12 483 427  11],618,5,22244,4.10936634029189,60.0,0.0
15413,1,5413,[ 64  12 483 427  11],618,5,22249,4.109530845954931,60.0,0.0
15414,1,5414,[194 235 269 333 427],416,4,22253,4.109510618651893,0.0,0.0
15415,1,5415,[ 70  12 302 185   8],297,5,22258,4.109675036927622,20.0,0.0
15416,1,5416,[ 64  12 483 427  11],618,5,22263,4.1098393944988,60.0,0.0
15417,1,5417,[328 173 176  88 546],416,3,22266,4.1096345514950166,0.0,0.0
15418,1,5418,[117 301 216 211 235],416,4,22270,4.109614319985237,0.0,0.0
15419,1,5419,[197   7  89  11 202],297,3,22273,4.109409594095941,0.0,0.0
15420,1,5420,[175 204 313  97   4],405,3,22276,4.109204943737318,20.0,20.0
15421,1,5421,[ 64  12 483 427  11],618,5,22281,4.109369236444117,60.0,0.0
15422,1,5422,[475 588 300 172 143],416,4,22285,4.109349068781118,0.0,0.0
15423,1,5423,[222 357 181   1 168],297,4,22289,4.109328908554573,0.0,20.0
15424,1,5424,[191  96 211 175 275],698,2,22291,4.1089400921658985,0.0,0.0
15425,1,5425,[568 385 288 276 546],654,3,22294,4.108735716918541,0.0,20.0
15426,1,5426,[204 100 435 288 258],297,2,22296,4.1083471531232725,0.0,20.0
15427,1,5427,[423 194 323 195  56],416,4,22300,4.108327192336035,0.0,0.0
15428,1,5428,[273 235  88 196 742],416,3,22303,4.108123042917664,0.0,0.0
15429,1,5429,[ 64  12 483 427  11],618,5,22308,4.108287292817679,60.0,0.0
15430,1,5430,[111 508 318   1 423],62,2,22310,4.10789909777205,20.0,0.0
15431,1,5431,[204 655 185 132  22],405,5,22315,4.108063328424153,0.0,0.0
15432,1,5432,[ 64  12 483 427  11],618,5,22320,4.108227498619547,60.0,0.0
15433,1,5433,[117 294 273   7 357],416,5,22325,4.108391608391608,0.0,0.0
15434,1,5434,[ 64  12 483 427  11],618,5,22330,4.108555657773689,60.0,0.0
15435,1,5435,[ 64  12 483 427  11],214,5,22335,4.108719646799117,60.0,0.0
15436,1,5436,[655 282 405 678 200],345,3,22338,4.1085157255839615,0.0,0.0
15437,1,5437,[ 25  79 435 496  70],230,4,22342,4.108495770503862,0.0,0.0
15438,1,5438,[603 173 185 117 191],854,4,22346,4.108475822761537,0.0,0.0
15439,1,5439,[ 64  12 483 427  11],618,5,22351,4.108639705882353,60.0,0.0
15440,1,5440,[ 64  12 483 427  11],214,5,22356,4.108803528763095,60.0,0.0
15441,1,5441,[234 238  88 423 265],416,4,22360,4.1087835354649025,0.0,0.0
15442,1,5442,[ 69  82 302 202 234],405,5,22365,4.108947271725151,0.0,0.0
15443,1,5443,[282  71  50  97  88],12,5,22370,4.109110947832476,0.0,20.0
15444,1,5444,[423 202 588 357  70],642,1,22371,4.1085399449035815,0.0,0.0
15445,1,5445,[597  70 216 273 215],416,4,22375,4.10852001468968,0.0,0.0
15446,1,5446,[302 276 597 191 300],43,4,22379,4.108500091793648,0.0,0.0
15447,1,5447,[ 64  12 483 427  11],618,5,22384,4.108663729809105,60.0,0.0
15448,1,5448,[ 64  12 483 427  11],214,5,22389,4.108827307762892,60.0,0.0
15449,1,5449,[ 64  12 483 427  11],618,5,22394,4.108990825688074,60.0,0.0
15450,1,5450,[ 95 215 475 273 125],416,3,22397,4.108787378462668,0.0,0.0
15451,1,5451,[269 496 234 100 216],416,5,22402,4.108950843727072,0.0,0.0
15452,1,5452,[197 100 748 132  98],416,5,22407,4.109114249037227,0.0,20.0
15453,1,5453,[ 70 210 318  15  71],437,2,22409,4.108727539420609,20.0,0.0
15454,1,5454,[282 100  25 118 191],630,1,22410,4.108157653528872,0.0,0.0
15455,1,5455,[237  98 194 301 118],751,3,22413,4.107954545454546,0.0,20.0
15456,1,5456,[ 25 496 318 117  97],373,4,22417,4.107934762690123,20.0,0.0
15457,1,5457,[748 275 294 121  97],416,5,22422,4.108098204470502,0.0,0.0
15458,1,5458,[ 64  12 483 427  11],618,5,22427,4.10826158637113,60.0,0.0
15459,1,5459,[ 64  12 483 427  11],618,5,22432,4.108424908424908,60.0,0.0
15460,1,5460,[180 175 216 144 100],854,3,22435,4.108221937374108,0.0,0.0
15461,1,5461,[286 181  64  15 318],373,4,22439,4.108202123764189,40.0,20.0
15462,1,5462,[ 56 144 597 143  15],654,4,22443,4.108182317408017,0.0,0.0
15463,1,5463,[ 64  12 483 427  11],618,5,22448,4.108345534407028,60.0,0.0
15464,1,5464,[200 179  15 211 174],417,4,22452,4.10832570905764,0.0,0.0
15465,1,5465,[185 515 143 323 603],416,4,22456,4.1083058909623125,0.0,0.0
15466,1,5466,[475 204 117 202 153],805,2,22458,4.1079202487653195,0.0,0.0
15467,1,5467,[111 179 268 183 222],417,3,22461,4.107717629846379,0.0,0.0
15468,1,5468,[ 64  12 483 427  11],618,5,22466,4.107880782592796,60.0,0.0
15469,1,5469,[ 64  12 483 427  11],214,5,22471,4.108043875685557,60.0,0.0
15470,1,5470,[228  50  69 475 151],297,2,22473,4.107658563333943,0.0,20.0
15471,1,5471,[ 64  12 483 427  11],214,5,22478,4.107821637426901,60.0,0.0
15472,1,5472,[288 546  95 143  22],805,0,22478,4.1070710761922165,0.0,20.0
15473,1,5473,[ 97 181 588 111  64],417,2,22480,4.1066861527219585,20.0,20.0
15474,1,5474,[ 64  12 483 427  11],214,5,22485,4.1068493150684935,60.0,0.0
15475,1,5475,[ 64  12 483 427  11],214,5,22490,4.107012417823229,60.0,0.0
15476,1,5476,[ 64  12 483 427  11],214,5,22495,4.107175461018806,60.0,0.0
15477,1,5477,[ 64  12 483 427  11],214,5,22500,4.1073384446878425,60.0,0.0
15478,1,5478,[ 64  12 483 427  11],618,5,22505,4.107501368862931,60.0,0.0
15479,1,5479,[ 64  12 483 427  11],618,5,22510,4.107664233576642,60.0,0.0
15480,1,5480,[144 204 257 181 269],43,5,22515,4.1078270388615215,0.0,20.0
15481,1,5481,[ 64  12 483 427  11],618,5,22520,4.1079897847500915,60.0,0.0
15482,1,5482,[ 64  12 483 427  11],214,5,22525,4.10815247127485,60.0,0.0
15483,1,5483,[ 64  12 483 427  11],618,5,22530,4.108315098468271,60.0,0.0
15484,1,5484,[174  98   8 144 202],297,3,22533,4.108113035551504,0.0,20.0
15485,1,5485,[ 28 181 435 135 100],698,0,22533,4.107364199781261,0.0,20.0
15486,1,5486,[237 135  97  82  56],230,3,22536,4.107162383816293,0.0,0.0
15487,1,5487,[ 64  12 483 427  11],618,5,22541,4.107325072886297,60.0,0.0
15488,1,5488,[  1 323 153 655 405],198,3,22544,4.10712333758426,0.0,0.0
15489,1,5489,[ 64  12 483 427  11],214,5,22549,4.1072859744990895,60.0,0.0
15490,1,5490,[ 64  12 483 427  11],214,5,22554,4.1074485521762885,60.0,0.0
15491,1,5491,[ 64  12 483 427  11],214,5,22559,4.107611070648216,60.0,0.0
15492,1,5492,[181 121 282 265 333],588,5,22564,4.107773529947205,0.0,20.0
15493,1,5493,[ 64  12 483 427  11],618,5,22569,4.10793593010557,60.0,0.0
15494,1,5494,[323 176 172  79 475],417,2,22571,4.107552320291174,0.0,0.0
15495,1,5495,[269 423 471  56  69],297,2,22573,4.10716885007278,0.0,0.0
15496,1,5496,[  7  11 191 202  88],618,4,22577,4.107149354193196,0.0,0.0
15497,1,5497,[678 211 202 268 568],416,4,22581,4.107129865405602,0.0,0.0
15498,1,5498,[ 64  12 483 427  11],214,5,22586,4.107292234951809,60.0,0.0
15499,1,5499,[ 56 568 200  70 197],618,3,22589,4.107090909090909,0.0,0.0
15500,1,5500,[ 64  12 483 427  11],214,5,22594,4.1072532266860575,60.0,0.0
15501,1,5501,[ 64  12 483 427  11],618,5,22599,4.10741548527808,60.0,0.0
15502,1,5502,[ 64  12 483 427  11],214,5,22604,4.107577684899146,60.0,0.0
15503,1,5503,[ 64  12 483 427  11],618,5,22609,4.107739825581396,60.0,0.0
15504,1,5504,[ 64  12 483 427  11],214,5,22614,4.107901907356948,60.0,0.0
15505,1,5505,[ 64  12 483 427  11],618,5,22619,4.1080639302579005,60.0,0.0
15506,1,5506,[197 276 191  50 655],618,3,22622,4.107862720174324,0.0,20.0
15507,1,5507,[ 64  12 483 427  11],618,5,22627,4.1080246913580245,60.0,0.0
15508,1,5508,[ 64  12 483 427  11],214,5,22632,4.108186603739336,60.0,0.0
15509,1,5509,[ 64  12 483 427  11],214,5,22637,4.108348457350273,60.0,0.0
15510,1,5510,[288  64 200 174  50],262,1,22638,4.107784431137724,20.0,40.0
15511,1,5511,[ 64  12 483 427  11],214,5,22643,4.107946298984035,60.0,0.0
15512,1,5512,[ 64  12 483 427  11],214,5,22648,4.108108108108108,60.0,0.0
15513,1,5513,[ 64  12 483 427  11],214,5,22653,4.1082698585418935,60.0,0.0
15514,1,5514,[357 286 405 238 204],62,2,22655,4.107887579329103,0.0,0.0
15515,1,5515,[ 64  12 483 427  11],618,5,22660,4.108049311094996,60.0,0.0
15516,1,5516,[275 111 187 183 385],618,3,22663,4.1078484683704914,0.0,0.0
15517,1,5517,[ 64  12 483 427  11],618,5,22668,4.108010148604567,60.0,0.0
15518,1,5518,[ 64  12 483 427  11],214,5,22673,4.108171770248234,60.0,0.0
15519,1,5519,[237  25 603 187 678],416,3,22676,4.107971014492754,0.0,0.0
15520,1,5520,[405 288 333 268 117],416,5,22681,4.108132584676689,0.0,20.0
15521,1,5521,[117 176 186 161 202],230,5,22686,4.108294096341905,0.0,0.0
15522,1,5522,[210 204  22   1 678],654,5,22691,4.108455549520189,0.0,0.0
15523,1,5523,[196  11 313 301 118],345,4,22695,4.108435916002897,20.0,20.0
15524,1,5524,[127 216 269  64 180],854,4,22699,4.1084162895927605,20.0,0.0
15525,1,5525,[ 64  12 483 427  11],618,5,22704,4.1085776330076005,60.0,0.0
15526,1,5526,[100 111 181 302  11],751,3,22707,4.108377058078523,0.0,20.0
15527,1,5527,[483 196 183 118  69],62,4,22711,4.108357452966715,20.0,0.0
15528,1,5528,[ 64  12 483 427  11],214,5,22716,4.10851871947911,60.0,0.0
15529,1,5529,[  9 385  82 403 210],43,5,22721,4.10867992766727,0.0,0.0
15530,1,5530,[215  25 174 196  97],297,4,22725,4.108660278430664,0.0,0.0
15531,1,5531,[ 64  12 483 427  11],214,5,22730,4.10882140274765,60.0,0.0
15532,1,5532,[ 64  12 483 427  11],618,5,22735,4.108982468823423,60.0,0.0
15533,1,5533,[ 64  12 483 427  11],214,5,22740,4.109143476689556,60.0,0.0
15534,1,5534,[322 546 286 282 423],416,3,22743,4.108943089430895,0.0,0.0
15535,1,5535,[ 64  12 483 427  11],214,5,22748,4.109104046242774,60.0,0.0
15536,1,5536,[200 655 234 423 181],416,5,22753,4.10926494491602,0.0,20.0
15537,1,5537,[183 496 403 168 196],416,5,22758,4.109425785482124,0.0,0.0
15538,1,5538,[  1 603 265 135  97],297,3,22761,4.1092254919660585,0.0,0.0
15539,1,5539,[ 70 210 135  69  12],373,4,22765,4.109205776173285,20.0,0.0
15540,1,5540,[ 79  28 117 197 144],618,4,22769,4.109186067496842,0.0,0.0
15541,1,5541,[ 64  12 483 427  11],214,5,22774,4.109346806207146,60.0,0.0
15542,1,5542,[ 64  12 483 427  11],214,5,22779,4.10950748692044,60.0,0.0
15543,1,5543,[ 64  12 483 427  11],214,5,22784,4.109668109668109,60.0,0.0
15544,1,5544,[111 273 153 742 121],416,5,22789,4.1098286744815145,0.0,0.0
15545,1,5545,[  8 294 475  69 508],24,4,22793,4.109808871258565,0.0,0.0
15546,1,5546,[483 186 328  88 508],128,4,22797,4.109789075175771,20.0,0.0
15547,1,5547,[ 96   1  64 125 427],262,3,22800,4.109589041095891,20.0,0.0
15548,1,5548,[ 64  12 483 427  11],214,5,22805,4.10974950441521,60.0,0.0
15549,1,5549,[ 64  12 483 427  11],214,5,22810,4.10990990990991,60.0,0.0
15550,1,5550,[ 64 187  97 182  88],405,2,22812,4.109529814447847,20.0,0.0
15551,1,5551,[ 64 234 300 318 117],198,2,22814,4.109149855907781,40.0,0.0
15552,1,5552,[ 64  12 483 427  11],618,5,22819,4.109310282730056,60.0,0.0
15553,1,5553,[288 276 597 161 483],618,3,22822,4.109110550954267,20.0,20.0
15554,1,5554,[ 64  12 483 427  11],214,5,22827,4.10927092709271,60.0,0.0
15555,1,5555,[ 64  12 483 427  11],214,5,22832,4.10943124550036,60.0,0.0
15556,1,5556,[ 71 237 268 288 301],416,4,22836,4.109411552996221,0.0,20.0
15557,1,5557,[ 64  12 483 427  11],618,5,22841,4.109571788413098,60.0,0.0
15558,1,5558,[ 82 313  50 235 742],43,4,22845,4.109552077711819,20.0,40.0
15559,1,5559,[ 64  12 483 427  11],214,5,22850,4.109712230215828,60.0,0.0
15560,1,5560,[174 179  64 496  82],416,4,22854,4.109692501348678,20.0,0.0
15561,1,5561,[144  82   8   9  56],43,5,22859,4.10985257101762,0.0,0.0
15562,1,5562,[ 64  12 483 427  11],618,5,22864,4.1100125831385945,60.0,0.0
15563,1,5563,[195  64 748  82   7],417,4,22868,4.10999281092739,20.0,0.0
15564,1,5564,[ 64  12 483 427  11],214,5,22873,4.1101527403414195,60.0,0.0
15565,1,5565,[202 588 302 603 100],751,5,22878,4.110312612288896,0.0,0.0
15566,1,5566,[269   4 268 275   9],416,5,22883,4.11047242680079,0.0,0.0
15567,1,5567,[ 64  12 483 427  11],618,5,22888,4.110632183908046,60.0,0.0
15568,1,5568,[ 64  12 483 427  11],214,5,22893,4.110791883641587,60.0,0.0
15569,1,5569,[ 97 597 100 151 234],588,3,22896,4.1105924596050265,0.0,0.0
15570,1,5570,[257  11  89  79  25],854,3,22899,4.110393107162089,0.0,0.0
15571,1,5571,[ 88 100 196  11 216],43,5,22904,4.110552763819095,0.0,0.0
15572,1,5572,[405 313 197  28 288],345,3,22907,4.110353490041271,20.0,40.0
15573,1,5573,[  4 191 216 289 268],854,1,22908,4.109795479009688,0.0,0.0
15574,1,5574,[ 64  12 483 427  11],214,5,22913,4.109955156950672,60.0,0.0
15575,1,5575,[ 64  12 483 427  11],214,5,22918,4.110114777618365,60.0,0.0
15576,1,5576,[186  12 238  70 202],405,4,22922,4.110095033171956,20.0,0.0
15577,1,5577,[ 64  12 483 427  11],618,5,22927,4.110254571531015,60.0,0.0
15578,1,5578,[ 64  12 483 427  11],214,5,22932,4.110414052697616,60.0,0.0
15579,1,5579,[ 22 111  96 423  69],262,5,22937,4.110573476702509,0.0,0.0
15580,1,5580,[ 95 427 258 194  25],698,1,22938,4.110016126142268,0.0,0.0
15581,1,5581,[ 64  12 483 427  11],214,5,22943,4.110175564313866,60.0,0.0
15582,1,5582,[313 286 117 183 176],416,5,22948,4.110334945369873,20.0,20.0
15583,1,5583,[ 64  12 483 427  11],618,5,22953,4.1104942693409745,60.0,0.0
15584,1,5584,[ 71 183 197 111  69],618,3,22956,4.110295434198747,0.0,0.0
15585,1,5585,[ 64  12 483 427  11],214,5,22961,4.110454708199069,60.0,0.0
15586,1,5586,[301 210  69 215   7],43,5,22966,4.110613925183461,0.0,0.0
15587,1,5587,[588 269  88 271 357],805,2,22968,4.110236220472441,0.0,0.0
15588,1,5588,[ 64  12 483 427  11],618,5,22973,4.110395419574163,60.0,0.0
15589,1,5589,[ 64  12 483 427  11],214,5,22978,4.110554561717352,60.0,0.0
15590,1,5590,[111 195 185  50  15],854,2,22980,4.11017707029154,0.0,20.0
15591,1,5591,[ 64  12 483 427  11],214,5,22985,4.110336194563662,60.0,0.0
15592,1,5592,[ 64  12 483 427  11],618,5,22990,4.110495261934561,60.0,0.0
15593,1,5593,[ 64  12 483 427  11],214,5,22995,4.1106542724347515,60.0,0.0
15594,1,5594,[  4 204 258 153   1],416,5,23000,4.110813226094727,0.0,0.0
15595,1,5595,[ 69 196 143 257 222],654,5,23005,4.11097212294496,0.0,0.0
15596,1,5596,[742 385 288 258 185],805,1,23006,4.110416294443452,0.0,20.0
15597,1,5597,[ 64  12 483 427  11],214,5,23011,4.110575205430511,60.0,0.0
15598,1,5598,[ 64  12 483 427  11],618,5,23016,4.11073405965351,60.0,0.0
15599,1,5599,[ 11 195 176 161 234],805,2,23018,4.110357142857143,0.0,0.0
15600,1,5600,[ 11 496 100  56 257],417,2,23020,4.109980360649884,0.0,0.0
15601,1,5601,[ 64  12 483 427  11],214,5,23025,4.110139235987147,60.0,0.0
15602,1,5602,[ 64  12 483 427  11],618,5,23030,4.1102980546136,60.0,0.0
15603,1,5603,[ 64  12 483 427  11],214,5,23035,4.1104568165596005,60.0,0.0
15604,1,5604,[ 96  82  15 215 597],618,3,23038,4.110258697591436,0.0,0.0
15605,1,5605,[ 64  12 483 427  11],618,5,23043,4.110417409917945,60.0,0.0
15606,1,5606,[ 64  12 483 427  11],214,5,23048,4.110576065632245,60.0,0.0
15607,1,5607,[ 64  12 483 427  11],618,5,23053,4.110734664764622,60.0,0.0
15608,1,5608,[135 471 234 204 269],297,2,23055,4.1103583526475305,0.0,0.0
15609,1,5609,[313 276 496 471 183],416,4,23059,4.110338680926916,20.0,20.0
15610,1,5610,[282 258 161  70 655],345,3,23062,4.110140794867225,0.0,0.0
15611,1,5611,[117 475 168 286 174],588,3,23065,4.1099429793300075,0.0,0.0
15612,1,5612,[ 64  12 483 427  11],618,5,23070,4.110101549973276,60.0,0.0
15613,1,5613,[322 496 204 117 143],416,4,23074,4.1100819380121125,0.0,0.0
15614,1,5614,[ 15  50 118 475   7],854,3,23077,4.109884238646482,0.0,20.0
15615,1,5615,[ 64  12 483 427  11],618,5,23082,4.110042735042735,60.0,0.0
15616,1,5616,[ 64  12 483 427  11],214,5,23087,4.110201175004451,60.0,0.0
15617,1,5617,[ 64  12 483 427  11],214,5,23092,4.110359558561766,60.0,0.0
15618,1,5618,[ 64  12 483 427  11],214,5,23097,4.110517885744795,60.0,0.0
15619,1,5619,[ 64  12 483 427  11],214,5,23102,4.11067615658363,60.0,0.0
15620,1,5620,[655 204 228 181 196],198,2,23104,4.110300658245864,0.0,20.0
15621,1,5621,[282 385 111 183  71],416,5,23109,4.110458911419424,0.0,0.0
15622,1,5622,[ 64  12 483 427  11],214,5,23114,4.110617108305175,60.0,0.0
15623,1,5623,[ 64  12 483 427  11],618,5,23119,4.110775248933144,60.0,0.0
15624,1,5624,[ 64  12 483 427  11],618,5,23124,4.1109333333333336,60.0,0.0
15625,1,5625,[ 25 194   4 405 302],854,1,23125,4.110380376821898,0.0,0.0
15626,1,5626,[ 64  12 483 427  11],214,5,23130,4.1105384752088145,60.0,0.0
15627,1,5627,[271 275 185 508  12],297,4,23134,4.110518834399431,20.0,0.0
15628,1,5628,[385  71 228 127 234],198,1,23135,4.109966246224907,0.0,0.0
15629,1,5629,[ 64  12 483 427  11],214,5,23140,4.110124333925399,60.0,0.0
15630,1,5630,[748 258  12 301 117],416,5,23145,4.110282365476825,20.0,0.0
15631,1,5631,[313  22 385 268 151],588,4,23149,4.110262784090909,20.0,20.0
15632,1,5632,[ 88  96 294 742 187],505,3,23152,4.110065684360022,0.0,0.0
15633,1,5633,[ 96 121 294 471 328],921,4,23156,4.110046148384806,0.0,0.0
15634,1,5634,[204 143 215 228 151],373,4,23160,4.110026619343389,0.0,0.0
15635,1,5635,[172 655  88  15  97],588,3,23163,4.109829666430092,0.0,0.0
15636,1,5636,[ 64  12 483 427  11],214,5,23168,4.1099875820471885,60.0,0.0
15637,1,5637,[ 64  12 483 427  11],618,5,23173,4.110145441645974,60.0,0.0
15638,1,5638,[ 64  12 483 427  11],214,5,23178,4.110303245256251,60.0,0.0
15639,1,5639,[ 22 143 588 235 323],805,1,23179,4.109751773049646,0.0,0.0
15640,1,5640,[185 423 322  79 180],805,2,23181,4.109377769898954,0.0,0.0
15641,1,5641,[ 64  12 483 427  11],618,5,23186,4.109535625664658,60.0,0.0
15642,1,5642,[300 181 174 196 127],198,3,23189,4.109339004075847,0.0,20.0
15643,1,5643,[151 234 202 168 235],642,1,23190,4.1087880935506735,0.0,0.0
15644,1,5644,[ 64  12 483 427  11],214,5,23195,4.108945969884854,60.0,0.0
15645,1,5645,[ 64  12 483 427  11],214,5,23200,4.1091037902940135,60.0,0.0
15646,1,5646,[ 96 742  82   1 475],417,3,23203,4.108907384451921,0.0,0.0
15647,1,5647,[237 117 196 182 294],62,3,23206,4.10871104815864,0.0,0.0
15648,1,5648,[ 64  12 483 427  11],214,5,23211,4.108868826340945,60.0,0.0
15649,1,5649,[300 125   9 234  96],416,5,23216,4.109026548672566,0.0,0.0
15650,1,5650,[ 12 268  56 100 161],417,3,23219,4.108830295522917,20.0,0.0
15651,1,5651,[ 89 655  88 181 222],805,2,23221,4.108457183297948,0.0,20.0
15652,1,5652,[ 64  12 483 427  11],618,5,23226,4.108614894746152,60.0,0.0
15653,1,5653,[ 64  12 483 427  11],214,5,23231,4.108772550406791,60.0,0.0
15654,1,5654,[210 427  69 211 195],230,4,23235,4.108753315649867,0.0,0.0
15655,1,5655,[195 125 222 196  64],417,4,23239,4.108734087694484,20.0,0.0
15656,1,5656,[294 655  15 234 143],588,4,23243,4.108714866537034,0.0,0.0
15657,1,5657,[ 64  12 483 427  11],618,5,23248,4.108872393071757,60.0,0.0
15658,1,5658,[  4   8 143 210  69],43,5,23253,4.109029863933557,0.0,0.0
15659,1,5659,[323 172   7 174 118],43,4,23257,4.109010600706714,0.0,0.0
15660,1,5660,[222 568   4 176 276],62,4,23261,4.108991344285462,0.0,0.0
15661,1,5661,[ 64  12 483 427  11],214,5,23266,4.109148710702931,60.0,0.0
15662,1,5662,[ 95 211 385 496 143],373,3,23269,4.108952851845312,0.0,0.0
15663,1,5663,[180   7 100 318 210],354,2,23271,4.108580508474576,20.0,0.0
15664,1,5664,[197 302 125 258 161],416,5,23276,4.1087378640776695,0.0,0.0
15665,1,5665,[ 64  12 483 427  11],618,5,23281,4.108895164136957,60.0,0.0
15666,1,5666,[ 64  12 483 427  11],214,5,23286,4.109052408681842,60.0,0.0
15667,1,5667,[173 742 195  22 301],416,5,23291,4.109209597741708,0.0,0.0
15668,1,5668,[174 210 257 258 175],354,3,23294,4.109013935438349,0.0,0.0
15669,1,5669,[  8 257 588  89 168],642,4,23298,4.108994708994709,0.0,0.0
15670,1,5670,[ 64  12 483 427  11],618,5,23303,4.109151825074942,60.0,0.0
15671,1,5671,[ 64  12 483 427  11],618,5,23308,4.109308885754584,60.0,0.0
15672,1,5672,[ 64  12 483 427  11],618,5,23313,4.109465891062929,60.0,0.0
15673,1,5673,[222 211 161  12 191],43,5,23318,4.109622841029256,20.0,0.0
15674,1,5674,[ 64  12 483 427  11],214,5,23323,4.109779735682819,60.0,0.0
15675,1,5675,[ 82 300  88 288 475],416,3,23326,4.109584214235377,0.0,20.0
15676,1,5676,[245 322  79 597 286],416,2,23328,4.109212612295226,0.0,0.0
15677,1,5677,[748  71 132 183 179],198,3,23331,4.10901725959845,0.0,0.0
15678,1,5678,[ 64  12 483 427  11],618,5,23336,4.109174150378588,60.0,0.0
15679,1,5679,[168 483  64 210  15],253,4,23340,4.109154929577465,40.0,0.0
15680,1,5680,[268  79 258 318 172],345,5,23345,4.109311740890688,20.0,0.0
15681,1,5681,[302  70 118 385 333],345,2,23347,4.108940513903555,0.0,0.0
15682,1,5682,[257 173 111 132 174],62,3,23350,4.108745380960761,0.0,0.0
15683,1,5683,[ 64  12 483 427  11],618,5,23355,4.10890218156228,60.0,0.0
15684,1,5684,[ 64  12 483 427  11],214,5,23360,4.10905892700088,60.0,0.0
15685,1,5685,[ 64  12 483 427  11],214,5,23365,4.109215617305663,60.0,0.0
15686,1,5686,[ 64  12 483 427  11],618,5,23370,4.109372252505715,60.0,0.0
15687,1,5687,[ 64  12 483 427  11],214,5,23375,4.109528832630098,60.0,0.0
15688,1,5688,[ 11 742   7  25   8],416,5,23380,4.109685357707857,0.0,0.0
15689,1,5689,[ 98 268 655 301   8],416,5,23385,4.109841827768014,0.0,20.0
15690,1,5690,[  9 100 211 153 121],698,0,23385,4.109119662625198,0.0,0.0
15691,1,5691,[183 210 174 179 144],417,2,23387,4.108749121574139,0.0,0.0
15692,1,5692,[483 228 237 191 265],128,4,23391,4.108730019321975,20.0,0.0
15693,1,5693,[ 64  12 483 427  11],618,5,23396,4.108886547242712,60.0,0.0
15694,1,5694,[210 238   1 182 588],416,5,23401,4.109043020193152,0.0,0.0
15695,1,5695,[ 64  12 483 427  11],618,5,23406,4.109199438202247,60.0,0.0
15696,1,5696,[ 64  12 483 427  11],618,5,23411,4.109355801298929,60.0,0.0
15697,1,5697,[ 64  12 483 427  11],618,5,23416,4.109512109512109,60.0,0.0
15698,1,5698,[  4 655 172 322   7],417,1,23417,4.108966485348307,0.0,0.0
15699,1,5699,[  7  56   4 258 200],198,4,23421,4.1089473684210525,0.0,0.0
15700,1,5700,[268 313 125  50 172],907,5,23426,4.109103666023505,20.0,40.0
15701,1,5701,[117 168 286 597  98],854,2,23428,4.108733777621887,0.0,20.0
15702,1,5702,[ 64  12 483 427  11],618,5,23433,4.108890057864282,60.0,0.0
15703,1,5703,[182 748 118   4 185],297,1,23434,4.108345021037868,0.0,0.0
15704,1,5704,[202  22 200 238  79],405,4,23438,4.108326029798422,0.0,0.0
15705,1,5705,[ 64  12 483 427  11],214,5,23443,4.108482299334034,60.0,0.0
15706,1,5706,[ 64  12 483 427  11],618,5,23448,4.108638514105484,60.0,0.0
15707,1,5707,[ 64  12 483 427  11],618,5,23453,4.1087946741415555,60.0,0.0
15708,1,5708,[ 12 161   1 127 210],43,5,23458,4.1089507794710105,20.0,0.0
15709,1,5709,[515 275  56 273 176],297,5,23463,4.109106830122592,0.0,0.0
15710,1,5710,[423 333   1  28 742],588,4,23467,4.109087725442129,0.0,0.0
15711,1,5711,[  1 515   7 238 196],297,4,23471,4.109068627450981,0.0,0.0
15712,1,5712,[216 405 235 172 238],62,4,23475,4.1090495361456325,0.0,0.0
15713,1,5713,[ 64  12 483 427  11],214,5,23480,4.109205460273014,60.0,0.0
15714,1,5714,[748 288 117 742 153],642,3,23483,4.109011373578303,0.0,20.0
15715,1,5715,[182 742 195 748 238],417,4,23487,4.108992302309307,0.0,0.0
15716,1,5716,[ 64  12 483 427  11],618,5,23492,4.109148154626553,60.0,0.0
15717,1,5717,[385 471 181 168 302],416,5,23497,4.10930395243092,0.0,20.0
15718,1,5718,[111 427 144   8  71],618,3,23500,4.109109984262983,0.0,0.0
15719,1,5719,[ 64  12 483 427  11],618,5,23505,4.109265734265734,60.0,0.0
15720,1,5720,[ 64  12 483 427  11],214,5,23510,4.109421429819961,60.0,0.0
15721,1,5721,[ 64  12 483 427  11],214,5,23515,4.109577070954212,60.0,0.0
15722,1,5722,[185 302 289 172 475],416,3,23518,4.109383190634283,0.0,0.0
15723,1,5723,[ 64  12 483 427  11],618,5,23523,4.109538784067086,60.0,0.0
15724,1,5724,[ 64  12 483 427  11],214,5,23528,4.1096943231441045,60.0,0.0
15725,1,5725,[ 64  12 483 427  11],618,5,23533,4.109849807893817,60.0,0.0
15726,1,5726,[ 64  12 483 427  11],214,5,23538,4.110005238344683,60.0,0.0
15727,1,5727,[ 64  12 483 427  11],214,5,23543,4.11016061452514,60.0,0.0
15728,1,5728,[328  56  22 313 151],505,3,23546,4.109966835398848,20.0,20.0
15729,1,5729,[ 89 174 111 328 176],854,1,23547,4.109424083769634,0.0,0.0
15730,1,5730,[655  96 318 228 179],373,4,23551,4.109404990403071,20.0,0.0
15731,1,5731,[ 64  12 483 427  11],618,5,23556,4.109560362875087,60.0,0.0
15732,1,5732,[ 15 301  56 216 174],43,5,23561,4.109715681144253,0.0,0.0
15733,1,5733,[204 508 318 302 655],345,5,23566,4.109870945238925,20.0,0.0
15734,1,5734,[546   7 742  64 405],314,5,23571,4.1100261551874455,20.0,0.0
15735,1,5735,[ 64  12 483 427  11],214,5,23576,4.110181311018131,60.0,0.0
15736,1,5736,[161   1 245 257 211],416,3,23579,4.109987798500959,0.0,0.0
15737,1,5737,[ 28 204 196 515   4],416,5,23584,4.110142906936215,0.0,0.0
15738,1,5738,[ 64  12 483 427  11],618,5,23589,4.110297961317302,60.0,0.0
15739,1,5739,[175 222 196 301  98],43,4,23593,4.1102787456445995,0.0,20.0
15740,1,5740,[ 64  12 483 427  11],214,5,23598,4.110433722348023,60.0,0.0
15741,1,5741,[ 64  12 483 427  11],214,5,23603,4.110588645071403,60.0,0.0
15742,1,5742,[271  89 258 269 228],297,3,23606,4.110395263799408,0.0,0.0
15743,1,5743,[ 64  12 483 427  11],618,5,23611,4.110550139275766,60.0,0.0
15744,1,5744,[151  69 200 318 405],416,4,23615,4.11053089643168,20.0,0.0
15745,1,5745,[ 64  12 483 427  11],618,5,23620,4.110685694396102,60.0,0.0
15746,1,5746,[216 318 228  79 127],405,3,23623,4.110492430833478,20.0,0.0
15747,1,5747,[ 64  12 483 427  11],618,5,23628,4.1106471816283925,60.0,0.0
15748,1,5748,[302 405  28  64 118],416,4,23632,4.110627935293095,20.0,0.0
15749,1,5749,[ 64  12 483 427  11],214,5,23637,4.1107826086956525,60.0,0.0
15750,1,5750,[300  98 275 132 238],128,4,23641,4.11076334550513,0.0,20.0
15751,1,5751,[ 64  12 483 427  11],214,5,23646,4.1109179415855355,60.0,0.0
15752,1,5752,[ 64  12 483 427  11],214,5,23651,4.111072483921432,60.0,0.0
15753,1,5753,[194 179 603 496   7],416,4,23655,4.1110531803962465,0.0,0.0
15754,1,5754,[100 282 228 286 245],297,2,23657,4.110686359687229,0.0,0.0
15755,1,5755,[235  12  11 748 204],805,1,23658,4.110145934676859,20.0,0.0
15756,1,5756,[ 64  12 483 427  11],618,5,23663,4.110300503734584,60.0,0.0
15757,1,5757,[ 64  12 483 427  11],618,5,23668,4.110455019103855,60.0,0.0
15758,1,5758,[ 64  12 483 427  11],618,5,23673,4.110609480812641,60.0,0.0
15759,1,5759,[ 64  12 483 427  11],618,5,23678,4.110763888888889,60.0,0.0
15760,1,5760,[ 64  12 483 427  11],618,5,23683,4.110918243360528,60.0,0.0
15761,1,5761,[100   7   4 185 471],297,3,23686,4.110725442554669,0.0,0.0
15762,1,5762,[ 69   9  25 216 168],618,2,23688,4.110359187922957,0.0,0.0
15763,1,5763,[423 257 237 173   1],223,4,23692,4.110340041637752,0.0,0.0
15764,1,5764,[ 64  12 483 427  11],214,5,23697,4.110494362532524,60.0,0.0
15765,1,5765,[ 64  12 483 427  11],214,5,23702,4.11064862989941,60.0,0.0
15766,1,5766,[200 282  96 597 275],618,2,23704,4.110282642621814,0.0,0.0
15767,1,5767,[ 64  12 483 427  11],214,5,23709,4.110436893203883,60.0,0.0
15768,1,5768,[ 64  12 483 427  11],618,5,23714,4.110591090310279,60.0,0.0
15769,1,5769,[ 64  12 483 427  11],214,5,23719,4.110745233968804,60.0,0.0
15770,1,5770,[200  56 269 435 168],297,3,23722,4.110552763819095,0.0,0.0
15771,1,5771,[ 64  12 483 427  11],618,5,23727,4.110706860706861,60.0,0.0
15772,1,5772,[ 64  12 483 427  11],214,5,23732,4.11086090420925,60.0,0.0
15773,1,5773,[282 235 191 318 286],416,4,23736,4.110841704191202,20.0,0.0
15774,1,5774,[ 64  12 483 427  11],618,5,23741,4.110995670995671,60.0,0.0
15775,1,5775,[ 64  12 483 427  11],618,5,23746,4.111149584487535,60.0,0.0
15776,1,5776,[  7 273  70 100 323],630,3,23749,4.1109572442444176,0.0,0.0
15777,1,5777,[ 64  12 483 427  11],618,5,23754,4.111111111111111,60.0,0.0
15778,1,5778,[ 22 127  97 183 235],62,4,23758,4.111091884409067,0.0,0.0
15779,1,5779,[275 403 238 471 174],416,5,23763,4.111245674740484,0.0,0.0
15780,1,5780,[ 64  12 483 427  11],618,5,23768,4.111399411866459,60.0,0.0
15781,1,5781,[275 318 196 216 357],373,5,23773,4.111553095814597,20.0,0.0
15782,1,5782,[ 11 143 603  71 423],437,3,23776,4.111360885353623,0.0,0.0
15783,1,5783,[ 64  12 483 427  11],214,5,23781,4.111514522821577,60.0,0.0
15784,1,5784,[176 143 132 211 161],405,2,23783,4.111149524632671,0.0,0.0
15785,1,5785,[ 64  12 483 427  11],214,5,23788,4.111303145523678,60.0,0.0
15786,1,5786,[403 191   9 496 588],43,5,23793,4.111456713322966,0.0,0.0
15787,1,5787,[322 546 273  69 100],417,0,23793,4.110746371803732,0.0,0.0
15788,1,5788,[405 175  15  71 182],198,1,23794,4.1102090171014,0.0,0.0
15789,1,5789,[ 64  12 483 427  11],214,5,23799,4.110362694300518,60.0,0.0
15790,1,5790,[ 64  12 483 427  11],618,5,23804,4.110516318425143,60.0,0.0
15791,1,5791,[ 64  12 483 427  11],214,5,23809,4.110669889502763,60.0,0.0
15792,1,5792,[ 64  12 483 427  11],214,5,23814,4.110823407560849,60.0,0.0
15793,1,5793,[ 64  12 483 427  11],214,5,23819,4.110976872626855,60.0,0.0
15794,1,5794,[265 210 237 228 174],128,3,23822,4.110785159620362,0.0,0.0
15795,1,5795,[ 64  12 483 427  11],214,5,23827,4.110938578329883,60.0,0.0
15796,1,5796,[ 64  12 483 427  11],618,5,23832,4.111091944109022,60.0,0.0
15797,1,5797,[ 64  12 483 427  11],214,5,23837,4.111245256985168,60.0,0.0
15798,1,5798,[ 64  12 483 427  11],214,5,23842,4.1113985169856875,60.0,0.0
15799,1,5799,[ 97  22 183  95 568],253,5,23847,4.111551724137931,0.0,0.0
15800,1,5800,[ 64  12 483 427  11],214,5,23852,4.111704878469229,60.0,0.0
15801,1,5801,[655 202  56 100 385],618,4,23856,4.111685625646329,0.0,0.0
15802,1,5802,[100   1   7 403 161],49,2,23858,4.111321730139583,0.0,0.0
15803,1,5803,[ 64  12 483 427  11],214,5,23863,4.111474844934528,60.0,0.0
15804,1,5804,[ 12 174 202 194 328],373,4,23867,4.1114556416882,20.0,0.0
15805,1,5805,[151  11 423 200 289],416,3,23870,4.111264209438512,0.0,0.0
15806,1,5806,[161 405 294 132  98],345,3,23873,4.111072843120372,0.0,20.0
15807,1,5807,[ 64  12 483 427  11],214,5,23878,4.111225895316805,60.0,0.0
15808,1,5808,[  8 435 257 228 508],297,2,23880,4.1108624548115,0.0,0.0
15809,1,5809,[ 64  12 483 427  11],214,5,23885,4.111015490533563,60.0,0.0
15810,1,5810,[286  56 174 496 282],764,5,23890,4.111168473584581,0.0,0.0
15811,1,5811,[ 64  12 483 427  11],618,5,23895,4.111321403991742,60.0,0.0
15812,1,5812,[187 144 210  11 333],416,5,23900,4.111474281782212,0.0,0.0
15813,1,5813,[ 64  12 483 427  11],214,5,23905,4.1116271069831445,60.0,0.0
15814,1,5814,[ 64  12 483 427  11],214,5,23910,4.111779879621668,60.0,0.0
15815,1,5815,[ 64  12 483 427  11],618,5,23915,4.111932599724897,60.0,0.0
15816,1,5816,[ 64  12 483 427  11],618,5,23920,4.112085267319924,60.0,0.0
15817,1,5817,[ 64  12 483 427  11],214,5,23925,4.112237882433826,60.0,0.0
15818,1,5818,[ 64  12 483 427  11],618,5,23930,4.112390445093658,60.0,0.0
15819,1,5819,[ 64  12 483 427  11],618,5,23935,4.11254295532646,60.0,0.0
15820,1,5820,[ 64  12 483 427  11],618,5,23940,4.112695413159251,60.0,0.0
15821,1,5821,[ 95  64  11 742 405],314,5,23945,4.112847818619032,20.0,0.0
15822,1,5822,[ 64  12 483 427  11],618,5,23950,4.113000171732784,60.0,0.0
15823,1,5823,[216 235  12 222  22],854,2,23952,4.112637362637362,20.0,0.0
15824,1,5824,[508  96 191 742 127],854,3,23955,4.112446351931331,0.0,0.0
15825,1,5825,[191 200 176  97 180],24,5,23960,4.112598695502918,0.0,0.0
15826,1,5826,[257 228 151 268 173],417,3,23963,4.112407756993307,0.0,0.0
15827,1,5827,[515 176  89 357 174],698,4,23967,4.11238846945779,0.0,0.0
15828,1,5828,[ 64  12 483 427  11],214,5,23972,4.112540744553097,60.0,0.0
15829,1,5829,[151   8  11 597 210],618,2,23974,4.1121783876500855,0.0,0.0
15830,1,5830,[ 64  12 483 427  11],618,5,23979,4.112330646544332,60.0,0.0
15831,1,5831,[323  79 186 515 288],417,2,23981,4.111968449931413,0.0,20.0
15832,1,5832,[ 64  12 483 427  11],618,5,23986,4.112120692611007,60.0,0.0
15833,1,5833,[483 161 183 191 168],618,5,23991,4.112272883099075,20.0,0.0
15834,1,5834,[ 64  12 483 427  11],618,5,23996,4.1124250214224505,60.0,0.0
15835,1,5835,[ 64  12 483 427  11],214,5,24001,4.112577107607951,60.0,0.0
15836,1,5836,[ 64  12 483 427  11],214,5,24006,4.1127291416823715,60.0,0.0
15837,1,5837,[196 200  15  96 215],12,4,24010,4.112709832134293,0.0,0.0
15838,1,5838,[258 181  25 508  50],354,3,24013,4.112519266997774,0.0,40.0
15839,1,5839,[ 11 301 153   4  96],416,5,24018,4.112671232876712,0.0,0.0
15840,1,5840,[ 64  12 483 427  11],618,5,24023,4.1128231467214516,60.0,0.0
15841,1,5841,[ 56  22  95 111 200],764,5,24028,4.1129750085587125,0.0,0.0
15842,1,5842,[ 64  12 483 427  11],214,5,24033,4.113126818415198,60.0,0.0
15843,1,5843,[ 64  12 483 427  11],618,5,24038,4.11327857631759,60.0,0.0
15844,1,5844,[125 202 515 357  50],416,5,24043,4.1134302822925575,0.0,20.0
15845,1,5845,[ 64  12 483 427  11],618,5,24048,4.113581936366747,60.0,0.0
15846,1,5846,[215 172 742 275  56],588,4,24052,4.113562510689242,0.0,0.0
15847,1,5847,[ 64  12 483 427  11],214,5,24057,4.113714090287278,60.0,0.0
15848,1,5848,[546  22 204   7  95],297,2,24059,4.113352709864934,0.0,0.0
15849,1,5849,[ 64  12 483 427  11],618,5,24064,4.113504273504273,60.0,0.0
15850,1,5850,[ 64  12 483 427  11],214,5,24069,4.11365578533584,60.0,0.0
15851,1,5851,[ 88   8 118  70 117],642,3,24072,4.113465481886535,0.0,0.0
15852,1,5852,[  7 294 748 678 111],805,2,24074,4.113104390910644,0.0,0.0
15853,1,5853,[ 95 258 144 181  89],297,3,24077,4.112914246668944,0.0,20.0
15854,1,5854,[ 64  12 483 427  11],618,5,24082,4.113065755764304,60.0,0.0
15855,1,5855,[286   8 288 173  71],588,5,24087,4.113217213114754,0.0,20.0
15856,1,5856,[ 64  12 483 427  11],214,5,24092,4.113368618746799,60.0,0.0
15857,1,5857,[ 88 588 151 215 276],618,3,24095,4.113178559235234,0.0,0.0
15858,1,5858,[ 64  12 483 427  11],618,5,24100,4.113329919781533,60.0,0.0
15859,1,5859,[ 64  12 483 427  11],618,5,24105,4.113481228668942,60.0,0.0
15860,1,5860,[ 64  12 483 427  11],214,5,24110,4.113632485923904,60.0,0.0
15861,1,5861,[ 71 301 125 742   9],416,5,24115,4.113783691572842,0.0,0.0
15862,1,5862,[135 508  89 302 483],854,4,24119,4.113764284495992,20.0,0.0
15863,1,5863,[172 143  15 313 294],642,5,24124,4.1139154160982265,20.0,20.0
15864,1,5864,[186 200 405 172 210],417,2,24126,4.113554987212276,0.0,0.0
15865,1,5865,[ 96 234 153  70 179],198,3,24129,4.113365155131265,0.0,0.0
15866,1,5866,[ 56  28 121 204 127],62,3,24132,4.113175387762059,0.0,0.0
15867,1,5867,[216 678 282  82 215],588,4,24136,4.113156100886163,0.0,0.0
15868,1,5868,[ 25 117 174  70   9],618,2,24138,4.112796047026751,0.0,0.0
15869,1,5869,[180 196 176 182 127],62,5,24143,4.112947189097104,0.0,0.0
15870,1,5870,[ 12  70 269 603 175],297,5,24148,4.113098279679782,20.0,0.0
15871,1,5871,[ 64  12 483 427  11],214,5,24153,4.11324931880109,60.0,0.0
15872,1,5872,[195 151 288 568 385],805,1,24154,4.1127192235654695,0.0,20.0
15873,1,5873,[ 64  12 483 427  11],214,5,24159,4.112870275791624,60.0,0.0
15874,1,5874,[161   4 153 202 546],417,2,24161,4.112510638297873,0.0,0.0
15875,1,5875,[ 64  12 483 427  11],618,5,24166,4.112661674608577,60.0,0.0
15876,1,5876,[185  12 405 168 204],601,2,24168,4.112302194997448,20.0,0.0
15877,1,5877,[ 64  12 483 427  11],214,5,24173,4.1124532153793805,60.0,0.0
15878,1,5878,[ 64  12 483 427  11],618,5,24178,4.112604184385099,60.0,0.0
15879,1,5879,[508 245 181 179  25],417,2,24180,4.112244897959184,0.0,20.0
15880,1,5880,[475 182 271 742 191],62,3,24183,4.11205577282775,0.0,0.0
15881,1,5881,[ 64  12 483 427  11],214,5,24188,4.112206732403944,60.0,0.0
15882,1,5882,[ 64  12 483 427  11],214,5,24193,4.1123576406595275,60.0,0.0
15883,1,5883,[ 25 204 191 117 403],198,2,24195,4.111998640380693,0.0,0.0
15884,1,5884,[ 64  12 483 427  11],618,5,24200,4.11214953271028,60.0,0.0
15885,1,5885,[333  71  56 173  12],875,4,24204,4.112130479102956,20.0,0.0
15886,1,5886,[ 98 175 546 161 301],49,2,24206,4.1117717003567185,0.0,20.0
15887,1,5887,[475  50 328 483 271],62,3,24209,4.111582880434782,20.0,20.0
15888,1,5888,[ 12  28 200 301 258],416,5,24214,4.111733740872814,20.0,0.0
15889,1,5889,[ 64  12 483 427  11],214,5,24219,4.1118845500848895,60.0,0.0
15890,1,5890,[ 64  12 483 427  11],618,5,24224,4.112035308097097,60.0,0.0
15891,1,5891,[328 161 111 265 216],416,5,24229,4.112186014935506,0.0,0.0
15892,1,5892,[100 357 265 568  82],373,3,24232,4.111997284914305,0.0,0.0
15893,1,5893,[172 127 471 268 151],416,4,24236,4.111978282999661,0.0,0.0
15894,1,5894,[100  50 237 678 204],654,4,24240,4.111959287531807,0.0,20.0
15895,1,5895,[ 64  12 483 427  11],618,5,24245,4.112109905020353,60.0,0.0
15896,1,5896,[435 282 117  50 182],297,2,24247,4.111751738171952,0.0,20.0
15897,1,5897,[ 25 289 100 597 210],887,3,24250,4.1115632417768735,0.0,0.0
15898,1,5898,[423 471 235 168 185],416,4,24254,4.111544329547381,0.0,0.0
15899,1,5899,[ 28  97 173 302 153],721,4,24258,4.111525423728813,0.0,0.0
15900,1,5900,[ 64  12 483 427  11],214,5,24263,4.111675987120827,60.0,0.0
15901,1,5901,[294 143 508  79 204],297,2,24265,4.111318197221281,0.0,0.0
15902,1,5902,[ 64  12 483 427  11],618,5,24270,4.111468744706082,60.0,0.0
15903,1,5903,[100 176 286 357 118],62,3,24273,4.111280487804878,0.0,0.0
15904,1,5904,[179  22 357 215 385],405,3,24276,4.1110922946655375,0.0,0.0
15905,1,5905,[323 271 151  28  22],805,2,24278,4.110734845919404,0.0,0.0
15906,1,5906,[ 64  12 483 427  11],618,5,24283,4.1108853902149995,60.0,0.0
15907,1,5907,[ 64  12 483 427  11],618,5,24288,4.111035883547732,60.0,0.0
15908,1,5908,[237 405  64 245 202],128,3,24291,4.1108478591978335,20.0,0.0
15909,1,5909,[318 135 269 191 204],373,4,24295,4.11082910321489,20.0,0.0
15910,1,5910,[ 64  12 483 427  11],618,5,24300,4.1109795296904075,60.0,0.0
15911,1,5911,[ 64  12 483 427  11],618,5,24305,4.1111299052774015,60.0,0.0
15912,1,5912,[ 71  56  79 172 151],805,4,24309,4.111111111111111,0.0,0.0
15913,1,5913,[ 64  12 483 427  11],618,5,24314,4.1112614135948595,60.0,0.0
15914,1,5914,[185 238 286   9 678],416,4,24318,4.111242603550296,0.0,0.0
15915,1,5915,[  4 204  97 588 603],297,3,24321,4.11105476673428,0.0,0.0
15916,1,5916,[ 64  12 483 427  11],214,5,24326,4.111205002535068,60.0,0.0
15917,1,5917,[182 475 228 357 742],297,2,24328,4.1108482595471445,0.0,0.0
15918,1,5918,[151 508 234   9 357],601,3,24331,4.110660584558202,0.0,0.0
15919,1,5919,[ 95  69 228 172 151],417,2,24333,4.110304054054054,0.0,0.0
15920,1,5920,[257 385 323  64 328],43,4,24337,4.110285424759331,20.0,0.0
15921,1,5921,[ 64  12 483 427  11],618,5,24342,4.110435663627153,60.0,0.0
15922,1,5922,[ 28 475 258  79   4],805,2,24344,4.110079351679892,0.0,0.0
15923,1,5923,[ 64  12 483 427  11],214,5,24349,4.110229574611749,60.0,0.0
15924,1,5924,[173  88 121  28 276],128,5,24354,4.110379746835443,0.0,0.0
15925,1,5925,[ 64  12 483 427  11],214,5,24359,4.110529868376645,60.0,0.0
15926,1,5926,[ 64  12 483 427  11],618,5,24364,4.110679939261009,60.0,0.0
15927,1,5927,[168 597  88  69 496],618,5,24369,4.11082995951417,0.0,0.0
15928,1,5928,[ 64  12 483 427  11],214,5,24374,4.110979929161747,60.0,0.0
15929,1,5929,[ 96 197 238 328 135],854,3,24377,4.11079258010118,0.0,0.0
15930,1,5930,[ 64  12 483 427  11],618,5,24382,4.110942505479683,60.0,0.0
15931,1,5931,[ 64  12 483 427  11],618,5,24387,4.111092380310182,60.0,0.0
15932,1,5932,[176 135  25 197 268],297,4,24391,4.111073655823361,0.0,0.0
15933,1,5933,[ 64  12 483 427  11],618,5,24396,4.111223458038423,60.0,0.0
15934,1,5934,[ 64  12 483 427  11],214,5,24401,4.111373209772536,60.0,0.0
15935,1,5935,[121  79 215 405 588],541,3,24404,4.111185983827493,0.0,0.0
15936,1,5936,[ 70 191   7 237  11],416,4,24408,4.111167256189995,0.0,0.0
15937,1,5937,[143 117 568 475 323],805,2,24410,4.110811721118222,0.0,0.0
15938,1,5938,[ 64  12 483 427  11],214,5,24415,4.110961441320088,60.0,0.0
15939,1,5939,[ 64  12 483 427  11],618,5,24420,4.111111111111111,60.0,0.0
15940,1,5940,[168 568 322 196 655],128,3,24423,4.110924086854065,0.0,0.0
15941,1,5941,[ 64  12 483 427  11],214,5,24428,4.1110737125546954,60.0,0.0
15942,1,5942,[405 234 132 423 144],417,3,24431,4.110886757529867,0.0,0.0
15943,1,5943,[161  70 216 172 182],417,2,24433,4.110531628532974,0.0,0.0
15944,1,5944,[235 153 181 403 265],922,3,24436,4.110344827586207,0.0,20.0
15945,1,5945,[ 64  12 483 427  11],618,5,24441,4.110494450050454,60.0,0.0
15946,1,5946,[ 64  12 483 427  11],214,5,24446,4.110644022196065,60.0,0.0
15947,1,5947,[ 64  12 483 427  11],618,5,24451,4.11079354404842,60.0,0.0
15948,1,5948,[ 64  12 483 427  11],214,5,24456,4.11094301563288,60.0,0.0
15949,1,5949,[ 64  12 483 427  11],214,5,24461,4.11109243697479,60.0,0.0
15950,1,5950,[ 97 143 403 181  88],405,3,24464,4.11090573012939,0.0,20.0
15951,1,5951,[ 64  12 483 427  11],214,5,24469,4.111055107526882,60.0,0.0
15952,1,5952,[ 64  12 483 427  11],618,5,24474,4.111204434738787,60.0,0.0
15953,1,5953,[ 64  12 483 427  11],214,5,24479,4.111353711790393,60.0,0.0
15954,1,5954,[405 191 508  70 322],128,3,24482,4.111167086481948,0.0,0.0
15955,1,5955,[118 282 172 100 121],630,2,24484,4.1108126259234385,0.0,0.0
15956,1,5956,[ 64 318 333 302 678],721,2,24486,4.110458284371328,40.0,0.0
15957,1,5957,[655 168 196 222   4],198,2,24488,4.110104061765693,0.0,0.0
15958,1,5958,[127 546 318 194 151],416,3,24491,4.109917771438161,20.0,0.0
15959,1,5959,[ 64  12 483 427  11],618,5,24496,4.11006711409396,60.0,0.0
15960,1,5960,[ 64  12 483 427  11],214,5,24501,4.110216406643181,60.0,0.0
15961,1,5961,[195 423   8 603  89],854,4,24505,4.11019792016102,0.0,0.0
15962,1,5962,[ 95 143 568   8 288],805,0,24505,4.109508636592319,0.0,20.0
15963,1,5963,[423 111 318 172 405],262,3,24508,4.109322602280349,20.0,0.0
15964,1,5964,[ 64  12 483 427  11],618,5,24513,4.109471919530595,60.0,0.0
15965,1,5965,[143  97  25 204 286],43,5,24518,4.109621186724774,0.0,0.0
15966,1,5966,[135 179  79 185 196],214,4,24522,4.109602815485168,0.0,0.0
15967,1,5967,[222 182 655 117 568],253,4,24526,4.109584450402145,0.0,0.0
15968,1,5968,[168 427 204 118 127],198,3,24529,4.10939855922265,0.0,0.0
15969,1,5969,[211 496  11 403 294],417,4,24533,4.1093802345058625,0.0,0.0
15970,1,5970,[271 588 385 273 748],805,0,24533,4.108692011388377,0.0,0.0
15971,1,5971,[ 64  12 483 427  11],214,5,24538,4.108841259209645,60.0,0.0
15972,1,5972,[ 64  12 483 427  11],618,5,24543,4.1089904570567555,60.0,0.0
15973,1,5973,[ 50 515 302 222 748],297,4,24547,4.108972212922665,0.0,20.0
15974,1,5974,[ 64  12 483 427  11],618,5,24552,4.109121338912134,60.0,0.0
15975,1,5975,[ 64  12 483 427  11],618,5,24557,4.109270414993307,60.0,0.0
15976,1,5976,[288  96  89 182  70],62,3,24560,4.109084825163126,0.0,20.0
15977,1,5977,[  1  50 215 168 175],43,4,24564,4.109066577450652,0.0,20.0
15978,1,5978,[ 64  12 483 427  11],214,5,24569,4.109215587890952,60.0,0.0
15979,1,5979,[496 423 135 144 174],417,1,24570,4.108695652173913,0.0,0.0
15980,1,5980,[282 215   4 403 588],345,2,24572,4.108343086440395,0.0,0.0
15981,1,5981,[ 64  12 483 427  11],214,5,24577,4.108492143095955,60.0,0.0
15982,1,5982,[179  79 176 174 258],417,3,24580,4.10830686946348,0.0,0.0
15983,1,5983,[ 64  12 483 427  11],214,5,24585,4.108455882352941,60.0,0.0
15984,1,5984,[655 323 197 435 318],721,3,24588,4.108270676691729,20.0,0.0
15985,1,5985,[183 265 268 245  97],417,4,24592,4.108252589375208,0.0,0.0
15986,1,5986,[ 64  12 483 427  11],214,5,24597,4.108401536662769,60.0,0.0
15987,1,5987,[118 153 475 275 269],297,4,24601,4.108383433533734,0.0,0.0
15988,1,5988,[ 64  12 483 427  11],214,5,24606,4.108532309233595,60.0,0.0
15989,1,5989,[ 64  12 483 427  11],214,5,24611,4.108681135225376,60.0,0.0
15990,1,5990,[180 403 245  25  82],417,4,24615,4.108662994491738,0.0,0.0
15991,1,5991,[ 56 132  71 300 238],416,5,24620,4.108811748998665,0.0,0.0
15992,1,5992,[ 64  12 483 427  11],618,5,24625,4.10896045386284,60.0,0.0
15993,1,5993,[ 64  12 483 427  11],214,5,24630,4.109109109109109,60.0,0.0
15994,1,5994,[ 22 235 286 245  64],62,3,24633,4.1089241034195165,20.0,0.0
15995,1,5995,[ 64  12 483 427  11],618,5,24638,4.109072715143429,60.0,0.0
15996,1,5996,[180 143 471 210 276],128,5,24643,4.109221277305319,0.0,0.0
15997,1,5997,[588   4 186 181 385],405,3,24646,4.109036345448483,0.0,20.0
15998,1,5998,[318 222 173 265 117],588,4,24650,4.1090181696949495,20.0,0.0
15999,1,5999,[168   9  79  97 235],43,4,24654,4.109,0.0,0.0
16000,1,6000,[ 88 313 258 180  22],711,5,24659,4.109148475254124,20.0,20.0
16001,1,6001,[ 64  12 483 427  11],618,5,24664,4.109296901032989,60.0,0.0
16002,1,6002,[ 64  12 483 427  11],618,5,24669,4.10944527736132,60.0,0.0
16003,1,6003,[222 234 294  79  95],588,4,24673,4.1094270486342435,0.0,0.0
16004,1,6004,[132 427 183  98 405],230,4,24677,4.109408825978352,0.0,20.0
16005,1,6005,[ 64  12 483 427  11],618,5,24682,4.10955710955711,60.0,0.0
16006,1,6006,[ 64  12 483 427  11],618,5,24687,4.109705343765607,60.0,0.0
16007,1,6007,[ 64  12 483 427  11],618,5,24692,4.109853528628495,60.0,0.0
16008,1,6008,[ 64  12 483 427  11],618,5,24697,4.110001664170411,60.0,0.0
16009,1,6009,[161 216 121 282 294],314,4,24701,4.1099833610648915,0.0,0.0
16010,1,6010,[ 64  12 483 427  11],618,5,24706,4.110131425719514,60.0,0.0
16011,1,6011,[ 64  12 483 427  11],618,5,24711,4.110279441117765,60.0,0.0
16012,1,6012,[ 56 235 132   4 215],345,4,24715,4.110261100947946,0.0,0.0
16013,1,6013,[748 168 117 238 302],751,3,24718,4.110076488194213,0.0,0.0
16014,1,6014,[678 185 173 197 269],416,4,24722,4.110058187863674,0.0,0.0
16015,1,6015,[100 237 111 678  12],297,3,24725,4.109873670212766,20.0,0.0
16016,1,6016,[748  82 294  15 117],642,5,24730,4.110021605451221,0.0,0.0
16017,1,6017,[ 64  12 483 427  11],618,5,24735,4.110169491525424,60.0,0.0
16018,1,6018,[ 64  12 483 427  11],214,5,24740,4.110317328459877,60.0,0.0
16019,1,6019,[  4 195  71 597   1],416,4,24744,4.110299003322259,0.0,0.0
16020,1,6020,[ 64  12 483 427  11],214,5,24749,4.110446769639594,60.0,0.0
16021,1,6021,[ 64  12 483 427  11],618,5,24754,4.110594486881435,60.0,0.0
16022,1,6022,[273 202 742  71 118],805,0,24754,4.109912003984725,0.0,0.0
16023,1,6023,[ 64  12 483 427  11],214,5,24759,4.110059760956175,60.0,0.0
16024,1,6024,[ 64  12 483 427  11],214,5,24764,4.110207468879668,60.0,0.0
16025,1,6025,[403 228 568 515 185],417,2,24766,4.109857285097909,0.0,0.0
16026,1,6026,[ 64  12 483 427  11],618,5,24771,4.110004977600797,60.0,0.0
16027,1,6027,[ 64  12 483 427  11],214,5,24776,4.110152621101526,60.0,0.0
16028,1,6028,[403 210 603 228 125],373,4,24780,4.11013435063858,0.0,0.0
16029,1,6029,[ 64 182 237  98 265],198,3,24783,4.109950248756219,20.0,20.0
16030,1,6030,[ 64  12 483 427  11],618,5,24788,4.110097827889239,60.0,0.0
16031,1,6031,[174 195 216 228 132],198,3,24791,4.109913793103448,0.0,0.0
16032,1,6032,[271 100 423 185 678],805,3,24794,4.109729819327034,0.0,0.0
16033,1,6033,[ 64  12 483 427  11],214,5,24799,4.1098773616175,60.0,0.0
16034,1,6034,[ 64  12 483 427  11],214,5,24804,4.110024855012427,60.0,0.0
16035,1,6035,[ 64  12 483 427  11],214,5,24809,4.110172299536116,60.0,0.0
16036,1,6036,[ 64  12 483 427  11],618,5,24814,4.110319695212854,60.0,0.0
16037,1,6037,[125 197 603 258 216],416,5,24819,4.11046704206691,0.0,0.0
16038,1,6038,[ 64  12 483 427  11],214,5,24824,4.110614340122537,60.0,0.0
16039,1,6039,[117 742  98 237 144],751,3,24827,4.110430463576159,0.0,20.0
16040,1,6040,[ 64  12 483 427  11],214,5,24832,4.110577718920709,60.0,0.0
16041,1,6041,[ 64  12 483 427  11],214,5,24837,4.1107249255213505,60.0,0.0
16042,1,6042,[ 70 238 216 235 125],417,3,24840,4.110541121959292,0.0,0.0
16043,1,6043,[194 313  95 172  88],751,4,24844,4.110522832561218,20.0,20.0
16044,1,6044,[197 175 191 187 313],405,4,24848,4.110504549214227,20.0,20.0
16045,1,6045,[ 64  12 483 427  11],618,5,24853,4.110651670525968,60.0,0.0
16046,1,6046,[ 82 181  64 210 111],62,4,24857,4.110633371919961,20.0,20.0
16047,1,6047,[318 121 200 603  96],416,5,24862,4.110780423280423,20.0,0.0
16048,1,6048,[678  95 588 405 318],654,5,24867,4.1109274260208295,20.0,0.0
16049,1,6049,[ 64  12 483 427  11],214,5,24872,4.111074380165289,60.0,0.0
16050,1,6050,[111 301 100 286 174],43,5,24877,4.111221285737894,0.0,0.0
16051,1,6051,[603 302 275  50 176],854,3,24880,4.111037673496365,0.0,20.0
16052,1,6052,[144 322 175 475 235],805,2,24882,4.110688914587808,0.0,0.0
16053,1,6053,[ 64  12 483 427  11],618,5,24887,4.110835811034027,60.0,0.0
16054,1,6054,[ 64  12 483 427  11],214,5,24892,4.1109826589595375,60.0,0.0
16055,1,6055,[  1 127 186  22 318],618,5,24897,4.111129458388375,20.0,0.0
16056,1,6056,[ 64  12 483 427  11],214,5,24902,4.11127620934456,60.0,0.0
16057,1,6057,[ 64  12 483 427  11],214,5,24907,4.111422911852096,60.0,0.0
16058,1,6058,[ 64  12 483 427  11],618,5,24912,4.111569565934973,60.0,0.0
16059,1,6059,[ 64  12 483 427  11],618,5,24917,4.111716171617162,60.0,0.0
16060,1,6060,[678 427 268 301 176],416,4,24921,4.111697739646923,0.0,0.0
16061,1,6061,[ 64  12 483 427  11],618,5,24926,4.111844275816562,60.0,0.0
16062,1,6062,[427 176  69 568  82],416,5,24931,4.111990763648359,0.0,0.0
16063,1,6063,[268  97 742  28  25],588,4,24935,4.111972295514512,0.0,0.0
16064,1,6064,[ 64  12 483 427  11],618,5,24940,4.112118713932399,60.0,0.0
16065,1,6065,[ 64  12 483 427  11],618,5,24945,4.112265084075173,60.0,0.0
16066,1,6066,[ 12  28  69 228 313],405,4,24949,4.112246579858249,40.0,20.0
16067,1,6067,[ 64  12 483 427  11],214,5,24954,4.112392880685563,60.0,0.0
16068,1,6068,[ 64  12 483 427  11],618,5,24959,4.112539133300379,60.0,0.0
16069,1,6069,[ 64  12 483 427  11],214,5,24964,4.112685337726524,60.0,0.0
16070,1,6070,[286  98 135   4  56],854,3,24967,4.112502058968868,0.0,20.0
16071,1,6071,[ 64  12 483 427  11],618,5,24972,4.112648221343873,60.0,0.0
16072,1,6072,[132 471 655 313 483],618,4,24976,4.1126296723201055,40.0,20.0
16073,1,6073,[117 185   1 132  15],416,5,24981,4.1127757655581165,0.0,0.0
16074,1,6074,[678  15 483 313   8],588,4,24985,4.11275720164609,40.0,20.0
16075,1,6075,[ 64  12 483 427  11],618,5,24990,4.112903225806452,60.0,0.0
16076,1,6076,[ 64  12 483 427  11],214,5,24995,4.1130492019088365,60.0,0.0
16077,1,6077,[282 204 211  95 423],297,1,24996,4.11253701875617,0.0,0.0
16078,1,6078,[ 64  12 483 427  11],618,5,25001,4.112683007073532,60.0,0.0
16079,1,6079,[ 64  12 483 427  11],214,5,25006,4.112828947368421,60.0,0.0
16080,1,6080,[ 64  12 483 427  11],618,5,25011,4.1129748396645285,60.0,0.0
16081,1,6081,[183 234  97  70 238],297,4,25015,4.112956264386715,0.0,0.0
16082,1,6082,[ 64  12 483 427  11],214,5,25020,4.113102087785632,60.0,0.0
16083,1,6083,[ 64  12 483 427  11],618,5,25025,4.113247863247863,60.0,0.0
16084,1,6084,[ 64  12 483 427  11],214,5,25030,4.113393590797042,60.0,0.0
16085,1,6085,[588 282 496 211 655],416,5,25035,4.113539270456786,0.0,0.0
16086,1,6086,[ 64  12 483 427  11],214,5,25040,4.113684902250698,60.0,0.0
16087,1,6087,[ 64  12 483 427  11],214,5,25045,4.113830486202366,60.0,0.0
16088,1,6088,[ 79 100 195   4 118],198,0,25045,4.1131548694366895,0.0,0.0
16089,1,6089,[ 64  12 483 427  11],618,5,25050,4.113300492610837,60.0,0.0
16090,1,6090,[742 183  50 301 300],416,5,25055,4.113446067969135,0.0,20.0
16091,1,6091,[195 318 168 423  64],373,4,25059,4.113427445830598,40.0,0.0
16092,1,6092,[ 64  12 483 427  11],618,5,25064,4.113572952568521,60.0,0.0
16093,1,6093,[202 237 168 125 282],416,4,25068,4.113554315720381,0.0,0.0
16094,1,6094,[ 64  12 483 427  11],214,5,25073,4.113699753896636,60.0,0.0
16095,1,6095,[ 64  12 483 427  11],618,5,25078,4.113845144356955,60.0,0.0
16096,1,6096,[475 132 318 215 153],198,5,25083,4.113990487124815,20.0,0.0
16097,1,6097,[748 174 273 179 228],417,2,25085,4.11364381764513,0.0,0.0
16098,1,6098,[ 64  12 483 427  11],618,5,25090,4.1137891457616,60.0,0.0
16099,1,6099,[ 64  12 483 427  11],618,5,25095,4.113934426229508,60.0,0.0
16100,1,6100,[ 71  97 403  95  56],405,2,25097,4.113587936403868,0.0,0.0
16101,1,6101,[ 64  12 483 427  11],618,5,25102,4.113733202228778,60.0,0.0
16102,1,6102,[ 11 655 153 179 135],198,5,25107,4.11387842044896,0.0,0.0
16103,1,6103,[475  82 118 258 168],416,3,25110,4.113695937090433,0.0,0.0
16104,1,6104,[ 15   4  96  97 100],62,3,25113,4.113513513513514,0.0,0.0
16105,1,6105,[ 64  12 483 427  11],214,5,25118,4.113658696364232,60.0,0.0
16106,1,6106,[ 64  12 483 427  11],214,5,25123,4.113803831668577,60.0,0.0
16107,1,6107,[173 211  12 117 187],416,5,25128,4.113948919449902,20.0,0.0
16108,1,6108,[ 64  12 483 427  11],618,5,25133,4.114093959731544,60.0,0.0
16109,1,6109,[ 25 257  56 127 222],43,5,25138,4.114238952536825,0.0,0.0
16110,1,6110,[ 64  12 483 427  11],618,5,25143,4.114383897889052,60.0,0.0
16111,1,6111,[ 56  50 191 323 748],416,4,25147,4.114365183246074,0.0,20.0
16112,1,6112,[ 64  12 483 427  11],618,5,25152,4.114510060526746,60.0,0.0
16113,1,6113,[202 168 143 228  95],297,2,25154,4.114164213280994,0.0,0.0
16114,1,6114,[238 191   7 111 132],62,4,25158,4.11414554374489,0.0,0.0
16115,1,6115,[ 64  12 483 427  11],214,5,25163,4.11429038587312,60.0,0.0
16116,1,6116,[194 286 117 403 111],416,5,25168,4.114435180644106,0.0,0.0
16117,1,6117,[385 423  82 222 100],198,0,25168,4.113762667538412,0.0,0.0
16118,1,6118,[268 275  98 135 196],354,2,25170,4.113417225036771,0.0,20.0
16119,1,6119,[ 64 111 546 471 210],43,4,25174,4.113398692810457,20.0,0.0
16120,1,6120,[132 127 597 301 195],416,4,25178,4.113380166639438,0.0,0.0
16121,1,6121,[ 64  12 483 427  11],214,5,25183,4.113524991832734,60.0,0.0
16122,1,6122,[ 64  12 483 427  11],214,5,25188,4.113669769720725,60.0,0.0
16123,1,6123,[111 187  95  50 151],618,2,25190,4.113324624428478,0.0,20.0
16124,1,6124,[ 64  12 483 427  11],618,5,25195,4.113469387755102,60.0,0.0
16125,1,6125,[ 64  12 483 427  11],618,5,25200,4.113614103819785,60.0,0.0
16126,1,6126,[ 64  12 483 427  11],214,5,25205,4.113758772645666,60.0,0.0
16127,1,6127,[180  12 118 117 127],62,4,25209,4.113740208877284,20.0,0.0
16128,1,6128,[ 64  12 483 427  11],214,5,25214,4.1138848099200525,60.0,0.0
16129,1,6129,[144 153 286 118 748],416,4,25218,4.113866231647634,0.0,0.0
16130,1,6130,[357 302  25  96 210],417,1,25219,4.113358342847823,0.0,0.0
16131,1,6131,[385 197  50 117 210],345,4,25223,4.1133398564905415,0.0,20.0
16132,1,6132,[276   1 125  70  22],764,4,25227,4.113321376161748,0.0,0.0
16133,1,6133,[ 79 275 186  98 496],711,4,25231,4.113302901858494,0.0,20.0
16134,1,6134,[ 64  12 483 427  11],214,5,25236,4.113447432762836,60.0,0.0
16135,1,6135,[ 64  12 483 427  11],214,5,25241,4.113591916558018,60.0,0.0
16136,1,6136,[471  96  69 423 228],505,3,25244,4.113410461137364,0.0,0.0
16137,1,6137,[127 100  97 568 121],618,5,25249,4.113554903877485,0.0,0.0
16138,1,6138,[ 89 228 174 357 211],373,5,25254,4.113699299560189,0.0,0.0
16139,1,6139,[313 333  71  15 385],416,5,25259,4.113843648208469,20.0,20.0
16140,1,6140,[ 50 191  88 603 179],373,4,25263,4.113825109916951,0.0,20.0
16141,1,6141,[ 28 118 143  69 300],705,3,25266,4.113643764246174,0.0,0.0
16142,1,6142,[ 64  12 483 427  11],214,5,25271,4.113788051440664,60.0,0.0
16143,1,6143,[ 64  12 483 427  11],214,5,25276,4.113932291666667,60.0,0.0
16144,1,6144,[ 64 195 301 257 168],416,4,25280,4.113913751017087,20.0,0.0
16145,1,6145,[ 64  12 483 427  11],214,5,25285,4.114057923852912,60.0,0.0
16146,1,6146,[318 186  25 173 742],588,5,25290,4.11420204978038,20.0,0.0
16147,1,6147,[ 64  12 483 427  11],214,5,25295,4.1143461288223815,60.0,0.0
16148,1,6148,[597 546  15 195 322],159,4,25299,4.114327532932184,0.0,0.0
16149,1,6149,[ 64  12 483 427  11],214,5,25304,4.114471544715447,60.0,0.0
16150,1,6150,[ 64  12 483 427  11],214,5,25309,4.114615509673224,60.0,0.0
16151,1,6151,[748 286 185 196  98],417,4,25313,4.114596879063719,0.0,20.0
16152,1,6152,[ 64 515 568 357  89],405,3,25316,4.114415732163172,20.0,0.0
16153,1,6153,[ 64  12 483 427  11],618,5,25321,4.1145596360090995,60.0,0.0
16154,1,6154,[ 64  12 483 427  11],618,5,25326,4.114703493095044,60.0,0.0
16155,1,6155,[ 64  12 483 427  11],214,5,25331,4.114847303443795,60.0,0.0
16156,1,6156,[ 64  12 483 427  11],618,5,25336,4.1149910670781225,60.0,0.0
16157,1,6157,[ 64  12 483 427  11],214,5,25341,4.115134784020786,60.0,0.0
16158,1,6158,[144  79 288  96 176],854,2,25343,4.114791362234129,0.0,20.0
16159,1,6159,[ 64  12 483 427  11],618,5,25348,4.114935064935065,60.0,0.0
16160,1,6160,[ 64  12 483 427  11],214,5,25353,4.115078720986853,60.0,0.0
16161,1,6161,[ 69 210  71  22  64],705,4,25357,4.115060045439792,20.0,0.0
16162,1,6162,[237 216 183 181  22],416,4,25361,4.115041375953269,0.0,20.0
16163,1,6163,[ 64  12 483 427  11],214,5,25366,4.115184944841013,60.0,0.0
16164,1,6164,[ 64 496 405 275  96],416,5,25371,4.115328467153285,20.0,0.0
16165,1,6165,[174 268  98 168 603],854,3,25374,4.115147583522543,0.0,20.0
16166,1,6166,[  9  12 496 135 275],618,3,25377,4.114966758553591,20.0,0.0
16167,1,6167,[269 313   8  96 143],416,5,25382,4.115110246433203,20.0,20.0
16168,1,6168,[ 64  12 483 427  11],618,5,25387,4.115253687793808,60.0,0.0
16169,1,6169,[181 245  50 197 385],345,3,25390,4.115072933549433,0.0,40.0
16170,1,6170,[597 187 289  22  50],416,3,25393,4.11489223788689,0.0,20.0
16171,1,6171,[ 64  12 483 427  11],214,5,25398,4.1150356448476995,60.0,0.0
16172,1,6172,[ 64  12 483 427  11],214,5,25403,4.115179005345861,60.0,0.0
16173,1,6173,[328 515 273 742  22],416,5,25408,4.115322319403952,0.0,0.0
16174,1,6174,[  7 475  50 294 471],416,4,25412,4.115303643724697,0.0,20.0
16175,1,6175,[ 88 275 204 196 172],373,5,25417,4.11544689119171,0.0,0.0
16176,1,6176,[ 64  12 483 427  11],214,5,25422,4.115590092277805,60.0,0.0
16177,1,6177,[196 289  50 301 475],416,3,25425,4.115409517643251,0.0,20.0
16178,1,6178,[185 144 496   4  82],417,1,25426,4.114905324486163,0.0,0.0
16179,1,6179,[ 64  12 483 427  11],214,5,25431,4.11504854368932,60.0,0.0
16180,1,6180,[588 132  64 265 197],711,4,25435,4.115029930431969,20.0,0.0
16181,1,6181,[153  56 143 475 132],416,4,25439,4.115011323196376,0.0,0.0
16182,1,6182,[275 228 234 301 238],297,3,25442,4.114830988193433,0.0,0.0
16183,1,6183,[301 135 222 678 191],721,2,25444,4.114489003880983,0.0,0.0
16184,1,6184,[127 204 176 179 196],416,4,25448,4.114470493128537,0.0,0.0
16185,1,6185,[ 56 168  88 200 301],416,4,25452,4.114451988360814,0.0,0.0
16186,1,6186,[ 69 597 204   1 161],416,4,25456,4.114433489574915,0.0,0.0
16187,1,6187,[ 64  12 483 427  11],214,5,25461,4.114576599870717,60.0,0.0
16188,1,6188,[ 64  12 483 427  11],214,5,25466,4.114719663919858,60.0,0.0
16189,1,6189,[ 64  12 483 427  11],214,5,25471,4.11486268174475,60.0,0.0
16190,1,6190,[ 64  12 483 427  11],214,5,25476,4.115005653367792,60.0,0.0
16191,1,6191,[ 25 435 151 286  50],373,4,25480,4.114987080103359,0.0,20.0
16192,1,6192,[204 748 318 186 143],373,4,25484,4.114968512837074,20.0,0.0
16193,1,6193,[300  64 118  15 276],630,3,25487,4.114788505004843,20.0,0.0
16194,1,6194,[ 64  12 483 427  11],618,5,25492,4.114931396287329,60.0,0.0
16195,1,6195,[196  50 258 597  97],654,4,25496,4.114912846998063,0.0,20.0
16196,1,6196,[318 655  96 588 185],416,5,25501,4.115055672099403,20.0,0.0
16197,1,6197,[ 64  12 483 427  11],618,5,25506,4.115198451113263,60.0,0.0
16198,1,6198,[ 64  12 483 427  11],618,5,25511,4.115341184061945,60.0,0.0
16199,1,6199,[180  71 179 286 258],62,4,25515,4.115322580645161,0.0,0.0
16200,1,6200,[ 64  12 483 427  11],214,5,25520,4.115465247540719,60.0,0.0
16201,1,6201,[ 56 196  12 173   7],314,2,25522,4.115124153498871,20.0,0.0
16202,1,6202,[  8 215 588 265 234],437,2,25524,4.114783169434145,0.0,0.0
16203,1,6203,[ 56 172 294  82 273],417,3,25527,4.1146034816247585,0.0,0.0
16204,1,6204,[ 64  12 483 427  11],618,5,25532,4.1147461724415795,60.0,0.0
16205,1,6205,[275 121  56 173 175],214,4,25536,4.114727682887528,0.0,0.0
16206,1,6206,[323 200 273  56 748],417,3,25539,4.114548090865152,0.0,0.0
16207,1,6207,[286  12 568  15 210],345,4,25543,4.114529639175258,20.0,0.0
16208,1,6208,[302 333  56 168 135],854,3,25546,4.114350136898051,0.0,0.0
16209,1,6209,[ 64  12 483 427  11],618,5,25551,4.114492753623188,60.0,0.0
16210,1,6210,[ 64  12 483 427  11],214,5,25556,4.114635324424408,60.0,0.0
16211,1,6211,[ 28 173 322  79 195],805,2,25558,4.1142949130714745,0.0,0.0
16212,1,6212,[655 132 161 222 597],588,3,25561,4.114115564139707,0.0,0.0
16213,1,6213,[121 268 202  25 118],416,4,25565,4.114097199871258,0.0,0.0
16214,1,6214,[568 237   4 273 403],618,4,25569,4.11407884151247,0.0,0.0
16215,1,6215,[ 64  12 483 427  11],214,5,25574,4.114221364221364,60.0,0.0
16216,1,6216,[ 64  12 483 427  11],618,5,25579,4.114363841080907,60.0,0.0
16217,1,6217,[ 64  12 483 427  11],214,5,25584,4.1145062721132195,60.0,0.0
16218,1,6218,[ 64  12 483 427  11],618,5,25589,4.114648657340409,60.0,0.0
16219,1,6219,[ 64  12 483 427  11],214,5,25594,4.114790996784566,60.0,0.0
16220,1,6220,[202 357 748 568 175],373,3,25597,4.114611798746182,0.0,0.0
16221,1,6221,[ 64  12 483 427  11],618,5,25602,4.114754098360656,60.0,0.0
16222,1,6222,[ 64  12 483 427  11],214,5,25607,4.114896352241684,60.0,0.0
16223,1,6223,[ 64  12 483 427  11],618,5,25612,4.115038560411311,60.0,0.0
16224,1,6224,[ 15 228  97 546 508],62,2,25614,4.114698795180723,0.0,0.0
16225,1,6225,[508 423  50 742   4],854,3,25617,4.114519755862512,0.0,20.0
16226,1,6226,[294 475 568  97  56],417,4,25621,4.114501365023286,0.0,0.0
16227,1,6227,[179 111 200 678 216],805,3,25624,4.11432241490045,0.0,0.0
16228,1,6228,[174 276   4 257 273],416,3,25627,4.114143522234708,0.0,0.0
16229,1,6229,[301 357 202 405  50],416,5,25632,4.114285714285714,0.0,20.0
16230,1,6230,[ 64  12 483 427  11],618,5,25637,4.114427860696518,60.0,0.0
16231,1,6231,[ 64  12 483 427  11],214,5,25642,4.114569961489089,60.0,0.0
16232,1,6232,[ 64  12 483 427  11],618,5,25647,4.1147120166853846,60.0,0.0
16233,1,6233,[ 64  12 483 427  11],214,5,25652,4.114854026307347,60.0,0.0
16234,1,6234,[ 56  97 275 496 237],618,4,25656,4.114835605453087,0.0,0.0
16235,1,6235,[546 508 168 228 210],417,1,25657,4.11433611289288,0.0,0.0
16236,1,6236,[ 64  12 483 427  11],618,5,25662,4.114478114478114,60.0,0.0
16237,1,6237,[ 50 313 132 144 216],711,4,25666,4.1144597627444695,20.0,40.0
16238,1,6238,[ 64  12 483 427  11],618,5,25671,4.1146016989902225,60.0,0.0
16239,1,6239,[211 210 423  11 191],405,4,25675,4.114583333333333,0.0,0.0
16240,1,6240,[ 64  12 483 427  11],618,5,25680,4.114725204294183,60.0,0.0
16241,1,6241,[ 64  12 483 427  11],618,5,25685,4.114867029798142,60.0,0.0
16242,1,6242,[ 64  12 483 427  11],618,5,25690,4.115008809867051,60.0,0.0
16243,1,6243,[ 64  12 483 427  11],214,5,25695,4.115150544522741,60.0,0.0
16244,1,6244,[ 95 135 475 153  15],342,3,25698,4.114971977582066,0.0,0.0
16245,1,6245,[  9   1 471 100 153],854,3,25701,4.114793467819404,0.0,0.0
16246,1,6246,[187  70 202  28 288],618,2,25703,4.114454938370418,0.0,20.0
16247,1,6247,[ 64  12 483 427  11],618,5,25708,4.1145966709346995,60.0,0.0
16248,1,6248,[ 64  12 483 427  11],214,5,25713,4.114738358137302,60.0,0.0
16249,1,6249,[ 64  12 483 427  11],214,5,25718,4.11488,60.0,0.0
16250,1,6250,[515 403 153 121  50],416,5,25723,4.115021596544553,0.0,20.0
16251,1,6251,[  1 475  28  98 322],805,3,25726,4.114843250159949,0.0,20.0
16252,1,6252,[ 97 161 210 234 197],618,3,25729,4.114664960818807,0.0,0.0
16253,1,6253,[273 271 179 135 197],805,3,25732,4.114486728493764,0.0,0.0
16254,1,6254,[ 64  12 483 427  11],618,5,25737,4.114628297362111,60.0,0.0
16255,1,6255,[748 257  82 471 161],416,4,25741,4.114609974424552,0.0,0.0
16256,1,6256,[322  25 222   1 328],854,1,25742,4.114112194342336,0.0,0.0
16257,1,6257,[ 64  12 483 427  11],214,5,25747,4.114253755193353,60.0,0.0
16258,1,6258,[ 64  12 483 427  11],214,5,25752,4.114395270810034,60.0,0.0
16259,1,6259,[  7 125 174 197 588],618,3,25755,4.114217252396166,0.0,0.0
16260,1,6260,[183 196 475  89 403],417,5,25760,4.1143587286375976,0.0,0.0
16261,1,6261,[ 64  12 483 427  11],214,5,25765,4.114500159693389,60.0,0.0
16262,1,6262,[ 64  12 483 427  11],214,5,25770,4.114641545585183,60.0,0.0
16263,1,6263,[483 655 200  95 186],618,4,25774,4.114623243933589,20.0,0.0
16264,1,6264,[323 185 202  28 200],805,3,25777,4.114445331205108,0.0,0.0
16265,1,6265,[ 64  12 483 427  11],618,5,25782,4.1145866581551225,60.0,0.0
16266,1,6266,[ 64  12 483 427  11],618,5,25787,4.114727940003191,60.0,0.0
16267,1,6267,[ 64  12 483 427  11],618,5,25792,4.1148691767709,60.0,0.0
16268,1,6268,[194 568 257 282   1],416,4,25796,4.114850853405647,0.0,0.0
16269,1,6269,[322  15 135 100 125],854,2,25798,4.11451355661882,0.0,0.0
16270,1,6270,[269 289  15   7 237],525,3,25801,4.114335831605804,0.0,0.0
16271,1,6271,[  4 173  56 100 153],297,4,25805,4.114317602040816,0.0,0.0
16272,1,6272,[204 323 196 405  12],416,4,25809,4.1142993782879005,20.0,0.0
16273,1,6273,[ 64  12 483 427  11],618,5,25814,4.1144405482945485,60.0,0.0
16274,1,6274,[174 132 222 294 228],417,2,25816,4.114103585657371,0.0,0.0
16275,1,6275,[ 64  12 483 427  11],214,5,25821,4.114244741873805,60.0,0.0
16276,1,6276,[405 161 204  98 100],345,4,25825,4.114226541341405,0.0,20.0
16277,1,6277,[ 70  15 180 742 273],62,2,25827,4.113889773813316,0.0,0.0
16278,1,6278,[168 222 385 186 151],43,4,25831,4.113871635610766,0.0,0.0
16279,1,6279,[196 322 161  71  79],805,1,25832,4.113375796178344,0.0,0.0
16280,1,6280,[ 89 238 117 173 496],437,3,25835,4.113198535265085,0.0,0.0
16281,1,6281,[ 12  50 588 483 181],601,3,25838,4.113021330786374,40.0,40.0
16282,1,6282,[678   1 257  82  96],416,3,25841,4.112844182715263,0.0,0.0
16283,1,6283,[ 70 121 237  69 168],128,4,25845,4.112826225334182,0.0,0.0
16284,1,6284,[ 64 483  12 427  11],214,5,25850,4.1129673826571205,60.0,0.0
16285,1,6285,[ 64 483  12 427  11],214,5,25855,4.113108495068406,60.0,0.0
16286,1,6286,[202 174 282 237  79],297,2,25857,4.1127723874662,0.0,0.0
16287,1,6287,[742 153 176 197 200],416,5,25862,4.112913486005089,0.0,0.0
16288,1,6288,[ 64 483  12 427  11],214,5,25867,4.113054539672444,60.0,0.0
16289,1,6289,[ 64 483  12 427  11],618,5,25872,4.113195548489666,60.0,0.0
16290,1,6290,[ 56 191 427   7  11],214,5,25877,4.113336512478144,0.0,0.0
16291,1,6291,[ 64 483  12 427  11],618,5,25882,4.11347743165925,60.0,0.0
16292,1,6292,[ 64 483  12 427  11],618,5,25887,4.113618306054346,60.0,0.0
16293,1,6293,[ 64 483  12 427  11],214,5,25892,4.113759135684779,60.0,0.0
16294,1,6294,[288 483 318 151  96],907,5,25897,4.113899920571883,40.0,20.0
16295,1,6295,[204 111  79 300  88],416,4,25901,4.113881829733164,0.0,0.0
16296,1,6296,[211  70  89 357 228],417,4,25905,4.113863744640305,0.0,0.0
16297,1,6297,[181  28 191  71 328],373,4,25909,4.113845665290569,0.0,20.0
16298,1,6298,[  7 546 228  89 222],297,3,25912,4.113668836323226,0.0,0.0
16299,1,6299,[ 64 483  12 427  11],214,5,25917,4.113809523809524,60.0,0.0
16300,1,6300,[ 64 483  12 427  11],618,5,25922,4.113950166640215,60.0,0.0
16301,1,6301,[ 64 483  12 427  11],618,5,25927,4.114090764836559,60.0,0.0
16302,1,6302,[ 64 483  12 427  11],618,5,25932,4.1142313184198,60.0,0.0
16303,1,6303,[357  25 289 328  15],854,1,25933,4.11373730964467,0.0,0.0
16304,1,6304,[185 186   4 275 234],618,3,25936,4.113560666137985,0.0,0.0
16305,1,6305,[172 678 302 258 238],654,5,25941,4.113701236917222,0.0,0.0
16306,1,6306,[161 200 144 265  12],437,2,25943,4.113366101157444,20.0,0.0
16307,1,6307,[ 64 483  12 427  11],214,5,25948,4.1135066582117945,60.0,0.0
16308,1,6308,[202  82 195 238  56],405,5,25953,4.113647170708512,0.0,0.0
16309,1,6309,[ 64 483  12 427  11],214,5,25958,4.1137876386687795,60.0,0.0
16310,1,6310,[197 182 118 403 237],198,3,25961,4.11361115512597,0.0,0.0
16311,1,6311,[603 216 655 161  95],437,4,25965,4.113593155893536,0.0,0.0
16312,1,6312,[ 64 483  12 427  11],618,5,25970,4.1137335656581655,60.0,0.0
16313,1,6313,[ 64 483  12 427  11],214,5,25975,4.1138739309471015,60.0,0.0
16314,1,6314,[ 95   1 423 202 174],805,1,25976,4.113380839271576,0.0,0.0
16315,1,6315,[211 269 742  97  98],297,4,25980,4.113362887903737,0.0,20.0
16316,1,6316,[ 64 483  12 427  11],214,5,25985,4.1135032452113345,60.0,0.0
16317,1,6317,[588 174 546 195 597],805,0,25985,4.112852168407724,0.0,0.0
16318,1,6318,[238 181 151 568  69],711,3,25988,4.112676056338028,0.0,20.0
16319,1,6319,[ 64 483  12 427  11],214,5,25993,4.112816455696202,60.0,0.0
16320,1,6320,[ 64 483  12 427  11],214,5,25998,4.112956810631229,60.0,0.0
16321,1,6321,[ 64 483  12 427  11],214,5,26003,4.113097121164189,60.0,0.0
16322,1,6322,[ 64 483  12 427  11],214,5,26008,4.113237387316147,60.0,0.0
16323,1,6323,[ 64 483  12 427  11],214,5,26013,4.113377609108159,60.0,0.0
16324,1,6324,[216 257 111 288 258],417,1,26014,4.112885375494071,0.0,20.0
16325,1,6325,[294  25 289 196 204],342,1,26015,4.112393297502371,0.0,0.0
16326,1,6326,[ 64 483  12 427  11],214,5,26020,4.112533586217797,60.0,0.0
16327,1,6327,[204 182 301 276 288],342,4,26024,4.11251580278129,0.0,20.0
16328,1,6328,[403 546  98 175 197],805,4,26028,4.11249802496445,0.0,20.0
16329,1,6329,[265 204 216  95 127],618,2,26030,4.1121642969984205,0.0,0.0
16330,1,6330,[ 64 483  12 427  11],214,5,26035,4.112304533249092,60.0,0.0
16331,1,6331,[ 64 483  12 427  11],214,5,26040,4.1124447252053065,60.0,0.0
16332,1,6332,[258 237 742 294  96],630,4,26044,4.112426969840518,0.0,0.0
16333,1,6333,[ 64 483  12 427  11],214,5,26049,4.11256709820019,60.0,0.0
16334,1,6334,[132  11  71  98 161],230,5,26054,4.112707182320442,0.0,20.0
16335,1,6335,[ 64 483  12 427  11],618,5,26059,4.112847222222222,60.0,0.0
16336,1,6336,[ 79 195 275 144 179],416,4,26063,4.112829414549472,0.0,0.0
16337,1,6337,[ 12 195 423 175 288],805,2,26065,4.112496055538025,20.0,20.0
16338,1,6338,[ 64 483  12 427  11],214,5,26070,4.112636062470421,60.0,0.0
16339,1,6339,[ 64 483  12 427  11],618,5,26075,4.1127760252365935,60.0,0.0
16340,1,6340,[ 64 483  12 427  11],214,5,26080,4.112915943857436,60.0,0.0
16341,1,6341,[ 64 483  12 427  11],214,5,26085,4.113055818353832,60.0,0.0
16342,1,6342,[ 64 483  12 427  11],618,5,26090,4.1131956487466494,60.0,0.0
16343,1,6343,[172 403 182 275  12],618,4,26094,4.113177805800756,20.0,0.0
16344,1,6344,[ 64 483  12 427  11],618,5,26099,4.113317572892041,60.0,0.0
16345,1,6345,[597 210 588 132  56],642,4,26103,4.11329971635676,0.0,0.0
16346,1,6346,[179 172 117 276   7],416,3,26106,4.113124310697968,0.0,0.0
16347,1,6347,[ 64 483  12 427  11],214,5,26111,4.1132640201638315,60.0,0.0
16348,1,6348,[ 64 483  12 427  11],618,5,26116,4.113403685619782,60.0,0.0
16349,1,6349,[ 64 483  12 427  11],214,5,26121,4.113543307086614,60.0,0.0
16350,1,6350,[237  12 228 173 318],62,3,26124,4.113367973547473,40.0,0.0
16351,1,6351,[ 64 483  12 427  11],618,5,26129,4.113507556675063,60.0,0.0
16352,1,6352,[ 64 483  12 427  11],214,5,26134,4.113647095860223,60.0,0.0
16353,1,6353,[ 64 483  12 427  11],214,5,26139,4.113786591123701,60.0,0.0
16354,1,6354,[153 748 435 318 385],373,4,26143,4.113768686073957,20.0,0.0
16355,1,6355,[ 15 117 546 183   8],416,4,26147,4.113750786658276,0.0,0.0
16356,1,6356,[ 64 483  12 427  11],618,5,26152,4.11389019977977,60.0,0.0
16357,1,6357,[197 228 273 174  97],297,3,26155,4.113715004718465,0.0,0.0
16358,1,6358,[357 172 200  82 143],405,4,26159,4.1136971221890235,0.0,0.0
16359,1,6359,[405 117 222 323 742],417,1,26160,4.113207547169812,0.0,0.0
16360,1,6360,[ 64 483  12 427  11],618,5,26165,4.113346958025468,60.0,0.0
16361,1,6361,[276 269 111 151 127],416,3,26168,4.1131719585036155,0.0,0.0
16362,1,6362,[286 185  97  95  71],416,4,26172,4.1131541725601135,0.0,0.0
16363,1,6363,[ 64 483  12 427  11],618,5,26177,4.113293526084224,60.0,0.0
16364,1,6364,[655  22  64  96 475],416,4,26181,4.1132757266300075,20.0,0.0
16365,1,6365,[216  64 238 568  69],43,4,26185,4.113257932767829,20.0,0.0
16366,1,6366,[269  95 234 471 603],416,4,26189,4.113240144495053,0.0,0.0
16367,1,6367,[568 210 153 204 496],416,5,26194,4.113379396984925,0.0,0.0
16368,1,6368,[194   8 273  56 294],416,5,26199,4.113518605746585,0.0,0.0
16369,1,6369,[168  22 385  56 186],405,3,26202,4.113343799058085,0.0,0.0
16370,1,6370,[ 28 118 323  98 210],751,3,26205,4.11316904724533,0.0,20.0
16371,1,6371,[568 179   4 118 603],416,3,26208,4.112994350282486,0.0,0.0
16372,1,6372,[257 496 269 322  88],416,2,26210,4.112662796171348,0.0,0.0
16373,1,6373,[ 64 483  12 427  11],214,5,26215,4.112802008158143,60.0,0.0
16374,1,6374,[132 117 197  12 135],618,4,26219,4.1127843137254905,20.0,0.0
16375,1,6375,[204 200 180  88 202],437,4,26223,4.112766624843162,0.0,0.0
16376,1,6376,[117 100  71 294   1],588,4,26227,4.1127489415085465,0.0,0.0
16377,1,6377,[  7 483 132  97 273],417,3,26230,4.112574474756977,20.0,0.0
16378,1,6378,[ 25  11 174 357  89],417,3,26233,4.1124000627057535,0.0,0.0
16379,1,6379,[100 175 135 655  70],354,2,26235,4.112068965517241,0.0,0.0
16380,1,6380,[ 64 483  12 427  11],618,5,26240,4.112208117849867,60.0,0.0
16381,1,6381,[ 64 483  12 427  11],618,5,26245,4.112347226574742,60.0,0.0
16382,1,6382,[ 64 483  12 427  11],618,5,26250,4.112486291712361,60.0,0.0
16383,1,6383,[ 69 423 496  12 257],654,5,26255,4.112625313283208,20.0,0.0
16384,1,6384,[ 70 288 286 132 180],437,2,26257,4.1122944400939705,0.0,20.0
16385,1,6385,[127  97 176 195 153],416,5,26262,4.1124334481678675,0.0,0.0
16386,1,6386,[ 64 483  12 427  11],214,5,26267,4.112572412713324,60.0,0.0
16387,1,6387,[289 597   7 174  71],43,4,26271,4.112554790231685,0.0,0.0
16388,1,6388,[ 25 302 118 742 483],417,2,26273,4.112224135232431,20.0,0.0
16389,1,6389,[ 98 405 191 118 173],345,4,26277,4.112206572769953,0.0,20.0
16390,1,6390,[ 64 483  12 427  11],214,5,26282,4.1123454858394615,60.0,0.0
16391,1,6391,[ 50  15 286 125 132],345,3,26285,4.112171464330413,0.0,20.0
16392,1,6392,[ 64 483  12 427  11],214,5,26290,4.112310339433756,60.0,0.0
16393,1,6393,[222 568 302 183  56],417,2,26292,4.111979981232405,0.0,0.0
16394,1,6394,[202 186 173 483 423],618,3,26295,4.111806098514465,20.0,0.0
16395,1,6395,[211 597  79 127 176],417,3,26298,4.1116322701688555,0.0,0.0
16396,1,6396,[ 64 483  12 427  11],214,5,26303,4.111771142723152,60.0,0.0
16397,1,6397,[100 288   7 111 678],805,3,26306,4.111597374179431,0.0,20.0
16398,1,6398,[ 64 483  12 427  11],214,5,26311,4.111736208782622,60.0,0.0
16399,1,6399,[ 64 483  12 427  11],618,5,26316,4.111875,60.0,0.0
16400,1,6400,[ 64 483  12 427  11],214,5,26321,4.112013747851898,60.0,0.0
16401,1,6401,[185 333 173 176 195],875,5,26326,4.112152452358638,0.0,0.0
16402,1,6402,[357 742 168 173 282],854,3,26329,4.111978759956271,0.0,0.0
16403,1,6403,[ 64 483  12 427  11],214,5,26334,4.1121174266083695,60.0,0.0
16404,1,6404,[742 357 328 182  15],416,5,26339,4.112256049960968,0.0,0.0
16405,1,6405,[135  64 132 200 179],417,4,26343,4.1122385263815175,20.0,0.0
16406,1,6406,[ 64 483  12 427  11],618,5,26348,4.112377087560481,60.0,0.0
16407,1,6407,[ 64 483  12 427  11],618,5,26353,4.112515605493134,60.0,0.0
16408,1,6408,[144 135 269 173 196],805,3,26356,4.112342019035731,0.0,0.0
16409,1,6409,[ 64 483  12 427  11],214,5,26361,4.112480499219969,60.0,0.0
16410,1,6410,[ 64 483  12 427  11],214,5,26366,4.1126189362034005,60.0,0.0
16411,1,6411,[ 64 483  12 427  11],618,5,26371,4.1127573300062386,60.0,0.0
16412,1,6412,[ 64 483  12 427  11],214,5,26376,4.112895680648682,60.0,0.0
16413,1,6413,[ 64 483  12 427  11],618,5,26381,4.11303398815092,60.0,0.0
16414,1,6414,[ 25 269   4 121  82],416,5,26386,4.113172252533126,0.0,0.0
16415,1,6415,[ 64 483  12 427  11],214,5,26391,4.113310473815462,60.0,0.0
16416,1,6416,[ 64 483  12 427  11],618,5,26396,4.113448652018077,60.0,0.0
16417,1,6417,[222 289 176 423 405],887,3,26399,4.113275163602369,0.0,0.0
16418,1,6418,[ 64 483  12 427  11],214,5,26404,4.113413304252999,60.0,0.0
16419,1,6419,[475 135 121 323 318],198,3,26407,4.113239875389408,20.0,0.0
16420,1,6420,[ 64 483  12 427  11],214,5,26412,4.11337797850802,60.0,0.0
16421,1,6421,[ 64 483  12 427  11],618,5,26417,4.113516038617253,60.0,0.0
16422,1,6422,[ 64 483  12 427  11],214,5,26422,4.113654055737195,60.0,0.0
16423,1,6423,[ 64 483  12 427  11],618,5,26427,4.113792029887921,60.0,0.0
16424,1,6424,[294 423 117 742 191],642,4,26431,4.113774319066148,0.0,0.0
16425,1,6425,[173 237 186 151 204],437,4,26435,4.113756613756614,0.0,0.0
16426,1,6426,[ 64 483  12 427  11],214,5,26440,4.113894507546289,60.0,0.0
16427,1,6427,[269 313   7 496   8],354,3,26443,4.1137212196639705,20.0,20.0
16428,1,6428,[ 64 483  12 427  11],214,5,26448,4.113859076061596,60.0,0.0
16429,1,6429,[  8 496 187 323  56],416,4,26452,4.113841368584759,0.0,0.0
16430,1,6430,[282  28  98 275 268],654,3,26455,4.113668169802519,0.0,20.0
16431,1,6431,[ 64 483  12 427  11],618,5,26460,4.1138059701492535,60.0,0.0
16432,1,6432,[ 64 483  12 427  11],618,5,26465,4.1139437276542825,60.0,0.0
16433,1,6433,[ 64 483  12 427  11],618,5,26470,4.114081442337581,60.0,0.0
16434,1,6434,[ 64 483  12 427  11],618,5,26475,4.1142191142191145,60.0,0.0
16435,1,6435,[301 385 258 257 276],416,3,26478,4.114045991298943,0.0,0.0
16436,1,6436,[ 11 245 100 508 568],417,2,26480,4.113717570296722,0.0,0.0
16437,1,6437,[ 64 483  12 427  11],214,5,26485,4.113855234544889,60.0,0.0
16438,1,6438,[ 70 121 237  98 211],43,5,26490,4.113992856033546,0.0,20.0
16439,1,6439,[127 196  95 322  11],417,4,26494,4.113975155279503,0.0,0.0
16440,1,6440,[  9   8 322 313  56],416,4,26498,4.1139574600217355,20.0,20.0
16441,1,6441,[300   7 161 143 179],198,2,26500,4.113629307668426,0.0,0.0
16442,1,6442,[ 64 483  12 427  11],618,5,26505,4.113766878783175,60.0,0.0
16443,1,6443,[ 64 483  12 427  11],618,5,26510,4.113904407200496,60.0,0.0
16444,1,6444,[ 64 483  12 427  11],214,5,26515,4.114041892940263,60.0,0.0
16445,1,6445,[ 64 483  12 427  11],214,5,26520,4.11417933602234,60.0,0.0
16446,1,6446,[181  79  25 282 300],128,3,26523,4.11400651465798,0.0,20.0
16447,1,6447,[ 64 483  12 427  11],214,5,26528,4.1141439205955335,60.0,0.0
16448,1,6448,[151 174  69   1 403],922,3,26531,4.113971158319119,0.0,0.0
16449,1,6449,[ 64 483  12 427  11],214,5,26536,4.1141085271317825,60.0,0.0
16450,1,6450,[ 89 100 258 182 211],417,4,26540,4.11409083862967,0.0,0.0
16451,1,6451,[ 64 483  12 427  11],618,5,26545,4.114228146311222,60.0,0.0
16452,1,6452,[ 64 483  12 427  11],618,5,26550,4.114365411436541,60.0,0.0
16453,1,6453,[ 70 313 471 172 286],345,3,26553,4.114192748682988,20.0,20.0
16454,1,6454,[ 64 483  12 427  11],618,5,26558,4.1143299767622,60.0,0.0
16455,1,6455,[302 228   1 179 258],62,2,26560,4.114002478314746,0.0,0.0
16456,1,6456,[ 79 496 111 176 121],437,2,26562,4.113675081307108,0.0,0.0
16457,1,6457,[132 323 282 245  15],921,2,26564,4.113347785692165,0.0,0.0
16458,1,6458,[ 64 483  12 427  11],618,5,26569,4.1134850596067505,60.0,0.0
16459,1,6459,[ 64 483  12 427  11],618,5,26574,4.113622291021672,60.0,0.0
16460,1,6460,[603 144 435  89 568],373,4,26578,4.113604705154001,0.0,0.0
16461,1,6461,[597 318   1  12 288],654,4,26582,4.113587124729186,40.0,20.0
16462,1,6462,[ 64 483  12 427  11],214,5,26587,4.11372427665171,60.0,0.0
16463,1,6463,[328 200 273 318 132],854,4,26591,4.113706683168317,20.0,0.0
16464,1,6464,[ 64 483  12 427  11],618,5,26596,4.1138437741686005,60.0,0.0
16465,1,6465,[172  82 403 423 496],711,3,26599,4.113671512527064,0.0,0.0
16466,1,6466,[ 64 483  12 427  11],618,5,26604,4.113808566568734,60.0,0.0
16467,1,6467,[ 64 483  12 427  11],214,5,26609,4.113945578231292,60.0,0.0
16468,1,6468,[301  25   7  95 194],751,4,26613,4.113927964136652,0.0,0.0
16469,1,6469,[ 64 483  12 427  11],214,5,26618,4.114064914992272,60.0,0.0
16470,1,6470,[ 56  89 185 125 245],417,4,26622,4.114047287899861,0.0,0.0
16471,1,6471,[ 64 483  12 427  11],618,5,26627,4.114184177997528,60.0,0.0
16472,1,6472,[ 64 483  12 427  11],618,5,26632,4.114321025799475,60.0,0.0
16473,1,6473,[186 210 125  28 135],642,4,26636,4.114303367315416,0.0,0.0
16474,1,6474,[ 69 294 153 328 257],43,5,26641,4.114440154440154,0.0,0.0
16475,1,6475,[ 64 483  12 427  11],618,5,26646,4.114576899320569,60.0,0.0
16476,1,6476,[ 64 483  12 427  11],618,5,26651,4.114713601976224,60.0,0.0
16477,1,6477,[172 257  22 118 195],654,4,26655,4.114695893794381,0.0,0.0
16478,1,6478,[  4  70  89 151  56],764,4,26659,4.114678191078871,0.0,0.0
16479,1,6479,[ 64 483  12 427  11],214,5,26664,4.114814814814815,60.0,0.0
16480,1,6480,[258 568 265 748 185],417,2,26666,4.114488504860361,0.0,0.0
16481,1,6481,[ 64 483  12 427  11],618,5,26671,4.114625115705029,60.0,0.0
16482,1,6482,[333 143 111  69 202],345,3,26674,4.1144531852537405,0.0,0.0
16483,1,6483,[210 234  25  11 275],618,2,26676,4.114127082048118,0.0,0.0
16484,1,6484,[215 211 168  89 265],437,1,26677,4.113646877409407,0.0,0.0
16485,1,6485,[258 294 313 328 245],507,5,26682,4.113783533765033,20.0,20.0
16486,1,6486,[ 64 483  12 427  11],214,5,26687,4.113920147988284,60.0,0.0
16487,1,6487,[ 64 483  12 427  11],214,5,26692,4.1140567200986435,60.0,0.0
16488,1,6488,[194 238 748 742  25],751,2,26694,4.11373092926491,0.0,0.0
16489,1,6489,[ 64 483  12 427  11],618,5,26699,4.11386748844376,60.0,0.0
16490,1,6490,[385 179 100  71   4],373,2,26701,4.113541827145278,0.0,0.0
16491,1,6491,[ 96 275 289   8 195],854,2,26703,4.113216266173752,0.0,0.0
16492,1,6492,[655 228  97 117 318],198,2,26705,4.112890805482827,20.0,0.0
16493,1,6493,[ 97 286 435 196 655],437,2,26707,4.112565445026178,0.0,0.0
16494,1,6494,[ 64 483  12 427  11],618,5,26712,4.11270207852194,60.0,0.0
16495,1,6495,[ 64 483  12 427  11],618,5,26717,4.112838669950739,60.0,0.0
16496,1,6496,[302 333 127 289 405],416,4,26721,4.112821302139449,0.0,0.0
16497,1,6497,[ 64 483  12 427  11],214,5,26726,4.11295783317944,60.0,0.0
16498,1,6498,[ 64 483  12 427  11],618,5,26731,4.113094322203416,60.0,0.0
16499,1,6499,[117  28 238  95 568],751,3,26734,4.112923076923077,0.0,0.0
16500,1,6500,[111 300  50  70 301],416,5,26739,4.113059529303184,0.0,20.0
16501,1,6501,[ 64 483  12 427  11],214,5,26744,4.113195939710859,60.0,0.0
16502,1,6502,[423 121 100 200 294],262,1,26745,4.112717207442719,0.0,0.0
16503,1,6503,[ 64 483  12 427  11],214,5,26750,4.1128536285362856,60.0,0.0
16504,1,6504,[ 64 483  12 427  11],618,5,26755,4.112990007686395,60.0,0.0
16505,1,6505,[ 69 273 405 245 483],417,2,26757,4.112665232093452,20.0,0.0
16506,1,6506,[168 235 216   8   9],43,4,26761,4.112647917627171,0.0,0.0
16507,1,6507,[ 64 483  12 427  11],618,5,26766,4.112784265519361,60.0,0.0
16508,1,6508,[268 423 222 245 655],721,3,26769,4.112613304655093,0.0,0.0
16509,1,6509,[121  25 294 195 174],630,3,26772,4.112442396313364,0.0,0.0
16510,1,6510,[ 64 483  12 427  11],214,5,26777,4.11257871294732,60.0,0.0
16511,1,6511,[ 64 483  12 427  11],618,5,26782,4.112714987714988,60.0,0.0
16512,1,6512,[ 64 483  12 427  11],214,5,26787,4.112851220635652,60.0,0.0
16513,1,6513,[ 15 313 288  56 403],345,3,26790,4.112680380718452,20.0,40.0
16514,1,6514,[ 64 483  12 427  11],214,5,26795,4.112816577129701,60.0,0.0
16515,1,6515,[ 64 483  12 427  11],214,5,26800,4.112952731737262,60.0,0.0
16516,1,6516,[ 64 483  12 427  11],618,5,26805,4.11308884456038,60.0,0.0
16517,1,6517,[132 143  89   1 186],642,3,26808,4.112918073028537,0.0,0.0
16518,1,6518,[ 64 483  12 427  11],214,5,26813,4.113054149409419,60.0,0.0
16519,1,6519,[ 64 483  12 427  11],214,5,26818,4.113190184049079,60.0,0.0
16520,1,6520,[435 302 275 153 286],297,4,26822,4.113172826253642,0.0,0.0
16521,1,6521,[275 265 294 282 182],416,5,26827,4.113308800981294,0.0,0.0
16522,1,6522,[ 98  56 216 168  28],62,4,26831,4.11329143032347,0.0,20.0
16523,1,6523,[ 64 483  12 427  11],618,5,26836,4.113427345187002,60.0,0.0
16524,1,6524,[ 64 483  12 427  11],214,5,26841,4.113563218390804,60.0,0.0
16525,1,6525,[ 56 125 127 222 210],62,5,26846,4.11369904995403,0.0,0.0
16526,1,6526,[ 64 483  12 427  11],214,5,26851,4.1138348398958176,60.0,0.0
16527,1,6527,[173 318 118   4 143],43,5,26856,4.113970588235294,20.0,0.0
16528,1,6528,[175 210 273 174  11],297,5,26861,4.114106294991576,0.0,0.0
16529,1,6529,[ 25 300 471 202 216],297,2,26863,4.113782542113323,0.0,0.0
16530,1,6530,[269  82 403  64  79],43,5,26868,4.113918236104731,20.0,0.0
16531,1,6531,[748 357 423 185 269],805,3,26871,4.113747703612982,0.0,0.0
16532,1,6532,[475 197 111 288 195],437,1,26872,4.113271085259452,0.0,20.0
16533,1,6533,[111  69 200  71  88],416,4,26876,4.113253749617386,0.0,0.0
16534,1,6534,[ 64 483  12 427  11],214,5,26881,4.113389441469013,60.0,0.0
16535,1,6535,[318 471  12 144  98],416,5,26886,4.113525091799265,40.0,20.0
16536,1,6536,[194 118 173   1 191],297,1,26887,4.113048799143338,0.0,0.0
16537,1,6537,[273 215 100  11  88],175,3,26890,4.112878556133374,0.0,0.0
16538,1,6538,[ 64 483  12 427  11],214,5,26895,4.113014222358159,60.0,0.0
16539,1,6539,[  1 237 222 100  89],764,5,26900,4.113149847094801,0.0,0.0
16540,1,6540,[ 64 483  12 427  11],214,5,26905,4.11328543036233,60.0,0.0
16541,1,6541,[ 64 483  12 427  11],618,5,26910,4.113420972179761,60.0,0.0
16542,1,6542,[ 64 483  12 427  11],618,5,26915,4.113556472566101,60.0,0.0
16543,1,6543,[ 64 483  12 427  11],214,5,26920,4.113691931540342,60.0,0.0
16544,1,6544,[ 71  56 568 127 202],922,2,26922,4.113368983957219,0.0,0.0
16545,1,6545,[ 64 483  12 427  11],214,5,26927,4.1135044301863735,60.0,0.0
16546,1,6546,[ 64 483  12 427  11],214,5,26932,4.113639835038949,60.0,0.0
16547,1,6547,[ 64 483  12 427  11],618,5,26937,4.1137751985339035,60.0,0.0
16548,1,6548,[ 64 172 496   1 313],416,5,26942,4.113910520690181,40.0,20.0
16549,1,6549,[ 64 483  12 427  11],618,5,26947,4.114045801526718,60.0,0.0
16550,1,6550,[197  88   1 385  50],751,3,26950,4.113875744161197,0.0,20.0
16551,1,6551,[121 168 237 475 423],62,3,26953,4.113705738705739,0.0,0.0
16552,1,6552,[ 64 483  12 427  11],618,5,26958,4.113840988860064,60.0,0.0
16553,1,6553,[ 64 483  12 427  11],214,5,26963,4.113976197741837,60.0,0.0
16554,1,6554,[ 64 483  12 427  11],618,5,26968,4.114111365369947,60.0,0.0
16555,1,6555,[ 64 483  12 427  11],618,5,26973,4.114246491763271,60.0,0.0
16556,1,6556,[ 69 111 357 185 234],416,5,26978,4.114381576940674,0.0,0.0
16557,1,6557,[ 64 483  12 427  11],618,5,26983,4.1145166209210124,60.0,0.0
16558,1,6558,[ 64 483  12 427  11],618,5,26988,4.1146516237231285,60.0,0.0
16559,1,6559,[597 273  82 222 678],805,2,26990,4.114329268292683,0.0,0.0
16560,1,6560,[ 64 483  12 427  11],214,5,26995,4.11446425849718,60.0,0.0
16561,1,6561,[ 64 483  12 427  11],214,5,27000,4.114599207558671,60.0,0.0
16562,1,6562,[ 15 318 289 215 118],43,5,27005,4.1147341154959625,20.0,0.0
16563,1,6563,[ 56 282 173 197  22],297,3,27008,4.114564290067032,0.0,0.0
16564,1,6564,[742 333 211 475 265],416,4,27012,4.114546839299314,0.0,0.0
16565,1,6565,[111  11 294 603  97],297,3,27015,4.114377094121231,0.0,0.0
16566,1,6566,[ 64 483  12 427  11],214,5,27020,4.114511953707933,60.0,0.0
16567,1,6567,[ 64 483  12 427  11],214,5,27025,4.114646772228989,60.0,0.0
16568,1,6568,[168 172 313 403 186],642,5,27030,4.114781549703151,20.0,20.0
16569,1,6569,[ 64 483  12 427  11],214,5,27035,4.114916286149163,60.0,0.0
16570,1,6570,[ 71 588 151 403 121],642,4,27039,4.11489879774768,0.0,0.0
16571,1,6571,[ 64 483  12 427  11],214,5,27044,4.1150334753499695,60.0,0.0
16572,1,6572,[546 435 245   4 195],297,0,27044,4.114407424311578,0.0,0.0
16573,1,6573,[ 64 483  12 427  11],618,5,27049,4.114542135686036,60.0,0.0
16574,1,6574,[ 64 483  12 427  11],214,5,27054,4.11467680608365,60.0,0.0
16575,1,6575,[ 70 258 197 238 196],198,3,27057,4.114507299270073,0.0,0.0
16576,1,6576,[ 64 483  12 427  11],618,5,27062,4.114641934012468,60.0,0.0
16577,1,6577,[302  70 151 496 121],43,5,27067,4.114776527820006,0.0,0.0
16578,1,6578,[597  95 237  25 100],764,4,27071,4.114759081927344,0.0,0.0
16579,1,6579,[742 471 191   7 300],630,4,27075,4.114741641337386,0.0,0.0
16580,1,6580,[ 64 483  12 427  11],214,5,27080,4.114876158638505,60.0,0.0
16581,1,6581,[ 64 483  12 427  11],214,5,27085,4.11501063506533,60.0,0.0
16582,1,6582,[ 64 483  12 427  11],214,5,27090,4.115145070636488,60.0,0.0
16583,1,6583,[ 98 135  89 173 222],711,3,27093,4.114975698663426,0.0,20.0
16584,1,6584,[ 56  69 294   9 257],314,4,27097,4.114958238420653,0.0,0.0
16585,1,6585,[323 168  69  79  15],43,4,27101,4.114940783480109,0.0,0.0
16586,1,6586,[202 568  71  98  50],805,2,27103,4.114619705480492,0.0,40.0
16587,1,6587,[318  56 235 132 204],887,4,27107,4.114602307225258,20.0,0.0
16588,1,6588,[ 64 483  12 427  11],618,5,27112,4.1147366823493705,60.0,0.0
16589,1,6589,[173  25  50 215 588],654,4,27116,4.114719271623672,0.0,20.0
16590,1,6590,[ 64 483  12 427  11],214,5,27121,4.114853588226369,60.0,0.0
16591,1,6591,[ 64 483  12 427  11],618,5,27126,4.11498786407767,60.0,0.0
16592,1,6592,[748  12 181 121 161],437,3,27129,4.114818747156074,20.0,20.0
16593,1,6593,[427  50 111 275 121],711,3,27132,4.114649681528663,0.0,20.0
16594,1,6594,[ 79 333 405 300 258],345,3,27135,4.1144806671721,0.0,0.0
16595,1,6595,[ 64 483  12 427  11],214,5,27140,4.114614918132201,60.0,0.0
16596,1,6596,[ 64 483  12 427  11],214,5,27145,4.1147491283916935,60.0,0.0
16597,1,6597,[ 12 496 194 588 318],416,5,27150,4.114883297969081,40.0,0.0
16598,1,6598,[ 64 483  12 427  11],618,5,27155,4.115017426882861,60.0,0.0
16599,1,6599,[ 64 483  12 427  11],618,5,27160,4.115151515151515,60.0,0.0
16600,1,6600,[ 64 483  12 427  11],214,5,27165,4.115285562793516,60.0,0.0
16601,1,6601,[ 64 483  12 427  11],214,5,27170,4.115419569827325,60.0,0.0
16602,1,6602,[179  64 655  79  96],373,4,27174,4.115402089959109,20.0,0.0
16603,1,6603,[194 483 200  96 127],854,3,27177,4.115233192004846,20.0,0.0
16604,1,6604,[ 64 483  12 427  11],618,5,27182,4.1153671461014385,60.0,0.0
16605,1,6605,[ 64 483  12 427  11],618,5,27187,4.115501059642749,60.0,0.0
16606,1,6606,[ 64 483  12 427  11],214,5,27192,4.115634932647192,60.0,0.0
16607,1,6607,[ 64 483  12 427  11],618,5,27197,4.115768765133172,60.0,0.0
16608,1,6608,[174 245 197 179  98],416,3,27200,4.115599939476471,0.0,20.0
16609,1,6609,[186 210  50 403  96],618,3,27203,4.115431164901664,0.0,20.0
16610,1,6610,[ 64 483  12 427  11],618,5,27208,4.115564967478445,60.0,0.0
16611,1,6611,[ 64 483  12 427  11],214,5,27213,4.1156987295825775,60.0,0.0
16612,1,6612,[ 64 483  12 427  11],618,5,27218,4.115832451232421,60.0,0.0
16613,1,6613,[ 64 483  12 427  11],214,5,27223,4.115966132446326,60.0,0.0
16614,1,6614,[427  15   8 111 257],541,3,27226,4.115797430083145,0.0,0.0
16615,1,6615,[117 215  70 204 655],62,1,27227,4.115326481257558,0.0,0.0
16616,1,6616,[471 168 228 235  95],297,1,27228,4.11485567477709,0.0,0.0
16617,1,6617,[ 64 483  12 427  11],214,5,27233,4.114989422786341,60.0,0.0
16618,1,6618,[ 64 483  12 427  11],618,5,27238,4.115123130382233,60.0,0.0
16619,1,6619,[ 64 483  12 427  11],214,5,27243,4.115256797583082,60.0,0.0
16620,1,6620,[ 64 483  12 427  11],214,5,27248,4.115390424407189,60.0,0.0
16621,1,6621,[ 64 483  12 427  11],214,5,27253,4.115524010872848,60.0,0.0
16622,1,6622,[286  22 288  70 258],62,2,27255,4.115204590064925,0.0,20.0
16623,1,6623,[ 64 483  12 427  11],214,5,27260,4.115338164251208,60.0,0.0
16624,1,6624,[ 56 181   7 258  64],43,5,27265,4.115471698113208,20.0,20.0
16625,1,6625,[ 64 483  12 427  11],214,5,27270,4.115605191669182,60.0,0.0
16626,1,6626,[318 121 118 273  98],618,4,27274,4.1155877470952165,20.0,20.0
16627,1,6627,[172 269 508 318 257],214,2,27276,4.115268557634279,20.0,0.0
16628,1,6628,[ 64 483  12 427  11],214,5,27281,4.115402021421029,60.0,0.0
16629,1,6629,[ 64 483  12 427  11],214,5,27286,4.115535444947209,60.0,0.0
16630,1,6630,[568 289  88  79 245],416,2,27288,4.115216407781632,0.0,0.0
16631,1,6631,[ 12  56 210 153  98],654,5,27293,4.115349819059108,20.0,20.0
16632,1,6632,[ 64 483  12 427  11],618,5,27298,4.115483190110056,60.0,0.0
16633,1,6633,[135 258 235 173 176],805,3,27301,4.115315043714199,0.0,0.0
16634,1,6634,[ 64 483  12 427  11],214,5,27306,4.11544837980407,60.0,0.0
16635,1,6635,[ 64 483  12 427  11],214,5,27311,4.115581675708258,60.0,0.0
16636,1,6636,[202 197  64 258 191],128,3,27314,4.115413590477625,20.0,0.0
16637,1,6637,[ 64 483  12 427  11],618,5,27319,4.115546851461284,60.0,0.0
16638,1,6638,[427 172 496 603 185],416,5,27324,4.115680072300045,0.0,0.0
16639,1,6639,[ 64 483  12 427  11],214,5,27329,4.115813253012048,60.0,0.0
16640,1,6640,[216 127  70 288  64],416,5,27334,4.1159463936154195,20.0,20.0
16641,1,6641,[568 186  64 403 258],417,4,27338,4.115928937067149,20.0,0.0
16642,1,6642,[121  79  25 125 742],588,4,27342,4.115911485774499,0.0,0.0
16643,1,6643,[245 144 196  28 200],416,4,27346,4.1158940397351,0.0,0.0
16644,1,6644,[204 268 111  95 121],679,1,27347,4.115425131677953,0.0,0.0
16645,1,6645,[216 333 289 204 210],345,3,27350,4.11525729762263,0.0,0.0
16646,1,6646,[172 195 234  69   7],198,3,27353,4.115089514066496,0.0,0.0
16647,1,6647,[ 64 483  12 427  11],618,5,27358,4.115222623345367,60.0,0.0
16648,1,6648,[153 187 748 174 181],198,4,27362,4.1152052940291775,0.0,20.0
16649,1,6649,[ 64 483  12 427  11],618,5,27367,4.115338345864662,60.0,0.0
16650,1,6650,[ 64 483  12 427  11],618,5,27372,4.115471357690573,60.0,0.0
16651,1,6651,[222 180 181  79 186],198,2,27374,4.115153337342153,0.0,20.0
16652,1,6652,[ 64 483  12 427  11],214,5,27379,4.115286336990831,60.0,0.0
16653,1,6653,[ 64 483  12 427  11],618,5,27384,4.115419296663661,60.0,0.0
16654,1,6654,[215 125 235   4 144],416,4,27388,4.115401953418482,0.0,0.0
16655,1,6655,[ 64 483  12 427  11],214,5,27393,4.115534855769231,60.0,0.0
16656,1,6656,[ 64 483  12 427  11],618,5,27398,4.115667718191378,60.0,0.0
16657,1,6657,[ 82 215 300 127  50],721,5,27403,4.115800540702914,0.0,20.0
16658,1,6658,[ 96  11 427 257 191],416,4,27407,4.1157831506232165,0.0,0.0
16659,1,6659,[ 64 483  12 427  11],214,5,27412,4.115915915915916,60.0,0.0
16660,1,6660,[588 313 202  22 210],505,4,27416,4.115898513736676,20.0,20.0
16661,1,6661,[ 98 276 144 475 174],437,3,27419,4.1157310117081956,0.0,20.0
16662,1,6662,[ 64 483  12 427  11],618,5,27424,4.115863725048777,60.0,0.0
16663,1,6663,[ 64 483  12 427  11],214,5,27429,4.115996398559424,60.0,0.0
16664,1,6664,[174  89  11 173 471],854,3,27432,4.11582895723931,0.0,0.0
16665,1,6665,[ 69  79   8 748 313],416,5,27437,4.115961596159616,20.0,20.0
16666,1,6666,[ 88  79 173 111 603],437,3,27440,4.1157942102894856,0.0,0.0
16667,1,6667,[ 64 483  12 427  11],214,5,27445,4.115926814637072,60.0,0.0
16668,1,6668,[328 385 172 294 191],43,5,27450,4.116059379217274,0.0,0.0
16669,1,6669,[211 405  64 302 111],416,5,27455,4.116191904047976,20.0,0.0
16670,1,6670,[ 64 483  12 427  11],214,5,27460,4.116324389147055,60.0,0.0
16671,1,6671,[ 64 483  12 427  11],214,5,27465,4.116456834532374,60.0,0.0
16672,1,6672,[ 64 483  12 427  11],618,5,27470,4.116589240221789,60.0,0.0
16673,1,6673,[ 64 483  12 427  11],618,5,27475,4.116721606233144,60.0,0.0
16674,1,6674,[ 64 483  12 427  11],618,5,27480,4.116853932584269,60.0,0.0
16675,1,6675,[ 64 483  12 427  11],618,5,27485,4.11698621929299,60.0,0.0
16676,1,6676,[ 64 483  12 427  11],618,5,27490,4.117118466377115,60.0,0.0
16677,1,6677,[181  89  11 180   7],198,4,27494,4.117100928421683,0.0,20.0
16678,1,6678,[ 64 483  12 427  11],214,5,27499,4.117233118730349,60.0,0.0
16679,1,6679,[ 12  97  96 588 357],416,5,27504,4.117365269461078,20.0,0.0
16680,1,6680,[215 118 588 151 111],705,2,27506,4.11704834605598,0.0,0.0
16681,1,6681,[ 64 483  12 427  11],214,5,27511,4.117180484884765,60.0,0.0
16682,1,6682,[ 64 483  12 427  11],618,5,27516,4.117312584168786,60.0,0.0
16683,1,6683,[588 318 197 655  71],437,3,27519,4.117145421903052,20.0,0.0
16684,1,6684,[ 64 483  12 427  11],618,5,27524,4.117277486910995,60.0,0.0
16685,1,6685,[ 64 483  12 427  11],618,5,27529,4.1174095124139996,60.0,0.0
16686,1,6686,[ 64 483  12 427  11],214,5,27534,4.117541498429789,60.0,0.0
16687,1,6687,[ 95 323   4 286 385],43,4,27538,4.117523923444976,0.0,0.0
16688,1,6688,[ 64 483  12 427  11],214,5,27543,4.117655852892809,60.0,0.0
16689,1,6689,[ 64 483  12 427  11],214,5,27548,4.117787742899851,60.0,0.0
16690,1,6690,[ 64 483  12 427  11],214,5,27553,4.1179195934837844,60.0,0.0
16691,1,6691,[127 153   4  95 215],373,4,27557,4.117901972504483,0.0,0.0
16692,1,6692,[357  89 127 132 200],198,5,27562,4.118033766621844,0.0,0.0
16693,1,6693,[ 64 483  12 427  11],618,5,27567,4.118165521362414,60.0,0.0
16694,1,6694,[  9 286 179 273 405],416,4,27571,4.11814787154593,0.0,0.0
16695,1,6695,[ 69 215 323  71 161],416,4,27575,4.118130227001195,0.0,0.0
16696,1,6696,[ 64 483  12 427  11],618,5,27580,4.118261908317157,60.0,0.0
16697,1,6697,[ 64 483  12 427  11],214,5,27585,4.1183935503135265,60.0,0.0
16698,1,6698,[ 64 483  12 427  11],214,5,27590,4.118525153007911,60.0,0.0
16699,1,6699,[151 173 265 200  28],297,2,27592,4.1182089552238805,0.0,0.0
16700,1,6700,[ 64 483  12 427  11],214,5,27597,4.118340546187136,60.0,0.0
16701,1,6701,[ 11 357 228 322  97],417,3,27600,4.118173679498657,0.0,0.0
16702,1,6702,[ 64 483  12 427  11],618,5,27605,4.118305236461286,60.0,0.0
16703,1,6703,[ 64 483  12 427  11],618,5,27610,4.118436754176611,60.0,0.0
16704,1,6704,[ 64 483  12 427  11],214,5,27615,4.118568232662192,60.0,0.0
16705,1,6705,[ 64 483  12 427  11],214,5,27620,4.11869967193558,60.0,0.0
16706,1,6706,[ 88  98  28 235 294],805,1,27621,4.118234680184881,0.0,20.0
16707,1,6707,[ 64 483  12 427  11],214,5,27626,4.118366129994037,60.0,0.0
16708,1,6708,[ 64 483  12 427  11],618,5,27631,4.118497540617081,60.0,0.0
16709,1,6709,[ 64 483  12 427  11],618,5,27636,4.118628912071535,60.0,0.0
16710,1,6710,[176 216 118 215  28],437,1,27637,4.118164208016689,0.0,0.0
16711,1,6711,[235 273 282  64  96],416,4,27641,4.1181466030989275,20.0,0.0
16712,1,6712,[153 275 748  15  50],373,5,27646,4.118277968121555,0.0,20.0
16713,1,6713,[ 64 483  12 427  11],214,5,27651,4.118409294012511,60.0,0.0
16714,1,6714,[322 237  11 144 185],854,2,27653,4.118093819806403,0.0,0.0
16715,1,6715,[423  28 237 215 301],416,4,27657,4.118076235854676,0.0,0.0
16716,1,6716,[ 11 655 215 300 403],198,4,27661,4.1180586571386035,0.0,0.0
16717,1,6717,[  1  98   7 275  22],262,4,27665,4.11804108365585,0.0,20.0
16718,1,6718,[ 64 483  12 427  11],214,5,27670,4.118172347075458,60.0,0.0
16719,1,6719,[  8  97 204  95 144],711,3,27673,4.118005952380952,0.0,0.0
16720,1,6720,[ 64 483  12 427  11],214,5,27678,4.118137181966969,60.0,0.0
16721,1,6721,[ 82 117 238   8 215],416,5,27683,4.118268372508182,0.0,0.0
16722,1,6722,[174 294 153 475 323],416,3,27686,4.118102037780752,0.0,0.0
16723,1,6723,[ 69  89 117 211 135],297,4,27690,4.118084473527662,0.0,0.0
16724,1,6724,[196 183 132  11 318],416,5,27695,4.118215613382899,20.0,0.0
16725,1,6725,[ 56 655 403 742 405],416,5,27700,4.118346714243235,0.0,0.0
16726,1,6726,[ 64 483  12 427  11],214,5,27705,4.118477776126059,60.0,0.0
16727,1,6727,[ 64 483  12 427  11],214,5,27710,4.118608799048752,60.0,0.0
16728,1,6728,[176  95 385 238 183],405,1,27711,4.118145341061079,0.0,0.0
16729,1,6729,[ 64 483  12 427  11],618,5,27716,4.118276374442793,60.0,0.0
16730,1,6730,[210 197  15 237 496],416,4,27720,4.118258802555341,0.0,0.0
16731,1,6731,[ 64 483  12 427  11],618,5,27725,4.118389780154486,60.0,0.0
16732,1,6732,[269 318 216 333 546],416,4,27729,4.118372196643398,20.0,0.0
16733,1,6733,[ 64 483  12 427  11],618,5,27734,4.118503118503119,60.0,0.0
16734,1,6734,[ 28 427 288 318 195],416,5,27739,4.118634001484781,20.0,20.0
16735,1,6735,[ 64 483  12 427  11],214,5,27744,4.118764845605701,60.0,0.0
16736,1,6736,[144  97 118 202 143],297,2,27746,4.118450348819949,0.0,0.0
16737,1,6737,[323  69 235 742 328],43,3,27749,4.118284357376076,0.0,0.0
16738,1,6738,[655 118  64 271 196],62,2,27751,4.1179700252262945,20.0,0.0
16739,1,6739,[ 79 197 174  15 300],416,5,27756,4.118100890207715,0.0,0.0
16740,1,6740,[ 64 483  12 427  11],618,5,27761,4.1182317163625575,60.0,0.0
16741,1,6741,[185 196 300 187  79],416,5,27766,4.118362503708099,0.0,0.0
16742,1,6742,[483 179 125   4 168],417,4,27770,4.118344950318849,20.0,0.0
16743,1,6743,[ 64 483  12 427  11],618,5,27775,4.118475682087782,60.0,0.0
16744,1,6744,[ 25 185 100 288  56],618,3,27778,4.118309859154929,0.0,20.0
16745,1,6745,[ 64 483  12 427  11],618,5,27783,4.118440557367329,60.0,0.0
16746,1,6746,[ 15 215 258 118 186],588,4,27787,4.118423002816066,0.0,0.0
16747,1,6747,[ 64 483  12 427  11],214,5,27792,4.1185536455245995,60.0,0.0
16748,1,6748,[  8  70 302 204  64],721,3,27795,4.1183879093199,20.0,0.0
16749,1,6749,[121 323 475 427 186],198,3,27798,4.118222222222222,0.0,0.0
16750,1,6750,[257  22  96 127   9],62,4,27802,4.118204710413272,0.0,0.0
16751,1,6751,[ 64 483  12 427  11],618,5,27807,4.118335308056872,60.0,0.0
16752,1,6752,[300  56  22  12 211],875,3,27810,4.118169702354509,20.0,0.0
16753,1,6753,[ 64 483  12 427  11],214,5,27815,4.118300266508736,60.0,0.0
16754,1,6754,[403 269 132 508 294],345,3,27818,4.1181347150259064,0.0,0.0
16755,1,6755,[ 64 483  12 427  11],618,5,27823,4.118265245707519,60.0,0.0
16756,1,6756,[ 64 483  12 427  11],618,5,27828,4.118395737753441,60.0,0.0
16757,1,6757,[ 64 483  12 427  11],618,5,27833,4.118526191180822,60.0,0.0
16758,1,6758,[ 64 483  12 427  11],214,5,27838,4.118656606006806,60.0,0.0
16759,1,6759,[ 64 483  12 427  11],214,5,27843,4.118786982248521,60.0,0.0
16760,1,6760,[153 168 475 183 172],62,5,27848,4.118917319923089,0.0,0.0
16761,1,6761,[196 191 168 282 181],128,4,27852,4.1188997338065665,0.0,20.0
16762,1,6762,[183 194 423 135  11],405,3,27855,4.118734289516487,0.0,0.0
16763,1,6763,[ 64 483  12 427  11],618,5,27860,4.11886457717327,60.0,0.0
16764,1,6764,[168  64 197  98 210],128,5,27865,4.1189948263119,20.0,20.0
16765,1,6765,[ 64 483  12 427  11],214,5,27870,4.119125036949453,60.0,0.0
16766,1,6766,[ 64 483  12 427  11],214,5,27875,4.119255209103,60.0,0.0
16767,1,6767,[222 403 313   8 275],588,2,27877,4.11894208037825,20.0,20.0
16768,1,6768,[300 276 118  97 423],43,5,27882,4.119072241099128,0.0,0.0
16769,1,6769,[185 269   8  82 403],711,4,27886,4.119054652880354,0.0,0.0
16770,1,6770,[496 234 173 174  70],417,3,27889,4.118889381184463,0.0,0.0
16771,1,6771,[ 64 483  12 427  11],618,5,27894,4.1190194920259895,60.0,0.0
16772,1,6772,[ 64 483  12 427  11],214,5,27899,4.119149564447069,60.0,0.0
16773,1,6773,[748 603 265  15 191],437,4,27903,4.119131975199291,0.0,0.0
16774,1,6774,[100 405 153 742 181],805,2,27905,4.118819188191882,0.0,20.0
16775,1,6775,[ 25 111 168  69 228],887,4,27909,4.118801652892562,0.0,0.0
16776,1,6776,[ 64 483  12 427  11],214,5,27914,4.1189316806846685,60.0,0.0
16777,1,6777,[ 28 176 234 238 496],437,3,27917,4.118766597816465,0.0,0.0
16778,1,6778,[196 100 234 235 357],417,3,27920,4.118601563652456,0.0,0.0
16779,1,6779,[ 64 483  12 427  11],214,5,27925,4.118731563421829,60.0,0.0
16780,1,6780,[ 64 483  12 427  11],214,5,27930,4.1188615248488425,60.0,0.0
16781,1,6781,[ 64 483  12 427  11],214,5,27935,4.1189914479504575,60.0,0.0
16782,1,6782,[496 172   8 238 196],437,5,27940,4.119121332743624,0.0,0.0
16783,1,6783,[ 64 483  12 427  11],618,5,27945,4.119251179245283,60.0,0.0
16784,1,6784,[403  56  64 194 176],416,5,27950,4.119380987472366,20.0,0.0
16785,1,6785,[269 161 176  82 748],805,2,27952,4.119068670792808,0.0,0.0
16786,1,6786,[228 322  79  50  25],128,2,27954,4.118756446147046,0.0,20.0
16787,1,6787,[ 64 483  12 427  11],618,5,27959,4.118886269888038,60.0,0.0
16788,1,6788,[288 215 216 176 204],297,2,27961,4.118574164088967,0.0,20.0
16789,1,6789,[211   8 269 204 202],297,3,27964,4.11840942562592,0.0,0.0
16790,1,6790,[ 69 132 168 228 216],417,2,27966,4.11809748196142,0.0,0.0
16791,1,6791,[ 64 483  12 427  11],214,5,27971,4.1182273262661955,60.0,0.0
16792,1,6792,[678 568   1 196 333],416,4,27975,4.118209921978507,0.0,0.0
16793,1,6793,[ 22 200 282 111 271],297,1,27976,4.117750956726524,0.0,0.0
16794,1,6794,[191 200 210 196 118],618,3,27979,4.117586460632818,0.0,0.0
16795,1,6795,[ 64 483  12 427  11],618,5,27984,4.117716303708064,60.0,0.0
16796,1,6796,[ 15  79  50 210 245],345,4,27988,4.117698984846256,0.0,20.0
16797,1,6797,[176 257 121 210   9],887,4,27992,4.11768167107973,0.0,0.0
16798,1,6798,[216   4 276  69 197],198,3,27995,4.117517281953228,0.0,0.0
16799,1,6799,[ 64 483  12 427  11],618,5,28000,4.117647058823529,60.0,0.0
16800,1,6800,[ 64 483  12 427  11],618,5,28005,4.117776797529775,60.0,0.0
16801,1,6801,[ 64 483  12 427  11],618,5,28010,4.117906498088797,60.0,0.0
16802,1,6802,[ 50 216 288 127  79],805,2,28012,4.117595178597678,0.0,40.0
16803,1,6803,[ 64 483  12 427  11],618,5,28017,4.117724867724868,60.0,0.0
16804,1,6804,[ 64 483  12 427  11],618,5,28022,4.117854518736223,60.0,0.0
16805,1,6805,[471 125  50 275 173],373,4,28026,4.11783720246841,0.0,20.0
16806,1,6806,[ 64 483  12 427  11],214,5,28031,4.1179667988835025,60.0,0.0
16807,1,6807,[ 64 483  12 427  11],618,5,28036,4.118096357226792,60.0,0.0
16808,1,6808,[423 161  25 186 222],43,4,28040,4.118079013070935,0.0,0.0
16809,1,6809,[ 64 483  12 427  11],618,5,28045,4.118208516886931,60.0,0.0
16810,1,6810,[186 318 202 302 286],43,4,28049,4.118191161356629,20.0,0.0
16811,1,6811,[403 118   1 275 597],618,3,28052,4.118027011156782,0.0,0.0
16812,1,6812,[183  28 132  82 153],62,4,28056,4.118009687362395,0.0,0.0
16813,1,6813,[ 64 483  12 427  11],618,5,28061,4.118139125330202,60.0,0.0
16814,1,6814,[546 191  96 302  56],417,2,28063,4.117828319882612,0.0,0.0
16815,1,6815,[294 597 195   7 322],630,4,28067,4.11781103286385,0.0,0.0
16816,1,6816,[258  89 235 508 196],417,3,28070,4.117647058823529,0.0,0.0
16817,1,6817,[237 245 202 328 183],416,3,28073,4.117483132883543,0.0,0.0
16818,1,6818,[385 173 161 258 289],416,4,28077,4.117465904091509,0.0,0.0
16819,1,6819,[ 71  25 222 235 257],887,2,28079,4.117155425219941,0.0,0.0
16820,1,6820,[211  96  28 215 228],373,4,28083,4.1171382495235305,0.0,0.0
16821,1,6821,[238 269 216 117 268],854,2,28085,4.1168279097039,0.0,0.0
16822,1,6822,[ 64 483  12 427  11],214,5,28090,4.116957350139235,60.0,0.0
16823,1,6823,[172 273  82 276 282],618,3,28093,4.11679366940211,0.0,0.0
16824,1,6824,[204 655 132  11 151],345,5,28098,4.116923076923077,0.0,0.0
16825,1,6825,[179  25  82 202 111],805,2,28100,4.116612950483446,0.0,0.0
16826,1,6826,[ 98 603 176 286 273],416,5,28105,4.116742346565109,0.0,20.0
16827,1,6827,[135 161 173 195 100],805,3,28108,4.116578793204452,0.0,0.0
16828,1,6828,[ 64 483  12 427  11],214,5,28113,4.116708156391859,60.0,0.0
16829,1,6829,[ 64 483  12 427  11],214,5,28118,4.116837481698389,60.0,0.0
16830,1,6830,[ 64 483  12 427  11],214,5,28123,4.116966769140682,60.0,0.0
16831,1,6831,[  7 294 125  64 186],854,2,28125,4.116656908665106,20.0,0.0
16832,1,6832,[ 64 483  12 427  11],618,5,28130,4.116786184691936,60.0,0.0
16833,1,6833,[168   1 403 182 195],618,4,28134,4.116769095697981,0.0,0.0
16834,1,6834,[275 286 742  89 294],764,3,28137,4.116605705925384,0.0,0.0
16835,1,6835,[ 56 238 172 200  82],49,2,28139,4.116296079578701,0.0,0.0
16836,1,6836,[ 64 483  12 427  11],618,5,28144,4.116425332748282,60.0,0.0
16837,1,6837,[ 64 483  12 427  11],214,5,28149,4.116554548113483,60.0,0.0
16838,1,6838,[ 69 300  70 496 748],654,5,28154,4.116683725690891,0.0,0.0
16839,1,6839,[588  88 286 496 265],711,4,28158,4.116666666666666,0.0,0.0
16840,1,6840,[ 64 483  12 427  11],214,5,28163,4.116795790089168,60.0,0.0
16841,1,6841,[ 82 471 275 597 197],416,4,28167,4.11677871967261,0.0,0.0
16842,1,6842,[ 64 483  12 427  11],618,5,28172,4.1169077889814405,60.0,0.0
16843,1,6843,[ 64 483  12 427  11],214,5,28177,4.117036820572764,60.0,0.0
16844,1,6844,[546 121 276 655 222],62,4,28181,4.117019722425128,0.0,0.0
16845,1,6845,[ 64 483  12 427  11],618,5,28186,4.117148699970786,60.0,0.0
16846,1,6846,[ 64 483  12 427  11],214,5,28191,4.117277639842267,60.0,0.0
16847,1,6847,[ 64 483  12 427  11],214,5,28196,4.117406542056075,60.0,0.0
16848,1,6848,[294  50   4 215 288],654,3,28199,4.1172433931960875,0.0,40.0
16849,1,6849,[ 11  79 403 289  95],43,5,28204,4.117372262773722,0.0,0.0
16850,1,6850,[ 64 483  12 427  11],618,5,28209,4.117501094730696,60.0,0.0
16851,1,6851,[ 64 483  12 427  11],618,5,28214,4.11762988908348,60.0,0.0
16852,1,6852,[301 302 235  95 282],297,2,28216,4.117320881365825,0.0,0.0
16853,1,6853,[143 546   7 196 216],297,4,28220,4.11730376422527,0.0,0.0
16854,1,6854,[ 64 483  12 427  11],618,5,28225,4.11743253099927,60.0,0.0
16855,1,6855,[ 64 483  12 427  11],618,5,28230,4.117561260210035,60.0,0.0
16856,1,6856,[121 234 127  22 173],805,2,28232,4.1172524427592245,0.0,0.0
16857,1,6857,[222 183 121 151 200],417,3,28235,4.117089530475357,0.0,0.0
16858,1,6858,[ 64 483  12 427  11],214,5,28240,4.117218253389707,60.0,0.0
16859,1,6859,[ 64 483  12 427  11],214,5,28245,4.11734693877551,60.0,0.0
16860,1,6860,[ 64 483  12 427  11],618,5,28250,4.117475586649176,60.0,0.0
16861,1,6861,[322  88  69  98 403],416,3,28253,4.117312736811425,0.0,20.0
16862,1,6862,[151 655 265 258 222],922,4,28257,4.1172956433046775,0.0,0.0
16863,1,6863,[173 118 603 135 238],805,4,28261,4.117278554778554,0.0,0.0
16864,1,6864,[ 64 483  12 427  11],214,5,28266,4.11740713765477,60.0,0.0
16865,1,6865,[ 64 483  12 427  11],618,5,28271,4.117535683076027,60.0,0.0
16866,1,6866,[ 64 483  12 427  11],214,5,28276,4.117664191058687,60.0,0.0
16867,1,6867,[ 64 483  12 427  11],618,5,28281,4.117792661619103,60.0,0.0
16868,1,6868,[ 64 483  12 427  11],618,5,28286,4.117921094773621,60.0,0.0
16869,1,6869,[ 82  28 185 216 276],416,4,28290,4.117903930131004,0.0,0.0
16870,1,6870,[ 64 483  12 427  11],618,5,28295,4.118032309707466,60.0,0.0
16871,1,6871,[ 64 483  12 427  11],618,5,28300,4.118160651920838,60.0,0.0
16872,1,6872,[ 64 483  12 427  11],618,5,28305,4.1182889567874295,60.0,0.0
16873,1,6873,[483  98 222 275 423],734,4,28309,4.118271748617981,20.0,20.0
16874,1,6874,[ 64 483  12 427  11],618,5,28314,4.1184,60.0,0.0
16875,1,6875,[496  82 132  95  79],230,5,28319,4.118528214077952,0.0,0.0
16876,1,6876,[ 64 483  12 427  11],618,5,28324,4.118656390868111,60.0,0.0
16877,1,6877,[568 153 748  25  95],198,1,28325,4.118202965978482,0.0,0.0
16878,1,6878,[ 64 483  12 427  11],618,5,28330,4.118331152783835,60.0,0.0
16879,1,6879,[183 269 546   8  96],416,4,28334,4.118313953488372,0.0,0.0
16880,1,6880,[ 22  25 195 245 151],416,3,28337,4.118151431477983,0.0,0.0
16881,1,6881,[357 172 301 265 111],416,5,28342,4.118279569892473,0.0,0.0
16882,1,6882,[ 64 483  12 427  11],214,5,28347,4.11840767107366,60.0,0.0
16883,1,6883,[ 64 483  12 427  11],618,5,28352,4.118535735037769,60.0,0.0
16884,1,6884,[234 235 174  97 125],417,3,28355,4.118373275236021,0.0,0.0
16885,1,6885,[288 286 269 405 268],416,5,28360,4.118501306999709,0.0,20.0
16886,1,6886,[185  69 288  25  71],416,5,28365,4.1186293015826925,0.0,20.0
16887,1,6887,[ 64 483  12 427  11],214,5,28370,4.118757259001161,60.0,0.0
16888,1,6888,[ 64 483  12 427  11],214,5,28375,4.118885179271302,60.0,0.0
16889,1,6889,[ 64 483  12 427  11],618,5,28380,4.119013062409289,60.0,0.0
16890,1,6890,[ 64 483  12 427  11],618,5,28385,4.119140908431287,60.0,0.0
16891,1,6891,[ 22  69 655 423 202],416,5,28390,4.119268717353453,0.0,0.0
16892,1,6892,[ 64 483  12 427  11],618,5,28395,4.119396489191934,60.0,0.0
16893,1,6893,[ 64 483  12 427  11],214,5,28400,4.119524223962866,60.0,0.0
16894,1,6894,[403 210 258 100 471],43,4,28404,4.119506889050037,0.0,0.0
16895,1,6895,[268 237  25  79 471],345,3,28407,4.119344547563805,0.0,0.0
16896,1,6896,[117 237 301  28  96],751,4,28411,4.119327243729158,0.0,0.0
16897,1,6897,[ 79 202 181  56  89],751,4,28415,4.119309944911569,0.0,20.0
16898,1,6898,[132 471  97 288 210],921,1,28416,4.118857805479055,0.0,20.0
16899,1,6899,[742 313 245 215  64],345,4,28420,4.118840579710145,40.0,20.0
16900,1,6900,[121 483 405  98 515],417,3,28423,4.118678452398203,20.0,20.0
16901,1,6901,[ 64 483  12 427  11],214,5,28428,4.118806143146914,60.0,0.0
16902,1,6902,[ 64 483  12 427  11],618,5,28433,4.118933796899898,60.0,0.0
16903,1,6903,[294 475 153 195 135],854,3,28436,4.118771726535342,0.0,0.0
16904,1,6904,[  8  71 655 100   1],618,4,28440,4.11875452570601,0.0,0.0
16905,1,6905,[258 273 204 385 748],416,5,28445,4.1188821314798725,0.0,0.0
16906,1,6906,[ 12 100 168 161  25],373,4,28449,4.118864919646735,20.0,0.0
16907,1,6907,[ 28  96 237 153 483],751,4,28453,4.118847712796757,20.0,0.0
16908,1,6908,[ 64 483  12 427  11],618,5,28458,4.118975249674338,60.0,0.0
16909,1,6909,[ 64 483  12 427  11],214,5,28463,4.1191027496382056,60.0,0.0
16910,1,6910,[333 655  88 237  12],416,3,28466,4.118940818984228,20.0,0.0
16911,1,6911,[ 64 483  12 427  11],618,5,28471,4.119068287037037,60.0,0.0
16912,1,6912,[ 64 483  12 427  11],214,5,28476,4.119195718212064,60.0,0.0
16913,1,6913,[655 144  96 180 294],62,2,28478,4.118889210297946,0.0,0.0
16914,1,6914,[ 95 588 276 143 173],437,4,28482,4.1188720173535796,0.0,0.0
16915,1,6915,[  1 173 237 276 228],62,2,28484,4.118565644881435,0.0,0.0
16916,1,6916,[  4  64 183  28 655],405,4,28488,4.118548503686569,20.0,0.0
16917,1,6917,[168 427 183 405 328],416,5,28493,4.118675917895345,0.0,0.0
16918,1,6918,[ 64 483  12 427  11],214,5,28498,4.118803295273883,60.0,0.0
16919,1,6919,[ 64 483  12 427  11],214,5,28503,4.11893063583815,60.0,0.0
16920,1,6920,[322 328  50 235 132],854,2,28505,4.1186244762317585,0.0,20.0
16921,1,6921,[ 64 483  12 427  11],214,5,28510,4.118751805836464,60.0,0.0
16922,1,6922,[323 275 161 385 405],416,4,28514,4.118734652607251,0.0,0.0
16923,1,6923,[ 64 483  12 427  11],214,5,28519,4.1188619295205084,60.0,0.0
16924,1,6924,[238 118   1 127  89],417,5,28524,4.11898916967509,0.0,0.0
16925,1,6925,[222 197  50 179 204],721,5,28529,4.119116373086919,0.0,20.0
16926,1,6926,[ 64 483  12 427  11],618,5,28534,4.119243539771907,60.0,0.0
16927,1,6927,[ 64 483  12 427  11],618,5,28539,4.119370669745958,60.0,0.0
16928,1,6928,[ 22 200 215 265  28],618,5,28544,4.119497763024968,0.0,0.0
16929,1,6929,[ 96 117 268 748  88],907,5,28549,4.1196248196248195,0.0,0.0
16930,1,6930,[ 22 257 180 318   4],854,2,28551,4.119319001587073,20.0,0.0
16931,1,6931,[228 286   1 323 508],417,2,28553,4.119013271783035,0.0,0.0
16932,1,6932,[144 265 204  25 588],416,5,28558,4.119140343285735,0.0,0.0
16933,1,6933,[ 64 483  12 427  11],214,5,28563,4.119267378136717,60.0,0.0
16934,1,6934,[238   8 204 153  50],437,5,28568,4.119394376351838,0.0,20.0
16935,1,6935,[ 96  50  22 194 186],405,3,28571,4.119232987312572,0.0,20.0
16936,1,6936,[ 64 483  12 427  11],214,5,28576,4.119359953870549,60.0,0.0
16937,1,6937,[ 64 483  12 427  11],618,5,28581,4.119486883828192,60.0,0.0
16938,1,6938,[ 56 268 180 423 475],854,4,28585,4.119469664216746,0.0,0.0
16939,1,6939,[235   1 185  25 117],417,2,28587,4.119164265129683,0.0,0.0
16940,1,6940,[ 64 483  12 427  11],618,5,28592,4.119291168419536,60.0,0.0
16941,1,6941,[176 234 186 742  95],230,5,28597,4.119418035148372,0.0,0.0
16942,1,6942,[ 64 483  12 427  11],214,5,28602,4.1195448653319895,60.0,0.0
16943,1,6943,[ 64 483  12 427  11],214,5,28607,4.119671658986175,60.0,0.0
16944,1,6944,[ 64 483  12 427  11],214,5,28612,4.11979841612671,60.0,0.0
16945,1,6945,[ 64 483  12 427  11],214,5,28617,4.119925136769363,60.0,0.0
16946,1,6946,[111 294 210 161   8],805,0,28617,4.119332085792428,0.0,0.0
16947,1,6947,[ 12 182  88   8 194],416,4,28621,4.119314910765688,20.0,0.0
16948,1,6948,[ 64 483  12 427  11],214,5,28626,4.11944164628004,60.0,0.0
16949,1,6949,[237 100 111 186 403],588,1,28627,4.118992805755395,0.0,0.0
16950,1,6950,[597 143 182 238 403],618,4,28631,4.118975686951518,0.0,0.0
16951,1,6951,[ 64 483  12 427  11],214,5,28636,4.119102416570771,60.0,0.0
16952,1,6952,[ 64 483  12 427  11],214,5,28641,4.119229109736804,60.0,0.0
16953,1,6953,[ 64 483  12 427  11],618,5,28646,4.119355766465343,60.0,0.0
16954,1,6954,[588 173 742  11 215],297,3,28649,4.119194823867721,0.0,0.0
16955,1,6955,[ 64 483  12 427  11],618,5,28654,4.119321449108683,60.0,0.0
16956,1,6956,[269 286 196  95 238],43,4,28658,4.119304297829524,0.0,0.0
16957,1,6957,[282 496  22 173  11],618,3,28661,4.119143432020696,0.0,0.0
16958,1,6958,[168 161  64 215  56],405,3,28664,4.1189826124443165,20.0,0.0
16959,1,6959,[144 603 435 302   7],297,3,28667,4.11882183908046,0.0,0.0
16960,1,6960,[288 143 748  97   8],437,3,28670,4.1186611119092085,0.0,20.0
16961,1,6961,[143 127 275 200 403],618,4,28674,4.11864406779661,0.0,0.0
16962,1,6962,[ 64 483  12 427  11],214,5,28679,4.118770644836996,60.0,0.0
16963,1,6963,[ 64 483  12 427  11],618,5,28684,4.11889718552556,60.0,0.0
16964,1,6964,[ 64 483  12 427  11],214,5,28689,4.119023689877961,60.0,0.0
16965,1,6965,[135 275  25 144   1],297,3,28692,4.118863049095607,0.0,0.0
16966,1,6966,[ 64 483  12 427  11],618,5,28697,4.118989522032439,60.0,0.0
16967,1,6967,[289 238 204 655  28],342,3,28700,4.118828932261768,0.0,0.0
16968,1,6968,[ 64 483  12 427  11],618,5,28705,4.11895537379825,60.0,0.0
16969,1,6969,[ 64 483  12 427  11],214,5,28710,4.119081779053085,60.0,0.0
16970,1,6970,[ 64 483  12 427  11],618,5,28715,4.119208148041888,60.0,0.0
16971,1,6971,[ 22  50  12 183   8],875,3,28718,4.119047619047619,20.0,20.0
16972,1,6972,[276   7 286 118 273],764,2,28720,4.118743725799512,0.0,0.0
16973,1,6973,[ 64 483  12 427  11],214,5,28725,4.118870088901635,60.0,0.0
16974,1,6974,[ 64 483  12 427  11],618,5,28730,4.118996415770609,60.0,0.0
16975,1,6975,[328 216 153  22  71],416,5,28735,4.119122706422019,0.0,0.0
16976,1,6976,[258   9 276 568 403],62,4,28739,4.119105632793464,0.0,0.0
16977,1,6977,[301 118 176 172 294],416,4,28743,4.11908856405847,0.0,0.0
16978,1,6978,[286 180 237 191 183],62,3,28746,4.118928213211062,0.0,0.0
16979,1,6979,[385 403   1  64 748],198,3,28749,4.118767908309455,20.0,0.0
16980,1,6980,[200 318 151  97 748],437,4,28753,4.118750895287208,20.0,0.0
16981,1,6981,[ 64 483  12 427  11],618,5,28758,4.118877112575193,60.0,0.0
16982,1,6982,[ 64 483  12 427  11],618,5,28763,4.119003293713304,60.0,0.0
16983,1,6983,[  4 235 385   1 238],416,4,28767,4.118986254295533,0.0,0.0
16984,1,6984,[ 11 132  96  12 742],854,3,28770,4.11882605583393,20.0,0.0
16985,1,6985,[ 64 483  12 427  11],618,5,28775,4.1189521900944746,60.0,0.0
16986,1,6986,[ 64 483  12 427  11],618,5,28780,4.119078288249606,60.0,0.0
16987,1,6987,[222  69 151  12 300],297,2,28782,4.118775042930738,20.0,0.0
16988,1,6988,[175 168 496  50 117],253,3,28785,4.118614966375733,0.0,20.0
16989,1,6989,[118  70 151   1 265],198,2,28787,4.118311874105865,0.0,0.0
16990,1,6990,[ 71 515 268 301  70],416,5,28792,4.118437991703619,0.0,0.0
16991,1,6991,[ 64 483  12 427  11],214,5,28797,4.118564073226545,60.0,0.0
16992,1,6992,[ 64 483  12 427  11],214,5,28802,4.118690118690119,60.0,0.0
16993,1,6993,[ 64 483  12 427  11],618,5,28807,4.118816128109809,60.0,0.0
16994,1,6994,[ 64 483  12 427  11],618,5,28812,4.118942101501072,60.0,0.0
16995,1,6995,[496 151 181 273  15],618,3,28815,4.118782161234991,0.0,20.0
16996,1,6996,[186 748  25 238 181],373,5,28820,4.118908103472917,0.0,20.0
16997,1,6997,[288 196 273 597 271],62,2,28822,4.1186053158045155,0.0,20.0
16998,1,6998,[ 64 483  12 427  11],214,5,28827,4.118731247321046,60.0,0.0
16999,1,6999,[ 64 483  12 427  11],214,5,28832,4.118857142857143,60.0,0.0
17000,1,7000,[ 64 483  12 427  11],214,5,28837,4.118983002428225,60.0,0.0
17001,1,7001,[202 222 210  79 135],417,1,28838,4.118537560696944,0.0,0.0
17002,1,7002,[ 64 483  12 427  11],214,5,28843,4.118663429958589,60.0,0.0
17003,1,7003,[181 301 191 144 121],711,3,28846,4.118503712164477,0.0,20.0
17004,1,7004,[196 268 357 237  11],416,4,28850,4.118486795146324,0.0,0.0
17005,1,7005,[ 15  25 179  95   7],417,3,28853,4.118327148158721,0.0,0.0
17006,1,7006,[ 64 483  12 427  11],618,5,28858,4.118452975595833,60.0,0.0
17007,1,7007,[302 111 597 357 185],417,1,28859,4.1180079908675795,0.0,0.0
17008,1,7008,[ 64 483  12 427  11],618,5,28864,4.1181338279355115,60.0,0.0
17009,1,7009,[ 64 483  12 427  11],214,5,28869,4.118259629101284,60.0,0.0
17010,1,7010,[ 79 228 182 197  25],297,1,28870,4.1178148623591495,0.0,0.0
17011,1,7011,[168 655 172 197   7],198,5,28875,4.117940673131774,0.0,0.0
17012,1,7012,[276   4 173 181 174],198,3,28878,4.11778126336803,0.0,20.0
17013,1,7013,[ 64 483  12 427  11],618,5,28883,4.117907043056744,60.0,0.0
17014,1,7014,[475  82 161 215   4],416,4,28887,4.117890235210264,0.0,0.0
17015,1,7015,[ 64 483  12 427  11],618,5,28892,4.118015963511973,60.0,0.0
17016,1,7016,[ 64 483  12 427  11],214,5,28897,4.118141655978338,60.0,0.0
17017,1,7017,[215 385  64 132  82],405,4,28901,4.118124821886577,20.0,0.0
17018,1,7018,[ 25 294 111   8 183],297,3,28904,4.117965522154153,0.0,0.0
17019,1,7019,[ 64 483  12 427  11],618,5,28909,4.118091168091168,60.0,0.0
17020,1,7020,[ 64 483  12 427  11],618,5,28914,4.118216778236718,60.0,0.0
17021,1,7021,[238  95 121  15 427],416,4,28918,4.118199943036172,0.0,0.0
17022,1,7022,[300  15  79 196  88],128,5,28923,4.118325501922255,0.0,0.0
17023,1,7023,[ 15  79 289 742 301],43,5,28928,4.118451025056948,0.0,0.0
17024,1,7024,[ 64 483  12 427  11],618,5,28933,4.118576512455516,60.0,0.0
17025,1,7025,[ 82 257  12  64 286],416,4,28937,4.118559635639055,40.0,0.0
17026,1,7026,[ 64 483  12 427  11],214,5,28942,4.118685071865661,60.0,0.0
17027,1,7027,[ 64 483  12 427  11],618,5,28947,4.11881047239613,60.0,0.0
17028,1,7028,[ 88 269 588 258 173],711,4,28951,4.118793569497795,0.0,0.0
17029,1,7029,[204 282 435 197 111],721,5,28956,4.118918918918919,0.0,0.0
17030,1,7030,[125 568 185 100  98],230,4,28960,4.118902005404637,0.0,20.0
17031,1,7031,[235  95 174  96  70],417,2,28962,4.118600682593857,0.0,0.0
17032,1,7032,[288 273  50 211 258],297,4,28966,4.1185838191383475,0.0,40.0
17033,1,7033,[ 95 515 258 385   1],417,5,28971,4.118709127096958,0.0,0.0
17034,1,7034,[ 64 483  12 427  11],214,5,28976,4.118834399431415,60.0,0.0
17035,1,7035,[ 64 483  12 427  11],214,5,28981,4.118959636156907,60.0,0.0
17036,1,7036,[ 97 276 289 175   1],43,4,28985,4.118942731277533,0.0,0.0
17037,1,7037,[300 121 216  98 182],198,3,28988,4.118783745382211,0.0,20.0
17038,1,7038,[ 64 483  12 427  11],214,5,28993,4.118908935928399,60.0,0.0
17039,1,7039,[423 275 191  12  22],62,4,28997,4.118892045454546,20.0,0.0
17040,1,7040,[ 64 483  12 427  11],214,5,29002,4.11901718505894,60.0,0.0
17041,1,7041,[176 423 265 655 172],416,5,29007,4.119142289122409,0.0,0.0
17042,1,7042,[ 22 269  25 678 117],805,3,29010,4.118983387760897,0.0,0.0
17043,1,7043,[655 294 328 215   7],314,5,29015,4.119108461101646,0.0,0.0
17044,1,7044,[748 117 222 127 191],805,2,29017,4.118807665010646,0.0,0.0
17045,1,7045,[181  79 176 216 100],805,3,29020,4.11864887879648,0.0,20.0
17046,1,7046,[748 172 496 132  97],505,3,29023,4.118490137647226,0.0,0.0
17047,1,7047,[216   1 276 153 258],416,4,29027,4.118473325766175,0.0,0.0
17048,1,7048,[289 173 294 403  25],345,1,29028,4.118030926372535,0.0,0.0
17049,1,7049,[ 64 483  12 427  11],214,5,29033,4.118156028368794,60.0,0.0
17050,1,7050,[204 328 276  71 144],62,2,29035,4.117855623315842,0.0,0.0
17051,1,7051,[ 79 234  89  95   4],253,5,29040,4.117980714690868,0.0,0.0
17052,1,7052,[ 64 483  12 427  11],214,5,29045,4.118105770594074,60.0,0.0
17053,1,7053,[ 64 483  12 427  11],214,5,29050,4.118230791040545,60.0,0.0
17054,1,7054,[153 269 204 423 471],416,5,29055,4.118355776045358,0.0,0.0
17055,1,7055,[ 64 483  12 427  11],618,5,29060,4.1184807256235825,60.0,0.0
17056,1,7056,[ 64 483  12 427  11],214,5,29065,4.118605639790279,60.0,0.0
17057,1,7057,[ 22 100 257 275  88],416,3,29068,4.118447152167753,0.0,0.0
17058,1,7058,[ 64 483  12 427  11],214,5,29073,4.118572035699107,60.0,0.0
17059,1,7059,[294 228 496 210 168],417,2,29075,4.118271954674221,0.0,0.0
17060,1,7060,[191  56 588 294 121],43,5,29080,4.118396827644809,0.0,0.0
17061,1,7061,[  8 268 196 423 323],416,4,29084,4.118380062305296,0.0,0.0
17062,1,7062,[174   1 294  95   9],764,4,29088,4.118363301713153,0.0,0.0
17063,1,7063,[423 357 200  82 121],417,4,29092,4.118346545866364,0.0,0.0
17064,1,7064,[ 64 483  12 427  11],214,5,29097,4.118471337579618,60.0,0.0
17065,1,7065,[196 300 286 215 515],297,3,29100,4.118313048400792,0.0,0.0
17066,1,7066,[215  64 172  15 216],128,3,29103,4.118154804018678,20.0,0.0
17067,1,7067,[125 357 276 196 475],62,5,29108,4.118279569892473,0.0,0.0
17068,1,7068,[ 64 483  12 427  11],214,5,29113,4.118404300466827,60.0,0.0
17069,1,7069,[ 64 483  12 427  11],618,5,29118,4.118528995756718,60.0,0.0
17070,1,7070,[ 64 483  12 427  11],618,5,29123,4.118653655777118,60.0,0.0
17071,1,7071,[323  69 405 742  11],417,1,29124,4.118212669683258,0.0,0.0
17072,1,7072,[ 96  25 234 125   4],618,1,29125,4.117771808285028,0.0,0.0
17073,1,7073,[179 151 202 168 435],437,3,29128,4.11761379700311,0.0,0.0
17074,1,7074,[286 234 282 333 475],416,4,29132,4.117597173144876,0.0,0.0
17075,1,7075,[ 64 483  12 427  11],214,5,29137,4.1177218767665345,60.0,0.0
17076,1,7076,[  4  70  96  11 132],416,5,29142,4.117846545146248,0.0,0.0
17077,1,7077,[471 275 405 257 143],416,4,29146,4.117829895450693,0.0,0.0
17078,1,7078,[ 97 288 204  28 385],642,4,29150,4.117813250459104,0.0,20.0
17079,1,7079,[ 64 483  12 427  11],214,5,29155,4.117937853107344,60.0,0.0
17080,1,7080,[282  82  56 200 286],416,5,29160,4.118062420562067,0.0,0.0
17081,1,7081,[ 64 483  12 427  11],618,5,29165,4.118186952838181,60.0,0.0
17082,1,7082,[ 64 483  12 427  11],618,5,29170,4.1183114499505855,60.0,0.0
17083,1,7083,[ 64 483  12 427  11],214,5,29175,4.1184359119141725,60.0,0.0
17084,1,7084,[597 276 742 258 313],416,3,29178,4.1182780522230065,20.0,20.0
17085,1,7085,[ 97 195  88 301 210],416,4,29182,4.118261360429015,0.0,0.0
17086,1,7086,[ 64 483  12 427  11],214,5,29187,4.1183857767743755,60.0,0.0
17087,1,7087,[276 328  69 210 143],921,4,29191,4.118369074492099,0.0,0.0
17088,1,7088,[153 427 204   1 132],198,4,29195,4.118352376921992,0.0,0.0
17089,1,7089,[216 471 235 175 195],297,2,29197,4.118053596614951,0.0,0.0
17090,1,7090,[ 64 483  12 427  11],214,5,29202,4.118177972077281,60.0,0.0
17091,1,7091,[ 64 483  12 427  11],618,5,29207,4.118302312464749,60.0,0.0
17092,1,7092,[257 405  15  97 496],654,3,29210,4.118144649654589,0.0,0.0
17093,1,7093,[ 64 483  12 427  11],618,5,29215,4.11826895968424,60.0,0.0
17094,1,7094,[174 403 173 151 257],705,3,29218,4.118111346018323,0.0,0.0
17095,1,7095,[161 742 655   7 100],751,1,29219,4.117671927846674,0.0,0.0
17096,1,7096,[ 64 483  12 427  11],214,5,29224,4.117796251937438,60.0,0.0
17097,1,7097,[ 64 483  12 427  11],214,5,29229,4.117920540997464,60.0,0.0
17098,1,7098,[ 64 483  12 427  11],618,5,29234,4.1180447950415555,60.0,0.0
17099,1,7099,[546  79 228 161 423],417,1,29235,4.117605633802817,0.0,0.0
17100,1,7100,[ 64 483  12 427  11],618,5,29240,4.117729897197578,60.0,0.0
17101,1,7101,[ 64 483  12 427  11],214,5,29245,4.117854125598423,60.0,0.0
17102,1,7102,[ 64 483  12 427  11],618,5,29250,4.117978319020132,60.0,0.0
17103,1,7103,[ 64 483  12 427  11],618,5,29255,4.1181024774774775,60.0,0.0
17104,1,7104,[196  15 475 597  97],417,4,29259,4.1180858550316675,0.0,0.0
17105,1,7105,[204  96 385 175 182],198,2,29261,4.117787784970448,0.0,0.0
17106,1,7106,[ 64 483  12 427  11],618,5,29266,4.117911917827494,60.0,0.0
17107,1,7107,[ 64 483  12 427  11],618,5,29271,4.118036015756894,60.0,0.0
17108,1,7108,[191 271 435 183 471],297,1,29272,4.117597411731608,0.0,0.0
17109,1,7109,[313  15  12 135 117],618,4,29276,4.117580872011252,40.0,20.0
17110,1,7110,[216  79 245 215 328],416,4,29280,4.117564336942765,0.0,0.0
17111,1,7111,[194 176 273 187   9],416,5,29285,4.117688413948256,0.0,0.0
17112,1,7112,[ 64 483  12 427  11],214,5,29290,4.117812456066357,60.0,0.0
17113,1,7113,[ 64 483  12 427  11],214,5,29295,4.117936463311779,60.0,0.0
17114,1,7114,[ 64 483  12 427  11],214,5,29300,4.118060435699227,60.0,0.0
17115,1,7115,[ 64 483  12 427  11],618,5,29305,4.118184373243396,60.0,0.0
17116,1,7116,[ 11 172 196 235  96],805,2,29307,4.117886750035127,0.0,0.0
17117,1,7117,[ 64 228  11  50 202],405,4,29311,4.117870188255128,20.0,20.0
17118,1,7118,[118 268   1  98  28],297,3,29314,4.11771316196095,0.0,20.0
17119,1,7119,[302 153 289  79   4],854,2,29316,4.117415730337079,0.0,0.0
17120,1,7120,[ 28 161 313 179 603],405,2,29318,4.117118382249684,20.0,20.0
17121,1,7121,[ 64 483  12 427  11],214,5,29323,4.117242347655153,60.0,0.0
17122,1,7122,[172 742 168 405  50],654,5,29328,4.117366278253545,0.0,20.0
17123,1,7123,[597 172 117 215 195],705,2,29330,4.1170690623245365,0.0,0.0
17124,1,7124,[ 64 483  12 427  11],214,5,29335,4.117192982456141,60.0,0.0
17125,1,7125,[ 64 483  12 427  11],214,5,29340,4.117316867808027,60.0,0.0
17126,1,7126,[ 64 483  12 427  11],214,5,29345,4.117440718394836,60.0,0.0
17127,1,7127,[132 276 245 185 174],921,1,29346,4.117003367003367,0.0,0.0
17128,1,7128,[  1  50 313 748 187],416,5,29351,4.117127226820031,20.0,40.0
17129,1,7129,[471   8 276 183 333],416,4,29355,4.11711079943899,0.0,0.0
17130,1,7130,[ 64 483  12 427  11],214,5,29360,4.11723460945169,60.0,0.0
17131,1,7131,[403 222 173 265  71],922,4,29364,4.117218171620864,0.0,0.0
17132,1,7132,[  8 153 202 144 742],43,5,29369,4.117341931865975,0.0,0.0
17133,1,7133,[ 11 181   1 132 183],230,4,29373,4.1173254835996635,0.0,20.0
17134,1,7134,[385  69 228 121 288],887,5,29378,4.117449194113525,0.0,20.0
17135,1,7135,[597  88 127 185   7],416,3,29381,4.117292600896861,0.0,0.0
17136,1,7136,[405 268 286 228 294],417,3,29384,4.117136051562281,0.0,0.0
17137,1,7137,[  8 678 172  15 111],721,4,29388,4.117119641356122,0.0,0.0
17138,1,7138,[111  12 168 151 483],588,4,29392,4.117103235747304,40.0,0.0
17139,1,7139,[748 294 568 117  88],642,5,29397,4.117226890756302,0.0,0.0
17140,1,7140,[ 64 483  12 427  11],214,5,29402,4.117350511132894,60.0,0.0
17141,1,7141,[117  71  88 174 313],618,5,29407,4.117474096891627,20.0,20.0
17142,1,7142,[ 64 483  12 427  11],618,5,29412,4.117597648047039,60.0,0.0
17143,1,7143,[153 568 237 258 191],43,5,29417,4.117721164613662,0.0,0.0
17144,1,7144,[200  82 153 191 202],805,3,29420,4.117564730580826,0.0,0.0
17145,1,7145,[ 64 483  12 427  11],214,5,29425,4.117688217184439,60.0,0.0
17146,1,7146,[ 64 483  12 427  11],214,5,29430,4.117811669231846,60.0,0.0
17147,1,7147,[ 64 483  12 427  11],618,5,29435,4.117935086737549,60.0,0.0
17148,1,7148,[ 64 483  12 427  11],618,5,29440,4.118058469716044,60.0,0.0
17149,1,7149,[588 496 568 215  28],128,4,29444,4.118041958041958,0.0,0.0
17150,1,7150,[181  69 237  82   1],262,1,29445,4.117605929240666,0.0,20.0
17151,1,7151,[  1 121 403 228 222],705,4,29449,4.117589485458613,0.0,0.0
17152,1,7152,[ 64 483  12 427  11],214,5,29454,4.117712847756186,60.0,0.0
17153,1,7153,[ 64 483  12 427  11],618,5,29459,4.117836175566117,60.0,0.0
17154,1,7154,[ 64 483  12 427  11],618,5,29464,4.117959468902865,60.0,0.0
17155,1,7155,[ 64 483  12 427  11],618,5,29469,4.118082727780883,60.0,0.0
17156,1,7156,[151 322 100 546 215],416,2,29471,4.117786782171301,0.0,0.0
17157,1,7157,[546  89 268  97 151],297,3,29474,4.117630623079072,0.0,0.0
17158,1,7158,[ 64 483  12 427  11],618,5,29479,4.117753876239698,60.0,0.0
17159,1,7159,[118 151  50 143 161],437,3,29482,4.117597765363128,0.0,20.0
17160,1,7160,[ 64 483  12 427  11],214,5,29487,4.11772098868873,60.0,0.0
17161,1,7161,[ 64 483  12 427  11],618,5,29492,4.117844177604021,60.0,0.0
17162,1,7162,[191 197 427 289 179],416,3,29495,4.1176881195030015,0.0,0.0
17163,1,7163,[655 172 678  15 210],416,4,29499,4.117671691792295,0.0,0.0
17164,1,7164,[197 210 234 175 181],198,3,29502,4.11751570132589,0.0,20.0
17165,1,7165,[ 71 257 182 228  96],62,3,29505,4.117359754395758,0.0,0.0
17166,1,7166,[176 289 475 197 508],854,3,29508,4.1172038509836755,0.0,0.0
17167,1,7167,[ 64 483  12 427  11],214,5,29513,4.117327008928571,60.0,0.0
17168,1,7168,[318 333 273 282 125],253,2,29515,4.117031664109359,20.0,0.0
17169,1,7169,[ 64 483  12 427  11],618,5,29520,4.117154811715481,60.0,0.0
17170,1,7170,[ 64 483  12 427  11],618,5,29525,4.117277924975596,60.0,0.0
17171,1,7171,[238 234   1 275 475],297,3,29528,4.117122141662019,0.0,0.0
17172,1,7172,[ 64 483  12 427  11],214,5,29533,4.117245225149867,60.0,0.0
17173,1,7173,[204 294 301 302 300],43,5,29538,4.1173682743239475,0.0,0.0
17174,1,7174,[173 200 313 588 191],405,3,29541,4.117212543554007,20.0,20.0
17175,1,7175,[172 655 483  98 215],62,3,29544,4.117056856187291,20.0,20.0
17176,1,7176,[237  69 742 173 125],642,5,29549,4.117179880172774,0.0,0.0
17177,1,7177,[ 64 483  12 427  11],618,5,29554,4.11730286988019,60.0,0.0
17178,1,7178,[118  88 237 185 597],416,1,29555,4.11686864465803,0.0,0.0
17179,1,7179,[ 64 483  12 427  11],618,5,29560,4.116991643454039,60.0,0.0
17180,1,7180,[ 64 483  12 427  11],214,5,29565,4.117114607993316,60.0,0.0
17181,1,7181,[161 135 121 111   4],618,3,29568,4.116959064327485,0.0,0.0
17182,1,7182,[265 181 132 176 385],505,4,29572,4.11694278156759,0.0,20.0
17183,1,7183,[ 64 483  12 427  11],214,5,29577,4.11706570155902,60.0,0.0
17184,1,7184,[ 64 483  12 427  11],618,5,29582,4.117188587334725,60.0,0.0
17185,1,7185,[257  64 258 235 475],416,2,29584,4.116893960478708,20.0,0.0
17186,1,7186,[568  96 200 275 302],416,5,29589,4.117016835953805,0.0,0.0
17187,1,7187,[ 64 483  12 427  11],618,5,29594,4.1171396772398445,60.0,0.0
17188,1,7188,[ 64 483  12 427  11],618,5,29599,4.117262484351092,60.0,0.0
17189,1,7189,[117 405   4 111 182],416,5,29604,4.117385257301808,0.0,0.0
17190,1,7190,[ 64 483  12 427  11],618,5,29609,4.1175079961062435,60.0,0.0
17191,1,7191,[ 64 483  12 427  11],618,5,29614,4.117630700778643,60.0,0.0
17192,1,7192,[655  89 100 125 588],253,4,29618,4.11761434728208,0.0,0.0
17193,1,7193,[ 64 483  12 427  11],214,5,29623,4.117737003058104,60.0,0.0
17194,1,7194,[151 143 258 222  15],588,4,29627,4.1177206393328705,0.0,0.0
17195,1,7195,[748 568 132  11 181],505,3,29630,4.117565314063368,0.0,20.0
17196,1,7196,[ 64 483  12 427  11],618,5,29635,4.117687925524524,60.0,0.0
17197,1,7197,[235   8   9 245  22],416,3,29638,4.117532647957766,0.0,0.0
17198,1,7198,[197 508 191  50  79],854,5,29643,4.117655229893041,0.0,20.0
17199,1,7199,[ 96 210 271 328 568],62,2,29645,4.117361111111111,0.0,0.0
17200,1,7200,[ 28   1 191 143 117],128,5,29650,4.11748368282183,0.0,0.0
17201,1,7201,[ 64 483  12 427  11],618,5,29655,4.117606220494308,60.0,0.0
17202,1,7202,[508 174 234  69 294],345,4,29659,4.117589893100098,0.0,0.0
17203,1,7203,[655 127  56 135  50],805,3,29662,4.117434758467518,0.0,20.0
17204,1,7204,[ 64 483  12 427  11],618,5,29667,4.117557251908397,60.0,0.0
17205,1,7205,[ 64 483  12 427  11],618,5,29672,4.117679711351651,60.0,0.0
17206,1,7206,[121 301 300 597 282],416,4,29676,4.117663382822256,0.0,0.0
17207,1,7207,[385  97 200 276 288],618,3,29679,4.11750832408435,0.0,20.0
17208,1,7208,[ 22 385  69 234 288],642,3,29682,4.117353308364544,0.0,20.0
17209,1,7209,[385 200   8 100   4],49,1,29683,4.116920943134535,0.0,0.0
17210,1,7210,[ 64 483  12 427  11],214,5,29688,4.1170434059076415,60.0,0.0
17211,1,7211,[ 64 483  12 427  11],214,5,29693,4.117165834719911,60.0,0.0
17212,1,7212,[ 64 483  12 427  11],214,5,29698,4.117288229585471,60.0,0.0
17213,1,7213,[ 56 234   1 143 204],642,4,29702,4.117271971167175,0.0,0.0
17214,1,7214,[ 15  56 294 427 357],342,2,29704,4.116978516978517,0.0,0.0
17215,1,7215,[ 64 483  12 427  11],214,5,29709,4.11710088691796,60.0,0.0
17216,1,7216,[ 64 483  12 427  11],214,5,29714,4.117223222945823,60.0,0.0
17217,1,7217,[100 748  70 282 655],345,3,29717,4.117068440011083,0.0,0.0
17218,1,7218,[ 64 483  12 427  11],618,5,29722,4.117190746640809,60.0,0.0
17219,1,7219,[655 288 151  64  28],62,2,29724,4.116897506925207,20.0,20.0
17220,1,7220,[ 89  28 216 603 181],297,5,29729,4.1170198033513365,0.0,20.0
17221,1,7221,[174 423 265 132  50],417,2,29731,4.116726668512877,0.0,20.0
17222,1,7222,[ 79 403 302 328 161],43,5,29736,4.116848954727953,0.0,0.0
17223,1,7223,[ 28 235 568  25  79],416,4,29740,4.116832779623477,0.0,0.0
17224,1,7224,[288 237  96 405 275],416,4,29744,4.1168166089965395,0.0,20.0
17225,1,7225,[ 50 176 258 282  88],416,4,29748,4.116800442845281,0.0,20.0
17226,1,7226,[117 403 597 121 301],43,4,29752,4.116784281167843,0.0,0.0
17227,1,7227,[265 597  11  70 183],417,3,29755,4.116629773104593,0.0,0.0
17228,1,7228,[118 194  50  97  70],297,3,29758,4.116475307788076,0.0,20.0
17229,1,7229,[ 64 483  12 427  11],618,5,29763,4.116597510373444,60.0,0.0
17230,1,7230,[275 143   1 210  95],588,4,29767,4.1165813857004565,0.0,0.0
17231,1,7231,[ 64 483  12 427  11],618,5,29772,4.116703539823009,60.0,0.0
17232,1,7232,[427 245 282 187 403],416,4,29776,4.116687404949537,0.0,0.0
17233,1,7233,[185 200 475 271 748],297,2,29778,4.116394802322366,0.0,0.0
17234,1,7234,[ 88 742 294  25 322],805,1,29779,4.1159640635798205,0.0,0.0
17235,1,7235,[ 64 483  12 427  11],214,5,29784,4.11608623548922,60.0,0.0
17236,1,7236,[ 64 483  12 427  11],618,5,29789,4.116208373635485,60.0,0.0
17237,1,7237,[  9 174 121 172  96],62,5,29794,4.116330478032606,0.0,0.0
17238,1,7238,[144  25 143 151 475],805,3,29797,4.116176267440254,0.0,0.0
17239,1,7239,[ 64 483  12 427  11],214,5,29802,4.116298342541437,60.0,0.0
17240,1,7240,[271 153 302 655 237],62,1,29803,4.115867974036735,0.0,0.0
17241,1,7241,[ 64 483  12 427  11],618,5,29808,4.115990057995029,60.0,0.0
17242,1,7242,[ 64 483  12 427  11],214,5,29813,4.116112108242441,60.0,0.0
17243,1,7243,[ 98 111 144 222 237],654,5,29818,4.116234124792932,0.0,20.0
17244,1,7244,[515 235  79 234 423],417,3,29821,4.11608005521049,0.0,0.0
17245,1,7245,[181  50 742 168 588],654,4,29825,4.1160640353298374,0.0,40.0
17246,1,7246,[300 174  56 597  22],416,4,29829,4.116048019870291,0.0,0.0
17247,1,7247,[234  82  98 215 301],437,2,29831,4.115756070640177,0.0,20.0
17248,1,7248,[275 228 427 257 265],705,3,29834,4.115602152020968,0.0,0.0
17249,1,7249,[301 168 181 475 508],49,2,29836,4.115310344827586,0.0,20.0
17250,1,7250,[ 64 483  12 427  11],618,5,29841,4.115432354158047,60.0,0.0
17251,1,7251,[322 125 357 168 191],416,4,29845,4.115416436845008,0.0,0.0
17252,1,7252,[ 64 483  12 427  11],618,5,29850,4.115538397904316,60.0,0.0
17253,1,7253,[234 127 168 258 182],198,4,29854,4.11552247036118,0.0,0.0
17254,1,7254,[ 64 483  12 427  11],618,5,29859,4.115644383184011,60.0,0.0
17255,1,7255,[588 385  25  95 143],751,5,29864,4.115766262403528,0.0,0.0
17256,1,7256,[ 64 483  12 427  11],214,5,29869,4.115888108033623,60.0,0.0
17257,1,7257,[181 127 471  56 496],887,3,29872,4.115734362083218,0.0,20.0
17258,1,7258,[568 121  97 118 173],128,4,29876,4.115718418514947,0.0,0.0
17259,1,7259,[144 483 257 168 161],711,3,29879,4.115564738292011,20.0,0.0
17260,1,7260,[  1  98  25 245 197],345,2,29881,4.115273378322545,0.0,20.0
17261,1,7261,[655 483 597   1 588],618,5,29886,4.115395207931699,20.0,0.0
17262,1,7262,[323 172 135  50 183],417,1,29887,4.114966267382624,0.0,20.0
17263,1,7263,[ 64 483  12 427  11],214,5,29892,4.115088105726873,60.0,0.0
17264,1,7264,[748  71 118 176 180],198,1,29893,4.114659325533379,0.0,0.0
17265,1,7265,[118 269 427 182   1],416,4,29897,4.1146435452793835,0.0,0.0
17266,1,7266,[ 25 234 168 174  70],230,4,29901,4.1146277693683775,0.0,0.0
17267,1,7267,[ 64 483  12 427  11],214,5,29906,4.1147495872317,60.0,0.0
17268,1,7268,[ 64 483  12 427  11],214,5,29911,4.114871371577934,60.0,0.0
17269,1,7269,[568  56  15 234 294],253,4,29915,4.114855570839064,0.0,0.0
17270,1,7270,[ 64 483  12 427  11],618,5,29920,4.114977307110439,60.0,0.0
17271,1,7271,[ 64 483  12 427  11],214,5,29925,4.11509900990099,60.0,0.0
17272,1,7272,[742 117 475  95 191],417,4,29929,4.115083184380586,0.0,0.0
17273,1,7273,[191 161  56  96  25],416,5,29934,4.115204839153148,0.0,0.0
17274,1,7274,[153 216 405 238 161],230,4,29938,4.115189003436426,0.0,0.0
17275,1,7275,[143 118 117 515  97],297,4,29942,4.115173172072567,0.0,0.0
17276,1,7276,[ 64 483  12 427  11],618,5,29947,4.1152947643259585,60.0,0.0
17277,1,7277,[471 181 191 427 143],373,3,29950,4.115141522396263,0.0,20.0
17278,1,7278,[ 95 111 475 238 215],437,2,29952,4.114850941063333,0.0,0.0
17279,1,7279,[ 12   4  64 111  82],43,5,29957,4.114972527472528,40.0,0.0
17280,1,7280,[118 403 172 276 121],416,3,29960,4.114819392940531,0.0,0.0
17281,1,7281,[ 64 483  12 427  11],214,5,29965,4.114940950288382,60.0,0.0
17282,1,7282,[ 79  88 180 748 328],373,4,29969,4.1149251681999175,0.0,0.0
17283,1,7283,[ 64 483  12 427  11],214,5,29974,4.1150466776496435,60.0,0.0
17284,1,7284,[ 11 143 173 132 273],416,5,29979,4.115168153740563,0.0,0.0
17285,1,7285,[196 191  56 195 151],297,2,29981,4.1148778479275325,0.0,0.0
17286,1,7286,[174 200 191  79 204],416,5,29986,4.114999313846576,0.0,0.0
17287,1,7287,[ 89  11 204 185 121],437,2,29988,4.114709110867179,0.0,0.0
17288,1,7288,[289 204   7 118 423],588,1,29989,4.11428179448484,0.0,0.0
17289,1,7289,[ 64 483  12 427  11],214,5,29994,4.11440329218107,60.0,0.0
17290,1,7290,[ 64 483  12 427  11],618,5,29999,4.11452475654917,60.0,0.0
17291,1,7291,[268 286 211  64  25],416,5,30004,4.114646187602853,20.0,0.0
17292,1,7292,[228 238  50 195 175],405,3,30007,4.114493349787468,0.0,20.0
17293,1,7293,[168 143 273 222 588],805,2,30009,4.114203454894434,0.0,0.0
17294,1,7294,[196 269  28  12 294],805,2,30011,4.113913639479096,20.0,0.0
17295,1,7295,[ 71 282 185 318 257],223,4,30015,4.113898026315789,20.0,0.0
17296,1,7296,[ 64 483  12 427  11],618,5,30020,4.114019460052076,60.0,0.0
17297,1,7297,[ 64 483  12 427  11],214,5,30025,4.114140860509728,60.0,0.0
17298,1,7298,[ 64 483  12 427  11],214,5,30030,4.114262227702425,60.0,0.0
17299,1,7299,[588 288  28 180  64],405,3,30033,4.114109589041096,20.0,20.0
17300,1,7300,[276 286 132 135 144],437,3,30036,4.1139569921928505,0.0,0.0
17301,1,7301,[151 603  12  28 211],373,4,30040,4.113941385921665,20.0,0.0
17302,1,7302,[ 96 132   4 135 117],373,3,30043,4.1137888538956595,0.0,0.0
17303,1,7303,[ 64 483  12 427  11],618,5,30048,4.113910186199343,60.0,0.0
17304,1,7304,[ 64 483  12 427  11],618,5,30053,4.114031485284052,60.0,0.0
17305,1,7305,[ 64 483  12 427  11],214,5,30058,4.114152751163427,60.0,0.0
17306,1,7306,[ 64 483  12 427  11],214,5,30063,4.114273983851102,60.0,0.0
17307,1,7307,[ 64 483  12 427  11],618,5,30068,4.114395183360701,60.0,0.0
17308,1,7308,[ 64 483  12 427  11],618,5,30073,4.114516349705842,60.0,0.0
17309,1,7309,[ 56 678  28 172 228],721,3,30076,4.1143638850889195,0.0,0.0
17310,1,7310,[180 172 546 125 235],62,5,30081,4.114485022568732,0.0,0.0
17311,1,7311,[186  28  22 174  69],230,5,30086,4.114606126914661,0.0,0.0
17312,1,7312,[181  64  56 328  12],43,5,30091,4.114727198140298,40.0,20.0
17313,1,7313,[194 235 210 475 161],416,3,30094,4.114574788077659,0.0,0.0
17314,1,7314,[238 216 183 268  11],297,5,30099,4.114695830485304,0.0,0.0
17315,1,7315,[  4  15 288 111  71],62,2,30101,4.114406779661017,0.0,20.0
17316,1,7316,[175 100 183 222 405],805,4,30105,4.114391143911439,0.0,0.0
17317,1,7317,[ 64 483  12 427  11],618,5,30110,4.11451216179284,60.0,0.0
17318,1,7318,[ 88 202 257 179  56],416,2,30112,4.114223254542971,0.0,0.0
17319,1,7319,[237 496  71 483 294],128,5,30117,4.114344262295082,20.0,0.0
17320,1,7320,[ 64 483  12 427  11],618,5,30122,4.114465236989482,60.0,0.0
17321,1,7321,[ 64 483  12 427  11],214,5,30127,4.1145861786397155,60.0,0.0
17322,1,7322,[302   1   4  11 196],43,5,30132,4.11470708725932,0.0,0.0
17323,1,7323,[118  71   7  89 174],198,3,30135,4.114554888039323,0.0,0.0
17324,1,7324,[ 64 483  12 427  11],618,5,30140,4.114675767918088,60.0,0.0
17325,1,7325,[ 82 172 403 200 202],618,4,30144,4.114660114660115,0.0,0.0
17326,1,7326,[269 546   7 265 318],416,4,30148,4.114644465674901,20.0,0.0
17327,1,7327,[ 64 483  12 427  11],214,5,30153,4.114765283842795,60.0,0.0
17328,1,7328,[121 216  79 204  95],654,5,30158,4.1148860690407965,0.0,0.0
17329,1,7329,[ 64 483  12 427  11],214,5,30163,4.115006821282401,60.0,0.0
17330,1,7330,[ 64 483  12 427  11],214,5,30168,4.115127540581094,60.0,0.0
17331,1,7331,[258  64 385   1 655],416,5,30173,4.115248226950355,20.0,0.0
17332,1,7332,[ 64 483  12 427  11],618,5,30178,4.115368880403655,60.0,0.0
17333,1,7333,[153 191 435 174 172],437,4,30182,4.115353149713663,0.0,0.0
17334,1,7334,[ 64 483  12 427  11],214,5,30187,4.115473755964554,60.0,0.0
17335,1,7335,[655  69 144 235   4],416,4,30191,4.115458015267175,0.0,0.0
17336,1,7336,[187 125 180 174  50],373,3,30194,4.11530598337195,0.0,20.0
17337,1,7337,[ 64 483  12 427  11],618,5,30199,4.115426546742982,60.0,0.0
17338,1,7338,[ 64 483  12 427  11],214,5,30204,4.115547077258482,60.0,0.0
17339,1,7339,[ 64 483  12 427  11],618,5,30209,4.11566757493188,60.0,0.0
17340,1,7340,[ 64 483  12 427  11],618,5,30214,4.115788039776597,60.0,0.0
17341,1,7341,[111 151 300 333  88],345,3,30217,4.1156360664669025,0.0,0.0
17342,1,7342,[265 111  28  79  98],128,4,30221,4.115620318670843,0.0,20.0
17343,1,7343,[275 194 132  96 153],854,3,30224,4.1154684095860565,0.0,0.0
17344,1,7344,[ 64 483  12 427  11],214,5,30229,4.115588835942818,60.0,0.0
17345,1,7345,[ 64 483  12 427  11],618,5,30234,4.11570922951266,60.0,0.0
17346,1,7346,[ 64 483  12 427  11],618,5,30239,4.115829590308969,60.0,0.0
17347,1,7347,[ 88  98 323 597  82],805,2,30241,4.115541643984757,0.0,20.0
17348,1,7348,[ 64 483  12 427  11],214,5,30246,4.115661994829228,60.0,0.0
17349,1,7349,[ 64 483  12 427  11],618,5,30251,4.1157823129251705,60.0,0.0
17350,1,7350,[ 64 483  12 427  11],618,5,30256,4.115902598285947,60.0,0.0
17351,1,7351,[273 211 187  50 328],416,5,30261,4.116022850924918,0.0,20.0
17352,1,7352,[186   8 117 181 183],437,2,30263,4.115735074119407,0.0,20.0
17353,1,7353,[ 64 483  12 427  11],618,5,30268,4.115855316834375,60.0,0.0
17354,1,7354,[121  28 172 176 228],230,4,30272,4.115839564921822,0.0,0.0
17355,1,7355,[ 64 483  12 427  11],214,5,30277,4.115959760739532,60.0,0.0
17356,1,7356,[ 64 483  12 427  11],214,5,30282,4.116079923882017,60.0,0.0
17357,1,7357,[204 322  69  88  11],416,3,30285,4.115928241369938,0.0,0.0
17358,1,7358,[ 64 483  12 427  11],214,5,30290,4.116048376138062,60.0,0.0
17359,1,7359,[ 64 483  12 427  11],618,5,30295,4.116168478260869,60.0,0.0
17360,1,7360,[132 546 197  15 143],416,4,30299,4.116152696644478,0.0,0.0
17361,1,7361,[ 64 483  12 427  11],618,5,30304,4.116272751969573,60.0,0.0
17362,1,7362,[ 64 483  12 427  11],214,5,30309,4.116392774684232,60.0,0.0
17363,1,7363,[ 64 483  12 427  11],618,5,30314,4.1165127648017386,60.0,0.0
17364,1,7364,[385 228 588  82  95],417,3,30317,4.116361167684997,0.0,0.0
17365,1,7365,[143  71  79 257 222],711,2,30319,4.116073852837361,0.0,0.0
17366,1,7366,[ 64 483  12 427  11],214,5,30324,4.116193837382924,60.0,0.0
17367,1,7367,[182 191  70 180 179],128,3,30327,4.116042345276873,0.0,0.0
17368,1,7368,[475  56 132 182  70],437,2,30329,4.115755190663591,0.0,0.0
17369,1,7369,[181 286   7 655 265],588,3,30332,4.115603799185889,0.0,20.0
17370,1,7370,[ 64 483  12 427  11],618,5,30337,4.115723782390449,60.0,0.0
17371,1,7371,[ 64 483  12 427  11],214,5,30342,4.11584373304395,60.0,0.0
17372,1,7372,[ 64 483  12 427  11],618,5,30347,4.115963651159636,60.0,0.0
17373,1,7373,[ 64 483  12 427  11],618,5,30352,4.116083536750746,60.0,0.0
17374,1,7374,[ 64 483  12 427  11],618,5,30357,4.116203389830509,60.0,0.0
17375,1,7375,[175 405 742 403 215],43,4,30361,4.116187635574837,0.0,0.0
17376,1,7376,[202 181 313 423 187],405,5,30366,4.116307442049614,20.0,40.0
17377,1,7377,[475 144  82 496 235],416,3,30369,4.116156139875305,0.0,0.0
17378,1,7378,[181   1 496 483 210],618,4,30373,4.116140398427971,20.0,20.0
17379,1,7379,[ 64 483  12 427  11],214,5,30378,4.116260162601626,60.0,0.0
17380,1,7380,[195 328 742 237 301],416,4,30382,4.116244411326378,0.0,0.0
17381,1,7381,[322 196   9 603 183],805,2,30384,4.115957735031157,0.0,0.0
17382,1,7382,[ 22  95 423 174  56],642,4,30388,4.115942028985507,0.0,0.0
17383,1,7383,[  7 111 423 216  11],618,3,30391,4.1157908992416035,0.0,0.0
17384,1,7384,[ 64 483  12 427  11],618,5,30396,4.115910629654706,60.0,0.0
17385,1,7385,[ 22 100 151 496 202],588,2,30398,4.115624153804495,0.0,0.0
17386,1,7386,[ 64 483  12 427  11],214,5,30403,4.1157438743739,60.0,0.0
17387,1,7387,[ 64 483  12 427  11],618,5,30408,4.115863562533838,60.0,0.0
17388,1,7388,[ 64 483  12 427  11],618,5,30413,4.115983218297469,60.0,0.0
17389,1,7389,[289 568 111 333 168],588,3,30416,4.115832205683356,0.0,0.0
17390,1,7390,[ 50 269   8 405 546],805,2,30418,4.115545934244351,0.0,20.0
17391,1,7391,[211 245 678   7  71],416,3,30421,4.115395021645021,0.0,0.0
17392,1,7392,[ 64 483  12 427  11],618,5,30426,4.115514676044907,60.0,0.0
17393,1,7393,[ 64 483  12 427  11],618,5,30431,4.115634298079524,60.0,0.0
17394,1,7394,[588 161 174 121 234],805,1,30432,4.115212981744422,0.0,0.0
17395,1,7395,[100  12 132  69 151],854,5,30437,4.115332612222823,20.0,0.0
17396,1,7396,[ 70 191 182   8 143],618,3,30440,4.115181830471813,0.0,0.0
17397,1,7397,[197 183 111  88 173],416,4,30444,4.115166261151662,0.0,0.0
17398,1,7398,[ 28 588 300  98 423],43,5,30449,4.115285849439114,0.0,20.0
17399,1,7399,[235  98 222 144 127],805,2,30451,4.115,0.0,20.0
17400,1,7400,[ 70 179 427 144 288],416,4,30455,4.114984461559248,0.0,20.0
17401,1,7401,[ 64 483  12 427  11],618,5,30460,4.115104025938935,60.0,0.0
17402,1,7402,[ 64 483  12 427  11],618,5,30465,4.1152235580170204,60.0,0.0
17403,1,7403,[ 64 483  12 427  11],618,5,30470,4.115343057806591,60.0,0.0
17404,1,7404,[ 64 483  12 427  11],214,5,30475,4.115462525320729,60.0,0.0
17405,1,7405,[ 64 483  12 427  11],618,5,30480,4.115581960572508,60.0,0.0
17406,1,7406,[132 196  82  71 268],128,3,30483,4.11543134872418,0.0,0.0
17407,1,7407,[228 215 435  82 568],373,4,30487,4.115415766738661,0.0,0.0
17408,1,7408,[ 64 483  12 427  11],214,5,30492,4.115535159940613,60.0,0.0
17409,1,7409,[ 64 483  12 427  11],618,5,30497,4.115654520917679,60.0,0.0
17410,1,7410,[  8  64 174 273 275],854,4,30501,4.115638915126164,20.0,0.0
17411,1,7411,[ 64 483  12 427  11],214,5,30506,4.115758229897463,60.0,0.0
17412,1,7412,[ 64 483  12 427  11],618,5,30511,4.115877512478079,60.0,0.0
17413,1,7413,[ 79 385  12 185   9],805,3,30514,4.115727002967359,20.0,0.0
17414,1,7414,[181   1 153 588  22],805,2,30516,4.115441672285907,0.0,20.0
17415,1,7415,[ 64 483  12 427  11],214,5,30521,4.115560949298813,60.0,0.0
17416,1,7416,[258 211 403 276 313],416,4,30525,4.115545368747472,20.0,20.0
17417,1,7417,[ 64   8 603 269 168],214,3,30528,4.115394985171205,20.0,0.0
17418,1,7418,[238   4 100 210 151],373,4,30532,4.1153794311901875,0.0,0.0
17419,1,7419,[ 64 483  12 427  11],618,5,30537,4.115498652291105,60.0,0.0
17420,1,7420,[ 64 483  12 427  11],618,5,30542,4.115617841261286,60.0,0.0
17421,1,7421,[ 64 483  12 427  11],214,5,30547,4.115736998113716,60.0,0.0
17422,1,7422,[ 64 483  12 427  11],214,5,30552,4.115856122861377,60.0,0.0
17423,1,7423,[ 98 100 742 132 117],416,5,30557,4.115975215517241,0.0,20.0
17424,1,7424,[ 64 483  12 427  11],618,5,30562,4.116094276094276,60.0,0.0
17425,1,7425,[471 265  22 153  89],373,4,30566,4.116078642607056,0.0,0.0
17426,1,7426,[185 742 322 288 405],417,0,30566,4.115524437861855,0.0,20.0
17427,1,7427,[ 64 483  12 427  11],618,5,30571,4.115643511039311,60.0,0.0
17428,1,7428,[  8  71 405 322  96],416,4,30575,4.115627944541661,0.0,0.0
17429,1,7429,[ 82  71 228 234 161],230,4,30579,4.115612382234186,0.0,0.0
17430,1,7430,[ 96  15 191 282 300],416,5,30584,4.115731395505316,0.0,0.0
17431,1,7431,[125 313 258 197 200],416,5,30589,4.115850376749193,20.0,20.0
17432,1,7432,[ 64 483  12 427  11],618,5,30594,4.115969325978743,60.0,0.0
17433,1,7433,[ 64 483  12 427  11],618,5,30599,4.116088243206887,60.0,0.0
17434,1,7434,[ 64 483  12 427  11],214,5,30604,4.116207128446536,60.0,0.0
17435,1,7435,[ 64 483  12 427  11],618,5,30609,4.116325981710597,60.0,0.0
17436,1,7436,[197 182  95 748 265],437,3,30612,4.1161758773699075,0.0,0.0
17437,1,7437,[ 64 483  12 427  11],618,5,30617,4.116294702877117,60.0,0.0
17438,1,7438,[ 64 483  12 427  11],618,5,30622,4.116413496437693,60.0,0.0
17439,1,7439,[ 64 483  12 427  11],618,5,30627,4.116532258064516,60.0,0.0
17440,1,7440,[204  89 235 257 174],922,3,30630,4.1163822066926485,0.0,0.0
17441,1,7441,[204  70  98 143 268],416,5,30635,4.116500940607364,0.0,20.0
17442,1,7442,[ 64 483  12 427  11],618,5,30640,4.116619642617224,60.0,0.0
17443,1,7443,[258 322  28 179  70],721,3,30643,4.116469639978506,0.0,0.0
17444,1,7444,[655  15  25  98 111],128,2,30645,4.116185359301545,0.0,20.0
17445,1,7445,[ 64 483  12 427  11],214,5,30650,4.116304055868923,60.0,0.0
17446,1,7446,[ 64 483  12 427  11],618,5,30655,4.116422720558615,60.0,0.0
17447,1,7447,[181  56 588 742 174],43,5,30660,4.116541353383458,0.0,20.0
17448,1,7448,[117 111 405  11 235],416,4,30664,4.116525708148745,0.0,0.0
17449,1,7449,[ 82 385  12  50  98],805,3,30667,4.116375838926174,20.0,40.0
17450,1,7450,[ 64 483  12 427  11],214,5,30672,4.1164944302778155,60.0,0.0
17451,1,7451,[ 11 496  79  95 288],437,3,30675,4.1163446054750406,0.0,20.0
17452,1,7452,[ 69 200   4 185 301],297,2,30677,4.116060646719442,0.0,0.0
17453,1,7453,[117 173  95 196   4],618,2,30679,4.115776764153475,0.0,0.0
17454,1,7454,[302 235 187 282 210],416,4,30683,4.115761234071093,0.0,0.0
17455,1,7455,[655 100 228  50 197],373,3,30686,4.1156115879828326,0.0,20.0
17456,1,7456,[153 405 235 144 135],854,3,30689,4.115461982030307,0.0,0.0
17457,1,7457,[276 222 161 172 385],43,5,30694,4.115580584607133,0.0,0.0
17458,1,7458,[ 64 483  12 427  11],618,5,30699,4.115699155382759,60.0,0.0
17459,1,7459,[ 64 483  12 427  11],214,5,30704,4.115817694369973,60.0,0.0
17460,1,7460,[403 127   7   8 125],618,3,30707,4.115668140999866,0.0,0.0
17461,1,7461,[200 210 196  82 302],405,3,30710,4.11551862771375,0.0,0.0
17462,1,7462,[ 64 483  12 427  11],618,5,30715,4.115637143239984,60.0,0.0
17463,1,7463,[ 64 483  12 427  11],214,5,30720,4.115755627009646,60.0,0.0
17464,1,7464,[222 183  89 174  25],805,4,30724,4.115740120562625,0.0,0.0
17465,1,7465,[ 64 483  12 427  11],214,5,30729,4.115858558799893,60.0,0.0
17466,1,7466,[289 161  82 597  22],588,4,30733,4.115843042721307,0.0,0.0
17467,1,7467,[ 64 483  12 427  11],618,5,30738,4.115961435457954,60.0,0.0
17468,1,7468,[181  56 161 237   8],721,3,30741,4.115812023028518,0.0,20.0
17469,1,7469,[ 64 483  12 427  11],214,5,30746,4.115930388219545,60.0,0.0
17470,1,7470,[ 25 210 323   7 258],805,3,30749,4.115781019943783,0.0,0.0
17471,1,7471,[ 82 742 423  12 100],62,3,30752,4.115631691648822,20.0,0.0
17472,1,7472,[118   7 357  79 238],805,4,30756,4.11561621838619,0.0,0.0
17473,1,7473,[ 64 483  12 427  11],214,5,30761,4.115734546427616,60.0,0.0
17474,1,7474,[111 268 181 300 568],416,5,30766,4.115852842809365,0.0,20.0
17475,1,7475,[176 151 132 143  71],618,4,30770,4.115837346174425,0.0,0.0
17476,1,7476,[ 64 483  12 427  11],618,5,30775,4.115955597164638,60.0,0.0
17477,1,7477,[ 64 483  12 427  11],214,5,30780,4.116073816528483,60.0,0.0
17478,1,7478,[197 117 183 475 100],805,4,30784,4.116058296563712,0.0,0.0
17479,1,7479,[ 64 483  12 427  11],618,5,30789,4.116176470588235,60.0,0.0
17480,1,7480,[269  88 185 265 568],711,3,30792,4.116027269081673,0.0,0.0
17481,1,7481,[318 742 258   7 161],588,4,30796,4.11601176156108,20.0,0.0
17482,1,7482,[ 64 483  12 427  11],618,5,30801,4.1161298944273685,60.0,0.0
17483,1,7483,[185 318 210 546 200],416,4,30805,4.116114377338322,20.0,0.0
17484,1,7484,[ 25  70 323  79 237],416,3,30808,4.115965263861056,0.0,0.0
17485,1,7485,[ 64 483  12 427  11],214,5,30813,4.116083355597115,60.0,0.0
17486,1,7486,[ 64 483  12 427  11],214,5,30818,4.116201415787365,60.0,0.0
17487,1,7487,[ 64 483  12 427  11],214,5,30823,4.116319444444445,60.0,0.0
17488,1,7488,[ 64 483  12 427  11],618,5,30828,4.1164374415809855,60.0,0.0
17489,1,7489,[ 64 483  12 427  11],618,5,30833,4.116555407209613,60.0,0.0
17490,1,7490,[ 64 483  12 427  11],618,5,30838,4.116673341342945,60.0,0.0
17491,1,7491,[ 95 121 210 197 180],805,1,30839,4.116257341163908,0.0,0.0
17492,1,7492,[ 64 483  12 427  11],618,5,30844,4.116375283598025,60.0,0.0
17493,1,7493,[135  28 210   1  95],642,4,30848,4.116359754470243,0.0,0.0
17494,1,7494,[ 64 483  12 427  11],214,5,30853,4.116477651767846,60.0,0.0
17495,1,7495,[ 64 483  12 427  11],214,5,30858,4.116595517609392,60.0,0.0
17496,1,7496,[ 64 483  12 427  11],618,5,30863,4.116713352007469,60.0,0.0
17497,1,7497,[151   7 235 288 135],297,2,30865,4.116431048279542,0.0,20.0
17498,1,7498,[ 64 483  12 427  11],214,5,30870,4.116548873183091,60.0,0.0
17499,1,7499,[403 655 176 204 196],805,2,30872,4.116266666666666,0.0,0.0
17500,1,7500,[174 210 121 257 204],43,5,30877,4.116384482069058,0.0,0.0
17501,1,7501,[ 64 483  12 427  11],214,5,30882,4.116502266062383,60.0,0.0
17502,1,7502,[ 64 483  12 427  11],214,5,30887,4.116620018659203,60.0,0.0
17503,1,7503,[ 64 483  12 427  11],618,5,30892,4.116737739872068,60.0,0.0
17504,1,7504,[ 50 132  88 588 161],345,3,30895,4.116588940706196,0.0,20.0
17505,1,7505,[ 64 483  12 427  11],618,5,30900,4.116706634692246,60.0,0.0
17506,1,7506,[ 64 483  12 427  11],618,5,30905,4.116824297322499,60.0,0.0
17507,1,7507,[ 64 483  12 427  11],214,5,30910,4.116941928609483,60.0,0.0
17508,1,7508,[183 174 405 603 282],416,5,30915,4.117059528565721,0.0,0.0
17509,1,7509,[ 96 742 151  56 202],505,2,30917,4.116777629826897,0.0,0.0
17510,1,7510,[483  64 111 182 181],62,4,30921,4.116762082279323,40.0,20.0
17511,1,7511,[237 151 268 195   4],297,2,30923,4.116480298189563,0.0,0.0
17512,1,7512,[275 168 385 588 161],618,4,30927,4.116464794356449,0.0,0.0
17513,1,7513,[121 294   1 568 100],62,2,30929,4.116183124833644,0.0,0.0
17514,1,7514,[222 132 597 153   1],417,3,30932,4.116034597471724,0.0,0.0
17515,1,7515,[ 64 483  12 427  11],618,5,30937,4.116152208621608,60.0,0.0
17516,1,7516,[125 405 322 195  28],416,4,30941,4.116136756684847,0.0,0.0
17517,1,7517,[161 588  79 302 121],751,4,30945,4.116121308858739,0.0,0.0
17518,1,7518,[187 200 301  15 269],416,5,30950,4.116238861550738,0.0,0.0
17519,1,7519,[ 64 483  12 427  11],618,5,30955,4.116356382978723,60.0,0.0
17520,1,7520,[ 89  98 151 173 195],417,5,30960,4.116473873155165,0.0,20.0
17521,1,7521,[ 64 483  12 427  11],618,5,30965,4.116591332092528,60.0,0.0
17522,1,7522,[222 405 153 175  95],43,4,30969,4.116575834108733,0.0,0.0
17523,1,7523,[ 64 483  12 427  11],618,5,30974,4.116693248272195,60.0,0.0
17524,1,7524,[ 64 483  12 427  11],214,5,30979,4.116810631229236,60.0,0.0
17525,1,7525,[ 64 483  12 427  11],618,5,30984,4.116927982992293,60.0,0.0
17526,1,7526,[568 174 258 269 118],654,4,30988,4.116912448518666,0.0,0.0
17527,1,7527,[100   8  96 742 228],230,3,30991,4.116764080765144,0.0,0.0
17528,1,7528,[427  56 125  98 173],253,3,30994,4.116615752423961,0.0,20.0
17529,1,7529,[ 64 483  12 427  11],214,5,30999,4.116733067729084,60.0,0.0
17530,1,7530,[742 204 222 275  71],588,3,31002,4.116584782897357,0.0,0.0
17531,1,7531,[151 180 181 222 357],805,3,31005,4.116436537440255,0.0,20.0
17532,1,7532,[ 64 483  12 427  11],214,5,31010,4.116553829815478,60.0,0.0
17533,1,7533,[ 64 483  12 427  11],214,5,31015,4.116671091053889,60.0,0.0
17534,1,7534,[273 191 197 235 100],297,2,31017,4.1163901791639015,0.0,0.0
17535,1,7535,[183 288 176 211 100],437,2,31019,4.1161093418259025,0.0,20.0
17536,1,7536,[191  95   1 323 168],43,4,31023,4.116093936579541,0.0,0.0
17537,1,7537,[748 276 471 318  95],416,3,31026,4.115945874237198,20.0,0.0
17538,1,7538,[276 174 151 328 196],921,3,31029,4.1157978511738955,0.0,0.0
17539,1,7539,[111 289 204 179 322],721,4,31033,4.1157824933687,0.0,0.0
17540,1,7540,[313 333 748 286  50],782,2,31035,4.115501922821907,20.0,40.0
17541,1,7541,[ 64 483  12 427  11],214,5,31040,4.115619199151419,60.0,0.0
17542,1,7542,[ 64 483  12 427  11],214,5,31045,4.115736444385523,60.0,0.0
17543,1,7543,[181  97 151  28 427],128,3,31048,4.1155885471898195,0.0,20.0
17544,1,7544,[ 64 483  12 427  11],214,5,31053,4.115705765407554,60.0,0.0
17545,1,7545,[  8   4 237  96 118],854,1,31054,4.115292870394911,0.0,0.0
17546,1,7546,[ 69   9 153 222 742],630,2,31056,4.115012587783225,0.0,0.0
17547,1,7547,[ 56 151 235 222 195],805,3,31059,4.114864864864865,0.0,0.0
17548,1,7548,[ 64 483  12 427  11],618,5,31064,4.114982116836667,60.0,0.0
17549,1,7549,[ 88 151  50 294 228],505,1,31065,4.114569536423841,0.0,20.0
17550,1,7550,[ 64 483  12 427  11],214,5,31070,4.114686796450801,60.0,0.0
17551,1,7551,[202  71 175 195 546],805,1,31071,4.114274364406779,0.0,0.0
17552,1,7552,[258 405 182 125 117],62,4,31075,4.114259234741162,0.0,0.0
17553,1,7553,[ 64 483  12 427  11],618,5,31080,4.114376489277205,60.0,0.0
17554,1,7554,[ 64 483  12 427  11],214,5,31085,4.114493712772998,60.0,0.0
17555,1,7555,[151  89   1  56 245],417,5,31090,4.114610905240868,0.0,0.0
17556,1,7556,[ 64 483  12 427  11],214,5,31095,4.114728066693132,60.0,0.0
17557,1,7557,[ 64 483  12 427  11],214,5,31100,4.114845197142101,60.0,0.0
17558,1,7558,[ 64 483  12 427  11],618,5,31105,4.114962296600079,60.0,0.0
17559,1,7559,[191  98 318 588 204],437,4,31109,4.11494708994709,20.0,20.0
17560,1,7560,[423 588  28  70 200],262,3,31112,4.114799629678614,0.0,0.0
17561,1,7561,[385 245 151 127 475],417,5,31117,4.114916688706692,0.0,0.0
17562,1,7562,[588 186 286 153 216],437,2,31119,4.114637048790162,0.0,0.0
17563,1,7563,[508 173 588 546 197],297,3,31122,4.1144896879957695,0.0,0.0
17564,1,7564,[234   1  28   9 183],618,4,31126,4.114474553866491,0.0,0.0
17565,1,7565,[ 64 483  12 427  11],214,5,31131,4.114591593973037,60.0,0.0
17566,1,7566,[ 64 483  12 427  11],618,5,31136,4.114708603145236,60.0,0.0
17567,1,7567,[111  70 151 173  98],49,2,31138,4.114429175475687,0.0,20.0
17568,1,7568,[ 64 483  12 427  11],618,5,31143,4.114546175188268,60.0,0.0
17569,1,7569,[ 64 483  12 427  11],618,5,31148,4.114663143989432,60.0,0.0
17570,1,7570,[ 64 483  12 427  11],618,5,31153,4.1147800818914275,60.0,0.0
17571,1,7571,[ 64 483  12 427  11],618,5,31158,4.114896988906498,60.0,0.0
17572,1,7572,[ 64 483  12 427  11],618,5,31163,4.115013865046877,60.0,0.0
17573,1,7573,[238 328 597 121 216],854,1,31164,4.11460258780037,0.0,0.0
17574,1,7574,[ 64 483  12 427  11],618,5,31169,4.114719471947195,60.0,0.0
17575,1,7575,[ 64 483  12 427  11],618,5,31174,4.114836325237593,60.0,0.0
17576,1,7576,[ 64 483  12 427  11],214,5,31179,4.11495314768378,60.0,0.0
17577,1,7577,[483 546  15 180   4],417,3,31182,4.114806017418844,20.0,0.0
17578,1,7578,[ 97 161 176  71 118],416,4,31186,4.114790869507851,0.0,0.0
17579,1,7579,[ 64 483  12 427  11],618,5,31191,4.11490765171504,60.0,0.0
17580,1,7580,[  8 173 288 268 318],214,3,31194,4.114760585674713,20.0,20.0
17581,1,7581,[ 64 483  12 427  11],214,5,31199,4.114877341070957,60.0,0.0
17582,1,7582,[748 289   8 173 202],416,4,31203,4.114862191744692,0.0,0.0
17583,1,7583,[ 64 483  12 427  11],618,5,31208,4.114978902953586,60.0,0.0
17584,1,7584,[143 132 427 200 568],405,4,31212,4.114963744232037,0.0,0.0
17585,1,7585,[ 95  56 182  50 496],505,2,31214,4.114684945953072,0.0,20.0
17586,1,7586,[ 64 483  12 427  11],618,5,31219,4.114801634374588,60.0,0.0
17587,1,7587,[ 79  97  69 100 322],417,1,31220,4.114391143911439,0.0,0.0
17588,1,7588,[323 742 235 182  98],417,2,31222,4.114112531295296,0.0,20.0
17589,1,7589,[ 64 483  12 427  11],214,5,31227,4.114229249011857,60.0,0.0
17590,1,7590,[269 132 268 288  82],416,5,31232,4.114345935976814,0.0,20.0
17591,1,7591,[742 186 228 282 588],128,2,31234,4.114067439409905,0.0,0.0
17592,1,7592,[318  11 127 174  97],618,5,31239,4.114184116949822,20.0,0.0
17593,1,7593,[294 603  79 196 300],297,2,31241,4.113905715038188,0.0,0.0
17594,1,7594,[ 64 483  12 427  11],618,5,31246,4.114022383146807,60.0,0.0
17595,1,7595,[ 64 483  12 427  11],214,5,31251,4.114139020537125,60.0,0.0
17596,1,7596,[ 64 483  12 427  11],618,5,31256,4.114255627221271,60.0,0.0
17597,1,7597,[ 64 483  12 427  11],618,5,31261,4.114372203211372,60.0,0.0
17598,1,7598,[ 64 483  12 427  11],618,5,31266,4.114488748519542,60.0,0.0
17599,1,7599,[132 151 276 183 427],601,4,31270,4.114473684210527,0.0,0.0
17600,1,7600,[174 268 271  12 333],854,2,31272,4.114195500592027,20.0,0.0
17601,1,7601,[275 237 117 276 294],654,3,31275,4.114048934490923,0.0,0.0
17602,1,7602,[ 96 273 300  97 302],416,5,31280,4.114165461002236,0.0,0.0
17603,1,7603,[183 269 357 191 288],416,5,31285,4.114281956864808,0.0,20.0
17604,1,7604,[ 89 195 423 176  71],198,2,31287,4.1140039447731755,0.0,0.0
17605,1,7605,[ 64 483  12 427  11],618,5,31292,4.114120431238496,60.0,0.0
17606,1,7606,[ 64 483  12 427  11],214,5,31297,4.114236887077691,60.0,0.0
17607,1,7607,[265 100 423 144 282],654,3,31300,4.114090431125131,0.0,0.0
17608,1,7608,[ 97 187   1  22  28],618,5,31305,4.114206860297017,0.0,0.0
17609,1,7609,[202 258 405 427 118],907,5,31310,4.114323258869908,0.0,0.0
17610,1,7610,[ 64 483  12 427  11],214,5,31315,4.114439626855867,60.0,0.0
17611,1,7611,[ 64 483  12 427  11],214,5,31320,4.114555964266947,60.0,0.0
17612,1,7612,[179 742 322 191 228],128,1,31321,4.114146854065415,0.0,0.0
17613,1,7613,[ 64 483  12 427  11],214,5,31326,4.114263199369582,60.0,0.0
17614,1,7614,[ 64 483  12 427  11],618,5,31331,4.114379514116875,60.0,0.0
17615,1,7615,[ 64 483  12 427  11],214,5,31336,4.114495798319328,60.0,0.0
17616,1,7616,[132 144 235 678 125],416,3,31339,4.114349481423132,0.0,0.0
17617,1,7617,[194 143 153 597 161],751,3,31342,4.114203202940404,0.0,0.0
17618,1,7618,[286 111 202 568 269],416,5,31347,4.114319464496653,0.0,0.0
17619,1,7619,[294 588 235 196 423],416,4,31351,4.1143044619422575,0.0,0.0
17620,1,7620,[385 117 318 288 161],416,5,31356,4.114420679700826,20.0,20.0
17621,1,7621,[ 64 483  12 427  11],618,5,31361,4.114536866964052,60.0,0.0
17622,1,7622,[ 64 483  12 427  11],214,5,31366,4.114653023743933,60.0,0.0
17623,1,7623,[ 64 483  12 427  11],214,5,31371,4.1147691500524655,60.0,0.0
17624,1,7624,[195 301 168 143 211],297,4,31375,4.114754098360656,0.0,0.0
17625,1,7625,[118 174 185 568  50],805,2,31377,4.114476789929189,0.0,20.0
17626,1,7626,[ 64 483  12 427  11],618,5,31382,4.1145928936672345,60.0,0.0
17627,1,7627,[ 64 483  12 427  11],618,5,31387,4.114708966963818,60.0,0.0
17628,1,7628,[318 423  64 176 385],618,5,31392,4.114825009830908,40.0,0.0
17629,1,7629,[121  82 204   1  95],541,3,31395,4.114678899082569,0.0,0.0
17630,1,7630,[ 64 483  12 427  11],618,5,31400,4.114794915476346,60.0,0.0
17631,1,7631,[173 179 210  22  71],805,2,31402,4.114517819706499,0.0,0.0
17632,1,7632,[ 64 483  12 427  11],214,5,31407,4.114633826804664,60.0,0.0
17633,1,7633,[385 197 603 748 127],805,2,31409,4.114356824731464,0.0,0.0
17634,1,7634,[168  69 515 144 357],416,5,31414,4.114472822527833,0.0,0.0
17635,1,7635,[ 64 483  12 427  11],618,5,31419,4.1145887899423785,60.0,0.0
17636,1,7636,[144 117 405 286  56],62,2,31421,4.114311902579547,0.0,0.0
17637,1,7637,[174  50 258 268 245],345,4,31425,4.114296936370778,0.0,20.0
17638,1,7638,[ 64 483  12 427  11],618,5,31430,4.114412881267182,60.0,0.0
17639,1,7639,[742 423 196 275  98],43,5,31435,4.114528795811518,0.0,20.0
17640,1,7640,[748   4 168 328 318],416,5,31440,4.114644680015704,20.0,0.0
17641,1,7641,[191 328 237  15 200],854,2,31442,4.114367966500916,0.0,0.0
17642,1,7642,[271 273  50   8 197],805,2,31444,4.114091325395787,0.0,20.0
17643,1,7643,[187 185   4 168 265],405,3,31447,4.113945578231292,0.0,0.0
17644,1,7644,[ 64 483  12 427  11],214,5,31452,4.114061478090255,60.0,0.0
17645,1,7645,[ 64 483  12 427  11],618,5,31457,4.114177347632749,60.0,0.0
17646,1,7646,[161 269 181  88 173],751,4,31461,4.114162416633974,0.0,20.0
17647,1,7647,[175 174 357  70 276],198,2,31463,4.113885983263598,0.0,0.0
17648,1,7648,[185 318 269  97 286],416,5,31468,4.114001830304615,20.0,0.0
17649,1,7649,[ 64 483  12 427  11],214,5,31473,4.114117647058824,60.0,0.0
17650,1,7650,[  7 202 269 132 211],416,5,31478,4.114233433538099,0.0,0.0
17651,1,7651,[ 64 483  12 427  11],618,5,31483,4.1143491897543125,60.0,0.0
17652,1,7652,[ 64 483  12 427  11],214,5,31488,4.114464915719326,60.0,0.0
17653,1,7653,[ 82 204 588 597 111],887,5,31493,4.114580611444996,0.0,0.0
17654,1,7654,[ 64 483  12 427  11],214,5,31498,4.1146962769431745,60.0,0.0
17655,1,7655,[228 168 238  64 197],198,4,31502,4.114681295715778,20.0,0.0
17656,1,7656,[ 64 483  12 427  11],214,5,31507,4.114796917852945,60.0,0.0
17657,1,7657,[125  70 286 117 471],416,5,31512,4.11491250979368,0.0,0.0
17658,1,7658,[ 12 275 588 175 300],297,4,31516,4.114897506201854,20.0,0.0
17659,1,7659,[ 64 483  12 427  11],214,5,31521,4.115013054830287,60.0,0.0
17660,1,7660,[ 64 483  12 427  11],214,5,31526,4.115128573293304,60.0,0.0
17661,1,7661,[ 64 483  12 427  11],618,5,31531,4.115244061602715,60.0,0.0
17662,1,7662,[ 64 483  12 427  11],214,5,31536,4.115359519770325,60.0,0.0
17663,1,7663,[ 64 483  12 427  11],214,5,31541,4.115474947807933,60.0,0.0
17664,1,7664,[475  50 742   1 135],62,3,31544,4.115329419439009,0.0,20.0
17665,1,7665,[ 64 483  12 427  11],618,5,31549,4.115444821288808,60.0,0.0
17666,1,7666,[ 64 483  12 427  11],618,5,31554,4.115560193035085,60.0,0.0
17667,1,7667,[168 257 238 202 258],416,4,31558,4.115545122587376,0.0,0.0
17668,1,7668,[471 127 196 121 195],618,3,31561,4.115399660972748,0.0,0.0
17669,1,7669,[111 268 300  70  79],416,5,31566,4.115514993481095,0.0,0.0
17670,1,7670,[268 678 117 245 508],297,3,31569,4.115369573719202,0.0,0.0
17671,1,7671,[ 64 483  12 427  11],214,5,31574,4.11548488008342,60.0,0.0
17672,1,7672,[ 64 483  12 427  11],618,5,31579,4.115600156392546,60.0,0.0
17673,1,7673,[318  79 182 258  15],416,5,31584,4.115715402658327,20.0,0.0
17674,1,7674,[ 79 173  25 597 333],416,4,31588,4.115700325732899,0.0,0.0
17675,1,7675,[ 64 483  12 427  11],214,5,31593,4.115815528921313,60.0,0.0
17676,1,7676,[ 64 483  12 427  11],618,5,31598,4.115930702097173,60.0,0.0
17677,1,7677,[ 64 483  12 427  11],214,5,31603,4.116045845272207,60.0,0.0
17678,1,7678,[ 64 483  12 427  11],618,5,31608,4.116160958458132,60.0,0.0
17679,1,7679,[ 56 405 273 125 127],417,3,31611,4.116015625,0.0,0.0
17680,1,7680,[ 64 483  12 427  11],214,5,31616,4.116130712146856,60.0,0.0
17681,1,7681,[ 64 483  12 427  11],214,5,31621,4.116245769330903,60.0,0.0
17682,1,7682,[ 64 483  12 427  11],214,5,31626,4.116360796563843,60.0,0.0
17683,1,7683,[265  56 475 183 588],416,4,31630,4.1163456533055705,0.0,0.0
17684,1,7684,[ 64 483  12 427  11],214,5,31635,4.116460637605726,60.0,0.0
17685,1,7685,[ 71 427 135 234 655],405,4,31639,4.116445485297945,0.0,0.0
17686,1,7686,[238 403 313 318 125],416,5,31644,4.116560426694419,40.0,20.0
17687,1,7687,[258 144 168 273 179],416,4,31648,4.116545265348595,0.0,0.0
17688,1,7688,[ 71 172   1 265 471],505,3,31651,4.11640005202237,0.0,0.0
17689,1,7689,[  4 216 235 405 271],805,0,31651,4.115864759427828,0.0,0.0
17690,1,7690,[ 64 483  12 427  11],618,5,31656,4.115979716551814,60.0,0.0
17691,1,7691,[508 211 257 588 197],297,3,31659,4.115834633385336,0.0,0.0
17692,1,7692,[ 64 483  12 427  11],618,5,31664,4.115949564539191,60.0,0.0
17693,1,7693,[  1 286  15 121 191],854,1,31665,4.115544580192358,0.0,0.0
17694,1,7694,[ 64 483  12 427  11],618,5,31670,4.115659519168291,60.0,0.0
17695,1,7695,[210  22 288  70 234],297,3,31673,4.115514553014553,0.0,20.0
17696,1,7696,[294 100 179 185 204],49,3,31676,4.115369624529038,0.0,0.0
17697,1,7697,[ 64 483  12 427  11],214,5,31681,4.115484541439335,60.0,0.0
17698,1,7698,[ 64 483  12 427  11],214,5,31686,4.115599428497207,60.0,0.0
17699,1,7699,[ 64 483  12 427  11],618,5,31691,4.115714285714286,60.0,0.0
17700,1,7700,[135  28  50  25 181],373,3,31694,4.115569406570575,0.0,40.0
17701,1,7701,[271 204 200 216 168],805,2,31696,4.115294728641911,0.0,0.0
17702,1,7702,[  4 496  50 153   8],642,3,31699,4.115149941581202,0.0,20.0
17703,1,7703,[ 64 216  98 202  88],128,4,31703,4.115134994807892,20.0,20.0
17704,1,7704,[121 135  64 515  69],417,2,31705,4.114860480207657,20.0,0.0
17705,1,7705,[302  82 153 597 210],43,4,31709,4.114845574876719,0.0,0.0
17706,1,7706,[265 282 301   9 215],416,5,31714,4.114960425587128,0.0,0.0
17707,1,7707,[ 97 333 173 471 100],588,3,31717,4.114815775817332,0.0,0.0
17708,1,7708,[ 64 483  12 427  11],618,5,31722,4.114930600596705,60.0,0.0
17709,1,7709,[286 172 151 269 210],373,4,31726,4.11491569390402,0.0,0.0
17710,1,7710,[323  82  97 191 286],43,4,31730,4.114900791077681,0.0,0.0
17711,1,7711,[ 89  70 172 195 234],642,1,31731,4.114496887966805,0.0,0.0
17712,1,7712,[273 144 238  50 655],416,5,31736,4.114611694541683,0.0,20.0
17713,1,7713,[216 121 323 748  12],345,2,31738,4.114337568058076,20.0,0.0
17714,1,7714,[427 475   4 318 185],416,4,31742,4.114322747893714,20.0,0.0
17715,1,7715,[ 50 151  71  96 216],805,3,31745,4.114178330741317,0.0,20.0
17716,1,7716,[ 64 483  12 427  11],214,5,31750,4.114293119087728,60.0,0.0
17717,1,7717,[300  25  15 268 196],345,3,31753,4.1141487431977195,0.0,0.0
17718,1,7718,[568  28 187 151 174],416,4,31757,4.114133955175541,0.0,0.0
17719,1,7719,[ 64 483  12 427  11],618,5,31762,4.114248704663212,60.0,0.0
17720,1,7720,[ 64 483  12 427  11],214,5,31767,4.114363424426887,60.0,0.0
17721,1,7721,[204 286   7  12 118],43,5,31772,4.114478114478114,20.0,0.0
17722,1,7722,[202 496  69 195 271],505,2,31774,4.114204324744271,0.0,0.0
17723,1,7723,[508 588 742 235 238],297,3,31777,4.114060072501295,0.0,0.0
17724,1,7724,[302 168 176  69  25],854,2,31779,4.11378640776699,0.0,0.0
17725,1,7725,[196 228 210 508 237],62,3,31782,4.113642246958323,0.0,0.0
17726,1,7726,[405 183 216 748  89],417,3,31785,4.113498123463181,0.0,0.0
17727,1,7727,[168 228 588 483 185],711,4,31789,4.113483436853002,20.0,0.0
17728,1,7728,[121 143 313  56 117],642,5,31794,4.113598136887049,20.0,20.0
17729,1,7729,[100 257  70 125 276],62,3,31797,4.113454075032341,0.0,0.0
17730,1,7730,[245 568 597 328 121],62,1,31798,4.113051351700944,0.0,0.0
17731,1,7731,[300 144 235  79 294],43,4,31802,4.113036730470771,0.0,0.0
17732,1,7732,[153   8 173 215 435],721,5,31807,4.113151428940903,0.0,0.0
17733,1,7733,[ 64 483  12 427  11],214,5,31812,4.113266097750194,60.0,0.0
17734,1,7734,[ 64 483  12 427  11],618,5,31817,4.113380736910148,60.0,0.0
17735,1,7735,[210 597 483 181  96],417,1,31818,4.112978283350569,20.0,20.0
17736,1,7736,[286 144  28 423 515],416,5,31823,4.113092930076257,0.0,0.0
17737,1,7737,[ 64 483  12 427  11],214,5,31828,4.113207547169812,60.0,0.0
17738,1,7738,[ 64 483  12 427  11],214,5,31833,4.1133221346427185,60.0,0.0
17739,1,7739,[276 423 191  69 403],416,4,31837,4.113307493540051,0.0,0.0
17740,1,7740,[100   9 546  97 168],43,5,31842,4.113422038496318,0.0,0.0
17741,1,7741,[ 97 302 118 294 237],654,2,31844,4.113149057091191,0.0,0.0
17742,1,7742,[117 678 135 168  69],297,3,31847,4.113005295105256,0.0,0.0
17743,1,7743,[496 269   8 168 748],654,5,31852,4.113119834710743,0.0,0.0
17744,1,7744,[186 185 151 238 196],417,4,31856,4.113105229180116,0.0,0.0
17745,1,7745,[ 64 483  12 427  11],214,5,31861,4.113219726310354,60.0,0.0
17746,1,7746,[ 64 483  12 427  11],214,5,31866,4.113334193881503,60.0,0.0
17747,1,7747,[ 64 483  12 427  11],214,5,31871,4.113448631905007,60.0,0.0
17748,1,7748,[ 64 483  12 427  11],618,5,31876,4.113563040392308,60.0,0.0
17749,1,7749,[ 64 483  12 427  11],214,5,31881,4.113677419354839,60.0,0.0
17750,1,7750,[183 143 191  69 173],416,5,31886,4.113791768804025,0.0,0.0
17751,1,7751,[ 64 483  12 427  11],214,5,31891,4.11390608875129,60.0,0.0
17752,1,7752,[  1   7 161 118  50],588,3,31894,4.113762414549207,0.0,20.0
17753,1,7753,[176  56 100 748 294],417,4,31898,4.113747743100335,0.0,0.0
17754,1,7754,[ 64 483  12 427  11],214,5,31903,4.113862024500323,60.0,0.0
17755,1,7755,[  4 597 127 202  56],805,1,31904,4.113460546673543,0.0,0.0
17756,1,7756,[ 64 483  12 427  11],618,5,31909,4.113574835632332,60.0,0.0
17757,1,7757,[144 196  69 204  25],373,4,31913,4.113560195926786,0.0,0.0
17758,1,7758,[276  12 216 176 173],416,4,31917,4.1135455599948445,20.0,0.0
17759,1,7759,[ 64 483  12 427  11],618,5,31922,4.113659793814433,60.0,0.0
17760,1,7760,[435  97 748  15  28],721,4,31926,4.113645148821028,0.0,0.0
17761,1,7761,[289 200 258 328  96],416,4,31930,4.113630507601134,0.0,0.0
17762,1,7762,[135   4 191  88  70],618,3,31933,4.113487053973979,0.0,0.0
17763,1,7763,[ 64 483  12 427  11],214,5,31938,4.113601236476043,60.0,0.0
17764,1,7764,[265 302 234 496 143],416,5,31943,4.1137153895685765,0.0,0.0
17765,1,7765,[597 125 237 222 289],588,1,31944,4.113314447592068,0.0,0.0
17766,1,7766,[127 427 471  88 318],373,3,31947,4.113171108536115,20.0,0.0
17767,1,7767,[ 28   4 183 210 302],405,4,31951,4.113156539649846,0.0,0.0
17768,1,7768,[ 64 483  12 427  11],618,5,31956,4.113270691208649,60.0,0.0
17769,1,7769,[435 483  79 275  71],437,3,31959,4.113127413127413,20.0,0.0
17770,1,7770,[197 328 427 302 276],416,4,31963,4.113112855488354,0.0,0.0
17771,1,7771,[ 64 483  12 427  11],214,5,31968,4.113226968605249,60.0,0.0
17772,1,7772,[  8  56 151 168 179],416,3,31971,4.113083751447317,0.0,0.0
17773,1,7773,[ 88  97 195 289 748],416,3,31974,4.112940571134551,0.0,0.0
17774,1,7774,[ 64 483  12 427  11],618,5,31979,4.1130546623794215,60.0,0.0
17775,1,7775,[ 64 483  12 427  11],618,5,31984,4.113168724279835,60.0,0.0
17776,1,7776,[ 64 483  12 427  11],214,5,31989,4.113282756847113,60.0,0.0
17777,1,7777,[173 427 286 588  89],711,4,31993,4.113268192337362,0.0,0.0
17778,1,7778,[ 64 483  12 427  11],618,5,31998,4.113382182799846,60.0,0.0
17779,1,7779,[ 64 483  12 427  11],214,5,32003,4.113496143958869,60.0,0.0
17780,1,7780,[ 64 483  12 427  11],214,5,32008,4.113610075825729,60.0,0.0
17781,1,7781,[258 323 588 173   9],805,2,32010,4.113338473400154,0.0,0.0
17782,1,7782,[ 64 483  12 427  11],214,5,32015,4.113452396248233,60.0,0.0
17783,1,7783,[237 202 210 288 515],416,4,32019,4.113437821171634,0.0,20.0
17784,1,7784,[475 181 196 100 286],416,4,32023,4.1134232498394345,0.0,20.0
17785,1,7785,[ 64 483  12 427  11],214,5,32028,4.11353711790393,60.0,0.0
17786,1,7786,[237 275 475 269 748],297,4,32032,4.113522537562605,0.0,0.0
17787,1,7787,[ 64 483  12 427  11],618,5,32037,4.113636363636363,60.0,0.0
17788,1,7788,[ 64 483  12 427  11],214,5,32042,4.1137501604827325,60.0,0.0
17789,1,7789,[301 546 257 515 237],416,2,32044,4.113478818998717,0.0,0.0
17790,1,7790,[ 64 483  12 427  11],618,5,32049,4.113592606854063,60.0,0.0
17791,1,7791,[ 64 483  12 427  11],618,5,32054,4.11370636550308,60.0,0.0
17792,1,7792,[168 508 302  15 222],654,3,32057,4.113563454382138,0.0,0.0
17793,1,7793,[427 132 357 176   7],24,4,32061,4.113548883756736,0.0,0.0
17794,1,7794,[ 64 483  12 427  11],618,5,32066,4.113662604233483,60.0,0.0
17795,1,7795,[ 25  50 196 222 318],354,1,32067,4.11326321190354,20.0,20.0
17796,1,7796,[ 64 483  12 427  11],618,5,32072,4.11337693984866,60.0,0.0
17797,1,7797,[222 111 257 174 144],417,0,32072,4.112849448576558,0.0,0.0
17798,1,7798,[191  15  97   7  12],417,4,32076,4.112834978843441,20.0,0.0
17799,1,7799,[ 64 483  12 427  11],618,5,32081,4.112948717948718,60.0,0.0
17800,1,7800,[ 64 483  12 427  11],214,5,32086,4.11306242789386,60.0,0.0
17801,1,7801,[ 64 483  12 427  11],214,5,32091,4.113176108690079,60.0,0.0
17802,1,7802,[ 64 483  12 427  11],214,5,32096,4.113289760348584,60.0,0.0
17803,1,7803,[210 153 300 211 202],698,2,32098,4.113018964633521,0.0,0.0
17804,1,7804,[132 182 238 185 276],198,3,32101,4.112876361306855,0.0,0.0
17805,1,7805,[100 117 268 294 603],854,2,32103,4.112605687932359,0.0,0.0
17806,1,7806,[ 64 483  12 427  11],618,5,32108,4.112719354425516,60.0,0.0
17807,1,7807,[174 181 276 153 175],43,4,32112,4.112704918032787,0.0,20.0
17808,1,7808,[423 111 403   8 100],43,5,32117,4.112818542707132,0.0,0.0
17809,1,7809,[117 471 118  12 151],345,3,32120,4.112676056338028,20.0,0.0
17810,1,7810,[ 64 483  12 427  11],214,5,32125,4.112789655613878,60.0,0.0
17811,1,7811,[132 161 100  50 195],417,2,32127,4.112519201228879,0.0,20.0
17812,1,7812,[ 64 483  12 427  11],214,5,32132,4.112632791501344,60.0,0.0
17813,1,7813,[204 508 135 475 289],342,2,32134,4.112362426414128,0.0,0.0
17814,1,7814,[597 302 215  64 357],416,4,32138,4.11234804862444,20.0,0.0
17815,1,7815,[ 64 483  12 427  11],618,5,32143,4.112461617195496,60.0,0.0
17816,1,7816,[ 64 483  12 427  11],618,5,32148,4.1125751567097355,60.0,0.0
17817,1,7817,[ 64 483  12 427  11],618,5,32153,4.112688667178307,60.0,0.0
17818,1,7818,[ 97  11 222 228 257],417,2,32155,4.112418467834761,0.0,0.0
17819,1,7819,[228  15 403 235 180],62,3,32158,4.112276214833759,0.0,0.0
17820,1,7820,[275 174  15 546 655],416,4,32162,4.112261859097302,0.0,0.0
17821,1,7821,[216 215 568  69 300],416,5,32167,4.112375351572488,0.0,0.0
17822,1,7822,[ 64 483  12 427  11],214,5,32172,4.112488815032596,60.0,0.0
17823,1,7823,[496 191 182  64 144],618,5,32177,4.112602249488752,20.0,0.0
17824,1,7824,[204 100 275 475 151],297,3,32180,4.112460063897764,0.0,0.0
17825,1,7825,[313 301 282 655  70],416,5,32185,4.112573473038589,20.0,20.0
17826,1,7826,[ 64 483  12 427  11],214,5,32190,4.11268685320046,60.0,0.0
17827,1,7827,[237 172 475 323  88],416,1,32191,4.112289218191109,0.0,0.0
17828,1,7828,[603  11 173 269 216],297,5,32196,4.112402605696769,0.0,0.0
17829,1,7829,[357  56  71   8 475],601,2,32198,4.11213282247765,0.0,0.0
17830,1,7830,[ 56 196  15 300  22],654,4,32202,4.112118503383987,0.0,0.0
17831,1,7831,[ 95 181 144  88 195],416,3,32205,4.111976506639428,0.0,20.0
17832,1,7832,[210 588 197 385 245],345,2,32207,4.111706881143879,0.0,0.0
17833,1,7833,[ 64 483  12 427  11],214,5,32212,4.111820270615267,60.0,0.0
17834,1,7834,[180 588 328  95  28],373,2,32214,4.111550733886407,0.0,0.0
17835,1,7835,[ 64 483  12 427  11],214,5,32219,4.111664114344053,60.0,0.0
17836,1,7836,[ 64 483  12 427  11],214,5,32224,4.111777465867041,60.0,0.0
17837,1,7837,[423 546 234  96   9],416,4,32228,4.1117632048992085,0.0,0.0
17838,1,7838,[271 179  12 181 483],62,4,32232,4.111748947569843,40.0,20.0
17839,1,7839,[ 11  28 118 222 271],297,3,32235,4.111607142857143,0.0,0.0
17840,1,7840,[ 64 483  12 427  11],214,5,32240,4.111720443820941,60.0,0.0
17841,1,7841,[ 64 483  12 427  11],618,5,32245,4.111833715888804,60.0,0.0
17842,1,7842,[191 269 258 210 182],416,5,32250,4.111946959071783,0.0,0.0
17843,1,7843,[222 172 174 508  69],128,2,32252,4.1116777154513,0.0,0.0
17844,1,7844,[235 238 194 678 182],416,3,32255,4.111536010197578,0.0,0.0
17845,1,7845,[475 121 202 174 182],437,2,32257,4.111266887586031,0.0,0.0
17846,1,7846,[ 64 483  12 427  11],214,5,32262,4.11138014527845,60.0,0.0
17847,1,7847,[385 405 748 180  70],417,4,32266,4.111365953109073,0.0,0.0
17848,1,7848,[405 301 286  88 268],345,4,32270,4.1113517645559945,0.0,0.0
17849,1,7849,[127 210 195 161   1],805,1,32271,4.1109554140127385,0.0,0.0
17850,1,7850,[ 64 483  12 427  11],214,5,32276,4.111068653674691,60.0,0.0
17851,1,7851,[204 144 174 161  97],230,4,32280,4.111054508405502,0.0,0.0
17852,1,7852,[ 64 483  12 427  11],214,5,32285,4.111167706608939,60.0,0.0
17853,1,7853,[ 11 179 196 197  56],198,4,32289,4.111153552330023,0.0,0.0
17854,1,7854,[195 100 483   7  12],214,5,32294,4.111266709102482,40.0,0.0
17855,1,7855,[322 269 258 288 210],805,1,32295,4.11087067209776,0.0,20.0
17856,1,7856,[ 64 483  12 427  11],618,5,32300,4.110983836069747,60.0,0.0
17857,1,7857,[ 64 483  12 427  11],618,5,32305,4.111096971239501,60.0,0.0
17858,1,7858,[ 69   4  22  28 385],405,4,32309,4.111082834966281,0.0,0.0
17859,1,7859,[ 64 483  12 427  11],618,5,32314,4.1111959287531805,60.0,0.0
17860,1,7860,[ 50 235 234 748 196],417,3,32317,4.111054573209516,0.0,20.0
17861,1,7861,[ 64 483  12 427  11],618,5,32322,4.111167641821419,60.0,0.0
17862,1,7862,[ 64 483  12 427  11],618,5,32327,4.111280681673661,60.0,0.0
17863,1,7863,[328 186 271   8  56],854,3,32330,4.111139369277721,0.0,0.0
17864,1,7864,[  8   4 655 187 172],416,5,32335,4.111252383979656,0.0,0.0
17865,1,7865,[ 64 483  12 427  11],214,5,32340,4.111365369946606,60.0,0.0
17866,1,7866,[132 257  98 168 294],62,3,32343,4.1112241006737005,0.0,20.0
17867,1,7867,[111 228 176   7 357],297,3,32346,4.111082867310626,0.0,0.0
17868,1,7868,[  9 258 655  12  50],805,2,32348,4.110814588893125,20.0,20.0
17869,1,7869,[ 82 176 144 117 151],618,4,32352,4.110800508259212,0.0,0.0
17870,1,7870,[ 64 483  12 427  11],618,5,32357,4.110913479862788,60.0,0.0
17871,1,7871,[276 204 211 294 172],416,4,32361,4.110899390243903,0.0,0.0
17872,1,7872,[238  11 118   1 235],43,3,32364,4.110758287819129,0.0,0.0
17873,1,7873,[302 176  64  98 288],417,3,32367,4.110617221234443,20.0,40.0
17874,1,7874,[ 64 483  12 427  11],214,5,32372,4.110730158730159,60.0,0.0
17875,1,7875,[289 275 568 294 100],588,2,32374,4.110462163534789,0.0,0.0
17876,1,7876,[318 288  98 427 216],416,5,32379,4.110575092040117,20.0,40.0
17877,1,7877,[182  97   1 271 194],297,1,32380,4.11018024879411,0.0,0.0
17878,1,7878,[ 64 483  12 427  11],618,5,32385,4.110293184414266,60.0,0.0
17879,1,7879,[508 568  25 318 385],654,3,32388,4.110152284263959,20.0,0.0
17880,1,7880,[ 64 483  12 427  11],214,5,32393,4.110265194772237,60.0,0.0
17881,1,7881,[235 118 237 275 211],43,4,32397,4.110251205277848,0.0,0.0
17882,1,7882,[117 200 288 121 100],805,2,32399,4.10998350881644,0.0,20.0
17883,1,7883,[191  98 196 234 211],417,5,32404,4.110096397767631,0.0,20.0
17884,1,7884,[ 96  98 405 196 180],62,4,32408,4.110082435003171,0.0,20.0
17885,1,7885,[168   4 191 286 423],417,4,32412,4.110068475779863,0.0,0.0
17886,1,7886,[ 79 357   7 237 258],854,4,32416,4.110054520096361,0.0,0.0
17887,1,7887,[174  12 568 151 191],214,5,32421,4.110167342799189,20.0,0.0
17888,1,7888,[ 96 257  50 195 323],417,1,32422,4.109773101787299,0.0,20.0
17889,1,7889,[197 185  98 100  95],297,3,32425,4.109632446134348,0.0,20.0
17890,1,7890,[ 64 483  12 427  11],214,5,32430,4.109745279432264,60.0,0.0
17891,1,7891,[ 64 483  12 427  11],214,5,32435,4.109858084135833,60.0,0.0
17892,1,7892,[ 64 483  12 427  11],618,5,32440,4.109970860255923,60.0,0.0
17893,1,7893,[ 64 483  12 427  11],214,5,32445,4.110083607803395,60.0,0.0
17894,1,7894,[ 64 483  12 427  11],618,5,32450,4.110196326789107,60.0,0.0
17895,1,7895,[322  56 179 423 678],805,3,32453,4.1100557244174265,0.0,0.0
17896,1,7896,[200 288 496 210 427],887,4,32457,4.110041788020768,0.0,20.0
17897,1,7897,[121  11 435 294 132],505,3,32460,4.109901240820461,0.0,0.0
17898,1,7898,[ 64 483  12 427  11],618,5,32465,4.110013925813394,60.0,0.0
17899,1,7899,[ 64 483  12 427  11],618,5,32470,4.110126582278481,60.0,0.0
17900,1,7900,[294 202 161 257  95],922,3,32473,4.109986077711682,0.0,0.0
17901,1,7901,[ 64 483  12 427  11],214,5,32478,4.110098709187548,60.0,0.0
17902,1,7902,[ 28 168 118 742 328],128,3,32481,4.109958243704922,0.0,0.0
17903,1,7903,[403 181  50 125 118],618,3,32484,4.109817813765182,0.0,40.0
17904,1,7904,[238  11 742 174 568],751,1,32485,4.109424414927261,0.0,0.0
17905,1,7905,[  4  22 475 121 153],62,5,32490,4.10953706046041,0.0,0.0
17906,1,7906,[ 56  69  12  70 173],62,4,32494,4.109523207284685,20.0,0.0
17907,1,7907,[ 64 483  12 427  11],618,5,32499,4.109635811836116,60.0,0.0
17908,1,7908,[286  98 100  82 655],588,2,32501,4.109369073207738,0.0,20.0
17909,1,7909,[  4 333 282 405 302],345,3,32504,4.109228824273072,0.0,0.0
17910,1,7910,[181  89 515 176 187],698,3,32507,4.109088610795095,0.0,20.0
17911,1,7911,[ 64 483  12 427  11],214,5,32512,4.1092012133468145,60.0,0.0
17912,1,7912,[ 64  11  25 258 202],417,4,32516,4.109187413117654,20.0,0.0
17913,1,7913,[172 175   4 235 127],43,3,32519,4.109047258023756,0.0,0.0
17914,1,7914,[ 64 483  12 427  11],214,5,32524,4.109159823120657,60.0,0.0
17915,1,7915,[172 127 313 282 276],618,3,32527,4.109019706922688,20.0,20.0
17916,1,7916,[180 258 234 238 200],417,5,32532,4.109132247063282,0.0,0.0
17917,1,7917,[508 655 179 151 182],62,4,32536,4.109118464258652,0.0,0.0
17918,1,7918,[ 97 172 427 235 144],416,4,32540,4.109104684934967,0.0,0.0
17919,1,7919,[ 64 483  12 427  11],618,5,32545,4.109217171717172,60.0,0.0
17920,1,7920,[268 546  97 100 405],417,2,32547,4.108950890039137,0.0,0.0
17921,1,7921,[ 64 483  12 427  11],618,5,32552,4.109063367836405,60.0,0.0
17922,1,7922,[ 64 483  12 427  11],618,5,32557,4.109175817240944,60.0,0.0
17923,1,7923,[ 64 483  12 427  11],214,5,32562,4.109288238263503,60.0,0.0
17924,1,7924,[273 186  79 597   9],618,4,32566,4.1092744479495265,0.0,0.0
17925,1,7925,[ 64 483  12 427  11],618,5,32571,4.109386828160485,60.0,0.0
17926,1,7926,[603  96 515  95 197],405,1,32572,4.108994575501451,0.0,0.0
17927,1,7927,[385  95 268 117 405],417,4,32576,4.108980827447024,0.0,0.0
17928,1,7928,[471 515 200  98 275],416,5,32581,4.109093202169252,0.0,20.0
17929,1,7929,[144 179   8 216   4],342,5,32586,4.109205548549811,0.0,0.0
17930,1,7930,[ 64 483  12 427  11],214,5,32591,4.10931786659942,60.0,0.0
17931,1,7931,[678 496 172 237 215],588,2,32593,4.1090519415027735,0.0,0.0
17932,1,7932,[191 357 127 117 173],373,4,32597,4.109038194882138,0.0,0.0
17933,1,7933,[238 742 179 508 603],128,3,32600,4.10889841189816,0.0,0.0
17934,1,7934,[ 64 483  12 427  11],214,5,32605,4.109010712035286,60.0,0.0
17935,1,7935,[ 64 483  12 427  11],214,5,32610,4.109122983870968,60.0,0.0
17936,1,7936,[ 64 483  12 427  11],214,5,32615,4.1092352274159,60.0,0.0
17937,1,7937,[ 64 483  12 427  11],214,5,32620,4.109347442680776,60.0,0.0
17938,1,7938,[ 64 483  12 427  11],214,5,32625,4.109459629676282,60.0,0.0
17939,1,7939,[210 173   8 204 143],43,5,32630,4.109571788413098,0.0,0.0
17940,1,7940,[ 64 483  12 427  11],214,5,32635,4.109683918901902,60.0,0.0
17941,1,7941,[322 200 265  88  69],416,3,32638,4.109544195416771,0.0,0.0
17942,1,7942,[ 64 483  12 427  11],214,5,32643,4.109656301145663,60.0,0.0
17943,1,7943,[ 64 483  12 427  11],214,5,32648,4.1097683786505534,60.0,0.0
17944,1,7944,[ 28 603 132 237 151],416,3,32651,4.109628697293895,0.0,0.0
17945,1,7945,[ 64 483  12 427  11],214,5,32656,4.109740750062925,60.0,0.0
17946,1,7946,[ 64 483  12 427  11],214,5,32661,4.109852774631936,60.0,0.0
17947,1,7947,[ 64 483  12 427  11],214,5,32666,4.109964771011575,60.0,0.0
17948,1,7948,[ 50  82  12 127 216],373,3,32669,4.109825135237137,20.0,20.0
17949,1,7949,[210 196 237  96 143],921,4,32673,4.109811320754717,0.0,0.0
17950,1,7950,[202 197  88 294 194],416,4,32677,4.109797509747201,0.0,0.0
17951,1,7951,[143 174 302  50 546],416,4,32681,4.10978370221328,0.0,20.0
17952,1,7952,[ 97  70 100 237  98],230,5,32686,4.109895636866591,0.0,20.0
17953,1,7953,[ 82 245 181 275 143],416,4,32690,4.109881820467689,0.0,20.0
17954,1,7954,[265 211 568 196 238],416,5,32695,4.109993714644878,0.0,0.0
17955,1,7955,[ 64 483  12 427  11],214,5,32700,4.110105580693816,60.0,0.0
17956,1,7956,[288 173 210 403 588],405,4,32704,4.110091743119266,0.0,20.0
17957,1,7957,[ 64 483  12 427  11],618,5,32709,4.110203568735863,60.0,0.0
17958,1,7958,[ 64 483  12 427  11],618,5,32714,4.110315366252042,60.0,0.0
17959,1,7959,[ 64 483  12 427  11],618,5,32719,4.110427135678392,60.0,0.0
17960,1,7960,[ 64 483  12 427  11],618,5,32724,4.110538877025499,60.0,0.0
17961,1,7961,[ 64 483  12 427  11],618,5,32729,4.110650590303944,60.0,0.0
17962,1,7962,[ 64 483  12 427  11],214,5,32734,4.1107622755243,60.0,0.0
17963,1,7963,[176  69 216 100 294],230,5,32739,4.110873932697137,0.0,0.0
17964,1,7964,[ 64 483  12 427  11],214,5,32744,4.1109855618330196,60.0,0.0
17965,1,7965,[ 64 483  12 427  11],618,5,32749,4.111097162942506,60.0,0.0
17966,1,7966,[ 64 483  12 427  11],214,5,32754,4.111208736036149,60.0,0.0
17967,1,7967,[175  22 323 174 100],805,3,32757,4.111069277108434,0.0,0.0
17968,1,7968,[ 64 483  12 427  11],618,5,32762,4.111180825699586,60.0,0.0
17969,1,7969,[475 286 235 427 174],416,3,32765,4.111041405269762,0.0,0.0
17970,1,7970,[ 11 132   7  70 496],417,3,32768,4.110902019821855,0.0,0.0
17971,1,7971,[ 64 483  12 427  11],618,5,32773,4.111013547415956,60.0,0.0
17972,1,7972,[ 25 748  82 183 655],805,2,32775,4.110748777122789,0.0,0.0
17973,1,7973,[  1  25 322 216  50],854,1,32776,4.110358665663406,0.0,20.0
17974,1,7974,[111 258 185  70  64],262,4,32780,4.110344827586207,20.0,0.0
17975,1,7975,[ 64 483  12 427  11],618,5,32785,4.110456369107322,60.0,0.0
17976,1,7976,[161 179 210 655 197],416,4,32789,4.110442522251473,0.0,0.0
17977,1,7977,[265 568 117 144 742],230,3,32792,4.1103033341689645,0.0,0.0
17978,1,7978,[ 12 313 216 181 568],43,5,32797,4.1104148389522495,40.0,40.0
17979,1,7979,[111 228 258 183   9],805,1,32798,4.110025062656642,0.0,0.0
17980,1,7980,[405 301 121 237   4],416,4,32802,4.110011276782358,0.0,0.0
17981,1,7981,[ 64 483  12 427  11],618,5,32807,4.110122776246555,60.0,0.0
17982,1,7982,[111 172 275  82 185],262,2,32809,4.10985844920456,0.0,0.0
17983,1,7983,[ 50 118   4 210 117],43,5,32814,4.109969939879759,0.0,20.0
17984,1,7984,[117 210 127 196 181],417,3,32817,4.109830932999373,0.0,20.0
17985,1,7985,[  7 127 275 282 268],416,5,32822,4.109942399198598,0.0,0.0
17986,1,7986,[ 64 483  12 427  11],214,5,32827,4.110053837485915,60.0,0.0
17987,1,7987,[143   4 273 144  69],297,2,32829,4.10978968452679,0.0,0.0
17988,1,7988,[ 64 483  12 427  11],214,5,32834,4.109901114031794,60.0,0.0
17989,1,7989,[ 64 483  12 427  11],618,5,32839,4.110012515644556,60.0,0.0
17990,1,7990,[357 273 200 322  79],854,4,32843,4.109998748592166,0.0,0.0
17991,1,7991,[475 200  56 300 357],198,4,32847,4.109984984984985,0.0,0.0
17992,1,7992,[289 237 588 245 191],416,2,32849,4.109721005880145,0.0,0.0
17993,1,7993,[215 515 118 176 276],416,3,32852,4.10958218663998,0.0,0.0
17994,1,7994,[302 271 118 168 313],43,4,32856,4.1095684803001875,20.0,20.0
17995,1,7995,[127  15 216  70 323],417,3,32859,4.109429714857429,0.0,0.0
17996,1,7996,[ 64 483  12 427  11],214,5,32864,4.109541077904214,60.0,0.0
17997,1,7997,[ 64 483  12 427  11],618,5,32869,4.109652413103276,60.0,0.0
17998,1,7998,[197 125 173   4 323],345,3,32872,4.109513689211151,0.0,0.0
17999,1,7999,[ 11 748 275  56 423],416,5,32877,4.109625,0.0,0.0
18000,1,8000,[ 64 483  12 427  11],214,5,32882,4.109736282964629,60.0,0.0
18001,1,8001,[ 64 483  12 427  11],214,5,32887,4.1098475381154715,60.0,0.0
18002,1,8002,[176 258 427 423 475],416,4,32891,4.10983381232038,0.0,0.0
18003,1,8003,[  9 588   1 427 289],416,4,32895,4.109820089955022,0.0,0.0
18004,1,8004,[  1 234 273 185  95],618,4,32899,4.109806371018114,0.0,0.0
18005,1,8005,[318 197 100 588  15],345,4,32903,4.109792655508369,20.0,0.0
18006,1,8006,[ 64 483  12 427  11],618,5,32908,4.109903834145123,60.0,0.0
18007,1,8007,[ 64 483  12 427  11],214,5,32913,4.110014985014985,60.0,0.0
18008,1,8008,[546 168 269 318 117],43,5,32918,4.110126108128355,20.0,0.0
18009,1,8009,[202 515 748  69 185],417,3,32921,4.109987515605493,0.0,0.0
18010,1,8010,[ 64 483  12 427  11],618,5,32926,4.110098614405193,60.0,0.0
18011,1,8011,[403 289 196 276  25],416,3,32929,4.109960059910135,0.0,0.0
18012,1,8012,[151 300  28 210 597],416,3,32932,4.109821539997504,0.0,0.0
18013,1,8013,[313 328 194   9 318],416,5,32937,4.109932617918642,40.0,20.0
18014,1,8014,[ 88 237 151 471  97],416,2,32939,4.109669369931379,0.0,0.0
18015,1,8015,[127 174 403 185 234],198,3,32942,4.109530938123752,0.0,0.0
18016,1,8016,[197  28 100 175 286],297,4,32946,4.109517275788948,0.0,0.0
18017,1,8017,[143 245 471 282 181],128,3,32949,4.109378897480669,0.0,20.0
18018,1,8018,[ 64 483  12 427  11],618,5,32954,4.109489961341813,60.0,0.0
18019,1,8019,[ 11 294 357 496  64],230,5,32959,4.109600997506234,20.0,0.0
18020,1,8020,[ 50 118 588 237  56],43,5,32964,4.109712005984291,0.0,20.0
18021,1,8021,[211  22 269 265 111],297,3,32967,4.109573672400898,0.0,0.0
18022,1,8022,[ 64 483  12 427  11],618,5,32972,4.10968465661224,60.0,0.0
18023,1,8023,[286 202 216 185 174],417,2,32974,4.109421734795613,0.0,0.0
18024,1,8024,[269 183 191 151 215],416,4,32978,4.109408099688474,0.0,0.0
18025,1,8025,[197 289 183 300 118],416,3,32981,4.109269872913033,0.0,0.0
18026,1,8026,[ 64 483  12 427  11],214,5,32986,4.109380839666127,60.0,0.0
18027,1,8027,[286 117  95  79 235],297,2,32988,4.109118086696562,0.0,0.0
18028,1,8028,[ 64 483  12 427  11],214,5,32993,4.109229044712916,60.0,0.0
18029,1,8029,[187  88  96 144 210],505,3,32996,4.109090909090909,0.0,0.0
18030,1,8030,[173 288 211 197 238],297,3,32999,4.108952807869506,0.0,20.0
18031,1,8031,[ 64 483  12 427  11],214,5,33004,4.10906374501992,60.0,0.0
18032,1,8032,[ 64 483  12 427  11],618,5,33009,4.109174654549982,60.0,0.0
18033,1,8033,[176 475 237 357  70],62,3,33012,4.109036594473488,0.0,0.0
18034,1,8034,[276   8 496 144 135],437,4,33016,4.109023024268824,0.0,0.0
18035,1,8035,[ 98  56   1 111 496],43,5,33021,4.109133897461423,0.0,20.0
18036,1,8036,[180 228 168 237 273],62,3,33024,4.108995893990295,0.0,0.0
18037,1,8037,[ 64 483  12 427  11],618,5,33029,4.109106742970888,60.0,0.0
18038,1,8038,[183 176  64   1 271],62,3,33032,4.108968777211096,20.0,0.0
18039,1,8039,[ 64 483  12 427  11],618,5,33037,4.10907960199005,60.0,0.0
18040,1,8040,[ 64 483  12 427  11],214,5,33042,4.1091903992040795,60.0,0.0
18041,1,8041,[172 117 678  71 197],416,4,33046,4.109176821686147,0.0,0.0
18042,1,8042,[403 121  50  28  88],43,5,33051,4.10928757926147,0.0,20.0
18043,1,8043,[294 748 275 181 328],550,4,33055,4.10927399303829,0.0,20.0
18044,1,8044,[ 64 483  12 427  11],214,5,33060,4.109384711000621,60.0,0.0
18045,1,8045,[ 64 483  12 427  11],214,5,33065,4.10949540144171,60.0,0.0
18046,1,8046,[210 215 323 546 742],416,3,33068,4.1093575245433085,0.0,0.0
18047,1,8047,[117 187 300 328 748],416,5,33073,4.109468190854871,0.0,0.0
18048,1,8048,[ 71 742 603  70 268],416,5,33078,4.109578829668282,0.0,0.0
18049,1,8049,[ 64 597 276 318 568],62,3,33081,4.109440993788819,40.0,0.0
18050,1,8050,[ 64 483  12 427  11],214,5,33086,4.109551608495839,60.0,0.0
18051,1,8051,[ 64 483  12 427  11],214,5,33091,4.109662195727769,60.0,0.0
18052,1,8052,[ 64 483  12 427  11],618,5,33096,4.109772755494847,60.0,0.0
18053,1,8053,[ 64 483  12 427  11],618,5,33101,4.109883287807301,60.0,0.0
18054,1,8054,[215 603 194 471 357],373,4,33105,4.109869646182496,0.0,0.0
18055,1,8055,[ 64 483  12 427  11],618,5,33110,4.1099801390268125,60.0,0.0
18056,1,8056,[ 64 483  12 427  11],618,5,33115,4.110090604443341,60.0,0.0
18057,1,8057,[ 64 483  12 427  11],618,5,33120,4.110201042442293,60.0,0.0
18058,1,8058,[655 173 172  50 182],416,5,33125,4.110311453033876,0.0,20.0
18059,1,8059,[ 64 483  12 427  11],214,5,33130,4.110421836228288,60.0,0.0
18060,1,8060,[187 117 318   4 265],416,5,33135,4.110532192035728,20.0,0.0
18061,1,8061,[403 180 161 191 176],405,2,33137,4.110270404366163,0.0,0.0
18062,1,8062,[ 64 483  12 427  11],214,5,33142,4.110380751581297,60.0,0.0
18063,1,8063,[ 64 483  12 427  11],214,5,33147,4.110491071428571,60.0,0.0
18064,1,8064,[ 79 323  25 508 186],417,1,33148,4.110105393676379,0.0,0.0
18065,1,8065,[ 64 483  12 427  11],618,5,33153,4.110215720307464,60.0,0.0
18066,1,8066,[135 234 405 235 174],805,2,33155,4.109954134126689,0.0,0.0
18067,1,8067,[237   8 181  97 508],62,3,33158,4.109816559246406,0.0,20.0
18068,1,8068,[ 79 678 191  25 238],345,3,33161,4.109679018465733,0.0,0.0
18069,1,8069,[ 64 483  12 427  11],214,5,33166,4.109789343246592,60.0,0.0
18070,1,8070,[111 153 196 132  22],62,4,33170,4.109775740304795,0.0,0.0
18071,1,8071,[269 215   8 179 235],416,3,33173,4.109638255698711,0.0,0.0
18072,1,8072,[ 50  96 135 276 237],618,3,33176,4.109500805152979,0.0,20.0
18073,1,8073,[ 64 483  12 427  11],618,5,33181,4.109611097349517,60.0,0.0
18074,1,8074,[ 64 483  12 427  11],214,5,33186,4.109721362229102,60.0,0.0
18075,1,8075,[286 195 168 588 508],297,4,33190,4.109707776126795,0.0,0.0
18076,1,8076,[ 64 483  12 427  11],618,5,33195,4.109818001733317,60.0,0.0
18077,1,8077,[ 64 483  12 427  11],214,5,33200,4.109928200049517,60.0,0.0
18078,1,8078,[  7 215 288 121 204],618,3,33203,4.109790815695011,0.0,20.0
18079,1,8079,[197 323 268 289 403],721,3,33206,4.109653465346534,0.0,0.0
18080,1,8080,[ 64 483  12 427  11],214,5,33211,4.109763643113476,60.0,0.0
18081,1,8081,[ 64 483  12 427  11],618,5,33216,4.109873793615442,60.0,0.0
18082,1,8082,[ 64 483  12 427  11],214,5,33221,4.109983916862551,60.0,0.0
18083,1,8083,[ 64 483  12 427  11],618,5,33226,4.110094012864918,60.0,0.0
18084,1,8084,[204 194 191 172 273],416,5,33231,4.110204081632653,0.0,0.0
18085,1,8085,[ 64 483  12 427  11],214,5,33236,4.1103141231758595,60.0,0.0
18086,1,8086,[ 28 748 302 588   4],345,2,33238,4.110053171757141,0.0,0.0
18087,1,8087,[  1  95 204 234 202],618,2,33240,4.109792284866469,0.0,0.0
18088,1,8088,[  1 245 183 275 301],416,4,33244,4.109778711830882,0.0,0.0
18089,1,8089,[ 64 483  12 427  11],214,5,33249,4.1098887515451175,60.0,0.0
18090,1,8090,[ 64 483  12 427  11],618,5,33254,4.1099987640588305,60.0,0.0
18091,1,8091,[ 64 483  12 427  11],618,5,33259,4.110108749382106,60.0,0.0
18092,1,8092,[ 64 483  12 427  11],618,5,33264,4.110218707525021,60.0,0.0
18093,1,8093,[ 64 483  12 427  11],618,5,33269,4.110328638497653,60.0,0.0
18094,1,8094,[427 288   1 597 187],416,4,33273,4.110315009264978,0.0,20.0
18095,1,8095,[ 64 483  12 427  11],618,5,33278,4.1104249011857705,60.0,0.0
18096,1,8096,[ 64 483  12 427  11],618,5,33283,4.1105347659627025,60.0,0.0
18097,1,8097,[ 64 483  12 427  11],214,5,33288,4.110644603605828,60.0,0.0
18098,1,8098,[ 79 427 258 568 186],198,3,33291,4.110507470058032,0.0,0.0
18099,1,8099,[ 64 483  12 427  11],214,5,33296,4.110617283950617,60.0,0.0
18100,1,8100,[196 258 289 153 173],721,3,33299,4.110480187631157,0.0,0.0
18101,1,8101,[117 302 211 237 118],416,3,33302,4.110343125154283,0.0,0.0
18102,1,8102,[143 294 210 323 181],345,3,33305,4.110206096507467,0.0,20.0
18103,1,8103,[301 318  70 269 151],416,4,33309,4.110192497532083,20.0,0.0
18104,1,8104,[144  12  56  64  22],854,3,33312,4.110055521283159,40.0,0.0
18105,1,8105,[ 64 483  12 427  11],214,5,33317,4.110165309647175,60.0,0.0
18106,1,8106,[ 56   4 135  22 127],405,5,33322,4.11027507092636,0.0,0.0
18107,1,8107,[  4 742 153 300 215],43,5,33327,4.110384805130735,0.0,0.0
18108,1,8108,[ 64 483  12 427  11],618,5,33332,4.110494512270317,60.0,0.0
18109,1,8109,[ 64 483  12 427  11],214,5,33337,4.110604192355117,60.0,0.0
18110,1,8110,[286  15 175 180 111],854,2,33339,4.110343977314757,0.0,0.0
18111,1,8111,[ 64 483  12 427  11],618,5,33344,4.110453648915187,60.0,0.0
18112,1,8112,[ 64 483  12 427  11],618,5,33349,4.110563293479601,60.0,0.0
18113,1,8113,[ 64 483  12 427  11],214,5,33354,4.110672911017994,60.0,0.0
18114,1,8114,[237 235 238 153 328],62,3,33357,4.110536044362292,0.0,0.0
18115,1,8115,[ 64 483  12 427  11],214,5,33362,4.110645638245441,60.0,0.0
18116,1,8116,[ 64 483  12 427  11],618,5,33367,4.110755205125046,60.0,0.0
18117,1,8117,[288 235 471 132 515],416,4,33371,4.110741561961074,0.0,20.0
18118,1,8118,[200  12 181 258 471],297,3,33374,4.110604754280084,20.0,20.0
18119,1,8119,[  1 196 235 185 597],417,2,33376,4.110344827586207,0.0,0.0
18120,1,8120,[ 64 483  12 427  11],618,5,33381,4.110454377539712,60.0,0.0
18121,1,8121,[174 588 427 222 210],705,3,33384,4.110317655749816,0.0,0.0
18122,1,8122,[187  69  96  28 588],618,4,33388,4.110304074849194,0.0,0.0
18123,1,8123,[ 64 483  12 427  11],618,5,33393,4.110413589364845,60.0,0.0
18124,1,8124,[ 64 483  12 427  11],618,5,33398,4.1105230769230765,60.0,0.0
18125,1,8125,[  4 258  82 197 288],805,1,33399,4.110140290425794,0.0,20.0
18126,1,8126,[ 64 483  12 427  11],214,5,33404,4.110249784668389,60.0,0.0
18127,1,8127,[ 64 483  12 427  11],618,5,33409,4.110359251968504,60.0,0.0
18128,1,8128,[ 64 483  12 427  11],618,5,33414,4.110468692336081,60.0,0.0
18129,1,8129,[176 186  98 228  69],198,4,33418,4.110455104551045,0.0,20.0
18130,1,8130,[ 64 483  12 427  11],618,5,33423,4.110564506210798,60.0,0.0
18131,1,8131,[ 64 483  12 427  11],618,5,33428,4.110673880964092,60.0,0.0
18132,1,8132,[ 56  88 742 427 245],416,3,33431,4.11053731710316,0.0,0.0
18133,1,8133,[ 64 483  12 427  11],214,5,33436,4.110646668305876,60.0,0.0
18134,1,8134,[  7   4 143  11 204],297,3,33439,4.1105101413644745,0.0,0.0
18135,1,8135,[ 64 483  12 427  11],214,5,33444,4.110619469026549,60.0,0.0
18136,1,8136,[ 69  88 405   8 117],642,4,33448,4.110605874400885,0.0,0.0
18137,1,8137,[ 64 483  12 427  11],214,5,33453,4.110715163430818,60.0,0.0
18138,1,8138,[ 64 483  12 427  11],618,5,33458,4.110824425605111,60.0,0.0
18139,1,8139,[ 64 483  12 427  11],618,5,33463,4.110933660933661,60.0,0.0
18140,1,8140,[294 181 175 588 655],805,1,33464,4.110551529296155,0.0,20.0
18141,1,8141,[ 64 483  12 427  11],214,5,33469,4.11066077130926,60.0,0.0
18142,1,8142,[ 64 483  12 427  11],214,5,33474,4.110769986491465,60.0,0.0
18143,1,8143,[ 64 483  12 427  11],618,5,33479,4.110879174852652,60.0,0.0
18144,1,8144,[ 64 483  12 427  11],214,5,33484,4.110988336402701,60.0,0.0
18145,1,8145,[ 64 483  12 427  11],214,5,33489,4.111097471151486,60.0,0.0
18146,1,8146,[ 64 483  12 427  11],618,5,33494,4.111206579108875,60.0,0.0
18147,1,8147,[181 191  97 125  69],417,3,33497,4.1110702012763864,0.0,20.0
18148,1,8148,[ 64 483  12 427  11],214,5,33502,4.1111792858019385,60.0,0.0
18149,1,8149,[179 235  96 161 588],805,2,33504,4.110920245398773,0.0,0.0
18150,1,8150,[313 181 427 196 191],711,5,33509,4.1110293215556375,20.0,40.0
18151,1,8151,[ 64 483  12 427  11],214,5,33514,4.111138370951914,60.0,0.0
18152,1,8152,[ 64 483  12 427  11],618,5,33519,4.1112473935974485,60.0,0.0
18153,1,8153,[286 111 597 403 183],705,3,33522,4.111111111111111,0.0,0.0
18154,1,8154,[  4  82 483 385 172],618,4,33526,4.111097486204782,20.0,0.0
18155,1,8155,[302 174 135  64 423],405,5,33531,4.111206473761648,20.0,0.0
18156,1,8156,[  1 174 655 181  15],345,4,33535,4.111192840505088,0.0,20.0
18157,1,8157,[191 174  50 153 275],698,2,33537,4.110934052463839,0.0,20.0
18158,1,8158,[ 64 483  12 427  11],618,5,33542,4.111043019977939,60.0,0.0
18159,1,8159,[597 181 748 265 168],416,4,33546,4.111029411764706,0.0,20.0
18160,1,8160,[333  64  50 237 125],721,2,33548,4.110770738880039,20.0,20.0
18161,1,8161,[403 118 588  88 257],541,3,33551,4.110634648370498,0.0,0.0
18162,1,8162,[ 64 483  12 427  11],618,5,33556,4.110743599166973,60.0,0.0
18163,1,8163,[ 64 483  12 427  11],618,5,33561,4.110852523272905,60.0,0.0
18164,1,8164,[323 258 357 173  64],416,4,33565,4.110838946723821,20.0,0.0
18165,1,8165,[ 95 210 204  25 238],416,4,33569,4.110825373499877,0.0,0.0
18166,1,8166,[ 64 483  12 427  11],618,5,33574,4.110934247581731,60.0,0.0
18167,1,8167,[216 196   8  64   9],416,5,33579,4.111043095004897,20.0,0.0
18168,1,8168,[ 64 483  12 427  11],618,5,33584,4.111151915779165,60.0,0.0
18169,1,8169,[ 64 483  12 427  11],214,5,33589,4.111260709914321,60.0,0.0
18170,1,8170,[ 64 483  12 427  11],618,5,33594,4.111369477420144,60.0,0.0
18171,1,8171,[187 603 181 385 121],698,2,33596,4.111111111111111,0.0,20.0
18172,1,8172,[385   1 111 288  98],417,3,33599,4.110975162119173,0.0,40.0
18173,1,8173,[742 603 235 294 121],416,4,33603,4.110961585515048,0.0,0.0
18174,1,8174,[ 64 483  12 427  11],618,5,33608,4.111070336391437,60.0,0.0
18175,1,8175,[245 403  89 286   4],62,3,33611,4.110934442270059,0.0,0.0
18176,1,8176,[385 597 216 127   4],43,4,33615,4.110920875626758,0.0,0.0
18177,1,8177,[282  79 568 202   1],618,3,33618,4.110785033015407,0.0,0.0
18178,1,8178,[194 180 186 588 161],405,1,33619,4.110404694950483,0.0,0.0
18179,1,8179,[ 64 483  12 427  11],214,5,33624,4.110513447432763,60.0,0.0
18180,1,8180,[273   4  25 117  50],417,1,33625,4.110133235545777,0.0,20.0
18181,1,8181,[ 64 483  12 427  11],618,5,33630,4.110241994622342,60.0,0.0
18182,1,8182,[ 64 483  12 427  11],618,5,33635,4.110350727117194,60.0,0.0
18183,1,8183,[588  12   8  88  50],805,2,33637,4.110092864125122,20.0,20.0
18184,1,8184,[ 64 483  12 427  11],618,5,33642,4.110201588271228,60.0,0.0
18185,1,8185,[ 64 483  12 427  11],214,5,33647,4.110310285853897,60.0,0.0
18186,1,8186,[ 64 483  12 427  11],618,5,33652,4.110418956882863,60.0,0.0
18187,1,8187,[288 132 405 483  98],417,3,33655,4.11028334147533,20.0,40.0
18188,1,8188,[ 64 483  12 427  11],214,5,33660,4.110391989253877,60.0,0.0
18189,1,8189,[ 64 483  12 427  11],618,5,33665,4.11050061050061,60.0,0.0
18190,1,8190,[ 64 483  12 427  11],214,5,33670,4.110609205225248,60.0,0.0
18191,1,8191,[ 64 483  12 427  11],618,5,33675,4.1107177734375,60.0,0.0
18192,1,8192,[ 64 483  12 427  11],214,5,33680,4.110826315147077,60.0,0.0
18193,1,8193,[286  88 333 268 144],588,4,33684,4.1108127898462286,0.0,0.0
18194,1,8194,[ 64 483  12 427  11],618,5,33689,4.110921293471629,60.0,0.0
18195,1,8195,[ 64 483  12 427  11],618,5,33694,4.1110297706198144,60.0,0.0
18196,1,8196,[405 175 269 234  82],805,3,33697,4.110894229596194,0.0,0.0
18197,1,8197,[ 64 483  12 427  11],214,5,33702,4.111002683581361,60.0,0.0
18198,1,8198,[655 603 427 174 265],373,5,33707,4.111111111111111,0.0,0.0
18199,1,8199,[ 98 100 222  64 195],417,3,33710,4.110975609756098,20.0,20.0
18200,1,8200,[568 288 125 151  56],314,4,33714,4.110962077795391,0.0,20.0
18201,1,8201,[ 64 483  12 427  11],214,5,33719,4.111070470616923,60.0,0.0
18202,1,8202,[  1 496 186   7  12],417,3,33722,4.110935023771791,20.0,0.0
18203,1,8203,[ 64 483  12 427  11],618,5,33727,4.111043393466602,60.0,0.0
18204,1,8204,[ 98 228 748 237  97],297,3,33730,4.110907982937233,0.0,20.0
18205,1,8205,[195 194 423 603 197],854,3,33733,4.110772605410675,0.0,0.0
18206,1,8206,[ 11 168  98  50 508],297,5,33738,4.110880955282076,0.0,40.0
18207,1,8207,[151 197   4 235 117],805,2,33740,4.110623781676413,0.0,0.0
18208,1,8208,[228  22 176 318 100],601,4,33744,4.110610305761969,20.0,0.0
18209,1,8209,[322 276  28 423 168],128,4,33748,4.110596833130329,0.0,0.0
18210,1,8210,[ 64 483  12 427  11],618,5,33753,4.110705151625868,60.0,0.0
18211,1,8211,[ 22   1 258  64 427],642,3,33756,4.1105698977106675,20.0,0.0
18212,1,8212,[678 216  71   1  98],416,4,33760,4.110556434920248,0.0,20.0
18213,1,8213,[ 64 483  12 427  11],214,5,33765,4.110664718772827,60.0,0.0
18214,1,8214,[ 64 483  12 427  11],214,5,33770,4.1107729762629335,60.0,0.0
18215,1,8215,[173 132 174 546  25],416,4,33774,4.110759493670886,0.0,0.0
18216,1,8216,[121  79 153  15 176],437,3,33777,4.110624315443593,0.0,0.0
18217,1,8217,[ 64 483  12 427  11],618,5,33782,4.1107325383304945,60.0,0.0
18218,1,8218,[ 64 483  12 427  11],618,5,33787,4.110840734882589,60.0,0.0
18219,1,8219,[ 64 483  12 427  11],618,5,33792,4.110948905109489,60.0,0.0
18220,1,8220,[269 471  88 191  98],416,4,33796,4.110935409317602,0.0,20.0
18221,1,8221,[185   7 475 483 200],854,5,33801,4.111043541717343,20.0,0.0
18222,1,8222,[ 12 144  22 235 100],854,2,33803,4.110786817463213,20.0,0.0
18223,1,8223,[ 56 168  82 385 302],43,5,33808,4.110894941634241,0.0,0.0
18224,1,8224,[ 64 483  12 427  11],214,5,33813,4.111003039513678,60.0,0.0
18225,1,8225,[111  22 204 328 117],314,5,33818,4.111111111111111,0.0,0.0
18226,1,8226,[ 64 483  12 427  11],618,5,33823,4.111219156436125,60.0,0.0
18227,1,8227,[ 64 483  12 427  11],618,5,33828,4.111327175498299,60.0,0.0
18228,1,8228,[ 64 483  12 427  11],214,5,33833,4.111435168307207,60.0,0.0
18229,1,8229,[ 64 483  12 427  11],618,5,33838,4.111543134872418,60.0,0.0
18230,1,8230,[127 288 475 173 191],416,4,33842,4.111529583282712,0.0,20.0
18231,1,8231,[286  89 202 135  79],711,5,33847,4.111637512147716,0.0,0.0
18232,1,8232,[118 258 172 273 144],805,1,33848,4.111259565164581,0.0,0.0
18233,1,8233,[ 28 742   4  22 597],416,4,33852,4.111246052951178,0.0,0.0
18234,1,8234,[ 64 483  12 427  11],618,5,33857,4.111353976927748,60.0,0.0
18235,1,8235,[269 328 216  82 196],721,5,33862,4.111461874696454,0.0,0.0
18236,1,8236,[ 64 483  12 427  11],618,5,33867,4.111569746266845,60.0,0.0
18237,1,8237,[173 289 121   8 423],49,1,33868,4.11119203690216,0.0,0.0
18238,1,8238,[ 64 483  12 427  11],618,5,33873,4.1112999150382326,60.0,0.0
18239,1,8239,[186 191 153 496 117],43,4,33877,4.111286407766991,0.0,0.0
18240,1,8240,[ 64 483  12 427  11],618,5,33882,4.111394248270841,60.0,0.0
18241,1,8241,[ 64 483  12 427  11],214,5,33887,4.111502062606164,60.0,0.0
18242,1,8242,[ 96 245 111 235  79],907,5,33892,4.111609850782482,0.0,0.0
18243,1,8243,[ 98 603 151 127 210],416,4,33896,4.111596312469675,0.0,20.0
18244,1,8244,[ 64 483  12 427  11],618,5,33901,4.111704063068526,60.0,0.0
18245,1,8245,[ 64 483  12 427  11],618,5,33906,4.111811787533349,60.0,0.0
18246,1,8246,[144 186  25 265 238],230,2,33908,4.111555717230508,0.0,0.0
18247,1,8247,[ 64 483  12 427  11],214,5,33913,4.1116634335596505,60.0,0.0
18248,1,8248,[ 64 483  12 427  11],618,5,33918,4.111771123772579,60.0,0.0
18249,1,8249,[588 161 475 181 597],417,1,33919,4.111393939393939,0.0,20.0
18250,1,8250,[143 313   4 238 655],405,5,33924,4.111501636165313,20.0,20.0
18251,1,8251,[288 182 153 546 742],416,4,33928,4.11148812409113,0.0,20.0
18252,1,8252,[ 64 483  12 427  11],618,5,33933,4.111595783351508,60.0,0.0
18253,1,8253,[ 64 483  12 427  11],214,5,33938,4.111703416525321,60.0,0.0
18254,1,8254,[195 118  70 496 655],437,2,33940,4.111447607510599,0.0,0.0
18255,1,8255,[ 64 483  12 427  11],618,5,33945,4.11155523255814,60.0,0.0
18256,1,8256,[ 64 483  12 427  11],618,5,33950,4.1116628315368775,60.0,0.0
18257,1,8257,[ 64 483  12 427  11],214,5,33955,4.111770404456284,60.0,0.0
18258,1,8258,[ 64 483  12 427  11],618,5,33960,4.111877951325827,60.0,0.0
18259,1,8259,[ 64 483  12 427  11],214,5,33965,4.111985472154964,60.0,0.0
18260,1,8260,[ 64 483  12 427  11],618,5,33970,4.112092966953154,60.0,0.0
18261,1,8261,[ 64 483  12 427  11],214,5,33975,4.112200435729847,60.0,0.0
18262,1,8262,[181 132   8 174 202],588,3,33978,4.112065835652911,0.0,20.0
18263,1,8263,[211 245 191 179  69],416,3,33981,4.111931268151016,0.0,0.0
18264,1,8264,[ 56 496  15 318 151],314,4,33985,4.111917725347852,20.0,0.0
18265,1,8265,[515  28 655 323 286],416,4,33989,4.111904185821437,0.0,0.0
18266,1,8266,[286 191 515  97  79],416,5,33994,4.112011612434983,0.0,0.0
18267,1,8267,[204 151  71 187 127],198,3,33997,4.111877116594098,0.0,0.0
18268,1,8268,[  4 228 234 195 323],198,0,33997,4.111379852460999,0.0,0.0
18269,1,8269,[  1 475  28 216 302],62,2,33999,4.111124546553809,0.0,0.0
18270,1,8270,[200 132 191 302 237],416,4,34003,4.111111111111111,0.0,0.0
18271,1,8271,[ 50  71  79 568 151],198,2,34005,4.110855899419729,0.0,20.0
18272,1,8272,[ 11   1   7 302  69],297,3,34008,4.110721624561828,0.0,0.0
18273,1,8273,[ 64 483  12 427  11],618,5,34013,4.11082910321489,60.0,0.0
18274,1,8274,[  1 127 588 174 228],922,4,34017,4.110815709969788,0.0,0.0
18275,1,8275,[ 64 483  12 427  11],618,5,34022,4.110923151280812,60.0,0.0
18276,1,8276,[ 64 483  12 427  11],214,5,34027,4.111030566630421,60.0,0.0
18277,1,8277,[ 64 483  12 427  11],618,5,34032,4.111137956028026,60.0,0.0
18278,1,8278,[269 268 215 655  22],416,5,34037,4.11124531948303,0.0,0.0
18279,1,8279,[ 11 742  97 268 195],654,3,34040,4.111111111111111,0.0,0.0
18280,1,8280,[ 64 483  12 427  11],618,5,34045,4.111218451877792,60.0,0.0
18281,1,8281,[ 79 168 328 405 210],416,5,34050,4.111325766723014,0.0,0.0
18282,1,8282,[ 64 483  12 427  11],618,5,34055,4.111433055656163,60.0,0.0
18283,1,8283,[ 64 483  12 427  11],618,5,34060,4.111540318686624,60.0,0.0
18284,1,8284,[228   1  70 275  82],62,2,34062,4.111285455642728,0.0,0.0
18285,1,8285,[ 64 483  12 427  11],214,5,34067,4.111392710596187,60.0,0.0
18286,1,8286,[ 64 483  12 427  11],214,5,34072,4.111499939664535,60.0,0.0
18287,1,8287,[515 588 143 175 186],405,2,34074,4.111245173745174,0.0,0.0
18288,1,8288,[ 64 483  12 427  11],214,5,34079,4.111352394740017,60.0,0.0
18289,1,8289,[ 64 483  12 427  11],214,5,34084,4.11145958986731,60.0,0.0
18290,1,8290,[127 405  98  25 588],416,5,34089,4.111566759136413,0.0,20.0
18291,1,8291,[186 269   9 322 271],854,3,34092,4.111432706222866,0.0,0.0
18292,1,8292,[ 64 483  12 427  11],618,5,34097,4.111539852887978,60.0,0.0
18293,1,8293,[ 64 483  12 427  11],618,5,34102,4.111646973715939,60.0,0.0
18294,1,8294,[ 64 483  12 427  11],618,5,34107,4.111754068716094,60.0,0.0
18295,1,8295,[ 96 172 121 117 173],198,3,34110,4.111620057859209,0.0,0.0
18296,1,8296,[ 64 483  12 427  11],618,5,34115,4.111727130288056,60.0,0.0
18297,1,8297,[ 64 483  12 427  11],214,5,34120,4.111834176910099,60.0,0.0
18298,1,8298,[ 64 483  12 427  11],618,5,34125,4.111941197734667,60.0,0.0
18299,1,8299,[ 28 588 144   8 568],230,3,34128,4.111807228915663,0.0,0.0
18300,1,8300,[118 151 173  28 405],345,3,34131,4.111673292374412,0.0,0.0
18301,1,8301,[ 64 483  12 427  11],618,5,34136,4.111780293905083,60.0,0.0
18302,1,8302,[ 64 483  12 427  11],618,5,34141,4.111887269661568,60.0,0.0
18303,1,8303,[ 64 483  12 427  11],214,5,34146,4.111994219653179,60.0,0.0
18304,1,8304,[202  97 197 183 215],618,3,34149,4.111860325105358,0.0,0.0
18305,1,8305,[185 268 302 655 197],416,5,34154,4.1119672525884905,0.0,0.0
18306,1,8306,[655 111 191 423  98],262,5,34159,4.112074154327676,0.0,20.0
18307,1,8307,[ 64 483  12 427  11],618,5,34164,4.11218103033221,60.0,0.0
18308,1,8308,[235 191  71 118 471],345,1,34165,4.111806474906728,0.0,0.0
18309,1,8309,[222 235 151  88 216],43,4,34169,4.111793020457281,0.0,0.0
18310,1,8310,[197 423 161 210  22],618,3,34172,4.111659246781374,0.0,0.0
18311,1,8311,[ 64 483  12 427  11],214,5,34177,4.111766121270453,60.0,0.0
18312,1,8312,[234 153 302 515  79],297,3,34180,4.111632383014555,0.0,0.0
18313,1,8313,[ 64 483  12 427  11],618,5,34185,4.111739235025259,60.0,0.0
18314,1,8314,[143 323 175 200 405],198,1,34186,4.111365003006615,0.0,0.0
18315,1,8315,[ 64 483  12 427  11],618,5,34191,4.111471861471862,60.0,0.0
18316,1,8316,[276 238 181 174 742],128,3,34194,4.111338222916917,0.0,20.0
18317,1,8317,[ 64 483  12 427  11],214,5,34199,4.111445058908392,60.0,0.0
18318,1,8318,[ 64 483  12 427  11],214,5,34204,4.11155186921505,60.0,0.0
18319,1,8319,[ 64 483  12 427  11],618,5,34209,4.1116586538461535,60.0,0.0
18320,1,8320,[257 161   9 546  22],314,5,34214,4.111765412810961,0.0,0.0
18321,1,8321,[568 471 222 215 228],922,2,34216,4.111511655851959,0.0,0.0
18322,1,8322,[ 64 483  12 427  11],618,5,34221,4.111618406824462,60.0,0.0
18323,1,8323,[508  88 237 191 216],128,5,34226,4.111725132148006,0.0,0.0
18324,1,8324,[ 64 483  12 427  11],618,5,34231,4.111831831831831,60.0,0.0
18325,1,8325,[ 69  15 202  12 211],416,5,34236,4.111938505885179,20.0,0.0
18326,1,8326,[ 25 100 195 275 742],416,5,34241,4.112045154317281,0.0,0.0
18327,1,8327,[173 222 153   7 294],43,5,34246,4.112151777137368,0.0,0.0
18328,1,8328,[ 64 483  12 427  11],618,5,34251,4.112258374354664,60.0,0.0
18329,1,8329,[ 69 655 121  88  25],416,4,34255,4.112244897959184,0.0,0.0
18330,1,8330,[176 423 288 168 200],416,5,34260,4.112351458408354,0.0,20.0
18331,1,8331,[ 64 483  12 427  11],214,5,34265,4.112457993278925,60.0,0.0
18332,1,8332,[496 588   9 211 181],416,5,34270,4.112564502580104,0.0,20.0
18333,1,8333,[151 655 313 597  96],618,3,34273,4.112431005519558,20.0,20.0
18334,1,8334,[357  64 135 294 182],214,3,34276,4.112297540491902,20.0,0.0
18335,1,8335,[179 132 405  89 423],417,4,34280,4.112284069097889,0.0,0.0
18336,1,8336,[ 64 483  12 427  11],214,5,34285,4.11239054815881,60.0,0.0
18337,1,8337,[385  88  64 265  79],416,4,34289,4.1123770688414485,20.0,0.0
18338,1,8338,[ 64 483  12 427  11],214,5,34294,4.112483511212376,60.0,0.0
18339,1,8339,[ 64 483  12 427  11],214,5,34299,4.112589928057554,60.0,0.0
18340,1,8340,[ 64 483  12 427  11],214,5,34304,4.112696319386164,60.0,0.0
18341,1,8341,[ 64 483  12 427  11],618,5,34309,4.1128026852073845,60.0,0.0
18342,1,8342,[172  82 238 153 265],416,5,34314,4.112909025530385,0.0,0.0
18343,1,8343,[ 50 161 200 168 496],711,5,34319,4.113015340364334,0.0,20.0
18344,1,8344,[318 568  95 515 143],416,4,34323,4.113001797483523,20.0,0.0
18345,1,8345,[ 64 483  12 427  11],618,5,34328,4.113108075724898,60.0,0.0
18346,1,8346,[118 286 678 185 132],416,3,34331,4.112974721456811,0.0,0.0
18347,1,8347,[ 64 483  12 427  11],618,5,34336,4.113080977479636,60.0,0.0
18348,1,8348,[238 237 100  64  69],345,5,34341,4.113187208048868,20.0,0.0
18349,1,8349,[161  98 588 655  22],618,5,34346,4.113293413173652,0.0,20.0
18350,1,8350,[ 64  97 176 168 546],417,4,34350,4.113279846724943,20.0,0.0
18351,1,8351,[ 64 483  12 427  11],618,5,34355,4.113386015325671,60.0,0.0
18352,1,8352,[ 64 483  12 427  11],214,5,34360,4.113492158505926,60.0,0.0
18353,1,8353,[ 64 483  12 427  11],618,5,34365,4.113598276274838,60.0,0.0
18354,1,8354,[ 64 483  12 427  11],618,5,34370,4.113704368641532,60.0,0.0
18355,1,8355,[ 64 483  12 427  11],618,5,34375,4.113810435615127,60.0,0.0
18356,1,8356,[210 288 265 405 258],417,1,34376,4.113437836544215,0.0,20.0
18357,1,8357,[ 64 483  12 427  11],214,5,34381,4.113543910026322,60.0,0.0
18358,1,8358,[245 273  70 111 196],416,4,34385,4.11353032659409,0.0,0.0
18359,1,8359,[ 64 483  12 427  11],618,5,34390,4.113636363636363,60.0,0.0
18360,1,8360,[ 64 483  12 427  11],618,5,34395,4.113742375313958,60.0,0.0
18361,1,8361,[ 64 483  12 427  11],618,5,34400,4.113848361635973,60.0,0.0
18362,1,8362,[ 64 483  12 427  11],618,5,34405,4.113954322611503,60.0,0.0
18363,1,8363,[ 64 483  12 427  11],214,5,34410,4.1140602582496415,60.0,0.0
18364,1,8364,[ 64 483  12 427  11],618,5,34415,4.114166168559474,60.0,0.0
18365,1,8365,[174 197 117 151 196],128,3,34418,4.114032990676548,0.0,0.0
18366,1,8366,[ 12 181 125 216 268],345,4,34422,4.114019361778415,20.0,20.0
18367,1,8367,[180  98  12 405 678],805,3,34425,4.113886233269598,20.0,20.0
18368,1,8368,[ 64 483  12 427  11],214,5,34430,4.113992113753136,60.0,0.0
18369,1,8369,[144   1 742 211 268],416,5,34435,4.114097968936679,0.0,0.0
18370,1,8370,[216 742  97 168  11],417,3,34438,4.1139648787480585,0.0,0.0
18371,1,8371,[ 64 483  12 427  11],618,5,34443,4.114070711896799,60.0,0.0
18372,1,8372,[546  82 100 357 168],416,4,34447,4.114057088259883,0.0,0.0
18373,1,8373,[588   1  88 202 117],618,4,34451,4.114043467876761,0.0,0.0
18374,1,8374,[ 64 483  12 427  11],618,5,34456,4.114149253731343,60.0,0.0
18375,1,8375,[181 496 403 125 210],588,2,34458,4.113896848137536,0.0,20.0
18376,1,8376,[ 64 483  12 427  11],618,5,34463,4.11400262623851,60.0,0.0
18377,1,8377,[ 64 483  12 427  11],618,5,34468,4.114108379088088,60.0,0.0
18378,1,8378,[ 64 483  12 427  11],618,5,34473,4.11421410669531,60.0,0.0
18379,1,8379,[ 98 180 143 175 318],405,3,34476,4.114081145584725,20.0,20.0
18380,1,8380,[ 64 483  12 427  11],214,5,34481,4.114186851211072,60.0,0.0
18381,1,8381,[181 132 202 678 172],588,3,34484,4.114053925077547,0.0,20.0
18382,1,8382,[289 655 483 151 215],588,3,34487,4.113921030657282,20.0,0.0
18383,1,8383,[182  50  79 238 273],618,4,34491,4.113907442748092,0.0,20.0
18384,1,8384,[182  70 174 195 173],437,2,34493,4.113655336911151,0.0,0.0
18385,1,8385,[ 64 483  12 427  11],214,5,34498,4.113761030288576,60.0,0.0
18386,1,8386,[ 64 483  12 427  11],618,5,34503,4.113866698461905,60.0,0.0
18387,1,8387,[ 64 483  12 427  11],214,5,34508,4.113972341440153,60.0,0.0
18388,1,8388,[181  50 174 403 322],417,1,34509,4.1136011443557035,0.0,40.0
18389,1,8389,[ 64 483  12 427  11],618,5,34514,4.113706793802145,60.0,0.0
18390,1,8390,[ 64 483  12 427  11],214,5,34519,4.113812418066977,60.0,0.0
18391,1,8391,[ 64 483  12 427  11],214,5,34524,4.113918017159199,60.0,0.0
18392,1,8392,[111 100   4 197 118],805,2,34526,4.113666150363398,0.0,0.0
18393,1,8393,[ 64 483  12 427  11],618,5,34531,4.113771741720276,60.0,0.0
18394,1,8394,[ 28 603 172 200 475],805,4,34535,4.113758189398451,0.0,0.0
18395,1,8395,[318 182 323 174 161],416,4,34539,4.113744640304907,20.0,0.0
18396,1,8396,[655 151 117  98 132],417,5,34544,4.113850184589735,0.0,20.0
18397,1,8397,[ 64 483  12 427  11],214,5,34549,4.113955703738985,60.0,0.0
18398,1,8398,[475   4  11 588 276],416,3,34552,4.113823074175497,0.0,0.0
18399,1,8399,[215  11 269 181  15],654,3,34555,4.1136904761904765,0.0,20.0
18400,1,8400,[168 191 153 117 275],297,4,34559,4.113676943221045,0.0,0.0
18401,1,8401,[ 64 483  12 427  11],618,5,34564,4.113782432754106,60.0,0.0
18402,1,8402,[ 64 483  12 427  11],618,5,34569,4.113887897179579,60.0,0.0
18403,1,8403,[181 276  98 655 200],416,4,34573,4.113874345549738,0.0,40.0
18404,1,8404,[237 423 181  95 313],642,4,34577,4.113860797144556,20.0,40.0
18405,1,8405,[423 191 181   9 168],62,4,34581,4.113847251962883,0.0,20.0
18406,1,8406,[ 64 483  12 427  11],214,5,34586,4.11395265849887,60.0,0.0
18407,1,8407,[172 144 176 588  97],230,4,34590,4.113939105613701,0.0,0.0
18408,1,8408,[ 64 483  12 427  11],214,5,34595,4.114044476156499,60.0,0.0
18409,1,8409,[ 64 483  12 427  11],618,5,34600,4.114149821640904,60.0,0.0
18410,1,8410,[ 64 483  12 427  11],214,5,34605,4.114255142075853,60.0,0.0
18411,1,8411,[ 50  12 265 216 515],417,2,34607,4.114003804089396,20.0,20.0
18412,1,8412,[ 64 483  12 427  11],618,5,34612,4.1141091168429815,60.0,0.0
18413,1,8413,[ 64 483  12 427  11],214,5,34617,4.114214404563822,60.0,0.0
18414,1,8414,[ 64 483  12 427  11],214,5,34622,4.114319667260844,60.0,0.0
18415,1,8415,[ 64 483  12 427  11],618,5,34627,4.1144249049429655,60.0,0.0
18416,1,8416,[ 64 483  12 427  11],618,5,34632,4.114530117619104,60.0,0.0
18417,1,8417,[ 64 483  12 427  11],618,5,34637,4.114635305298171,60.0,0.0
18418,1,8418,[ 64 483  12 427  11],618,5,34642,4.114740467989073,60.0,0.0
18419,1,8419,[ 64 483  12 427  11],618,5,34647,4.114845605700713,60.0,0.0
18420,1,8420,[ 71 118  56 546 200],805,2,34649,4.114594466215414,0.0,0.0
18421,1,8421,[ 64 483  12 427  11],214,5,34654,4.1146995962954165,60.0,0.0
18422,1,8422,[257 546 294   1 286],416,3,34657,4.114567256321975,0.0,0.0
18423,1,8423,[ 28   4  70  22 423],297,3,34660,4.114434947768281,0.0,0.0
18424,1,8424,[475   8   4  95 288],297,2,34662,4.114183976261128,0.0,20.0
18425,1,8425,[ 64 483  12 427  11],618,5,34667,4.114289105150724,60.0,0.0
18426,1,8426,[ 22 588  88 435 151],373,4,34671,4.114275542897828,0.0,0.0
18427,1,8427,[ 64 483  12 427  11],214,5,34676,4.11438063597532,60.0,0.0
18428,1,8428,[ 64 483  12 427  11],214,5,34681,4.11448570411674,60.0,0.0
18429,1,8429,[238  22 196 357  70],405,3,34684,4.11435349940688,0.0,0.0
18430,1,8430,[ 64 483  12 427  11],214,5,34689,4.114458545842723,60.0,0.0
18431,1,8431,[235 655 742 173  56],345,4,34693,4.114444971537002,0.0,0.0
18432,1,8432,[ 64 483  12 427  11],618,5,34698,4.114549982212735,60.0,0.0
18433,1,8433,[ 64 483  12 427  11],618,5,34703,4.114654967986721,60.0,0.0
18434,1,8434,[210   9 222 318 182],62,5,34708,4.114759928867812,20.0,0.0
18435,1,8435,[286  25  97 210 496],417,2,34710,4.114509246088193,0.0,0.0
18436,1,8436,[ 64 483  12 427  11],214,5,34715,4.114614199359962,60.0,0.0
18437,1,8437,[ 64 483  12 427  11],214,5,34720,4.114719127755392,60.0,0.0
18438,1,8438,[ 64 483  12 427  11],618,5,34725,4.1148240312833275,60.0,0.0
18439,1,8439,[ 64 483  12 427  11],618,5,34730,4.1149289099526065,60.0,0.0
18440,1,8440,[ 64 483  12 427  11],618,5,34735,4.115033763772065,60.0,0.0
18441,1,8441,[268 182 132 238 135],417,4,34739,4.115020137408197,0.0,0.0
18442,1,8442,[ 64 483  12 427  11],618,5,34744,4.115124955584508,60.0,0.0
18443,1,8443,[ 64 483  12 427  11],214,5,34749,4.115229748934154,60.0,0.0
18444,1,8444,[ 64 483  12 427  11],214,5,34754,4.115334517465956,60.0,0.0
18445,1,8445,[ 64 483  12 427  11],618,5,34759,4.115439261188729,60.0,0.0
18446,1,8446,[ 50 235 237  70 385],43,4,34763,4.1154255948857585,0.0,20.0
18447,1,8447,[ 64 483  12 427  11],214,5,34768,4.115530303030303,60.0,0.0
18448,1,8448,[ 98 161 196 181  97],417,3,34771,4.1153982719848505,0.0,40.0
18449,1,8449,[ 64 483  12 427  11],214,5,34776,4.1155029585798815,60.0,0.0
18450,1,8450,[210 185 288  98 132],416,5,34781,4.1156076203999525,0.0,40.0
18451,1,8451,[179 135   7 483 200],417,3,34784,4.1154756270705155,20.0,0.0
18452,1,8452,[ 64 483  12 427  11],618,5,34789,4.1155802673607,60.0,0.0
18453,1,8453,[153  12 237 143 257],416,3,34792,4.115448308493021,20.0,0.0
18454,1,8454,[ 11   4 318 216  28],345,4,34796,4.1154346540508575,20.0,0.0
18455,1,8455,[ 64 483  12 427  11],214,5,34801,4.115539262062441,60.0,0.0
18456,1,8456,[  8 245 333  28  64],721,3,34804,4.115407354853967,20.0,0.0
18457,1,8457,[742 143 275 202 118],416,4,34808,4.115393710096949,0.0,0.0
18458,1,8458,[  1 191 174 269  22],416,5,34813,4.115498285849391,0.0,0.0
18459,1,8459,[ 64 483  12 427  11],214,5,34818,4.115602836879432,60.0,0.0
18460,1,8460,[ 64 483  12 427  11],214,5,34823,4.11570736319584,60.0,0.0
18461,1,8461,[174  71  96   9 125],630,1,34824,4.115339163318365,0.0,0.0
18462,1,8462,[300 216 211  15 286],43,5,34829,4.115443696088858,0.0,0.0
18463,1,8463,[405 286 125 179 197],416,4,34833,4.115430056710775,0.0,0.0
18464,1,8464,[271 196 678 515 195],297,2,34835,4.115180153573538,0.0,0.0
18465,1,8465,[ 64 483  12 427  11],214,5,34840,4.115284668084101,60.0,0.0
18466,1,8466,[ 64 483  12 427  11],618,5,34845,4.115389157907169,60.0,0.0
18467,1,8467,[185 289 234 215   4],416,4,34849,4.115375531412376,0.0,0.0
18468,1,8468,[ 64 483  12 427  11],214,5,34854,4.115479985830676,60.0,0.0
18469,1,8469,[ 22  50 234 210 427],230,5,34859,4.115584415584416,0.0,20.0
18470,1,8470,[ 64 483  12 427  11],214,5,34864,4.115688820682328,60.0,0.0
18471,1,8471,[197 204 546  95 405],416,3,34867,4.115557129367327,0.0,0.0
18472,1,8472,[161 258 322 168 385],416,4,34871,4.115543491089342,0.0,0.0
18473,1,8473,[ 64 483  12 427  11],618,5,34876,4.115647864054756,60.0,0.0
18474,1,8474,[ 64 483  12 427  11],214,5,34881,4.11575221238938,60.0,0.0
18475,1,8475,[ 64 483  12 427  11],214,5,34886,4.115856536101935,60.0,0.0
18476,1,8476,[ 64 483  12 427  11],214,5,34891,4.1159608352011325,60.0,0.0
18477,1,8477,[ 71 127 568 427  64],373,4,34895,4.115947157348431,20.0,0.0
18478,1,8478,[ 64 483  12 427  11],618,5,34900,4.116051421158155,60.0,0.0
18479,1,8479,[194  96 258 269 100],416,5,34905,4.116155660377358,0.0,0.0
18480,1,8480,[181 597  88 271  82],43,3,34908,4.116024053767244,0.0,20.0
18481,1,8481,[ 64 483  12 427  11],618,5,34913,4.116128271634048,60.0,0.0
18482,1,8482,[ 64 483  12 427  11],618,5,34918,4.11623246492986,60.0,0.0
18483,1,8483,[403  56 235 200 258],416,4,34922,4.116218764733616,0.0,0.0
18484,1,8484,[237 603  97 405 121],416,4,34926,4.116205067766647,0.0,0.0
18485,1,8485,[ 64 483  12 427  11],214,5,34931,4.116309215177941,60.0,0.0
18486,1,8486,[ 64 483  12 427  11],214,5,34936,4.116413338046424,60.0,0.0
18487,1,8487,[ 64 483  12 427  11],618,5,34941,4.116517436380773,60.0,0.0
18488,1,8488,[200 238   7   8   4],297,3,34944,4.116385911179173,0.0,0.0
18489,1,8489,[ 88 471 275 496  50],274,5,34949,4.116489988221437,0.0,20.0
18490,1,8490,[ 64 483  12 427  11],618,5,34954,4.116594040749028,60.0,0.0
18491,1,8491,[ 64 483  12 427  11],618,5,34959,4.116698068770607,60.0,0.0
18492,1,8492,[191 195 302 475  11],297,3,34962,4.11656658424585,0.0,0.0
18493,1,8493,[135 265 161 174 496],437,3,34965,4.116435130680481,0.0,0.0
18494,1,8494,[  1 238 161 257 132],416,4,34969,4.1164214243672745,0.0,0.0
18495,1,8495,[ 71  82 222  95  70],43,5,34974,4.116525423728813,0.0,0.0
18496,1,8496,[222 173 172 655 215],62,3,34977,4.116394021419325,0.0,0.0
18497,1,8497,[423  70 186 161  56],417,4,34981,4.116380324782302,0.0,0.0
18498,1,8498,[265  98  15 597 186],588,4,34985,4.116366631368396,0.0,20.0
18499,1,8499,[ 64 483  12 427  11],214,5,34990,4.116470588235294,60.0,0.0
18500,1,8500,[ 64 483  12 427  11],618,5,34995,4.1165745206446305,60.0,0.0
18501,1,8501,[174  28 258 678 210],416,4,34999,4.11656080922136,0.0,0.0
18502,1,8502,[ 64 483  12 427  11],214,5,35004,4.11666470657415,60.0,0.0
18503,1,8503,[ 64 483  12 427  11],214,5,35009,4.116768579492004,60.0,0.0
18504,1,8504,[151  11 210 257 300],297,2,35011,4.116519694297472,0.0,0.0
18505,1,8505,[300 168 195  96 496],698,3,35014,4.116388431695274,0.0,0.0
18506,1,8506,[328 237 143  79 118],128,4,35018,4.116374750205713,0.0,0.0
18507,1,8507,[ 28 568 588 237 405],642,4,35022,4.116361071932299,0.0,0.0
18508,1,8508,[ 64 483  12 427  11],214,5,35027,4.1164649194970035,60.0,0.0
18509,1,8509,[ 25 238  69 258 216],43,4,35031,4.116451233842538,0.0,0.0
18510,1,8510,[ 64 483  12 427  11],618,5,35036,4.116555046410528,60.0,0.0
18511,1,8511,[173 191 168  22   8],62,5,35041,4.116658834586466,0.0,0.0
18512,1,8512,[175  98 187 211 186],405,3,35044,4.1165276635733585,0.0,20.0
18513,1,8513,[ 15 475 185 216 237],416,3,35047,4.116396523373267,0.0,0.0
18514,1,8514,[ 15 313  71 742 151],345,4,35051,4.116382853787434,20.0,20.0
18515,1,8515,[ 64 483  12 427  11],214,5,35056,4.116486613433537,60.0,0.0
18516,1,8516,[568 204 385 265 238],416,5,35061,4.116590348714336,0.0,0.0
18517,1,8517,[ 64 483  12 427  11],618,5,35066,4.116694059638413,60.0,0.0
18518,1,8518,[  7 210  71 176 172],230,4,35070,4.116680361544782,0.0,0.0
18519,1,8519,[ 64 483  12 427  11],214,5,35075,4.116784037558685,60.0,0.0
18520,1,8520,[ 64 483  12 427  11],618,5,35080,4.116887689238352,60.0,0.0
18521,1,8521,[ 64 483  12 427  11],618,5,35085,4.116991316592349,60.0,0.0
18522,1,8522,[222 403  50  97  15],62,3,35088,4.116860260471665,0.0,20.0
18523,1,8523,[ 64 483  12 427  11],214,5,35093,4.116963866729235,60.0,0.0
18524,1,8524,[678 282  89 245 288],297,1,35094,4.116598240469208,0.0,20.0
18525,1,8525,[215 275   8 111 180],62,3,35097,4.116467276565799,0.0,0.0
18526,1,8526,[ 64 483  12 427  11],214,5,35102,4.116570892459247,60.0,0.0
18527,1,8527,[183 179 182 245 385],416,3,35105,4.116439962476548,0.0,0.0
18528,1,8528,[ 64 483  12 427  11],618,5,35110,4.116543557275179,60.0,0.0
18529,1,8529,[202 289  56 111 276],764,4,35114,4.116529894490035,0.0,0.0
18530,1,8530,[191 257 132  95 144],416,3,35117,4.1163990153557615,0.0,0.0
18531,1,8531,[655 405  69 216 202],314,4,35121,4.116385372714487,0.0,0.0
18532,1,8532,[742 288 423 385  98],588,2,35123,4.1161373491152,0.0,40.0
18533,1,8533,[ 64 483  12 427  11],618,5,35128,4.116240918678228,60.0,0.0
18534,1,8534,[ 50  69 322 144 153],854,3,35131,4.1161101347393085,0.0,20.0
18535,1,8535,[257  25 174 318 275],654,4,35135,4.116096532333645,20.0,0.0
18536,1,8536,[ 64 483  12 427  11],618,5,35140,4.116200070282301,60.0,0.0
18537,1,8537,[273   7 597 210 403],805,2,35142,4.115952213633169,0.0,0.0
18538,1,8538,[ 64 483  12 427  11],618,5,35147,4.116055744232345,60.0,0.0
18539,1,8539,[ 64 483  12 427  11],618,5,35152,4.11615925058548,60.0,0.0
18540,1,8540,[196 508   1 195  22],297,3,35155,4.116028568083363,0.0,0.0
18541,1,8541,[161 258 191 121  12],416,5,35160,4.116132053383283,20.0,0.0
18542,1,8542,[ 64 483  12 427  11],214,5,35165,4.11623551445628,60.0,0.0
18543,1,8543,[ 64 483  12 427  11],214,5,35170,4.116338951310861,60.0,0.0
18544,1,8544,[655 403 176 161 153],416,5,35175,4.11644236395553,0.0,0.0
18545,1,8545,[ 64 483  12 427  11],618,5,35180,4.116545752398783,60.0,0.0
18546,1,8546,[313 121 117 135   4],618,4,35184,4.116532116532117,20.0,20.0
18547,1,8547,[196 176   7  89 286],297,5,35189,4.116635470285447,0.0,0.0
18548,1,8548,[ 64 483  12 427  11],618,5,35194,4.1167387998596325,60.0,0.0
18549,1,8549,[385 174 294 275  50],698,4,35198,4.116725146198831,0.0,20.0
18550,1,8550,[185  70  69  95 357],405,3,35201,4.116594550344989,0.0,0.0
18551,1,8551,[ 64 483  12 427  11],214,5,35206,4.116697848456502,60.0,0.0
18552,1,8552,[ 64 483  12 427  11],214,5,35211,4.116801122413189,60.0,0.0
18553,1,8553,[268   1 275 245 228],128,2,35213,4.116553659106851,0.0,0.0
18554,1,8554,[ 64 483  12 427  11],618,5,35218,4.116656925774401,60.0,0.0
18555,1,8555,[215 200 357 127  71],405,3,35221,4.116526414212249,0.0,0.0
18556,1,8556,[161 181  15 216 475],198,3,35224,4.116395933154143,0.0,20.0
18557,1,8557,[  1 216 204 271 168],62,2,35226,4.1161486328581445,0.0,0.0
18558,1,8558,[ 64 483  12 427  11],618,5,35231,4.116251898586284,60.0,0.0
18559,1,8559,[ 64 483  12 427  11],618,5,35236,4.116355140186916,60.0,0.0
18560,1,8560,[216 357 174 257 173],297,4,35240,4.116341548884476,0.0,0.0
18561,1,8561,[300  56 180 211 423],875,4,35244,4.116327960756832,0.0,0.0
18562,1,8562,[ 64 483  12 427  11],618,5,35249,4.116431157304683,60.0,0.0
18563,1,8563,[289 748 333 385 357],416,4,35253,4.116417561886968,0.0,0.0
18564,1,8564,[ 64 483  12 427  11],214,5,35258,4.11652072387624,60.0,0.0
18565,1,8565,[183 302  15 275 238],62,3,35261,4.116390380574364,0.0,0.0
18566,1,8566,[ 11 100 282 385 568],416,5,35266,4.1164935216528535,0.0,0.0
18567,1,8567,[  7 222 143  56  28],588,3,35269,4.116363211951447,0.0,0.0
18568,1,8568,[ 79 196 258 168  97],43,5,35274,4.116466332127436,0.0,0.0
18569,1,8569,[273 200 175 655 496],253,3,35277,4.1163360560093345,0.0,0.0
18570,1,8570,[ 64 483  12 427  11],618,5,35282,4.116439155291098,60.0,0.0
18571,1,8571,[ 64 483  12 427  11],618,5,35287,4.1165422305179655,60.0,0.0
18572,1,8572,[ 50   1  71 117 100],416,5,35292,4.116645281698355,0.0,20.0
18573,1,8573,[ 64 483  12 427  11],618,5,35297,4.116748308840681,60.0,0.0
18574,1,8574,[ 64 483  12 427  11],214,5,35302,4.1168513119533525,60.0,0.0
18575,1,8575,[508 143 475 153 257],342,3,35305,4.116721082089552,0.0,0.0
18576,1,8576,[ 64 483  12 427  11],618,5,35310,4.116824064358167,60.0,0.0
18577,1,8577,[235 289 179 216 132],416,2,35312,4.116577290743763,0.0,0.0
18578,1,8578,[ 15  70 200 132 237],198,2,35314,4.1163305746590515,0.0,0.0
18579,1,8579,[655   1 318 471 132],887,3,35317,4.116200466200466,20.0,0.0
18580,1,8580,[191  15 196  82 289],43,5,35322,4.1163034611350655,0.0,0.0
18581,1,8581,[ 64 483  12 427  11],618,5,35327,4.116406432067118,60.0,0.0
18582,1,8582,[ 64 483  12 427  11],618,5,35332,4.11650937900501,60.0,0.0
18583,1,8583,[ 64 483  12 427  11],214,5,35337,4.1166123019571295,60.0,0.0
18584,1,8584,[  4 180  96  79 215],405,3,35340,4.11648223645894,0.0,0.0
18585,1,8585,[118 597 191 234 151],417,4,35344,4.116468669927789,0.0,0.0
18586,1,8586,[ 56 405 118  50 182],62,3,35347,4.116338651449866,0.0,20.0
18587,1,8587,[121 144  69 423  15],654,4,35351,4.116325104797392,0.0,0.0
18588,1,8588,[  7  64 191 185 195],417,3,35354,4.116195133310048,20.0,0.0
18589,1,8589,[ 64 483  12 427  11],618,5,35359,4.1162980209545985,60.0,0.0
18590,1,8590,[211 286  11 289 237],43,5,35364,4.1164008846467235,0.0,0.0
18591,1,8591,[ 64 483  12 427  11],214,5,35369,4.116503724394786,60.0,0.0
18592,1,8592,[ 71 318 172 276 121],198,2,35371,4.11625741882928,20.0,0.0
18593,1,8593,[ 64 483  12 427  11],618,5,35376,4.1163602513381425,60.0,0.0
18594,1,8594,[ 70  12 742 597 118],630,4,35380,4.116346713205352,20.0,0.0
18595,1,8595,[ 70 121 288 125 282],416,5,35385,4.116449511400652,0.0,20.0
18596,1,8596,[258 288  89 235 196],62,4,35389,4.116435966034663,0.0,20.0
18597,1,8597,[ 64 483  12 427  11],618,5,35394,4.1165387299371945,60.0,0.0
18598,1,8598,[ 64 483  12 427  11],618,5,35399,4.116641469938365,60.0,0.0
18599,1,8599,[ 64 483  12 427  11],214,5,35404,4.116744186046511,60.0,0.0
18600,1,8600,[ 64 483  12 427  11],618,5,35409,4.1168468782699685,60.0,0.0
18601,1,8601,[302  70   1 121 289],49,2,35411,4.116600790513834,0.0,0.0
18602,1,8602,[318  28 210   7 238],43,4,35415,4.116587237010346,20.0,0.0
18603,1,8603,[655 204  50 257 172],416,4,35419,4.116573686657369,0.0,20.0
18604,1,8604,[ 64 483  12 427  11],618,5,35424,4.116676350958745,60.0,0.0
18605,1,8605,[ 64 483  12 427  11],214,5,35429,4.116778991401348,60.0,0.0
18606,1,8606,[ 64 483  12 427  11],618,5,35434,4.116881607993494,60.0,0.0
18607,1,8607,[222 265 435 234 211],297,2,35436,4.116635687732342,0.0,0.0
18608,1,8608,[200 234  79 475   4],416,4,35440,4.1166221396213265,0.0,0.0
18609,1,8609,[183 176 427 496 245],416,4,35444,4.116608594657375,0.0,0.0
18610,1,8610,[318 161 423 121 200],416,5,35449,4.116711183370108,20.0,0.0
18611,1,8611,[ 64 483  12 427  11],214,5,35454,4.116813748258244,60.0,0.0
18612,1,8612,[ 64 483  12 427  11],214,5,35459,4.116916289330082,60.0,0.0
18613,1,8613,[ 64 483  12 427  11],618,5,35464,4.117018806593917,60.0,0.0
18614,1,8614,[ 64 483  12 427  11],214,5,35469,4.117121300058038,60.0,0.0
18615,1,8615,[ 64 483  12 427  11],618,5,35474,4.1172237697307335,60.0,0.0
18616,1,8616,[ 64 483  12 427  11],618,5,35479,4.1173262156202854,60.0,0.0
18617,1,8617,[ 64 483  12 427  11],618,5,35484,4.117428637734974,60.0,0.0
18618,1,8618,[ 64 483  12 427  11],618,5,35489,4.117531036083072,60.0,0.0
18619,1,8619,[ 69 678 228 117 300],297,1,35490,4.117169373549884,0.0,0.0
18620,1,8620,[ 28 403 423  79 245],416,4,35494,4.117155782391834,0.0,0.0
18621,1,8621,[172  97 191  64 275],62,4,35498,4.117142194386453,20.0,0.0
18622,1,8622,[  1 568 322 742 173],417,2,35500,4.116896671691986,0.0,0.0
18623,1,8623,[ 64 483  12 427  11],618,5,35505,4.116999072356215,60.0,0.0
18624,1,8624,[ 64 483  12 427  11],214,5,35510,4.117101449275363,60.0,0.0
18625,1,8625,[288 357  82  12 222],805,3,35513,4.116971945281707,20.0,20.0
18626,1,8626,[ 64 483  12 427  11],214,5,35518,4.117074301611221,60.0,0.0
18627,1,8627,[245 275 235  82 215],62,3,35521,4.1169448307834955,0.0,0.0
18628,1,8628,[ 64 483  12 427  11],618,5,35526,4.117047166531464,60.0,0.0
18629,1,8629,[ 64 483  12 427  11],618,5,35531,4.117149478563152,60.0,0.0
18630,1,8630,[117 238 173 153 508],854,4,35535,4.117135905457073,0.0,0.0
18631,1,8631,[ 28 286 144 195  96],416,5,35540,4.117238183503244,0.0,0.0
18632,1,8632,[235 179 168 258 127],417,4,35544,4.117224603266536,0.0,0.0
18633,1,8633,[151 117   1 276 161],618,3,35547,4.117095205003475,0.0,0.0
18634,1,8634,[  7  28 275 568 200],262,2,35549,4.11685002895194,0.0,0.0
18635,1,8635,[ 64 483  12 427  11],214,5,35554,4.116952292728115,60.0,0.0
18636,1,8636,[ 64 483  12 427  11],618,5,35559,4.117054532823897,60.0,0.0
18637,1,8637,[ 64 483  12 427  11],618,5,35564,4.117156749247511,60.0,0.0
18638,1,8638,[ 70   7 508 313 423],49,1,35565,4.116795925454335,20.0,20.0
18639,1,8639,[423 181 182 271 118],62,2,35567,4.116550925925926,0.0,20.0
18640,1,8640,[132 125  15   9  71],601,2,35569,4.116305983103808,0.0,0.0
18641,1,8641,[322 175 288 179  69],721,4,35573,4.1162925248785,0.0,20.0
18642,1,8642,[211 175 286 144  56],297,4,35577,4.116279069767442,0.0,0.0
18643,1,8643,[222 603 180 161 111],805,2,35579,4.116034243405831,0.0,0.0
18644,1,8644,[174 181 269 237  71],654,3,35582,4.115905147484095,0.0,20.0
18645,1,8645,[ 64 483  12 427  11],214,5,35587,4.116007402266944,60.0,0.0
18646,1,8646,[187 179 191 211 132],373,2,35589,4.115762692263213,0.0,0.0
18647,1,8647,[ 71 195 427 127  95],373,4,35593,4.115749306197965,0.0,0.0
18648,1,8648,[ 64 483  12 427  11],214,5,35598,4.115851543531044,60.0,0.0
18649,1,8649,[300 328  98  28 273],416,5,35603,4.115953757225434,0.0,20.0
18650,1,8650,[ 64 483  12 427  11],618,5,35608,4.116055947289331,60.0,0.0
18651,1,8651,[ 64 483  12 427  11],618,5,35613,4.116158113730929,60.0,0.0
18652,1,8652,[121  71  96 265 655],198,2,35615,4.115913555992141,0.0,0.0
18653,1,8653,[678   8 200 273 238],805,3,35618,4.115784608273631,0.0,0.0
18654,1,8654,[288  95 200 196  79],618,3,35621,4.115655690352398,0.0,20.0
18655,1,8655,[ 64 483  12 427  11],618,5,35626,4.115757855822551,60.0,0.0
18656,1,8656,[300 265 132 228 111],128,2,35628,4.115513457317777,0.0,0.0
18657,1,8657,[ 64 483  12 427  11],214,5,35633,4.115615615615615,60.0,0.0
18658,1,8658,[172 568 435 151 179],373,4,35637,4.115602263540825,0.0,0.0
18659,1,8659,[200 100 215 301 245],416,4,35641,4.115588914549654,0.0,0.0
18660,1,8660,[546 181  70 238  28],654,4,35645,4.1155755686410345,0.0,20.0
18661,1,8661,[ 64 483  12 427  11],214,5,35650,4.115677672592935,60.0,0.0
18662,1,8662,[ 64 483  12 427  11],618,5,35655,4.115779752972411,60.0,0.0
18663,1,8663,[ 64 483  12 427  11],214,5,35660,4.115881809787627,60.0,0.0
18664,1,8664,[ 64 483  12 427  11],214,5,35665,4.11598384304674,60.0,0.0
18665,1,8665,[ 64 483  12 427  11],214,5,35670,4.116085852757904,60.0,0.0
18666,1,8666,[322   7 197 196 568],805,2,35672,4.115841698396215,0.0,0.0
18667,1,8667,[ 79 228 153 210 195],805,2,35674,4.115597600369174,0.0,0.0
18668,1,8668,[ 64 483  12 427  11],618,5,35679,4.115699619333256,60.0,0.0
18669,1,8669,[ 64 483  12 427  11],214,5,35684,4.115801614763552,60.0,0.0
18670,1,8670,[174 423 568  25 179],373,3,35687,4.115672932764387,0.0,0.0
18671,1,8671,[ 64 483  12 427  11],618,5,35692,4.115774907749078,60.0,0.0
18672,1,8672,[ 64 483  12 427  11],214,5,35697,4.115876859218264,60.0,0.0
18673,1,8673,[ 64 483  12 427  11],214,5,35702,4.115978787180079,60.0,0.0
18674,1,8674,[ 64 483  12 427  11],618,5,35707,4.116080691642651,60.0,0.0
18675,1,8675,[ 64 483  12 427  11],618,5,35712,4.1161825726141075,60.0,0.0
18676,1,8676,[245 195 258 294 423],642,2,35714,4.115938688486804,0.0,0.0
18677,1,8677,[118 185  25   4 301],416,4,35718,4.115925328416686,0.0,0.0
18678,1,8678,[ 64 483  12 427  11],214,5,35723,4.11602719207282,60.0,0.0
18679,1,8679,[ 64 483  12 427  11],214,5,35728,4.116129032258065,60.0,0.0
18680,1,8680,[234 313 282 143 117],588,5,35733,4.116230848980532,20.0,20.0
18681,1,8681,[ 64 483  12 427  11],214,5,35738,4.11633264224833,60.0,0.0
18682,1,8682,[313 132 405  71 294],642,3,35741,4.116204076931936,20.0,20.0
18683,1,8683,[ 64 483  12 427  11],618,5,35746,4.116305849838784,60.0,0.0
18684,1,8684,[ 64   4 273 211  70],417,3,35749,4.1161773172135865,20.0,0.0
18685,1,8685,[235   4 322  64 273],417,1,35750,4.115818558600046,20.0,0.0
18686,1,8686,[357 135 161 186 180],198,3,35753,4.115690111661102,0.0,0.0
18687,1,8687,[ 64 483  12 427  11],618,5,35758,4.115791896869245,60.0,0.0
18688,1,8688,[197 195 202 276 187],618,1,35759,4.115433306479456,0.0,0.0
18689,1,8689,[471  97 181 271 215],297,2,35761,4.115189873417721,0.0,20.0
18690,1,8690,[173 496 471  79 275],128,5,35766,4.115291681049362,0.0,0.0
18691,1,8691,[ 64 483  12 427  11],214,5,35771,4.115393465255408,60.0,0.0
18692,1,8692,[176  95 515 302  89],405,1,35772,4.115035085701138,0.0,0.0
18693,1,8693,[ 64 483  12 427  11],214,5,35777,4.115136876006441,60.0,0.0
18694,1,8694,[294 588 269 222 111],43,5,35782,4.115238642898217,0.0,0.0
18695,1,8695,[496 143 238 144 117],373,3,35785,4.115110395584177,0.0,0.0
18696,1,8696,[ 64 483  12 427  11],618,5,35790,4.115212142117972,60.0,0.0
18697,1,8697,[276 588 182 127 238],416,4,35794,4.115198896298,0.0,0.0
18698,1,8698,[ 64 483  12 427  11],214,5,35799,4.115300609265433,60.0,0.0
18699,1,8699,[ 64 483  12 427  11],618,5,35804,4.115402298850575,60.0,0.0
18700,1,8700,[678 300 655  28  70],721,2,35806,4.115159177106079,0.0,0.0
18701,1,8701,[ 64 483  12 427  11],618,5,35811,4.115260859572512,60.0,0.0
18702,1,8702,[210 215 174 186  11],437,1,35812,4.1149029070435486,0.0,0.0
18703,1,8703,[ 64 483  12 427  11],618,5,35817,4.1150045955882355,60.0,0.0
18704,1,8704,[ 64 483  12 427  11],618,5,35822,4.1151062607696725,60.0,0.0
18705,1,8705,[ 64 483  12 427  11],618,5,35827,4.115207902595911,60.0,0.0
18706,1,8706,[ 64 483  12 427  11],618,5,35832,4.115309521074997,60.0,0.0
18707,1,8707,[ 69 121 546 328 288],314,5,35837,4.1154111162149745,0.0,20.0
18708,1,8708,[742 483 168 475 151],854,4,35841,4.115397864278333,20.0,0.0
18709,1,8709,[427  25   9 173 265],618,2,35843,4.115154994259472,0.0,0.0
18710,1,8710,[328  25 127  71 161],373,4,35847,4.115141774767535,0.0,0.0
18711,1,8711,[603 294 117 191 176],416,5,35852,4.11524334251607,0.0,0.0
18712,1,8712,[204 265 568 195   1],416,5,35857,4.115344886950534,0.0,0.0
18713,1,8713,[ 64 483  12 427  11],618,5,35862,4.115446408078953,60.0,0.0
18714,1,8714,[245 143  70 151 286],764,5,35867,4.115547905909351,0.0,0.0
18715,1,8715,[ 64 483  12 427  11],214,5,35872,4.115649380449748,60.0,0.0
18716,1,8716,[204 568 423 118  12],416,4,35876,4.115636113341746,20.0,0.0
18717,1,8717,[ 11 204 568   9 471],416,5,35881,4.115737554484974,0.0,0.0
18718,1,8718,[ 25 423 286  96  22],854,1,35882,4.115380204151852,0.0,0.0
18719,1,8719,[257  12   1 222 181],417,2,35884,4.115137614678899,20.0,20.0
18720,1,8720,[ 64 483  12 427  11],214,5,35889,4.1152390780873755,60.0,0.0
18721,1,8721,[ 15 161  71  98 153],416,5,35894,4.115340518229764,0.0,20.0
18722,1,8722,[385  95  28   9 195],416,4,35898,4.115327295655164,0.0,0.0
18723,1,8723,[ 64 483  12 427  11],618,5,35903,4.115428702430078,60.0,0.0
18724,1,8724,[185 748 282 258 294],297,2,35905,4.115186246418338,0.0,0.0
18725,1,8725,[ 28  50 144   9 318],618,4,35909,4.115173046069218,20.0,20.0
18726,1,8726,[ 64 483  12 427  11],214,5,35914,4.1152744356594475,60.0,0.0
18727,1,8727,[ 97 111   1 288 174],297,2,35916,4.115032080659945,0.0,20.0
18728,1,8728,[288   7 151 357 202],417,3,35919,4.114904341849009,0.0,20.0
18729,1,8729,[143  88 427 195 748],416,4,35923,4.114891179839633,0.0,0.0
18730,1,8730,[100 405 191 210 678],345,4,35927,4.114878020845264,0.0,0.0
18731,1,8731,[ 64 483  12 427  11],214,5,35932,4.114979386165827,60.0,0.0
18732,1,8732,[204 313 655 185 475],711,4,35936,4.114966220084736,20.0,20.0
18733,1,8733,[496 180 655  97 234],417,4,35940,4.114953057018548,0.0,0.0
18734,1,8734,[ 98  56 288  82 144],437,2,35942,4.114710933028048,0.0,40.0
18735,1,8735,[ 64 483  12 427  11],214,5,35947,4.114812271062271,60.0,0.0
18736,1,8736,[ 64 483  12 427  11],214,5,35952,4.11491358589905,60.0,0.0
18737,1,8737,[172 655 276 175 127],922,1,35953,4.114557106889448,0.0,0.0
18738,1,8738,[546 471   8 211  97],416,4,35957,4.114543998169127,0.0,0.0
18739,1,8739,[ 64 483  12 427  11],618,5,35962,4.114645308924485,60.0,0.0
18740,1,8740,[ 64 483  12 427  11],618,5,35967,4.1147465964992564,60.0,0.0
18741,1,8741,[187 186  71 168 143],405,3,35970,4.11461908030199,0.0,0.0
18742,1,8742,[234 294 173  88 597],416,3,35973,4.11449159327462,0.0,0.0
18743,1,8743,[ 64 483  12 427  11],618,5,35978,4.1145928636779505,60.0,0.0
18744,1,8744,[ 64 483  12 427  11],618,5,35983,4.114694110920526,60.0,0.0
18745,1,8745,[202 238 282 273 234],618,2,35985,4.114452321061057,0.0,0.0
18746,1,8746,[173  28  88 168 204],751,5,35990,4.1145535612209905,0.0,0.0
18747,1,8747,[403 268 197 210   4],345,4,35994,4.114540466392318,0.0,0.0
18748,1,8748,[423 294 210  22 655],887,3,35997,4.114413075780089,0.0,0.0
18749,1,8749,[ 64 483  12 427  11],618,5,36002,4.114514285714286,60.0,0.0
18750,1,8750,[403 183  95 168 234],416,4,36006,4.114501199862873,0.0,0.0
18751,1,8751,[258 200 111  25 435],297,2,36008,4.114259597806216,0.0,0.0
18752,1,8752,[ 64 483  12 427  11],214,5,36013,4.114360790586085,60.0,0.0
18753,1,8753,[328 276 268 121 204],416,4,36017,4.1143477267534845,0.0,0.0
18754,1,8754,[286 423  97 125 234],588,2,36019,4.114106225014278,0.0,0.0
18755,1,8755,[ 64 483  12 427  11],618,5,36024,4.114207400639561,60.0,0.0
18756,1,8756,[ 64 483  12 427  11],618,5,36029,4.114308553157474,60.0,0.0
18757,1,8757,[234 173  28  22 195],642,3,36032,4.114181319936058,0.0,0.0
18758,1,8758,[405 257 100 216  95],751,4,36036,4.114168284050691,0.0,0.0
18759,1,8759,[197 269 597 183 117],805,3,36039,4.114041095890411,0.0,0.0
18760,1,8760,[175 173  64 135 222],721,4,36043,4.114028078986417,20.0,0.0
18761,1,8761,[100  56 228  28 151],805,3,36046,4.113900935859393,0.0,0.0
18762,1,8762,[ 64 483  12 427  11],214,5,36051,4.114002054091065,60.0,0.0
18763,1,8763,[294 181 204 174 202],805,0,36051,4.113532633500685,0.0,20.0
18764,1,8764,[ 64 483  12 427  11],214,5,36056,4.113633770678836,60.0,0.0
18765,1,8765,[ 64 483  12 427  11],214,5,36061,4.1137348847821125,60.0,0.0
18766,1,8766,[ 64 483  12 427  11],214,5,36066,4.11383597581841,60.0,0.0
18767,1,8767,[181 323 175 275 117],43,3,36069,4.113708941605839,0.0,20.0
18768,1,8768,[ 64 483  12 427  11],214,5,36074,4.11381001254419,60.0,0.0
18769,1,8769,[ 64 483  12 427  11],214,5,36079,4.113911060433296,60.0,0.0
18770,1,8770,[ 64 483  12 427  11],214,5,36084,4.11401208528104,60.0,0.0
18771,1,8771,[235 174  50 276 288],416,3,36087,4.113885088919289,0.0,40.0
18772,1,8772,[ 64 483  12 427  11],214,5,36092,4.113986093696569,60.0,0.0
18773,1,8773,[ 64 483  12 427  11],214,5,36097,4.114087075450194,60.0,0.0
18774,1,8774,[265 508 121 200  50],417,1,36098,4.113732193732194,0.0,20.0
18775,1,8775,[176 195 313  11 655],416,5,36103,4.1138331814038285,20.0,20.0
18776,1,8776,[ 64 483  12 427  11],214,5,36108,4.113934146063575,60.0,0.0
18777,1,8777,[ 64 483  12 427  11],214,5,36113,4.114035087719298,60.0,0.0
18778,1,8778,[273 182  25 186 568],417,2,36115,4.113794281808862,0.0,0.0
18779,1,8779,[125  71  50 151 172],642,4,36119,4.1137813211845105,0.0,20.0
18780,1,8780,[ 64 483  12 427  11],618,5,36124,4.113882245757886,60.0,0.0
18781,1,8781,[ 64 483  12 427  11],214,5,36129,4.113983147346846,60.0,0.0
18782,1,8782,[ 64 483  12 427  11],214,5,36134,4.114084025959239,60.0,0.0
18783,1,8783,[286 228 173 742 181],62,2,36136,4.11384335154827,0.0,20.0
18784,1,8784,[186  79 194 202  25],373,4,36140,4.1138303927148545,0.0,0.0
18785,1,8785,[ 64 483  12 427  11],618,5,36145,4.113931254268154,60.0,0.0
18786,1,8786,[117 185 132 191 111],854,3,36148,4.113804483896666,0.0,0.0
18787,1,8787,[322 328 313 597 286],223,3,36151,4.113677742375967,20.0,20.0
18788,1,8788,[ 64 483  12 427  11],214,5,36156,4.113778586869951,60.0,0.0
18789,1,8789,[ 64 483  12 427  11],618,5,36161,4.113879408418658,60.0,0.0
18790,1,8790,[ 25  82  98 294 427],128,4,36165,4.11386645432829,0.0,20.0
18791,1,8791,[ 11  98 100 202 301],751,4,36169,4.113853503184713,0.0,20.0
18792,1,8792,[174 427  89 179 135],198,5,36174,4.11395428181508,0.0,0.0
18793,1,8793,[ 64 483  12 427  11],214,5,36179,4.114055037525586,60.0,0.0
18794,1,8794,[ 64 483  12 427  11],214,5,36184,4.1141557703240474,60.0,0.0
18795,1,8795,[183 117 202 161  95],437,2,36186,4.1139154160982265,0.0,0.0
18796,1,8796,[ 64 483  12 427  11],214,5,36191,4.1140161418665455,60.0,0.0
18797,1,8797,[235 216 403 475 182],416,3,36194,4.113889520345533,0.0,0.0
18798,1,8798,[ 64 483  12 427  11],214,5,36199,4.113990226162064,60.0,0.0
18799,1,8799,[181  69  64 294  95],230,5,36204,4.114090909090909,20.0,20.0
18800,1,8800,[ 56   1 678 191 174],297,2,36206,4.113850698784229,0.0,0.0
18801,1,8801,[ 89 234 405 257 195],642,1,36207,4.113496932515337,0.0,0.0
18802,1,8802,[ 64 483  12 427  11],618,5,36212,4.113597637169147,60.0,0.0
18803,1,8803,[ 88 748 153 211 111],437,3,36215,4.11347114947751,0.0,0.0
18804,1,8804,[ 64 483  12 427  11],214,5,36220,4.113571834185122,60.0,0.0
18805,1,8805,[ 79 282  50 175 173],253,4,36224,4.1135589370883485,0.0,20.0
18806,1,8806,[603  95  69 195   8],405,3,36227,4.113432496877484,0.0,0.0
18807,1,8807,[ 64 483  12 427  11],214,5,36232,4.113533151680291,60.0,0.0
18808,1,8808,[ 64 483  12 427  11],618,5,36237,4.1136337836303785,60.0,0.0
18809,1,8809,[423  22  82  28 282],721,5,36242,4.113734392735528,0.0,0.0
18810,1,8810,[286  82  69 496 357],416,5,36247,4.113834979003518,0.0,0.0
18811,1,8811,[385 405 195 121  95],198,0,36247,4.113368134362234,0.0,0.0
18812,1,8812,[ 64 483  12 427  11],214,5,36252,4.113468739362306,60.0,0.0
18813,1,8813,[135  88 496 265 176],618,5,36257,4.113569321533923,0.0,0.0
18814,1,8814,[132  25  15 302 258],416,5,36262,4.1136698808848555,0.0,0.0
18815,1,8815,[144 655  70 588  98],711,4,36266,4.113656987295826,0.0,20.0
18816,1,8816,[195 357 180  98 257],62,4,36270,4.113644096631507,0.0,20.0
18817,1,8817,[ 64 483  12 427  11],214,5,36275,4.113744613290995,60.0,0.0
18818,1,8818,[ 64 483  12 427  11],214,5,36280,4.113845107155006,60.0,0.0
18819,1,8819,[423 168 405 204 215],43,5,36285,4.113945578231292,0.0,0.0
18820,1,8820,[ 79  50 200 135  97],297,3,36288,4.113819294864528,0.0,20.0
18821,1,8821,[ 64 483  12 427  11],214,5,36293,4.113919746089322,60.0,0.0
18822,1,8822,[ 64 483  12 427  11],618,5,36298,4.114020174543806,60.0,0.0
18823,1,8823,[ 25 127 118 172 258],417,3,36301,4.113893925657298,0.0,0.0
18824,1,8824,[ 64 483  12 427  11],618,5,36306,4.113994334277621,60.0,0.0
18825,1,8825,[ 64 483  12 427  11],214,5,36311,4.114094720145026,60.0,0.0
18826,1,8826,[237 144 100 245 748],907,5,36316,4.114195083267248,0.0,0.0
18827,1,8827,[ 64 483  12 427  11],214,5,36321,4.114295423652016,60.0,0.0
18828,1,8828,[ 15 222 210 742 144],417,1,36322,4.113942688866237,0.0,0.0
18829,1,8829,[257 151 121   8  98],43,5,36327,4.114043035107588,0.0,20.0
18830,1,8830,[ 64 483  12 427  11],618,5,36332,4.114143358623033,60.0,0.0
18831,1,8831,[ 64 483  12 427  11],618,5,36337,4.11424365942029,60.0,0.0
18832,1,8832,[ 64 483  12 427  11],618,5,36342,4.114343937507075,60.0,0.0
18833,1,8833,[ 64 483  12 427  11],618,5,36347,4.114444192891103,60.0,0.0
18834,1,8834,[ 64 483  12 427  11],214,5,36352,4.114544425580079,60.0,0.0
18835,1,8835,[ 64 483  12 427  11],618,5,36357,4.114644635581711,60.0,0.0
18836,1,8836,[ 64 483  12 427  11],214,5,36362,4.114744822903701,60.0,0.0
18837,1,8837,[216 143  98 210  96],230,4,36366,4.114731839782756,0.0,20.0
18838,1,8838,[ 64 483  12 427  11],214,5,36371,4.1148319945695215,60.0,0.0
18839,1,8839,[135 210 286 508 257],354,1,36372,4.114479638009049,0.0,0.0
18840,1,8840,[ 79   1 180 195 202],805,2,36374,4.114240470535007,0.0,0.0
18841,1,8841,[ 64 483  12 427  11],214,5,36379,4.1143406469124635,60.0,0.0
18842,1,8842,[257 301  12  95 210],416,3,36382,4.114214633043085,20.0,0.0
18843,1,8843,[ 64 483  12 427  11],214,5,36387,4.114314789687924,60.0,0.0
18844,1,8844,[385 286 118 210 742],345,2,36389,4.11407574901074,0.0,0.0
18845,1,8845,[ 64 483  12 427  11],214,5,36394,4.114175898711282,60.0,0.0
18846,1,8846,[100 294 144 568  69],62,2,36396,4.1139369277721265,0.0,0.0
18847,1,8847,[ 64 483  12 427  11],618,5,36401,4.114037070524413,60.0,0.0
18848,1,8848,[ 64 483  12 427  11],214,5,36406,4.11413719064301,60.0,0.0
18849,1,8849,[ 64 483  12 427  11],618,5,36411,4.114237288135593,60.0,0.0
18850,1,8850,[ 64 483  12 427  11],214,5,36416,4.114337363009829,60.0,0.0
18851,1,8851,[496 276  71  98  96],630,2,36418,4.114098508811568,0.0,20.0
18852,1,8852,[302  28 265  56 197],297,3,36421,4.113972664633458,0.0,0.0
18853,1,8853,[ 97 195 197 196  89],437,2,36423,4.113733905579399,0.0,0.0
18854,1,8854,[ 64 483  12 427  11],214,5,36428,4.113833992094862,60.0,0.0
18855,1,8855,[ 95 191 144 276   8],342,4,36432,4.1138211382113825,0.0,0.0
18856,1,8856,[ 64 483  12 427  11],214,5,36437,4.113921192277295,60.0,0.0
18857,1,8857,[ 64 483  12 427  11],618,5,36442,4.11402122375254,60.0,0.0
18858,1,8858,[ 64 483  12 427  11],214,5,36447,4.114121232644768,60.0,0.0
18859,1,8859,[ 64 483  12 427  11],618,5,36452,4.114221218961625,60.0,0.0
18860,1,8860,[183   1  25 678  56],297,3,36455,4.114095474551405,0.0,0.0
18861,1,8861,[202  28 268 742 185],416,5,36460,4.1141954412096595,0.0,0.0
18862,1,8862,[ 64 483  12 427  11],618,5,36465,4.114295385309714,60.0,0.0
18863,1,8863,[168  69  11 515 121],230,5,36470,4.114395306859206,0.0,0.0
18864,1,8864,[568 269 496  97 313],654,4,36474,4.1143824027072755,20.0,20.0
18865,1,8865,[357 286 323 546 117],416,3,36477,4.1142567110309045,0.0,0.0
18866,1,8866,[191 127 328 333 216],854,2,36479,4.11401826998985,0.0,0.0
18867,1,8867,[125  95 202 179 172],416,3,36482,4.113892647722147,0.0,0.0
18868,1,8868,[282 427 289 173 235],416,3,36485,4.113767053782839,0.0,0.0
18869,1,8869,[174 238 211 288  11],297,4,36489,4.113754227733935,0.0,20.0
18870,1,8870,[118 200 216 176 271],297,2,36491,4.113515950851088,0.0,0.0
18871,1,8871,[200  11 179  12  79],416,4,36495,4.113503155996393,20.0,0.0
18872,1,8872,[ 28 597   8 289 181],887,5,36500,4.113603065479545,0.0,20.0
18873,1,8873,[ 64 483  12 427  11],618,5,36505,4.113702952445346,60.0,0.0
18874,1,8874,[597 313  15 174 289],416,3,36508,4.113577464788732,20.0,20.0
18875,1,8875,[475 195 234 200 655],805,3,36511,4.113452005407841,0.0,0.0
18876,1,8876,[ 70 121 496 168 568],711,3,36514,4.113326574293117,0.0,0.0
18877,1,8877,[ 64 483  12 427  11],618,5,36519,4.113426447398063,60.0,0.0
18878,1,8878,[ 64 483  12 427  11],214,5,36524,4.113526298006533,60.0,0.0
18879,1,8879,[265  88 197 143  98],128,5,36529,4.113626126126126,0.0,20.0
18880,1,8880,[ 64 483  12 427  11],214,5,36534,4.113725931764441,60.0,0.0
18881,1,8881,[ 64 483  12 427  11],618,5,36539,4.11382571492907,60.0,0.0
18882,1,8882,[168 191  22 183  28],698,0,36539,4.113362602724305,0.0,0.0
18883,1,8883,[ 64 483  12 427  11],618,5,36544,4.1134624043223775,60.0,0.0
18884,1,8884,[111 183 143 237  95],297,3,36547,4.113337084974677,0.0,0.0
18885,1,8885,[ 64 483  12 427  11],618,5,36552,4.113436866981769,60.0,0.0
18886,1,8886,[ 64 483  12 427  11],214,5,36557,4.113536626533138,60.0,0.0
18887,1,8887,[ 64 483  12 427  11],214,5,36562,4.113636363636363,60.0,0.0
18888,1,8888,[194  28 568  82  25],751,4,36566,4.113623579705254,0.0,0.0
18889,1,8889,[302 748 143  50 515],416,5,36571,4.113723284589426,0.0,20.0
18890,1,8890,[ 64 483  12 427  11],214,5,36576,4.113822967045326,60.0,0.0
18891,1,8891,[ 71 603   8 289 333],416,4,36580,4.113810166441746,0.0,0.0
18892,1,8892,[ 64 483  12 427  11],214,5,36585,4.113909816709771,60.0,0.0
18893,1,8893,[ 64 483  12 427  11],214,5,36590,4.114009444569373,60.0,0.0
18894,1,8894,[175 301 153  97 117],297,5,36595,4.114109050028106,0.0,0.0
18895,1,8895,[276  70 132 588 151],437,3,36598,4.11398381294964,0.0,0.0
18896,1,8896,[ 64 483  12 427  11],618,5,36603,4.114083398898505,60.0,0.0
18897,1,8897,[ 64 483  12 427  11],618,5,36608,4.114182962463475,60.0,0.0
18898,1,8898,[210 333  82 742 111],588,4,36612,4.114170131475447,0.0,0.0
18899,1,8899,[ 64 483  12 427  11],618,5,36617,4.114269662921348,60.0,0.0
18900,1,8900,[ 64 483  12 427  11],214,5,36622,4.114369172003146,60.0,0.0
18901,1,8901,[194 204  95 288  11],416,4,36626,4.114356324421478,0.0,20.0
18902,1,8902,[  7 508 235  25 294],417,1,36627,4.11400651465798,0.0,0.0
18903,1,8903,[ 64 483  12 427  11],618,5,36632,4.114106019766397,60.0,0.0
18904,1,8904,[ 64 483  12 427  11],214,5,36637,4.11420550252667,60.0,0.0
18905,1,8905,[269  50 748 185 194],297,3,36640,4.1140803952391645,0.0,20.0
18906,1,8906,[496  69  82 318 210],373,4,36644,4.1140675872908945,20.0,0.0
18907,1,8907,[125  22 546  56 357],62,5,36649,4.114167040862147,0.0,0.0
18908,1,8908,[ 64 483  12 427  11],214,5,36654,4.114266472106858,60.0,0.0
18909,1,8909,[427 318 195  69 215],705,1,36655,4.113916947250281,20.0,0.0
18910,1,8910,[597 294 288 180 275],62,2,36657,4.11367972169229,0.0,20.0
18911,1,8911,[191  11 176  70 403],416,5,36662,4.113779174147218,0.0,0.0
18912,1,8912,[ 64 483  12 427  11],214,5,36667,4.113878604285874,60.0,0.0
18913,1,8913,[ 64 483  12 427  11],214,5,36672,4.113978012115773,60.0,0.0
18914,1,8914,[ 64 483  12 427  11],214,5,36677,4.11407739764442,60.0,0.0
18915,1,8915,[ 64 483  12 427  11],618,5,36682,4.114176760879318,60.0,0.0
18916,1,8916,[ 64 483  12 427  11],618,5,36687,4.114276101827969,60.0,0.0
18917,1,8917,[ 64 483  12 427  11],618,5,36692,4.114375420497869,60.0,0.0
18918,1,8918,[ 64 483  12 427  11],214,5,36697,4.114474716896513,60.0,0.0
18919,1,8919,[568  82 508 475 118],62,3,36700,4.114349775784754,0.0,0.0
18920,1,8920,[ 97 603 678 269 515],416,4,36704,4.114336957740163,0.0,0.0
18921,1,8921,[168 100 191  98 118],198,3,36707,4.114212060076216,0.0,20.0
18922,1,8922,[ 64 483  12 427  11],214,5,36712,4.114311330270088,60.0,0.0
18923,1,8923,[ 64 483  12 427  11],214,5,36717,4.114410578216047,60.0,0.0
18924,1,8924,[ 64 483  12 427  11],618,5,36722,4.114509803921568,60.0,0.0
18925,1,8925,[196  28 197 385 258],416,5,36727,4.1146090073941295,0.0,0.0
18926,1,8926,[ 64 483  12 427  11],214,5,36732,4.114708188641201,60.0,0.0
18927,1,8927,[ 22 144 100  71 179],62,4,36736,4.114695340501792,0.0,0.0
18928,1,8928,[ 64 483  12 427  11],214,5,36741,4.114794489864487,60.0,0.0
18929,1,8929,[ 98 180  28  50 179],128,4,36745,4.11478163493841,0.0,40.0
18930,1,8930,[423 228 655  50 100],198,2,36747,4.114544843802486,0.0,20.0
18931,1,8931,[200 258 117   7  56],198,4,36751,4.114532019704433,0.0,0.0
18932,1,8932,[168 191 118  79  11],805,3,36754,4.114407254002015,0.0,0.0
18933,1,8933,[ 64 483  12 427  11],618,5,36759,4.114506380120886,60.0,0.0
18934,1,8934,[603 294 588 357 269],416,5,36764,4.1146054840514825,0.0,0.0
18935,1,8935,[ 64 483  12 427  11],618,5,36769,4.1147045658012535,60.0,0.0
18936,1,8936,[ 88 265  96 302 294],416,4,36773,4.11469173100593,0.0,0.0
18937,1,8937,[475 174 100  79  56],417,2,36775,4.1144551353770416,0.0,0.0
18938,1,8938,[323 475 588 282 118],416,2,36777,4.114218592683746,0.0,0.0
18939,1,8939,[228 173 286 215   1],297,2,36779,4.1139821029082775,0.0,0.0
18940,1,8940,[117 323 210 118 742],751,2,36781,4.113745666032882,0.0,0.0
18941,1,8941,[ 15  25 200 655 175],198,2,36783,4.1135092820398125,0.0,0.0
18942,1,8942,[ 64 483  12 427  11],618,5,36788,4.113608408811361,60.0,0.0
18943,1,8943,[135 288  50 196 191],297,3,36791,4.113483899821109,0.0,40.0
18944,1,8944,[508 216  69   8 175],214,4,36795,4.113471212968139,0.0,0.0
18945,1,8945,[200  22 185 228 161],805,2,36797,4.113234965347641,0.0,0.0
18946,1,8946,[385 173 185 678  82],805,3,36800,4.113110539845758,0.0,0.0
18947,1,8947,[ 64 483  12 427  11],214,5,36805,4.113209655789003,60.0,0.0
18948,1,8948,[333 276 237 179 597],416,1,36806,4.112861772265058,0.0,0.0
18949,1,8949,[273 245 153  56 385],416,4,36810,4.112849162011173,0.0,0.0
18950,1,8950,[ 64 483  12 427  11],214,5,36815,4.112948273935873,60.0,0.0
18951,1,8951,[ 64 483  12 427  11],214,5,36820,4.113047363717605,60.0,0.0
18952,1,8952,[597 288 202 200 216],805,1,36821,4.112699653747347,0.0,20.0
18953,1,8953,[ 64 483  12 427  11],618,5,36826,4.112798749162385,60.0,0.0
18954,1,8954,[275   9 195   7 475],416,4,36830,4.112786152987158,0.0,0.0
18955,1,8955,[ 64 483  12 427  11],618,5,36835,4.11288521661456,60.0,0.0
18956,1,8956,[588  25 210 748 234],345,2,36837,4.112649324550631,0.0,0.0
18957,1,8957,[ 64 483  12 427  11],214,5,36842,4.11274838133512,60.0,0.0
18958,1,8958,[111 385 173 655 403],805,2,36844,4.112512557205045,0.0,0.0
18959,1,8959,[215 174  56 173 121],618,4,36848,4.1125,0.0,0.0
18960,1,8960,[ 64 483  12 427  11],214,5,36853,4.112599040285683,60.0,0.0
18961,1,8961,[588 269  50 496  25],711,5,36858,4.112698058469092,0.0,20.0
18962,1,8962,[ 95 301 265  71 181],437,2,36860,4.112462345196921,0.0,20.0
18963,1,8963,[ 64 483  12 427  11],618,5,36865,4.1125613565372605,60.0,0.0
18964,1,8964,[ 69 313 302 135 176],405,4,36869,4.112548800892359,20.0,20.0
18965,1,8965,[ 64 483  12 427  11],618,5,36874,4.112647780504127,60.0,0.0
18966,1,8966,[ 64 483  12 427  11],618,5,36879,4.112746738039478,60.0,0.0
18967,1,8967,[ 64 483  12 427  11],618,5,36884,4.112845673505799,60.0,0.0
18968,1,8968,[ 64 483  12 427  11],214,5,36889,4.112944586910469,60.0,0.0
18969,1,8969,[ 64 483  12 427  11],618,5,36894,4.113043478260869,60.0,0.0
18970,1,8970,[ 64 483  12 427  11],214,5,36899,4.1131423475643745,60.0,0.0
18971,1,8971,[271 294 245 135  79],297,1,36900,4.112795363352653,0.0,0.0
18972,1,8972,[483 174 216  97 151],618,3,36903,4.11267134737546,20.0,0.0
18973,1,8973,[ 64 483  12 427  11],214,5,36908,4.112770225094718,60.0,0.0
18974,1,8974,[ 64 483  12 427  11],618,5,36913,4.112869080779944,60.0,0.0
18975,1,8975,[ 64 483  12 427  11],214,5,36918,4.112967914438503,60.0,0.0
18976,1,8976,[194 179 168 568  71],373,4,36922,4.112955330288515,0.0,0.0
18977,1,8977,[496 197  89 603 204],373,4,36926,4.112942748941858,0.0,0.0
18978,1,8978,[ 64 483  12 427  11],618,5,36931,4.113041541374318,60.0,0.0
18979,1,8979,[235 100 294   8 144],907,4,36935,4.113028953229398,0.0,0.0
18980,1,8980,[ 64 483  12 427  11],618,5,36940,4.113127714063022,60.0,0.0
18981,1,8981,[144 125  15 268 357],417,4,36944,4.113115119127143,0.0,0.0
18982,1,8982,[ 64 483  12 427  11],618,5,36949,4.113213848380274,60.0,0.0
18983,1,8983,[238 405 202  98  71],128,4,36953,4.11320124666073,0.0,20.0
18984,1,8984,[  9 276 357  71 180],62,5,36958,4.113299944351697,0.0,0.0
18985,1,8985,[588 258 300 385 269],345,2,36960,4.11306476741598,0.0,0.0
18986,1,8986,[288 216  56 597  88],805,1,36961,4.112718370980305,0.0,20.0
18987,1,8987,[168  95 143 100 276],416,3,36964,4.112594570538496,0.0,0.0
18988,1,8988,[ 64 483  12 427  11],618,5,36969,4.11269329180109,60.0,0.0
18989,1,8989,[153  15  56 288 237],342,4,36973,4.112680756395996,0.0,20.0
18990,1,8990,[210  88  64 496 568],642,5,36978,4.112779446112779,20.0,0.0
18991,1,8991,[  4 195 182 322  11],417,3,36981,4.1126556939501775,0.0,0.0
18992,1,8992,[ 64 483  12 427  11],618,5,36986,4.112754364505727,60.0,0.0
18993,1,8993,[132  11 742   7 200],764,4,36990,4.112741827885257,0.0,0.0
18994,1,8994,[196 471   1 194 202],416,5,36995,4.11284046692607,0.0,0.0
18995,1,8995,[ 64 483  12 427  11],214,5,37000,4.11293908403735,60.0,0.0
18996,1,8996,[ 64 483  12 427  11],618,5,37005,4.113037679226409,60.0,0.0
18997,1,8997,[151 238 216 258  97],711,5,37010,4.1131362525005555,0.0,0.0
18998,1,8998,[ 50 173 496 385  98],43,5,37015,4.113234803867097,0.0,40.0
18999,1,8999,[ 64 483  12 427  11],618,5,37020,4.113333333333333,60.0,0.0
19000,1,9000,[ 64 483  12 427  11],214,5,37025,4.113431840906566,60.0,0.0
19001,1,9001,[127 288  50 204 144],805,1,37026,4.113085980893135,0.0,40.0
19002,1,9002,[ 64 483  12 427  11],618,5,37031,4.113184494057537,60.0,0.0
19003,1,9003,[ 64 483  12 427  11],214,5,37036,4.113282985339849,60.0,0.0
19004,1,9004,[118  89 258 117 196],62,4,37040,4.113270405330372,0.0,0.0
19005,1,9005,[328 235 100 238 200],854,3,37043,4.113146791028203,0.0,0.0
19006,1,9006,[ 64 483  12 427  11],618,5,37048,4.113245253691574,60.0,0.0
19007,1,9007,[ 79 216 143   4  98],405,4,37052,4.11323268206039,0.0,20.0
19008,1,9008,[ 79 515 202 204 216],230,5,37057,4.113331113331113,0.0,0.0
19009,1,9009,[ 64 483  12 427  11],618,5,37062,4.113429522752497,60.0,0.0
19010,1,9010,[ 64 483  12 427  11],214,5,37067,4.1135279103318165,60.0,0.0
19011,1,9011,[313   9 118  64 238],345,4,37071,4.113515312916112,40.0,20.0
19012,1,9012,[ 79 294 288 222 196],297,2,37073,4.113280816598247,0.0,20.0
19013,1,9013,[  1 423 196 175 168],297,3,37076,4.11315731084979,0.0,0.0
19014,1,9014,[238 161 313 257   7],751,1,37077,4.112811980033278,20.0,20.0
19015,1,9015,[132 294 588 204  69],679,2,37079,4.112577639751553,0.0,0.0
19016,1,9016,[174  71  22 191  88],505,4,37083,4.112565154707775,0.0,0.0
19017,1,9017,[ 50 153 187 237 127],198,4,37087,4.112552672432912,0.0,20.0
19018,1,9018,[ 64 483  12 427  11],214,5,37092,4.112651069963411,60.0,0.0
19019,1,9019,[ 64 483  12 427  11],214,5,37097,4.1127494456762745,60.0,0.0
19020,1,9020,[ 64 483  12 427  11],214,5,37102,4.112847799578761,60.0,0.0
19021,1,9021,[313 181 151  97  50],921,3,37105,4.112724451341166,20.0,60.0
19022,1,9022,[ 95 403 195 127 318],405,4,37109,4.112711958328716,20.0,0.0
19023,1,9023,[ 12 168  96 258 294],49,2,37111,4.112477836879433,20.0,0.0
19024,1,9024,[182 180  95 216 202],437,4,37115,4.112465373961219,0.0,0.0
19025,1,9025,[ 64 483  12 427  11],618,5,37120,4.112563704852648,60.0,0.0
19026,1,9026,[ 64 483  12 427  11],618,5,37125,4.112662013958126,60.0,0.0
19027,1,9027,[191 228 678 435 222],721,3,37128,4.112538768276473,0.0,0.0
19028,1,9028,[475 333 118 127 153],854,3,37131,4.112415549894783,0.0,0.0
19029,1,9029,[ 64 483  12 427  11],618,5,37136,4.1125138427464005,60.0,0.0
19030,1,9030,[235 678  22 111 179],805,2,37138,4.112279924703798,0.0,0.0
19031,1,9031,[168 742  64 546 204],62,3,37141,4.112156775907883,20.0,0.0
19032,1,9032,[  8 286  89 276  98],437,3,37144,4.11203365437839,0.0,20.0
19033,1,9033,[318 196 273  15   7],62,4,37148,4.112021253044055,20.0,0.0
19034,1,9034,[ 89 100 182 202 475],417,4,37152,4.112008854454897,0.0,0.0
19035,1,9035,[ 64 483  12 427  11],214,5,37157,4.112107127047366,60.0,0.0
19036,1,9036,[143 132  88 173 195],373,3,37160,4.111984065508465,0.0,0.0
19037,1,9037,[ 50 183 125 483 202],253,4,37164,4.111971675149369,20.0,20.0
19038,1,9038,[ 64 483  12 427  11],214,5,37169,4.112069919238854,60.0,0.0
19039,1,9039,[234 172 655  95 423],262,2,37171,4.11183628318584,0.0,0.0
19040,1,9040,[176  88  25 144 111],618,3,37174,4.111713306050215,0.0,0.0
19041,1,9041,[ 64 483  12 427  11],618,5,37179,4.1118115461181155,60.0,0.0
19042,1,9042,[423 405 181 515 161],416,5,37184,4.111909764458697,0.0,20.0
19043,1,9043,[ 64 483  12 427  11],214,5,37189,4.112007961079168,60.0,0.0
19044,1,9044,[121 186 294 258 282],854,1,37190,4.1116639027086785,0.0,0.0
19045,1,9045,[ 64 483  12 427  11],618,5,37195,4.111762104797701,60.0,0.0
19046,1,9046,[ 64 483  12 427  11],618,5,37200,4.111860285177407,60.0,0.0
19047,1,9047,[ 64 483  12 427  11],214,5,37205,4.111958443854996,60.0,0.0
19048,1,9048,[ 64 483  12 427  11],214,5,37210,4.1120565808376615,60.0,0.0
19049,1,9049,[ 28 151 132  71 323],345,2,37212,4.111823204419889,0.0,0.0
19050,1,9050,[ 64 483  12 427  11],618,5,37217,4.111921334659153,60.0,0.0
19051,1,9051,[153 546  69  98 174],654,5,37222,4.112019443216969,0.0,20.0
19052,1,9052,[195 273  25  95 118],297,2,37224,4.111786148238153,0.0,0.0
19053,1,9053,[ 64 483  12 427  11],214,5,37229,4.111884250055224,60.0,0.0
19054,1,9054,[ 64 483  12 427  11],618,5,37234,4.111982330204307,60.0,0.0
19055,1,9055,[269 200 546 234 187],416,4,37238,4.111969964664311,0.0,0.0
19056,1,9056,[ 64 483  12 427  11],214,5,37243,4.112068013691068,60.0,0.0
19057,1,9057,[ 64 483  12 427  11],214,5,37248,4.112166041068669,60.0,0.0
19058,1,9058,[216   9 405  56 273],854,4,37252,4.112153659344298,0.0,0.0
19059,1,9059,[ 64 483  12 427  11],618,5,37257,4.112251655629139,60.0,0.0
19060,1,9060,[187  25 265 181 197],416,5,37262,4.112349630283633,0.0,20.0
19061,1,9061,[ 64 483  12 427  11],618,5,37267,4.112447583314942,60.0,0.0
19062,1,9062,[151 496 132  71 186],711,3,37270,4.112324837250359,0.0,0.0
19063,1,9063,[ 64 483  12 427  11],214,5,37275,4.112422771403354,60.0,0.0
19064,1,9064,[ 64 483  12 427  11],214,5,37280,4.112520683949255,60.0,0.0
19065,1,9065,[ 64 483  12 427  11],214,5,37285,4.112618574895213,60.0,0.0
19066,1,9066,[181 282 127 204 173],416,5,37290,4.112716444248373,0.0,20.0
19067,1,9067,[  8 186 235 175 318],854,3,37293,4.1125937362152625,20.0,0.0
19068,1,9068,[132 100 180  79 181],198,2,37295,4.112360789502701,0.0,20.0
19069,1,9069,[117  69 748 475 216],416,4,37299,4.112348401323043,0.0,0.0
19070,1,9070,[  1 294 385 181  69],887,5,37304,4.112446257303494,0.0,20.0
19071,1,9071,[153  50 173 435 216],96,3,37307,4.112323633156967,0.0,20.0
19072,1,9072,[ 64 483  12 427  11],618,5,37312,4.112421470296484,60.0,0.0
19073,1,9073,[ 64 483  12 427  11],214,5,37317,4.112519285871722,60.0,0.0
19074,1,9074,[ 64 483  12 427  11],214,5,37322,4.112617079889807,60.0,0.0
19075,1,9075,[168 132 111 328 483],62,3,37325,4.112494490965183,20.0,0.0
19076,1,9076,[153  95 185 245 183],297,3,37328,4.112371929051449,0.0,0.0
19077,1,9077,[ 12 127 183   8   9],62,5,37333,4.112469706983918,20.0,0.0
19078,1,9078,[194 234 655 603  88],416,4,37337,4.112457319088005,0.0,0.0
19079,1,9079,[405 655 427  79 211],416,5,37342,4.112555066079295,0.0,0.0
19080,1,9080,[ 64 483  12 427  11],618,5,37347,4.112652791542781,60.0,0.0
19081,1,9081,[ 98 172 748 182 185],198,3,37350,4.112530279674081,0.0,20.0
19082,1,9082,[300 197 301 235  12],345,3,37353,4.1124077947814595,20.0,0.0
19083,1,9083,[302 742 175 423  64],43,4,37357,4.1123954205195945,20.0,0.0
19084,1,9084,[ 64 483  12 427  11],214,5,37362,4.1124931205283435,60.0,0.0
19085,1,9085,[ 64 483  12 427  11],618,5,37367,4.112590799031477,60.0,0.0
19086,1,9086,[ 82 216 211 742 235],417,2,37369,4.112358314075053,0.0,0.0
19087,1,9087,[ 64 483  12 427  11],214,5,37374,4.112455985915493,60.0,0.0
19088,1,9088,[ 64 483  12 427  11],214,5,37379,4.112553636263615,60.0,0.0
19089,1,9089,[228 423 265 269  97],297,2,37381,4.112321232123212,0.0,0.0
19090,1,9090,[202 111  95 186 215],437,2,37383,4.112088879111209,0.0,0.0
19091,1,9091,[ 82  95 385 181 200],417,4,37387,4.112076550813902,0.0,20.0
19092,1,9092,[194 597 265 117   7],416,4,37391,4.112064225228197,0.0,0.0
19093,1,9093,[ 64 483  12 427  11],618,5,37396,4.112161864965912,60.0,0.0
19094,1,9094,[ 95  56 185 179 273],805,3,37399,4.112039582188015,0.0,0.0
19095,1,9095,[  8 185  70 173   7],49,2,37401,4.111807387862797,0.0,0.0
19096,1,9096,[ 12 238 100 195 294],601,1,37402,4.111465318236782,20.0,0.0
19097,1,9097,[ 64 483  12 427  11],618,5,37407,4.1115629808749175,60.0,0.0
19098,1,9098,[ 64 483  12 427  11],618,5,37412,4.1116606220463785,60.0,0.0
19099,1,9099,[ 64 483  12 427  11],214,5,37417,4.111758241758242,60.0,0.0
19100,1,9100,[ 64 483  12 427  11],618,5,37422,4.11185584001758,60.0,0.0
19101,1,9101,[ 64 483  12 427  11],214,5,37427,4.111953416831466,60.0,0.0
19102,1,9102,[191 234 174  71 655],618,5,37432,4.112050972206965,0.0,0.0
19103,1,9103,[100 328  70  12 151],62,3,37435,4.1119288224956065,20.0,0.0
19104,1,9104,[  8 195  15 151  12],437,4,37439,4.111916529379462,20.0,0.0
19105,1,9105,[191 117 597   4 216],417,2,37441,4.111684603558094,0.0,0.0
19106,1,9106,[191  71  88  98 275],43,5,37446,4.111782145602284,0.0,20.0
19107,1,9107,[ 64 483  12 427  11],618,5,37451,4.111879666227492,60.0,0.0
19108,1,9108,[ 64 483  12 427  11],618,5,37456,4.111977165440773,60.0,0.0
19109,1,9109,[ 64 483  12 427  11],214,5,37461,4.112074643249176,60.0,0.0
19110,1,9110,[515  69 127 234 191],416,5,37466,4.112172099659752,0.0,0.0
19111,1,9111,[ 64 483  12 427  11],214,5,37471,4.112269534679544,60.0,0.0
19112,1,9112,[385 423  22  56 216],642,3,37474,4.112147481619664,0.0,0.0
19113,1,9113,[265 215 269 118 588],297,2,37476,4.111915734035549,0.0,0.0
19114,1,9114,[216 275 210  64 276],416,4,37480,4.111903455842018,20.0,0.0
19115,1,9115,[ 64 483  12 427  11],214,5,37485,4.112000877577885,60.0,0.0
19116,1,9116,[268 301 655 161 117],416,5,37490,4.112098277942305,0.0,0.0
19117,1,9117,[ 64 483  12 427  11],214,5,37495,4.112195656942312,60.0,0.0
19118,1,9118,[191 318 181   4 111],416,5,37500,4.112293014584933,20.0,20.0
19119,1,9119,[ 64 483  12 427  11],618,5,37505,4.112390350877193,60.0,0.0
19120,1,9120,[302 118 405 288  89],62,1,37506,4.112049117421336,0.0,20.0
19121,1,9121,[245 211 216  69 268],416,4,37510,4.112036834027625,0.0,0.0
19122,1,9122,[ 64 483  12 427  11],618,5,37515,4.112134166392634,60.0,0.0
19123,1,9123,[ 64 483  12 427  11],214,5,37520,4.112231477422183,60.0,0.0
19124,1,9124,[211  28 294 427 742],416,5,37525,4.112328767123287,0.0,0.0
19125,1,9125,[748 328 597 144 172],416,4,37529,4.112316458470304,0.0,0.0
19126,1,9126,[135 197 186 286 191],854,3,37532,4.112194587487674,0.0,0.0
19127,1,9127,[ 64 483  12 427  11],618,5,37537,4.1122918492550395,60.0,0.0
19128,1,9128,[ 64 483  12 427  11],618,5,37542,4.112389089714098,60.0,0.0
19129,1,9129,[ 64 483  12 427  11],214,5,37547,4.112486308871851,60.0,0.0
19130,1,9130,[ 64 483  12 427  11],214,5,37552,4.112583506735297,60.0,0.0
19131,1,9131,[121 216 100 211  82],230,5,37557,4.112680683311432,0.0,0.0
19132,1,9132,[196 195 132 288 210],601,2,37559,4.112449359465674,0.0,20.0
19133,1,9133,[ 70 174 132 117  95],437,3,37562,4.112327567330852,0.0,0.0
19134,1,9134,[210 191 268 161 275],416,5,37567,4.112424740010947,0.0,0.0
19135,1,9135,[ 64 483  12 427  11],618,5,37572,4.112521891418564,60.0,0.0
19136,1,9136,[ 28 276 179  50 301],437,3,37575,4.112400131334136,0.0,20.0
19137,1,9137,[176 568 237 121 265],198,1,37576,4.112059531626176,0.0,0.0
19138,1,9138,[483  88 173 258  97],588,4,37580,4.112047269942007,20.0,0.0
19139,1,9139,[ 98 183 195 117  69],417,4,37584,4.112035010940919,0.0,20.0
19140,1,9140,[655  22 265 143 282],416,5,37589,4.112132151843343,0.0,0.0
19141,1,9141,[ 64 483  12 427  11],214,5,37594,4.112229271494202,60.0,0.0
19142,1,9142,[ 64 483  12 427  11],618,5,37599,4.112326369900471,60.0,0.0
19143,1,9143,[257 294 211 182  70],416,4,37603,4.112314085739283,0.0,0.0
19144,1,9144,[ 64 483  12 427  11],618,5,37608,4.1124111536358665,60.0,0.0
19145,1,9145,[191 121 153 125 301],416,5,37613,4.112508200306145,0.0,0.0
19146,1,9146,[182  70 357  56 196],62,4,37617,4.112495900295179,0.0,0.0
19147,1,9147,[ 64 483  12 427  11],214,5,37622,4.112592916484478,60.0,0.0
19148,1,9148,[ 64 483  12 427  11],214,5,37627,4.112689911465734,60.0,0.0
19149,1,9149,[ 25 275 195   7 187],416,5,37632,4.112786885245901,0.0,0.0
19150,1,9150,[ 71 183 234 174 185],198,2,37634,4.1125560048082175,0.0,0.0
19151,1,9151,[215 210 151 204 144],373,4,37638,4.112543706293707,0.0,0.0
19152,1,9152,[ 64 483  12 427  11],214,5,37643,4.1126406642630835,60.0,0.0
19153,1,9153,[151  28  98  64  97],416,4,37647,4.112628359187241,20.0,20.0
19154,1,9154,[153  96 195  82 121],642,3,37650,4.112506826870563,0.0,0.0
19155,1,9155,[ 64 483  12 427  11],618,5,37655,4.11260375709917,60.0,0.0
19156,1,9156,[183 174 294 568 202],505,2,37657,4.112373047941466,0.0,0.0
19157,1,9157,[ 22   1 204  98 182],297,2,37659,4.112142389167941,0.0,20.0
19158,1,9158,[ 64 483  12 427  11],618,5,37664,4.112239327437493,60.0,0.0
19159,1,9159,[269 168  70 258 257],654,5,37669,4.112336244541485,0.0,0.0
19160,1,9160,[200 195 313 257 427],416,4,37673,4.112323982098024,20.0,20.0
19161,1,9161,[ 64 483  12 427  11],214,5,37678,4.112420868805938,60.0,0.0
19162,1,9162,[ 64 483  12 427  11],618,5,37683,4.112517734366474,60.0,0.0
19163,1,9163,[ 25  79 172 288  71],711,3,37686,4.11239633347883,0.0,20.0
19164,1,9164,[ 22 173 302   4 215],416,5,37691,4.112493180578287,0.0,0.0
19165,1,9165,[ 98 515 403  82 196],416,5,37696,4.112590006545931,0.0,20.0
19166,1,9166,[323  64 197 100  56],198,3,37699,4.112468637504091,20.0,0.0
19167,1,9167,[300 143 204 286  22],297,3,37702,4.112347294938918,0.0,0.0
19168,1,9168,[235  25 234 111  22],297,2,37704,4.112116915694187,0.0,0.0
19169,1,9169,[ 64 483  12 427  11],618,5,37709,4.1122137404580155,60.0,0.0
19170,1,9170,[ 64 483  12 427  11],214,5,37714,4.112310544106422,60.0,0.0
19171,1,9171,[202 127 197 144 175],373,0,37714,4.111862189271696,0.0,0.0
19172,1,9172,[ 64 483  12 427  11],618,5,37719,4.11195901013845,60.0,0.0
19173,1,9173,[ 64 483  12 427  11],618,5,37724,4.112055809897536,60.0,0.0
19174,1,9174,[215 294 202 258   9],416,5,37729,4.112152588555858,0.0,0.0
19175,1,9175,[ 64 174 143  22  15],373,4,37733,4.112140366172624,20.0,0.0
19176,1,9176,[ 64 483  12 427  11],618,5,37738,4.112237114525444,60.0,0.0
19177,1,9177,[ 64 483  12 427  11],214,5,37743,4.112333841795598,60.0,0.0
19178,1,9178,[111 195 435 153 678],297,1,37744,4.111994770672187,0.0,0.0
19179,1,9179,[186 143 211   8  56],43,4,37748,4.1119825708061,0.0,0.0
19180,1,9180,[ 64 483  12 427  11],214,5,37753,4.112079294194532,60.0,0.0
19181,1,9181,[ 64 483  12 427  11],618,5,37758,4.112175996514921,60.0,0.0
19182,1,9182,[245 183  64  96  82],416,4,37762,4.112163780899488,20.0,0.0
19183,1,9183,[ 96 294  50 191   4],416,5,37767,4.112260452961673,0.0,20.0
19184,1,9184,[237   4 176   1 268],416,4,37771,4.1122482308111055,0.0,0.0
19185,1,9185,[ 64 483  12 427  11],214,5,37776,4.112344872632266,60.0,0.0
19186,1,9186,[300 186 179 238 196],198,3,37779,4.112223794492217,0.0,0.0
19187,1,9187,[286  89  97  95 180],373,2,37781,4.1119939050936,0.0,0.0
19188,1,9188,[ 64 483  12 427  11],214,5,37786,4.112090543040592,60.0,0.0
19189,1,9189,[ 69 204 268  70 435],297,2,37788,4.111860718171926,0.0,0.0
19190,1,9190,[ 50  71 742   1 235],62,3,37791,4.111739745403112,0.0,20.0
19191,1,9191,[186  22   8 655 111],618,3,37794,4.111618798955614,0.0,0.0
19192,1,9192,[ 64 483  12 427  11],618,5,37799,4.111715435657565,60.0,0.0
19193,1,9193,[121   4 183 111 288],618,2,37801,4.111485751577115,0.0,20.0
19194,1,9194,[ 50 302  22 237 174],416,4,37805,4.11147362697118,0.0,20.0
19195,1,9195,[ 98 588  71 202  12],43,5,37810,4.1115702479338845,20.0,20.0
19196,1,9196,[ 64 483  12 427  11],618,5,37815,4.11166684788518,60.0,0.0
19197,1,9197,[ 56 196 100  50  22],601,3,37818,4.111545988258317,0.0,20.0
19198,1,9198,[ 64 483  12 427  11],214,5,37823,4.111642569844548,60.0,0.0
19199,1,9199,[ 64 483  12 427  11],214,5,37828,4.111739130434783,60.0,0.0
19200,1,9200,[ 64 483  12 427  11],618,5,37833,4.111835670035866,60.0,0.0
19201,1,9201,[ 64 483  12 427  11],214,5,37838,4.111932188654641,60.0,0.0
19202,1,9202,[ 64 483  12 427  11],214,5,37843,4.112028686297946,60.0,0.0
19203,1,9203,[ 28 168  98 195 185],405,4,37847,4.112016514558888,0.0,20.0
19204,1,9204,[ 15   9  69  11 357],630,1,37848,4.111678435632808,0.0,0.0
19205,1,9205,[118 153  95  22 273],805,1,37849,4.1113404301542475,0.0,0.0
19206,1,9206,[ 64 483  12 427  11],618,5,37854,4.1114369501466275,60.0,0.0
19207,1,9207,[161 202 301 323 265],416,4,37858,4.111424847958297,0.0,0.0
19208,1,9208,[117 118 197 215 269],345,4,37862,4.111412748398306,0.0,0.0
19209,1,9209,[237 118 742   8 151],62,2,37864,4.111183496199783,0.0,0.0
19210,1,9210,[235  50 258 210 742],345,4,37868,4.111171425469547,0.0,20.0
19211,1,9211,[ 64 483  12 427  11],214,5,37873,4.111267911419887,60.0,0.0
19212,1,9212,[ 64 483  12 427  11],618,5,37878,4.111364376424618,60.0,0.0
19213,1,9213,[ 98 588  12 100 202],43,5,37883,4.111460820490558,20.0,20.0
19214,1,9214,[ 64 483  12 427  11],618,5,37888,4.111557243624525,60.0,0.0
19215,1,9215,[215 268  22 275 173],654,4,37892,4.111545138888889,0.0,0.0
19216,1,9216,[ 64 483  12 427  11],214,5,37897,4.111641531951828,60.0,0.0
19217,1,9217,[118 238  12 111 179],437,3,37900,4.111520937296594,20.0,0.0
19218,1,9218,[  9  11 176 322 257],416,3,37903,4.111400368803558,0.0,0.0
19219,1,9219,[ 64 483  12 427  11],618,5,37908,4.111496746203905,60.0,0.0
19220,1,9220,[ 64 483  12 427  11],214,5,37913,4.111593102700358,60.0,0.0
19221,1,9221,[ 64 483  12 427  11],618,5,37918,4.1116894382997184,60.0,0.0
19222,1,9222,[ 96 204 174 328  25],49,0,37918,4.111243630055297,0.0,0.0
19223,1,9223,[118 234 168 515 202],417,5,37923,4.111339982653946,0.0,0.0
19224,1,9224,[ 64 483  12 427  11],214,5,37928,4.111436314363144,60.0,0.0
19225,1,9225,[257   1 271 483  50],62,2,37930,4.111207457186213,20.0,20.0
19226,1,9226,[ 79  64  56   9 288],854,5,37935,4.111303782377805,20.0,20.0
19227,1,9227,[191 328 742 135 144],62,2,37937,4.1110749891634155,0.0,0.0
19228,1,9228,[ 64 483  12 427  11],618,5,37942,4.1111713078340015,60.0,0.0
19229,1,9229,[ 64 483  12 427  11],214,5,37947,4.1112676056338024,60.0,0.0
19230,1,9230,[185 180  28 216  89],805,2,37949,4.111038890694399,0.0,0.0
19231,1,9231,[216 276 258  71 235],43,4,37953,4.111026863084922,0.0,0.0
19232,1,9232,[ 64 483  12 427  11],618,5,37958,4.1111231452399,60.0,0.0
19233,1,9233,[496 748 268 300 125],416,5,37963,4.111219406541044,0.0,0.0
19234,1,9234,[ 64 483  12 427  11],618,5,37968,4.111315646995127,60.0,0.0
19235,1,9235,[405  15 276 121 328],921,3,37971,4.111195322650498,0.0,0.0
19236,1,9236,[ 64 483  12 427  11],618,5,37976,4.111291544873877,60.0,0.0
19237,1,9237,[204 210  12 111  25],43,5,37981,4.111387746265425,20.0,0.0
19238,1,9238,[ 71 483  22 172 174],588,4,37985,4.111375690009742,20.0,0.0
19239,1,9239,[ 64 483  12 427  11],214,5,37990,4.111471861471862,60.0,0.0
19240,1,9240,[127 357 328 121 568],62,3,37993,4.111351585326263,0.0,0.0
19241,1,9241,[144 568  56 294   7],416,5,37998,4.111447738584722,0.0,0.0
19242,1,9242,[187 313 173   4 151],416,4,38002,4.1114356810559345,20.0,20.0
19243,1,9243,[ 64 483  12 427  11],214,5,38007,4.111531804413674,60.0,0.0
19244,1,9244,[228 475 742 200 161],805,2,38009,4.111303407247161,0.0,0.0
19245,1,9245,[237 222 588   1 275],588,2,38011,4.111075059485183,0.0,0.0
19246,1,9246,[238 286 258  11 144],43,4,38015,4.111063047474857,0.0,0.0
19247,1,9247,[ 64  88 125  71 597],642,5,38020,4.111159169550173,20.0,0.0
19248,1,9248,[ 64 483  12 427  11],618,5,38025,4.111255270840091,60.0,0.0
19249,1,9249,[496 204  88 118 742],128,4,38029,4.111243243243243,0.0,0.0
19250,1,9250,[ 70 265 179  11 181],416,4,38033,4.111231218246676,0.0,20.0
19251,1,9251,[ 64 483  12 427  11],214,5,38038,4.111327280587981,60.0,0.0
19252,1,9252,[ 64 483  12 427  11],214,5,38043,4.111423322165784,60.0,0.0
19253,1,9253,[515 100 151 423 215],416,4,38047,4.111411281607953,0.0,0.0
19254,1,9254,[301  69 191   7 597],43,4,38051,4.11139924365208,0.0,0.0
19255,1,9255,[ 64 483  12 427  11],214,5,38056,4.111495246326707,60.0,0.0
19256,1,9256,[ 96  88 603 245 211],416,3,38059,4.1113751755428325,0.0,0.0
19257,1,9257,[ 64 483  12 427  11],214,5,38064,4.1114711600777705,60.0,0.0
19258,1,9258,[185  50 216 194 183],405,2,38066,4.111243114807214,0.0,20.0
19259,1,9259,[ 64 483  12 427  11],214,5,38071,4.11133909287257,60.0,0.0
19260,1,9260,[546 175 111 286   8],43,4,38075,4.111327070510744,0.0,0.0
19261,1,9261,[ 70 153 748 405 161],198,1,38076,4.1109911466206,0.0,0.0
19262,1,9262,[ 64 483  12 427  11],214,5,38081,4.111087120803195,60.0,0.0
19263,1,9263,[ 64 483  12 427  11],618,5,38086,4.111183074265976,60.0,0.0
19264,1,9264,[ 64 483  12 427  11],214,5,38091,4.11127900701565,60.0,0.0
19265,1,9265,[ 64 483  12 427  11],618,5,38096,4.1113749190589255,60.0,0.0
19266,1,9266,[ 64 483  12 427  11],618,5,38101,4.111470810402504,60.0,0.0
19267,1,9267,[182 185 742 301 294],297,2,38103,4.11124298662063,0.0,0.0
19268,1,9268,[289   8 175 176 185],854,3,38106,4.111123098500378,0.0,0.0
19269,1,9269,[ 64 483  12 427  11],618,5,38111,4.111218985976268,60.0,0.0
19270,1,9270,[546 357  56  64 508],417,3,38114,4.111099126307842,20.0,0.0
19271,1,9271,[215  97   7 187 183],618,5,38119,4.111194995685936,0.0,0.0
19272,1,9272,[196   4 385 276 175],43,4,38123,4.111183004421439,0.0,0.0
19273,1,9273,[742 288 257 403 245],417,2,38125,4.110955359068363,0.0,20.0
19274,1,9274,[ 64 483  12 427  11],618,5,38130,4.111051212938006,60.0,0.0
19275,1,9275,[385 181 204  71  69],373,4,38134,4.111039241052178,0.0,20.0
19276,1,9276,[ 64 483  12 427  11],618,5,38139,4.111135065215048,60.0,0.0
19277,1,9277,[ 82 173  56 483 423],437,4,38143,4.111123086872171,20.0,0.0
19278,1,9278,[257 235 151  97 195],416,2,38145,4.110895570643389,0.0,0.0
19279,1,9279,[172  69 301 333 258],588,4,38149,4.1108836206896555,0.0,0.0
19280,1,9280,[ 64 483  12 427  11],214,5,38154,4.110979420321086,60.0,0.0
19281,1,9281,[182  82  79  98 228],405,3,38157,4.110859728506787,0.0,20.0
19282,1,9282,[238 181  70  79 186],417,3,38160,4.110740062479802,0.0,20.0
19283,1,9283,[194 172  98  89 435],405,2,38162,4.110512710038776,0.0,20.0
19284,1,9284,[195  64 143 175 423],405,4,38166,4.110500807754443,20.0,0.0
19285,1,9285,[153  96 405 288 322],416,4,38170,4.110488908033599,0.0,20.0
19286,1,9286,[ 71 496 174 228 313],505,4,38174,4.110477010875417,20.0,20.0
19287,1,9287,[ 64 483  12 427  11],618,5,38179,4.11057278208441,60.0,0.0
19288,1,9288,[ 64 483  12 427  11],214,5,38184,4.1106685326730545,60.0,0.0
19289,1,9289,[742 216   8 195 302],416,5,38189,4.110764262648009,0.0,0.0
19290,1,9290,[289 202 403 276 301],416,3,38192,4.110644709934345,0.0,0.0
19291,1,9291,[228 197 222 200  79],805,4,38196,4.1106328024106755,0.0,0.0
19292,1,9292,[ 64 483  12 427  11],618,5,38201,4.11072850532659,60.0,0.0
19293,1,9293,[ 64 483  12 427  11],214,5,38206,4.110824187647945,60.0,0.0
19294,1,9294,[ 88 215  28 182 180],437,1,38207,4.1104895104895105,0.0,0.0
19295,1,9295,[ 64 483  12 427  11],618,5,38212,4.110585197934595,60.0,0.0
19296,1,9296,[185 258 238 568 302],416,5,38217,4.110680864795095,0.0,0.0
19297,1,9297,[182 301 176 204 322],416,4,38221,4.110668961066896,0.0,0.0
19298,1,9298,[168 318 210 180 186],373,4,38225,4.110657059898914,20.0,0.0
19299,1,9299,[ 64 483  12 427  11],214,5,38230,4.110752688172043,60.0,0.0
19300,1,9300,[ 64 483  12 427  11],618,5,38235,4.110848295882163,60.0,0.0
19301,1,9301,[168 483 186  69  95],437,2,38237,4.110621371748011,20.0,0.0
19302,1,9302,[ 64 483  12 427  11],214,5,38242,4.110716973019456,60.0,0.0
19303,1,9303,[ 64 483  12 427  11],214,5,38247,4.110812553740327,60.0,0.0
19304,1,9304,[423  89  95 180 127],417,5,38252,4.110908113917249,0.0,0.0
19305,1,9305,[ 64 483  12 427  11],618,5,38257,4.111003653556845,60.0,0.0
19306,1,9306,[265  15  95  98 237],198,1,38258,4.110669388632212,0.0,20.0
19307,1,9307,[328 423  22  96  89],62,3,38261,4.110550064460679,0.0,0.0
19308,1,9308,[ 64 483  12 427  11],618,5,38266,4.110645611773553,60.0,0.0
19309,1,9309,[597 200 546 603 403],416,3,38269,4.110526315789474,0.0,0.0
19310,1,9310,[ 12 508  50 191 135],297,4,38273,4.110514445279777,20.0,20.0
19311,1,9311,[181 357 202 183 161],230,4,38277,4.110502577319588,0.0,20.0
19312,1,9312,[ 64 483  12 427  11],214,5,38282,4.110598088693225,60.0,0.0
19313,1,9313,[181  97 117  71 183],505,3,38285,4.1104788490444495,0.0,20.0
19314,1,9314,[ 64 483  12 427  11],618,5,38290,4.1105743424584,60.0,0.0
19315,1,9315,[135 268  11  89 182],214,3,38293,4.110455130957493,0.0,0.0
19316,1,9316,[ 64 483  12 427  11],618,5,38298,4.110550606418375,60.0,0.0
19317,1,9317,[ 64 483  12 427  11],618,5,38303,4.110646061386563,60.0,0.0
19318,1,9318,[ 64 483  12 427  11],618,5,38308,4.1107414958686554,60.0,0.0
19319,1,9319,[ 64 483  12 427  11],214,5,38313,4.110836909871245,60.0,0.0
19320,1,9320,[ 64 483  12 427  11],618,5,38318,4.110932303400923,60.0,0.0
19321,1,9321,[ 64 483  12 427  11],618,5,38323,4.111027676464278,60.0,0.0
19322,1,9322,[ 64 483  12 427  11],214,5,38328,4.111123029067897,60.0,0.0
19323,1,9323,[ 70  64 288   4  97],62,2,38330,4.110896610896611,20.0,20.0
19324,1,9324,[238 515  69 427 197],405,4,38334,4.110884718498659,0.0,0.0
19325,1,9325,[ 64 483  12 427  11],618,5,38339,4.1109800557580956,60.0,0.0
19326,1,9326,[ 64 483  12 427  11],214,5,38344,4.111075372574247,60.0,0.0
19327,1,9327,[ 50 125 100 313  88],345,4,38348,4.111063464837049,20.0,40.0
19328,1,9328,[100  82 111  89 234],417,3,38351,4.110944367027549,0.0,0.0
19329,1,9329,[ 64 483  12 427  11],214,5,38356,4.111039657020364,60.0,0.0
19330,1,9330,[ 64 483  12 427  11],618,5,38361,4.11113492658879,60.0,0.0
19331,1,9331,[ 79  25 286 257  56],417,2,38363,4.1109087012430345,0.0,0.0
19332,1,9332,[ 25 204 603  15 276],128,4,38367,4.110896817743491,0.0,0.0
19333,1,9333,[322 302 117 294 238],416,4,38371,4.110884936790229,0.0,0.0
19334,1,9334,[276  25  97 174 568],198,1,38372,4.110551687198715,0.0,0.0
19335,1,9335,[173 210 202 597 496],417,2,38374,4.1103256212510715,0.0,0.0
19336,1,9336,[ 64 483  12 427  11],214,5,38379,4.110420906072615,60.0,0.0
19337,1,9337,[ 64 483  12 427  11],618,5,38384,4.110516170486186,60.0,0.0
19338,1,9338,[ 64 483  12 427  11],214,5,38389,4.11061141449834,60.0,0.0
19339,1,9339,[135 172  89 143 286],373,2,38391,4.110385438972163,0.0,0.0
19340,1,9340,[ 64 483  12 427  11],214,5,38396,4.110480676587089,60.0,0.0
19341,1,9341,[ 64 483  12 427  11],214,5,38401,4.1105758938128885,60.0,0.0
19342,1,9342,[  4 121 161 273  89],805,1,38402,4.110242962645831,0.0,0.0
19343,1,9343,[ 64 483  12 427  11],214,5,38407,4.110338184931507,60.0,0.0
19344,1,9344,[ 82 185 216 151  69],416,4,38411,4.110326377742108,0.0,0.0
19345,1,9345,[100  70 300 176  98],198,2,38413,4.110100577787288,0.0,20.0
19346,1,9346,[ 64 483  12 427  11],618,5,38418,4.110195784743768,60.0,0.0
19347,1,9347,[ 95 678 121 268 181],416,3,38421,4.11007702182285,0.0,20.0
19348,1,9348,[ 64 483  12 427  11],214,5,38426,4.11017221093165,60.0,0.0
19349,1,9349,[268 265 197 328 403],416,5,38431,4.1102673796791445,0.0,0.0
19350,1,9350,[ 64 483  12 427  11],214,5,38436,4.110362528071864,60.0,0.0
19351,1,9351,[385 187 182 204 215],198,3,38439,4.1102437981180495,0.0,0.0
19352,1,9352,[ 25 588  82 196 210],805,1,38440,4.109911258419759,0.0,0.0
19353,1,9353,[276 132 237 210 168],416,3,38443,4.10979260209536,0.0,0.0
19354,1,9354,[742 318 216 215 196],654,5,38448,4.109887760555853,20.0,0.0
19355,1,9355,[ 64 483  12 427  11],214,5,38453,4.109982898674647,60.0,0.0
19356,1,9356,[546 265 597 275  79],416,3,38456,4.1098642727369885,0.0,0.0
19357,1,9357,[ 64 483  12 427  11],618,5,38461,4.1099593930327,60.0,0.0
19358,1,9358,[ 82 385 173  69  97],642,5,38466,4.110054493001389,0.0,0.0
19359,1,9359,[655  97 172 302 174],405,4,38470,4.110042735042735,0.0,0.0
19360,1,9360,[ 64 483  12 427  11],618,5,38475,4.11013780578998,60.0,0.0
19361,1,9361,[ 64 483  12 427  11],214,5,38480,4.110232856227302,60.0,0.0
19362,1,9362,[ 64 483  12 427  11],214,5,38485,4.110327886361209,60.0,0.0
19363,1,9363,[ 64 483  12 427  11],618,5,38490,4.110422896198206,60.0,0.0
19364,1,9364,[ 64 483  12 427  11],618,5,38495,4.110517885744795,60.0,0.0
19365,1,9365,[200 403  96 161 357],405,2,38497,4.1102925475122785,0.0,0.0
19366,1,9366,[748  56 322 196 204],679,3,38500,4.110174015159603,0.0,0.0
19367,1,9367,[ 64 483  12 427  11],214,5,38505,4.110269000853971,60.0,0.0
19368,1,9368,[ 64 483  12 427  11],618,5,38510,4.1103639662717475,60.0,0.0
19369,1,9369,[405 100 181 423 210],230,5,38515,4.110458911419424,0.0,20.0
19370,1,9370,[ 64 483  12 427  11],618,5,38520,4.11055383630349,60.0,0.0
19371,1,9371,[  9 197 265 385  25],618,2,38522,4.110328638497653,0.0,0.0
19372,1,9372,[ 64 483  12 427  11],618,5,38527,4.1104235570254986,60.0,0.0
19373,1,9373,[121  79 238 144  25],417,1,38528,4.110091743119266,0.0,0.0
19374,1,9374,[ 64 483  12 427  11],618,5,38533,4.110186666666666,60.0,0.0
19375,1,9375,[742 276 427 597 195],416,3,38536,4.110068259385666,0.0,0.0
19376,1,9376,[ 64 483  12 427  11],618,5,38541,4.110163165191426,60.0,0.0
19377,1,9377,[216 405 125 151 742],854,2,38543,4.109938153124333,0.0,0.0
19378,1,9378,[ 71  82 121   1 172],620,5,38548,4.11003305256424,0.0,0.0
19379,1,9379,[333 273  69  79 194],854,3,38551,4.109914712153518,0.0,0.0
19380,1,9380,[ 64 483  12 427  11],618,5,38556,4.11000959385993,60.0,0.0
19381,1,9381,[ 15 172 282 228 143],921,3,38559,4.109891281176721,0.0,0.0
19382,1,9382,[ 97  28  69  98 403],405,4,38563,4.109879569434083,0.0,20.0
19383,1,9383,[ 64 483  12 427  11],618,5,38568,4.10997442455243,60.0,0.0
19384,1,9384,[ 64 483  12 427  11],618,5,38573,4.11006925945658,60.0,0.0
19385,1,9385,[ 22 294  11 289 185],854,2,38575,4.109844449179629,0.0,0.0
19386,1,9386,[ 64 483  12 427  11],618,5,38580,4.1099392777245125,60.0,0.0
19387,1,9387,[258 286 100 238 245],416,4,38584,4.109927567106945,0.0,0.0
19388,1,9388,[405 238 175 144 655],805,2,38586,4.109702843753328,0.0,0.0
19389,1,9389,[222 210 257 435 423],354,2,38588,4.10947816826411,0.0,0.0
19390,1,9390,[ 71 257 191 118 228],705,3,38591,4.109360025556383,0.0,0.0
19391,1,9391,[117 588 546 313 423],43,5,38596,4.109454855195912,20.0,20.0
19392,1,9392,[ 64 483  12 427  11],618,5,38601,4.109549664643883,60.0,0.0
19393,1,9393,[183 135 143 151 546],297,3,38604,4.109431552054503,0.0,0.0
19394,1,9394,[168 182 181 216 603],214,3,38607,4.109313464608834,0.0,20.0
19395,1,9395,[ 64 483  12 427  11],618,5,38612,4.109408258833546,60.0,0.0
19396,1,9396,[275 237  25 286 302],297,5,38617,4.109503032882835,0.0,0.0
19397,1,9397,[111 328 603 185 210],921,3,38620,4.109384975526708,0.0,0.0
19398,1,9398,[245 144 423   1 182],417,4,38624,4.109373337589105,0.0,0.0
19399,1,9399,[ 98 173 168 427 276],198,4,38628,4.10936170212766,0.0,20.0
19400,1,9400,[ 64 483  12 427  11],618,5,38633,4.10945644080417,60.0,0.0
19401,1,9401,[ 64 483  12 427  11],618,5,38638,4.109551159327802,60.0,0.0
19402,1,9402,[161 475  28 302  88],416,3,38641,4.109433159629905,0.0,0.0
19403,1,9403,[ 12  64 471 678 215],345,3,38644,4.109315185027648,40.0,0.0
19404,1,9404,[ 64 483  12 427  11],618,5,38649,4.1094098883572565,60.0,0.0
19405,1,9405,[216  15  89  69  95],198,3,38652,4.109291941314055,0.0,0.0
19406,1,9406,[197  15 125  12 191],373,4,38656,4.109280323163602,20.0,0.0
19407,1,9407,[ 64 483  12 427  11],214,5,38661,4.109375,60.0,0.0
19408,1,9408,[ 64 483  12 427  11],618,5,38666,4.109469656711659,60.0,0.0
19409,1,9409,[ 64 483  12 427  11],214,5,38671,4.109564293304994,60.0,0.0
19410,1,9410,[100   8 118 302 328],62,2,38673,4.109340133885878,0.0,0.0
19411,1,9411,[186 515 357 385 265],230,4,38677,4.10932851678708,0.0,0.0
19412,1,9412,[100  25 405 200   1],345,3,38680,4.109210666100075,0.0,0.0
19413,1,9413,[ 64 483  12 427  11],618,5,38685,4.109305289993626,60.0,0.0
19414,1,9414,[ 64 483  12 427  11],618,5,38690,4.109399893786511,60.0,0.0
19415,1,9415,[ 64 483  12 427  11],618,5,38695,4.109494477485132,60.0,0.0
19416,1,9416,[294 118 257  71   8],642,4,38699,4.109482850164596,0.0,0.0
19417,1,9417,[ 28 294 288  64 202],416,5,38704,4.109577404969208,20.0,20.0
19418,1,9418,[ 64 483  12 427  11],214,5,38709,4.109671939696359,60.0,0.0
19419,1,9419,[ 64 483  12 427  11],618,5,38714,4.1097664543524415,60.0,0.0
19420,1,9420,[ 64 483  12 427  11],214,5,38719,4.109860948943849,60.0,0.0
19421,1,9421,[ 88  96   4 143 161],373,4,38723,4.109849288898323,0.0,0.0
19422,1,9422,[423  64 121 181 276],43,5,38728,4.109943754642895,20.0,20.0
19423,1,9423,[282  69 423 197 405],416,5,38733,4.110038200339559,0.0,0.0
19424,1,9424,[179   4 127  79  89],417,3,38736,4.109920424403183,0.0,0.0
19425,1,9425,[202  15  64  28  89],642,3,38739,4.1098026734563975,20.0,0.0
19426,1,9426,[ 64 483  12 427  11],214,5,38744,4.1098971040627985,60.0,0.0
19427,1,9427,[216 288  70  28  56],654,4,38748,4.109885447602885,0.0,20.0
19428,1,9428,[ 64 483  12 427  11],618,5,38753,4.109979849400784,60.0,0.0
19429,1,9429,[228   7 265 471 132],505,3,38756,4.109862142099682,0.0,0.0
19430,1,9430,[ 64 483  12 427  11],214,5,38761,4.109956526349274,60.0,0.0
19431,1,9431,[ 64 483  12 427  11],214,5,38766,4.110050890585241,60.0,0.0
19432,1,9432,[127 742 216   9   8],805,0,38766,4.1096151807484365,0.0,0.0
19433,1,9433,[ 64 483  12 427  11],618,5,38771,4.109709561161756,60.0,0.0
19434,1,9434,[ 64 483  12 427  11],618,5,38776,4.109803921568627,60.0,0.0
19435,1,9435,[ 25 111 191  96 125],618,1,38777,4.109474353539635,0.0,0.0
19436,1,9436,[117  64 273 748 269],416,5,38782,4.109568718872523,20.0,0.0
19437,1,9437,[173   8 588  69 475],601,2,38784,4.109345200254291,0.0,0.0
19438,1,9438,[ 64 483  12 427  11],618,5,38789,4.109439559275347,60.0,0.0
19439,1,9439,[ 64 483  12 427  11],214,5,38794,4.109533898305084,60.0,0.0
19440,1,9440,[ 64 483  12 427  11],618,5,38799,4.109628217349857,60.0,0.0
19441,1,9441,[200 127 176 276   7],416,4,38803,4.109616606651133,0.0,0.0
19442,1,9442,[ 64 483  12 427  11],214,5,38808,4.109710896960712,60.0,0.0
19443,1,9443,[405  50 173   4 174],417,1,38809,4.109381617958492,0.0,20.0
19444,1,9444,[322  97  22 182 211],416,4,38813,4.109370037056644,0.0,0.0
19445,1,9445,[ 64 483  12 427  11],618,5,38818,4.109464323523184,60.0,0.0
19446,1,9446,[515 333  15  50 117],416,5,38823,4.1095585900285805,0.0,20.0
19447,1,9447,[  7 603  96 597 323],805,4,38827,4.1095469940728195,0.0,0.0
19448,1,9448,[ 69 302 118 655 568],416,4,38831,4.109535400571489,0.0,0.0
19449,1,9449,[ 64 483  12 427  11],618,5,38836,4.109629629629629,60.0,0.0
19450,1,9450,[ 64 483  12 427  11],618,5,38841,4.109723838747223,60.0,0.0
19451,1,9451,[ 64 483  12 427  11],214,5,38846,4.109818027930597,60.0,0.0
19452,1,9452,[196 234 168 191 405],416,5,38851,4.109912197186079,0.0,0.0
19453,1,9453,[ 64 483  12 427  11],214,5,38856,4.110006346519992,60.0,0.0
19454,1,9454,[286 173 405 204  12],62,2,38858,4.109783183500793,20.0,0.0
19455,1,9455,[ 64 483  12 427  11],618,5,38863,4.109877326565144,60.0,0.0
19456,1,9456,[ 64 483  12 427  11],214,5,38868,4.109971449719784,60.0,0.0
19457,1,9457,[ 64 483  12 427  11],214,5,38873,4.1100655529710295,60.0,0.0
19458,1,9458,[ 28 269 191 100  97],43,5,38878,4.110159636325193,0.0,0.0
19459,1,9459,[588  98 132 508  69],601,2,38880,4.1099365750528545,0.0,20.0
19460,1,9460,[333 237 181  79  50],588,4,38884,4.1099249550787444,0.0,40.0
19461,1,9461,[ 64 483  12 427  11],214,5,38889,4.11001902346227,60.0,0.0
19462,1,9462,[ 64 483  12 427  11],618,5,38894,4.110113071964493,60.0,0.0
19463,1,9463,[ 64 483  12 427  11],214,5,38899,4.110207100591716,60.0,0.0
19464,1,9464,[ 64 483  12 427  11],618,5,38904,4.110301109350238,60.0,0.0
19465,1,9465,[179 183  88  50 742],805,3,38907,4.1101838157616735,0.0,20.0
19466,1,9466,[ 25 196  89 195 143],297,4,38911,4.11017217703602,0.0,0.0
19467,1,9467,[ 12 273 144 132  22],62,4,38915,4.110160540768906,20.0,0.0
19468,1,9468,[ 64 483  12 427  11],214,5,38920,4.110254514732285,60.0,0.0
19469,1,9469,[200 269 151 100 294],297,2,38922,4.110031678986273,0.0,0.0
19470,1,9470,[197 127 172  89 210],405,4,38926,4.110020061239574,0.0,0.0
19471,1,9471,[ 64 483  12 427  11],618,5,38931,4.11011402027027,60.0,0.0
19472,1,9472,[ 64 483  12 427  11],214,5,38936,4.110207959463739,60.0,0.0
19473,1,9473,[ 64 483  12 427  11],214,5,38941,4.110301878826261,60.0,0.0
19474,1,9474,[ 70   1 172 143  88],128,3,38944,4.110184696569921,0.0,0.0
19475,1,9475,[322 288  79 168 475],854,4,38948,4.110173068805403,0.0,20.0
19476,1,9476,[195  82 748 174 179],198,2,38950,4.1099504062467025,0.0,0.0
19477,1,9477,[ 64 483  12 427  11],618,5,38955,4.110044313146234,60.0,0.0
19478,1,9478,[ 64 483  12 427  11],214,5,38960,4.110138200232092,60.0,0.0
19479,1,9479,[ 64 483  12 427  11],618,5,38965,4.110232067510548,60.0,0.0
19480,1,9480,[ 64 483  12 427  11],214,5,38970,4.110325914987871,60.0,0.0
19481,1,9481,[546 273 678 195  97],297,2,38972,4.1101033537228435,0.0,0.0
19482,1,9482,[ 64 483  12 427  11],618,5,38977,4.110197194980492,60.0,0.0
19483,1,9483,[ 64 483  12 427  11],214,5,38982,4.110291016448755,60.0,0.0
19484,1,9484,[ 28 268 153 118   4],416,4,38986,4.110279388508171,0.0,0.0
19485,1,9485,[ 11  69 127 125 318],618,4,38990,4.110267763019186,20.0,0.0
19486,1,9486,[ 97 655  98 216 300],24,5,38995,4.110361547380626,0.0,20.0
19487,1,9487,[  9 111  50   1 748],805,2,38997,4.110139123102867,0.0,20.0
19488,1,9488,[ 64 483  12 427  11],214,5,39002,4.110232901254084,60.0,0.0
19489,1,9489,[ 64 483  12 427  11],214,5,39007,4.1103266596417285,60.0,0.0
19490,1,9490,[ 98 181 258 168 179],62,5,39012,4.110420398272047,0.0,40.0
19491,1,9491,[ 64 483  12 427  11],618,5,39017,4.110514117151285,60.0,0.0
19492,1,9492,[294 403  82 289 237],721,2,39019,4.110291793953439,0.0,0.0
19493,1,9493,[ 12 117  98 172 427],416,5,39024,4.11038550663577,20.0,20.0
19494,1,9494,[144 427 286  15  56],416,5,39029,4.110479199578726,0.0,0.0
19495,1,9495,[ 64 483  12 427  11],618,5,39034,4.110572872788542,60.0,0.0
19496,1,9496,[175 222 237  89   7],198,2,39036,4.110350637043277,0.0,0.0
19497,1,9497,[237 275 742  89 118],764,3,39039,4.110233733417561,0.0,0.0
19498,1,9498,[328  28 175 597 151],43,3,39042,4.110116854405727,0.0,0.0
19499,1,9499,[182 117 185   1 300],198,2,39044,4.109894736842105,0.0,0.0
19500,1,9500,[483 257 196  82 176],601,1,39045,4.109567413956426,20.0,0.0
19501,1,9501,[ 64 483  12 427  11],214,5,39050,4.1096611239739005,60.0,0.0
19502,1,9502,[215 211 435 515 200],405,1,39051,4.1093338945596125,0.0,0.0
19503,1,9503,[215  64 228 183 200],198,4,39055,4.109322390572391,20.0,0.0
19504,1,9504,[ 15 328 125 237 405],62,1,39056,4.108995265649658,0.0,0.0
19505,1,9505,[ 64 483  12 427  11],214,5,39061,4.109088996423312,60.0,0.0
19506,1,9506,[196 237 182 153 276],437,4,39065,4.109077521826023,0.0,0.0
19507,1,9507,[168  97 181 204 196],297,4,39069,4.109066049642406,0.0,20.0
19508,1,9508,[  4 257 182 144 179],416,3,39072,4.108949416342412,0.0,0.0
19509,1,9509,[143 234 121 405 168],230,5,39077,4.109043112513144,0.0,0.0
19510,1,9510,[ 64 483  12 427  11],214,5,39082,4.109136788981179,60.0,0.0
19511,1,9511,[235 742 183 182 127],416,4,39086,4.109125315391085,0.0,0.0
19512,1,9512,[273 238 191 185  70],417,3,39089,4.109008724902765,0.0,0.0
19513,1,9513,[181 182 202 546  22],297,2,39091,4.108787050662182,0.0,20.0
19514,1,9514,[ 12 204 286 196 238],437,4,39095,4.108775617446137,20.0,0.0
19515,1,9515,[ 56 100 111  15 222],764,5,39100,4.108869272803699,0.0,0.0
19516,1,9516,[168 181 238   9 318],43,4,39104,4.108857833350846,20.0,20.0
19517,1,9517,[ 64 483  12 427  11],618,5,39109,4.108951460390839,60.0,0.0
19518,1,9518,[197 121 333 273 258],854,3,39112,4.108834961655636,0.0,0.0
19519,1,9519,[427  70 196 151 172],373,5,39117,4.108928571428572,0.0,0.0
19520,1,9520,[117 196 289 257  69],416,3,39120,4.108812099569373,0.0,0.0
19521,1,9521,[ 64 483  12 427  11],618,5,39125,4.108905692081495,60.0,0.0
19522,1,9522,[742  25 111 118   4],345,3,39128,4.108789247086002,0.0,0.0
19523,1,9523,[175 216  69 174 161],43,4,39132,4.108777824443511,0.0,0.0
19524,1,9524,[ 82 132 197 313  97],405,4,39136,4.108766404199475,20.0,20.0
19525,1,9525,[748 258 117   9 191],345,4,39140,4.108754986353139,0.0,0.0
19526,1,9526,[202 111   7 200 237],764,5,39145,4.108848535740527,0.0,0.0
19527,1,9527,[127 200 216 100 385],618,4,39149,4.108837111670865,0.0,0.0
19528,1,9528,[222 202 483 300 168],253,4,39153,4.108825689998951,20.0,0.0
19529,1,9529,[288  82 403 121 508],417,2,39155,4.1086044071353625,0.0,20.0
19530,1,9530,[ 64 483  12 427  11],214,5,39160,4.108697933060539,60.0,0.0
19531,1,9531,[  4 234 175 210 197],297,2,39162,4.108476710029374,0.0,0.0
19532,1,9532,[ 64 483  12 427  11],618,5,39167,4.108570229728312,60.0,0.0
19533,1,9533,[ 28 286 323   1 405],223,2,39169,4.108349066498846,0.0,0.0
19534,1,9534,[ 28   1 300 202  56],751,3,39172,4.108232826428946,0.0,0.0
19535,1,9535,[ 64 483  12 427  11],618,5,39177,4.108326342281879,60.0,0.0
19536,1,9536,[111 183 151 234 195],437,2,39179,4.10810527419524,0.0,0.0
19537,1,9537,[235 269 301 197  96],416,4,39183,4.108093940029356,0.0,0.0
19538,1,9538,[ 50 181 655   4 174],345,5,39188,4.108187441031554,0.0,40.0
19539,1,9539,[  1  96 196 127 238],417,4,39192,4.108176100628931,0.0,0.0
19540,1,9540,[ 64 483  12 427  11],618,5,39197,4.108269573419977,60.0,0.0
19541,1,9541,[168 483 215  98 265],588,4,39201,4.1082582267868375,20.0,20.0
19542,1,9542,[ 64 483  12 427  11],214,5,39206,4.108351671382165,60.0,0.0
19543,1,9543,[ 64 483  12 427  11],618,5,39211,4.108445096395641,60.0,0.0
19544,1,9544,[ 64 483  12 427  11],214,5,39216,4.10853850183342,60.0,0.0
19545,1,9545,[328 423 121 202 143],49,0,39216,4.108108108108108,0.0,0.0
19546,1,9546,[ 64 483  12 427  11],214,5,39221,4.108201529276212,60.0,0.0
19547,1,9547,[ 64 483  12 427  11],214,5,39226,4.108294930875576,60.0,0.0
19548,1,9548,[168 210  98 655 288],618,3,39229,4.108178866897057,0.0,40.0
19549,1,9549,[ 64 483  12 427  11],214,5,39234,4.1082722513089,60.0,0.0
19550,1,9550,[186  82 222 568  69],711,0,39234,4.107842110773741,0.0,0.0
19551,1,9551,[ 82 385 151 143  79],654,5,39239,4.107935510887772,0.0,0.0
19552,1,9552,[269 271 385 318  50],43,4,39243,4.107924212289333,20.0,20.0
19553,1,9553,[186  71 357 161 180],373,4,39247,4.107912916056102,0.0,0.0
19554,1,9554,[  4   8 187 496 237],618,3,39250,4.107796964939822,0.0,0.0
19555,1,9555,[405  88 143  96 173],751,4,39254,4.107785684386773,0.0,0.0
19556,1,9556,[302  12   1 357  71],416,5,39259,4.107879041540232,20.0,0.0
19557,1,9557,[ 70 216  71 405 423],43,5,39264,4.10797237915882,0.0,0.0
19558,1,9558,[ 97 678 215  12 655],416,4,39268,4.107961083795376,20.0,0.0
19559,1,9559,[ 64 483  12 427  11],214,5,39273,4.108054393305439,60.0,0.0
19560,1,9560,[ 64 483  12 427  11],214,5,39278,4.1081476832967265,60.0,0.0
19561,1,9561,[118 195 168  95 318],198,2,39280,4.10792721188036,20.0,0.0
19562,1,9562,[ 64 483  12 427  11],214,5,39285,4.108020495660358,60.0,0.0
19563,1,9563,[ 64 483  12 427  11],214,5,39290,4.108113759933082,60.0,0.0
19564,1,9564,[ 64 483  12 427  11],214,5,39295,4.108207004704652,60.0,0.0
19565,1,9565,[475 748 357 151 144],417,4,39299,4.108195693079657,0.0,0.0
19566,1,9566,[ 64 483  12 427  11],618,5,39304,4.108288909794084,60.0,0.0
19567,1,9567,[ 64 483  12 427  11],618,5,39309,4.108382107023411,60.0,0.0
19568,1,9568,[ 64 483  12 427  11],214,5,39314,4.108475284773749,60.0,0.0
19569,1,9569,[  8 195  71 237 234],618,3,39317,4.108359456635319,0.0,0.0
19570,1,9570,[515 173  28  70 546],416,4,39321,4.108348134991119,0.0,0.0
19571,1,9571,[ 64 483  12 427  11],618,5,39326,4.108441287087338,60.0,0.0
19572,1,9572,[ 50 423  28 496  25],698,1,39327,4.108116577875275,0.0,20.0
19573,1,9573,[ 64 483  12 427  11],214,5,39332,4.108209734698141,60.0,0.0
19574,1,9574,[ 64 483  12 427  11],214,5,39337,4.108302872062663,60.0,0.0
19575,1,9575,[200 234 515 597  79],417,3,39340,4.108187134502924,0.0,0.0
19576,1,9576,[265 237 238 423  12],654,5,39345,4.10828025477707,20.0,0.0
19577,1,9577,[405  64   7 301 234],416,5,39350,4.108373355606599,20.0,0.0
19578,1,9578,[ 64 483  12 427  11],618,5,39355,4.108466436997599,60.0,0.0
19579,1,9579,[  1 180 405 238 135],805,3,39358,4.108350730688935,0.0,0.0
19580,1,9580,[286 475 144 100   1],62,2,39360,4.108130675294855,0.0,0.0
19581,1,9581,[151 273 385 172 234],417,3,39363,4.108015028177833,0.0,0.0
19582,1,9582,[ 69  89  56 515  98],417,4,39367,4.108003756652406,0.0,20.0
19583,1,9583,[ 64 483  12 427  11],618,5,39372,4.108096828046745,60.0,0.0
19584,1,9584,[ 64 483  12 427  11],214,5,39377,4.108189880020866,60.0,0.0
19585,1,9585,[603  69 748 475 210],297,3,39380,4.108074274984352,0.0,0.0
19586,1,9586,[ 64 483  12 427  11],214,5,39385,4.108167309898821,60.0,0.0
19587,1,9587,[ 64 483  12 427  11],214,5,39390,4.108260325406758,60.0,0.0
19588,1,9588,[216   8 135 194 215],405,3,39393,4.108144749191783,0.0,0.0
19589,1,9589,[ 64 483  12 427  11],618,5,39398,4.108237747653806,60.0,0.0
19590,1,9590,[ 64 483  12 427  11],214,5,39403,4.108330726722969,60.0,0.0
19591,1,9591,[508 100 294 216 302],417,1,39404,4.108006672226856,0.0,0.0
19592,1,9592,[173 215   8 678  25],921,3,39407,4.107891170645262,0.0,0.0
19593,1,9593,[ 64 483  12 427  11],618,5,39412,4.107984156764645,60.0,0.0
19594,1,9594,[  4 286  98  12 258],854,3,39415,4.1078686816050025,20.0,20.0
19595,1,9595,[ 64 483  12 427  11],214,5,39420,4.107961650687787,60.0,0.0
19596,1,9596,[ 64 483  12 427  11],618,5,39425,4.108054600395957,60.0,0.0
19597,1,9597,[ 64 483  12 427  11],618,5,39430,4.10814753073557,60.0,0.0
19598,1,9598,[ 50 235 211 294 588],43,4,39434,4.1081362641941865,0.0,20.0
19599,1,9599,[ 64 483  12 427  11],618,5,39439,4.108229166666667,60.0,0.0
19600,1,9600,[125 117 195 288  69],417,3,39442,4.108113738152276,0.0,20.0
19601,1,9601,[ 64 483  12 427  11],618,5,39447,4.108206623620079,60.0,0.0
19602,1,9602,[ 64 483  12 427  11],214,5,39452,4.108299489742789,60.0,0.0
19603,1,9603,[222  64  70 423 300],128,3,39455,4.108184089962515,20.0,0.0
19604,1,9604,[ 64 483  12 427  11],214,5,39460,4.108276939094222,60.0,0.0
19605,1,9605,[ 64 483  12 427  11],214,5,39465,4.108369768894441,60.0,0.0
19606,1,9606,[ 64 483  12 427  11],214,5,39470,4.10846257936921,60.0,0.0
19607,1,9607,[204  69  50 187  97],505,1,39471,4.108139050791007,0.0,20.0
19608,1,9608,[655 483 168 216 276],354,2,39473,4.107919658653346,20.0,0.0
19609,1,9609,[ 64 483  12 427  11],214,5,39478,4.108012486992716,60.0,0.0
19610,1,9610,[ 15 144 423  56 385],43,5,39483,4.108105296014982,0.0,0.0
19611,1,9611,[ 64 483  12 427  11],214,5,39488,4.108198085726175,60.0,0.0
19612,1,9612,[ 50 111  79 288 235],805,2,39490,4.1079787787371265,0.0,40.0
19613,1,9613,[ 64 483  12 427  11],214,5,39495,4.108071562304972,60.0,0.0
19614,1,9614,[ 64 483  12 427  11],618,5,39500,4.108164326573063,60.0,0.0
19615,1,9615,[ 64 483  12 427  11],214,5,39505,4.108257071547421,60.0,0.0
19616,1,9616,[ 22 265 200 245 144],416,4,39509,4.10824581470313,0.0,0.0
19617,1,9617,[588  70 276 211  82],230,5,39514,4.108338531919318,0.0,0.0
19618,1,9618,[ 64 483  12 427  11],618,5,39519,4.108431229857573,60.0,0.0
19619,1,9619,[ 56 216   4 180 323],198,2,39521,4.108212058212058,0.0,0.0
19620,1,9620,[  4  95 742 357 176],417,3,39524,4.108096871427087,0.0,0.0
19621,1,9621,[ 64 483  12 427  11],618,5,39529,4.108189565578882,60.0,0.0
19622,1,9622,[ 64 483  12 427  11],618,5,39534,4.1082822404655515,60.0,0.0
19623,1,9623,[  1 322 185 265 210],416,4,39538,4.108270989193683,0.0,0.0
19624,1,9624,[ 64 483  12 427  11],214,5,39543,4.108363636363636,60.0,0.0
19625,1,9625,[ 64 483  12 427  11],214,5,39548,4.10845626428423,60.0,0.0
19626,1,9626,[742 301 471 546 568],416,4,39552,4.1084449984418825,0.0,0.0
19627,1,9627,[ 64 483  12 427  11],214,5,39557,4.108537598670544,60.0,0.0
19628,1,9628,[ 64 483  12 427  11],214,5,39562,4.108630179665593,60.0,0.0
19629,1,9629,[ 64 483  12 427  11],214,5,39567,4.108722741433022,60.0,0.0
19630,1,9630,[ 64 483  12 427  11],214,5,39572,4.108815283978818,60.0,0.0
19631,1,9631,[174 289 151  88  11],345,4,39576,4.108803986710964,0.0,0.0
19632,1,9632,[ 97 151   7 276 245],416,2,39578,4.108585072147825,0.0,0.0
19633,1,9633,[ 64 483  12 427  11],214,5,39583,4.108677600166079,60.0,0.0
19634,1,9634,[588 273 196  89 257],417,2,39585,4.10845874416191,0.0,0.0
19635,1,9635,[ 64 483  12 427  11],214,5,39590,4.108551266085513,60.0,0.0
19636,1,9636,[475 258 748 196 237],297,4,39594,4.108540002075334,0.0,0.0
19637,1,9637,[100  15  11 294 175],43,4,39598,4.108528740402573,0.0,0.0
19638,1,9638,[300  70 515 423 182],297,2,39600,4.1083099906629315,0.0,0.0
19639,1,9639,[175 127 111 216 204],43,4,39604,4.108298755186722,0.0,0.0
19640,1,9640,[216  79 204 100 313],588,4,39608,4.108287522041282,20.0,20.0
19641,1,9641,[ 64 483  12 427  11],214,5,39613,4.108380004148517,60.0,0.0
19642,1,9642,[187 135 100 204 234],618,4,39617,4.108368764907187,0.0,0.0
19643,1,9643,[ 64 483  12 427  11],618,5,39622,4.108461219411033,60.0,0.0
19644,1,9644,[288  12   8 300 118],297,2,39624,4.108242612752721,20.0,20.0
19645,1,9645,[111 597  28 568  56],887,4,39628,4.108231391250259,0.0,0.0
19646,1,9646,[ 79 117  69 144 568],373,4,39632,4.10822017207422,0.0,0.0
19647,1,9647,[ 79 132 237 322  69],921,2,39634,4.108001658374793,0.0,0.0
19648,1,9648,[ 64 483  12 427  11],618,5,39639,4.108094103015857,60.0,0.0
19649,1,9649,[ 15 508 748 195 144],654,3,39642,4.107979274611399,0.0,0.0
19650,1,9650,[ 64 483  12 427  11],618,5,39647,4.108071702414257,60.0,0.0
19651,1,9651,[215 172 288 276 111],437,2,39649,4.107853294653958,0.0,20.0
19652,1,9652,[ 64 483  12 427  11],618,5,39654,4.107945716357609,60.0,0.0
19653,1,9653,[ 64 483  12 427  11],214,5,39659,4.10803811891444,60.0,0.0
19654,1,9654,[ 64 483  12 427  11],214,5,39664,4.108130502330399,60.0,0.0
19655,1,9655,[ 64 483  12 427  11],618,5,39669,4.108222866611433,60.0,0.0
19656,1,9656,[ 64 483  12 427  11],214,5,39674,4.108315211763488,60.0,0.0
19657,1,9657,[ 64 483  12 427  11],214,5,39679,4.108407537792504,60.0,0.0
19658,1,9658,[ 69 168 245  97   4],62,3,39682,4.108292783932084,0.0,0.0
19659,1,9659,[211  89 200 151 118],417,5,39687,4.108385093167702,0.0,0.0
19660,1,9660,[ 64 483  12 427  11],214,5,39692,4.108477383293655,60.0,0.0
19661,1,9661,[191 183 496 655 235],417,3,39695,4.1083626578348165,0.0,0.0
19662,1,9662,[181  98 483 174 182],417,3,39698,4.1082479561212875,20.0,40.0
19663,1,9663,[132 403 405  89 143],642,2,39700,4.108029801324503,0.0,0.0
19664,1,9664,[ 64 483  12 427  11],618,5,39705,4.10812209001552,60.0,0.0
19665,1,9665,[237 180 271  12 111],62,2,39707,4.107903993378854,20.0,0.0
19666,1,9666,[276  95 117 151 385],198,1,39708,4.107582497155271,0.0,0.0
19667,1,9667,[588 265 238 269 195],297,3,39711,4.107467935457178,0.0,0.0
19668,1,9668,[191 245 603 204   7],416,4,39715,4.107456820767401,0.0,0.0
19669,1,9669,[ 64 483  12 427  11],214,5,39720,4.107549120992761,60.0,0.0
19670,1,9670,[357   4  22 423  70],373,4,39724,4.107538000206804,0.0,0.0
19671,1,9671,[275 135 322 117 273],854,3,39727,4.1074234904880065,0.0,0.0
19672,1,9672,[ 64 483  12 427  11],214,5,39732,4.107515765532927,60.0,0.0
19673,1,9673,[202 322 173 427 508],128,3,39735,4.107401281786231,0.0,0.0
19674,1,9674,[ 70 742 269  71  96],416,5,39740,4.10749354005168,0.0,0.0
19675,1,9675,[269 403   8 294 185],416,5,39745,4.107585779247623,0.0,0.0
19676,1,9676,[ 28 132  12 742  22],314,5,39750,4.107677999379973,20.0,0.0
19677,1,9677,[ 64 483  12 427  11],618,5,39755,4.107770200454639,60.0,0.0
19678,1,9678,[ 64 483  12 427  11],618,5,39760,4.107862382477529,60.0,0.0
19679,1,9679,[127  96 276  79 282],416,4,39764,4.107851239669421,0.0,0.0
19680,1,9680,[125 210  56 742 678],345,3,39767,4.107736804049169,0.0,0.0
19681,1,9681,[ 64 483  12 427  11],618,5,39772,4.1078289609584795,60.0,0.0
19682,1,9682,[ 64 483  12 427  11],618,5,39777,4.107921098833006,60.0,0.0
19683,1,9683,[ 71 238  12  79 403],345,3,39780,4.107806691449814,20.0,0.0
19684,1,9684,[ 64 483  12 427  11],618,5,39785,4.107898812596799,60.0,0.0
19685,1,9685,[121 195  69  28 748],654,5,39790,4.107990914722279,0.0,0.0
19686,1,9686,[ 64 483  12 427  11],214,5,39795,4.108082997832146,60.0,0.0
19687,1,9687,[318 196  82  56  50],62,5,39800,4.108175061932287,20.0,20.0
19688,1,9688,[228 132 268 322  71],128,1,39801,4.107854267726288,0.0,0.0
19689,1,9689,[ 97 135 405   9 144],62,2,39803,4.107636738906089,0.0,0.0
19690,1,9690,[ 64 483  12 427  11],214,5,39808,4.107728820555154,60.0,0.0
19691,1,9691,[179 322 742  96  12],417,2,39810,4.107511349566653,20.0,0.0
19692,1,9692,[286 385 275   7  15],43,5,39815,4.107603425152171,0.0,0.0
19693,1,9693,[ 64 483  12 427  11],214,5,39820,4.107695481741283,60.0,0.0
19694,1,9694,[127 222  11 288   4],805,1,39821,4.10737493553378,0.0,20.0
19695,1,9695,[ 64 483  12 427  11],214,5,39826,4.10746699669967,60.0,0.0
19696,1,9696,[182 210 151 423  50],297,2,39828,4.107249664844797,0.0,20.0
19697,1,9697,[302  69 588  70  56],345,4,39832,4.107238605898123,0.0,0.0
19698,1,9698,[ 64 483  12 427  11],214,5,39837,4.1073306526446025,60.0,0.0
19699,1,9699,[ 64 483  12 427  11],214,5,39842,4.1074226804123715,60.0,0.0
19700,1,9700,[269 153 313  71   4],43,5,39847,4.1075146892072985,20.0,20.0
19701,1,9701,[ 64 483  12 427  11],214,5,39852,4.107606679035251,60.0,0.0
19702,1,9702,[ 64 483  12 427  11],214,5,39857,4.107698649902092,60.0,0.0
19703,1,9703,[ 64 483  12 427  11],618,5,39862,4.107790601813685,60.0,0.0
19704,1,9704,[ 64 483  12 427  11],214,5,39867,4.1078825347758885,60.0,0.0
19705,1,9705,[  7 238 111  89  98],297,4,39871,4.107871419740367,0.0,20.0
19706,1,9706,[655 194 216 143  82],373,3,39874,4.107757288554652,0.0,0.0
19707,1,9707,[318 191  88 216 132],405,3,39877,4.107643180881747,20.0,0.0
19708,1,9708,[  4  97 475 181 357],416,4,39881,4.107632093933463,0.0,20.0
19709,1,9709,[ 64 483  12 427  11],214,5,39886,4.107723995880535,60.0,0.0
19710,1,9710,[ 50  97 588 275 471],128,4,39890,4.107712902893626,0.0,20.0
19711,1,9711,[ 64 483  12 427  11],214,5,39895,4.107804777594728,60.0,0.0
19712,1,9712,[ 8 71 88 79 98],43,5,39900,4.107896633377947,0.0,20.0
19713,1,9713,[597  79 318 275 174],854,3,39903,4.107782581840643,20.0,0.0
19714,1,9714,[ 64 483  12 427  11],618,5,39908,4.107874420998456,60.0,0.0
19715,1,9715,[423 655 237 117 100],437,4,39912,4.107863318237958,0.0,0.0
19716,1,9716,[ 64 483  12 427  11],618,5,39917,4.107955130184213,60.0,0.0
19717,1,9717,[385 186 153 202  70],43,4,39921,4.107944021403581,0.0,0.0
19718,1,9718,[ 64 483  12 427  11],214,5,39926,4.1080358061528965,60.0,0.0
19719,1,9719,[ 64 483  12 427  11],214,5,39931,4.1081275720164605,60.0,0.0
19720,1,9720,[ 64 483  12 427  11],214,5,39936,4.108219319000103,60.0,0.0
19721,1,9721,[228 168 182 568 161],405,1,39937,4.1078996091339235,0.0,0.0
19722,1,9722,[ 71 301   4  70 328],416,5,39942,4.107991360691145,0.0,0.0
19723,1,9723,[  4 175 322 268 328],854,1,39943,4.107671740024681,0.0,0.0
19724,1,9724,[ 64 483  12 427  11],214,5,39948,4.107763496143959,60.0,0.0
19725,1,9725,[496 603 100 748 655],437,5,39953,4.107855233395024,0.0,0.0
19726,1,9726,[ 64 483  12 427  11],618,5,39958,4.107946951783695,60.0,0.0
19727,1,9727,[ 82 179 172 210 176],62,5,39963,4.108038651315789,0.0,0.0
19728,1,9728,[ 64 483  12 427  11],214,5,39968,4.108130331997122,60.0,0.0
19729,1,9729,[235 546 204 135 127],62,4,39972,4.108119218910586,0.0,0.0
19730,1,9730,[174  88 318 515 143],354,2,39974,4.1079025793854695,20.0,0.0
19731,1,9731,[161 742 235  28 173],416,4,39978,4.107891491985203,0.0,0.0
19732,1,9732,[328  98  69 508 588],128,4,39982,4.107880406863249,0.0,20.0
19733,1,9733,[ 64 483  12 427  11],214,5,39987,4.107972056708444,60.0,0.0
19734,1,9734,[204 132 216  50  12],373,4,39991,4.107960965588084,20.0,20.0
19735,1,9735,[143  98 300 265  64],416,5,39996,4.108052588331963,20.0,20.0
19736,1,9736,[117 276 237 435  69],437,2,39998,4.1078360891445005,0.0,0.0
19737,1,9737,[ 64 483  12 427  11],214,5,40003,4.107927705894435,60.0,0.0
19738,1,9738,[176 200 117 135 118],297,3,40006,4.107813943936749,0.0,0.0
19739,1,9739,[ 64 483  12 427  11],214,5,40011,4.107905544147844,60.0,0.0
19740,1,9740,[ 64 483  12 427  11],618,5,40016,4.107997125551791,60.0,0.0
19741,1,9741,[258 655 471  28 191],721,2,40018,4.107780743173886,0.0,0.0
19742,1,9742,[ 64 483  12 427  11],214,5,40023,4.107872318587704,60.0,0.0
19743,1,9743,[ 64 483  12 427  11],214,5,40028,4.107963875205255,60.0,0.0
19744,1,9744,[ 64 483  12 427  11],618,5,40033,4.108055413032324,60.0,0.0
19745,1,9745,[ 64 483  12 427  11],618,5,40038,4.108146932074697,60.0,0.0
19746,1,9746,[100 405  69   7 204],198,2,40040,4.107930645326767,0.0,0.0
19747,1,9747,[132 423 282  28 182],618,4,40044,4.107919573245794,0.0,0.0
19748,1,9748,[202 191   4 273 176],416,5,40049,4.108011078059288,0.0,0.0
19749,1,9749,[ 64 483  12 427  11],214,5,40054,4.108102564102564,60.0,0.0
19750,1,9750,[ 71 265 161  79 118],588,4,40058,4.108091477797149,0.0,0.0
19751,1,9751,[ 64 483  12 427  11],214,5,40063,4.10818293683347,60.0,0.0
19752,1,9752,[ 64 483  12 427  11],618,5,40068,4.108274377114734,60.0,0.0
19753,1,9753,[496 215  97 273 168],618,5,40073,4.108365798646709,0.0,0.0
19754,1,9754,[ 64 483  12 427  11],618,5,40078,4.1084572014351615,60.0,0.0
19755,1,9755,[ 64 483  12 427  11],214,5,40083,4.108548585485855,60.0,0.0
19756,1,9756,[403 257  89 748 210],417,3,40086,4.108434969765296,0.0,0.0
19757,1,9757,[ 64 483  12 427  11],618,5,40091,4.108526337364214,60.0,0.0
19758,1,9758,[ 64 483  12 427  11],214,5,40096,4.108617686238344,60.0,0.0
19759,1,9759,[286 180   1 273  56],854,3,40099,4.1085040983606556,0.0,0.0
19760,1,9760,[257 403 405 173 135],62,3,40102,4.108390533756787,0.0,0.0
19761,1,9761,[173 655 197 161 132],373,3,40105,4.1082769924195865,0.0,0.0
19762,1,9762,[289 143 245 100 405],764,5,40110,4.108368329406945,0.0,0.0
19763,1,9763,[ 64 483  12 427  11],618,5,40115,4.1084596476853745,60.0,0.0
19764,1,9764,[ 64 483  12 427  11],618,5,40120,4.108550947260625,60.0,0.0
19765,1,9765,[  7   8 385 172  56],887,5,40125,4.108642228138439,0.0,0.0
19766,1,9766,[ 64 483  12 427  11],618,5,40130,4.108733490324562,60.0,0.0
19767,1,9767,[ 64 483  12 427  11],618,5,40135,4.108824733824734,60.0,0.0
19768,1,9768,[ 64 483  12 427  11],214,5,40140,4.108915958644692,60.0,0.0
19769,1,9769,[202 118 181 144 655],751,3,40143,4.108802456499488,0.0,20.0
19770,1,9770,[ 64 483  12 427  11],214,5,40148,4.108893664926824,60.0,0.0
19771,1,9771,[118 235  11 588 273],297,3,40151,4.108780188293082,0.0,0.0
19772,1,9772,[174 313 125 588 185],416,5,40156,4.108871380333572,20.0,20.0
19773,1,9773,[ 64 483  12 427  11],618,5,40161,4.108962553713935,60.0,0.0
19774,1,9774,[ 64 483  12 427  11],618,5,40166,4.109053708439897,60.0,0.0
19775,1,9775,[ 79 121 176 265 471],416,5,40171,4.109144844517185,0.0,0.0
19776,1,9776,[288  95  11 111   9],314,5,40176,4.109235961951519,0.0,20.0
19777,1,9777,[ 50 117 405 194 403],416,5,40181,4.109327060748619,0.0,20.0
19778,1,9778,[238  96  97 151 100],373,3,40184,4.109213621024645,0.0,0.0
19779,1,9779,[ 64 483  12 427  11],618,5,40189,4.109304703476482,60.0,0.0
19780,1,9780,[ 15   4  69 117 237],654,4,40193,4.109293528269093,0.0,0.0
19781,1,9781,[185 257 496 168   8],214,3,40196,4.109180126763443,0.0,0.0
19782,1,9782,[ 64 483  12 427  11],618,5,40201,4.1092711847081675,60.0,0.0
19783,1,9783,[ 64 483  12 427  11],214,5,40206,4.109362224039248,60.0,0.0
19784,1,9784,[568  71 185 161 172],618,5,40211,4.109453244762391,0.0,0.0
19785,1,9785,[ 64 483  12 427  11],618,5,40216,4.109544246883303,60.0,0.0
19786,1,9786,[ 64 483  12 427  11],618,5,40221,4.109635230407684,60.0,0.0
19787,1,9787,[ 89 258 174 153  82],198,4,40225,4.1096240294237845,0.0,0.0
19788,1,9788,[181 282 471 748 143],297,2,40227,4.1094085197670855,0.0,20.0
19789,1,9789,[ 64 483  12 427  11],618,5,40232,4.1094994892747705,60.0,0.0
19790,1,9790,[181 276  70 405 153],654,3,40235,4.109386170973343,0.0,20.0
19791,1,9791,[161 273 423   4 194],416,5,40240,4.109477124183006,0.0,0.0
19792,1,9792,[ 98 196 100 603 257],416,4,40244,4.1094659450628,0.0,20.0
19793,1,9793,[202   4 204  28  56],642,3,40247,4.109352664896876,0.0,0.0
19794,1,9794,[  4 294  89 194  25],854,1,40248,4.109035222052067,0.0,0.0
19795,1,9795,[ 64 483  12 427  11],618,5,40253,4.1091261739485505,60.0,0.0
19796,1,9796,[144 173  96  95 151],505,2,40255,4.108910891089109,0.0,0.0
19797,1,9797,[ 22 194  50 183 210],405,3,40258,4.108797713819147,0.0,20.0
19798,1,9798,[196 118 197 216 117],805,1,40259,4.1084804571895095,0.0,0.0
19799,1,9799,[202 234 237 275 357],297,3,40262,4.108367346938776,0.0,0.0
19800,1,9800,[197 127 143 195 118],198,2,40264,4.10815222936435,0.0,0.0
19801,1,9801,[168 216 183  56  71],230,3,40267,4.108039175678433,0.0,0.0
19802,1,9802,[ 64 483  12 427  11],214,5,40272,4.108130164235438,60.0,0.0
19803,1,9803,[357 191 174 302 427],405,5,40277,4.108221134230926,0.0,0.0
19804,1,9804,[215  97 265   8 294],416,5,40282,4.108312085670576,0.0,0.0
19805,1,9805,[135  89 265 196 173],405,2,40284,4.108097083418316,0.0,0.0
19806,1,9806,[ 64 483  12 427  11],618,5,40289,4.108188028958907,60.0,0.0
19807,1,9807,[ 64 483  12 427  11],214,5,40294,4.108278955954323,60.0,0.0
19808,1,9808,[ 64 483  12 427  11],214,5,40299,4.1083698644102356,60.0,0.0
19809,1,9809,[ 64  88  25 161 496],43,5,40304,4.108460754332314,20.0,0.0
19810,1,9810,[ 64 483  12 427  11],214,5,40309,4.108551625726226,60.0,0.0
19811,1,9811,[ 89 288 357 144 173],805,3,40312,4.108438646555238,0.0,20.0
19812,1,9812,[ 64 483  12 427  11],618,5,40317,4.108529501681443,60.0,0.0
19813,1,9813,[ 64 483  12 427  11],214,5,40322,4.108620338292235,60.0,0.0
19814,1,9814,[265 176 568 423 237],505,4,40326,4.108609271523179,0.0,0.0
19815,1,9815,[ 11 176   4 245 125],417,4,40330,4.108598207008965,0.0,0.0
19816,1,9816,[ 64 483  12 427  11],618,5,40335,4.108689008862178,60.0,0.0
19817,1,9817,[  8 153  97 135   4],297,4,40339,4.1086779384803425,0.0,0.0
19818,1,9818,[185   7  96  50 603],805,5,40344,4.108768713718301,0.0,20.0
19819,1,9819,[  1 245 183 405 135],62,2,40346,4.108553971486762,0.0,0.0
19820,1,9820,[ 64 483  12 427  11],214,5,40351,4.108644740861419,60.0,0.0
19821,1,9821,[238 603 174 435  28],373,4,40355,4.108633679495012,0.0,0.0
19822,1,9822,[ 64 483  12 427  11],618,5,40360,4.108724422274254,60.0,0.0
19823,1,9823,[568 172  95 257  28],698,1,40361,4.108407980456026,0.0,0.0
19824,1,9824,[ 64 483  12 427  11],618,5,40366,4.108498727735369,60.0,0.0
19825,1,9825,[ 64 483  12 427  11],618,5,40371,4.108589456543863,60.0,0.0
19826,1,9826,[173 235 403 181 182],416,4,40375,4.108578406431261,0.0,20.0
19827,1,9827,[ 98  22  95 269 228],711,4,40379,4.108567358567359,0.0,20.0
19828,1,9828,[ 64 483  12 427  11],214,5,40384,4.10865805270119,60.0,0.0
19829,1,9829,[ 64 483  12 427  11],618,5,40389,4.108748728382502,60.0,0.0
19830,1,9830,[121 168 186 222 483],128,4,40393,4.108737666564948,20.0,0.0
19831,1,9831,[ 50 161 100 269  96],416,5,40398,4.108828315703824,0.0,20.0
19832,1,9832,[568 423 282 183 127],416,5,40403,4.1089189464049625,0.0,0.0
19833,1,9833,[ 64 483  12 427  11],618,5,40408,4.109009558673988,60.0,0.0
19834,1,9834,[678 483  56 202 301],588,3,40411,4.108896797153025,20.0,0.0
19835,1,9835,[ 28 300 275 173  98],654,5,40416,4.108987393249288,0.0,20.0
19836,1,9836,[ 64 483  12 427  11],618,5,40421,4.109077970926095,60.0,0.0
19837,1,9837,[ 64 483  12 427  11],618,5,40426,4.109168530189063,60.0,0.0
19838,1,9838,[151 161 168 211 302],416,4,40430,4.109157434698648,0.0,0.0
19839,1,9839,[603   9 483  89 173],354,3,40433,4.109044715447155,20.0,0.0
19840,1,9840,[ 64 483  12 427  11],214,5,40438,4.109135250482675,60.0,0.0
19841,1,9841,[151 135 742 258 202],805,2,40440,4.108920951026215,0.0,0.0
19842,1,9842,[ 64 483  12 427  11],618,5,40445,4.109011480239764,60.0,0.0
19843,1,9843,[ 64 483  12 427  11],214,5,40450,4.109101991060545,60.0,0.0
19844,1,9844,[ 64 483  12 427  11],618,5,40455,4.1091924834941596,60.0,0.0
19845,1,9845,[202 471 211 121 176],416,5,40460,4.1092829575462115,0.0,0.0
19846,1,9846,[ 64 483  12 427  11],618,5,40465,4.109373413222301,60.0,0.0
19847,1,9847,[176 318 678 197 655],416,4,40469,4.109362307067425,20.0,0.0
19848,1,9848,[ 64 483  12 427  11],618,5,40474,4.109452736318408,60.0,0.0
19849,1,9849,[ 64 483  12 427  11],214,5,40479,4.109543147208122,60.0,0.0
19850,1,9850,[ 28 183  89  50  11],496,3,40482,4.109430514668562,0.0,20.0
19851,1,9851,[ 64 483  12 427  11],214,5,40487,4.1095209094600085,60.0,0.0
19852,1,9852,[ 64 483  12 427  11],214,5,40492,4.109611285902771,60.0,0.0
19853,1,9853,[ 64 483  12 427  11],618,5,40497,4.109701644002436,60.0,0.0
19854,1,9854,[ 64 483  12 427  11],214,5,40502,4.109791983764587,60.0,0.0
19855,1,9855,[ 64 483  12 427  11],214,5,40507,4.109882305194805,60.0,0.0
19856,1,9856,[289 135 125   8 194],854,2,40509,4.109668256061682,0.0,0.0
19857,1,9857,[135 228 475 403  95],198,3,40512,4.109555690809495,0.0,0.0
19858,1,9858,[210 181  12 187 423],618,4,40516,4.109544578557663,20.0,20.0
19859,1,9859,[210 322  64 187 323],416,3,40519,4.109432048681541,20.0,0.0
19860,1,9860,[ 25 271 748 121 405],805,1,40520,4.109116722441943,0.0,0.0
19861,1,9861,[357  64 405 742 385],230,4,40524,4.109105658081525,20.0,0.0
19862,1,9862,[ 64 483  12 427  11],618,5,40529,4.1091959849944235,60.0,0.0
19863,1,9863,[200 405  97 289 125],416,4,40533,4.109184914841849,0.0,0.0
19864,1,9864,[ 70   9 403 483 546],62,4,40537,4.109173846933603,20.0,0.0
19865,1,9865,[ 64 483  12 427  11],618,5,40542,4.109264139468883,60.0,0.0
19866,1,9866,[515 276 245 143 655],416,3,40545,4.10915171784737,0.0,0.0
19867,1,9867,[ 64 483  12 427  11],618,5,40550,4.1092419943250915,60.0,0.0
19868,1,9868,[ 15 423 173 483 132],417,5,40555,4.109332252507853,20.0,0.0
19869,1,9869,[ 64 483  12 427  11],618,5,40560,4.109422492401216,60.0,0.0
19870,1,9870,[ 64 483  12 427  11],214,5,40565,4.109512714010738,60.0,0.0
19871,1,9871,[275 153  97 197 127],416,5,40570,4.109602917341977,0.0,0.0
19872,1,9872,[173  82 210 215 328],128,3,40573,4.10949052972754,0.0,0.0
19873,1,9873,[ 64 483  12 427  11],214,5,40578,4.109580717034636,60.0,0.0
19874,1,9874,[125 405  15  50 294],416,5,40583,4.109670886075949,0.0,20.0
19875,1,9875,[181 180 135 216 191],711,5,40588,4.109761036857027,0.0,20.0
19876,1,9876,[ 64 483  12 427  11],618,5,40593,4.109851169383416,60.0,0.0
19877,1,9877,[ 64 483  12 427  11],618,5,40598,4.10994128366066,60.0,0.0
19878,1,9878,[ 64 483  12 427  11],618,5,40603,4.110031379694301,60.0,0.0
19879,1,9879,[ 64 483  12 427  11],214,5,40608,4.110121457489878,60.0,0.0
19880,1,9880,[202 176 234 143 216],437,4,40612,4.1101103127213845,0.0,0.0
19881,1,9881,[ 64 483  12 427  11],214,5,40617,4.110200364298725,60.0,0.0
19882,1,9882,[ 64 483  12 427  11],214,5,40622,4.110290397652535,60.0,0.0
19883,1,9883,[179 195 403 238 117],198,3,40625,4.110178065560502,0.0,0.0
19884,1,9884,[215  71 111 180 132],711,2,40627,4.1099645928174,0.0,0.0
19885,1,9885,[265 215 655  97 313],416,5,40632,4.110054622698766,20.0,20.0
19886,1,9886,[127 435 222 568  89],698,3,40635,4.1099423485384845,0.0,0.0
19887,1,9887,[181  95 172 286  79],705,3,40638,4.109830097087379,0.0,20.0
19888,1,9888,[ 64 483  12 427  11],214,5,40643,4.109920113257155,60.0,0.0
19889,1,9889,[  7 216 238  95 153],230,3,40646,4.1098078867542975,0.0,0.0
19890,1,9890,[ 64 483  12 427  11],618,5,40651,4.109897886967951,60.0,0.0
19891,1,9891,[200  89 222 268  12],417,4,40655,4.109886777193692,20.0,0.0
19892,1,9892,[  8  69 273 271 222],297,3,40658,4.10977458809259,0.0,0.0
19893,1,9893,[ 64 483  12 427  11],214,5,40663,4.109864564382454,60.0,0.0
19894,1,9894,[ 64 483  12 427  11],214,5,40668,4.109954522486104,60.0,0.0
19895,1,9895,[275 333 475 269 237],735,4,40672,4.109943411479386,0.0,0.0
19896,1,9896,[748  71 515 302 655],416,5,40677,4.110033343437405,0.0,0.0
19897,1,9897,[ 64 483  12 427  11],214,5,40682,4.110123257223681,60.0,0.0
19898,1,9898,[ 64 483  12 427  11],214,5,40687,4.110213152843722,60.0,0.0
19899,1,9899,[257 483 143 294  25],698,1,40688,4.10989898989899,20.0,0.0
19900,1,9900,[ 64 483  12 427  11],214,5,40693,4.10998889001111,60.0,0.0
19901,1,9901,[204 258 257 181 111],711,2,40695,4.109775802868107,0.0,20.0
19902,1,9902,[ 64 483  12 427  11],618,5,40700,4.109865697263455,60.0,0.0
19903,1,9903,[ 64 483  12 427  11],214,5,40705,4.109955573505654,60.0,0.0
19904,1,9904,[ 64 483  12 427  11],214,5,40710,4.110045431600202,60.0,0.0
19905,1,9905,[ 64 483  12 427  11],618,5,40715,4.110135271552594,60.0,0.0
19906,1,9906,[748 161 127  71 194],373,4,40719,4.110124154638135,0.0,0.0
19907,1,9907,[ 64 483  12 427  11],618,5,40724,4.110213968510295,60.0,0.0
19908,1,9908,[302 151  28 742  56],416,4,40728,4.1102028458976685,0.0,0.0
19909,1,9909,[294 127 168 186 117],43,4,40732,4.110191725529768,0.0,0.0
19910,1,9910,[ 70 191 117  12 273],62,4,40736,4.110180607405913,20.0,0.0
19911,1,9911,[ 64 483  12 427  11],214,5,40741,4.110270379338176,60.0,0.0
19912,1,9912,[568 289 597 176 228],887,4,40745,4.110259255523051,0.0,0.0
19913,1,9913,[ 64 483  12 427  11],618,5,40750,4.110349001412144,60.0,0.0
19914,1,9914,[ 64 483  12 427  11],618,5,40755,4.110438729198185,60.0,0.0
19915,1,9915,[ 89 237 197 200 111],437,3,40758,4.110326744655103,0.0,0.0
19916,1,9916,[ 64 483  12 427  11],214,5,40763,4.110416456589695,60.0,0.0
19917,1,9917,[121 175 286  28 300],43,4,40767,4.110405323653962,0.0,0.0
19918,1,9918,[127 202 194 294  12],416,5,40772,4.110495009577578,20.0,0.0
19919,1,9919,[ 64 483  12 427  11],618,5,40777,4.110584677419355,60.0,0.0
19920,1,9920,[ 64 483  12 427  11],618,5,40782,4.11067432718476,60.0,0.0
19921,1,9921,[ 64 483  12 427  11],618,5,40787,4.110763958879258,60.0,0.0
19922,1,9922,[143 302 211 111 176],416,5,40792,4.110853572508314,0.0,0.0
19923,1,9923,[385 271 273 204 748],805,0,40792,4.110439338976219,0.0,0.0
19924,1,9924,[ 64 483  12 427  11],618,5,40797,4.110528967254408,60.0,0.0
19925,1,9925,[111 181  25 143   7],751,3,40800,4.110417086439654,0.0,20.0
19926,1,9926,[ 64 483  12 427  11],214,5,40805,4.110506698901984,60.0,0.0
19927,1,9927,[185 357 268 546  89],417,3,40808,4.110394842868654,0.0,0.0
19928,1,9928,[ 64 483  12 427  11],618,5,40813,4.110484439520596,60.0,0.0
19929,1,9929,[ 64 483  12 427  11],214,5,40818,4.110574018126888,60.0,0.0
19930,1,9930,[ 64 483  12 427  11],214,5,40823,4.110663578692981,60.0,0.0
19931,1,9931,[282  22 186  69 161],618,4,40827,4.1106524365686665,0.0,0.0
19932,1,9932,[144 181 286   7 357],297,4,40831,4.110641296687809,0.0,20.0
19933,1,9933,[ 64 483  12 427  11],214,5,40836,4.110730823434669,60.0,0.0
19934,1,9934,[ 64 483  12 427  11],214,5,40841,4.110820332159034,60.0,0.0
19935,1,9935,[ 64 483  12 427  11],618,5,40846,4.110909822866344,60.0,0.0
19936,1,9936,[ 79 121 197 186 118],437,2,40848,4.110697393579551,0.0,0.0
19937,1,9937,[ 64 483  12 427  11],214,5,40853,4.110786878647615,60.0,0.0
19938,1,9938,[ 64 483  12 427  11],618,5,40858,4.1108763457088235,60.0,0.0
19939,1,9939,[ 64 483  12 427  11],618,5,40863,4.110965794768612,60.0,0.0
19940,1,9940,[ 64 483  12 427  11],214,5,40868,4.111055225832411,60.0,0.0
19941,1,9941,[ 82 216  97 357 100],230,5,40873,4.111144638905653,0.0,0.0
19942,1,9942,[ 64 483  12 427  11],618,5,40878,4.111234033993765,60.0,0.0
19943,1,9943,[168 268  22 228  56],297,4,40882,4.111222847948512,0.0,0.0
19944,1,9944,[ 64 483  12 427  11],214,5,40887,4.11131221719457,60.0,0.0
19945,1,9945,[ 64 483  12 427  11],618,5,40892,4.111401568469737,60.0,0.0
19946,1,9946,[ 97 234 100  70 435],437,2,40894,4.11118930330753,0.0,0.0
19947,1,9947,[ 64 483  12 427  11],618,5,40899,4.111278648974668,60.0,0.0
19948,1,9948,[187 405 748 210  82],198,2,40901,4.111066438838074,0.0,0.0
19949,1,9949,[ 64 483  12 427  11],214,5,40906,4.111155778894473,60.0,0.0
19950,1,9950,[185 196  88 403  25],711,5,40911,4.111245100994875,0.0,0.0
19951,1,9951,[ 64 483  12 427  11],618,5,40916,4.111334405144695,60.0,0.0
19952,1,9952,[276  11 496  89  28],764,4,40920,4.11132321912991,0.0,0.0
19953,1,9953,[ 64 483  12 427  11],214,5,40925,4.1114124974884465,60.0,0.0
19954,1,9954,[257 202 151 301 174],297,2,40927,4.111200401808136,0.0,0.0
19955,1,9955,[179 174 483   4 288],417,2,40929,4.110988348734431,20.0,20.0
19956,1,9956,[ 64 483  12 427  11],214,5,40934,4.11107763382545,60.0,0.0
19957,1,9957,[ 15 258  89  98 235],417,4,40938,4.111066479212694,0.0,20.0
19958,1,9958,[ 64 483  12 427  11],214,5,40943,4.111155738527964,60.0,0.0
19959,1,9959,[204 275 313 238   1],416,5,40948,4.111244979919679,20.0,20.0
19960,1,9960,[385 174 515 117  97],417,4,40952,4.111233811866279,0.0,0.0
19961,1,9961,[ 64 483  12 427  11],618,5,40957,4.111323027504517,60.0,0.0
19962,1,9962,[ 64 483  12 427  11],214,5,40962,4.111412225233363,60.0,0.0
19963,1,9963,[655 268 176 385 313],416,5,40967,4.11150140505821,20.0,20.0
19964,1,9964,[ 64 483  12 427  11],214,5,40972,4.111590566984446,60.0,0.0
19965,1,9965,[276 111   4   8 508],654,3,40975,4.1114790286975715,0.0,0.0
19966,1,9966,[ 64 483  12 427  11],214,5,40980,4.1115681749774255,60.0,0.0
19967,1,9967,[174 118 143  25 313],345,3,40983,4.111456661316212,20.0,20.0
19968,1,9968,[ 12 117 100 153 294],43,5,40988,4.111545791955061,20.0,0.0
19969,1,9969,[204  28 403 143  82],373,1,40989,4.11123370110331,0.0,0.0
19970,1,9970,[423  88 161 357 176],416,4,40993,4.111222545381606,0.0,0.0
19971,1,9971,[ 64 483  12 427  11],214,5,40998,4.111311672683514,60.0,0.0
19972,1,9972,[ 50  22 168  95 475],588,4,41002,4.111300511380728,0.0,20.0
19973,1,9973,[ 64 483  12 427  11],214,5,41007,4.111389612993784,60.0,0.0
19974,1,9974,[  7 118 195 282 742],630,4,41011,4.111378446115288,0.0,0.0
19975,1,9975,[ 64 483  12 427  11],214,5,41016,4.111467522052927,60.0,0.0
19976,1,9976,[ 64 483  12 427  11],618,5,41021,4.111556580134309,60.0,0.0
19977,1,9977,[ 64 483  12 427  11],214,5,41026,4.111645620364802,60.0,0.0
19978,1,9978,[ 64 483  12 427  11],618,5,41031,4.1117346427497745,60.0,0.0
19979,1,9979,[ 64 483  12 427  11],618,5,41036,4.111823647294589,60.0,0.0
19980,1,9980,[ 64 483  12 427  11],214,5,41041,4.111912634004609,60.0,0.0
19981,1,9981,[ 64 483  12 427  11],618,5,41046,4.112001602885194,60.0,0.0
19982,1,9982,[ 64 483  12 427  11],214,5,41051,4.112090553941701,60.0,0.0
19983,1,9983,[235 268  98 258 301],297,4,41055,4.112079326923077,0.0,20.0
19984,1,9984,[678 286 294 318   8],588,4,41059,4.11206810215323,20.0,0.0
19985,1,9985,[268 385 655 179  70],417,5,41064,4.112157019827759,0.0,0.0
19986,1,9986,[ 64 483  12 427  11],618,5,41069,4.112245919695605,60.0,0.0
19987,1,9987,[ 64 483  12 427  11],618,5,41074,4.112334801762114,60.0,0.0
19988,1,9988,[508 144 271  69 275],854,4,41078,4.112323555911503,0.0,0.0
19989,1,9989,[294 100 168 603  89],297,4,41082,4.112312312312312,0.0,0.0
19990,1,9990,[235 286  70 100 357],416,4,41086,4.112301070963867,0.0,0.0
19991,1,9991,[ 64 483  12 427  11],618,5,41091,4.112389911929544,60.0,0.0
19992,1,9992,[187  70 234 174 197],416,5,41096,4.11247873511458,0.0,0.0
19993,1,9993,[ 12 403 111  15 174],62,3,41099,4.112367420452271,20.0,0.0
19994,1,9994,[ 64 483  12 427  11],618,5,41104,4.112456228114057,60.0,0.0
19995,1,9995,[191  89 197  70   7],354,4,41108,4.1124449779911965,0.0,0.0
19996,1,9996,[ 70  96 127 288 269],416,5,41113,4.112533760128039,0.0,20.0
19997,1,9997,[ 64 483  12 427  11],618,5,41118,4.112622524504901,60.0,0.0
19998,1,9998,[508 300 546 268  15],708,2,41120,4.1124112411241125,0.0,0.0
19999,1,9999,[ 64 483  12 427  11],618,5,41125,4.1125,60.0,0.0
20000,2,0,[568 273  71 228  56],62,3,3,3.0,0.0,0.0
20001,2,1,[182 185   1 471 204],416,5,8,4.0,0.0,0.0
20002,2,2,[405 655 179  69 294],416,4,12,4.0,0.0,0.0
20003,2,3,[204  56 655 185 405],805,2,14,3.5,0.0,0.0
20004,2,4,[273 288   7  11 161],416,5,19,3.8,0.0,20.0
20005,2,5,[ 96 427 403 588 151],705,2,21,3.5,0.0,0.0
20006,2,6,[  7  11   1  96 403],618,4,25,3.5714285714285716,0.0,0.0
20007,2,7,[  7  11   1 403  71],198,4,29,3.625,0.0,0.0
20008,2,8,[  7  11   1 403  69],198,5,34,3.7777777777777777,0.0,0.0
20009,2,9,[172 202   8 121 204],437,4,38,3.8,0.0,0.0
20010,2,10,[288   1  69 172   8],679,3,41,3.727272727272727,0.0,20.0
20011,2,11,[288 202  69 172   7],416,5,46,3.8333333333333335,0.0,20.0
20012,2,12,[288 202  69 172   7],618,3,49,3.769230769230769,0.0,20.0
20013,2,13,[175 135 678 174 228],721,3,52,3.7142857142857144,0.0,0.0
20014,2,14,[ 64 237 276 182 427],230,4,56,3.7333333333333334,20.0,0.0
20015,2,15,[121  79 655 204 144],416,5,61,3.8125,0.0,0.0
20016,2,16,[ 97 153   7 168 322],417,3,64,3.764705882352941,0.0,0.0
20017,2,17,[222 357 121 568 245],62,3,67,3.7222222222222223,0.0,0.0
20018,2,18,[ 97 161  79 276 185],230,5,72,3.789473684210526,0.0,0.0
20019,2,19,[ 97 161  79 276 185],437,3,75,3.75,0.0,0.0
20020,2,20,[276 273  56  11  64],618,4,79,3.761904761904762,20.0,0.0
20021,2,21,[403 273  56  11  64],618,5,84,3.8181818181818183,20.0,0.0
20022,2,22,[268 423 265 496 118],417,3,87,3.782608695652174,0.0,0.0
20023,2,23,[118 357 403  11 174],416,4,91,3.7916666666666665,0.0,0.0
20024,2,24,[ 64  15 191 143 678],416,4,95,3.8,20.0,0.0
20025,2,25,[ 12 132 186  98 275],437,4,99,3.8076923076923075,20.0,20.0
20026,2,26,[  8 168 546 196   4],62,5,104,3.8518518518518516,0.0,0.0
20027,2,27,[111 238 742 568 546],654,5,109,3.892857142857143,0.0,0.0
20028,2,28,[117 742 151 269  96],416,4,113,3.896551724137931,0.0,0.0
20029,2,29,[ 82 111 265 238  64],711,2,115,3.8333333333333335,20.0,0.0
20030,2,30,[174  11 185  15   4],198,2,117,3.774193548387097,0.0,0.0
20031,2,31,[216 294 748 175  95],297,2,119,3.71875,0.0,0.0
20032,2,32,[ 11 222 144 174 168],854,3,122,3.696969696969697,0.0,0.0
20033,2,33,[ 11 238  69 172 546],416,4,126,3.7058823529411766,0.0,0.0
20034,2,34,[ 12 238 172 357 275],416,5,131,3.742857142857143,20.0,0.0
20035,2,35,[ 12 238 172 357 275],214,3,134,3.7222222222222223,20.0,0.0
20036,2,36,[ 12 357 153 222 423],417,4,138,3.72972972972973,20.0,0.0
20037,2,37,[ 56 153 423 168 196],43,5,143,3.763157894736842,0.0,0.0
20038,2,38,[ 56 153 423 168 196],198,3,146,3.7435897435897436,0.0,0.0
20039,2,39,[ 56 357 153 403 191],805,5,151,3.775,0.0,0.0
20040,2,40,[ 56 357 153 403 191],721,3,154,3.7560975609756095,0.0,0.0
20041,2,41,[273  98 357 168  69],416,5,159,3.7857142857142856,0.0,20.0
20042,2,42,[273  98 357 168  69],416,5,164,3.813953488372093,0.0,20.0
20043,2,43,[273  98 357 168  69],297,4,168,3.8181818181818183,0.0,20.0
20044,2,44,[273  98 357 168 403],416,5,173,3.8444444444444446,0.0,20.0
20045,2,45,[185 475 294  11 100],297,4,177,3.847826086956522,0.0,0.0
20046,2,46,[132 210 471 403 144],373,1,178,3.7872340425531914,0.0,0.0
20047,2,47,[475  98 357 153 168],62,5,183,3.8125,0.0,20.0
20048,2,48,[475  98 357 153 168],854,5,188,3.836734693877551,0.0,20.0
20049,2,49,[405 194 100 135 153],854,4,192,3.84,0.0,0.0
20050,2,50,[ 12  98 153 475 168],437,3,195,3.823529411764706,20.0,20.0
20051,2,51,[ 12  79 100  11 238],297,4,199,3.826923076923077,20.0,0.0
20052,2,52,[ 12  64 100  11 238],416,5,204,3.849056603773585,40.0,0.0
20053,2,53,[ 12  64 100  11 238],618,4,208,3.8518518518518516,40.0,0.0
20054,2,54,[ 12  64 100  11 143],43,5,213,3.8727272727272726,40.0,0.0
20055,2,55,[ 12  64 100  11 143],416,5,218,3.892857142857143,40.0,0.0
20056,2,56,[204 288 111 179 286],62,1,219,3.8421052631578947,0.0,20.0
20057,2,57,[ 98 357 153 143  11],297,5,224,3.8620689655172415,0.0,20.0
20058,2,58,[ 98 357 153 143  11],198,4,228,3.864406779661017,0.0,20.0
20059,2,59,[ 64 100 357 153  11],198,4,232,3.8666666666666667,20.0,0.0
20060,2,60,[117  12 153 268 273],854,3,235,3.8524590163934427,20.0,0.0
20061,2,61,[153  12 216 210 269],373,5,240,3.870967741935484,20.0,0.0
20062,2,62,[153  12 216 210 269],43,5,245,3.888888888888889,20.0,0.0
20063,2,63,[153  12 216 210 269],416,5,250,3.90625,20.0,0.0
20064,2,64,[153  12 216 210 269],416,5,255,3.923076923076923,20.0,0.0
20065,2,65,[153  12 216 210 269],416,5,260,3.9393939393939394,20.0,0.0
20066,2,66,[153  12 216 210 269],373,5,265,3.955223880597015,20.0,0.0
20067,2,67,[153  12 216 210 269],416,5,270,3.9705882352941178,20.0,0.0
20068,2,68,[153  12 216 210 269],416,5,275,3.9855072463768115,20.0,0.0
20069,2,69,[153  12 216 210 269],805,3,278,3.9714285714285715,20.0,0.0
20070,2,70,[ 98 257 588 173 111],417,2,280,3.943661971830986,0.0,20.0
20071,2,71,[111 161 196  69 301],416,5,285,3.9583333333333335,0.0,0.0
20072,2,72,[276 323 300  97 597],43,3,288,3.9452054794520546,0.0,0.0
20073,2,73,[294  70  11 286 273],417,4,292,3.945945945945946,0.0,0.0
20074,2,74,[300  98  12 301 269],416,5,297,3.96,20.0,20.0
20075,2,75,[276 742 125  69 121],223,2,299,3.9342105263157894,0.0,0.0
20076,2,76,[215   1   7 216  97],588,3,302,3.9220779220779223,0.0,0.0
20077,2,77,[ 64  11 300 301 269],345,4,306,3.923076923076923,20.0,0.0
20078,2,78,[742 403 121  15 197],345,3,309,3.911392405063291,0.0,0.0
20079,2,79,[ 12  98 215 301 269],43,5,314,3.925,20.0,20.0
20080,2,80,[ 12  98 215 301 269],297,4,318,3.925925925925926,20.0,20.0
20081,2,81,[ 12 173  98  64  70],62,4,322,3.926829268292683,40.0,20.0
20082,2,82,[197 173  98  12  64],405,5,327,3.9397590361445785,40.0,20.0
20083,2,83,[197 173  98  12  64],345,5,332,3.9523809523809526,40.0,20.0
20084,2,84,[197 173  98  12  64],618,3,335,3.9411764705882355,40.0,20.0
20085,2,85,[175  64 301 269  98],43,4,339,3.941860465116279,20.0,20.0
20086,2,86,[ 98 301 269 237 153],43,5,344,3.954022988505747,0.0,20.0
20087,2,87,[ 96 405 173  69 195],642,3,347,3.9431818181818183,0.0,0.0
20088,2,88,[475 269 181   8 135],711,5,352,3.955056179775281,0.0,20.0
20089,2,89,[181 237  11  64  12],630,4,356,3.9555555555555557,40.0,20.0
20090,2,90,[ 69 181 269 275  28],654,4,360,3.956043956043956,0.0,20.0
20091,2,91,[ 11 237  12  64  28],618,5,365,3.967391304347826,40.0,0.0
20092,2,92,[ 11 237  12  64  28],416,4,369,3.967741935483871,40.0,0.0
20093,2,93,[ 11  98 301 269 153],751,4,373,3.9680851063829787,0.0,20.0
20094,2,94,[194 181  98   8 196],416,5,378,3.9789473684210526,0.0,40.0
20095,2,95,[  7 275 191  88   8],416,4,382,3.9791666666666665,0.0,0.0
20096,2,96,[ 96 121 210 144 172],505,3,385,3.9690721649484537,0.0,0.0
20097,2,97,[678 204 237 216 357],721,3,388,3.9591836734693877,0.0,0.0
20098,2,98,[ 64 357 301 269  28],416,5,393,3.9696969696969697,20.0,0.0
20099,2,99,[313 268 194 302 288],416,5,398,3.98,20.0,40.0
20100,2,100,[210 172 200  97 423],618,4,402,3.98019801980198,0.0,0.0
20101,2,101,[265   8  11  50 496],416,5,407,3.9901960784313726,0.0,20.0
20102,2,102,[302 200  12  98 313],416,5,412,4.0,40.0,40.0
20103,2,103,[302 200  12  98 313],49,3,415,3.9903846153846154,40.0,40.0
20104,2,104,[276 215  25 742  98],416,4,419,3.9904761904761905,0.0,20.0
20105,2,105,[176  25 275 174 168],297,5,424,4.0,0.0,0.0
20106,2,106,[302  25 153 301 269],416,5,429,4.009345794392523,0.0,0.0
20107,2,107,[  8 322 161 269 173],721,5,434,4.018518518518518,0.0,0.0
20108,2,108,[245  95   9  79 282],416,3,437,4.009174311926605,0.0,0.0
20109,2,109,[132  28 475 258 273],62,4,441,4.009090909090909,0.0,0.0
20110,2,110,[153 258  64  25   9],416,5,446,4.018018018018018,20.0,0.0
20111,2,111,[153 258  64  25   9],24,5,451,4.026785714285714,20.0,0.0
20112,2,112,[153 258  64  25   9],24,5,456,4.035398230088496,20.0,0.0
20113,2,113,[153 258  64  25   9],43,5,461,4.043859649122807,20.0,0.0
20114,2,114,[597  11   4  50 118],618,3,464,4.034782608695652,0.0,20.0
20115,2,115,[ 12  25  64 301 269],43,5,469,4.043103448275862,40.0,0.0
20116,2,116,[238 111 471 268 276],128,3,472,4.034188034188034,0.0,0.0
20117,2,117,[117 216 202   1 200],764,5,477,4.0423728813559325,0.0,0.0
20118,2,118,[ 64 176  25 357 302],417,3,480,4.033613445378151,20.0,0.0
20119,2,119,[ 64 282  12 301 269],416,5,485,4.041666666666667,40.0,0.0
20120,2,120,[202 655 265   1  12],588,3,488,4.033057851239669,20.0,0.0
20121,2,121,[202 144 273 111 118],805,0,488,4.0,0.0,0.0
20122,2,122,[357  12  64 282 258],854,4,492,4.0,40.0,0.0
20123,2,123,[357 176  64 301 269],416,5,497,4.008064516129032,20.0,0.0
20124,2,124,[276  70  25  71 265],230,4,501,4.008,0.0,0.0
20125,2,125,[211  56 204   8 173],437,5,506,4.015873015873016,0.0,0.0
20126,2,126,[194 161 300   4 179],416,4,510,4.015748031496063,0.0,0.0
20127,2,127,[265 475 185  64  98],417,3,513,4.0078125,20.0,20.0
20128,2,128,[168 117 161 655 216],805,1,514,3.9844961240310077,0.0,0.0
20129,2,129,[678 318  88 237 202],588,2,516,3.9692307692307693,20.0,0.0
20130,2,130,[211 357 301 269  98],416,5,521,3.9770992366412212,0.0,20.0
20131,2,131,[132 655 318   7 172],618,5,526,3.984848484848485,20.0,0.0
20132,2,132,[210 153 275 174 185],262,1,527,3.962406015037594,0.0,0.0
20133,2,133,[357  50  12 318  64],214,4,531,3.962686567164179,60.0,20.0
20134,2,134,[211 318  98 301 269],416,5,536,3.9703703703703703,20.0,20.0
20135,2,135,[200 191 282 215  88],12,4,540,3.9705882352941178,0.0,0.0
20136,2,136,[ 98 258 211 318  64],416,5,545,3.978102189781022,40.0,20.0
20137,2,137,[294 191 161 235 318],345,2,547,3.963768115942029,20.0,0.0
20138,2,138,[176 357 211 318  98],405,3,550,3.9568345323741005,20.0,20.0
20139,2,139,[ 64 258  98  12 357],416,5,555,3.9642857142857144,40.0,20.0
20140,2,140,[ 64 258  98  12 357],875,5,560,3.971631205673759,40.0,20.0
20141,2,141,[ 64 258  98  12 357],601,3,563,3.964788732394366,40.0,20.0
20142,2,142,[ 64   9 357 258 318],601,5,568,3.972027972027972,40.0,0.0
20143,2,143,[ 64   9 357 258 318],24,5,573,3.9791666666666665,40.0,0.0
20144,2,144,[ 64   9 357 258 318],62,5,578,3.986206896551724,40.0,0.0
20145,2,145,[ 64   9 357 258 318],62,5,583,3.993150684931507,40.0,0.0
20146,2,146,[ 64   9 357 258 318],416,5,588,4.0,40.0,0.0
20147,2,147,[215 275 117  25 496],43,5,593,4.006756756756757,0.0,0.0
20148,2,148,[ 64   9 357 258 318],601,5,598,4.0134228187919465,40.0,0.0
20149,2,149,[ 64   9 357 258 318],62,5,603,4.02,40.0,0.0
20150,2,150,[ 64   9 357 258 318],854,5,608,4.026490066225166,40.0,0.0
20151,2,151,[ 64   9 357 258 318],854,5,613,4.032894736842105,40.0,0.0
20152,2,152,[187  97 174  95 135],198,3,616,4.026143790849673,0.0,0.0
20153,2,153,[403 125 143 172 496],588,2,618,4.012987012987013,0.0,0.0
20154,2,154,[258 357 301 269  64],416,5,623,4.019354838709678,20.0,0.0
20155,2,155,[ 98 294 258 742 121],588,4,627,4.019230769230769,0.0,20.0
20156,2,156,[302 234 288 403 173],417,3,630,4.012738853503185,0.0,20.0
20157,2,157,[210  28 216 179 180],405,2,632,4.0,0.0,0.0
20158,2,158,[234 258 357 301 269],297,4,636,4.0,0.0,0.0
20159,2,159,[357 301 269  64 187],416,5,641,4.00625,20.0,0.0
20160,2,160,[357 301 269  64 187],416,5,646,4.012422360248447,20.0,0.0
20161,2,161,[301 143   4 238   7],416,5,651,4.018518518518518,0.0,0.0
20162,2,162,[151 200 568 228 288],887,3,654,4.012269938650307,0.0,20.0
20163,2,163,[174 172 111 173 100],679,2,656,4.0,0.0,0.0
20164,2,164,[ 95 222 471 318 328],43,4,660,4.0,20.0,0.0
20165,2,165,[258 301 269   9  64],345,5,665,4.006024096385542,20.0,0.0
20166,2,166,[258 301 269   9  64],416,5,670,4.0119760479041915,20.0,0.0
20167,2,167,[258 301 269   9  64],43,5,675,4.017857142857143,20.0,0.0
20168,2,168,[258 301 269   9  64],345,5,680,4.023668639053255,20.0,0.0
20169,2,169,[ 70   9 235 125 568],345,3,683,4.017647058823529,0.0,0.0
20170,2,170,[258 301 269   9  64],345,5,688,4.023391812865497,20.0,0.0
20171,2,171,[117  28 135 161 357],230,4,692,4.023255813953488,0.0,0.0
20172,2,172,[423 603 153 427 273],416,5,697,4.028901734104046,0.0,0.0
20173,2,173,[151   4 121 168 144],805,2,699,4.017241379310345,0.0,0.0
20174,2,174,[121 568  82 265 172],416,5,704,4.022857142857143,0.0,0.0
20175,2,175,[318 357 301 269 328],721,5,709,4.028409090909091,20.0,0.0
20176,2,176,[318 357 301 269 328],721,5,714,4.033898305084746,20.0,0.0
20177,2,177,[174 301 269 328  28],721,5,719,4.03932584269663,0.0,0.0
20178,2,178,[318 357 301 269 328],721,5,724,4.044692737430168,20.0,0.0
20179,2,179,[318 357 301 269 328],416,5,729,4.05,20.0,0.0
20180,2,180,[318 357 301 269 328],721,5,734,4.05524861878453,20.0,0.0
20181,2,181,[ 11 475 161   4 172],198,3,737,4.049450549450549,0.0,0.0
20182,2,182,[318 357 301 269 328],555,5,742,4.054644808743169,20.0,0.0
20183,2,183,[318 357 301 269 328],555,5,747,4.059782608695652,20.0,0.0
20184,2,184,[318 357 301 269 328],721,5,752,4.064864864864865,20.0,0.0
20185,2,185,[ 79  56 275  15 153],43,5,757,4.06989247311828,0.0,0.0
20186,2,186,[318 357 301 269 328],416,5,762,4.074866310160428,20.0,0.0
20187,2,187,[202 483 588 222 328],128,2,764,4.0638297872340425,20.0,0.0
20188,2,188,[ 89 143  71 483 427],711,4,768,4.063492063492063,20.0,0.0
20189,2,189,[ 64 357 301 269 603],416,5,773,4.068421052631579,20.0,0.0
20190,2,190,[151   9  50 121 258],805,2,775,4.057591623036649,0.0,20.0
20191,2,191,[100 185 655 603 174],437,5,780,4.0625,0.0,0.0
20192,2,192,[ 64 357 301 269 603],416,5,785,4.067357512953368,20.0,0.0
20193,2,193,[  4 328 153 111   8],416,5,790,4.072164948453608,0.0,0.0
20194,2,194,[289 185 132 121 180],854,3,793,4.066666666666666,0.0,0.0
20195,2,195,[301  28 143 588 238],297,5,798,4.071428571428571,0.0,0.0
20196,2,196,[300 172 483 210 216],128,4,802,4.071065989847716,20.0,0.0
20197,2,197,[187 318 301 269 357],416,5,807,4.075757575757576,20.0,0.0
20198,2,198,[ 88 200  71 194 143],405,1,808,4.060301507537688,0.0,0.0
20199,2,199,[118 318 191  69 143],437,3,811,4.055,20.0,0.0
20200,2,200,[357 318 301 269 603],416,5,816,4.059701492537314,20.0,0.0
20201,2,201,[ 28 182 275 117   8],437,2,818,4.0495049504950495,0.0,0.0
20202,2,202,[742 588  15 328  71],128,3,821,4.044334975369458,0.0,0.0
20203,2,203,[144 588 282   4 313],618,3,824,4.03921568627451,20.0,20.0
20204,2,204,[435 186 215 216 655],373,5,829,4.04390243902439,0.0,0.0
20205,2,205,[182  22 588 286   9],416,5,834,4.048543689320389,0.0,0.0
20206,2,206,[100 471 496  71   9],274,5,839,4.053140096618358,0.0,0.0
20207,2,207,[435 187 318  22 357],405,4,843,4.052884615384615,20.0,0.0
20208,2,208,[ 64 603 318  22  89],373,5,848,4.057416267942584,40.0,0.0
20209,2,209,[ 64 603 318  22  89],214,4,852,4.057142857142857,40.0,0.0
20210,2,210,[237 121  12  70 135],618,4,856,4.056872037914692,20.0,0.0
20211,2,211,[483 546 202 168  11],417,4,860,4.056603773584905,20.0,0.0
20212,2,212,[748 427 742 655 144],416,5,865,4.061032863849765,0.0,0.0
20213,2,213,[ 70 496  64 204  89],373,5,870,4.065420560747664,20.0,0.0
20214,2,214,[ 89 318 301 269  64],711,5,875,4.069767441860465,40.0,0.0
20215,2,215,[300 742 275  71 211],274,5,880,4.074074074074074,0.0,0.0
20216,2,216,[143 135 111   7 678],805,3,883,4.0691244239631335,0.0,0.0
20217,2,217,[132 222   4  50 742],417,1,884,4.055045871559633,0.0,20.0
20218,2,218,[153 568 268  79  15],417,3,887,4.050228310502283,0.0,0.0
20219,2,219,[195 161  69  89 135],437,1,888,4.036363636363636,0.0,0.0
20220,2,220,[234 118 289 322 588],416,2,890,4.027149321266968,0.0,0.0
20221,2,221,[194 200 357 603  97],405,1,891,4.013513513513513,0.0,0.0
20222,2,222,[235 195 200 257  11],854,2,893,4.004484304932736,0.0,0.0
20223,2,223,[ 97 678 322 195 125],416,3,896,4.0,0.0,0.0
20224,2,224,[197 423  96 405 403],198,3,899,3.9955555555555557,0.0,0.0
20225,2,225,[196 153  95 173 143],416,4,903,3.995575221238938,0.0,0.0
20226,2,226,[ 95  98 100 182  97],416,4,907,3.995594713656388,0.0,20.0
20227,2,227,[271 216 100 257 318],62,3,910,3.991228070175439,20.0,0.0
20228,2,228,[191   8  12 202 238],618,2,912,3.982532751091703,20.0,0.0
20229,2,229,[515 222 228 191 405],417,2,914,3.973913043478261,0.0,0.0
20230,2,230,[328 245 655 268 182],416,4,918,3.9740259740259742,0.0,0.0
20231,2,231,[508 197   4   7 216],297,3,921,3.9698275862068964,0.0,0.0
20232,2,232,[275 215 135 117 195],297,3,924,3.9656652360515023,0.0,0.0
20233,2,233,[568 173 151 234 202],417,4,928,3.965811965811966,0.0,0.0
20234,2,234,[300  64 237 118 153],198,2,930,3.9574468085106385,20.0,0.0
20235,2,235,[ 11 216 318 405 269],345,5,935,3.961864406779661,20.0,0.0
20236,2,236,[235 282   7  12 333],416,4,939,3.962025316455696,20.0,0.0
20237,2,237,[183 742 181 269  97],416,5,944,3.966386554621849,0.0,20.0
20238,2,238,[180 357 132   4  70],417,4,948,3.9665271966527196,0.0,0.0
20239,2,239,[ 56 173  11 175 200],297,4,952,3.966666666666667,0.0,0.0
20240,2,240,[125 151  89  69  79],373,5,957,3.970954356846473,0.0,0.0
20241,2,241,[168 191  71 288  88],805,2,959,3.9628099173553717,0.0,20.0
20242,2,242,[117 235 271 118  15],62,2,961,3.954732510288066,0.0,0.0
20243,2,243,[144 143 748 200  28],297,2,963,3.94672131147541,0.0,0.0
20244,2,244,[ 12  79  22 197  95],405,4,967,3.946938775510204,20.0,0.0
20245,2,245,[423 318  97 385   8],416,5,972,3.951219512195122,20.0,0.0
20246,2,246,[121 117 143 678 176],805,2,974,3.9433198380566803,0.0,0.0
20247,2,247,[ 12 168  95 313 423],405,3,977,3.939516129032258,40.0,20.0
20248,2,248,[318  50 333 603  98],416,5,982,3.9437751004016066,20.0,40.0
20249,2,249,[ 88 202 385 405 196],805,0,982,3.928,0.0,0.0
20250,2,250,[144 597 678 268 186],588,3,985,3.9243027888446216,0.0,0.0
20251,2,251,[161   7 182  28 143],230,3,988,3.9206349206349205,0.0,0.0
20252,2,252,[187  64 515 301 269],416,5,993,3.924901185770751,20.0,0.0
20253,2,253,[323  64 322 174 294],417,2,995,3.9173228346456694,20.0,0.0
20254,2,254,[187  64 515 301 269],416,5,1000,3.9215686274509802,20.0,0.0
20255,2,255,[117  56 151 181 118],43,5,1005,3.92578125,0.0,20.0
20256,2,256,[  1  12 135 210 202],618,3,1008,3.922178988326848,20.0,0.0
20257,2,257,[603 475  22 471 176],416,4,1012,3.9224806201550386,0.0,0.0
20258,2,258,[515 357 301 269  64],416,5,1017,3.9266409266409266,20.0,0.0
20259,2,259,[515 357 301 269  64],416,5,1022,3.9307692307692306,20.0,0.0
20260,2,260,[135 127 191  11 195],805,2,1024,3.9233716475095783,0.0,0.0
20261,2,261,[204 176  79 568  22],405,4,1028,3.9236641221374047,0.0,0.0
20262,2,262,[  4  15 405 496 271],43,4,1032,3.923954372623574,0.0,0.0
20263,2,263,[333 318 301 269  64],345,4,1036,3.9242424242424243,40.0,0.0
20264,2,264,[423 176 234  25 546],297,2,1038,3.9169811320754717,0.0,0.0
20265,2,265,[ 96 268 202 125 546],417,3,1041,3.9135338345864663,0.0,0.0
20266,2,266,[508 318 483 357 183],601,5,1046,3.9176029962546814,40.0,0.0
20267,2,267,[323 151 238   9 161],345,3,1049,3.9141791044776117,0.0,0.0
20268,2,268,[508 318 483 357 183],62,5,1054,3.9182156133828996,40.0,0.0
20269,2,269,[508 318 483 357 183],62,5,1059,3.922222222222222,40.0,0.0
20270,2,270,[423  50 185 132  95],198,2,1061,3.915129151291513,0.0,20.0
20271,2,271,[508 318 483 357 183],601,5,1066,3.9191176470588234,40.0,0.0
20272,2,272,[222 403 175 197 191],805,5,1071,3.923076923076923,0.0,0.0
20273,2,273,[ 69 508  25 273 200],417,1,1072,3.9124087591240877,0.0,0.0
20274,2,274,[ 11   8 196   4 318],416,5,1077,3.9163636363636365,20.0,0.0
20275,2,275,[678  70 172 185 179],416,3,1080,3.9130434782608696,0.0,0.0
20276,2,276,[168 222 655 423 135],805,3,1083,3.9097472924187726,0.0,0.0
20277,2,277,[194 655 597  98 215],416,4,1087,3.9100719424460433,0.0,20.0
20278,2,278,[196 603 111 568   4],416,5,1092,3.913978494623656,0.0,0.0
20279,2,279,[183 269 568 588  12],416,5,1097,3.9178571428571427,20.0,0.0
20280,2,280,[655 118 204 197 282],128,3,1100,3.9145907473309607,0.0,0.0
20281,2,281,[ 69  50 172   1 135],618,5,1105,3.9184397163120566,0.0,20.0
20282,2,282,[403 118  89 173 179],198,4,1109,3.918727915194346,0.0,0.0
20283,2,283,[ 28  70 143 588 322],416,4,1113,3.9190140845070425,0.0,0.0
20284,2,284,[172  69  50  82  25],711,3,1116,3.9157894736842107,0.0,20.0
20285,2,285,[483 135 210   7   4],62,5,1121,3.9195804195804196,20.0,0.0
20286,2,286,[186 245 742  28 405],642,4,1125,3.9198606271777003,0.0,0.0
20287,2,287,[  4 196 318 121 245],416,4,1129,3.920138888888889,20.0,0.0
20288,2,288,[275 318 168 403 269],43,5,1134,3.9238754325259517,20.0,0.0
20289,2,289,[168 143 568 228  11],230,3,1137,3.920689655172414,0.0,0.0
20290,2,290,[597 181 276 403 483],62,4,1141,3.9209621993127146,20.0,20.0
20291,2,291,[300 111 100  82  71],654,3,1144,3.9178082191780823,0.0,0.0
20292,2,292,[100  82  70 161 265],198,0,1144,3.9044368600682593,0.0,0.0
20293,2,293,[286 423 195 403 202],416,5,1149,3.9081632653061225,0.0,0.0
20294,2,294,[678 196  28 181  50],297,4,1153,3.9084745762711863,0.0,40.0
20295,2,295,[ 88 313 282 288 182],907,5,1158,3.9121621621621623,20.0,40.0
20296,2,296,[300 173 121 546 313],43,5,1163,3.9158249158249157,20.0,20.0
20297,2,297,[ 64  95 597 132 153],416,3,1166,3.912751677852349,20.0,0.0
20298,2,298,[597 144 328   7  28],416,4,1170,3.9130434782608696,0.0,0.0
20299,2,299,[216 496 228 475 597],417,1,1171,3.9033333333333333,0.0,0.0
20300,2,300,[183 318 301 269  64],416,5,1176,3.9069767441860463,40.0,0.0
20301,2,301,[144  82 187  25 471],373,1,1177,3.8973509933774833,0.0,0.0
20302,2,302,[183 515 301 269  64],416,5,1182,3.900990099009901,20.0,0.0
20303,2,303,[121 151  82 748   4],805,1,1183,3.8914473684210527,0.0,0.0
20304,2,304,[515  64 301 269 318],416,5,1188,3.8950819672131147,40.0,0.0
20305,2,305,[515  64 301 269 318],416,5,1193,3.8986928104575163,40.0,0.0
20306,2,306,[185 588 222 125 195],601,2,1195,3.8925081433224755,0.0,0.0
20307,2,307,[515  64 301 269 318],416,5,1200,3.896103896103896,40.0,0.0
20308,2,308,[515  64 301 269 318],416,5,1205,3.899676375404531,40.0,0.0
20309,2,309,[678 211   7  15 322],416,3,1208,3.8967741935483873,0.0,0.0
20310,2,310,[127  69  15 202 216],165,4,1212,3.897106109324759,0.0,0.0
20311,2,311,[197  88  71  70 216],405,1,1213,3.8878205128205128,0.0,0.0
20312,2,312,[515 301 269 318 357],416,5,1218,3.891373801916933,20.0,0.0
20313,2,313,[172 471 200 183 100],416,5,1223,3.894904458598726,0.0,0.0
20314,2,314,[186  79 181 197 258],354,4,1227,3.895238095238095,0.0,20.0
20315,2,315,[235 318  69  79 121],180,4,1231,3.8955696202531644,20.0,0.0
20316,2,316,[210 194  69  71 742],416,5,1236,3.8990536277602525,0.0,0.0
20317,2,317,[202 568 222 748   7],417,2,1238,3.893081761006289,0.0,0.0
20318,2,318,[318 483 301 269  64],711,5,1243,3.896551724137931,60.0,0.0
20319,2,319,[173 210  25 258 323],805,3,1246,3.89375,0.0,0.0
20320,2,320,[318 301 269  64 515],416,5,1251,3.897196261682243,40.0,0.0
20321,2,321,[423 427 235 322  96],416,3,1254,3.8944099378881987,0.0,0.0
20322,2,322,[318  64 301 269 357],416,5,1259,3.8978328173374615,40.0,0.0
20323,2,323,[153 100 144 172 471],416,5,1264,3.9012345679012346,0.0,0.0
20324,2,324,[ 25 275   1 258  89],698,3,1267,3.8984615384615386,0.0,0.0
20325,2,325,[318  64 301 269 357],721,5,1272,3.901840490797546,40.0,0.0
20326,2,326,[318  64 301 269 357],721,5,1277,3.90519877675841,40.0,0.0
20327,2,327,[ 95  11   8 300 515],416,4,1281,3.9054878048780486,0.0,0.0
20328,2,328,[ 69 204 121   8 174],437,3,1284,3.9027355623100304,0.0,0.0
20329,2,329,[185  64 204  12 515],405,4,1288,3.903030303030303,40.0,0.0
20330,2,330,[471 197  12 237 588],618,3,1291,3.900302114803625,20.0,0.0
20331,2,331,[125 117  89 302  25],417,3,1294,3.897590361445783,0.0,0.0
20332,2,332,[197 385 111 245 258],345,3,1297,3.894894894894895,0.0,0.0
20333,2,333,[ 28 135  25 195 143],230,2,1299,3.8892215568862274,0.0,0.0
20334,2,334,[357 483  64 318 183],62,5,1304,3.8925373134328356,60.0,0.0
20335,2,335,[357 483  64 318 183],601,5,1309,3.8958333333333335,60.0,0.0
20336,2,336,[357 483  64 318 183],601,5,1314,3.8991097922848663,60.0,0.0
20337,2,337,[357 483  64 318 183],62,5,1319,3.9023668639053253,60.0,0.0
20338,2,338,[153   9 204 173 405],805,2,1321,3.896755162241888,0.0,0.0
20339,2,339,[ 95 603  11 423 405],805,1,1322,3.888235294117647,0.0,0.0
20340,2,340,[161 301  96  11 235],49,0,1322,3.87683284457478,0.0,0.0
20341,2,341,[302 300 200 403 588],49,2,1324,3.871345029239766,0.0,0.0
20342,2,342,[258 234 210 269 245],416,4,1328,3.871720116618076,0.0,0.0
20343,2,343,[125   7 328 153  50],854,3,1331,3.869186046511628,0.0,20.0
20344,2,344,[300 183 202  28 357],698,2,1333,3.863768115942029,0.0,0.0
20345,2,345,[318 269 357 483  64],214,4,1337,3.8641618497109826,60.0,0.0
20346,2,346,[318 483 357  64 269],854,5,1342,3.867435158501441,60.0,0.0
20347,2,347,[318 483 357  64 269],854,5,1347,3.8706896551724137,60.0,0.0
20348,2,348,[318 483 357  64 269],854,5,1352,3.8739255014326646,60.0,0.0
20349,2,349,[318 483 357  64 269],214,4,1356,3.874285714285714,60.0,0.0
20350,2,350,[100 235 385 210  15],416,4,1360,3.8746438746438745,0.0,0.0
20351,2,351,[  1 288  25 546 748],417,2,1362,3.8693181818181817,0.0,20.0
20352,2,352,[191  11 318   9 173],43,5,1367,3.8725212464589234,20.0,0.0
20353,2,353,[ 88 588 168 183 597],618,5,1372,3.8757062146892656,0.0,0.0
20354,2,354,[271 200   8 235  56],854,4,1376,3.876056338028169,0.0,0.0
20355,2,355,[ 96 313 655  12  82],416,5,1381,3.8792134831460676,40.0,20.0
20356,2,356,[153 237 275 172  15],654,4,1385,3.8795518207282913,0.0,0.0
20357,2,357,[175 588 323   9 328],43,3,1388,3.877094972067039,0.0,0.0
20358,2,358,[ 56  79 144 111   7],854,3,1391,3.8746518105849583,0.0,0.0
20359,2,359,[286  11 294 742 173],416,5,1396,3.8777777777777778,0.0,0.0
20360,2,360,[143 655 204 121  69],198,2,1398,3.8725761772853184,0.0,0.0
20361,2,361,[ 12 423 197 127   4],416,5,1403,3.8756906077348066,20.0,0.0
20362,2,362,[144 174 257 245 268],297,2,1405,3.8705234159779613,0.0,0.0
20363,2,363,[202 118 172 655 215],618,3,1408,3.868131868131868,0.0,0.0
20364,2,364,[ 22  79  69 471 196],297,2,1410,3.863013698630137,0.0,0.0
20365,2,365,[  7 200 175  22  56],297,4,1414,3.8633879781420766,0.0,0.0
20366,2,366,[117 215 508  22 121],62,4,1418,3.863760217983651,0.0,0.0
20367,2,367,[ 69 118 117  97 121],62,3,1421,3.8614130434782608,0.0,0.0
20368,2,368,[191 294 286  98 228],417,4,1425,3.861788617886179,0.0,20.0
20369,2,369,[ 12  98 135 179 183],805,5,1430,3.864864864864865,20.0,20.0
20370,2,370,[ 22 204  88  79 195],373,5,1435,3.8679245283018866,0.0,0.0
20371,2,371,[181 496 185  69 228],417,0,1435,3.85752688172043,0.0,20.0
20372,2,372,[151 211   4  96  12],373,5,1440,3.8605898123324396,20.0,0.0
20373,2,373,[300   1  71 143 678],416,4,1444,3.8609625668449197,0.0,0.0
20374,2,374,[ 70 276 118 742 385],416,3,1447,3.8586666666666667,0.0,0.0
20375,2,375,[742  69 423 405 222],654,5,1452,3.8617021276595747,0.0,0.0
20376,2,376,[210 475 181 275 357],297,5,1457,3.8647214854111405,0.0,20.0
20377,2,377,[ 56 475 597 655 196],62,3,1460,3.8624338624338623,0.0,0.0
20378,2,378,[125 181 179 238 245],416,3,1463,3.8601583113456464,0.0,20.0
20379,2,379,[742 200   7 143 215],297,2,1465,3.8552631578947367,0.0,0.0
20380,2,380,[211 216 118   9 168],43,5,1470,3.858267716535433,0.0,0.0
20381,2,381,[151 195   4  82 182],618,2,1472,3.8534031413612566,0.0,0.0
20382,2,382,[322 515  28 183 172],416,4,1476,3.85378590078329,0.0,0.0
20383,2,383,[ 97 196 300 222 215],198,1,1477,3.8463541666666665,0.0,0.0
20384,2,384,[ 25 143 117 202 282],588,4,1481,3.846753246753247,0.0,0.0
20385,2,385,[117 121 276 179 183],198,2,1483,3.8419689119170983,0.0,0.0
20386,2,386,[216 151  79  95 269],297,2,1485,3.8372093023255816,0.0,0.0
20387,2,387,[ 11 245 210  70  95],416,3,1488,3.8350515463917527,0.0,0.0
20388,2,388,[186 118 318 168 588],588,4,1492,3.83547557840617,20.0,0.0
20389,2,389,[ 15 238  69  70 288],437,2,1494,3.830769230769231,0.0,20.0
20390,2,390,[357  89 125 237  69],62,4,1498,3.8312020460358056,0.0,0.0
20391,2,391,[180 196 182 215  56],198,3,1501,3.829081632653061,0.0,0.0
20392,2,392,[ 82 405 318  50 427],601,3,1504,3.826972010178117,20.0,20.0
20393,2,393,[222 568 237 151 265],128,3,1507,3.8248730964467006,0.0,0.0
20394,2,394,[588  97 268 288 546],417,2,1509,3.820253164556962,0.0,20.0
20395,2,395,[603  11 118 475 301],416,3,1512,3.8181818181818183,0.0,0.0
20396,2,396,[111 357 211  97  50],297,4,1516,3.818639798488665,0.0,20.0
20397,2,397,[151 423 161  11 132],618,4,1520,3.819095477386935,0.0,0.0
20398,2,398,[111  56 235 322 302],854,1,1521,3.81203007518797,0.0,0.0
20399,2,399,[273 238 168 191 289],854,4,1525,3.8125,0.0,0.0
20400,2,400,[  7 288 168  79 234],416,5,1530,3.8154613466334166,0.0,20.0
20401,2,401,[742 427 204 423 172],416,5,1535,3.818407960199005,0.0,0.0
20402,2,402,[282 289  98 257 216],342,1,1536,3.8114143920595533,0.0,20.0
20403,2,403,[197 204 748 215  15],721,4,1540,3.8118811881188117,0.0,0.0
20404,2,404,[200 121 168 235 265],417,2,1542,3.8074074074074074,0.0,0.0
20405,2,405,[111 471   7 483 118],854,2,1544,3.8029556650246303,20.0,0.0
20406,2,406,[161   8 471  69 100],43,4,1548,3.8034398034398036,0.0,0.0
20407,2,407,[475 111 257 168 195],854,2,1550,3.799019607843137,0.0,0.0
20408,2,408,[515 228 195 172 568],417,2,1552,3.7946210268948657,0.0,0.0
20409,2,409,[196 204  98  22 333],496,2,1554,3.790243902439024,0.0,20.0
20410,2,410,[200 161  25 181 294],416,5,1559,3.7931873479318736,0.0,20.0
20411,2,411,[ 70 403 357 435 181],405,3,1562,3.79126213592233,0.0,20.0
20412,2,412,[288 191 286  97 357],416,5,1567,3.794188861985472,0.0,20.0
20413,2,413,[151 196 144 288 135],62,3,1570,3.792270531400966,0.0,20.0
20414,2,414,[568  97 211 288 100],417,2,1572,3.787951807228916,0.0,20.0
20415,2,415,[234   1 405  89 173],198,3,1575,3.7860576923076925,0.0,0.0
20416,2,416,[ 28  25 174 385 286],345,1,1576,3.7793764988009593,0.0,0.0
20417,2,417,[237 216 238 194 191],297,3,1579,3.777511961722488,0.0,0.0
20418,2,418,[301 323  56 273 111],416,4,1583,3.7780429594272076,0.0,0.0
20419,2,419,[228 286 121 186 403],417,3,1586,3.776190476190476,0.0,0.0
20420,2,420,[286  70 294 144 195],417,4,1590,3.776722090261283,0.0,0.0
20421,2,421,[568 588 173  69   1],679,2,1592,3.772511848341232,0.0,0.0
20422,2,422,[ 95 508 322 357 323],417,2,1594,3.768321513002364,0.0,0.0
20423,2,423,[ 89  70 204 161 655],198,2,1596,3.7641509433962264,0.0,0.0
20424,2,424,[179 265  69 405 204],128,4,1600,3.764705882352941,0.0,0.0
20425,2,425,[197 288   8  70  88],711,4,1604,3.7652582159624415,0.0,20.0
20426,2,426,[204 275 174 237  12],437,5,1609,3.7681498829039812,20.0,0.0
20427,2,427,[ 98 100   1 143 258],654,4,1613,3.7686915887850465,0.0,20.0
20428,2,428,[423 294   4 288 202],805,0,1613,3.7599067599067597,0.0,20.0
20429,2,429,[257 496  64 423 276],43,5,1618,3.7627906976744185,20.0,0.0
20430,2,430,[286 475 183 357 100],417,4,1622,3.7633410672853826,0.0,0.0
20431,2,431,[423 176   4   1 300],198,2,1624,3.759259259259259,0.0,0.0
20432,2,432,[210 144  79 194  88],373,4,1628,3.759815242494226,0.0,0.0
20433,2,433,[ 11 127  50  56 183],417,4,1632,3.76036866359447,0.0,20.0
20434,2,434,[ 70  50 588 515 294],417,3,1635,3.7586206896551726,0.0,20.0
20435,2,435,[132 151  22 288 121],601,2,1637,3.7545871559633026,0.0,20.0
20436,2,436,[195  98 210 202 288],417,3,1640,3.7528604118993134,0.0,40.0
20437,2,437,[289   1 174  56   8],854,2,1642,3.7488584474885847,0.0,0.0
20438,2,438,[  8 471 286 302 100],854,2,1644,3.744874715261959,0.0,0.0
20439,2,439,[118 300 568 216 276],654,3,1647,3.743181818181818,0.0,0.0
20440,2,440,[174  69 161  64 125],618,4,1651,3.743764172335601,20.0,0.0
20441,2,441,[ 15 197  82 127 211],373,2,1653,3.739819004524887,0.0,0.0
20442,2,442,[200  64 151   1  28],416,4,1657,3.740406320541761,20.0,0.0
20443,2,443,[273 194 257 161  64],416,4,1661,3.740990990990991,20.0,0.0
20444,2,444,[ 71 328  25 121 191],128,3,1664,3.7393258426966294,0.0,0.0
20445,2,445,[181  70 144  50 204],437,3,1667,3.7376681614349776,0.0,40.0
20446,2,446,[269   1  97 216 182],416,5,1672,3.7404921700223714,0.0,0.0
20447,2,447,[318 210   4 117   1],654,5,1677,3.7433035714285716,20.0,0.0
20448,2,448,[289 238 182 143  98],416,4,1681,3.7438752783964366,0.0,20.0
20449,2,449,[ 64  88 173 597  50],642,5,1686,3.7466666666666666,20.0,20.0
20450,2,450,[742 286 301 275 318],416,5,1691,3.7494456762749446,20.0,0.0
20451,2,451,[196 174 180 172  88],373,4,1695,3.75,0.0,0.0
20452,2,452,[172 111 423   1 191],618,4,1699,3.750551876379691,0.0,0.0
20453,2,453,[ 15 197 475 121  69],854,3,1702,3.748898678414097,0.0,0.0
20454,2,454,[144  70  98 302   7],416,5,1707,3.7516483516483516,0.0,20.0
20455,2,455,[168 568  82 294 475],417,4,1711,3.7521929824561404,0.0,0.0
20456,2,456,[271 117 294   7 191],505,2,1713,3.74835886214442,0.0,0.0
20457,2,457,[  7 135 202  64 385],618,4,1717,3.7489082969432315,20.0,0.0
20458,2,458,[ 15 125 173 197  69],416,5,1722,3.7516339869281046,0.0,0.0
20459,2,459,[111  96 117  69 588],705,3,1725,3.75,0.0,0.0
20460,2,460,[258 496 121 471 125],416,5,1730,3.752711496746204,0.0,0.0
20461,2,461,[202 211 289 210 568],43,5,1735,3.7554112554112553,0.0,0.0
20462,2,462,[ 11  97 245 265 678],297,2,1737,3.751619870410367,0.0,0.0
20463,2,463,[265 172 496  56 357],230,4,1741,3.752155172413793,0.0,0.0
20464,2,464,[173 216 423  11 357],417,4,1745,3.752688172043011,0.0,0.0
20465,2,465,[423 282 117 125 204],416,5,1750,3.755364806866953,0.0,0.0
20466,2,466,[286 357 181 172 197],373,3,1753,3.753747323340471,0.0,20.0
20467,2,467,[210 186  70  22  89],373,5,1758,3.7564102564102564,0.0,0.0
20468,2,468,[275 143 117 568 174],128,4,1762,3.7569296375266523,0.0,0.0
20469,2,469,[176 678 172 235 268],416,3,1765,3.75531914893617,0.0,0.0
20470,2,470,[ 50 204 132  12 423],405,5,1770,3.7579617834394905,20.0,20.0
20471,2,471,[ 82  97 210  69  88],128,4,1774,3.7584745762711864,0.0,0.0
20472,2,472,[301 197 257 210 286],297,3,1777,3.7568710359408035,0.0,0.0
20473,2,473,[211 323 286   4 508],417,2,1779,3.7531645569620253,0.0,0.0
20474,2,474,[ 69 265 176   7 197],618,4,1783,3.7536842105263157,0.0,0.0
20475,2,475,[195 323 181 168 288],805,2,1785,3.75,0.0,40.0
20476,2,476,[ 79 151 405 423  12],805,3,1788,3.748427672955975,20.0,0.0
20477,2,477,[  4 273  25 125   1],416,5,1793,3.7510460251046025,0.0,0.0
20478,2,478,[ 70 496  98 144 210],43,5,1798,3.7536534446764094,0.0,20.0
20479,2,479,[181 174 385 144 172],230,3,1801,3.752083333333333,0.0,20.0
20480,2,480,[ 89 151 222  95 191],297,2,1803,3.7484407484407485,0.0,0.0
20481,2,481,[ 22 289 153 197 273],854,3,1806,3.7468879668049793,0.0,0.0
20482,2,482,[173 127 100  25 748],416,5,1811,3.749482401656315,0.0,0.0
20483,2,483,[282 235  69 210  50],345,3,1814,3.7479338842975207,0.0,20.0
20484,2,484,[318 144 117  96 475],907,4,1818,3.7484536082474227,20.0,0.0
20485,2,485,[151 588 289 245 216],764,5,1823,3.751028806584362,0.0,0.0
20486,2,486,[132  71  50  69 597],642,4,1827,3.751540041067762,0.0,20.0
20487,2,487,[174  88 313  11 475],416,3,1830,3.75,20.0,20.0
20488,2,488,[125   7 179  97 176],416,4,1834,3.7505112474437627,0.0,0.0
20489,2,489,[151 603 125  22 300],416,4,1838,3.7510204081632654,0.0,0.0
20490,2,490,[  8 153 475 151 515],297,4,1842,3.75152749490835,0.0,0.0
20491,2,491,[238 179 195  22 603],373,4,1846,3.752032520325203,0.0,0.0
20492,2,492,[ 25   8 174 588 265],416,5,1851,3.7545638945233266,0.0,0.0
20493,2,493,[ 97 588 742 172 228],230,4,1855,3.7550607287449393,0.0,0.0
20494,2,494,[237 471 678   8 546],297,2,1857,3.7515151515151515,0.0,0.0
20495,2,495,[ 12 176 143  88  71],805,2,1859,3.747983870967742,20.0,0.0
20496,2,496,[328 135 276  70 238],62,3,1862,3.7464788732394365,0.0,0.0
20497,2,497,[180  97 403  11 182],198,3,1865,3.744979919678715,0.0,0.0
20498,2,498,[597 172  22 195 357],416,4,1869,3.7454909819639277,0.0,0.0
20499,2,499,[153 546 322 301 211],416,3,1872,3.744,0.0,0.0
20500,2,500,[ 25 328 275  82  71],416,5,1877,3.7465069860279443,0.0,0.0
20501,2,501,[405 144 302  71 276],62,2,1879,3.743027888446215,0.0,0.0
20502,2,502,[257 748 475 204 235],297,1,1880,3.737574552683897,0.0,0.0
20503,2,503,[187   4 132  69 405],198,3,1883,3.736111111111111,0.0,0.0
20504,2,504,[508 475  15 234 127],417,4,1887,3.736633663366337,0.0,0.0
20505,2,505,[204 216 153 222 257],654,5,1892,3.739130434782609,0.0,0.0
20506,2,506,[151  12 276   8 144],62,4,1896,3.739644970414201,20.0,0.0
20507,2,507,[403  12 471 100 275],373,2,1898,3.736220472440945,20.0,0.0
20508,2,508,[423 403 144  64 515],416,5,1903,3.7387033398821217,20.0,0.0
20509,2,509,[ 11 257 268 185 216],297,4,1907,3.73921568627451,0.0,0.0
20510,2,510,[228 471 125 117  11],505,3,1910,3.7377690802348336,0.0,0.0
20511,2,511,[ 15 269  12 195 678],416,4,1914,3.73828125,20.0,0.0
20512,2,512,[655 237  98 175 742],253,4,1918,3.7387914230019494,0.0,20.0
20513,2,513,[ 70 175 196 385 127],43,4,1922,3.7392996108949417,0.0,0.0
20514,2,514,[153   4  15 588 423],417,3,1925,3.737864077669903,0.0,0.0
20515,2,515,[204 568  12 144 257],654,5,1930,3.74031007751938,20.0,0.0
20516,2,516,[ 71 265 588 234  12],588,5,1935,3.7427466150870408,20.0,0.0
20517,2,517,[271 546 276 153 508],62,4,1939,3.7432432432432434,0.0,0.0
20518,2,518,[ 98 385   1 144  50],230,3,1942,3.7418111753371868,0.0,40.0
20519,2,519,[111 196 302  70  25],43,5,1947,3.7442307692307693,0.0,0.0
20520,2,520,[ 96 275 172  69 427],705,2,1949,3.740882917466411,0.0,0.0
20521,2,521,[ 89 385 323  56 173],805,4,1953,3.7413793103448274,0.0,0.0
20522,2,522,[427 191 172 180  11],214,4,1957,3.7418738049713194,0.0,0.0
20523,2,523,[  4 328 748 302  88],416,4,1961,3.7423664122137406,0.0,0.0
20524,2,524,[289   4  12 655 234],416,4,1965,3.742857142857143,20.0,0.0
20525,2,525,[286  82 238 234  56],437,3,1968,3.741444866920152,0.0,0.0
20526,2,526,[475 597 222 568 121],588,3,1971,3.740037950664137,0.0,0.0
20527,2,527,[405 237 496 191   4],764,3,1974,3.7386363636363638,0.0,0.0
20528,2,528,[143 172 471 568 215],416,5,1979,3.7410207939508506,0.0,0.0
20529,2,529,[173 181 182 191 435],505,0,1979,3.7339622641509433,0.0,20.0
20530,2,530,[183 405 273  71   4],62,4,1983,3.7344632768361583,0.0,0.0
20531,2,531,[ 97 215  71 176 191],618,5,1988,3.736842105263158,0.0,0.0
20532,2,532,[269 174  88 143 258],354,4,1992,3.7373358348968106,0.0,0.0
20533,2,533,[118 111 405 258 235],805,0,1992,3.730337078651685,0.0,0.0
20534,2,534,[185  70  95 200 143],262,1,1993,3.725233644859813,0.0,0.0
20535,2,535,[222 202   1  64   7],417,3,1996,3.7238805970149254,20.0,0.0
20536,2,536,[100 515 194 294 228],297,2,1998,3.7206703910614527,0.0,0.0
20537,2,537,[ 56 216 265 546 322],416,3,2001,3.7193308550185873,0.0,0.0
20538,2,538,[204 111   1  11 269],297,2,2003,3.7161410018552874,0.0,0.0
20539,2,539,[168   8 238 258 111],49,2,2005,3.712962962962963,0.0,0.0
20540,2,540,[174 269 318 328 275],43,5,2010,3.7153419593345656,20.0,0.0
20541,2,541,[  8 173 588 748 265],654,5,2015,3.717712177121771,0.0,0.0
20542,2,542,[742 161   7 302 210],416,5,2020,3.720073664825046,0.0,0.0
20543,2,543,[ 97 597 186 111 127],43,3,2023,3.71875,0.0,0.0
20544,2,544,[216 176 121 546  70],416,4,2027,3.7192660550458716,0.0,0.0
20545,2,545,[ 69 258 216 435 204],297,2,2029,3.7161172161172162,0.0,0.0
20546,2,546,[742 323 235  95 196],805,1,2030,3.7111517367458866,0.0,0.0
20547,2,547,[132 210 237  12  95],416,3,2033,3.70985401459854,20.0,0.0
20548,2,548,[ 25   7 100  88 273],618,4,2037,3.710382513661202,0.0,0.0
20549,2,549,[121 153 204  98  56],230,4,2041,3.710909090909091,0.0,20.0
20550,2,550,[195 216 597 144  89],417,2,2043,3.707803992740472,0.0,0.0
20551,2,551,[471 161 132 121 300],416,5,2048,3.710144927536232,0.0,0.0
20552,2,552,[288 427   8 471  97],618,2,2050,3.7070524412296564,0.0,20.0
20553,2,553,[ 12 204 196 117  98],654,5,2055,3.7093862815884475,20.0,20.0
20554,2,554,[  1 235 275 742 197],854,2,2057,3.706306306306306,0.0,0.0
20555,2,555,[191  56 151 161 496],416,4,2061,3.7068345323741005,0.0,0.0
20556,2,556,[357 318  64 483  12],62,5,2066,3.7091561938958706,80.0,0.0
20557,2,557,[196 268 182 180 174],128,3,2069,3.707885304659498,0.0,0.0
20558,2,558,[357 318 483  64  12],214,5,2074,3.710196779964222,80.0,0.0
20559,2,559,[568 265 121 187 234],198,1,2075,3.705357142857143,0.0,0.0
20560,2,560,[ 64 318 357 483  12],214,5,2080,3.7076648841354722,80.0,0.0
20561,2,561,[ 64 100 182 496 318],214,5,2085,3.709964412811388,40.0,0.0
20562,2,562,[357 318 483  64  12],601,4,2089,3.710479573712256,80.0,0.0
20563,2,563,[318 271 182 288 286],907,5,2094,3.7127659574468086,20.0,20.0
20564,2,564,[323 111 603  12 294],416,4,2098,3.713274336283186,20.0,0.0
20565,2,565,[  8 143   4  89 742],805,1,2099,3.708480565371025,0.0,0.0
20566,2,566,[100   4 245 318 228],62,3,2102,3.707231040564374,20.0,0.0
20567,2,567,[471  11 172 403  12],345,3,2105,3.7059859154929575,20.0,0.0
20568,2,568,[269 294   1 742 403],805,3,2108,3.704745166959578,0.0,0.0
20569,2,569,[508 237  64 144  69],854,3,2111,3.7035087719298247,20.0,0.0
20570,2,570,[603  28 151 111 269],416,4,2115,3.7040280210157617,0.0,0.0
20571,2,571,[197 151   8  97 216],354,2,2117,3.7010489510489513,0.0,0.0
20572,2,572,[228  64  69  56 333],721,3,2120,3.699825479930192,20.0,0.0
20573,2,573,[ 15 300 275  28 496],43,5,2125,3.702090592334495,0.0,0.0
20574,2,574,[173 302 276 216 257],62,3,2128,3.7008695652173915,0.0,0.0
20575,2,575,[191 258  12 546 423],417,4,2132,3.701388888888889,20.0,0.0
20576,2,576,[ 28 515 238 300  69],297,3,2135,3.700173310225303,0.0,0.0
20577,2,577,[100 187 288 228  71],887,4,2139,3.7006920415224913,0.0,20.0
20578,2,578,[ 22 127 228  88 294],805,0,2139,3.694300518134715,0.0,0.0
20579,2,579,[216  70 655 132 276],416,4,2143,3.6948275862068964,0.0,0.0
20580,2,580,[ 82 179 168 204 588],49,3,2146,3.693631669535284,0.0,0.0
20581,2,581,[403 144 313 265 117],588,3,2149,3.6924398625429555,20.0,20.0
20582,2,582,[181 111 288  25 301],907,5,2154,3.694682675814751,0.0,40.0
20583,2,583,[405 100 222  11 135],417,1,2155,3.690068493150685,0.0,0.0
20584,2,584,[182 328 161 153 568],416,5,2160,3.6923076923076925,0.0,0.0
20585,2,585,[289 423 183 357 742],416,4,2164,3.6928327645051193,0.0,0.0
20586,2,586,[323  11 118 748 195],198,1,2165,3.68824531516184,0.0,0.0
20587,2,587,[210 257 269 185 183],297,4,2169,3.688775510204082,0.0,0.0
20588,2,588,[143  69 173 144 153],416,5,2174,3.6910016977928692,0.0,0.0
20589,2,589,[ 88 179 222 288 475],805,3,2177,3.6898305084745764,0.0,20.0
20590,2,590,[678 216 211   4   8],297,3,2180,3.688663282571912,0.0,0.0
20591,2,591,[100 181 258 200 275],262,2,2182,3.685810810810811,0.0,20.0
20592,2,592,[100  95 143  25 180],805,2,2184,3.6829679595278244,0.0,0.0
20593,2,593,[313 268 185 318 748],416,5,2189,3.685185185185185,40.0,20.0
20594,2,594,[ 56 275 195 191 135],62,5,2194,3.687394957983193,0.0,0.0
20595,2,595,[ 69 127 546 405 588],417,1,2195,3.6828859060402683,0.0,0.0
20596,2,596,[405 210 269 588 174],654,5,2200,3.6850921273031827,0.0,0.0
20597,2,597,[357 135 118 483 196],417,4,2204,3.68561872909699,20.0,0.0
20598,2,598,[245 301 294  98 603],416,4,2208,3.686143572621035,0.0,20.0
20599,2,599,[182 471 237 435 302],297,2,2210,3.683333333333333,0.0,0.0
20600,2,600,[117 655 748 294 328],416,5,2215,3.6855241264559067,0.0,0.0
20601,2,601,[183 300   1 176  89],297,3,2218,3.6843853820598005,0.0,0.0
20602,2,602,[655 183 121 475   4],417,3,2221,3.683250414593698,0.0,0.0
20603,2,603,[ 50 427 228 508 143],128,4,2225,3.683774834437086,0.0,20.0
20604,2,604,[  7 328 405 294 385],416,5,2230,3.6859504132231407,0.0,0.0
20605,2,605,[211 427 197 288  12],405,4,2234,3.6864686468646863,20.0,20.0
20606,2,606,[202 215 195 183 237],297,2,2236,3.683690280065898,0.0,0.0
20607,2,607,[196 276 268  70  11],314,2,2238,3.6809210526315788,0.0,0.0
20608,2,608,[276 182 742 228 100],230,3,2241,3.6798029556650245,0.0,0.0
20609,2,609,[151  95 125 471 245],505,3,2244,3.678688524590164,0.0,0.0
20610,2,610,[ 70 143   1 302  11],297,4,2248,3.679214402618658,0.0,0.0
20611,2,611,[ 97 191 195  69 174],62,4,2252,3.679738562091503,0.0,0.0
20612,2,612,[153 215 210 172 333],416,5,2257,3.6818923327895594,0.0,0.0
20613,2,613,[423 172 258 191 496],642,3,2260,3.6807817589576546,0.0,0.0
20614,2,614,[200 132 121 204 588],416,5,2265,3.682926829268293,0.0,0.0
20615,2,615,[288  22 172 508 748],654,3,2268,3.6818181818181817,0.0,20.0
20616,2,616,[ 96 132 273 235 271],62,4,2272,3.6823338735818476,0.0,0.0
20617,2,617,[222  97 268 235  22],297,4,2276,3.6828478964401294,0.0,0.0
20618,2,618,[127   8 196 269 496],43,5,2281,3.6849757673667205,0.0,0.0
20619,2,619,[403   4 211 172  97],373,3,2284,3.6838709677419357,0.0,0.0
20620,2,620,[323  95   8 185   1],223,2,2286,3.681159420289855,0.0,0.0
20621,2,621,[117 265 179 125 161],373,4,2290,3.6816720257234725,0.0,0.0
20622,2,622,[200  82 228 174 276],198,2,2292,3.678972712680578,0.0,0.0
20623,2,623,[655 234  95 597 286],588,4,2296,3.6794871794871793,0.0,0.0
20624,2,624,[475 179 288 125  96],601,2,2298,3.6768,0.0,20.0
20625,2,625,[118 194 655  95 168],751,3,2301,3.6757188498402558,0.0,0.0
20626,2,626,[328 222 258 678 125],708,3,2304,3.674641148325359,0.0,0.0
20627,2,627,[195 186 257  70 238],417,4,2308,3.6751592356687897,0.0,0.0
20628,2,628,[ 97 181 508 288 125],62,3,2311,3.674085850556439,0.0,40.0
20629,2,629,[273 222  98 288 195],630,5,2316,3.676190476190476,0.0,40.0
20630,2,630,[121  22 215 269 257],711,2,2318,3.6735340729001584,0.0,0.0
20631,2,631,[294 238  79 121 655],416,5,2323,3.675632911392405,0.0,0.0
20632,2,632,[245 655   1 475 168],62,2,2325,3.6729857819905214,0.0,0.0
20633,2,633,[132 237 182 405 117],62,3,2328,3.67192429022082,0.0,0.0
20634,2,634,[302  71   8  70 210],654,4,2332,3.6724409448818895,0.0,0.0
20635,2,635,[ 95  70 195 211 265],297,2,2334,3.669811320754717,0.0,0.0
20636,2,636,[ 25 508 588 257 191],417,1,2335,3.6656200941915227,0.0,0.0
20637,2,637,[127 151  79 185 318],618,4,2339,3.666144200626959,20.0,0.0
20638,2,638,[475 328  96 385 742],416,4,2343,3.6666666666666665,0.0,0.0
20639,2,639,[132 258 172 546 597],417,2,2345,3.6640625,0.0,0.0
20640,2,640,[210 245 144 125 276],416,3,2348,3.6630265210608424,0.0,0.0
20641,2,641,[161 143  69  25 568],711,3,2351,3.661993769470405,0.0,0.0
20642,2,642,[179  96  64 323 403],416,3,2354,3.660964230171073,20.0,0.0
20643,2,643,[ 25 216 202 742 588],230,4,2358,3.6614906832298137,0.0,0.0
20644,2,644,[ 22 191 175 288 174],214,3,2361,3.66046511627907,0.0,20.0
20645,2,645,[132 257   1 168   4],854,2,2363,3.6578947368421053,0.0,0.0
20646,2,646,[237 153  70 117 403],416,4,2367,3.6584234930448223,0.0,0.0
20647,2,647,[257 294 151  12 127],214,3,2370,3.6574074074074074,20.0,0.0
20648,2,648,[ 22 117 597 144 132],588,4,2374,3.657935285053929,0.0,0.0
20649,2,649,[323  22 546 568 151],805,2,2376,3.6553846153846155,0.0,0.0
20650,2,650,[588 328 301   4  11],416,5,2381,3.6574500768049156,0.0,0.0
20651,2,651,[ 12 403 603 179 597],416,3,2384,3.6564417177914113,20.0,0.0
20652,2,652,[ 95 678 655  70 282],416,3,2387,3.655436447166922,0.0,0.0
20653,2,653,[ 56   9   1  25 172],345,3,2390,3.654434250764526,0.0,0.0
20654,2,654,[ 88 265  11 153 268],416,4,2394,3.6549618320610686,0.0,0.0
20655,2,655,[191 546 515  97  22],416,4,2398,3.6554878048780486,0.0,0.0
20656,2,656,[176 127   8 202 597],416,4,2402,3.6560121765601217,0.0,0.0
20657,2,657,[234 117  97 135 173],198,2,2404,3.653495440729483,0.0,0.0
20658,2,658,[742  71 117 121 385],345,2,2406,3.6509863429438543,0.0,0.0
20659,2,659,[181 385 222  64 496],417,2,2408,3.6484848484848484,20.0,20.0
20660,2,660,[204 385 275 655  82],373,3,2411,3.6475037821482603,0.0,0.0
20661,2,661,[  1 496 196  11 100],230,5,2416,3.6495468277945617,0.0,0.0
20662,2,662,[322 216   8   1  22],314,4,2420,3.650075414781297,0.0,0.0
20663,2,663,[  9 268 194  95 300],416,4,2424,3.6506024096385543,0.0,0.0
20664,2,664,[172 405 191 179  56],62,4,2428,3.651127819548872,0.0,0.0
20665,2,665,[275  97 475  71 265],711,3,2431,3.65015015015015,0.0,0.0
20666,2,666,[176 357 403 186  82],417,5,2436,3.652173913043478,0.0,0.0
20667,2,667,[ 22 185 258  50 168],416,5,2441,3.654191616766467,0.0,20.0
20668,2,668,[  4  56  15 144   8],43,5,2446,3.656203288490284,0.0,0.0
20669,2,669,[117  12 216 161 275],437,3,2449,3.6552238805970148,20.0,0.0
20670,2,670,[427 210 318 161 265],705,4,2453,3.6557377049180326,20.0,0.0
20671,2,671,[427   9 196 245 187],416,4,2457,3.65625,0.0,0.0
20672,2,672,[301 269 286   7 210],416,5,2462,3.6582466567607725,0.0,0.0
20673,2,673,[143 222 176  95 238],297,4,2466,3.658753709198813,0.0,0.0
20674,2,674,[211   9 603 143 196],354,2,2468,3.656296296296296,0.0,0.0
20675,2,675,[546 132 288  96  70],262,2,2470,3.6538461538461537,0.0,20.0
20676,2,676,[588 288 151 313 143],618,3,2473,3.65288035450517,20.0,40.0
20677,2,677,[151 121   9  28  69],314,5,2478,3.6548672566371683,0.0,0.0
20678,2,678,[257   8  22 121 588],601,1,2479,3.6509572901325478,0.0,0.0
20679,2,679,[496 153 742 222 173],417,2,2481,3.648529411764706,0.0,0.0
20680,2,680,[216 135  71 181  12],805,2,2483,3.6461086637298092,20.0,20.0
20681,2,681,[121 288 180 111   8],887,5,2488,3.6480938416422286,0.0,20.0
20682,2,682,[328  89 385  79 180],373,3,2491,3.6471449487554906,0.0,0.0
20683,2,683,[151 121  50 117 176],764,4,2495,3.6476608187134505,0.0,20.0
20684,2,684,[ 64 172 196 132 289],416,4,2499,3.6481751824817517,20.0,0.0
20685,2,685,[313 174  28  25 597],588,4,2503,3.6486880466472305,20.0,20.0
20686,2,686,[423 235  12 294 288],854,3,2506,3.6477438136826783,20.0,20.0
20687,2,687,[194 144 172 286  15],416,5,2511,3.6497093023255816,0.0,0.0
20688,2,688,[588 210 211 265 172],437,2,2513,3.647314949201742,0.0,0.0
20689,2,689,[185 168 135 508 318],854,5,2518,3.6492753623188405,20.0,0.0
20690,2,690,[742   4 748 318 172],642,3,2521,3.6483357452966714,20.0,0.0
20691,2,691,[ 50 265 222 275 202],711,3,2524,3.647398843930636,0.0,20.0
20692,2,692,[228  71 176 403 135],62,4,2528,3.647907647907648,0.0,0.0
20693,2,693,[117 471 258 515  97],416,5,2533,3.64985590778098,0.0,0.0
20694,2,694,[237 118 111   9 318],416,3,2536,3.6489208633093524,20.0,0.0
20695,2,695,[258  96 211 202  25],417,3,2539,3.6479885057471266,0.0,0.0
20696,2,696,[211 168  15  25 403],43,5,2544,3.649928263988522,0.0,0.0
20697,2,697,[173  56  79 200 176],416,5,2549,3.651862464183381,0.0,0.0
20698,2,698,[271  28 210  79 191],805,2,2551,3.6494992846924177,0.0,0.0
20699,2,699,[323 269  71 215 111],345,3,2554,3.6485714285714286,0.0,0.0
20700,2,700,[ 98 568 132  96 496],253,5,2559,3.6504992867332384,0.0,20.0
20701,2,701,[508  25 328 496 322],314,3,2562,3.6495726495726495,0.0,0.0
20702,2,702,[  4 273 176 132 286],416,5,2567,3.65149359886202,0.0,0.0
20703,2,703,[269 302 435 245  28],297,3,2570,3.6505681818181817,0.0,0.0
20704,2,704,[186 195 235  70 568],417,3,2573,3.649645390070922,0.0,0.0
20705,2,705,[  4  15  95 328 496],43,5,2578,3.651558073654391,0.0,0.0
20706,2,706,[288 151 173 143 100],907,5,2583,3.6534653465346536,0.0,20.0
20707,2,707,[475  97  50   9 294],62,3,2586,3.652542372881356,0.0,20.0
20708,2,708,[204  50  56  11 294],345,4,2590,3.6530324400564176,0.0,20.0
20709,2,709,[ 25 318 568 258 204],654,4,2594,3.6535211267605634,20.0,0.0
20710,2,710,[ 22 172 197  25 215],416,5,2599,3.6554149085794654,0.0,0.0
20711,2,711,[  8 286   1 275 121],854,2,2601,3.6530898876404496,0.0,0.0
20712,2,712,[151   7 175 168 174],805,4,2605,3.653576437587658,0.0,0.0
20713,2,713,[271 234 168   8 515],297,3,2608,3.65266106442577,0.0,0.0
20714,2,714,[187   8  79 282 151],618,2,2610,3.6503496503496504,0.0,0.0
20715,2,715,[191 117  64  97 168],373,4,2614,3.6508379888268156,20.0,0.0
20716,2,716,[173 742 385 144 328],505,3,2617,3.6499302649930265,0.0,0.0
20717,2,717,[121 318  25 185 276],223,2,2619,3.647632311977716,20.0,0.0
20718,2,718,[271 222 471 483  25],854,3,2622,3.64673157162726,20.0,0.0
20719,2,719,[200 237 238 176 318],437,4,2626,3.647222222222222,20.0,0.0
20720,2,720,[318 471 301 196 174],721,5,2631,3.649098474341193,20.0,0.0
20721,2,721,[ 95  97 143 173 176],416,4,2635,3.649584487534626,0.0,0.0
20722,2,722,[ 96 257 168 385 195],416,4,2639,3.6500691562932226,0.0,0.0
20723,2,723,[127 313 174 238 143],618,4,2643,3.6505524861878453,20.0,20.0
20724,2,724,[211  70  22 588 202],38,3,2646,3.649655172413793,0.0,0.0
20725,2,725,[515 210 173 151 135],297,4,2650,3.650137741046832,0.0,0.0
20726,2,726,[237 588 483 125  56],618,4,2654,3.6506189821182944,20.0,0.0
20727,2,727,[257 168 121 179  11],751,4,2658,3.651098901098901,0.0,0.0
20728,2,728,[144   8 111 210 546],416,4,2662,3.651577503429355,0.0,0.0
20729,2,729,[ 97  79 174   9 276],618,3,2665,3.6506849315068495,0.0,0.0
20730,2,730,[ 96 183 333  56 318],496,3,2668,3.649794801641587,20.0,0.0
20731,2,731,[286  79 403 289 222],43,5,2673,3.651639344262295,0.0,0.0
20732,2,732,[181 597 238 237 588],751,2,2675,3.649386084583902,0.0,20.0
20733,2,733,[ 64 265 282 182 258],128,3,2678,3.64850136239782,20.0,0.0
20734,2,734,[300  25 268 301 276],416,4,2682,3.6489795918367345,0.0,0.0
20735,2,735,[186 210 195  11 322],417,3,2685,3.6480978260869565,0.0,0.0
20736,2,736,[  7 153  22 168 357],297,5,2690,3.649932157394844,0.0,0.0
20737,2,737,[405 748 385 118  88],345,2,2692,3.6476964769647697,0.0,0.0
20738,2,738,[ 56 508 302 191  71],345,4,2696,3.648173207036536,0.0,0.0
20739,2,739,[ 50 153 202 597 118],43,4,2700,3.6486486486486487,0.0,20.0
20740,2,740,[655 186   4 475 228],417,3,2703,3.6477732793522266,0.0,0.0
20741,2,741,[196  11 300 204 144],43,5,2708,3.6495956873315363,0.0,0.0
20742,2,742,[258 238 216   8 496],43,4,2712,3.6500672947510093,0.0,0.0
20743,2,743,[588  25 257 174  12],417,1,2713,3.646505376344086,20.0,0.0
20744,2,744,[176 185 748  25  89],297,4,2717,3.646979865771812,0.0,0.0
20745,2,745,[385 176 483   1 742],417,4,2721,3.6474530831099194,20.0,0.0
20746,2,746,[427 215 258 181 168],711,4,2725,3.647925033467202,0.0,20.0
20747,2,747,[ 95 182 168  82 742],417,4,2729,3.6483957219251337,0.0,0.0
20748,2,748,[210 742 508 258 475],62,4,2733,3.6488651535380505,0.0,0.0
20749,2,749,[ 28 496 196 172 288],416,5,2738,3.6506666666666665,0.0,20.0
20750,2,750,[ 79 245 357  98 475],417,4,2742,3.651131824234354,0.0,20.0
20751,2,751,[ 15 742 238 222 405],417,2,2744,3.648936170212766,0.0,0.0
20752,2,752,[235 135 435 301 153],297,3,2747,3.648074369189907,0.0,0.0
20753,2,753,[215  88 265 603 183],405,1,2748,3.6445623342175066,0.0,0.0
20754,2,754,[ 82 655 135 196 275],437,4,2752,3.6450331125827815,0.0,0.0
20755,2,755,[ 22 235 282 471 151],854,1,2753,3.6415343915343916,0.0,0.0
20756,2,756,[603 655  79 132 245],128,2,2755,3.6393659180977544,0.0,0.0
20757,2,757,[588 200 328  12   7],49,3,2758,3.638522427440633,20.0,0.0
20758,2,758,[204 143 423 228 235],297,1,2759,3.635046113306983,0.0,0.0
20759,2,759,[ 50 265  95 245 471],416,3,2762,3.6342105263157896,0.0,20.0
20760,2,760,[211 588 194 234 175],297,3,2765,3.633377135348226,0.0,0.0
20761,2,761,[405 276 300 161 125],416,4,2769,3.6338582677165356,0.0,0.0
20762,2,762,[269 286  64 185 144],854,3,2772,3.63302752293578,20.0,0.0
20763,2,763,[118 568  98 210 204],588,3,2775,3.6321989528795813,0.0,20.0
20764,2,764,[ 97 176 100 153 257],417,3,2778,3.631372549019608,0.0,0.0
20765,2,765,[257 143 238 196 185],354,2,2780,3.629242819843342,0.0,0.0
20766,2,766,[ 89 265 302 210 273],297,4,2784,3.6297262059973923,0.0,0.0
20767,2,767,[238 200  28 194  25],297,3,2787,3.62890625,0.0,0.0
20768,2,768,[161 181 257 403 222],705,5,2792,3.6306892067620287,0.0,20.0
20769,2,769,[111  89 144 197  15],437,2,2794,3.6285714285714286,0.0,0.0
20770,2,770,[655 179  71 238  82],405,3,2797,3.627756160830091,0.0,0.0
20771,2,771,[  1 172 195 222 597],630,4,2801,3.628238341968912,0.0,0.0
20772,2,772,[423 288 117   7 748],416,5,2806,3.630012936610608,0.0,20.0
20773,2,773,[471 127 111 204  56],887,3,2809,3.6291989664082687,0.0,0.0
20774,2,774,[216 294 210 333 143],416,5,2814,3.6309677419354838,0.0,0.0
20775,2,775,[117  82 405 313  28],43,5,2819,3.6327319587628866,20.0,20.0
20776,2,776,[234 111  69 423 483],618,4,2823,3.6332046332046333,20.0,0.0
20777,2,777,[ 22 423 603 228 435],698,1,2824,3.6298200514138816,0.0,0.0
20778,2,778,[475 191 153  89 222],198,4,2828,3.6302952503209243,0.0,0.0
20779,2,779,[228  22 322 153   8],721,5,2833,3.632051282051282,0.0,0.0
20780,2,780,[211 216 288 121 235],416,4,2837,3.6325224071702946,0.0,20.0
20781,2,781,[216  56   9 742 176],805,2,2839,3.630434782608696,0.0,0.0
20782,2,782,[ 82 210   8 173 174],805,1,2840,3.627075351213282,0.0,0.0
20783,2,783,[271  56  97   1  12],62,2,2842,3.625,20.0,0.0
20784,2,784,[111 200  56 180 196],437,4,2846,3.6254777070063695,0.0,0.0
20785,2,785,[  9  70 186 588 403],43,4,2850,3.6259541984732824,0.0,0.0
20786,2,786,[168  79 202 515 183],405,2,2852,3.6238881829733165,0.0,0.0
20787,2,787,[185 294 257 235 403],417,2,2854,3.6218274111675126,0.0,0.0
20788,2,788,[111 288 318 118 125],274,5,2859,3.623574144486692,20.0,20.0
20789,2,789,[515 195  96 288  12],417,3,2862,3.6227848101265825,20.0,20.0
20790,2,790,[385 172 294 568 194],698,4,2866,3.6232616940581543,0.0,0.0
20791,2,791,[ 25  69   8 100 175],43,4,2870,3.6237373737373737,0.0,0.0
20792,2,792,[289 179 151 742 185],416,2,2872,3.621689785624212,0.0,0.0
20793,2,793,[151 286 294 385 173],416,4,2876,3.6221662468513856,0.0,0.0
20794,2,794,[186 405 127 100 275],854,4,2880,3.6226415094339623,0.0,0.0
20795,2,795,[496 282  82 313 300],416,5,2885,3.6243718592964824,20.0,20.0
20796,2,796,[471 181  22 196 597],618,4,2889,3.6248431618569636,0.0,20.0
20797,2,797,[117 385 118 143 357],198,1,2890,3.6215538847117794,0.0,0.0
20798,2,798,[135 118 117 196  15],62,3,2893,3.620775969962453,0.0,0.0
20799,2,799,[ 97 483 111 234 172],588,3,2896,3.62,20.0,0.0
20800,2,800,[ 25 318 655 210 196],416,5,2901,3.6217228464419478,20.0,0.0
20801,2,801,[204 132 173 313  50],734,3,2904,3.6209476309226933,20.0,40.0
20802,2,802,[172  11 258  69 216],345,5,2909,3.62266500622665,0.0,0.0
20803,2,803,[216   8 423 276 202],354,2,2911,3.620646766169154,0.0,0.0
20804,2,804,[ 88 210 678 286 333],588,4,2915,3.62111801242236,0.0,0.0
20805,2,805,[ 56   9 276 195 357],416,4,2919,3.6215880893300247,0.0,0.0
20806,2,806,[302 211 328 258 181],416,5,2924,3.6232961586121437,0.0,20.0
20807,2,807,[185   1 273 197 302],416,5,2929,3.625,0.0,0.0
20808,2,808,[ 95 197 176 435 127],405,2,2931,3.622991347342398,0.0,0.0
20809,2,809,[257  95 403 180 301],711,4,2935,3.623456790123457,0.0,0.0
20810,2,810,[174  82  95  98 405],198,2,2937,3.6214549938347718,0.0,20.0
20811,2,811,[132 161 655 508 181],345,4,2941,3.62192118226601,0.0,20.0
20812,2,812,[403 179  69 127 194],405,3,2944,3.6211562115621154,0.0,0.0
20813,2,813,[196 568 265   8 180],405,2,2946,3.619164619164619,0.0,0.0
20814,2,814,[273 475 655 173 176],417,4,2950,3.6196319018404908,0.0,0.0
20815,2,815,[200 204 294 475 603],805,3,2953,3.6188725490196076,0.0,0.0
20816,2,816,[143  70 215  56 276],198,2,2955,3.616891064871481,0.0,0.0
20817,2,817,[196 235 173   7  88],805,2,2957,3.6149144254278727,0.0,0.0
20818,2,818,[182  22  71 258 318],62,5,2962,3.6166056166056166,20.0,0.0
20819,2,819,[191 403 174 135 195],62,5,2967,3.618292682926829,0.0,0.0
20820,2,820,[357 748 275 385 125],373,4,2971,3.6187576126674785,0.0,0.0
20821,2,821,[135  50 427 210 191],698,2,2973,3.616788321167883,0.0,20.0
20822,2,822,[385 302  50 597 202],417,2,2975,3.614823815309842,0.0,20.0
20823,2,823,[100 294 125 603 471],416,5,2980,3.616504854368932,0.0,0.0
20824,2,824,[ 82 597 151  97 475],417,4,2984,3.616969696969697,0.0,0.0
20825,2,825,[275 211 153 288 215],416,5,2989,3.6186440677966103,0.0,20.0
20826,2,826,[ 56 100 195 168 742],417,3,2992,3.617896009673519,0.0,0.0
20827,2,827,[153 273  79 176 216],854,3,2995,3.617149758454106,0.0,0.0
20828,2,828,[ 56   7 117 483 174],854,3,2998,3.6164053075995173,20.0,0.0
20829,2,829,[ 12   4  11   9 238],416,5,3003,3.6180722891566264,20.0,0.0
20830,2,830,[173 655 222 191 210],805,3,3006,3.6173285198555956,0.0,0.0
20831,2,831,[258 135 191 175 234],297,3,3009,3.6165865384615383,0.0,0.0
20832,2,832,[588 174 168 265 471],922,3,3012,3.6158463385354143,0.0,0.0
20833,2,833,[ 11 322 268 238 269],854,3,3015,3.615107913669065,0.0,0.0
20834,2,834,[181 183 173   7 423],618,4,3019,3.615568862275449,0.0,20.0
20835,2,835,[403 258  71  12 496],43,5,3024,3.617224880382775,20.0,0.0
20836,2,836,[ 50  25 161 173 197],128,4,3028,3.6176821983273597,0.0,20.0
20837,2,837,[174  11 121 173 475],417,3,3031,3.616945107398568,0.0,0.0
20838,2,838,[151 180 117 508 179],417,4,3035,3.6174016686531587,0.0,0.0
20839,2,839,[ 89 168  22 603 435],698,2,3037,3.6154761904761905,0.0,0.0
20840,2,840,[ 88   1 245 132 182],505,3,3040,3.61474435196195,0.0,0.0
20841,2,841,[180 546 318 127 181],62,5,3045,3.616389548693587,20.0,20.0
20842,2,842,[228 118 357 265 301],297,2,3047,3.6144721233689205,0.0,0.0
20843,2,843,[275 742 183 245 118],297,2,3049,3.612559241706161,0.0,0.0
20844,2,844,[195 237  82 423   1],416,4,3053,3.61301775147929,0.0,0.0
20845,2,845,[235  69 168  56 182],417,3,3056,3.6122931442080377,0.0,0.0
20846,2,846,[603   7  12 111 742],416,5,3061,3.613931523022432,20.0,0.0
20847,2,847,[588 568 185 357 135],230,3,3064,3.6132075471698113,0.0,0.0
20848,2,848,[216  97 301 210 289],43,5,3069,3.614840989399293,0.0,0.0
20849,2,849,[174 132   8 258 302],416,5,3074,3.6164705882352943,0.0,0.0
20850,2,850,[215  98 200 187  79],198,4,3078,3.616921269095182,0.0,20.0
20851,2,851,[ 25 121 471  97 151],43,4,3082,3.6173708920187795,0.0,0.0
20852,2,852,[132  69 238  71 179],198,4,3086,3.6178194607268463,0.0,0.0
20853,2,853,[121  88 191 282 496],416,4,3090,3.6182669789227164,0.0,0.0
20854,2,854,[258 275  98 423  15],262,4,3094,3.6187134502923977,0.0,20.0
20855,2,855,[288 323  50 238 655],805,3,3097,3.6179906542056073,0.0,40.0
20856,2,856,[302  98  12 144   1],654,5,3102,3.6196032672112017,20.0,20.0
20857,2,857,[204 182 300 269  79],416,5,3107,3.621212121212121,0.0,0.0
20858,2,858,[385 496 180   7  50],417,2,3109,3.619324796274738,0.0,20.0
20859,2,859,[ 95  25 117 276  97],43,5,3114,3.6209302325581394,0.0,0.0
20860,2,860,[  1 475 200 603 286],416,4,3118,3.62137049941928,0.0,0.0
20861,2,861,[143 268 234 678  22],297,3,3121,3.620649651972158,0.0,0.0
20862,2,862,[385 228 742 127  22],805,0,3121,3.6164542294322133,0.0,0.0
20863,2,863,[153  71 271 323 144],43,3,3124,3.615740740740741,0.0,0.0
20864,2,864,[135 313  88 196 238],405,3,3127,3.615028901734104,20.0,20.0
20865,2,865,[ 56 423 322 742 288],805,1,3128,3.612009237875289,0.0,20.0
20866,2,866,[423 603  70   8  88],416,4,3132,3.612456747404844,0.0,0.0
20867,2,867,[  7 496  64 294 313],416,5,3137,3.6140552995391704,40.0,20.0
20868,2,868,[100  12 269 294  50],43,5,3142,3.615650172612198,20.0,20.0
20869,2,869,[294 237 168 597 385],588,3,3145,3.6149425287356323,0.0,0.0
20870,2,870,[186  98 275 216 153],354,2,3147,3.61308840413318,0.0,20.0
20871,2,871,[475  28  96 288 258],805,2,3149,3.6112385321100917,0.0,20.0
20872,2,872,[ 64 588 132 258 275],416,5,3154,3.6128293241695304,20.0,0.0
20873,2,873,[ 11  89 245 515 176],297,4,3158,3.6132723112128144,0.0,0.0
20874,2,874,[151 546 202  69 588],297,1,3159,3.6102857142857143,0.0,0.0
20875,2,875,[288 276 183 237 180],62,3,3162,3.6095890410958904,0.0,20.0
20876,2,876,[  7 475 423  71 678],805,3,3165,3.6088939566704674,0.0,0.0
20877,2,877,[132 179 748 211 286],417,5,3170,3.6104783599088837,0.0,0.0
20878,2,878,[  1 294  95  70  28],262,1,3171,3.6075085324232083,0.0,0.0
20879,2,879,[161 282 204 257 276],416,3,3174,3.606818181818182,0.0,0.0
20880,2,880,[181 216  79 179 288],405,3,3177,3.606129398410897,0.0,40.0
20881,2,881,[323 385 173 597 742],43,3,3180,3.6054421768707483,0.0,0.0
20882,2,882,[ 15 186 211 118 423],417,5,3185,3.607021517553794,0.0,0.0
20883,2,883,[200 197 286 588 475],437,2,3187,3.6052036199095023,0.0,0.0
20884,2,884,[357 597  50  12 245],416,3,3190,3.6045197740112993,20.0,20.0
20885,2,885,[216 202 161  50   4],345,3,3193,3.6038374717832955,0.0,20.0
20886,2,886,[196 216 238  64 100],618,3,3196,3.6031567080045095,20.0,0.0
20887,2,887,[195  88 282 238 168],416,4,3200,3.6036036036036037,0.0,0.0
20888,2,888,[ 15 588 216 132 200],618,3,3203,3.6029246344206975,0.0,0.0
20889,2,889,[ 56  11 655  64 333],416,5,3208,3.6044943820224717,20.0,0.0
20890,2,890,[216 568 183  82 173],62,4,3212,3.6049382716049383,0.0,0.0
20891,2,891,[ 64 215 294  69 286],416,5,3217,3.6065022421524664,20.0,0.0
20892,2,892,[678 172 127 222  82],805,3,3220,3.6058230683090704,0.0,0.0
20893,2,893,[211 265 471 210 300],416,5,3225,3.6073825503355703,0.0,0.0
20894,2,894,[168 276 173   1 127],922,2,3227,3.605586592178771,0.0,0.0
20895,2,895,[191 111   1 323  70],417,3,3230,3.6049107142857144,0.0,0.0
20896,2,896,[ 97 302  22 237 322],721,3,3233,3.6042363433667783,0.0,0.0
20897,2,897,[257 328 196 275   1],921,2,3235,3.6024498886414253,0.0,0.0
20898,2,898,[238 117 300   1   9],345,3,3238,3.6017797552836486,0.0,0.0
20899,2,899,[282 328 318  69 127],416,5,3243,3.6033333333333335,20.0,0.0
20900,2,900,[172 597 333 174  88],416,3,3246,3.6026637069922307,0.0,0.0
20901,2,901,[ 12 127 195 181 273],417,3,3249,3.6019955654101996,20.0,20.0
20902,2,902,[546 588 216 271 471],297,2,3251,3.600221483942414,0.0,0.0
20903,2,903,[ 28 405 172 237 211],416,4,3255,3.600663716814159,0.0,0.0
20904,2,904,[ 71 202 195 568 100],416,5,3260,3.6022099447513813,0.0,0.0
20905,2,905,[ 56 176 100   7 268],297,5,3265,3.6037527593818983,0.0,0.0
20906,2,906,[ 11 222  56 742  69],43,5,3270,3.6052921719955897,0.0,0.0
20907,2,907,[237 228 196  22  82],62,3,3273,3.604625550660793,0.0,0.0
20908,2,908,[200 173 597 202 357],805,3,3276,3.603960396039604,0.0,0.0
20909,2,909,[245   8 211 197 132],416,4,3280,3.6043956043956045,0.0,0.0
20910,2,910,[186 288  64 181 483],496,3,3283,3.6037321624588365,40.0,40.0
20911,2,911,[546 275 302 187 328],416,4,3287,3.6041666666666665,0.0,0.0
20912,2,912,[ 11 597 318 161 143],314,5,3292,3.605695509309967,20.0,0.0
20913,2,913,[427 328 143  25 276],128,3,3295,3.605032822757112,0.0,0.0
20914,2,914,[302 118 121 276 258],43,5,3300,3.6065573770491803,0.0,0.0
20915,2,915,[294 496 237 427 655],128,4,3304,3.606986899563319,0.0,0.0
20916,2,916,[ 97 588 603 385 282],416,5,3309,3.608505997818975,0.0,0.0
20917,2,917,[151  22 144   9 318],62,4,3313,3.6089324618736383,20.0,0.0
20918,2,918,[328 111   8 135 172],62,3,3316,3.6082698585418935,0.0,0.0
20919,2,919,[ 22 222 282 273 183],297,4,3320,3.608695652173913,0.0,0.0
20920,2,920,[678 196 237 302 282],297,3,3323,3.6080347448425623,0.0,0.0
20921,2,921,[181  28 111 210 742],345,4,3327,3.608459869848156,0.0,20.0
20922,2,922,[200 258 181 196 238],198,4,3331,3.6088840736728063,0.0,20.0
20923,2,923,[245 151 195 191 423],505,2,3333,3.607142857142857,0.0,0.0
20924,2,924,[195 288 385 265 197],618,2,3335,3.6054054054054054,0.0,20.0
20925,2,925,[222 111 273 238 173],805,3,3338,3.6047516198704104,0.0,0.0
20926,2,926,[238 276  97  22  25],416,4,3342,3.605177993527508,0.0,0.0
20927,2,927,[ 22 222 100   9 174],698,1,3343,3.6023706896551726,0.0,0.0
20928,2,928,[ 64  22 174 151  50],764,4,3347,3.602798708288482,20.0,20.0
20929,2,929,[151 237 172   1 276],654,4,3351,3.6032258064516127,0.0,0.0
20930,2,930,[204 215  11 423  89],198,3,3354,3.602577873254565,0.0,0.0
20931,2,931,[174 238  69  95 282],416,4,3358,3.6030042918454934,0.0,0.0
20932,2,932,[313 144 143 234 168],618,5,3363,3.604501607717042,20.0,20.0
20933,2,933,[173 603  82 238 118],751,3,3366,3.6038543897216275,0.0,0.0
20934,2,934,[313  15   9 301 678],416,4,3370,3.6042780748663104,20.0,20.0
20935,2,935,[135 313 151 173 276],618,2,3372,3.6025641025641026,20.0,20.0
20936,2,936,[210 121 194  98 245],416,4,3376,3.6029882604055494,0.0,20.0
20937,2,937,[ 12 125 183 121 427],253,4,3380,3.603411513859275,20.0,0.0
20938,2,938,[508   8 174 204 144],297,3,3383,3.602768903088392,0.0,0.0
20939,2,939,[ 69 300 196  95 228],297,1,3384,3.6,0.0,0.0
20940,2,940,[ 70 204 210 125 182],416,5,3389,3.6014877789585547,0.0,0.0
20941,2,941,[100 176 423 286 515],416,5,3394,3.602972399150743,0.0,0.0
20942,2,942,[185 483   4 265  15],417,2,3396,3.601272534464475,20.0,0.0
20943,2,943,[ 28  96 300 258  56],875,4,3400,3.6016949152542375,0.0,0.0
20944,2,944,[471 125 405 245 288],921,0,3400,3.5978835978835977,0.0,20.0
20945,2,945,[286 588   8 496 235],43,4,3404,3.59830866807611,0.0,0.0
20946,2,946,[172 403 132   9 202],416,5,3409,3.5997888067581836,0.0,0.0
20947,2,947,[135   7 200 475 286],417,3,3412,3.5991561181434597,0.0,0.0
20948,2,948,[127 237  11 111 323],416,3,3415,3.5985247629083243,0.0,0.0
20949,2,949,[313 196   1 597  50],416,4,3419,3.5989473684210527,20.0,40.0
20950,2,950,[ 22 211 204 427 183],405,3,3422,3.5983175604626707,0.0,0.0
20951,2,951,[748 235 161  69 333],416,4,3426,3.5987394957983194,0.0,0.0
20952,2,952,[111 286 275 185 204],711,3,3429,3.5981112277019935,0.0,0.0
20953,2,953,[282 174 153 204 181],654,3,3432,3.59748427672956,0.0,20.0
20954,2,954,[ 71  97  79 183   8],437,2,3434,3.5958115183246075,0.0,0.0
20955,2,955,[282 216 288 427 204],618,1,3435,3.5930962343096233,0.0,20.0
20956,2,956,[173  64 196 174  69],345,5,3440,3.5945663531870427,20.0,0.0
20957,2,957,[228 234  22 179  98],601,3,3443,3.593945720250522,0.0,20.0
20958,2,958,[  8 269  98 200  28],805,3,3446,3.5933263816475494,0.0,20.0
20959,2,959,[275   8 300 215 143],43,5,3451,3.5947916666666666,0.0,0.0
20960,2,960,[385 318 210  71 238],618,3,3454,3.5941727367325704,20.0,0.0
20961,2,961,[204 300   8 748 144],654,5,3459,3.5956340956340958,0.0,0.0
20962,2,962,[597  50   4  56  22],62,4,3463,3.596053997923157,0.0,20.0
20963,2,963,[202 483 216  89 234],253,5,3468,3.5975103734439835,20.0,0.0
20964,2,964,[ 95  11  71 294 181],922,4,3472,3.5979274611398964,0.0,20.0
20965,2,965,[191 186 258 173 588],601,4,3476,3.598343685300207,0.0,0.0
20966,2,966,[ 89 211  56  28 238],437,3,3479,3.5977249224405377,0.0,0.0
20967,2,967,[588  25 435 483 222],698,2,3481,3.5960743801652892,20.0,0.0
20968,2,968,[186 257 135  50 216],642,3,3484,3.5954592363261093,0.0,20.0
20969,2,969,[153  82 204 655 125],416,5,3489,3.5969072164948455,0.0,0.0
20970,2,970,[173 269 265 276 161],416,4,3493,3.597322348094748,0.0,0.0
20971,2,971,[ 25  15 322  69  56],416,4,3497,3.597736625514403,0.0,0.0
20972,2,972,[202  50 176 143 161],416,5,3502,3.5991778006166495,0.0,20.0
20973,2,973,[ 79 328 289 275 185],854,3,3505,3.5985626283367558,0.0,0.0
20974,2,974,[ 50  79 475   7 200],417,2,3507,3.596923076923077,0.0,20.0
20975,2,975,[180  64 127 508 302],854,4,3511,3.5973360655737703,20.0,0.0
20976,2,976,[357  64 318 301 269],721,5,3516,3.5987717502558856,40.0,0.0
20977,2,977,[357  64 318 301 269],416,5,3521,3.6002044989775053,40.0,0.0
20978,2,978,[357  64 318 301 269],416,5,3526,3.601634320735444,40.0,0.0
20979,2,979,[ 22 180  71 258 655],887,3,3529,3.6010204081632655,0.0,0.0
20980,2,980,[238 172 211 191 597],417,3,3532,3.600407747196738,0.0,0.0
20981,2,981,[423  95 496 483 127],698,1,3533,3.5977596741344198,20.0,0.0
20982,2,982,[  9 187 168 313  64],416,5,3538,3.5991861648016275,40.0,20.0
20983,2,983,[271  71 180 173 127],805,1,3539,3.5965447154471546,0.0,0.0
20984,2,984,[183 603 121  95 385],416,4,3543,3.5969543147208123,0.0,0.0
20985,2,985,[ 50 174 496 181 143],373,4,3547,3.5973630831643004,0.0,40.0
20986,2,986,[357  64 318 301 269],721,5,3552,3.5987841945288754,40.0,0.0
20987,2,987,[ 28 235 173 125 195],642,3,3555,3.598178137651822,0.0,0.0
20988,2,988,[357  64 318 301 269],416,5,3560,3.5995955510616784,40.0,0.0
20989,2,989,[ 95 215  50 194 111],297,1,3561,3.596969696969697,0.0,20.0
20990,2,990,[318 186  64  50 357],373,5,3566,3.598385469223007,40.0,20.0
20991,2,991,[496 333  98  79  50],253,4,3570,3.598790322580645,0.0,40.0
20992,2,992,[357  64 318 301 269],721,5,3575,3.6002014098690838,40.0,0.0
20993,2,993,[ 82  64 483  79 238],711,4,3579,3.6006036217303823,40.0,0.0
20994,2,994,[357  64 318 301 269],721,5,3584,3.6020100502512564,40.0,0.0
20995,2,995,[357  64 318 301 269],721,5,3589,3.603413654618474,40.0,0.0
20996,2,996,[357  64 318 301 269],416,5,3594,3.60481444332999,40.0,0.0
20997,2,997,[357  64 318 301 269],721,5,3599,3.6062124248496996,40.0,0.0
20998,2,998,[143 265 403 195 748],416,5,3604,3.6076076076076076,0.0,0.0
20999,2,999,[357  64 318 301 269],721,5,3609,3.609,40.0,0.0
21000,2,1000,[125  89 258 318 357],642,1,3610,3.606393606393606,20.0,0.0
21001,2,1001,[ 64 357 301 318 269],416,5,3615,3.6077844311377247,40.0,0.0
21002,2,1002,[ 64 357 301 318 269],721,5,3620,3.609172482552343,40.0,0.0
21003,2,1003,[ 64 357 301 318 269],416,5,3625,3.610557768924303,40.0,0.0
21004,2,1004,[181  15 588  95 200],262,1,3626,3.607960199004975,0.0,20.0
21005,2,1005,[ 70 182 475 603  71],437,1,3627,3.6053677932405566,0.0,0.0
21006,2,1006,[ 64 357 301 318 269],721,5,3632,3.606752730883813,40.0,0.0
21007,2,1007,[ 64 357 301 318 269],416,5,3637,3.6081349206349205,40.0,0.0
21008,2,1008,[175 121   7 191 151],43,4,3641,3.6085232903865214,0.0,0.0
21009,2,1009,[174 385 179 318  25],416,4,3645,3.608910891089109,20.0,0.0
21010,2,1010,[588 174 322  50 179],805,2,3647,3.6073194856577646,0.0,20.0
21011,2,1011,[ 64 357 301 318 269],416,5,3652,3.608695652173913,40.0,0.0
21012,2,1012,[ 64 357 301 318 269],416,5,3657,3.6100691016781834,40.0,0.0
21013,2,1013,[294 200  25 173   8],49,0,3657,3.606508875739645,0.0,0.0
21014,2,1014,[121   7 423 222 357],805,3,3660,3.605911330049261,0.0,0.0
21015,2,1015,[ 64 357 301 318 269],416,5,3665,3.607283464566929,40.0,0.0
21016,2,1016,[ 64 357 301 318 269],721,5,3670,3.608652900688299,40.0,0.0
21017,2,1017,[ 64 357 301 318 269],721,5,3675,3.6100196463654224,40.0,0.0
21018,2,1018,[168 151 275 282 423],854,4,3679,3.6104023552502453,0.0,0.0
21019,2,1019,[603 748 234 194  97],297,2,3681,3.6088235294117648,0.0,0.0
21020,2,1020,[204 318 235 117 153],642,2,3683,3.6072477962781586,20.0,0.0
21021,2,1021,[ 11  50 238 187 678],416,4,3687,3.607632093933464,0.0,20.0
21022,2,1022,[173 143 568  89 168],751,3,3690,3.6070381231671553,0.0,0.0
21023,2,1023,[185 216 151 655 333],416,4,3694,3.607421875,0.0,0.0
21024,2,1024,[ 64 357 301 269  12],416,5,3699,3.608780487804878,40.0,0.0
21025,2,1025,[ 70 168 175 405 161],198,1,3700,3.6062378167641325,0.0,0.0
21026,2,1026,[245 121 191 385 204],416,4,3704,3.6066212268743914,0.0,0.0
21027,2,1027,[ 64 357 301 269  12],416,5,3709,3.607976653696498,40.0,0.0
21028,2,1028,[273  95 161   9 328],416,4,3713,3.608357628765792,0.0,0.0
21029,2,1029,[195 268  97  98 275],654,3,3716,3.607766990291262,0.0,20.0
21030,2,1030,[143   1 135 125 195],618,3,3719,3.6071774975751696,0.0,0.0
21031,2,1031,[ 64 357 301 269  12],416,5,3724,3.608527131782946,40.0,0.0
21032,2,1032,[427  88  79 210  96],405,3,3727,3.607938044530494,0.0,0.0
21033,2,1033,[ 64 357 301 269  12],416,5,3732,3.609284332688588,40.0,0.0
21034,2,1034,[191 168 174 405  88],43,5,3737,3.6106280193236713,0.0,0.0
21035,2,1035,[ 28 318 748 471 172],416,5,3742,3.611969111969112,20.0,0.0
21036,2,1036,[180  79 175 143 597],805,2,3744,3.6104146576663454,0.0,0.0
21037,2,1037,[ 28 194 179 655 302],721,3,3747,3.6098265895953756,0.0,0.0
21038,2,1038,[ 95 182 204 172 318],198,3,3750,3.609239653512993,20.0,0.0
21039,2,1039,[185 603 117 175 196],297,5,3755,3.610576923076923,0.0,0.0
21040,2,1040,[ 64 180  96 273 286],62,4,3759,3.610951008645533,20.0,0.0
21041,2,1041,[385 300 588 121 748],654,5,3764,3.6122840690978886,0.0,0.0
21042,2,1042,[ 64 357 301 269  12],416,5,3769,3.613614573346117,40.0,0.0
21043,2,1043,[235 196 471   4 143],297,2,3771,3.6120689655172415,0.0,0.0
21044,2,1044,[183 655 196 237  69],198,3,3774,3.6114832535885166,0.0,0.0
21045,2,1045,[ 64 357 301 269  12],416,5,3779,3.612810707456979,40.0,0.0
21046,2,1046,[96 88 25 95 50],618,2,3781,3.6112702960840495,0.0,20.0
21047,2,1047,[ 64 357 301 269  12],416,5,3786,3.6125954198473282,40.0,0.0
21048,2,1048,[496 403   7 269 172],43,5,3791,3.6139180171591994,0.0,0.0
21049,2,1049,[ 64 357 301 269  12],416,5,3796,3.6152380952380954,40.0,0.0
21050,2,1050,[121   4 100 174 151],854,2,3798,3.6137012369172217,0.0,0.0
21051,2,1051,[183 275 496 471 286],416,5,3803,3.615019011406844,0.0,0.0
21052,2,1052,[202 475 275 568  69],711,3,3806,3.614434947768281,0.0,0.0
21053,2,1053,[748 151 385 197  79],373,3,3809,3.613851992409867,0.0,0.0
21054,2,1054,[ 64 357 301 269  12],416,5,3814,3.615165876777251,40.0,0.0
21055,2,1055,[ 64 357 301 269  12],416,5,3819,3.616477272727273,40.0,0.0
21056,2,1056,[269 323 168 216 172],416,4,3823,3.616840113528855,0.0,0.0
21057,2,1057,[ 98  96 117 289 300],416,4,3827,3.6172022684310017,0.0,20.0
21058,2,1058,[202 288 191 210  97],405,4,3831,3.6175637393767706,0.0,20.0
21059,2,1059,[258 276  98   9 161],416,4,3835,3.6179245283018866,0.0,20.0
21060,2,1060,[ 64 357 301 269  12],416,5,3840,3.6192271442035815,40.0,0.0
21061,2,1061,[ 50 265  28  82 313],405,4,3844,3.6195856873822976,20.0,40.0
21062,2,1062,[125 423 195 174  88],505,3,3847,3.619002822201317,0.0,0.0
21063,2,1063,[ 64 357 301 269  12],416,5,3852,3.6203007518796992,40.0,0.0
21064,2,1064,[ 15 423 180  79 275],854,4,3856,3.6206572769953054,0.0,0.0
21065,2,1065,[ 71 597 471  69 186],618,4,3860,3.621013133208255,0.0,0.0
21066,2,1066,[ 28 195 100   7 135],805,3,3863,3.6204311152764763,0.0,0.0
21067,2,1067,[ 64 357 301 269  12],416,5,3868,3.6217228464419478,40.0,0.0
21068,2,1068,[ 64 357 301 269  12],416,5,3873,3.6230121608980355,40.0,0.0
21069,2,1069,[235 385 496 568 546],43,4,3877,3.6233644859813086,0.0,0.0
21070,2,1070,[ 22 210 405 173  69],416,5,3882,3.6246498599439776,0.0,0.0
21071,2,1071,[423 328 153 197 172],373,3,3885,3.6240671641791047,0.0,0.0
21072,2,1072,[191  69 176 135   9],601,3,3888,3.623485554520037,0.0,0.0
21073,2,1073,[269 568   7 117 273],805,2,3890,3.621973929236499,0.0,0.0
21074,2,1074,[294 273  82 176 471],416,5,3895,3.6232558139534885,0.0,0.0
21075,2,1075,[ 64 357 301 269  12],416,5,3900,3.62453531598513,40.0,0.0
21076,2,1076,[ 64 357 301 269  12],416,5,3905,3.625812441968431,40.0,0.0
21077,2,1077,[  4 185 268 234  12],416,5,3910,3.62708719851577,20.0,0.0
21078,2,1078,[ 15 161 195 258 185],416,5,3915,3.628359592215014,0.0,0.0
21079,2,1079,[ 64 357 301 269  12],416,5,3920,3.6296296296296298,40.0,0.0
21080,2,1080,[216 197 234   7 655],805,3,3923,3.62904717853839,0.0,0.0
21081,2,1081,[288 144 185 216 276],416,4,3927,3.629390018484288,0.0,20.0
21082,2,1082,[196 117 288 294 323],417,3,3930,3.628808864265928,0.0,20.0
21083,2,1083,[ 56 483 186 748 183],417,5,3935,3.6300738007380073,20.0,0.0
21084,2,1084,[294 100  28  12 151],345,3,3938,3.6294930875576035,20.0,0.0
21085,2,1085,[ 12 180   4 174 235],854,2,3940,3.6279926335174952,20.0,0.0
21086,2,1086,[ 79 210 151 655 568],373,5,3945,3.6292548298068077,0.0,0.0
21087,2,1087,[ 64 357 301 269  12],416,5,3950,3.630514705882353,40.0,0.0
21088,2,1088,[318 237 294  69 174],416,4,3954,3.630853994490358,20.0,0.0
21089,2,1089,[568 185  70  12 204],405,4,3958,3.6311926605504588,20.0,0.0
21090,2,1090,[ 82 385 168  12 597],805,2,3960,3.629697525206233,20.0,0.0
21091,2,1091,[ 64 357 301 269  12],416,5,3965,3.630952380952381,40.0,0.0
21092,2,1092,[ 12   9 125  22 197],854,3,3968,3.6303751143641354,20.0,0.0
21093,2,1093,[121 174 423 245 210],62,3,3971,3.629798903107861,0.0,0.0
21094,2,1094,[ 22 268 194 100 127],854,2,3973,3.628310502283105,0.0,0.0
21095,2,1095,[  7 151  64 475 117],214,5,3978,3.6295620437956204,20.0,0.0
21096,2,1096,[ 64 357 301 269  12],416,5,3983,3.6308113035551504,40.0,0.0
21097,2,1097,[276 742 182   7 313],416,4,3987,3.6311475409836067,20.0,20.0
21098,2,1098,[125 210 288 282   9],416,5,3992,3.632393084622384,0.0,20.0
21099,2,1099,[125 237 161 269 282],721,3,3995,3.631818181818182,0.0,0.0
21100,2,1100,[742 435 210 282  25],297,2,3997,3.630336058128974,0.0,0.0
21101,2,1101,[153   7 269 194 228],297,3,4000,3.629764065335753,0.0,0.0
21102,2,1102,[ 64 357 301 269  12],416,5,4005,3.6310063463281956,40.0,0.0
21103,2,1103,[ 79 237 515 385 117],230,4,4009,3.631340579710145,0.0,0.0
21104,2,1104,[ 64 357 301 269  12],416,5,4014,3.632579185520362,40.0,0.0
21105,2,1105,[ 64 357 301 269  12],416,5,4019,3.6338155515370705,40.0,0.0
21106,2,1106,[ 50 175 269 568 132],214,3,4022,3.6332429990966575,0.0,20.0
21107,2,1107,[288 603 168 568 197],805,3,4025,3.6326714801444044,0.0,20.0
21108,2,1108,[185 405 111 210 515],416,5,4030,3.6339044183949505,0.0,0.0
21109,2,1109,[ 64 357 301  12 269],416,5,4035,3.635135135135135,40.0,0.0
21110,2,1110,[151 191 117 333  64],345,4,4039,3.6354635463546354,20.0,0.0
21111,2,1111,[ 98  50 238 143 210],354,3,4042,3.634892086330935,0.0,40.0
21112,2,1112,[191 210  28 215 118],62,2,4044,3.6334231805929917,0.0,0.0
21113,2,1113,[ 64 357 301  12 269],416,5,4049,3.634649910233393,40.0,0.0
21114,2,1114,[ 64 357 301  12 269],416,5,4054,3.6358744394618836,40.0,0.0
21115,2,1115,[204  69 405 257  97],62,1,4055,3.6335125448028673,0.0,0.0
21116,2,1116,[111  71  82  98 191],43,5,4060,3.6347358997314236,0.0,20.0
21117,2,1117,[655 271  70 215 127],62,1,4061,3.6323792486583186,0.0,0.0
21118,2,1118,[ 64 357 301  12 269],416,5,4066,3.6336014298480785,40.0,0.0
21119,2,1119,[ 64 357 301  12 269],416,5,4071,3.6348214285714286,40.0,0.0
21120,2,1120,[197 144 288 216 588],416,5,4076,3.6360392506690453,0.0,20.0
21121,2,1121,[ 97 475  12 235 195],416,3,4079,3.635472370766488,20.0,0.0
21122,2,1122,[174 179   9 273 173],805,2,4081,3.634016028495102,0.0,0.0
21123,2,1123,[ 64 357 301  12 269],416,5,4086,3.6352313167259784,40.0,0.0
21124,2,1124,[135 269 181 385 191],805,3,4089,3.6346666666666665,0.0,20.0
21125,2,1125,[288 238  88  70 210],618,1,4090,3.6323268206039074,0.0,20.0
21126,2,1126,[ 64 357 301  12 269],416,5,4095,3.6335403726708075,40.0,0.0
21127,2,1127,[235 216 403   7 144],416,4,4099,3.6338652482269502,0.0,0.0
21128,2,1128,[121  98 234 197 300],345,3,4102,3.633303808680248,0.0,20.0
21129,2,1129,[435 588 475 197 161],437,1,4103,3.6309734513274337,0.0,0.0
21130,2,1130,[111  82 588   1  28],705,4,4107,3.6312997347480107,0.0,0.0
21131,2,1131,[257 268 191 168  50],354,4,4111,3.631625441696113,0.0,20.0
21132,2,1132,[202 174  56 210 176],505,3,4114,3.6310679611650487,0.0,0.0
21133,2,1133,[187  64 294  15 333],416,5,4119,3.632275132275132,20.0,0.0
21134,2,1134,[ 64 357 301  12 269],416,5,4124,3.633480176211454,40.0,0.0
21135,2,1135,[238  64 508 151 222],62,5,4129,3.6346830985915495,20.0,0.0
21136,2,1136,[111 210 125  89 127],417,3,4132,3.6341248900615657,0.0,0.0
21137,2,1137,[568 222 275  88 204],43,5,4137,3.6353251318101933,0.0,0.0
21138,2,1138,[ 82 127 196 125 179],416,4,4141,3.635645302897278,0.0,0.0
21139,2,1139,[288 117  69 100 216],654,3,4144,3.635087719298246,0.0,20.0
21140,2,1140,[ 64 357 301  12 269],416,5,4149,3.6362839614373357,40.0,0.0
21141,2,1141,[ 64 357 301  12 269],416,5,4154,3.637478108581436,40.0,0.0
21142,2,1142,[186  56 234 100 168],198,3,4157,3.636920384951881,0.0,0.0
21143,2,1143,[ 64 357 301  12 269],416,5,4162,3.638111888111888,40.0,0.0
21144,2,1144,[151 237 385 135  71],618,4,4166,3.6384279475982533,0.0,0.0
21145,2,1145,[174 385 200 176  50],405,2,4168,3.636998254799302,0.0,20.0
21146,2,1146,[195 194 234  95 216],297,1,4169,3.6346992153443765,0.0,0.0
21147,2,1147,[132 238  50 135 423],417,3,4172,3.6341463414634148,0.0,20.0
21148,2,1148,[ 89 117 215 135 100],62,4,4176,3.6344647519582245,0.0,0.0
21149,2,1149,[ 64 357 301  12 269],416,5,4181,3.6356521739130434,40.0,0.0
21150,2,1150,[286 135 273 215  89],62,3,4184,3.635099913119027,0.0,0.0
21151,2,1151,[186  88 195 179 173],373,4,4188,3.6354166666666665,0.0,0.0
21152,2,1152,[181 655 153  89   9],354,2,4190,3.633998265394623,0.0,20.0
21153,2,1153,[ 64 357 301  12 269],416,5,4195,3.6351819757365686,40.0,0.0
21154,2,1154,[195 265  22 143 173],297,3,4198,3.6346320346320344,0.0,0.0
21155,2,1155,[ 82 111  15 742 475],416,4,4202,3.634948096885813,0.0,0.0
21156,2,1156,[ 64 357 301  12 269],416,5,4207,3.6361279170267933,40.0,0.0
21157,2,1157,[ 25 268 175 403 385],49,1,4208,3.633851468048359,0.0,0.0
21158,2,1158,[127 197 200 322   9],854,4,4212,3.634167385677308,0.0,0.0
21159,2,1159,[ 64 357 301  12 269],416,5,4217,3.635344827586207,40.0,0.0
21160,2,1160,[  8 588 286 269  11],416,5,4222,3.636520241171404,0.0,0.0
21161,2,1161,[144 204 181 182   7],230,2,4224,3.6351118760757317,0.0,20.0
21162,2,1162,[  4 265 187 176 173],198,3,4227,3.6345657781599314,0.0,0.0
21163,2,1163,[294 748 301   1  69],345,2,4229,3.6331615120274914,0.0,0.0
21164,2,1164,[  1 403 276 121 328],416,4,4233,3.6334763948497852,0.0,0.0
21165,2,1165,[ 64 357 301  12 269],416,5,4238,3.6346483704974273,40.0,0.0
21166,2,1166,[323 238  82  88  96],805,3,4241,3.6341045415595543,0.0,0.0
21167,2,1167,[ 12 318 121  82 483],62,5,4246,3.63527397260274,60.0,0.0
21168,2,1168,[269 121 597 286 357],416,4,4250,3.6355859709153124,0.0,0.0
21169,2,1169,[333 323 174 187 121],416,4,4254,3.635897435897436,0.0,0.0
21170,2,1170,[237 153   8 132  28],62,3,4257,3.63535439795047,0.0,0.0
21171,2,1171,[210 168  28 143 179],805,2,4259,3.6339590443686007,0.0,0.0
21172,2,1172,[238 427  98 172 357],405,5,4264,3.6351236146632564,0.0,20.0
21173,2,1173,[ 12 273 286 186  15],854,2,4266,3.6337308347529813,20.0,0.0
21174,2,1174,[ 64 357 301  12 269],416,5,4271,3.6348936170212767,40.0,0.0
21175,2,1175,[181  79 200 117 173],297,3,4274,3.6343537414965987,0.0,20.0
21176,2,1176,[200 423 172 318   1],618,5,4279,3.635514018691589,20.0,0.0
21177,2,1177,[ 64 357 301  12 269],416,5,4284,3.636672325976231,40.0,0.0
21178,2,1178,[603 179 294 257 191],214,3,4287,3.6361323155216283,0.0,0.0
21179,2,1179,[357 471  82 197 173],416,5,4292,3.6372881355932205,0.0,0.0
21180,2,1180,[301 173 132 161 655],416,5,4297,3.63844199830652,0.0,0.0
21181,2,1181,[483   4 153 742 257],854,2,4299,3.6370558375634516,20.0,0.0
21182,2,1182,[302 333 257 100 475],854,2,4301,3.635672020287405,0.0,0.0
21183,2,1183,[357 174 405 222  15],198,2,4303,3.6342905405405403,0.0,0.0
21184,2,1184,[ 64 357 301  12 269],416,5,4308,3.6354430379746834,40.0,0.0
21185,2,1185,[ 64 357 301  12 269],416,5,4313,3.636593591905565,40.0,0.0
21186,2,1186,[ 70 204 135 182 385],198,2,4315,3.6352148272957034,0.0,0.0
21187,2,1187,[ 64 357 301  12 269],416,5,4320,3.6363636363636362,40.0,0.0
21188,2,1188,[ 64 357 301  12 269],416,5,4325,3.637510513036165,40.0,0.0
21189,2,1189,[294 235 173 172 176],416,4,4329,3.63781512605042,0.0,0.0
21190,2,1190,[742   1 234 127 313],416,5,4334,3.638958858102435,20.0,20.0
21191,2,1191,[ 64 357 301  12 269],416,5,4339,3.6401006711409396,40.0,0.0
21192,2,1192,[403 125 235 742 185],417,2,4341,3.63872590108969,0.0,0.0
21193,2,1193,[185  97   8 496 176],437,3,4344,3.6381909547738696,0.0,0.0
21194,2,1194,[ 64 357 301  12 269],416,5,4349,3.6393305439330543,40.0,0.0
21195,2,1195,[423 117  11 174 182],618,5,4354,3.640468227424749,0.0,0.0
21196,2,1196,[275 185 161 118 238],618,2,4356,3.6390977443609023,0.0,0.0
21197,2,1197,[ 64 357 301  12 269],416,5,4361,3.6402337228714523,40.0,0.0
21198,2,1198,[427 191 185 200 268],416,5,4366,3.6413678065054214,0.0,0.0
21199,2,1199,[ 64 357 301  12 269],416,5,4371,3.6425,40.0,0.0
21200,2,1200,[ 64 357 301  12 269],416,5,4376,3.643630308076603,40.0,0.0
21201,2,1201,[742 161 385   8  50],43,5,4381,3.6447587354409317,0.0,20.0
21202,2,1202,[ 64 357 301  12 269],416,5,4386,3.6458852867830425,40.0,0.0
21203,2,1203,[258 144 288   8 153],854,4,4390,3.6461794019933556,0.0,20.0
21204,2,1204,[ 64 357 301  12 269],416,5,4395,3.6473029045643153,40.0,0.0
21205,2,1205,[ 64 357 301  12 269],416,5,4400,3.648424543946932,40.0,0.0
21206,2,1206,[546 568 328 144 183],416,4,4404,3.6487158243579123,0.0,0.0
21207,2,1207,[ 64 357 301  12 269],416,5,4409,3.649834437086093,40.0,0.0
21208,2,1208,[ 64 357 301  12 269],416,5,4414,3.650951199338296,40.0,0.0
21209,2,1209,[322 200  79 265 471],416,4,4418,3.6512396694214875,0.0,0.0
21210,2,1210,[ 25 603 216 271 597],805,2,4420,3.6498761354252682,0.0,0.0
21211,2,1211,[357 204 435 237 588],297,3,4423,3.6493399339933994,0.0,0.0
21212,2,1212,[588 185 228 153 200],805,3,4426,3.6488046166529267,0.0,0.0
21213,2,1213,[ 95  97 132 161 117],618,4,4430,3.6490939044481054,0.0,0.0
21214,2,1214,[195  95 228 294 135],230,2,4432,3.6477366255144035,0.0,0.0
21215,2,1215,[  4 475 235 546 153],416,2,4434,3.6463815789473686,0.0,0.0
21216,2,1216,[183  97 132 403 333],416,5,4439,3.647493837304848,0.0,0.0
21217,2,1217,[ 64 357 301  12 269],416,5,4444,3.6486042692939247,40.0,0.0
21218,2,1218,[ 82 237 508  56 273],62,4,4448,3.6488925348646433,0.0,0.0
21219,2,1219,[ 64 357 301  12 269],416,5,4453,3.65,40.0,0.0
21220,2,1220,[475 678 655 111  95],805,2,4455,3.6486486486486487,0.0,0.0
21221,2,1221,[ 64 357 301  12 269],416,5,4460,3.6497545008183305,40.0,0.0
21222,2,1222,[ 56 318 187  89  98],214,5,4465,3.650858544562551,20.0,20.0
21223,2,1223,[202 173 288 282   1],314,4,4469,3.651143790849673,0.0,20.0
21224,2,1224,[210  25 294 568 127],416,5,4474,3.6522448979591835,0.0,0.0
21225,2,1225,[496  96 125  12 191],373,5,4479,3.6533442088091355,20.0,0.0
21226,2,1226,[185 182  96 237 168],198,3,4482,3.65281173594132,0.0,0.0
21227,2,1227,[405 168 181 357 588],230,5,4487,3.653908794788274,0.0,20.0
21228,2,1228,[ 64 357 301  12 269],416,5,4492,3.6550040683482505,40.0,0.0
21229,2,1229,[ 64 357 301  12 269],416,5,4497,3.65609756097561,40.0,0.0
21230,2,1230,[276 328 313  12 597],43,4,4501,3.6563769293257513,40.0,20.0
21231,2,1231,[228 168 234 151 144],297,1,4502,3.654220779220779,0.0,0.0
21232,2,1232,[ 97 204 215 174  95],198,2,4504,3.6528791565287917,0.0,0.0
21233,2,1233,[ 95 742 121 204 748],505,3,4507,3.652350081037277,0.0,0.0
21234,2,1234,[269 546   4 195 403],416,4,4511,3.6526315789473682,0.0,0.0
21235,2,1235,[328 385 127 121 237],43,5,4516,3.6537216828478964,0.0,0.0
21236,2,1236,[ 69 195 151  95 210],505,2,4518,3.652384801940178,0.0,0.0
21237,2,1237,[ 64 357 301  12 269],416,5,4523,3.6534733441033924,40.0,0.0
21238,2,1238,[176 427 168 328 385],416,5,4528,3.6545601291364003,0.0,0.0
21239,2,1239,[216 153 187  56 174],416,5,4533,3.6556451612903227,0.0,0.0
21240,2,1240,[200 186 475 655   8],711,4,4537,3.6559226430298146,0.0,0.0
21241,2,1241,[197 508  56 268 195],297,3,4540,3.655394524959742,0.0,0.0
21242,2,1242,[546 405 597 268  95],416,2,4542,3.654062751407884,0.0,0.0
21243,2,1243,[318  56 268 333 191],721,2,4544,3.652733118971061,20.0,0.0
21244,2,1244,[ 50   1 423 403 222],541,3,4547,3.6522088353413653,0.0,20.0
21245,2,1245,[ 64 357 301  12 269],416,5,4552,3.653290529695024,40.0,0.0
21246,2,1246,[125 117   7 288 172],630,3,4555,3.652766639935846,0.0,20.0
21247,2,1247,[ 64 357 301  12 269],416,5,4560,3.6538461538461537,40.0,0.0
21248,2,1248,[186 180 238 471  70],373,3,4563,3.653322658126501,0.0,0.0
21249,2,1249,[183  70  64 151 182],618,3,4566,3.6528,20.0,0.0
21250,2,1250,[ 64 357 301  12 269],416,5,4571,3.653876898481215,40.0,0.0
21251,2,1251,[ 11 288 181 210 237],654,3,4574,3.6533546325878596,0.0,40.0
21252,2,1252,[423  89 318 125 176],62,4,4578,3.653631284916201,20.0,0.0
21253,2,1253,[  7 300 385 286 265],416,5,4583,3.6547049441786283,0.0,0.0
21254,2,1254,[245 181 678  25 204],297,2,4585,3.653386454183267,0.0,20.0
21255,2,1255,[175 678  71   7  95],805,3,4588,3.6528662420382165,0.0,0.0
21256,2,1256,[  8  71 265 202 258],416,5,4593,3.6539379474940334,0.0,0.0
21257,2,1257,[ 64 357 301  12 269],416,5,4598,3.6550079491255962,40.0,0.0
21258,2,1258,[ 50 153 180 403 357],805,4,4602,3.6552819698173153,0.0,20.0
21259,2,1259,[597  89  56 210   7],417,2,4604,3.653968253968254,0.0,0.0
21260,2,1260,[ 69 197 237 588 196],345,4,4608,3.654242664551943,0.0,0.0
21261,2,1261,[328 357 257 191 302],854,2,4610,3.652931854199683,0.0,0.0
21262,2,1262,[ 64 357 301  12 269],416,5,4615,3.6539984164687254,40.0,0.0
21263,2,1263,[508 197 100 483  15],342,3,4618,3.653481012658228,20.0,0.0
21264,2,1264,[ 56 588 313 271  50],505,3,4621,3.65296442687747,20.0,40.0
21265,2,1265,[121 237 496 204  25],618,3,4624,3.6524486571879935,0.0,0.0
21266,2,1266,[655 182   1 173   4],618,3,4627,3.6519337016574585,0.0,0.0
21267,2,1267,[121 194 204  25 282],416,5,4632,3.6529968454258674,0.0,0.0
21268,2,1268,[176 181 546 238 111],62,4,4636,3.653270291568164,0.0,20.0
21269,2,1269,[ 64 357 301  12 269],416,5,4641,3.6543307086614174,40.0,0.0
21270,2,1270,[258 173  25 301 568],416,5,4646,3.6553894571203775,0.0,0.0
21271,2,1271,[ 64 357 301  12 269],416,5,4651,3.6564465408805034,40.0,0.0
21272,2,1272,[ 64 357 301  12 269],416,5,4656,3.657501963864886,40.0,0.0
21273,2,1273,[405 748 168  71 144],654,4,4660,3.6577708006279437,0.0,0.0
21274,2,1274,[ 64 357 301  12 269],416,5,4665,3.6588235294117646,40.0,0.0
21275,2,1275,[269  82 258  12 228],805,2,4667,3.657523510971787,20.0,0.0
21276,2,1276,[405 313 172 302 191],43,5,4672,3.658574784651527,20.0,20.0
21277,2,1277,[ 64 357 301  12 269],416,5,4677,3.65962441314554,40.0,0.0
21278,2,1278,[183   9 210 153  25],416,5,4682,3.660672400312744,0.0,0.0
21279,2,1279,[234 151  28 143 302],416,4,4686,3.6609375,0.0,0.0
21280,2,1280,[301 742 302 216 173],345,5,4691,3.661982825917252,0.0,0.0
21281,2,1281,[ 64 357 301  12 269],416,5,4696,3.6630265210608424,40.0,0.0
21282,2,1282,[118 191 276 515 678],416,2,4698,3.661730319563523,0.0,0.0
21283,2,1283,[ 22 258  89  25 191],297,4,4702,3.661993769470405,0.0,0.0
21284,2,1284,[ 64 357 301  12 269],416,5,4707,3.663035019455253,40.0,0.0
21285,2,1285,[ 64 357 301  12 269],416,5,4712,3.6640746500777603,40.0,0.0
21286,2,1286,[200 111 182 496 237],437,3,4715,3.6635586635586637,0.0,0.0
21287,2,1287,[ 64 357 301  12 269],416,5,4720,3.6645962732919255,40.0,0.0
21288,2,1288,[ 25 174   4 125 678],345,2,4722,3.6633048875096974,0.0,0.0
21289,2,1289,[210 546 174 405 268],654,4,4726,3.663565891472868,0.0,0.0
21290,2,1290,[143 151 144 132 546],416,3,4729,3.6630518977536792,0.0,0.0
21291,2,1291,[323 117 655 216  15],417,3,4732,3.6625386996904026,0.0,0.0
21292,2,1292,[172 269 385 496 173],654,5,4737,3.663573085846868,0.0,0.0
21293,2,1293,[ 79 228 282 121 222],128,2,4739,3.6622874806800616,0.0,0.0
21294,2,1294,[ 64 357 301  12 269],416,5,4744,3.6633204633204635,40.0,0.0
21295,2,1295,[302 135 238   7 200],297,4,4748,3.6635802469135803,0.0,0.0
21296,2,1296,[245  22  69 111 144],416,4,4752,3.6638396299151887,0.0,0.0
21297,2,1297,[ 95 603 323 328  79],416,3,4755,3.663328197226502,0.0,0.0
21298,2,1298,[ 64 357 301  12 269],416,5,4760,3.6643571978444958,40.0,0.0
21299,2,1299,[  8  97 271 257 742],43,4,4764,3.664615384615385,0.0,0.0
21300,2,1300,[483 191  22 172  25],618,4,4768,3.6648731744811682,20.0,0.0
21301,2,1301,[161 496 238 180  82],128,5,4773,3.665898617511521,0.0,0.0
21302,2,1302,[216 228 151 197 135],711,4,4777,3.6661550268610896,0.0,0.0
21303,2,1303,[597 196 313   9 144],618,4,4781,3.666411042944785,20.0,20.0
21304,2,1304,[ 50 282  56 435 153],297,3,4784,3.6659003831417625,0.0,20.0
21305,2,1305,[  1 603 151 215 269],297,2,4786,3.664624808575804,0.0,0.0
21306,2,1306,[234 195 181   7 174],297,3,4789,3.664116296863045,0.0,20.0
21307,2,1307,[186 403 275 597  69],618,4,4793,3.664373088685015,0.0,0.0
21308,2,1308,[ 64 357 301  12 269],416,5,4798,3.6653934300993125,40.0,0.0
21309,2,1309,[187 323 121   9 172],416,4,4802,3.665648854961832,0.0,0.0
21310,2,1310,[435 135 238 655 423],373,3,4805,3.6651411136536995,0.0,0.0
21311,2,1311,[151 588 175   4 268],49,3,4808,3.6646341463414633,0.0,0.0
21312,2,1312,[195 117 245 588 100],297,3,4811,3.6641279512566642,0.0,0.0
21313,2,1313,[121 237  11   1 204],505,2,4813,3.662861491628615,0.0,0.0
21314,2,1314,[196 678  25 282 153],297,3,4816,3.6623574144486692,0.0,0.0
21315,2,1315,[127 328 222 151 196],43,5,4821,3.6633738601823707,0.0,0.0
21316,2,1316,[ 11 258   7 100 288],805,2,4823,3.6621108580106303,0.0,20.0
21317,2,1317,[168 568 435 515  28],698,1,4824,3.660091047040971,0.0,0.0
21318,2,1318,[ 71 187 475 300 237],198,2,4826,3.6588324488248674,0.0,0.0
21319,2,1319,[ 70 427 196   4  95],405,2,4828,3.6575757575757577,0.0,0.0
21320,2,1320,[ 64 357 301  12 269],416,5,4833,3.6585919757759275,40.0,0.0
21321,2,1321,[197  71  69 143 423],416,5,4838,3.6596066565809378,0.0,0.0
21322,2,1322,[273 181  96 597 121],618,4,4842,3.6598639455782314,0.0,20.0
21323,2,1323,[ 64 357 301  12 269],416,5,4847,3.6608761329305137,40.0,0.0
21324,2,1324,[180 175  15 216 132],373,2,4849,3.659622641509434,0.0,0.0
21325,2,1325,[ 64 357 301  12 269],416,5,4854,3.660633484162896,40.0,0.0
21326,2,1326,[ 50 200 322  28 183],416,4,4858,3.660889223813112,0.0,20.0
21327,2,1327,[  9 100 471 172 132],887,2,4860,3.6596385542168677,0.0,0.0
21328,2,1328,[ 64 357 301  12 269],416,5,4865,3.6606471030850263,40.0,0.0
21329,2,1329,[125 196 496 276  95],342,2,4867,3.6593984962406014,0.0,0.0
21330,2,1330,[ 64 357 301  12 269],416,5,4872,3.660405709992487,40.0,0.0
21331,2,1331,[238   8 318 125 286],854,3,4875,3.65990990990991,20.0,0.0
21332,2,1332,[ 64 357 301  12 269],416,5,4880,3.6609152288072018,40.0,0.0
21333,2,1333,[200 568 216   1 234],805,3,4883,3.6604197901049473,0.0,0.0
21334,2,1334,[ 64 357 301  12 269],416,5,4888,3.661423220973783,40.0,0.0
21335,2,1335,[  8 597 294 286  64],854,2,4890,3.660179640718563,20.0,0.0
21336,2,1336,[204  69 276  88 318],618,3,4893,3.6596858638743455,20.0,0.0
21337,2,1337,[  7 195 403  71 265],416,5,4898,3.6606875934230194,0.0,0.0
21338,2,1338,[ 22 144 173 300 265],297,2,4900,3.659447348767737,0.0,0.0
21339,2,1339,[180 187 265 176 427],405,2,4902,3.6582089552238806,0.0,0.0
21340,2,1340,[215  69 144  56  71],62,3,4905,3.6577181208053693,0.0,0.0
21341,2,1341,[ 69 174 546 168 597],62,4,4909,3.657973174366617,0.0,0.0
21342,2,1342,[423  56  95 125 328],314,4,4913,3.6582278481012658,0.0,0.0
21343,2,1343,[183 100  79 275 173],437,4,4917,3.658482142857143,0.0,0.0
21344,2,1344,[ 71 172 427 135 200],711,4,4921,3.658736059479554,0.0,0.0
21345,2,1345,[235   1   7 294 117],854,1,4922,3.6567607726597324,0.0,0.0
21346,2,1346,[322 172 135 742 125],417,1,4923,3.6547884187082404,0.0,0.0
21347,2,1347,[ 64 357 301  12 269],416,5,4928,3.655786350148368,40.0,0.0
21348,2,1348,[181 216 228 215 197],711,3,4931,3.6553002223869533,0.0,20.0
21349,2,1349,[ 64 423 168 144 173],854,4,4935,3.6555555555555554,20.0,0.0
21350,2,1350,[210   8 181 186  12],588,5,4940,3.6565507031828277,20.0,20.0
21351,2,1351,[ 70 678 318 245 289],345,2,4942,3.655325443786982,20.0,0.0
21352,2,1352,[118 173 127 194 215],416,4,4946,3.655580192165558,0.0,0.0
21353,2,1353,[215 210 135 403 471],373,2,4948,3.6543574593796158,0.0,0.0
21354,2,1354,[ 64 357 301  12 269],416,5,4953,3.655350553505535,40.0,0.0
21355,2,1355,[ 64 357 301  12 269],416,5,4958,3.6563421828908553,40.0,0.0
21356,2,1356,[323  28 210 597  56],751,3,4961,3.655858511422255,0.0,0.0
21357,2,1357,[ 64 357 301  12 269],416,5,4966,3.6568483063328423,40.0,0.0
21358,2,1358,[100 135 273 603  11],854,5,4971,3.6578366445916113,0.0,0.0
21359,2,1359,[ 69 588 427 300 328],416,5,4976,3.6588235294117646,0.0,0.0
21360,2,1360,[176 191 100 655 405],416,5,4981,3.659808963997061,0.0,0.0
21361,2,1361,[ 28 183  95 181 496],416,4,4985,3.6600587371512483,0.0,20.0
21362,2,1362,[173 111 385 403 132],417,4,4989,3.66030814380044,0.0,0.0
21363,2,1363,[ 64 357 301  12 269],416,5,4994,3.661290322580645,40.0,0.0
21364,2,1364,[  8 568  88  70   4],405,3,4997,3.6608058608058607,0.0,0.0
21365,2,1365,[216 471 403 111 273],618,2,4999,3.659590043923865,0.0,0.0
21366,2,1366,[748 183  82  28 111],437,1,5000,3.6576444769568397,0.0,0.0
21367,2,1367,[ 64 357 301  12 269],416,5,5005,3.658625730994152,40.0,0.0
21368,2,1368,[257 121 151 748  97],416,3,5008,3.658144631117604,0.0,0.0
21369,2,1369,[182 302 300 235   1],297,1,5009,3.656204379562044,0.0,0.0
21370,2,1370,[323 288 405 151   1],417,2,5011,3.6549963530269878,0.0,20.0
21371,2,1371,[ 98 238 183   8 195],230,2,5013,3.6537900874635567,0.0,20.0
21372,2,1372,[ 25 179 333 118   8],416,3,5016,3.6533139111434814,0.0,0.0
21373,2,1373,[323 195 180  96  64],198,2,5018,3.6521106259097524,20.0,0.0
21374,2,1374,[ 15 211  89 197 200],437,4,5022,3.6523636363636363,0.0,0.0
21375,2,1375,[423  70 300 151   1],297,1,5023,3.650436046511628,0.0,0.0
21376,2,1376,[173 182 289 328  25],49,1,5024,3.6485112563543938,0.0,0.0
21377,2,1377,[483  22 185  50  98],601,4,5028,3.648766328011611,20.0,40.0
21378,2,1378,[210 515 222  50 405],417,1,5029,3.6468455402465554,0.0,20.0
21379,2,1379,[ 64 357 301  12 269],416,5,5034,3.6478260869565218,40.0,0.0
21380,2,1380,[ 71 385 427  88 132],405,2,5036,3.6466328747284575,0.0,0.0
21381,2,1381,[222 235   7  69 210],43,4,5040,3.646888567293777,0.0,0.0
21382,2,1382,[294 222  56 276 269],654,3,5043,3.646420824295011,0.0,0.0
21383,2,1383,[  7 273 118 176 405],854,3,5046,3.6459537572254335,0.0,0.0
21384,2,1384,[655 235 405 196  28],541,3,5049,3.6454873646209385,0.0,0.0
21385,2,1385,[ 64 357 301  12 269],416,5,5054,3.6464646464646466,40.0,0.0
21386,2,1386,[  1 269 471 111   9],43,4,5058,3.6467195385724587,0.0,0.0
21387,2,1387,[161 282 288 471 289],721,3,5061,3.6462536023054755,0.0,20.0
21388,2,1388,[475 200 202 132 265],437,3,5064,3.6457883369330455,0.0,0.0
21389,2,1389,[588 483 423 286   7],588,3,5067,3.645323741007194,20.0,0.0
21390,2,1390,[ 64 357 301  12 269],416,5,5072,3.646297627606039,40.0,0.0
21391,2,1391,[ 64 357 301  12 269],416,5,5077,3.6472701149425286,40.0,0.0
21392,2,1392,[ 64 357 301  12 269],416,5,5082,3.648241206030151,40.0,0.0
21393,2,1393,[118 423 742  11 127],417,4,5086,3.648493543758967,0.0,0.0
21394,2,1394,[ 64 357 301  12 269],416,5,5091,3.649462365591398,40.0,0.0
21395,2,1395,[ 64 357 301  12 269],416,5,5096,3.650429799426934,40.0,0.0
21396,2,1396,[194 111  22 302 185],297,3,5099,3.649964209019327,0.0,0.0
21397,2,1397,[  4 289 475 194 276],416,2,5101,3.6487839771101576,0.0,0.0
21398,2,1398,[ 82 210 196   9 427],618,3,5104,3.6483202287348107,0.0,0.0
21399,2,1399,[118 125 191 568 302],416,4,5108,3.6485714285714286,0.0,0.0
21400,2,1400,[ 64 357 301  12 269],416,5,5113,3.649536045681656,40.0,0.0
21401,2,1401,[286 423 288  70  98],416,5,5118,3.6504992867332384,0.0,40.0
21402,2,1402,[132 144 289 151 597],588,3,5121,3.6500356379187457,0.0,0.0
21403,2,1403,[215  25 234 202 568],618,3,5124,3.6495726495726495,0.0,0.0
21404,2,1404,[ 70  71 200 471 238],416,5,5129,3.6505338078291816,0.0,0.0
21405,2,1405,[ 15 423 385 546 173],417,4,5133,3.650782361308677,0.0,0.0
21406,2,1406,[202   4 258 238 196],297,3,5136,3.650319829424307,0.0,0.0
21407,2,1407,[ 22 313 216 276   9],416,4,5140,3.6505681818181817,20.0,20.0
21408,2,1408,[245   8 121 257  70],62,2,5142,3.6493967352732435,0.0,0.0
21409,2,1409,[153 655 323 196 597],751,2,5144,3.64822695035461,0.0,0.0
21410,2,1410,[ 64 357 301  12 269],416,5,5149,3.6491849751948973,40.0,0.0
21411,2,1411,[ 64 357 301  12 269],416,5,5154,3.65014164305949,40.0,0.0
21412,2,1412,[135 179 276 174 603],214,3,5157,3.6496815286624202,0.0,0.0
21413,2,1413,[ 64 357 301  12 269],416,5,5162,3.6506364922206505,40.0,0.0
21414,2,1414,[515 333 257 195  95],416,3,5165,3.65017667844523,0.0,0.0
21415,2,1415,[179   8  11 483 144],342,5,5170,3.651129943502825,20.0,0.0
21416,2,1416,[200 179   1 273  64],417,4,5174,3.6513761467889907,20.0,0.0
21417,2,1417,[318 655 185 183 427],416,5,5179,3.652327221438646,20.0,0.0
21418,2,1418,[ 64 357 301  12 269],416,5,5184,3.653276955602537,40.0,0.0
21419,2,1419,[ 64 357 301  12 269],416,5,5189,3.654225352112676,40.0,0.0
21420,2,1420,[151 143 403  97 191],618,4,5193,3.654468684025334,0.0,0.0
21421,2,1421,[328  96  11 245  82],416,4,5197,3.6547116736990155,0.0,0.0
21422,2,1422,[ 64 357 301  12 269],416,5,5202,3.6556570625439213,40.0,0.0
21423,2,1423,[210 202 215   7 182],416,5,5207,3.6566011235955056,0.0,0.0
21424,2,1424,[197 195 127 168 238],805,3,5210,3.656140350877193,0.0,0.0
21425,2,1425,[ 25 257   4  11 153],416,4,5214,3.656381486676017,0.0,0.0
21426,2,1426,[210 257 173 357 117],416,4,5218,3.6566222845129643,0.0,0.0
21427,2,1427,[181 132  96 385 333],416,5,5223,3.657563025210084,0.0,20.0
21428,2,1428,[496 427 403 515 161],416,5,5228,3.6585024492652205,0.0,0.0
21429,2,1429,[ 69 153 151  22 238],601,2,5230,3.6573426573426575,0.0,0.0
21430,2,1430,[313  70 172 161 173],49,0,5230,3.6547868623340323,20.0,20.0
21431,2,1431,[245 515 265 302  50],416,4,5234,3.655027932960894,0.0,20.0
21432,2,1432,[568   8  64 318 175],405,4,5238,3.655268667131891,40.0,0.0
21433,2,1433,[ 95 215  79 678 202],297,0,5238,3.6527196652719667,0.0,0.0
21434,2,1434,[ 64 357 301  12 269],416,5,5243,3.653658536585366,40.0,0.0
21435,2,1435,[151 143 273 234 215],416,4,5247,3.653899721448468,0.0,0.0
21436,2,1436,[144 210 161 187  50],505,1,5248,3.65205288796103,0.0,20.0
21437,2,1437,[143 216 588  25 172],618,3,5251,3.6515994436717665,0.0,0.0
21438,2,1438,[153  98 288 237 135],922,3,5254,3.6511466296038915,0.0,40.0
21439,2,1439,[ 15 153 173 496  70],43,5,5259,3.652083333333333,0.0,0.0
21440,2,1440,[ 64 357 301  12 269],416,5,5264,3.653018736988203,40.0,0.0
21441,2,1441,[185 301 318 197 161],711,5,5269,3.6539528432732316,20.0,0.0
21442,2,1442,[318 496 151 143 237],907,5,5274,3.6548856548856548,20.0,0.0
21443,2,1443,[294  11 196  95 117],654,4,5278,3.655124653739612,0.0,0.0
21444,2,1444,[ 64 357 301  12 269],416,5,5283,3.656055363321799,40.0,0.0
21445,2,1445,[ 64 357 301  12 269],416,5,5288,3.656984785615491,40.0,0.0
21446,2,1446,[196 568 144  88 238],751,3,5291,3.6565307532826536,0.0,0.0
21447,2,1447,[180 185 357 288 117],805,2,5293,3.6553867403314917,0.0,20.0
21448,2,1448,[597 176 603 238 265],416,4,5297,3.655624568668047,0.0,0.0
21449,2,1449,[ 64 357 301  12 269],416,5,5302,3.656551724137931,40.0,0.0
21450,2,1450,[197   4 191 515 175],297,2,5304,3.655410062026189,0.0,0.0
21451,2,1451,[385 196 204 215 144],654,5,5309,3.65633608815427,0.0,0.0
21452,2,1452,[132 655 423  28 117],373,2,5311,3.655196145905024,0.0,0.0
21453,2,1453,[176 175 174 143  97],198,2,5313,3.654057771664374,0.0,0.0
21454,2,1454,[175 268 194 234  89],297,3,5316,3.6536082474226803,0.0,0.0
21455,2,1455,[ 64 357 301  12 269],416,5,5321,3.654532967032967,40.0,0.0
21456,2,1456,[588 228   1 265 121],505,3,5324,3.654083733699382,0.0,0.0
21457,2,1457,[568  69   1 127 215],62,2,5326,3.652949245541838,0.0,0.0
21458,2,1458,[ 64 357 301  12 269],416,5,5331,3.6538725154215217,40.0,0.0
21459,2,1459,[655  71 301 127 143],416,5,5336,3.654794520547945,0.0,0.0
21460,2,1460,[ 64 357 301  12 269],416,5,5341,3.6557152635181382,40.0,0.0
21461,2,1461,[ 15   1 603 174 100],416,5,5346,3.6566347469220246,0.0,0.0
21462,2,1462,[ 98 471 196 153 323],416,4,5350,3.6568694463431304,0.0,20.0
21463,2,1463,[471 294  64 275 196],128,5,5355,3.6577868852459017,20.0,0.0
21464,2,1464,[151   8  12 173 508],62,5,5360,3.6587030716723548,20.0,0.0
21465,2,1465,[ 12 191 238 196 127],618,4,5364,3.65893587994543,20.0,0.0
21466,2,1466,[318 117 258  70 237],416,4,5368,3.6591683708248124,20.0,0.0
21467,2,1467,[ 64 357 301  12 269],416,5,5373,3.6600817438692097,40.0,0.0
21468,2,1468,[237 173  97 202 568],43,5,5378,3.660993873383254,0.0,0.0
21469,2,1469,[ 64 357 301  12 269],416,5,5383,3.6619047619047618,40.0,0.0
21470,2,1470,[ 64 357 301  12 269],416,5,5388,3.66281441196465,40.0,0.0
21471,2,1471,[ 64 357 301  12 269],416,5,5393,3.6637228260869565,40.0,0.0
21472,2,1472,[161  69 100 286 496],373,3,5396,3.663272233536999,0.0,0.0
21473,2,1473,[ 64 357 301  12 269],416,5,5401,3.6641791044776117,40.0,0.0
21474,2,1474,[ 64 357 301  12 269],416,5,5406,3.665084745762712,40.0,0.0
21475,2,1475,[323 216 200  97 125],417,3,5409,3.6646341463414633,0.0,0.0
21476,2,1476,[ 96 483  89  22 289],854,2,5411,3.6635071090047395,20.0,0.0
21477,2,1477,[125 475 678  79 100],588,1,5412,3.6617050067659,0.0,0.0
21478,2,1478,[427  96 483  71 132],618,4,5416,3.6619337390128464,20.0,0.0
21479,2,1479,[ 89 153 185 197 118],437,3,5419,3.6614864864864867,0.0,0.0
21480,2,1480,[302 568  12 588 318],654,5,5424,3.662390276839973,40.0,0.0
21481,2,1481,[118 588 403 168 216],642,3,5427,3.661943319838057,0.0,0.0
21482,2,1482,[ 11 275  96 132 234],618,3,5430,3.6614969656102496,0.0,0.0
21483,2,1483,[  9 235 427 385 111],887,3,5433,3.6610512129380055,0.0,0.0
21484,2,1484,[ 12  64 197  88 185],416,4,5437,3.6612794612794612,40.0,0.0
21485,2,1485,[655  70  56 282 427],416,5,5442,3.6621803499327052,0.0,0.0
21486,2,1486,[153 271 603  11  25],805,3,5445,3.661735036987223,0.0,0.0
21487,2,1487,[121 185 588  69 195],262,2,5447,3.6606182795698925,0.0,0.0
21488,2,1488,[427 405 357  71 200],416,5,5452,3.661517797179315,0.0,0.0
21489,2,1489,[197  69 127  82 191],198,4,5456,3.661744966442953,0.0,0.0
21490,2,1490,[222 185 151 265 168],711,3,5459,3.6613011401743796,0.0,0.0
21491,2,1491,[  1 125   9 195  50],630,2,5461,3.6601876675603218,0.0,20.0
21492,2,1492,[ 50 186  64 135  56],618,5,5466,3.6610850636302747,20.0,20.0
21493,2,1493,[ 71  15  89 180 185],198,1,5467,3.6593038821954487,0.0,0.0
21494,2,1494,[ 22  28  71 144 678],416,4,5471,3.6595317725752508,0.0,0.0
21495,2,1495,[271 234 273  98 403],805,3,5474,3.659090909090909,0.0,20.0
21496,2,1496,[289 655 117 427 302],416,4,5478,3.659318637274549,0.0,0.0
21497,2,1497,[ 64 357 301  12 269],416,5,5483,3.6602136181575435,40.0,0.0
21498,2,1498,[238 302  89 168 271],854,4,5487,3.6604402935290192,0.0,0.0
21499,2,1499,[168 182 265 234 215],437,1,5488,3.6586666666666665,0.0,0.0
21500,2,1500,[ 64 357 301  12 269],416,5,5493,3.659560293137908,40.0,0.0
21501,2,1501,[161  11 215 269 132],416,5,5498,3.6604527296937417,0.0,0.0
21502,2,1502,[655 176 202 121   4],805,1,5499,3.658682634730539,0.0,0.0
21503,2,1503,[ 64 357 301  12 269],416,5,5504,3.6595744680851063,40.0,0.0
21504,2,1504,[ 64 357 301  12 269],416,5,5509,3.66046511627907,40.0,0.0
21505,2,1505,[ 88 118 234 435 588],437,1,5510,3.6586985391766267,0.0,0.0
21506,2,1506,[ 95 496 357   1 294],417,4,5514,3.65892501658925,0.0,0.0
21507,2,1507,[175 289 121  28 269],43,4,5518,3.6591511936339525,0.0,0.0
21508,2,1508,[ 15 237 151  70 282],345,4,5522,3.659377070907886,0.0,0.0
21509,2,1509,[423 237 125 153 100],62,3,5525,3.6589403973509933,0.0,0.0
21510,2,1510,[ 64 357 301  12 269],416,5,5530,3.659827928524156,40.0,0.0
21511,2,1511,[ 64 357 301  12 269],416,5,5535,3.6607142857142856,40.0,0.0
21512,2,1512,[357 168  88 423  82],642,3,5538,3.660277594183741,0.0,0.0
21513,2,1513,[ 64 301 357  12 269],416,5,5543,3.6611624834874505,40.0,0.0
21514,2,1514,[ 64 301 357  12 269],416,5,5548,3.662046204620462,40.0,0.0
21515,2,1515,[258 289   1 294 678],721,1,5549,3.6602902374670183,0.0,0.0
21516,2,1516,[100 174  22 597 143],416,4,5553,3.6605141727092945,0.0,0.0
21517,2,1517,[200  64  79 127 195],198,3,5556,3.6600790513833994,20.0,0.0
21518,2,1518,[588 515 204 301   8],297,4,5560,3.6603028308097434,0.0,0.0
21519,2,1519,[191 328  79 405 245],128,3,5563,3.6598684210526318,0.0,0.0
21520,2,1520,[ 64 301 357  12 269],416,5,5568,3.660749506903353,40.0,0.0
21521,2,1521,[121   1  79 282 597],854,1,5569,3.659001314060447,0.0,0.0
21522,2,1522,[179 215  70 515 282],416,4,5573,3.659225213394616,0.0,0.0
21523,2,1523,[ 64 301 357  12 269],416,5,5578,3.6601049868766404,40.0,0.0
21524,2,1524,[237 258  50 194 125],416,4,5582,3.660327868852459,0.0,20.0
21525,2,1525,[ 64 301 357  12 269],416,5,5587,3.6612057667103537,40.0,0.0
21526,2,1526,[194 153 288 603 257],297,2,5589,3.6601178781925343,0.0,20.0
21527,2,1527,[127   9 197 183  96],805,3,5592,3.6596858638743455,0.0,0.0
21528,2,1528,[180 174 288 423 257],62,2,5594,3.658600392413342,0.0,20.0
21529,2,1529,[202 200 222  15 282],764,5,5599,3.6594771241830064,0.0,0.0
21530,2,1530,[238 222 216 168 333],854,3,5602,3.659046374918354,0.0,0.0
21531,2,1531,[546 471  15  25 118],416,3,5605,3.6586161879895562,0.0,0.0
21532,2,1532,[ 97  22  88 228 195],373,4,5609,3.6588388780169603,0.0,0.0
21533,2,1533,[238 100  96 245 204],416,4,5613,3.6590612777053453,0.0,0.0
21534,2,1534,[ 64 301 357  12 269],416,5,5618,3.6599348534201956,40.0,0.0
21535,2,1535,[ 64 301 357  12 269],416,5,5623,3.6608072916666665,40.0,0.0
21536,2,1536,[168 475 588 273 180],805,2,5625,3.659726740403383,0.0,0.0
21537,2,1537,[276 181 313 174  71],43,5,5630,3.660598179453836,20.0,40.0
21538,2,1538,[215 269 300  11   1],751,2,5632,3.659519168291098,0.0,0.0
21539,2,1539,[237 191 179 742 357],62,3,5635,3.659090909090909,0.0,0.0
21540,2,1540,[118 125 228  12  82],62,3,5638,3.6586632057105777,20.0,0.0
21541,2,1541,[172  98 111 275 204],416,5,5643,3.659533073929961,0.0,20.0
21542,2,1542,[403   7  95 655  71],618,4,5647,3.6597537265068047,0.0,0.0
21543,2,1543,[  4  12 181 313 132],345,5,5652,3.660621761658031,40.0,40.0
21544,2,1544,[195   9 496 568 168],887,3,5655,3.6601941747572817,0.0,0.0
21545,2,1545,[179 302  11 118 117],416,3,5658,3.6597671410090555,0.0,0.0
21546,2,1546,[323 471 322 282  28],416,3,5661,3.659340659340659,0.0,0.0
21547,2,1547,[  9 328 269 333 153],854,3,5664,3.6589147286821704,0.0,0.0
21548,2,1548,[ 64 301 357  12 269],416,5,5669,3.659780503550678,40.0,0.0
21549,2,1549,[  9  12 258 117 568],43,5,5674,3.6606451612903226,20.0,0.0
21550,2,1550,[588 328 185 258 238],49,3,5677,3.6602192134107026,0.0,0.0
21551,2,1551,[194 210  22 211 161],416,5,5682,3.661082474226804,0.0,0.0
21552,2,1552,[ 64 301 357  12 269],416,5,5687,3.661944623309723,40.0,0.0
21553,2,1553,[168 588  15 181 144],417,2,5689,3.660875160875161,0.0,20.0
21554,2,1554,[ 64 301 357  12 269],416,5,5694,3.661736334405145,40.0,0.0
21555,2,1555,[742  95 508  71 144],38,4,5698,3.6619537275064267,0.0,0.0
21556,2,1556,[ 64 301 357  12 269],416,5,5703,3.6628131021194603,40.0,0.0
21557,2,1557,[475 237  56 135 496],342,4,5707,3.6630295250320923,0.0,0.0
21558,2,1558,[182  15 210 237 288],437,2,5709,3.6619627966645285,0.0,20.0
21559,2,1559,[ 79   7  95 173 180],805,3,5712,3.6615384615384614,0.0,0.0
21560,2,1560,[318 742 258   1 172],345,4,5716,3.6617552850736708,20.0,0.0
21561,2,1561,[135 269 435  98 197],297,3,5719,3.6613316261203583,0.0,20.0
21562,2,1562,[ 97 117 195 118  70],654,3,5722,3.6609085092770313,0.0,0.0
21563,2,1563,[333 385 269 234  69],345,3,5725,3.6604859335038364,0.0,0.0
21564,2,1564,[180 568   7 323   1],417,2,5727,3.6594249201277957,0.0,0.0
21565,2,1565,[153 181  71  89   4],373,5,5732,3.660280970625798,0.0,20.0
21566,2,1566,[318 258 194 144 269],854,3,5735,3.6598596043395024,20.0,0.0
21567,2,1567,[215 276  98 269  50],43,5,5740,3.6607142857142856,0.0,40.0
21568,2,1568,[ 64 301 357  12 269],416,5,5745,3.661567877629063,40.0,0.0
21569,2,1569,[302  79 172 202   4],405,5,5750,3.662420382165605,0.0,0.0
21570,2,1570,[ 64 301 357  12 269],416,5,5755,3.663271801400382,40.0,0.0
21571,2,1571,[ 64 301 357  12 269],416,5,5760,3.66412213740458,40.0,0.0
21572,2,1572,[ 98 742 204 271  11],805,1,5761,3.662428480610299,0.0,20.0
21573,2,1573,[ 64 301 357  12 269],416,5,5766,3.6632782719186787,40.0,0.0
21574,2,1574,[ 64 301 357  12 269],416,5,5771,3.6641269841269843,40.0,0.0
21575,2,1575,[ 64 471 173 235   1],43,3,5774,3.6637055837563453,20.0,0.0
21576,2,1576,[313 215 210  88  12],345,5,5779,3.664552948636652,40.0,20.0
21577,2,1577,[ 64 301 357  12 269],416,5,5784,3.665399239543726,40.0,0.0
21578,2,1578,[323 125  11 210 313],345,3,5787,3.6649778340721975,20.0,20.0
21579,2,1579,[ 64 301 357  12 269],416,5,5792,3.6658227848101266,40.0,0.0
21580,2,1580,[ 64 301 357  12 269],416,5,5797,3.6666666666666665,40.0,0.0
21581,2,1581,[258 117 191 742   7],805,2,5799,3.665613147914033,0.0,0.0
21582,2,1582,[403 427  22  70   1],618,4,5803,3.6658243840808593,0.0,0.0
21583,2,1583,[  4 161 135 195 144],373,3,5806,3.66540404040404,0.0,0.0
21584,2,1584,[235 174 121 182  98],417,2,5808,3.6643533123028393,0.0,20.0
21585,2,1585,[215 127 275 174 200],618,4,5812,3.6645649432534677,0.0,0.0
21586,2,1586,[ 64 301 357  12 269],416,5,5817,3.665406427221172,40.0,0.0
21587,2,1587,[100 546 423  11 742],416,4,5821,3.665617128463476,0.0,0.0
21588,2,1588,[183  28 197 385 273],618,4,5825,3.6658275645059786,0.0,0.0
21589,2,1589,[100 135 143 196  95],437,5,5830,3.6666666666666665,0.0,0.0
21590,2,1590,[ 64 301 357  12 269],416,5,5835,3.6675047140163417,40.0,0.0
21591,2,1591,[196 168 172 173   8],654,5,5840,3.6683417085427137,0.0,0.0
21592,2,1592,[282 196 117 151 655],416,4,5844,3.6685499058380415,0.0,0.0
21593,2,1593,[357 603 515  12 143],297,5,5849,3.6693851944792972,20.0,0.0
21594,2,1594,[ 79 202 403  69 257],417,2,5851,3.66833855799373,0.0,0.0
21595,2,1595,[182  12 313 215 289],416,4,5855,3.668546365914787,40.0,20.0
21596,2,1596,[ 64 301 357  12 269],416,5,5860,3.6693800876643707,40.0,0.0
21597,2,1597,[ 64 301 357  12 269],416,5,5865,3.6702127659574466,40.0,0.0
21598,2,1598,[ 64 301 357  12 269],416,5,5870,3.6710444027517197,40.0,0.0
21599,2,1599,[ 64 301 357  12 269],416,5,5875,3.671875,40.0,0.0
21600,2,1600,[357 427 151   8 288],601,2,5877,3.6708307307932544,0.0,20.0
21601,2,1601,[ 64 301 357  12 269],416,5,5882,3.671660424469413,40.0,0.0
21602,2,1602,[187 173 328 179 333],416,4,5886,3.671865252651279,0.0,0.0
21603,2,1603,[ 12 144  15 268 294],588,4,5890,3.672069825436409,20.0,0.0
21604,2,1604,[ 64 301 357  12 269],416,5,5895,3.6728971962616823,40.0,0.0
21605,2,1605,[ 22 173 176  98 222],764,4,5899,3.6731008717310085,0.0,20.0
21606,2,1606,[132 302 385 174 301],345,4,5903,3.6733042937149967,0.0,0.0
21607,2,1607,[ 64 301 357  12 269],416,5,5908,3.674129353233831,40.0,0.0
21608,2,1608,[ 25 144 180  82 195],805,1,5909,3.6724673710379117,0.0,0.0
21609,2,1609,[202  70 597 403   1],43,4,5913,3.6726708074534162,0.0,0.0
21610,2,1610,[180  89 204 183 423],437,3,5916,3.6722532588454375,0.0,0.0
21611,2,1611,[483 194 471 282 475],854,2,5918,3.6712158808933,20.0,0.0
21612,2,1612,[238 195 228 258 161],198,2,5920,3.6701797892126473,0.0,0.0
21613,2,1613,[322 215   8   9  70],314,4,5924,3.670384138785626,0.0,0.0
21614,2,1614,[ 64 301 357  12 269],416,5,5929,3.6712074303405573,40.0,0.0
21615,2,1615,[151 271 288 175 568],922,1,5930,3.6695544554455446,0.0,20.0
21616,2,1616,[ 64 301 357  12 269],416,5,5935,3.6703772418058134,40.0,0.0
21617,2,1617,[161  64 118 176 216],618,3,5938,3.6699629171817056,20.0,0.0
21618,2,1618,[ 64 301 357  12 269],416,5,5943,3.6707844348363188,40.0,0.0
21619,2,1619,[ 70  64  22 313  69],416,5,5948,3.6716049382716047,40.0,20.0
21620,2,1620,[204 195  82 742 597],416,4,5952,3.671807526218384,0.0,0.0
21621,2,1621,[191 568  50 515 597],417,2,5954,3.6707768187422936,0.0,20.0
21622,2,1622,[ 95 200 546 423 111],416,3,5957,3.6703635243376462,0.0,0.0
21623,2,1623,[ 97 742 603 405  28],128,3,5960,3.6699507389162562,0.0,0.0
21624,2,1624,[435 202 183  96 427],698,1,5961,3.6683076923076925,0.0,0.0
21625,2,1625,[ 70 174 282 323  64],630,2,5963,3.667281672816728,20.0,0.0
21626,2,1626,[ 64 301 357  12 269],416,5,5968,3.668100799016595,40.0,0.0
21627,2,1627,[318 322 301 238  96],416,4,5972,3.6683046683046685,20.0,0.0
21628,2,1628,[  4 269 174 132 200],345,5,5977,3.669122160834868,0.0,0.0
21629,2,1629,[ 28 237  56 216 191],62,3,5980,3.668711656441718,0.0,0.0
21630,2,1630,[186 603 282 276 655],128,3,5983,3.6683016554261187,0.0,0.0
21631,2,1631,[211 288 748 597 127],417,3,5986,3.667892156862745,0.0,20.0
21632,2,1632,[742  98   1 288 195],416,5,5991,3.668707899571341,0.0,40.0
21633,2,1633,[ 12  70 238   7 275],618,2,5993,3.667686658506732,20.0,0.0
21634,2,1634,[ 64 301 357  12 269],416,5,5998,3.6685015290519876,40.0,0.0
21635,2,1635,[ 64 301 357  12 269],416,5,6003,3.6693154034229827,40.0,0.0
21636,2,1636,[ 82  79 179 603 403],416,4,6007,3.6695174098961516,0.0,0.0
21637,2,1637,[161 135 118 423 282],618,3,6010,3.669108669108669,0.0,0.0
21638,2,1638,[742 328  71  15 546],314,5,6015,3.669920683343502,0.0,0.0
21639,2,1639,[435  28 603  98 173],297,4,6019,3.670121951219512,0.0,20.0
21640,2,1640,[195 127 313  82 183],618,4,6023,3.6703229737964658,20.0,20.0
21641,2,1641,[179 185  95 496 423],416,3,6026,3.6699147381242385,0.0,0.0
21642,2,1642,[318 405  12 182 546],62,4,6030,3.6701156421180765,40.0,0.0
21643,2,1643,[301 294 742 405 423],43,5,6035,3.670924574209246,0.0,0.0
21644,2,1644,[204 210 475 268 403],416,4,6039,3.67112462006079,0.0,0.0
21645,2,1645,[ 12 151 216  15 403],416,4,6043,3.671324422843256,20.0,0.0
21646,2,1646,[ 64 301 357  12 269],416,5,6048,3.6721311475409837,40.0,0.0
21647,2,1647,[ 64 301 357  12 269],416,5,6053,3.6729368932038833,40.0,0.0
21648,2,1648,[ 64 301 357  12 269],416,5,6058,3.6737416616130987,40.0,0.0
21649,2,1649,[210 117  71 195 588],705,3,6061,3.6733333333333333,0.0,0.0
21650,2,1650,[271 742 313 151  79],505,3,6064,3.672925499697153,20.0,20.0
21651,2,1651,[  8  50 235 173  28],805,2,6066,3.671912832929782,0.0,20.0
21652,2,1652,[211  97 153 121  12],437,3,6069,3.6715063520871145,20.0,0.0
21653,2,1653,[ 82 318  71  95 181],588,5,6074,3.672309552599758,20.0,20.0
21654,2,1654,[546 127 294 195 748],416,4,6078,3.6725075528700906,0.0,0.0
21655,2,1655,[475 269 100 483 238],214,4,6082,3.672705314009662,20.0,0.0
21656,2,1656,[288 475  50 100 168],62,4,6086,3.672902836451418,0.0,40.0
21657,2,1657,[257 210  95 405 323],43,4,6090,3.6731001206272618,0.0,0.0
21658,2,1658,[496 603 216  79  95],373,5,6095,3.6738999397227246,0.0,0.0
21659,2,1659,[ 64 301 357  12 269],416,5,6100,3.674698795180723,40.0,0.0
21660,2,1660,[ 64 222 357 135 508],62,5,6105,3.6754966887417218,20.0,0.0
21661,2,1661,[588 191 211  56 302],297,4,6109,3.6756919374247894,0.0,0.0
21662,2,1662,[ 64 301 357  12 269],416,5,6114,3.676488274203247,40.0,0.0
21663,2,1663,[ 64 301 357  12 269],416,5,6119,3.6772836538461537,40.0,0.0
21664,2,1664,[ 64 301 357  12 269],416,5,6124,3.678078078078078,40.0,0.0
21665,2,1665,[179  12   1 183 195],417,5,6129,3.6788715486194477,20.0,0.0
21666,2,1666,[ 88 427 245  97 748],416,3,6132,3.6784643071385723,0.0,0.0
21667,2,1667,[ 64 301 357  12 269],416,5,6137,3.6792565947242206,40.0,0.0
21668,2,1668,[568 423 257  96  50],698,2,6139,3.6782504493708807,0.0,20.0
21669,2,1669,[ 64 301 357  12 269],416,5,6144,3.6790419161676646,40.0,0.0
21670,2,1670,[427 268 603 257 181],214,2,6146,3.6780371035308197,0.0,20.0
21671,2,1671,[121 258 268  12  71],49,1,6147,3.6764354066985647,20.0,0.0
21672,2,1672,[161 100 276  82 588],416,4,6151,3.676628810520024,0.0,0.0
21673,2,1673,[143 546 245 603 333],416,3,6154,3.6762246117084825,0.0,0.0
21674,2,1674,[ 64 301 357  12 269],416,5,6159,3.6770149253731343,40.0,0.0
21675,2,1675,[257 435 153 197 143],354,3,6162,3.6766109785202863,0.0,0.0
21676,2,1676,[269 385 173 496   1],416,5,6167,3.6774001192605845,0.0,0.0
21677,2,1677,[ 64 301 357  12 269],416,5,6172,3.6781883194278904,40.0,0.0
21678,2,1678,[ 64 301 357  12 269],416,5,6177,3.678975580702799,40.0,0.0
21679,2,1679,[ 64 301 357  12 269],416,5,6182,3.6797619047619046,40.0,0.0
21680,2,1680,[135 234 228 195 182],417,3,6185,3.67935752528257,0.0,0.0
21681,2,1681,[194 294 132 204 228],698,3,6188,3.6789536266349585,0.0,0.0
21682,2,1682,[ 98 181 186 197  69],437,3,6191,3.6785502079619725,0.0,40.0
21683,2,1683,[ 50   1 195  28 181],416,5,6196,3.679334916864608,0.0,40.0
21684,2,1684,[216 603 276 174 143],354,3,6199,3.6789317507418398,0.0,0.0
21685,2,1685,[ 64 301 357  12 269],416,5,6204,3.679715302491103,40.0,0.0
21686,2,1686,[265 175 238 191 182],297,2,6206,3.678719620628334,0.0,0.0
21687,2,1687,[ 98  79 245  15 515],417,4,6210,3.678909952606635,0.0,20.0
21688,2,1688,[143 216 235 748 423],805,0,6210,3.6767317939609234,0.0,0.0
21689,2,1689,[ 64 301 357  12 269],416,5,6215,3.6775147928994083,40.0,0.0
21690,2,1690,[568 427  15  28  71],416,5,6220,3.6782968657599056,0.0,0.0
21691,2,1691,[143 121 182 268 258],416,5,6225,3.6790780141843973,0.0,0.0
21692,2,1692,[597 357 204 196 210],416,4,6229,3.679267572356763,0.0,0.0
21693,2,1693,[ 64 301 357  12 269],416,5,6234,3.680047225501771,40.0,0.0
21694,2,1694,[180 286 257   7 508],354,2,6236,3.67905604719764,0.0,0.0
21695,2,1695,[168 234  50 597  22],642,4,6240,3.6792452830188678,0.0,20.0
21696,2,1696,[ 64 301 357  12 269],416,5,6245,3.6800235710076605,40.0,0.0
21697,2,1697,[546 195 151 234 235],416,2,6247,3.6790341578327443,0.0,0.0
21698,2,1698,[111 196 300 202 588],416,5,6252,3.6798116539140673,0.0,0.0
21699,2,1699,[385 568 222 275  22],698,3,6255,3.679411764705882,0.0,0.0
21700,2,1700,[174  12 268 179 323],417,3,6258,3.6790123456790123,20.0,0.0
21701,2,1701,[117 357  28 318 204],642,3,6261,3.6786133960047005,20.0,0.0
21702,2,1702,[269  56 276 197  97],416,4,6265,3.6788021139166176,0.0,0.0
21703,2,1703,[302  28 238  25 135],297,5,6270,3.6795774647887325,0.0,0.0
21704,2,1704,[183 313   4 195 210],405,4,6274,3.679765395894428,20.0,20.0
21705,2,1705,[195 210 174 211 185],230,4,6278,3.679953106682298,0.0,0.0
21706,2,1706,[ 64 301  12 357 269],416,5,6283,3.6807264206209727,40.0,0.0
21707,2,1707,[ 89 182 187  69  98],214,4,6287,3.680913348946136,0.0,20.0
21708,2,1708,[181  71 423 257 176],887,4,6291,3.6811000585137506,0.0,20.0
21709,2,1709,[275 187 216 257 288],416,4,6295,3.681286549707602,0.0,20.0
21710,2,1710,[100  82 423 143 302],654,4,6299,3.6814728229105786,0.0,0.0
21711,2,1711,[183 174 202  22 357],405,4,6303,3.681658878504673,0.0,0.0
21712,2,1712,[  9 143 135  96 174],601,3,6306,3.681260945709282,0.0,0.0
21713,2,1713,[202 196 423  95 168],711,4,6310,3.6814469078179695,0.0,0.0
21714,2,1714,[ 64 301  12 357 269],416,5,6315,3.682215743440233,40.0,0.0
21715,2,1715,[385 273 235  50 294],805,1,6316,3.6806526806526807,0.0,20.0
21716,2,1716,[ 64 301  12 357 269],416,5,6321,3.681421083284799,40.0,0.0
21717,2,1717,[ 64 301  12 357 269],416,5,6326,3.682188591385332,40.0,0.0
21718,2,1718,[ 64 301  12 357 269],416,5,6331,3.682955206515416,40.0,0.0
21719,2,1719,[234 121 385  50 655],262,1,6332,3.681395348837209,0.0,20.0
21720,2,1720,[318 117   1 405 100],274,5,6337,3.682161533991865,20.0,0.0
21721,2,1721,[151 423 275  25 496],354,2,6339,3.681184668989547,0.0,0.0
21722,2,1722,[200   8 269 546 197],297,2,6341,3.6802089378990135,0.0,0.0
21723,2,1723,[427 125 143 294 423],642,3,6344,3.679814385150812,0.0,0.0
21724,2,1724,[ 22 174  25   1 202],618,3,6347,3.6794202898550723,0.0,0.0
21725,2,1725,[ 11 111 322 202 174],805,0,6347,3.6772885283893397,0.0,0.0
21726,2,1726,[ 28 483 276 174 118],62,3,6350,3.6768963520555875,20.0,0.0
21727,2,1727,[288 174 179 588  28],405,3,6353,3.6765046296296298,0.0,20.0
21728,2,1728,[ 64 301  12 357 269],416,5,6358,3.67727009832273,40.0,0.0
21729,2,1729,[286 194 215 282 302],297,2,6360,3.6763005780346822,0.0,0.0
21730,2,1730,[183 195 186 483 151],601,3,6363,3.6759098786828424,20.0,0.0
21731,2,1731,[173 222 210 238 423],297,4,6367,3.6760969976905313,0.0,0.0
21732,2,1732,[ 50   8 257   7 173],354,3,6370,3.6757068667051356,0.0,20.0
21733,2,1733,[191 144 294 238  25],297,2,6372,3.6747404844290656,0.0,0.0
21734,2,1734,[ 50  95 200 127 151],618,3,6375,3.674351585014409,0.0,20.0
21735,2,1735,[ 64 301  12 357 269],416,5,6380,3.675115207373272,40.0,0.0
21736,2,1736,[174 357 268 234 273],417,3,6383,3.674726540011514,0.0,0.0
21737,2,1737,[  8 435  25 265 237],230,4,6387,3.674913693901036,0.0,0.0
21738,2,1738,[286 151 282 588  79],297,2,6389,3.6739505462909716,0.0,0.0
21739,2,1739,[ 12  71 204 423  56],62,3,6392,3.6735632183908047,20.0,0.0
21740,2,1740,[180 182 174 200 655],417,4,6396,3.6737507179781734,0.0,0.0
21741,2,1741,[ 12 174 153  95 181],654,4,6400,3.6739380022962114,20.0,20.0
21742,2,1742,[ 50 271  56 200 151],297,2,6402,3.6729776247848536,0.0,20.0
21743,2,1743,[216  69 742 258  50],62,4,6406,3.6731651376146788,0.0,20.0
21744,2,1744,[  7 151 185 121 603],214,5,6411,3.673925501432665,0.0,0.0
21745,2,1745,[172 127 176 276 118],198,3,6414,3.6735395189003435,0.0,0.0
21746,2,1746,[118   4 202 257  95],43,5,6419,3.6742987979393247,0.0,0.0
21747,2,1747,[ 64 301  12 357 269],416,5,6424,3.675057208237986,40.0,0.0
21748,2,1748,[ 89 132 405 179  82],198,3,6427,3.6746712407089768,0.0,0.0
21749,2,1749,[ 64 301  12 357 269],416,5,6432,3.6754285714285713,40.0,0.0
21750,2,1750,[118  11 385  12 173],618,3,6435,3.6750428326670472,20.0,0.0
21751,2,1751,[742 403 100  97 235],417,2,6437,3.6740867579908674,0.0,0.0
21752,2,1752,[294 276 748 118 333],159,4,6441,3.674272675413577,0.0,0.0
21753,2,1753,[313 235 245 237  88],907,5,6446,3.6750285062713797,20.0,20.0
21754,2,1754,[210 318  69  12  97],62,4,6450,3.675213675213675,40.0,0.0
21755,2,1755,[  7 237 151  69 117],297,3,6453,3.674829157175399,0.0,0.0
21756,2,1756,[ 64 301  12 357 269],416,5,6458,3.6755833807626637,40.0,0.0
21757,2,1757,[ 64 301  12 357 269],416,5,6463,3.6763367463026166,40.0,0.0
21758,2,1758,[ 64 301  12 357 269],416,5,6468,3.67708925525867,40.0,0.0
21759,2,1759,[215 597 655 187 143],416,4,6472,3.6772727272727272,0.0,0.0
21760,2,1760,[ 64 301  12 357 269],416,5,6477,3.6780238500851787,40.0,0.0
21761,2,1761,[228 210 294 302  70],62,1,6478,3.6765039727582294,0.0,0.0
21762,2,1762,[357  69 211 603 282],416,5,6483,3.6772546795235392,0.0,0.0
21763,2,1763,[191 385 174 288  71],405,3,6486,3.67687074829932,0.0,20.0
21764,2,1764,[588 181 385 195 318],416,5,6491,3.6776203966005667,20.0,20.0
21765,2,1765,[ 64 301  12 357 269],416,5,6496,3.67836919592299,40.0,0.0
21766,2,1766,[678   4 215 216 132],345,4,6500,3.6785512167515564,0.0,0.0
21767,2,1767,[ 64 301  12 357 269],416,5,6505,3.6792986425339365,40.0,0.0
21768,2,1768,[ 89 143  95 210 228],705,2,6507,3.6783493499152065,0.0,0.0
21769,2,1769,[ 64 301  12 357 269],416,5,6512,3.67909604519774,40.0,0.0
21770,2,1770,[191  95 143 183 423],198,2,6514,3.6781479390175043,0.0,0.0
21771,2,1771,[ 64 301  12 357 269],416,5,6519,3.6788939051918734,40.0,0.0
21772,2,1772,[ 25  98  70 211 269],297,5,6524,3.679639029892837,0.0,20.0
21773,2,1773,[289 196 235 257  12],416,2,6526,3.6786922209695603,20.0,0.0
21774,2,1774,[ 64 301  12 357 269],416,5,6531,3.67943661971831,40.0,0.0
21775,2,1775,[568 197 202 273 423],618,3,6534,3.679054054054054,0.0,0.0
21776,2,1776,[204 403 515 282 288],416,5,6539,3.679797411367473,0.0,20.0
21777,2,1777,[ 64 301  12 357 269],416,5,6544,3.6805399325084363,40.0,0.0
21778,2,1778,[ 64 301  12 357 269],416,5,6549,3.681281618887015,40.0,0.0
21779,2,1779,[153 195  64 568 435],230,3,6552,3.6808988764044943,20.0,0.0
21780,2,1780,[215 181 173 151 196],43,5,6557,3.681639528354857,0.0,20.0
21781,2,1781,[179 237 257 173  15],416,2,6559,3.680695847362514,0.0,0.0
21782,2,1782,[  4  12 195 568 117],805,1,6560,3.679192372406057,20.0,0.0
21783,2,1783,[ 12  79  28 588  82],654,5,6565,3.679932735426009,20.0,0.0
21784,2,1784,[ 64 301  12 357 269],416,5,6570,3.680672268907563,40.0,0.0
21785,2,1785,[ 64 301  12 357 269],416,5,6575,3.681410974244121,40.0,0.0
21786,2,1786,[100 282 655  71 496],416,5,6580,3.682148852825965,0.0,0.0
21787,2,1787,[237 195 196   4 161],618,3,6583,3.681767337807606,0.0,0.0
21788,2,1788,[ 64 301  12 357 269],416,5,6588,3.6825041922861934,40.0,0.0
21789,2,1789,[ 64 301  12 357 269],416,5,6593,3.683240223463687,40.0,0.0
21790,2,1790,[235 117  98  95  11],417,4,6597,3.6834170854271355,0.0,20.0
21791,2,1791,[258 176 275  28 175],698,2,6599,3.6824776785714284,0.0,0.0
21792,2,1792,[  7  95 258  71 568],416,4,6603,3.682654768544339,0.0,0.0
21793,2,1793,[588 135 111 161 121],805,1,6604,3.681159420289855,0.0,0.0
21794,2,1794,[ 64 301  12 357 269],416,5,6609,3.6818941504178273,40.0,0.0
21795,2,1795,[496  97  22 117 385],618,5,6614,3.6826280623608016,0.0,0.0
21796,2,1796,[496 546 172 179 238],262,3,6617,3.6822481914301615,0.0,0.0
21797,2,1797,[121 269  79 322 197],416,4,6621,3.682424916573971,0.0,0.0
21798,2,1798,[ 88 176 496 174 196],437,3,6624,3.6820455808782655,0.0,0.0
21799,2,1799,[ 64 301  12 357 269],416,5,6629,3.682777777777778,40.0,0.0
21800,2,1800,[ 64 301  12 357 269],416,5,6634,3.6835091615769016,40.0,0.0
21801,2,1801,[  7  56 197  28 301],751,3,6637,3.683129855715871,0.0,0.0
21802,2,1802,[228  25  89 216 275],373,5,6642,3.6838602329450914,0.0,0.0
21803,2,1803,[200 204 210 202 197],618,1,6643,3.682372505543237,0.0,0.0
21804,2,1804,[235 144 174 151 210],62,4,6647,3.6825484764542935,0.0,0.0
21805,2,1805,[ 88 195 172  95 117],805,1,6648,3.681063122923588,0.0,0.0
21806,2,1806,[ 64 301  12 357 269],416,5,6653,3.6817930271167683,40.0,0.0
21807,2,1807,[ 88 183 172  12  25],416,4,6657,3.6819690265486726,20.0,0.0
21808,2,1808,[ 64 301  12 357 269],416,5,6662,3.6826976229961303,40.0,0.0
21809,2,1809,[ 64 301  12 357 269],416,5,6667,3.683425414364641,40.0,0.0
21810,2,1810,[191 742 202 471 143],128,3,6670,3.68304803975704,0.0,0.0
21811,2,1811,[423 655 173 265  96],405,3,6673,3.682671081677704,0.0,0.0
21812,2,1812,[ 28 144 496   4 302],416,5,6678,3.6833976833976836,0.0,0.0
21813,2,1813,[ 64 301  12 357 269],416,5,6683,3.6841234840132304,40.0,0.0
21814,2,1814,[568 132 196 180 216],417,3,6686,3.683746556473829,0.0,0.0
21815,2,1815,[ 50 210 176 132  28],437,2,6688,3.682819383259912,0.0,20.0
21816,2,1816,[118  98 183 655 282],618,3,6691,3.6824435883324163,0.0,20.0
21817,2,1817,[515 173 111 302 496],416,5,6696,3.6831683168316833,0.0,0.0
21818,2,1818,[182  95 288   7 245],297,1,6697,3.6816932380428806,0.0,20.0
21819,2,1819,[ 28 173 318 168 471],618,3,6700,3.681318681318681,20.0,0.0
21820,2,1820,[211 168 271 238 111],43,3,6703,3.680944535969248,0.0,0.0
21821,2,1821,[655 265 185 475 204],711,3,6706,3.680570801317234,0.0,0.0
21822,2,1822,[168 237  96 483 271],62,3,6709,3.68019747668678,20.0,0.0
21823,2,1823,[151  56 144 238 403],417,4,6713,3.6803728070175437,0.0,0.0
21824,2,1824,[ 97 132   9  25 269],416,5,6718,3.6810958904109587,0.0,0.0
21825,2,1825,[ 64 301  12 357 269],416,5,6723,3.6818181818181817,40.0,0.0
21826,2,1826,[182 323 597 191  96],416,3,6726,3.6814449917898195,0.0,0.0
21827,2,1827,[ 25 175 132 194 100],854,3,6729,3.6810722100656457,0.0,0.0
21828,2,1828,[182  69 100 471 588],297,2,6731,3.6801530891197376,0.0,0.0
21829,2,1829,[ 64 301  12 357 269],416,5,6736,3.6808743169398905,40.0,0.0
21830,2,1830,[ 64 301  12 357 269],416,5,6741,3.681594756963408,40.0,0.0
21831,2,1831,[ 64 301  12 357 269],416,5,6746,3.682314410480349,40.0,0.0
21832,2,1832,[318   9  56 568 151],618,3,6749,3.6819421713038736,20.0,0.0
21833,2,1833,[ 79 215 301 318 275],588,4,6753,3.6821155943293347,20.0,0.0
21834,2,1834,[ 12 182 301 357 100],297,4,6757,3.6822888283378745,20.0,0.0
21835,2,1835,[ 64 301  12 357 269],416,5,6762,3.683006535947712,40.0,0.0
21836,2,1836,[238 268 200 403 125],416,5,6767,3.6837234621665758,0.0,0.0
21837,2,1837,[ 64 301  12 357 269],416,5,6772,3.6844396082698587,40.0,0.0
21838,2,1838,[508 237 173 405 423],854,4,6776,3.684611201740076,0.0,0.0
21839,2,1839,[117 121 546 187 403],416,4,6780,3.6847826086956523,0.0,0.0
21840,2,1840,[357 100 179 568 186],417,3,6783,3.6844106463878328,0.0,0.0
21841,2,1841,[ 64 301  12 357 269],416,5,6788,3.6851248642779586,40.0,0.0
21842,2,1842,[357 269 282 423  22],854,3,6791,3.684753119913185,0.0,0.0
21843,2,1843,[ 64 301  12 357 269],416,5,6796,3.685466377440347,40.0,0.0
21844,2,1844,[132   4 143  15 318],618,3,6799,3.6850948509485093,20.0,0.0
21845,2,1845,[ 64 301  12 357 269],416,5,6804,3.685807150595883,40.0,0.0
21846,2,1846,[180   9 125   1 271],62,3,6807,3.685435841905793,0.0,0.0
21847,2,1847,[ 64 301  12 357 269],416,5,6812,3.686147186147186,40.0,0.0
21848,2,1848,[ 50 483  79  98 268],128,4,6816,3.6863169280692265,20.0,40.0
21849,2,1849,[  1 180 483 210  70],128,4,6820,3.6864864864864866,20.0,0.0
21850,2,1850,[ 22   4 475  50 180],805,2,6822,3.685575364667747,0.0,20.0
21851,2,1851,[ 64 301  12 357 269],416,5,6827,3.6862850971922247,40.0,0.0
21852,2,1852,[ 64 301  12 357 269],416,5,6832,3.686994063680518,40.0,0.0
21853,2,1853,[100  69  25 357   8],416,5,6837,3.6877022653721685,0.0,0.0
21854,2,1854,[195 294 568  82  64],642,4,6841,3.6878706199460916,20.0,0.0
21855,2,1855,[202  88 318   4 197],373,3,6844,3.6875,20.0,0.0
21856,2,1856,[238 121 257  70 405],62,2,6846,3.6865912762520194,0.0,0.0
21857,2,1857,[313 268 125 245 568],345,3,6849,3.686221743810549,20.0,20.0
21858,2,1858,[  4  79 135 234 300],297,1,6850,3.6847767616998386,0.0,0.0
21859,2,1859,[ 64 301  12 357 269],416,5,6855,3.685483870967742,40.0,0.0
21860,2,1860,[568  25  28 161 204],618,3,6858,3.6851155292853304,0.0,0.0
21861,2,1861,[174  71 143 168 276],12,5,6863,3.6858216970998927,0.0,0.0
21862,2,1862,[180  11 179  12 238],805,3,6866,3.6854535695115405,20.0,0.0
21863,2,1863,[179  25 100 427  69],416,4,6870,3.6856223175965663,0.0,0.0
21864,2,1864,[ 64 301  12 357 269],416,5,6875,3.6863270777479893,40.0,0.0
21865,2,1865,[ 56 132 301 182 435],437,2,6877,3.685423365487674,0.0,0.0
21866,2,1866,[168 496 172 483 173],437,4,6881,3.685591858596679,20.0,0.0
21867,2,1867,[121 237 568 234  89],253,5,6886,3.6862955032119915,0.0,0.0
21868,2,1868,[ 95   7 403  79 200],417,3,6889,3.685928303905832,0.0,0.0
21869,2,1869,[ 22 300 143 265 423],705,3,6892,3.685561497326203,0.0,0.0
21870,2,1870,[265 215 100  69 301],437,1,6893,3.68412613575628,0.0,0.0
21871,2,1871,[ 50   8 111 496 211],416,5,6898,3.6848290598290596,0.0,20.0
21872,2,1872,[301 197 258 678 289],416,3,6901,3.6844634276561665,0.0,0.0
21873,2,1873,[ 64  12 357 301 269],416,5,6906,3.6851654215581644,40.0,0.0
21874,2,1874,[276 195 655 182  82],618,3,6909,3.6848,0.0,0.0
21875,2,1875,[ 56  22   8 179 173],805,3,6912,3.6844349680170576,0.0,0.0
21876,2,1876,[546 176  64 179 181],62,5,6917,3.685135855087906,20.0,20.0
21877,2,1877,[216  82 127  56  28],43,5,6922,3.685835995740149,0.0,0.0
21878,2,1878,[275 322 125 313 245],907,5,6927,3.6865353911655134,20.0,20.0
21879,2,1879,[ 64  12 357 301 269],416,5,6932,3.6872340425531913,40.0,0.0
21880,2,1880,[179 435 127 318 197],721,5,6937,3.687931951089846,20.0,0.0
21881,2,1881,[ 64  12 357 301 269],416,5,6942,3.6886291179596173,40.0,0.0
21882,2,1882,[ 98 191 181 423 196],805,2,6944,3.687732342007435,0.0,40.0
21883,2,1883,[276 144   8 289  89],342,2,6946,3.686836518046709,0.0,0.0
21884,2,1884,[288 216 111 748 117],297,2,6948,3.6859416445623343,0.0,20.0
21885,2,1885,[ 64  12 357 301 269],416,5,6953,3.686638388123012,40.0,0.0
21886,2,1886,[258 168 210  25 185],354,2,6955,3.685744568097509,0.0,0.0
21887,2,1887,[ 64  12 357 301 269],416,5,6960,3.6864406779661016,40.0,0.0
21888,2,1888,[483 117 197  11 328],854,3,6963,3.6860772895712017,20.0,0.0
21889,2,1889,[ 64  12 357 301 269],416,5,6968,3.6867724867724867,40.0,0.0
21890,2,1890,[ 64  12 357 301 269],416,5,6973,3.6874669487043894,40.0,0.0
21891,2,1891,[302  64 173  69 282],854,3,6976,3.6871035940803383,20.0,0.0
21892,2,1892,[678 196  12 144  28],297,3,6979,3.686740623349181,20.0,0.0
21893,2,1893,[ 50 195 196 161 100],437,3,6982,3.6863780359028513,0.0,20.0
21894,2,1894,[ 79  12 186 191 357],405,5,6987,3.6870712401055408,20.0,0.0
21895,2,1895,[483 496 238 111 215],618,3,6990,3.6867088607594938,20.0,0.0
21896,2,1896,[186 318 100 286 172],43,4,6994,3.6868740115972587,20.0,0.0
21897,2,1897,[ 64  12 357 301 269],416,5,6999,3.6875658587987354,40.0,0.0
21898,2,1898,[ 25 546 174  15 323],416,3,7002,3.6872037914691944,0.0,0.0
21899,2,1899,[322  11 125 168 200],416,4,7006,3.6873684210526316,0.0,0.0
21900,2,1900,[ 64  12 357 301 269],416,5,7011,3.6880589163598105,40.0,0.0
21901,2,1901,[235  28 132 144 179],62,3,7014,3.687697160883281,0.0,0.0
21902,2,1902,[546 195 234 265 200],297,0,7014,3.6857593273778244,0.0,0.0
21903,2,1903,[211 180 202  89 508],417,4,7018,3.685924369747899,0.0,0.0
21904,2,1904,[210 268 196  12 238],297,5,7023,3.6866141732283464,20.0,0.0
21905,2,1905,[546 323 111 288 286],416,3,7026,3.6862539349422874,0.0,20.0
21906,2,1906,[ 64  12 357 301 269],416,5,7031,3.6869428421604615,40.0,0.0
21907,2,1907,[ 56 403 182 135 294],417,4,7035,3.6871069182389937,0.0,0.0
21908,2,1908,[172 135  71  50 121],198,3,7038,3.6867469879518073,0.0,20.0
21909,2,1909,[ 64  12 357 301 269],416,5,7043,3.687434554973822,40.0,0.0
21910,2,1910,[ 64  12 357 301 269],416,5,7048,3.6881214024071167,40.0,0.0
21911,2,1911,[185 603 174 322  22],416,4,7052,3.688284518828452,0.0,0.0
21912,2,1912,[357 173 127 269  22],854,4,7056,3.6884474647151073,0.0,0.0
21913,2,1913,[258 237 496 286   1],43,5,7061,3.6891327063740857,0.0,0.0
21914,2,1914,[ 64  12 357 301 269],416,5,7066,3.689817232375979,40.0,0.0
21915,2,1915,[ 64  12 357 301 269],416,5,7071,3.690501043841336,40.0,0.0
21916,2,1916,[ 64  12 357 301 269],416,5,7076,3.691184141888367,40.0,0.0
21917,2,1917,[100  15  50 286 161],416,5,7081,3.691866527632951,0.0,20.0
21918,2,1918,[546 132 322 258  12],416,3,7084,3.6915059927045335,20.0,0.0
21919,2,1919,[ 64  12 357 301 269],416,5,7089,3.6921875,40.0,0.0
21920,2,1920,[313 161 151 238 202],711,5,7094,3.6928682977615823,20.0,20.0
21921,2,1921,[215 313 197 471 132],345,4,7098,3.693028095733611,20.0,20.0
21922,2,1922,[ 64  12 357 301 269],416,5,7103,3.6937077483099325,40.0,0.0
21923,2,1923,[ 64  12 357 301 269],416,5,7108,3.6943866943866945,40.0,0.0
21924,2,1924,[ 28 176 568 143 202],416,5,7113,3.695064935064935,0.0,0.0
21925,2,1925,[258 742 273  11  50],417,2,7115,3.6941848390446523,0.0,20.0
21926,2,1926,[135 245 172   8  28],721,3,7118,3.6938245978204463,0.0,0.0
21927,2,1927,[ 64  12 357 301 269],416,5,7123,3.694502074688797,40.0,0.0
21928,2,1928,[  8 143  96 655 385],705,2,7125,3.6936236391912907,0.0,0.0
21929,2,1929,[301 403 471 182 276],416,4,7129,3.693782383419689,0.0,0.0
21930,2,1930,[238 597 127  95 153],43,3,7132,3.693423096841015,0.0,0.0
21931,2,1931,[181 144  64   1 179],62,3,7135,3.693064182194617,20.0,20.0
21932,2,1932,[143 475 483   8 235],907,3,7138,3.6927056389032593,20.0,0.0
21933,2,1933,[ 50  71 117 161 125],505,2,7140,3.6918304033092038,0.0,20.0
21934,2,1934,[135 222 238 288  97],417,2,7142,3.690956072351421,0.0,20.0
21935,2,1935,[ 64  12 357 301 269],416,5,7147,3.6916322314049586,40.0,0.0
21936,2,1936,[496 185  70 257 168],354,1,7148,3.6902426432627773,0.0,0.0
21937,2,1937,[ 98 186 168 237 235],854,2,7150,3.6893704850361195,0.0,20.0
21938,2,1938,[ 95 132 265 181 202],437,4,7154,3.6895306859205776,0.0,20.0
21939,2,1939,[ 64 275 302 273 176],62,4,7158,3.6896907216494848,20.0,0.0
21940,2,1940,[111  56 508   1  71],314,3,7161,3.6893353941267386,0.0,0.0
21941,2,1941,[275 423 173  79 268],588,3,7164,3.688980432543769,0.0,0.0
21942,2,1942,[ 64  12 357 301 269],416,5,7169,3.689655172413793,40.0,0.0
21943,2,1943,[496 215 288 132  70],416,5,7174,3.6903292181069958,0.0,20.0
21944,2,1944,[385 748 288  12 175],805,2,7176,3.689460154241645,20.0,20.0
21945,2,1945,[196   7 168 216 235],417,2,7178,3.6885919835560124,0.0,0.0
21946,2,1946,[ 64  12 357 301 269],416,5,7183,3.689265536723164,40.0,0.0
21947,2,1947,[238  88  12 118 385],618,3,7186,3.688911704312115,20.0,0.0
21948,2,1948,[ 64  12 357 301 269],416,5,7191,3.689584402257568,40.0,0.0
21949,2,1949,[222 427 300 132 323],198,2,7193,3.6887179487179487,0.0,0.0
21950,2,1950,[423 258 300 245 196],721,3,7196,3.6883649410558688,0.0,0.0
21951,2,1951,[202 176 228 258   1],922,4,7200,3.6885245901639343,0.0,0.0
21952,2,1952,[186  95 655 161 313],711,4,7204,3.68868407578085,20.0,20.0
21953,2,1953,[ 64  12 357 301 269],416,5,7209,3.68935516888434,40.0,0.0
21954,2,1954,[187 318  15  97 179],198,3,7212,3.689002557544757,20.0,0.0
21955,2,1955,[  9 111  97 276 405],43,5,7217,3.6896728016359917,0.0,0.0
21956,2,1956,[568 475  69 405 135],198,3,7220,3.6893203883495147,0.0,0.0
21957,2,1957,[ 12  88 143 289 151],588,4,7224,3.689479060265577,20.0,0.0
21958,2,1958,[357  97 174 191 196],373,4,7228,3.689637570188872,0.0,0.0
21959,2,1959,[ 96  95 132 202 118],416,3,7231,3.6892857142857145,0.0,0.0
21960,2,1960,[357 603 475 742   7],297,4,7235,3.689444161142274,0.0,0.0
21961,2,1961,[515 186  11  95 187],405,3,7238,3.689092762487258,0.0,0.0
21962,2,1962,[216 117  28  71 174],373,4,7242,3.689251146204789,0.0,0.0
21963,2,1963,[117 597 168   8 423],642,4,7246,3.6894093686354377,0.0,0.0
21964,2,1964,[ 64  12 357 301 269],416,5,7251,3.6900763358778628,40.0,0.0
21965,2,1965,[ 64  12 357 301 269],416,5,7256,3.690742624618515,40.0,0.0
21966,2,1966,[168 322 588 385 288],416,4,7260,3.6908998474834775,0.0,20.0
21967,2,1967,[ 64  12 357 301 269],416,5,7265,3.6915650406504064,40.0,0.0
21968,2,1968,[276 403   7  64 187],198,4,7269,3.691721686135094,20.0,0.0
21969,2,1969,[ 64  12 357 301 269],416,5,7274,3.6923857868020304,40.0,0.0
21970,2,1970,[275 288 294 181 215],416,5,7279,3.693049213597159,0.0,40.0
21971,2,1971,[313 568 742 132 288],642,3,7282,3.6926977687626774,20.0,40.0
21972,2,1972,[197  50  56 185  15],198,3,7285,3.6923466801824634,0.0,20.0
21973,2,1973,[ 64  12 357 301 269],416,5,7290,3.6930091185410334,40.0,0.0
21974,2,1974,[151 508 200  11  79],297,2,7292,3.6921518987341773,0.0,0.0
21975,2,1975,[ 64  12 357 301 269],416,5,7297,3.692813765182186,40.0,0.0
21976,2,1976,[197 144 237 275 176],416,4,7301,3.6929691451694486,0.0,0.0
21977,2,1977,[ 64  12 357 301 269],416,5,7306,3.693629929221436,40.0,0.0
21978,2,1978,[ 64  12 357 301 269],416,5,7311,3.694290045477514,40.0,0.0
21979,2,1979,[195 515  79 118  71],416,4,7315,3.6944444444444446,0.0,0.0
21980,2,1980,[313  71 143 275 597],416,4,7319,3.6945986875315495,20.0,20.0
21981,2,1981,[301  50 174 313 111],345,5,7324,3.6952573158425834,20.0,40.0
21982,2,1982,[286 118 204 181 282],297,2,7326,3.6944024205748867,0.0,20.0
21983,2,1983,[289   7  15 151 405],854,3,7329,3.6940524193548385,0.0,0.0
21984,2,1984,[300 496  82 237  98],505,4,7333,3.694206549118388,0.0,20.0
21985,2,1985,[ 64  12 357 301 269],416,5,7338,3.694864048338369,40.0,0.0
21986,2,1986,[ 98 181 568 125 301],345,4,7342,3.6950176144942124,0.0,40.0
21987,2,1987,[ 64  12 357 301 269],416,5,7347,3.6956740442655938,40.0,0.0
21988,2,1988,[127 118 183 588  97],416,4,7351,3.6958270487682254,0.0,0.0
21989,2,1989,[187 496  15 151  56],416,4,7355,3.6959798994974875,0.0,0.0
21990,2,1990,[ 64  12 357 301 269],416,5,7360,3.696634856855851,40.0,0.0
21991,2,1991,[300 173 197 568 313],345,4,7364,3.6967871485943773,20.0,20.0
21992,2,1992,[215 111 269  82 385],654,5,7369,3.697441043652785,0.0,0.0
21993,2,1993,[ 64  12 357 301 269],416,5,7374,3.6980942828485457,40.0,0.0
21994,2,1994,[ 69 125  50 135 385],417,2,7376,3.6972431077694234,0.0,20.0
21995,2,1995,[ 64  12 357 301 269],416,5,7381,3.6978957915831665,40.0,0.0
21996,2,1996,[ 89 435  70 234 300],297,2,7383,3.6970455683525287,0.0,0.0
21997,2,1997,[ 64  12 357 301 269],416,5,7388,3.6976976976976976,40.0,0.0
21998,2,1998,[427   9 423 234 328],416,5,7393,3.698349174587294,0.0,0.0
21999,2,1999,[  8 655 173 294 333],416,5,7398,3.699,0.0,0.0
22000,2,2000,[ 64  12 357 301 269],416,5,7403,3.6996501749125437,40.0,0.0
22001,2,2001,[ 64  12 357 301 269],416,5,7408,3.7002997002997002,40.0,0.0
22002,2,2002,[173  95 135 202  69],618,2,7410,3.6994508237643533,0.0,0.0
22003,2,2003,[322 237 238 269 245],416,2,7412,3.6986027944111775,0.0,0.0
22004,2,2004,[ 50 100 385 655  89],417,3,7415,3.6982543640897756,0.0,20.0
22005,2,2005,[ 64  12 357 301 269],416,5,7420,3.698903290129611,40.0,0.0
22006,2,2006,[ 64  12 357 301 269],416,5,7425,3.6995515695067263,40.0,0.0
22007,2,2007,[191   8  28  96   1],642,5,7430,3.700199203187251,0.0,0.0
22008,2,2008,[288 176 197 258  25],416,5,7435,3.7008461921353906,0.0,20.0
22009,2,2009,[ 64  12 357 301 269],416,5,7440,3.701492537313433,40.0,0.0
22010,2,2010,[603 200 294 235  98],805,3,7443,3.7011437095972153,0.0,20.0
22011,2,2011,[ 64  12 357 301 269],416,5,7448,3.701789264413519,40.0,0.0
22012,2,2012,[ 64  12 357 301 269],416,5,7453,3.702434177844014,40.0,0.0
22013,2,2013,[186 151 483  50  82],618,4,7457,3.7025819265143993,20.0,20.0
22014,2,2014,[ 64  12 357 301 269],416,5,7462,3.703225806451613,40.0,0.0
22015,2,2015,[265 135 385 276 144],618,4,7466,3.703373015873016,0.0,0.0
22016,2,2016,[ 64  12 357 301 269],416,5,7471,3.704015865146257,40.0,0.0
22017,2,2017,[ 64  12 357 301 269],416,5,7476,3.7046580773042614,40.0,0.0
22018,2,2018,[ 64  12 357 301 269],416,5,7481,3.70529965329371,40.0,0.0
22019,2,2019,[ 64  12 357 301 269],416,5,7486,3.705940594059406,40.0,0.0
22020,2,2020,[132 144 294  79 176],505,2,7488,3.7050964868876792,0.0,0.0
22021,2,2021,[268 313 568 191  96],416,5,7493,3.7057368941641937,20.0,20.0
22022,2,2022,[ 64  12 357 301 269],416,5,7498,3.7063766683143844,40.0,0.0
22023,2,2023,[ 64  12 357 301 269],416,5,7503,3.7070158102766797,40.0,0.0
22024,2,2024,[210 294 144 237 182],62,2,7505,3.706172839506173,0.0,0.0
22025,2,2025,[210 186 144 127 588],373,2,7507,3.70533070088845,0.0,0.0
22026,2,2026,[181 403 655 127  12],405,5,7512,3.705969412925506,20.0,20.0
22027,2,2027,[180 196 546 173 405],417,3,7515,3.705621301775148,0.0,0.0
22028,2,2028,[237 200 748 191 161],345,3,7518,3.705273533760473,0.0,0.0
22029,2,2029,[180 322 135 151  82],417,3,7521,3.704926108374384,0.0,0.0
22030,2,2030,[546 286 135  50 196],417,2,7523,3.704086656819301,0.0,20.0
22031,2,2031,[  8  64  11 202 127],43,5,7528,3.704724409448819,20.0,0.0
22032,2,2032,[ 95  70 423  50  97],373,3,7531,3.704377766847024,0.0,20.0
22033,2,2033,[  4 181  56 222  82],654,4,7535,3.7045231071779745,0.0,20.0
22034,2,2034,[258 475 403  69 288],62,4,7539,3.7046683046683047,0.0,20.0
22035,2,2035,[ 64  12 357 301 269],416,5,7544,3.705304518664047,40.0,0.0
22036,2,2036,[245  98 187 471  95],416,3,7547,3.7049582719685814,0.0,20.0
22037,2,2037,[  1 405 313 173 117],751,2,7549,3.7041216879293426,20.0,20.0
22038,2,2038,[118 135 185  22  15],601,3,7552,3.7037763609612555,0.0,0.0
22039,2,2039,[143 121  50  71 258],588,5,7557,3.7044117647058825,0.0,20.0
22040,2,2040,[ 64  12 357 301 269],416,5,7562,3.7050465458108772,40.0,0.0
22041,2,2041,[ 64  12 357 301 269],416,5,7567,3.7056807051909892,40.0,0.0
22042,2,2042,[179 475 655   7 269],805,4,7571,3.7058247674987763,0.0,0.0
22043,2,2043,[568  56 117 111 174],416,5,7576,3.7064579256360077,0.0,0.0
22044,2,2044,[ 64  12 357 301 269],416,5,7581,3.707090464547677,40.0,0.0
22045,2,2045,[ 64  12 357 301 269],416,5,7586,3.70772238514174,40.0,0.0
22046,2,2046,[ 64  12 357 301 269],416,5,7591,3.7083536883243773,40.0,0.0
22047,2,2047,[ 64  12 357 301 269],416,5,7596,3.708984375,40.0,0.0
22048,2,2048,[323 135 197  11 191],805,4,7600,3.709126403123475,0.0,0.0
22049,2,2049,[603 742 323 385 153],416,4,7604,3.709268292682927,0.0,0.0
22050,2,2050,[427 405 475 328  15],416,4,7608,3.7094100438810336,0.0,0.0
22051,2,2051,[ 64  12 357 301 269],416,5,7613,3.710038986354776,40.0,0.0
22052,2,2052,[143  95 216 117 588],642,4,7617,3.7101802240623476,0.0,0.0
22053,2,2053,[191  15 328  69 196],373,5,7622,3.7108081791626097,0.0,0.0
22054,2,2054,[328 125 273 185 117],416,5,7627,3.711435523114355,0.0,0.0
22055,2,2055,[257 323  88 127 183],416,2,7629,3.710603112840467,0.0,0.0
22056,2,2056,[245 742 204 258 117],505,3,7632,3.710257656781721,0.0,0.0
22057,2,2057,[118 191  82 318  88],437,2,7634,3.7094266277939747,20.0,0.0
22058,2,2058,[200 127 181 238 294],805,2,7636,3.708596406022341,0.0,20.0
22059,2,2059,[ 64  12 357 301 269],416,5,7641,3.7092233009708737,40.0,0.0
22060,2,2060,[151 215 210 273 168],297,3,7644,3.7088791848617175,0.0,0.0
22061,2,2061,[257 294 191  79 405],43,5,7649,3.7095053346265763,0.0,0.0
22062,2,2062,[405 191 423 180 742],805,1,7650,3.7081919534658265,0.0,0.0
22063,2,2063,[ 97 234 742  96 235],417,2,7652,3.7073643410852712,0.0,0.0
22064,2,2064,[ 95 173 245  97 275],297,3,7655,3.7070217917675543,0.0,0.0
22065,2,2065,[313 301 269  88 174],43,5,7660,3.707647628267183,20.0,20.0
22066,2,2066,[471 273 125 678   4],416,4,7664,3.7077890662796325,0.0,0.0
22067,2,2067,[ 88 286 143 258 237],43,5,7669,3.708413926499033,0.0,0.0
22068,2,2068,[ 64  12 357 301 269],416,5,7674,3.709038182696955,40.0,0.0
22069,2,2069,[ 64  12 357 301 269],416,5,7679,3.7096618357487925,40.0,0.0
22070,2,2070,[176 235  25  89 273],297,4,7683,3.7098020280057944,0.0,0.0
22071,2,2071,[ 64  12 357 301 269],416,5,7688,3.7104247104247103,40.0,0.0
22072,2,2072,[ 64  12 357 301 269],416,5,7693,3.7110467920887604,40.0,0.0
22073,2,2073,[ 28 235  25 471 135],297,3,7696,3.7107039537126325,0.0,0.0
22074,2,2074,[121 275 204 111 135],437,3,7699,3.7103614457831324,0.0,0.0
22075,2,2075,[196 183 678 153 588],416,4,7703,3.7105009633911368,0.0,0.0
22076,2,2076,[ 64  12 357 301 269],416,5,7708,3.711121810303322,40.0,0.0
22077,2,2077,[161 286 125 333 216],345,1,7709,3.7098171318575552,0.0,0.0
22078,2,2078,[ 64  12 357 301 269],416,5,7714,3.7104377104377106,40.0,0.0
22079,2,2079,[427 143 215  69 168],405,4,7718,3.710576923076923,0.0,0.0
22080,2,2080,[301 385 151  56 182],416,4,7722,3.710716001922153,0.0,0.0
22081,2,2081,[ 64  12 357 301 269],416,5,7727,3.71133525456292,40.0,0.0
22082,2,2082,[471 127  15 200   9],618,2,7729,3.7105136821891502,0.0,0.0
22083,2,2083,[161 405  28   4 210],345,3,7732,3.7101727447216892,0.0,0.0
22084,2,2084,[181 265 174 301 161],416,5,7737,3.710791366906475,0.0,20.0
22085,2,2085,[127 276 143 357 181],416,4,7741,3.710930009587728,0.0,20.0
22086,2,2086,[238 111 176 174 191],437,3,7744,3.7105893627216098,0.0,0.0
22087,2,2087,[127  56  79 603  50],405,4,7748,3.710727969348659,0.0,20.0
22088,2,2088,[ 64  12 357 301 269],416,5,7753,3.711345141215893,40.0,0.0
22089,2,2089,[173 210 742 144 182],297,2,7755,3.710526315789474,0.0,0.0
22090,2,2090,[475 132 196 151 161],437,3,7758,3.710186513629842,0.0,0.0
22091,2,2091,[ 64  12 357 301 269],416,5,7763,3.7108030592734225,40.0,0.0
22092,2,2092,[144  71  22  69 471],373,3,7766,3.710463449593884,0.0,0.0
22093,2,2093,[276   8  89   7 568],214,4,7770,3.7106017191977076,0.0,0.0
22094,2,2094,[ 64  12 357 301 269],416,5,7775,3.711217183770883,40.0,0.0
22095,2,2095,[ 64  12 357 301 269],416,5,7780,3.7118320610687023,40.0,0.0
22096,2,2096,[ 64  12 357 301 269],416,5,7785,3.7124463519313307,40.0,0.0
22097,2,2097,[ 64  12 357 301 269],416,5,7790,3.713060057197331,40.0,0.0
22098,2,2098,[172  56  82 269 127],721,4,7794,3.7131967603620772,0.0,0.0
22099,2,2099,[  8 183 496 328 678],416,4,7798,3.7133333333333334,0.0,0.0
22100,2,2100,[172   9 121 161  15],345,3,7801,3.7129938124702524,0.0,0.0
22101,2,2101,[151 313 117 405 322],907,5,7806,3.71360608943863,20.0,20.0
22102,2,2102,[257 273 483 245  70],417,3,7809,3.7132667617689017,20.0,0.0
22103,2,2103,[515 175 245 257 275],297,3,7812,3.7129277566539924,0.0,0.0
22104,2,2104,[286  71 111 313 173],711,2,7814,3.7121140142517817,20.0,20.0
22105,2,2105,[ 64  12 357 301 269],416,5,7819,3.7127255460588793,40.0,0.0
22106,2,2106,[403 269 302 216 318],43,5,7824,3.7133364973896534,20.0,0.0
22107,2,2107,[222 288 180 275 168],711,3,7827,3.712998102466793,0.0,20.0
22108,2,2108,[202 273  96 216 186],417,2,7829,3.712185870080607,0.0,0.0
22109,2,2109,[  4 273 385 322 289],416,3,7832,3.7118483412322276,0.0,0.0
22110,2,2110,[ 71 568 173   9  69],345,4,7836,3.711984841307437,0.0,0.0
22111,2,2111,[655 182 183 234  95],253,4,7840,3.712121212121212,0.0,0.0
22112,2,2112,[ 64  12 357 301 269],416,5,7845,3.7127307146237576,40.0,0.0
22113,2,2113,[175  88 588  64  56],43,4,7849,3.7128666035950806,20.0,0.0
22114,2,2114,[191 289 186 222 211],43,4,7853,3.713002364066194,0.0,0.0
22115,2,2115,[ 64  12 357 301 269],416,5,7858,3.713610586011342,40.0,0.0
22116,2,2116,[269 237   9 258 496],416,4,7862,3.7137458667926313,0.0,0.0
22117,2,2117,[ 64  12 357 301 269],416,5,7867,3.714353163361662,40.0,0.0
22118,2,2118,[ 64  12 357 301 269],416,5,7872,3.714959886739028,40.0,0.0
22119,2,2119,[515 403  22 132  97],416,5,7877,3.715566037735849,0.0,0.0
22120,2,2120,[ 64  12 357 301 269],416,5,7882,3.716171617161716,40.0,0.0
22121,2,2121,[ 69 118  25   4 183],198,2,7884,3.715362865221489,0.0,0.0
22122,2,2122,[215 323  28 385 143],416,4,7888,3.7154969382948657,0.0,0.0
22123,2,2123,[144  64 237  50 132],854,3,7891,3.715160075329567,20.0,20.0
22124,2,2124,[ 64  12 357 301 269],416,5,7896,3.715764705882353,40.0,0.0
22125,2,2125,[185 258 151  22 181],805,2,7898,3.7149576669802444,0.0,20.0
22126,2,2126,[173 100 194 678  22],297,3,7901,3.7146215326751295,0.0,0.0
22127,2,2127,[268 195  96 289  11],416,4,7905,3.7147556390977443,0.0,0.0
22128,2,2128,[135  71 204  89 161],437,2,7907,3.713950211366839,0.0,0.0
22129,2,2129,[ 11 176 151 195 435],505,2,7909,3.7131455399061033,0.0,0.0
22130,2,2130,[ 64  12 357 301 269],416,5,7914,3.713749413420929,40.0,0.0
22131,2,2131,[ 64  12 357 301 269],416,5,7919,3.7143527204502815,40.0,0.0
22132,2,2132,[302 202 471 187 276],416,4,7923,3.7144866385372715,0.0,0.0
22133,2,2133,[222 568  50 288 588],711,2,7925,3.7136832239925024,0.0,40.0
22134,2,2134,[268 265 191 234 222],297,2,7927,3.71288056206089,0.0,0.0
22135,2,2135,[182 185 127  11 568],618,5,7932,3.7134831460674156,0.0,0.0
22136,2,2136,[237  15 257  56 357],342,2,7934,3.71268132896584,0.0,0.0
22137,2,2137,[275  22  97 174   4],373,4,7938,3.7128157156220767,0.0,0.0
22138,2,2138,[125 265 200 286 111],416,5,7943,3.713417484805984,0.0,0.0
22139,2,2139,[ 64  12 301 269 357],416,5,7948,3.714018691588785,40.0,0.0
22140,2,2140,[ 64  12 301 269 357],416,5,7953,3.714619336758524,40.0,0.0
22141,2,2141,[ 71 568 121 276 181],43,5,7958,3.715219421101774,0.0,20.0
22142,2,2142,[300  95 111  28 302],654,5,7963,3.71581894540364,0.0,0.0
22143,2,2143,[515 405  12  71 111],416,5,7968,3.716417910447761,20.0,0.0
22144,2,2144,[200 742 176 238 135],854,3,7971,3.716083916083916,0.0,0.0
22145,2,2145,[118 568 182 187  82],198,2,7973,3.7152842497670084,0.0,0.0
22146,2,2146,[ 64  12 301 269 357],416,5,7978,3.7158826269212857,40.0,0.0
22147,2,2147,[471 597 288 195 318],887,4,7982,3.7160148975791434,20.0,20.0
22148,2,2148,[ 50 174 222 211 483],698,2,7984,3.7152163797114937,20.0,20.0
22149,2,2149,[ 64  12 301 269 357],416,5,7989,3.715813953488372,40.0,0.0
22150,2,2150,[ 64  12 301 269 357],416,5,7994,3.716410971641097,40.0,0.0
22151,2,2151,[ 64  12 301 269 357],416,5,7999,3.717007434944238,40.0,0.0
22152,2,2152,[ 64  12 301 269 357],416,5,8004,3.717603344170924,40.0,0.0
22153,2,2153,[182 172 235 496 301],907,5,8009,3.7181987000928505,0.0,0.0
22154,2,2154,[111 258 403 172   7],417,2,8011,3.717401392111369,0.0,0.0
22155,2,2155,[275 181 742 117 143],297,4,8015,3.7175324675324677,0.0,20.0
22156,2,2156,[ 64  12 301 269 357],416,5,8020,3.7181270282800187,40.0,0.0
22157,2,2157,[ 64  12 301 269 357],416,5,8025,3.7187210379981464,40.0,0.0
22158,2,2158,[127 185   4 313 215],618,4,8029,3.7188513200555815,20.0,20.0
22159,2,2159,[475 118 333 132 471],588,3,8032,3.7185185185185183,0.0,0.0
22160,2,2160,[ 64  12 301 269 357],416,5,8037,3.7191115224433133,40.0,0.0
22161,2,2161,[228 176 182  56  96],62,4,8041,3.719241443108233,0.0,0.0
22162,2,2162,[135 186 238 211   1],230,3,8044,3.718908922792418,0.0,0.0
22163,2,2163,[175 235 222 357  12],805,4,8048,3.7190388170055453,20.0,0.0
22164,2,2164,[ 64  12 301 357 269],416,5,8053,3.7196304849884525,40.0,0.0
22165,2,2165,[294 117 546 588 176],416,4,8057,3.7197599261311174,0.0,0.0
22166,2,2166,[ 64  12 301 357 269],416,5,8062,3.720350715274573,40.0,0.0
22167,2,2167,[ 89  88 173 318 174],437,3,8065,3.7200184501845017,20.0,0.0
22168,2,2168,[288 210 151 273  15],618,1,8066,3.718764407561088,0.0,20.0
22169,2,2169,[ 12 423 588  69 121],654,5,8071,3.7193548387096773,20.0,0.0
22170,2,2170,[ 64  12 301 357 269],416,5,8076,3.71994472593275,40.0,0.0
22171,2,2171,[ 64  12 301 357 269],416,5,8081,3.720534069981584,40.0,0.0
22172,2,2172,[ 70 202 318 153 172],43,5,8086,3.7211228716060747,20.0,0.0
22173,2,2173,[258 257 301 181 515],416,4,8090,3.7212511499540017,0.0,20.0
22174,2,2174,[282 216 515 257 289],416,3,8093,3.720919540229885,0.0,0.0
22175,2,2175,[ 64  12 301 357 269],416,5,8098,3.7215073529411766,40.0,0.0
22176,2,2176,[185 568 288 216 200],417,1,8099,3.720257234726688,0.0,20.0
22177,2,2177,[ 64  12 301 357 269],416,5,8104,3.720844811753903,40.0,0.0
22178,2,2178,[ 97 210 423  70 318],373,3,8107,3.720513997246443,20.0,0.0
22179,2,2179,[174 143 151 153 301],297,4,8111,3.7206422018348624,0.0,0.0
22180,2,2180,[655 588 357 234 748],805,2,8113,3.7198532783127005,0.0,0.0
22181,2,2181,[ 64  12 301 357 269],416,5,8118,3.7204399633363887,40.0,0.0
22182,2,2182,[  9  79 144  11 172],43,5,8123,3.721026110856619,0.0,0.0
22183,2,2183,[ 64  12 301 357 269],416,5,8128,3.7216117216117217,40.0,0.0
22184,2,2184,[118 202 257  56 216],297,2,8130,3.720823798627002,0.0,0.0
22185,2,2185,[ 64  12 301 357 269],416,5,8135,3.721408966148216,40.0,0.0
22186,2,2186,[125 183 151 235 176],887,3,8138,3.7210791037951534,0.0,0.0
22187,2,2187,[183  25   9 176 427],887,2,8140,3.720292504570384,0.0,0.0
22188,2,2188,[ 64 182  95  82 302],405,3,8143,3.719963453631795,20.0,0.0
22189,2,2189,[  8 323 496  98 210],416,4,8147,3.7200913242009133,0.0,20.0
22190,2,2190,[ 70 100 186 245 228],417,3,8150,3.7197626654495664,0.0,0.0
22191,2,2191,[ 64  12 301 357 269],416,5,8155,3.7203467153284673,40.0,0.0
22192,2,2192,[742 603 179 180 423],128,3,8158,3.720018239854081,0.0,0.0
22193,2,2193,[ 15 546 385  69 301],416,4,8162,3.720145852324521,0.0,0.0
22194,2,2194,[ 15 202 265 197  11],618,2,8164,3.719362186788155,0.0,0.0
22195,2,2195,[ 64  12 301 357 269],416,5,8169,3.719945355191257,40.0,0.0
22196,2,2196,[127   7 117 135 196],62,5,8174,3.720527992717342,0.0,0.0
22197,2,2197,[ 64  12 301 357 269],416,5,8179,3.721110100090992,40.0,0.0
22198,2,2198,[588  97  79 168  98],437,2,8181,3.720327421555252,0.0,20.0
22199,2,2199,[172  50 180 168 265],373,4,8185,3.7204545454545452,0.0,20.0
22200,2,2200,[ 95 294 143  96 210],805,1,8186,3.7192185370286235,0.0,0.0
22201,2,2201,[117  82  79 180 135],373,2,8188,3.7184377838328793,0.0,0.0
22202,2,2202,[ 22 405 288 588 678],416,4,8192,3.7185655923740355,0.0,20.0
22203,2,2203,[323  97 168 275 318],43,4,8196,3.7186932849364793,20.0,0.0
22204,2,2204,[ 64  12 301 357 269],416,5,8201,3.7192743764172334,40.0,0.0
22205,2,2205,[ 64  12 301 357 269],416,5,8206,3.7198549410698094,40.0,0.0
22206,2,2206,[196 210 161  82  22],416,5,8211,3.7204349796103307,0.0,0.0
22207,2,2207,[179 235 100 405 403],417,2,8213,3.7196557971014492,0.0,0.0
22208,2,2208,[204 153  69  64  50],262,2,8215,3.718877320054323,20.0,20.0
22209,2,2209,[ 12 288  25 496 121],630,3,8218,3.718552036199095,20.0,20.0
22210,2,2210,[121  64 258 427 237],416,4,8222,3.7186793306196293,20.0,0.0
22211,2,2211,[ 64  12 301 357 269],416,5,8227,3.719258589511754,40.0,0.0
22212,2,2212,[588 333 191 237 405],52,5,8232,3.719837324898328,0.0,0.0
22213,2,2213,[174 405 211 168 216],416,5,8237,3.7204155374887082,0.0,0.0
22214,2,2214,[118 100 403 204 265],198,1,8238,3.7191873589164786,0.0,0.0
22215,2,2215,[ 82 194 276 153 301],416,4,8242,3.7193140794223827,0.0,0.0
22216,2,2216,[204 191  50 172 282],721,4,8246,3.719440685611186,0.0,20.0
22217,2,2217,[168 174  22 423 195],297,3,8249,3.7191163210099187,0.0,0.0
22218,2,2218,[ 22 180 655 181  50],373,4,8253,3.719242902208202,0.0,40.0
22219,2,2219,[144 318 385 257 121],654,5,8258,3.71981981981982,20.0,0.0
22220,2,2220,[228 179 121 196 568],62,3,8261,3.7194957226474563,0.0,0.0
22221,2,2221,[  8   1 111 678 269],416,4,8265,3.7196219621962197,0.0,0.0
22222,2,2222,[275 181  69 118 427],416,4,8269,3.719748088169141,0.0,20.0
22223,2,2223,[121 286 200 655 273],416,5,8274,3.7203237410071943,0.0,0.0
22224,2,2224,[127   9 191 471 265],416,5,8279,3.7208988764044943,0.0,0.0
22225,2,2225,[ 64  12 301 357 269],416,5,8284,3.7214734950584005,40.0,0.0
22226,2,2226,[195 173 191 187 568],405,5,8289,3.72204759766502,0.0,0.0
22227,2,2227,[423 228 475  56 174],198,3,8292,3.7217235188509874,0.0,0.0
22228,2,2228,[275 265 245 176 144],416,4,8296,3.7218483624943923,0.0,0.0
22229,2,2229,[ 64  12 301 357 269],416,5,8301,3.722421524663677,40.0,0.0
22230,2,2230,[143   8 151 318 265],416,4,8305,3.722545943523084,20.0,0.0
22231,2,2231,[118 257 144 195 135],297,1,8306,3.721326164874552,0.0,0.0
22232,2,2232,[655 174 175 111 483],342,3,8309,3.7210031347962382,20.0,0.0
22233,2,2233,[204 748  96 118 132],416,4,8313,3.7211280214861238,0.0,0.0
22234,2,2234,[ 70  64 144 483 174],618,4,8317,3.7212527964205817,40.0,0.0
22235,2,2235,[588 357 742  96 111],417,1,8318,3.7200357781753133,0.0,0.0
22236,2,2236,[151 168  12 222 289],854,4,8322,3.7201609298167186,20.0,0.0
22237,2,2237,[ 64  12 301 357 269],416,5,8327,3.720732797140304,40.0,0.0
22238,2,2238,[228 423 269 318 181],721,5,8332,3.721304153640018,20.0,20.0
22239,2,2239,[245 282 118 100 515],416,3,8335,3.720982142857143,0.0,0.0
22240,2,2240,[ 64  12 301 357 269],416,5,8340,3.7215528781793843,40.0,0.0
22241,2,2241,[655 234 568 475 176],198,3,8343,3.721231043710972,0.0,0.0
22242,2,2242,[ 64  12 301 357 269],416,5,8348,3.7218011591618367,40.0,0.0
22243,2,2243,[ 64  12 301 357 269],416,5,8353,3.7223707664884134,40.0,0.0
22244,2,2244,[357  12 202 294 405],805,2,8355,3.7216035634743876,20.0,0.0
22245,2,2245,[ 96 588  50 238  25],618,2,8357,3.7208370436331255,0.0,20.0
22246,2,2246,[546 117 357 496 385],417,3,8360,3.7205162438807298,0.0,0.0
22247,2,2247,[423 323 403 196  88],43,4,8364,3.7206405693950177,0.0,0.0
22248,2,2248,[180 269 265  79  89],373,4,8368,3.7207647843485994,0.0,0.0
22249,2,2249,[294 179 143 172  12],601,2,8370,3.72,20.0,0.0
22250,2,2250,[ 64  12 301 357 269],416,5,8375,3.720568636161706,40.0,0.0
22251,2,2251,[ 64  12 301 357 269],416,5,8380,3.7211367673179394,40.0,0.0
22252,2,2252,[ 64  12 301 357 269],416,5,8385,3.721704394141145,40.0,0.0
22253,2,2253,[ 64  12 301 357 269],416,5,8390,3.7222715173025733,40.0,0.0
22254,2,2254,[496 175 179 748 168],373,3,8393,3.7219512195121953,0.0,0.0
22255,2,2255,[ 95   8 265  96 182],618,2,8395,3.7211879432624113,0.0,0.0
22256,2,2256,[  1 238 200 483 127],618,4,8399,3.721311475409836,20.0,0.0
22257,2,2257,[182 174 265 471   7],297,2,8401,3.720549158547387,0.0,0.0
22258,2,2258,[282  22 161 597 118],416,3,8404,3.7202301903497124,0.0,0.0
22259,2,2259,[194 175 275 357 216],297,4,8408,3.720353982300885,0.0,0.0
22260,2,2260,[ 64  12 301 357 269],416,5,8413,3.7209199469261387,40.0,0.0
22261,2,2261,[172 186  22  69 202],711,3,8416,3.720601237842617,0.0,0.0
22262,2,2262,[  1 257 179 269 195],416,3,8419,3.7202828104286345,0.0,0.0
22263,2,2263,[ 64  12 301 357 269],416,5,8424,3.7208480565371023,40.0,0.0
22264,2,2264,[268 288 475 496   4],416,4,8428,3.7209713024282562,0.0,20.0
22265,2,2265,[215 302 748 423 125],721,2,8430,3.7202118270079434,0.0,0.0
22266,2,2266,[228  97  28  64 294],62,1,8431,3.7190119100132333,20.0,0.0
22267,2,2267,[ 97 173 132 385 174],618,4,8435,3.7191358024691357,0.0,0.0
22268,2,2268,[385 405 174 742   4],417,1,8436,3.7179374173644777,0.0,0.0
22269,2,2269,[269 176 132 234 197],416,5,8441,3.718502202643172,0.0,0.0
22270,2,2270,[289  28 168  95 288],887,5,8446,3.719066490532805,0.0,20.0
22271,2,2271,[153   7 118 121  22],416,4,8450,3.7191901408450705,0.0,0.0
22272,2,2272,[ 64  12 301 357 269],416,5,8455,3.7197536295644524,40.0,0.0
22273,2,2273,[191  25  82 161 215],128,3,8458,3.7194371152154795,0.0,0.0
22274,2,2274,[200 276 100 195 204],198,1,8459,3.718241758241758,0.0,0.0
22275,2,2275,[ 64  12 301 357 269],416,5,8464,3.718804920913884,40.0,0.0
22276,2,2276,[405  70 173 546 125],416,4,8468,3.7189284145805885,0.0,0.0
22277,2,2277,[385 176 257 235  25],417,2,8470,3.718173836698859,0.0,0.0
22278,2,2278,[ 64  12 301 357 269],416,5,8475,3.7187362878455463,40.0,0.0
22279,2,2279,[144  12  95  25 286],416,4,8479,3.718859649122807,20.0,0.0
22280,2,2280,[191 185 135 196  79],618,5,8484,3.719421306444542,0.0,0.0
22281,2,2281,[ 64  12 301 357 269],416,5,8489,3.719982471516214,40.0,0.0
22282,2,2282,[ 70 265 132 200 151],416,4,8493,3.7201051248357424,0.0,0.0
22283,2,2283,[238 168 173 191 258],354,4,8497,3.7202276707530646,0.0,0.0
22284,2,2284,[  8 245 323 328 202],921,3,8500,3.719912472647702,0.0,0.0
22285,2,2285,[ 64  12 301 357 269],416,5,8505,3.720472440944882,40.0,0.0
22286,2,2286,[191 195   1 121 276],618,3,8508,3.720157411456056,0.0,0.0
22287,2,2287,[ 64  12 301 357 269],416,5,8513,3.7207167832167833,40.0,0.0
22288,2,2288,[ 28  95 125  11 471],416,4,8517,3.7208387942332894,0.0,0.0
22289,2,2289,[200 294 181 168  25],417,3,8520,3.7205240174672487,0.0,20.0
22290,2,2290,[125 301  98  15 496],588,2,8522,3.719773024879965,0.0,20.0
22291,2,2291,[ 64  12 301 357 269],416,5,8527,3.7203315881326353,40.0,0.0
22292,2,2292,[742  56 294 197 179],128,2,8529,3.719581334496293,0.0,0.0
22293,2,2293,[143 210 117 288  56],297,4,8533,3.7197035745422844,0.0,20.0
22294,2,2294,[471  70  82 153 403],721,4,8537,3.719825708061002,0.0,0.0
22295,2,2295,[655 172  88  15 423],541,2,8539,3.7190766550522647,0.0,0.0
22296,2,2296,[ 12  82 211  25 322],417,3,8542,3.718763604701785,20.0,0.0
22297,2,2297,[ 64  12 301 357 269],416,5,8547,3.7193211488250655,40.0,0.0
22298,2,2298,[328 294 237 546 515],416,3,8550,3.71900826446281,0.0,0.0
22299,2,2299,[269 357 302 153 215],416,5,8555,3.7195652173913043,0.0,0.0
22300,2,2300,[ 98 427 183 318  96],618,4,8559,3.7196870925684484,20.0,20.0
22301,2,2301,[ 15 742 191 483 508],417,3,8562,3.7193744569939184,20.0,0.0
22302,2,2302,[ 12 282 175 333 216],854,2,8564,3.718627876682588,20.0,0.0
22303,2,2303,[ 79 385 191 405 333],345,3,8567,3.7183159722222223,0.0,0.0
22304,2,2304,[ 64  12 301 357 269],416,5,8572,3.718872017353579,40.0,0.0
22305,2,2305,[258 135 313  71   4],642,2,8574,3.718126626192541,20.0,20.0
22306,2,2306,[  4 196 271 300 282],297,1,8575,3.716948417858691,0.0,0.0
22307,2,2307,[588 357 204 197  96],373,3,8578,3.716637781629116,0.0,0.0
22308,2,2308,[ 71 200 385 294 151],416,4,8582,3.7167605023819834,0.0,0.0
22309,2,2309,[ 95  82   4  98 258],416,4,8586,3.7168831168831167,0.0,20.0
22310,2,2310,[118 423 655 182 132],437,3,8589,3.7165729121592386,0.0,0.0
22311,2,2311,[286 197  70 117 257],297,3,8592,3.716262975778547,0.0,0.0
22312,2,2312,[ 64  12 301 357 269],416,5,8597,3.7168179853004757,40.0,0.0
22313,2,2313,[245  56 187 125 174],505,2,8599,3.716076058772688,0.0,0.0
22314,2,2314,[ 82 216 135  22  64],711,4,8603,3.7161987041036717,20.0,0.0
22315,2,2315,[ 64  12 301 357 269],416,5,8608,3.7167530224525045,40.0,0.0
22316,2,2316,[323 210 118  89  82],417,3,8611,3.7164436771687526,0.0,0.0
22317,2,2317,[135 175 271   4 357],297,3,8614,3.716134598792062,0.0,0.0
22318,2,2318,[235 423 222   1 196],805,2,8616,3.715394566623545,0.0,0.0
22319,2,2319,[ 64  12 301 357 269],416,5,8621,3.7159482758620688,40.0,0.0
22320,2,2320,[313 423 483 176   8],618,4,8625,3.7160706591986212,40.0,20.0
22321,2,2321,[183 172 655 357 179],405,3,8628,3.7157622739018086,0.0,0.0
22322,2,2322,[ 82 403 210 181 257],642,5,8633,3.7163151097718465,0.0,20.0
22323,2,2323,[ 64  12 301 357 269],416,5,8638,3.716867469879518,40.0,0.0
22324,2,2324,[ 64  12 301 357 269],416,5,8643,3.7174193548387096,40.0,0.0
22325,2,2325,[235  95  69 515 302],297,2,8645,3.716680997420464,0.0,0.0
22326,2,2326,[655 191 357 234 143],405,5,8650,3.717232488182209,0.0,0.0
22327,2,2327,[196 588 597  56  95],805,1,8651,3.71606529209622,0.0,0.0
22328,2,2328,[318 191  50  89  70],405,3,8654,3.715757835981108,20.0,20.0
22329,2,2329,[271  96 172 132 357],62,4,8658,3.7158798283261802,0.0,0.0
22330,2,2330,[ 98 118 328 405  50],128,4,8662,3.716001716001716,0.0,40.0
22331,2,2331,[302 182 546  64 196],417,3,8665,3.7156946826758146,20.0,0.0
22332,2,2332,[269 211 423 168 195],297,3,8668,3.715387912558937,0.0,0.0
22333,2,2333,[235 323  79 151 403],345,2,8670,3.7146529562982007,0.0,0.0
22334,2,2334,[204 187 568 191  96],416,5,8675,3.715203426124197,0.0,0.0
22335,2,2335,[ 64  12 301 357 269],416,5,8680,3.7157534246575343,40.0,0.0
22336,2,2336,[ 64  12 301 357 269],416,5,8685,3.7163029525032094,40.0,0.0
22337,2,2337,[302 275 258 181 276],62,4,8689,3.7164242942686054,0.0,20.0
22338,2,2338,[471 181 125  70 496],373,4,8693,3.7165455322787517,0.0,20.0
22339,2,2339,[100 222 286  15 216],43,5,8698,3.717094017094017,0.0,0.0
22340,2,2340,[195 204 427  88 135],642,2,8700,3.7163605296881674,0.0,0.0
22341,2,2341,[ 64  12 301 357 269],416,5,8705,3.7169086251067465,40.0,0.0
22342,2,2342,[197 176 127  50 655],618,4,8709,3.7170294494238156,0.0,20.0
22343,2,2343,[496   7 182 568 111],618,4,8713,3.717150170648464,0.0,0.0
22344,2,2344,[180 181 185 403 153],198,3,8716,3.7168443496801706,0.0,20.0
22345,2,2345,[ 64  12 301 357 269],416,5,8721,3.717391304347826,40.0,0.0
22346,2,2346,[ 64  12 301 357 269],416,5,8726,3.717937792927141,40.0,0.0
22347,2,2347,[179 423 678 210 187],416,3,8729,3.71763202725724,0.0,0.0
22348,2,2348,[  1 174 748 423  28],679,2,8731,3.716900808854832,0.0,0.0
22349,2,2349,[333  88 196 200 117],416,4,8735,3.717021276595745,0.0,0.0
22350,2,2350,[186 269 328 302 168],43,4,8739,3.7171416418545298,0.0,0.0
22351,2,2351,[ 64  12 301 357 269],416,5,8744,3.7176870748299318,40.0,0.0
22352,2,2352,[  7 515 117 475  96],416,4,8748,3.7178070548236293,0.0,0.0
22353,2,2353,[185 475  79 174 333],416,4,8752,3.717926932880204,0.0,0.0
22354,2,2354,[318   7 173 153 301],416,5,8757,3.7184713375796177,20.0,0.0
22355,2,2355,[215 273  56  64   9],175,3,8760,3.7181663837011882,20.0,0.0
22356,2,2356,[289 546   1  56   4],416,3,8763,3.717861688587187,0.0,0.0
22357,2,2357,[ 56 111   9   1  70],43,5,8768,3.7184054283290924,0.0,0.0
22358,2,2358,[318  25 597 143  71],416,4,8772,3.718524798643493,20.0,0.0
22359,2,2359,[ 64  12 301 357 269],416,5,8777,3.7190677966101693,40.0,0.0
22360,2,2360,[ 56 546 200  95  89],417,4,8781,3.719186785260483,0.0,0.0
22361,2,2361,[300 195 211 294 127],416,5,8786,3.7197290431837424,0.0,0.0
22362,2,2362,[ 82 328 195 181   9],62,4,8790,3.719847651290732,0.0,20.0
22363,2,2363,[ 64  12 301 357 269],416,5,8795,3.720389170896785,40.0,0.0
22364,2,2364,[186 237 200   7 273],854,3,8798,3.7200845665961944,0.0,0.0
22365,2,2365,[323   1 268 748 678],721,2,8800,3.7193575655114115,0.0,0.0
22366,2,2366,[273 195 286 301 322],159,2,8802,3.7186311787072244,0.0,0.0
22367,2,2367,[294  71  50 216   4],43,5,8807,3.7191722972972974,0.0,20.0
22368,2,2368,[ 98 273 333  96 258],416,5,8812,3.7197129590544535,0.0,20.0
22369,2,2369,[ 56  64  95 471 258],416,4,8816,3.719831223628692,20.0,0.0
22370,2,2370,[132 655 228 196   1],417,4,8820,3.7199493884436947,0.0,0.0
22371,2,2371,[132 282   8  79 125],618,2,8822,3.719224283305228,0.0,0.0
22372,2,2372,[ 64  12 357 269 301],416,5,8827,3.71976401179941,40.0,0.0
22373,2,2373,[174 276 655 176 182],62,4,8831,3.719882055602359,0.0,0.0
22374,2,2374,[435 222  56   8 748],721,3,8834,3.719578947368421,0.0,0.0
22375,2,2375,[173 143 475 187 200],416,4,8838,3.7196969696969697,0.0,0.0
22376,2,2376,[ 64  12 357 269 301],416,5,8843,3.720235591081195,40.0,0.0
22377,2,2377,[ 64  12 357 269 301],416,5,8848,3.7207737594617325,40.0,0.0
22378,2,2378,[276  56  96   9 182],618,2,8850,3.720050441361917,0.0,0.0
22379,2,2379,[202 357  11 132   9],416,5,8855,3.7205882352941178,0.0,0.0
22380,2,2380,[ 64  12 357 269 301],416,5,8860,3.72112557748845,40.0,0.0
22381,2,2381,[ 64  12 357 269 301],416,5,8865,3.7216624685138537,40.0,0.0
22382,2,2382,[ 50 173 211 318 515],405,3,8868,3.7213596307175827,20.0,20.0
22383,2,2383,[195 258  82 265  25],654,4,8872,3.721476510067114,0.0,0.0
22384,2,2384,[ 64  12 357 269 301],416,5,8877,3.722012578616352,40.0,0.0
22385,2,2385,[ 82 234  70 385 588],405,2,8879,3.7212908633696564,0.0,0.0
22386,2,2386,[  4  71 300   7 423],43,5,8884,3.721826560536238,0.0,0.0
22387,2,2387,[ 15 234 235 173 301],416,4,8888,3.7219430485762146,0.0,0.0
22388,2,2388,[268  70  15  71  25],128,2,8890,3.7212222687316867,0.0,0.0
22389,2,2389,[ 64  12 357 269 301],416,5,8895,3.721757322175732,40.0,0.0
22390,2,2390,[ 64  12 357 269 301],416,5,8900,3.7222919280635716,40.0,0.0
22391,2,2391,[475 742 179  97 238],416,3,8903,3.721989966555184,0.0,0.0
22392,2,2392,[ 70 215 483 191 258],62,3,8906,3.7216882574174677,20.0,0.0
22393,2,2393,[265  82 174 603 471],373,3,8909,3.7213868003341686,0.0,0.0
22394,2,2394,[172 234 678 515 282],416,4,8913,3.7215031315240084,0.0,0.0
22395,2,2395,[475 151 235 111  70],49,2,8915,3.7207846410684473,0.0,0.0
22396,2,2396,[ 64  12 357 269 301],416,5,8920,3.7213183145598663,40.0,0.0
22397,2,2397,[  9  95 175 588 153],805,2,8922,3.720600500417014,0.0,0.0
22398,2,2398,[151   8 742 161 172],805,2,8924,3.719883284701959,0.0,0.0
22399,2,2399,[294 301   8 515  70],416,5,8929,3.7204166666666665,0.0,0.0
22400,2,2400,[ 64  12 357 269 301],416,5,8934,3.7209496043315284,40.0,0.0
22401,2,2401,[742 151 204 655 515],416,4,8938,3.7210657785179015,0.0,0.0
22402,2,2402,[ 28 174   4 588 144],805,0,8938,3.7195172700790677,0.0,0.0
22403,2,2403,[318 403 181 127  82],416,5,8943,3.7200499168053245,20.0,20.0
22404,2,2404,[318 222 257 403 121],705,5,8948,3.7205821205821206,20.0,0.0
22405,2,2405,[302   8 508 286   7],297,5,8953,3.721113881961762,0.0,0.0
22406,2,2406,[  7 268 289 318 288],588,3,8956,3.720814291649356,20.0,20.0
22407,2,2407,[182 385 238 423   7],416,5,8961,3.721345514950166,0.0,0.0
22408,2,2408,[183 603 191  97  70],405,1,8962,3.7202158572021586,0.0,0.0
22409,2,2409,[204  22  98 168 288],618,3,8965,3.719917012448133,0.0,40.0
22410,2,2410,[187 385 603 181  25],698,2,8967,3.719203649937785,0.0,20.0
22411,2,2411,[302 127 265 237 588],416,4,8971,3.719320066334992,0.0,0.0
22412,2,2412,[333 357 300 471 174],416,5,8976,3.719850808122669,0.0,0.0
22413,2,2413,[200 385  88 238  79],416,4,8980,3.71996685998343,0.0,0.0
22414,2,2414,[ 64  12 357 269 301],416,5,8985,3.720496894409938,40.0,0.0
22415,2,2415,[216 132 423  15 210],62,3,8988,3.7201986754966887,0.0,0.0
22416,2,2416,[ 64  12 357 269 301],416,5,8993,3.7207281754240795,40.0,0.0
22417,2,2417,[117 588   1 127 323],43,4,8997,3.7208436724565757,0.0,0.0
22418,2,2418,[ 95 333 475 748 235],416,2,8999,3.7201322860686235,0.0,0.0
22419,2,2419,[ 64  12 357 269 301],416,5,9004,3.7206611570247934,40.0,0.0
22420,2,2420,[ 64  12 357 269 301],416,5,9009,3.721189591078067,40.0,0.0
22421,2,2421,[ 64  12 357 269 301],416,5,9014,3.7217175887696117,40.0,0.0
22422,2,2422,[742 111 288  15 483],854,2,9016,3.721007016095749,20.0,20.0
22423,2,2423,[181 215 161 179 204],437,3,9019,3.7207095709570956,0.0,20.0
22424,2,2424,[ 64  12 357 269 301],416,5,9024,3.721237113402062,40.0,0.0
22425,2,2425,[ 64  12 357 269 301],416,5,9029,3.7217642209398187,40.0,0.0
22426,2,2426,[173  12 168 197 151],437,4,9033,3.7218788627935724,20.0,0.0
22427,2,2427,[286  95 197 294 234],416,4,9037,3.721993410214168,0.0,0.0
22428,2,2428,[ 64  12 357 269 301],416,5,9042,3.7225195553725814,40.0,0.0
22429,2,2429,[546 182 302   4 234],297,1,9043,3.7213991769547325,0.0,0.0
22430,2,2430,[174 111   1 100  12],588,2,9045,3.72069107363225,20.0,0.0
22431,2,2431,[ 64  12 357 269 301],416,5,9050,3.721217105263158,40.0,0.0
22432,2,2432,[ 64  12 357 269 301],416,5,9055,3.7217427044800657,40.0,0.0
22433,2,2433,[423  50  70 191 237],437,4,9059,3.7218570254724734,0.0,20.0
22434,2,2434,[603  15 197 185 187],416,5,9064,3.722381930184805,0.0,0.0
22435,2,2435,[ 64  12 357 269 301],416,5,9069,3.7229064039408866,40.0,0.0
22436,2,2436,[ 64  12 357 269 301],416,5,9074,3.723430447271235,40.0,0.0
22437,2,2437,[ 64  12 357 269 301],416,5,9079,3.723954060705496,40.0,0.0
22438,2,2438,[ 50  28 748 275 268],297,4,9083,3.7240672406724067,0.0,20.0
22439,2,2439,[ 56 216 597 215 288],618,3,9086,3.7237704918032786,0.0,20.0
22440,2,2440,[ 64  12 357 269 301],416,5,9091,3.724293322408849,40.0,0.0
22441,2,2441,[172 265 204 286 202],373,3,9094,3.723996723996724,0.0,0.0
22442,2,2442,[200 185 144   9 427],416,5,9099,3.7245190339746213,0.0,0.0
22443,2,2443,[  4 191  70 603 245],297,2,9101,3.7238134206219313,0.0,0.0
22444,2,2444,[269  97 300 237  25],297,4,9105,3.723926380368098,0.0,0.0
22445,2,2445,[194 403 265 121 153],416,5,9110,3.7244480784955027,0.0,0.0
22446,2,2446,[161 200  70 588  79],405,1,9111,3.723334695545566,0.0,0.0
22447,2,2447,[ 97 191 265  25 748],297,2,9113,3.7226307189542482,0.0,0.0
22448,2,2448,[185 748 237  15  50],198,1,9114,3.721518987341772,0.0,20.0
22449,2,2449,[174 742 237  82 151],642,4,9118,3.7216326530612247,0.0,0.0
22450,2,2450,[100 180 475 176 191],805,4,9122,3.721746226030192,0.0,0.0
22451,2,2451,[194   8 100 117  56],416,5,9127,3.722267536704731,0.0,0.0
22452,2,2452,[202 121 294 210  15],253,5,9132,3.722788422339992,0.0,0.0
22453,2,2453,[ 50 176  56 204 200],887,4,9136,3.7229013854930724,0.0,20.0
22454,2,2454,[181 269 435 300 176],297,3,9139,3.7226069246435847,0.0,20.0
22455,2,2455,[ 64  12 357 269 301],416,5,9144,3.7231270358306188,40.0,0.0
22456,2,2456,[ 64  12 357 269 301],416,5,9149,3.7236467236467234,40.0,0.0
22457,2,2457,[ 98 182 597 323 132],417,3,9152,3.723352318958503,0.0,20.0
22458,2,2458,[ 64  12 357 269 301],416,5,9157,3.7238714924766163,40.0,0.0
22459,2,2459,[ 64  12 357 269 301],416,5,9162,3.7243902439024392,40.0,0.0
22460,2,2460,[265 127  71 588 471],922,3,9165,3.724095895977245,0.0,0.0
22461,2,2461,[ 69 168 125 153 268],854,3,9168,3.7238017871649065,0.0,0.0
22462,2,2462,[ 64  12 357 269 301],416,5,9173,3.724319935038571,40.0,0.0
22463,2,2463,[ 64  12 357 269 301],416,5,9178,3.7248376623376624,40.0,0.0
22464,2,2464,[ 64  12 357 269 301],416,5,9183,3.7253549695740364,40.0,0.0
22465,2,2465,[ 64  12 357 269 301],416,5,9188,3.7258718572587184,40.0,0.0
22466,2,2466,[132  96 258  25 195],887,3,9191,3.725577624645318,0.0,0.0
22467,2,2467,[515 100 175 181 603],297,5,9196,3.726094003241491,0.0,20.0
22468,2,2468,[ 64  12 357 269 301],416,5,9201,3.726609963547995,40.0,0.0
22469,2,2469,[ 50 151 568 173 471],43,4,9205,3.7267206477732793,0.0,20.0
22470,2,2470,[111 181 546 216 237],416,3,9208,3.726426547956293,0.0,20.0
22471,2,2471,[ 25  79 143 161  88],416,4,9212,3.726537216828479,0.0,0.0
22472,2,2472,[300 235 269  50 215],43,4,9216,3.726647796198949,0.0,20.0
22473,2,2473,[  8  96 200 546 180],805,2,9218,3.7259498787388843,0.0,0.0
22474,2,2474,[423 385 237 211 181],416,4,9222,3.726060606060606,0.0,20.0
22475,2,2475,[ 69 269 471 289 118],43,4,9226,3.7261712439418417,0.0,0.0
22476,2,2476,[234 357 143 655 179],405,4,9230,3.7262817924909166,0.0,0.0
22477,2,2477,[ 79 423 127 151 275],43,5,9235,3.7267958030669894,0.0,0.0
22478,2,2478,[174 161 427 258 288],416,5,9240,3.72730939895119,0.0,20.0
22479,2,2479,[ 64  12 357 269 301],416,5,9245,3.7278225806451615,40.0,0.0
22480,2,2480,[195 238 191 118 222],601,2,9247,3.7271261588069327,0.0,0.0
22481,2,2481,[204 357 194 515 568],405,3,9250,3.7268331990330377,0.0,0.0
22482,2,2482,[301 196  11  79 100],416,5,9255,3.7273459524768424,0.0,0.0
22483,2,2483,[211   1 423 271 235],297,1,9256,3.7262479871175525,0.0,0.0
22484,2,2484,[235 742  69 238 151],416,3,9259,3.7259557344064387,0.0,0.0
22485,2,2485,[204  96 588 496   8],230,4,9263,3.7260659694288014,0.0,0.0
22486,2,2486,[ 64  12 357 269 301],416,5,9268,3.7265782066747084,40.0,0.0
22487,2,2487,[265  50 258 153 202],922,5,9273,3.727090032154341,0.0,20.0
22488,2,2488,[ 64  12 357 269 301],416,5,9278,3.7276014463640017,40.0,0.0
22489,2,2489,[100 222 471  97   8],588,2,9280,3.7269076305220885,0.0,0.0
22490,2,2490,[  7 655 423 200  97],416,5,9285,3.7274187073464473,0.0,0.0
22491,2,2491,[ 50 172 215   8  15],654,4,9289,3.7275280898876404,0.0,20.0
22492,2,2492,[588 282  22 161 194],416,5,9294,3.728038507821901,0.0,0.0
22493,2,2493,[153 258 271 235 742],854,3,9297,3.727746591820369,0.0,0.0
22494,2,2494,[127 117 135 121 475],805,2,9299,3.727054108216433,0.0,0.0
22495,2,2495,[ 64  12 357 269 301],416,5,9304,3.7275641025641026,40.0,0.0
22496,2,2496,[ 64  12 357 269 301],416,5,9309,3.7280736884261114,40.0,0.0
22497,2,2497,[ 64  12 357 269 301],416,5,9314,3.7285828662930345,40.0,0.0
22498,2,2498,[ 28 496 655 588  97],618,5,9319,3.729091636654662,0.0,0.0
22499,2,2499,[ 96  50  15 111 125],630,2,9321,3.7284,0.0,20.0
22500,2,2500,[  8 153 289 496 294],416,4,9325,3.7285085965613756,0.0,0.0
22501,2,2501,[ 64  12 357 269 301],416,5,9330,3.7290167865707433,40.0,0.0
22502,2,2502,[235 423 200 100 202],887,1,9331,3.727926488214143,0.0,0.0
22503,2,2503,[ 64  12 357 269 301],416,5,9336,3.7284345047923324,40.0,0.0
22504,2,2504,[268  69  98 204 168],654,4,9340,3.7285429141716566,0.0,20.0
22505,2,2505,[ 64  12 357 269 301],416,5,9345,3.7290502793296088,40.0,0.0
22506,2,2506,[ 82  15 423 210 276],416,4,9349,3.729158356601516,0.0,0.0
22507,2,2507,[ 69 588 471 234 286],345,2,9351,3.728468899521531,0.0,0.0
22508,2,2508,[ 25 318 117 151   7],198,3,9354,3.7281785571941013,20.0,0.0
22509,2,2509,[  1   8 588 121   9],314,5,9359,3.7286852589641435,0.0,0.0
22510,2,2510,[ 64  12 357 269 301],416,5,9364,3.7291915571485466,40.0,0.0
22511,2,2511,[ 64  12 357 269 301],416,5,9369,3.729697452229299,40.0,0.0
22512,2,2512,[ 71 496 132 423 748],373,3,9372,3.729407083167529,0.0,0.0
22513,2,2513,[ 64  12 357 269 301],416,5,9377,3.729912490055688,40.0,0.0
22514,2,2514,[ 64  12 357 269 301],416,5,9382,3.7304174950298212,40.0,0.0
22515,2,2515,[ 64  12 357 269 301],416,5,9387,3.7309220985691574,40.0,0.0
22516,2,2516,[216 328  95 196 496],416,4,9391,3.7310290027810886,0.0,0.0
22517,2,2517,[258 125 180 403 222],62,5,9396,3.7315329626687848,0.0,0.0
22518,2,2518,[121 597   7 496 185],416,4,9400,3.7316395394998016,0.0,0.0
22519,2,2519,[185 273 168 294 748],297,3,9403,3.7313492063492064,0.0,0.0
22520,2,2520,[ 64  12 357 269 301],416,5,9408,3.7318524395081316,40.0,0.0
22521,2,2521,[ 71 135   4 427 181],642,2,9410,3.73116574147502,0.0,20.0
22522,2,2522,[211 288 357 118 508],417,3,9413,3.730875941339675,0.0,20.0
22523,2,2523,[135 181  12 238 258],417,3,9416,3.7305863708399367,20.0,20.0
22524,2,2524,[  9  56 483 318  15],601,3,9419,3.7302970297029705,40.0,0.0
22525,2,2525,[  4  82 173 216 313],43,5,9424,3.730799683293745,20.0,20.0
22526,2,2526,[  8  98   4 742   7],62,4,9428,3.7309062129006727,0.0,20.0
22527,2,2527,[265 603   9 118 204],416,4,9432,3.731012658227848,0.0,0.0
22528,2,2528,[ 69 423 301 174  56],297,3,9435,3.730723606168446,0.0,0.0
22529,2,2529,[215 294 678 228 195],297,0,9435,3.7292490118577075,0.0,0.0
22530,2,2530,[ 64 427 175 182 168],253,2,9437,3.72856578427499,20.0,0.0
22531,2,2531,[588 111  50 423 181],618,4,9441,3.7286729857819907,0.0,40.0
22532,2,2532,[235 185 144 135 200],417,1,9442,3.7275957362810894,0.0,0.0
22533,2,2533,[143 210  50  69 182],618,4,9446,3.727703235990529,0.0,20.0
22534,2,2534,[ 11 496 153 191 238],416,5,9451,3.7282051282051283,0.0,0.0
22535,2,2535,[172   7 237 655  15],62,2,9453,3.7275236593059935,0.0,0.0
22536,2,2536,[ 64  12 357 269 301],416,5,9458,3.7280252266456446,40.0,0.0
22537,2,2537,[357 471 678  22 197],297,2,9460,3.727344365642238,0.0,0.0
22538,2,2538,[121 143 597  56  70],642,4,9464,3.727451752658527,0.0,0.0
22539,2,2539,[210 111 286 273 181],297,4,9468,3.7275590551181104,0.0,20.0
22540,2,2540,[172  71 655  12 403],373,4,9472,3.7276662731208186,20.0,0.0
22541,2,2541,[257 174 210  69 234],416,4,9476,3.7277734067663255,0.0,0.0
22542,2,2542,[ 11 187 186 172  12],175,5,9481,3.728273692489186,20.0,0.0
22543,2,2543,[235 423 234  89  64],417,4,9485,3.728380503144654,20.0,0.0
22544,2,2544,[238 265 288 196 403],618,3,9488,3.7280943025540276,0.0,20.0
22545,2,2545,[588 265 405 132 204],416,5,9493,3.7285938727415555,0.0,0.0
22546,2,2546,[194  97 238 301 210],416,5,9498,3.729093050647821,0.0,0.0
22547,2,2547,[515 194  82 257 100],416,4,9502,3.729199372056515,0.0,0.0
22548,2,2548,[ 64  12 357 269 301],416,5,9507,3.7296979207532366,40.0,0.0
22549,2,2549,[179  98 200 196 175],805,4,9511,3.7298039215686276,0.0,20.0
22550,2,2550,[294 196 185  22 568],214,3,9514,3.7295178361426893,0.0,0.0
22551,2,2551,[ 28 176 197 568  69],405,4,9518,3.729623824451411,0.0,0.0
22552,2,2552,[195 191 211  82 173],437,3,9521,3.7293380336858597,0.0,0.0
22553,2,2553,[385 235  70  12   1],416,4,9525,3.7294440093970245,20.0,0.0
22554,2,2554,[111 289   1  71  25],49,1,9526,3.7283757338551857,0.0,0.0
22555,2,2555,[273 200 301 245 678],416,3,9529,3.7280907668231613,0.0,0.0
22556,2,2556,[ 64  12 357 269 301],416,5,9534,3.7285881892843173,40.0,0.0
22557,2,2557,[ 64  12 357 269 301],416,5,9539,3.7290852228303364,40.0,0.0
22558,2,2558,[ 95 275 125 289 597],416,2,9541,3.7284095349745994,0.0,0.0
22559,2,2559,[ 64  12 357 269 301],416,5,9546,3.72890625,40.0,0.0
22560,2,2560,[ 22 237 210 234  28],588,4,9550,3.7290121046466225,0.0,0.0
22561,2,2561,[121 185 168 471 118],416,4,9554,3.72911787665886,0.0,0.0
22562,2,2562,[ 79  70 300 268  28],345,3,9557,3.7288333983612953,0.0,0.0
22563,2,2563,[ 64  12 357 269 301],416,5,9562,3.7293291731669265,40.0,0.0
22564,2,2564,[269 603  71   7 168],805,4,9566,3.7294346978557504,0.0,0.0
22565,2,2565,[ 70 269 210 385 132],262,1,9567,3.7283710054559625,0.0,0.0
22566,2,2566,[  1 144 245 313 176],416,4,9571,3.728476821192053,20.0,20.0
22567,2,2567,[678 200 125 127 216],416,4,9575,3.728582554517134,0.0,0.0
22568,2,2568,[475 135 151 405 258],805,3,9578,3.728298949007396,0.0,0.0
22569,2,2569,[ 28  71   1 328 496],314,5,9583,3.7287937743190662,0.0,0.0
22570,2,2570,[ 89 322 222 200 121],805,3,9586,3.7285103072734342,0.0,0.0
22571,2,2571,[ 64  12 357 301 269],416,5,9591,3.72900466562986,40.0,0.0
22572,2,2572,[ 64  12 357 301 269],416,5,9596,3.729498639720171,40.0,0.0
22573,2,2573,[271  79  11 100  69],854,5,9601,3.72999222999223,0.0,0.0
22574,2,2574,[ 64  12 357 301 269],416,5,9606,3.7304854368932037,40.0,0.0
22575,2,2575,[ 64  12 357 301 269],416,5,9611,3.7309782608695654,40.0,0.0
22576,2,2576,[ 12   4 181 288 222],62,4,9615,3.731082654249127,20.0,40.0
22577,2,2577,[ 64  12 357 301 269],416,5,9620,3.7315748642358417,40.0,0.0
22578,2,2578,[ 50 322   7 153 135],805,4,9624,3.7316789453276464,0.0,20.0
22579,2,2579,[215 132 181  50 289],588,4,9628,3.731782945736434,0.0,40.0
22580,2,2580,[ 64  12 357 301 269],416,5,9633,3.7322743122820614,40.0,0.0
22581,2,2581,[ 64  12 357 301 269],416,5,9638,3.7327652982184354,40.0,0.0
22582,2,2582,[215  22 228  71 655],711,2,9640,3.732094463801781,0.0,0.0
22583,2,2583,[111 179   1 357 153],805,4,9644,3.7321981424148607,0.0,0.0
22584,2,2584,[ 64  12 357 301 269],416,5,9649,3.7326885880077367,40.0,0.0
22585,2,2585,[  8   7 121  82  70],416,5,9654,3.7331786542923435,0.0,0.0
22586,2,2586,[ 28  50   1 496  22],416,5,9659,3.7336683417085426,0.0,20.0
22587,2,2587,[191  97 187  69 318],618,5,9664,3.7341576506955176,20.0,0.0
22588,2,2588,[ 64  12 357 301 269],416,5,9669,3.734646581691773,40.0,0.0
22589,2,2589,[238 423 235 186 204],43,2,9671,3.733976833976834,0.0,0.0
22590,2,2590,[111 423 222 191 237],721,3,9674,3.733693554612119,0.0,0.0
22591,2,2591,[ 64  12 357 301 269],416,5,9679,3.734182098765432,40.0,0.0
22592,2,2592,[405 508 172 238  15],345,5,9684,3.734670266101041,0.0,0.0
22593,2,2593,[  1 196  50 216 238],230,4,9688,3.7347725520431765,0.0,20.0
22594,2,2594,[195 302 204 678  12],416,4,9692,3.734874759152216,20.0,0.0
22595,2,2595,[179   9   1  70 568],62,2,9694,3.7342064714946073,0.0,0.0
22596,2,2596,[238 125   9 328 475],854,3,9697,3.7339237581825184,0.0,0.0
22597,2,2597,[ 64  12 357 301 269],416,5,9702,3.7344110854503465,40.0,0.0
22598,2,2598,[ 64  12 357 301 269],416,5,9707,3.7348980377068104,40.0,0.0
22599,2,2599,[257 173 288 546 276],654,3,9710,3.7346153846153847,0.0,20.0
22600,2,2600,[204  98 176 238  82],437,3,9713,3.734332948865821,0.0,20.0
22601,2,2601,[294  71 678 286 333],588,4,9717,3.734435049961568,0.0,0.0
22602,2,2602,[118 269 144  96 294],854,1,9718,3.733384556281214,0.0,0.0
22603,2,2603,[ 25  95 143 215  12],373,4,9722,3.7334869431643627,20.0,0.0
22604,2,2604,[197 144 568 183 742],416,5,9727,3.7339731285988482,0.0,0.0
22605,2,2605,[ 64  12 357 301 269],416,5,9732,3.7344589409056024,40.0,0.0
22606,2,2606,[ 98 222 127  22 191],630,2,9734,3.7337936325278096,0.0,20.0
22607,2,2607,[197  69 181 144 313],416,5,9739,3.7342791411042944,20.0,40.0
22608,2,2608,[ 64  12 357 301 269],416,5,9744,3.7347642775009584,40.0,0.0
22609,2,2609,[  9 333 151 294 268],416,4,9748,3.734865900383142,0.0,0.0
22610,2,2610,[216 121 423 275  25],588,3,9751,3.734584450402145,0.0,0.0
22611,2,2611,[275 268 271 121 288],854,3,9754,3.7343032159264933,0.0,20.0
22612,2,2612,[  1 257 265 273 302],297,2,9756,3.7336394948335245,0.0,0.0
22613,2,2613,[546 195  79 269 294],805,2,9758,3.7329762815608265,0.0,0.0
22614,2,2614,[322  96  69 286 238],854,2,9760,3.7323135755258128,0.0,0.0
22615,2,2615,[215 121  71  82 174],541,3,9763,3.7320336391437308,0.0,0.0
22616,2,2616,[  7 288 508 742 175],854,4,9767,3.7321360336262894,0.0,20.0
22617,2,2617,[ 64  12 357 301 269],416,5,9772,3.732620320855615,40.0,0.0
22618,2,2618,[ 64  12 357 301 269],416,5,9777,3.7331042382588775,40.0,0.0
22619,2,2619,[  4 186 258  98 151],43,4,9781,3.733206106870229,0.0,20.0
22620,2,2620,[117  11  97  70  98],437,1,9782,3.732163296451736,0.0,20.0
22621,2,2621,[100 216 597 197 135],805,3,9785,3.7318840579710146,0.0,0.0
22622,2,2622,[ 64  12 357 301 269],416,5,9790,3.7323675181090357,40.0,0.0
22623,2,2623,[ 56 153 245 603 132],416,4,9794,3.732469512195122,0.0,0.0
22624,2,2624,[ 64  12 357 301 269],416,5,9799,3.732952380952381,40.0,0.0
22625,2,2625,[ 12   1  15 168 300],416,5,9804,3.7334348819497336,20.0,0.0
22626,2,2626,[603 568 288   7 546],805,2,9806,3.7327750285496766,0.0,20.0
22627,2,2627,[202 175 118  56 597],43,3,9809,3.7324961948249618,0.0,0.0
22628,2,2628,[ 64  12 357 301 269],416,5,9814,3.7329783187523775,40.0,0.0
22629,2,2629,[ 64  12 357 301 269],416,5,9819,3.7334600760456276,40.0,0.0
22630,2,2630,[273 385 238 191  95],417,4,9823,3.733561383504371,0.0,0.0
22631,2,2631,[ 88  96 603 300 216],751,4,9827,3.733662613981763,0.0,0.0
22632,2,2632,[ 64  12 357 301 269],416,5,9832,3.734143562476263,40.0,0.0
22633,2,2633,[ 64  12 357 301 269],416,5,9837,3.734624145785877,40.0,0.0
22634,2,2634,[143 183 234 181 269],297,4,9841,3.7347248576850096,0.0,20.0
22635,2,2635,[  8 515 172 173 196],416,5,9846,3.735204855842185,0.0,0.0
22636,2,2636,[  7 496 483 200  95],417,3,9849,3.7349260523321957,20.0,0.0
22637,2,2637,[118 200 204 197 174],437,4,9853,3.73502653525398,0.0,0.0
22638,2,2638,[ 64 191 172 588  95],642,5,9858,3.735505873436908,20.0,0.0
22639,2,2639,[ 64  12 357 301 269],416,5,9863,3.7359848484848484,40.0,0.0
22640,2,2640,[275 588 423 257 288],297,2,9865,3.735327527451723,0.0,20.0
22641,2,2641,[ 96  25 588 216 121],751,5,9870,3.7358062074186225,0.0,0.0
22642,2,2642,[ 79 183 210  71 588],230,4,9874,3.7359061672342038,0.0,0.0
22643,2,2643,[265  70 127 161 588],373,3,9877,3.735627836611195,0.0,0.0
22644,2,2644,[302  28 423 427 196],416,5,9882,3.7361058601134216,0.0,0.0
22645,2,2645,[ 64  12 357 301 269],416,5,9887,3.736583522297808,40.0,0.0
22646,2,2646,[132 168 153 181 234],601,4,9891,3.736683037400831,0.0,20.0
22647,2,2647,[182  79 195 265 202],230,3,9894,3.736404833836858,0.0,0.0
22648,2,2648,[196  12 475  15 496],342,3,9897,3.736126840317101,20.0,0.0
22649,2,2649,[ 64  12 357 301 269],416,5,9902,3.7366037735849056,40.0,0.0
22650,2,2650,[118 403 257 210 333],416,3,9905,3.7363259147491514,0.0,0.0
22651,2,2651,[ 64  12 357 301 269],416,5,9910,3.7368024132730016,40.0,0.0
22652,2,2652,[ 64  12 357 301 269],416,5,9915,3.7372785525819827,40.0,0.0
22653,2,2653,[ 64  12 357 301 269],416,5,9920,3.7377543330821403,40.0,0.0
22654,2,2654,[ 96 191 276  22 546],416,3,9923,3.737476459510358,0.0,0.0
22655,2,2655,[322 144 235 357  79],854,2,9925,3.7368222891566263,0.0,0.0
22656,2,2656,[257 182 258  95  11],297,2,9927,3.736168611215657,0.0,0.0
22657,2,2657,[151  11 143 258 200],297,3,9930,3.7358916478555306,0.0,0.0
22658,2,2658,[144  97 496  50 288],417,1,9931,3.7348627303497555,0.0,40.0
22659,2,2659,[ 64  12 357 301 269],416,5,9936,3.735338345864662,40.0,0.0
22660,2,2660,[132 222 173 176 234],417,4,9940,3.7354378053363395,0.0,0.0
22661,2,2661,[ 64  12 357 301 269],416,5,9945,3.7359128474830956,40.0,0.0
22662,2,2662,[168 172 174 187 211],416,5,9950,3.7363875328576794,0.0,0.0
22663,2,2663,[ 64  12 357 301 269],416,5,9955,3.7368618618618616,40.0,0.0
22664,2,2664,[588 405  28 196 174],128,4,9959,3.7369606003752347,0.0,0.0
22665,2,2665,[179 161 132   7 328],416,4,9963,3.737059264816204,0.0,0.0
22666,2,2666,[288 678  79 275   4],654,4,9967,3.7371578552680913,0.0,20.0
22667,2,2667,[196 215 588 195  50],437,2,9969,3.7365067466266866,0.0,20.0
22668,2,2668,[ 15  56 273  96  89],62,4,9973,3.736605470213563,0.0,0.0
22669,2,2669,[173 151  64 258  71],198,4,9977,3.736704119850187,20.0,0.0
22670,2,2670,[ 64  12 357 301 269],416,5,9982,3.737177087233246,40.0,0.0
22671,2,2671,[ 69 245  50 423  82],721,4,9986,3.7372754491017965,0.0,20.0
22672,2,2672,[ 64  12 357 301 269],416,5,9991,3.73774784885896,40.0,0.0
22673,2,2673,[180 271 597 273 678],805,1,9992,3.736724008975318,0.0,0.0
22674,2,2674,[132 302 100 182  64],416,5,9997,3.737196261682243,20.0,0.0
22675,2,2675,[118 275 286 174 475],297,4,10001,3.7372944693572494,0.0,0.0
22676,2,2676,[742 111 211 313 118],416,4,10005,3.7373926036608145,20.0,20.0
22677,2,2677,[238  56  79 515 143],405,4,10009,3.7374906646751307,0.0,0.0
22678,2,2678,[ 98 125 357 568 216],62,4,10013,3.7375886524822697,0.0,20.0
22679,2,2679,[216 301 153 175 294],297,4,10017,3.7376865671641792,0.0,0.0
22680,2,2680,[ 64  12 357 301 269],416,5,10022,3.7381574039537484,40.0,0.0
22681,2,2681,[ 64  12 357 301 269],416,5,10027,3.7386278896346012,40.0,0.0
22682,2,2682,[234   7  22 174 181],416,5,10032,3.739098024599329,0.0,20.0
22683,2,2683,[ 12 357  71 475 597],62,4,10036,3.7391952309985097,20.0,0.0
22684,2,2684,[ 64  12 357 301 269],416,5,10041,3.7396648044692737,40.0,0.0
22685,2,2685,[191 273 268 100 168],416,5,10046,3.7401340282948623,0.0,0.0
22686,2,2686,[ 28 175 215 135 748],373,2,10048,3.7394864160774097,0.0,0.0
22687,2,2687,[ 64  12 357 301 269],416,5,10053,3.739955357142857,40.0,0.0
22688,2,2688,[ 64  12 357 301 269],416,5,10058,3.7404239494235774,40.0,0.0
22689,2,2689,[144 202 357 194 173],297,2,10060,3.7397769516728623,0.0,0.0
22690,2,2690,[151 403 257  82 258],416,3,10063,3.73950204384987,0.0,0.0
22691,2,2691,[ 25 508  12  70 265],297,4,10067,3.739598811292719,20.0,0.0
22692,2,2692,[ 11  15 173 215 121],437,2,10069,3.738952840698106,0.0,0.0
22693,2,2693,[ 64  12 357 301 269],416,5,10074,3.739420935412027,40.0,0.0
22694,2,2694,[273  70  97 183 179],417,4,10078,3.739517625231911,0.0,0.0
22695,2,2695,[238  28 257 496  88],43,4,10082,3.7396142433234423,0.0,0.0
22696,2,2696,[ 64  12 357 301 269],416,5,10087,3.7400815721171674,40.0,0.0
22697,2,2697,[289 269 174 197 191],721,3,10090,3.7398072646404743,0.0,0.0
22698,2,2698,[742 546 196 238   7],417,2,10092,3.7391626528343833,0.0,0.0
22699,2,2699,[ 64  12 357 301 269],416,5,10097,3.7396296296296296,40.0,0.0
22700,2,2700,[  9 289 403 186 211],43,4,10101,3.73972602739726,0.0,0.0
22701,2,2701,[655 125 195 483 385],417,5,10106,3.74019245003701,20.0,0.0
22702,2,2702,[195 385 588 322   4],417,2,10108,3.7395486496485386,0.0,0.0
22703,2,2703,[ 64  12 357 301 269],416,5,10113,3.7400147928994083,40.0,0.0
22704,2,2704,[742 258  95 210   4],416,4,10117,3.7401109057301296,0.0,0.0
22705,2,2705,[ 64  12 357 301 269],416,5,10122,3.740576496674058,40.0,0.0
22706,2,2706,[211 286 182 118 655],417,5,10127,3.741041743627632,0.0,0.0
22707,2,2707,[ 64  12 357 301 269],416,5,10132,3.741506646971935,40.0,0.0
22708,2,2708,[276   8 144  89 121],62,4,10136,3.7416020671834627,0.0,0.0
22709,2,2709,[265 210  95 288 427],618,2,10138,3.740959409594096,0.0,20.0
22710,2,2710,[234 603 258 275 265],270,4,10142,3.7410549612689046,0.0,0.0
22711,2,2711,[ 64  12 357 301 269],416,5,10147,3.741519174041298,40.0,0.0
22712,2,2712,[  4 271 508  98 742],297,2,10149,3.7408772576483598,0.0,20.0
22713,2,2713,[ 64  12 357 301 269],416,5,10154,3.7413411938098746,40.0,0.0
22714,2,2714,[265  71  96 117  98],198,2,10156,3.7406998158379374,0.0,20.0
22715,2,2715,[ 64  12 357 301 269],416,5,10161,3.741163475699558,40.0,0.0
22716,2,2716,[269  64 423  89 302],854,4,10165,3.7412587412587412,20.0,0.0
22717,2,2717,[435 186 132 276  15],437,3,10168,3.7409860191317144,0.0,0.0
22718,2,2718,[275 271 471  70 176],297,3,10171,3.7407134976094154,0.0,0.0
22719,2,2719,[202 742 282  28  15],416,5,10176,3.7411764705882353,0.0,0.0
22720,2,2720,[ 95  82 275 300  69],654,5,10181,3.7416391032708565,0.0,0.0
22721,2,2721,[ 69  89 135 174  71],405,3,10184,3.7413666421748712,0.0,0.0
22722,2,2722,[ 64  12 357 301 269],416,5,10189,3.7418288652221814,40.0,0.0
22723,2,2723,[195 288 313  56 237],618,3,10192,3.7415565345080766,20.0,40.0
22724,2,2724,[ 64  12 357 301 269],416,5,10197,3.742018348623853,40.0,0.0
22725,2,2725,[211 288 144 286 275],416,5,10202,3.7424798239178285,0.0,20.0
22726,2,2726,[403 111 275 318  15],618,2,10204,3.7418408507517418,20.0,0.0
22727,2,2727,[313 161 173  71 191],345,3,10207,3.741568914956012,20.0,20.0
22728,2,2728,[258 185 191 176  50],601,4,10211,3.7416636130450716,0.0,20.0
22729,2,2729,[ 71 313 185 275 568],416,5,10216,3.742124542124542,20.0,20.0
22730,2,2730,[191 269 174  56  82],805,3,10219,3.741852801171732,0.0,0.0
22731,2,2731,[ 64  12 357 301 269],416,5,10224,3.7423133235724744,40.0,0.0
22732,2,2732,[ 79  82 234 196 655],618,5,10229,3.742773508964508,0.0,0.0
22733,2,2733,[ 97 197 210 143  64],416,5,10234,3.7432333577176298,20.0,0.0
22734,2,2734,[ 64  12 357 301 269],416,5,10239,3.7436928702010968,40.0,0.0
22735,2,2735,[172   4 294 210 323],43,4,10243,3.743786549707602,0.0,0.0
22736,2,2736,[200 385 318 475 127],416,4,10247,3.7438801607599563,20.0,0.0
22737,2,2737,[471 176 403 742 289],416,4,10251,3.743973703433163,0.0,0.0
22738,2,2738,[ 64  12 357 301 269],416,5,10256,3.7444322745527563,40.0,0.0
22739,2,2739,[ 64  12 357 301 269],416,5,10261,3.7448905109489052,40.0,0.0
22740,2,2740,[ 64  12 357 301 269],416,5,10266,3.7453484129879606,40.0,0.0
22741,2,2741,[ 64  12 357 301 269],416,5,10271,3.7458059810357405,40.0,0.0
22742,2,2742,[257 742   4 678  28],416,3,10274,3.7455340867663143,0.0,0.0
22743,2,2743,[117 197   7   9 125],854,3,10277,3.745262390670554,0.0,0.0
22744,2,2744,[135  11 300 423 197],297,2,10279,3.7446265938069216,0.0,0.0
22745,2,2745,[ 79 275 216  82  56],437,4,10283,3.7447195921340133,0.0,0.0
22746,2,2746,[ 69  79  11 121 269],345,4,10287,3.744812522752093,0.0,0.0
22747,2,2747,[ 64  12 357 301 269],416,5,10292,3.7452692867540027,40.0,0.0
22748,2,2748,[234 121 275 183  97],618,4,10296,3.745361949799927,0.0,0.0
22749,2,2749,[ 64  12 357 301 269],416,5,10301,3.7458181818181817,40.0,0.0
22750,2,2750,[ 64  12 357 301 269],416,5,10306,3.746274082151945,40.0,0.0
22751,2,2751,[210 748 186 222 234],417,3,10309,3.746002906976744,0.0,0.0
22752,2,2752,[ 64  12 357 301 269],416,5,10314,3.7464584090083544,40.0,0.0
22753,2,2753,[  4 174 127 132 238],417,3,10317,3.7461873638344225,0.0,0.0
22754,2,2754,[ 82 174 742 168 151],43,5,10322,3.7466424682395645,0.0,0.0
22755,2,2755,[173 111 117 216 288],437,2,10324,3.7460087082728593,0.0,20.0
22756,2,2756,[405 269  15 125 275],854,3,10327,3.7457381211461733,0.0,0.0
22757,2,2757,[ 96  12 151 475   1],417,4,10331,3.7458303118201597,20.0,0.0
22758,2,2758,[ 56 275 191 185 435],437,4,10335,3.745922435665096,0.0,0.0
22759,2,2759,[ 89 196  79   4 182],405,2,10337,3.7452898550724636,0.0,0.0
22760,2,2760,[121  15  89  97 483],417,4,10341,3.7453821079319085,20.0,0.0
22761,2,2761,[748 258   9 235 238],805,1,10342,3.7443881245474295,0.0,0.0
22762,2,2762,[  8  25 245 323 588],416,3,10345,3.7441187115454215,0.0,0.0
22763,2,2763,[ 64  12 357 301 269],416,5,10350,3.744573082489146,40.0,0.0
22764,2,2764,[ 88  69 313 268 200],345,5,10355,3.7450271247739604,20.0,20.0
22765,2,2765,[ 64  12 357 301 269],416,5,10360,3.7454808387563268,40.0,0.0
22766,2,2766,[ 97 132 185 179 176],437,3,10363,3.745211420310806,0.0,0.0
22767,2,2767,[597 323 100 135 234],417,1,10364,3.744219653179191,0.0,0.0
22768,2,2768,[323 185  79  64 471],416,4,10368,3.744312026002167,20.0,0.0
22769,2,2769,[ 64  12 357 301 269],416,5,10373,3.7447653429602887,40.0,0.0
22770,2,2770,[195 168 234 204 216],416,5,10378,3.7452183327318656,0.0,0.0
22771,2,2771,[ 64  12 357 301 269],416,5,10383,3.7456709956709955,40.0,0.0
22772,2,2772,[ 64  12 357 301 269],416,5,10388,3.746123332131266,40.0,0.0
22773,2,2773,[ 64  12 357 301 269],416,5,10393,3.7465753424657535,40.0,0.0
22774,2,2774,[ 64  12 357 301 269],416,5,10398,3.747027027027027,40.0,0.0
22775,2,2775,[168 127 403 191  12],618,5,10403,3.747478386167147,20.0,0.0
22776,2,2776,[100  95 174  64   7],198,3,10406,3.7472092185812027,20.0,0.0
22777,2,2777,[ 64  12 357 301 269],416,5,10411,3.747660187185025,40.0,0.0
22778,2,2778,[ 64  12 357 301 269],416,5,10416,3.748110831234257,40.0,0.0
22779,2,2779,[195 200  28  22 294],416,5,10421,3.748561151079137,0.0,0.0
22780,2,2780,[403 258 568 210 195],62,4,10425,3.7486515641855447,0.0,0.0
22781,2,2781,[ 64  95 100 546  56],417,3,10428,3.7483824586628325,20.0,0.0
22782,2,2782,[132 475 127 568  64],416,4,10432,3.7484728710025155,20.0,0.0
22783,2,2783,[ 15 318 655   1 222],198,3,10435,3.7482040229885056,20.0,0.0
22784,2,2784,[210 475 197 185 202],437,3,10438,3.747935368043088,0.0,0.0
22785,2,2785,[ 64  12 357 301 269],416,5,10443,3.7483847810480975,40.0,0.0
22786,2,2786,[ 64  12 357 301 269],416,5,10448,3.7488338715464655,40.0,0.0
22787,2,2787,[ 64  12 357 301 269],416,5,10453,3.7492826398852226,40.0,0.0
22788,2,2788,[143  25 328 742  64],416,5,10458,3.7497310864109,20.0,0.0
22789,2,2789,[ 95 125 153   7  56],416,4,10462,3.749820788530466,0.0,0.0
22790,2,2790,[546 176 181 191 100],416,4,10466,3.7499104263704766,0.0,20.0
22791,2,2791,[194 197 144  12 318],373,3,10469,3.7496418338108883,40.0,0.0
22792,2,2792,[144 318 185  15 111],618,3,10472,3.7493734335839597,20.0,0.0
22793,2,2793,[187   7  95 117 183],198,3,10475,3.749105225483178,0.0,0.0
22794,2,2794,[546 257 176 597 111],62,2,10477,3.748479427549195,0.0,0.0
22795,2,2795,[ 64  12 357 301 269],416,5,10482,3.7489270386266096,40.0,0.0
22796,2,2796,[588 186  69  98 257],601,1,10483,3.747944225956382,0.0,20.0
22797,2,2797,[204 222 172 144 121],698,2,10485,3.7473195139385274,0.0,0.0
22798,2,2798,[ 64  12 357 301 269],416,5,10490,3.7477670596641657,40.0,0.0
22799,2,2799,[588 125 151 161 313],618,3,10493,3.7475,20.0,20.0
22800,2,2800,[ 64  12 357 301 269],416,5,10498,3.7479471617279545,40.0,0.0
22801,2,2801,[423 237 186  71 121],43,4,10502,3.7480371163454675,0.0,0.0
22802,2,2802,[483 597 588 197 603],751,3,10505,3.7477702461648232,20.0,0.0
22803,2,2803,[ 64  12 357 301 269],416,5,10510,3.7482168330955776,40.0,0.0
22804,2,2804,[ 64  12 357 301 269],416,5,10515,3.748663101604278,40.0,0.0
22805,2,2805,[ 64  12 357 301 269],416,5,10520,3.7491090520313612,40.0,0.0
22806,2,2806,[ 64  12 357 301 269],416,5,10525,3.7495546847167796,40.0,0.0
22807,2,2807,[216 186 135 191 195],642,2,10527,3.748931623931624,0.0,0.0
22808,2,2808,[ 64  12 357 301 269],416,5,10532,3.74937700249199,40.0,0.0
22809,2,2809,[204  82   4 289 323],43,4,10536,3.7494661921708183,0.0,0.0
22810,2,2810,[ 64  12 357 301 269],416,5,10541,3.749911063678406,40.0,0.0
22811,2,2811,[ 56 323 288   7 111],416,4,10545,3.75,0.0,20.0
22812,2,2812,[288 172  25  71 181],805,2,10547,3.7493778883754,0.0,40.0
22813,2,2813,[427 588 181 191  69],618,5,10552,3.749822316986496,0.0,20.0
22814,2,2814,[196  28 268  71 289],416,4,10556,3.749911190053286,0.0,0.0
22815,2,2815,[183 588 121 174 187],618,5,10561,3.7503551136363638,0.0,0.0
22816,2,2816,[ 64  12 357 301 269],416,5,10566,3.7507987220447285,40.0,0.0
22817,2,2817,[423 143 678 269  71],805,2,10568,3.7501774308019873,0.0,0.0
22818,2,2818,[ 64  12 357 301 269],416,5,10573,3.7506207875133026,40.0,0.0
22819,2,2819,[ 28 258 742 257 269],654,5,10578,3.751063829787234,0.0,0.0
22820,2,2820,[210 245  50  88 125],416,3,10581,3.750797589507267,0.0,20.0
22821,2,2821,[127 161  28 275  56],43,5,10586,3.7512402551382,0.0,0.0
22822,2,2822,[257 215 237 117 271],297,2,10588,3.750619907899398,0.0,0.0
22823,2,2823,[176 191 403 195   1],198,4,10592,3.7507082152974505,0.0,0.0
22824,2,2824,[ 64  12 357 301 269],416,5,10597,3.751150442477876,40.0,0.0
22825,2,2825,[183 135  98  89 111],417,3,10600,3.750884642604388,0.0,20.0
22826,2,2826,[748 200 210 174   1],345,3,10603,3.750619030774673,0.0,0.0
22827,2,2827,[275  12 475 117 238],437,3,10606,3.7503536067892504,20.0,0.0
22828,2,2828,[655  25 282 385 235],416,4,10610,3.7504418522446095,0.0,0.0
22829,2,2829,[173 289 245 111 323],764,3,10613,3.7501766784452295,0.0,0.0
22830,2,2830,[ 71  28 153  11  15],654,3,10616,3.749911691981632,0.0,0.0
22831,2,2831,[ 64  12 357 301 269],416,5,10621,3.750353107344633,40.0,0.0
22832,2,2832,[181 234 176 100  79],96,5,10626,3.7507942110836567,0.0,20.0
22833,2,2833,[172 202 237  15 135],642,3,10629,3.750529287226535,0.0,0.0
22834,2,2834,[ 64  12 357 301 269],416,5,10634,3.7509700176366843,40.0,0.0
22835,2,2835,[ 64  12 357 301 269],416,5,10639,3.7514104372355432,40.0,0.0
22836,2,2836,[151 294 132 125 328],505,2,10641,3.75079309129362,0.0,0.0
22837,2,2837,[216 271  64 275 168],854,4,10645,3.7508809020436926,20.0,0.0
22838,2,2838,[268 151 237 288 191],297,2,10647,3.7502641775272982,0.0,20.0
22839,2,2839,[300  11 385 655 118],416,4,10651,3.7503521126760564,0.0,0.0
22840,2,2840,[ 64  12 357 301 269],416,5,10656,3.750791974656811,40.0,0.0
22841,2,2841,[ 64  12 357 301 269],416,5,10661,3.751231527093596,40.0,0.0
22842,2,2842,[216 176 508 273 286],854,2,10663,3.750615546957439,0.0,0.0
22843,2,2843,[179 294 117 258 183],417,5,10668,3.7510548523206753,0.0,0.0
22844,2,2844,[204   8 111  71 181],437,3,10671,3.75079086115993,0.0,20.0
22845,2,2845,[ 88  70  22 234   4],405,3,10674,3.7505270555165144,0.0,0.0
22846,2,2846,[ 88 286 301 181 215],43,5,10679,3.750965929048121,0.0,20.0
22847,2,2847,[286 289 333 678 173],721,2,10681,3.7503511235955056,0.0,0.0
22848,2,2848,[ 64  12 357 301 269],416,5,10686,3.750789750789751,40.0,0.0
22849,2,2849,[196  71  11 168 258],198,3,10689,3.7505263157894735,0.0,0.0
22850,2,2850,[276 132 181   9 403],62,5,10694,3.7509645738337425,0.0,20.0
22851,2,2851,[196   4  79  12  88],373,5,10699,3.7514025245441793,20.0,0.0
22852,2,2852,[168 275 135 100  56],214,2,10701,3.7507886435331232,0.0,0.0
22853,2,2853,[ 79  11  98 180 268],214,4,10705,3.750875963559916,0.0,20.0
22854,2,2854,[ 64  12 357 301 269],416,5,10710,3.7513134851138354,40.0,0.0
22855,2,2855,[204 211 185 568  28],230,4,10714,3.7514005602240896,0.0,0.0
22856,2,2856,[151  50  11 118 245],764,3,10717,3.751137556877844,0.0,20.0
22857,2,2857,[ 64  12 357 301 269],416,5,10722,3.7515745276417074,40.0,0.0
22858,2,2858,[191   8  11 204  88],43,5,10727,3.752011192724729,0.0,0.0
22859,2,2859,[153 135 174 483  98],601,4,10731,3.752097902097902,20.0,20.0
22860,2,2860,[ 64  12 357 301 269],416,5,10736,3.752534078993359,40.0,0.0
22861,2,2861,[ 71   9 202   1 117],618,3,10739,3.752271139063592,0.0,0.0
22862,2,2862,[ 64  12 357 301 269],416,5,10744,3.7527069507509605,40.0,0.0
22863,2,2863,[ 64  12 357 301 269],416,5,10749,3.753142458100559,40.0,0.0
22864,2,2864,[ 64  12 357 301 269],416,5,10754,3.7535776614310645,40.0,0.0
22865,2,2865,[ 69 265 603  82 181],405,3,10757,3.753314724354501,0.0,20.0
22866,2,2866,[ 79   8 268 185  12],297,4,10761,3.7534007673526335,20.0,0.0
22867,2,2867,[588 100   4 175 237],297,4,10765,3.753486750348675,0.0,0.0
22868,2,2868,[237 294  22 176   8],297,4,10769,3.7535726734053676,0.0,0.0
22869,2,2869,[100 215  12   1 275],618,4,10773,3.7536585365853656,20.0,0.0
22870,2,2870,[313 385 423 161 174],505,4,10777,3.7537443399512367,20.0,20.0
22871,2,2871,[ 64  12 357 301 269],416,5,10782,3.7541782729805013,40.0,0.0
22872,2,2872,[  1 357 202 168 273],416,5,10787,3.7546119039331707,0.0,0.0
22873,2,2873,[ 69  12 286 258 191],43,5,10792,3.755045233124565,20.0,0.0
22874,2,2874,[ 89 300 301 483 748],751,2,10794,3.7544347826086955,20.0,0.0
22875,2,2875,[161 301 172 318  88],43,5,10799,3.7548678720445063,20.0,0.0
22876,2,2876,[ 22  89  15 173 568],922,4,10803,3.7549530761209593,0.0,0.0
22877,2,2877,[ 70 385 245 185 143],416,4,10807,3.7550382209867963,0.0,0.0
22878,2,2878,[ 50 132 405 168 179],62,4,10811,3.7551233067037164,0.0,20.0
22879,2,2879,[ 88  22 151 276  56],314,3,10814,3.754861111111111,0.0,0.0
22880,2,2880,[144 496 197  70  15],437,3,10817,3.754599097535578,0.0,0.0
22881,2,2881,[ 64  12 357 301 269],416,5,10822,3.755031228313671,40.0,0.0
22882,2,2882,[275 216 211 288  79],416,5,10827,3.7554630593132154,0.0,20.0
22883,2,2883,[385  82 546 245 238],417,4,10831,3.7555478502080444,0.0,0.0
22884,2,2884,[ 64  12 357 301 269],416,5,10836,3.7559792027729637,40.0,0.0
22885,2,2885,[ 64  12 357 301 269],416,5,10841,3.7564102564102564,40.0,0.0
22886,2,2886,[471 182 143 210  22],297,3,10844,3.7561482507793555,0.0,0.0
22887,2,2887,[ 64  12 357 301 269],416,5,10849,3.7565789473684212,40.0,0.0
22888,2,2888,[ 64  12 357 301 269],416,5,10854,3.7570093457943927,40.0,0.0
22889,2,2889,[ 64  12 357 301 269],416,5,10859,3.757439446366782,40.0,0.0
22890,2,2890,[161 186 127 405 173],198,3,10862,3.7571774472500863,0.0,0.0
22891,2,2891,[222 276 168 121 300],198,1,10863,3.7562240663900415,0.0,0.0
22892,2,2892,[ 64  12 357 301 269],416,5,10868,3.7566539923954374,40.0,0.0
22893,2,2893,[ 22 655 288 118   1],588,3,10871,3.756392536281963,0.0,20.0
22894,2,2894,[ 64  12 357 301 269],416,5,10876,3.7568221070811743,40.0,0.0
22895,2,2895,[ 64  12 357 301 269],416,5,10881,3.7572513812154695,40.0,0.0
22896,2,2896,[197  79  89 185   1],297,2,10883,3.756644804970659,0.0,0.0
22897,2,2897,[195 174  89 173 153],854,3,10886,3.756383712905452,0.0,0.0
22898,2,2898,[357 100 588  82 196],416,5,10891,3.756812694032425,0.0,0.0
22899,2,2899,[151 125 216 546  56],314,3,10894,3.756551724137931,0.0,0.0
22900,2,2900,[655 286 269 118 245],416,3,10897,3.756290934160634,0.0,0.0
22901,2,2901,[ 64  12 357 301 269],416,5,10902,3.7567195037904892,40.0,0.0
22902,2,2902,[ 96   1 195 234 678],805,4,10906,3.7568033069238718,0.0,0.0
22903,2,2903,[196 111 742 435 100],297,2,10908,3.756198347107438,0.0,0.0
22904,2,2904,[118 257 235 269 176],854,1,10909,3.755249569707401,0.0,0.0
22905,2,2905,[300 143 234 181 269],345,4,10913,3.755333792154164,0.0,20.0
22906,2,2906,[ 88   8  12  56 748],437,4,10917,3.7554179566563466,20.0,0.0
22907,2,2907,[237  70 322 269 318],416,3,10920,3.7551581843191197,20.0,0.0
22908,2,2908,[187  15 172  82  11],198,3,10923,3.7548985905809555,0.0,0.0
22909,2,2909,[191 176 655 196 742],416,5,10928,3.7553264604810996,0.0,0.0
22910,2,2910,[ 64  12 357 301 269],416,5,10933,3.7557540364136037,40.0,0.0
22911,2,2911,[151 423 127  69 117],417,4,10937,3.755837912087912,0.0,0.0
22912,2,2912,[294  12 210  97 245],417,4,10941,3.755921730175077,20.0,0.0
22913,2,2913,[603  50  12 144 508],297,4,10945,3.7560054907343856,20.0,20.0
22914,2,2914,[183 182 655 222 742],253,4,10949,3.756089193825043,0.0,0.0
22915,2,2915,[215 588  70 176 302],416,5,10954,3.7565157750342935,0.0,0.0
22916,2,2916,[ 64  12 357 301 269],416,5,10959,3.756942063764141,40.0,0.0
22917,2,2917,[ 12 271 194 748 301],297,2,10961,3.7563399588759423,20.0,0.0
22918,2,2918,[ 98 265 568 168 222],922,3,10964,3.7560808496060294,0.0,20.0
22919,2,2919,[588 328  98 161  11],416,5,10969,3.7565068493150684,0.0,20.0
22920,2,2920,[ 64  12 357 301 269],416,5,10974,3.7569325573433754,40.0,0.0
22921,2,2921,[200 237 172 289 496],416,3,10977,3.7566735112936347,0.0,0.0
22922,2,2922,[ 64  12 357 301 269],416,5,10982,3.757098871022922,40.0,0.0
22923,2,2923,[ 64  12 357 301 269],416,5,10987,3.7575239398084817,40.0,0.0
22924,2,2924,[ 64 153 200 275 286],854,4,10991,3.7576068376068377,20.0,0.0
22925,2,2925,[ 64  12 357 301 269],416,5,10996,3.7580314422419687,40.0,0.0
22926,2,2926,[117  50  88 118 405],43,5,11001,3.758455756747523,0.0,20.0
22927,2,2927,[ 64  12 357 301 269],416,5,11006,3.758879781420765,40.0,0.0
22928,2,2928,[ 64  12 357 301 269],416,5,11011,3.7593035165585524,40.0,0.0
22929,2,2929,[191 180  15  50 179],417,4,11015,3.75938566552901,0.0,20.0
22930,2,2930,[172 210 191 222 180],198,3,11018,3.7591265779597407,0.0,0.0
22931,2,2931,[742 258 121 195 318],642,2,11020,3.758526603001364,20.0,0.0
22932,2,2932,[179 435 423 265  88],405,1,11021,3.7575860893283326,0.0,0.0
22933,2,2933,[ 64  12 357 301 269],416,5,11026,3.758009543285617,40.0,0.0
22934,2,2934,[ 28 175 211 174 172],43,4,11030,3.75809199318569,0.0,0.0
22935,2,2935,[475  50 173 127 183],416,4,11034,3.758174386920981,0.0,20.0
22936,2,2936,[475 496 588 286 423],417,3,11037,3.7579162410623086,0.0,0.0
22937,2,2937,[ 64  12 357 301 269],416,5,11042,3.758339006126617,40.0,0.0
22938,2,2938,[ 64  12 357 301 269],416,5,11047,3.7587614834977883,40.0,0.0
22939,2,2939,[313 191 257 222 228],711,2,11049,3.7581632653061225,20.0,20.0
22940,2,2940,[ 64  12 357 301 269],416,5,11054,3.7585855151309078,40.0,0.0
22941,2,2941,[ 64  12 357 301 269],416,5,11059,3.759007477906186,40.0,0.0
22942,2,2942,[265 151 471 117 588],618,3,11062,3.758749575263337,0.0,0.0
22943,2,2943,[ 70 215 197  95 191],618,2,11064,3.7581521739130435,0.0,0.0
22944,2,2944,[ 15 238 151 174 195],654,4,11068,3.758234295415959,0.0,0.0
22945,2,2945,[174 405 234  96 144],230,3,11071,3.757976917854718,0.0,0.0
22946,2,2946,[182 180 238 185 175],405,2,11073,3.7573803868340687,0.0,0.0
22947,2,2947,[ 64  12 357 301 269],416,5,11078,3.7578018995929443,40.0,0.0
22948,2,2948,[ 97 216  22   8  98],230,5,11083,3.758223126483554,0.0,20.0
22949,2,2949,[ 64  12 357 301 269],416,5,11088,3.75864406779661,40.0,0.0
22950,2,2950,[118 268 258   9 237],708,3,11091,3.7583869874618774,0.0,0.0
22951,2,2951,[143 235 300  71  11],49,0,11091,3.7571138211382116,0.0,0.0
22952,2,2952,[ 64  12 357 301 269],416,5,11096,3.757534710463935,40.0,0.0
22953,2,2953,[100 301 204 258 216],43,5,11101,3.7579553148273526,0.0,0.0
22954,2,2954,[302 742 268 748 237],654,4,11105,3.758037225042301,0.0,0.0
22955,2,2955,[471 173  11  88 301],416,4,11109,3.7581190798376185,0.0,0.0
22956,2,2956,[ 11 196 132  69  71],230,5,11114,3.758539059857964,0.0,0.0
22957,2,2957,[ 56 100  11 111   4],416,5,11119,3.7589587559161597,0.0,0.0
22958,2,2958,[ 64  12 357 301 269],416,5,11124,3.7593781683001013,40.0,0.0
22959,2,2959,[118   9  12 197  50],854,4,11128,3.7594594594594595,20.0,20.0
22960,2,2960,[300 196 257 385 313],43,5,11133,3.7598784194528876,20.0,20.0
22961,2,2961,[  9 132 125 235 127],62,5,11138,3.7602970965563807,0.0,0.0
22962,2,2962,[  7 187 603 182  22],214,4,11142,3.760377995275059,0.0,0.0
22963,2,2963,[181 144 265  98   7],417,1,11143,3.75944669365722,0.0,40.0
22964,2,2964,[286 275 748 323 475],324,5,11148,3.7598650927487354,0.0,0.0
22965,2,2965,[588 508 135 183 302],297,5,11153,3.7602832097100474,0.0,0.0
22966,2,2966,[111  95 151  88   8],588,4,11157,3.7603640040444892,0.0,0.0
22967,2,2967,[ 64  12 357 301 269],416,5,11162,3.76078167115903,40.0,0.0
22968,2,2968,[ 64 125  15 655 228],417,4,11166,3.760862243179522,20.0,0.0
22969,2,2969,[ 64  12 357 301 269],416,5,11171,3.7612794612794613,40.0,0.0
22970,2,2970,[ 82 143   7   1  56],618,5,11176,3.761696398519017,0.0,0.0
22971,2,2971,[ 64 195 268 237  22],854,1,11177,3.7607671601615076,20.0,0.0
22972,2,2972,[ 64  12 357 301 269],416,5,11182,3.7611839892364616,40.0,0.0
22973,2,2973,[ 28 125 318 179   8],721,4,11186,3.761264290517821,20.0,0.0
22974,2,2974,[ 95 265 282 195 568],705,4,11190,3.761344537815126,0.0,0.0
22975,2,2975,[ 64  12 357 301 269],416,5,11195,3.761760752688172,40.0,0.0
22976,2,2976,[ 64  12 357 301 269],416,5,11200,3.76217668794088,40.0,0.0
22977,2,2977,[ 64  12 357 301 269],416,5,11205,3.7625923438549362,40.0,0.0
22978,2,2978,[125  69 597  56 471],887,4,11209,3.762672037596509,0.0,0.0
22979,2,2979,[ 64  12 357 301 269],416,5,11214,3.763087248322148,40.0,0.0
22980,2,2980,[323 168 289 216 235],416,2,11216,3.7624958067762497,0.0,0.0
22981,2,2981,[ 64  12 357 301 269],416,5,11221,3.7629107981220655,40.0,0.0
22982,2,2982,[181 288 132 216 318],345,4,11225,3.7629902782433793,20.0,40.0
22983,2,2983,[ 69  71  97 423 216],416,5,11230,3.763404825737265,0.0,0.0
22984,2,2984,[742 173 185 175  89],854,4,11234,3.7634840871021775,0.0,0.0
22985,2,2985,[ 64  12 357 301 269],416,5,11239,3.763898191560616,40.0,0.0
22986,2,2986,[ 69  50   1 288 175],854,4,11243,3.763977234683629,0.0,40.0
22987,2,2987,[ 64  12 357 301 269],416,5,11248,3.7643908969210176,40.0,0.0
22988,2,2988,[180 427 235  82 127],887,3,11251,3.764135162261626,0.0,0.0
22989,2,2989,[176 288 180  69 200],437,2,11253,3.763545150501672,0.0,20.0
22990,2,2990,[258 238  97 742  98],24,5,11258,3.763958542293547,0.0,20.0
22991,2,2991,[ 64  12 357 301 269],416,5,11263,3.7643716577540105,40.0,0.0
22992,2,2992,[ 64  12 357 301 269],416,5,11268,3.76478449716004,40.0,0.0
22993,2,2993,[151  70  82 237 568],43,5,11273,3.765197060788243,0.0,0.0
22994,2,2994,[151 215 111 173  82],43,5,11278,3.765609348914858,0.0,0.0
22995,2,2995,[ 64  12 357 301 269],416,5,11283,3.7660213618157545,40.0,0.0
22996,2,2996,[216 186  97 187  89],405,2,11285,3.765432098765432,0.0,0.0
22997,2,2997,[ 64  12 357 301 269],416,5,11290,3.7658438959306206,40.0,0.0
22998,2,2998,[235  97 423 179 182],416,3,11293,3.7655885295098366,0.0,0.0
22999,2,2999,[ 64  12 357 301 269],416,5,11298,3.766,40.0,0.0
23000,2,3000,[ 56  96 202 118 655],751,3,11301,3.7657447517494167,0.0,0.0
23001,2,3001,[183 238  98 257  12],416,4,11305,3.7658227848101267,20.0,20.0
23002,2,3002,[ 64  12 357 301 269],416,5,11310,3.7662337662337664,40.0,0.0
23003,2,3003,[111 161 258 546 210],417,1,11311,3.765312916111851,0.0,0.0
23004,2,3004,[100 742 196  96 475],417,2,11313,3.7647254575707154,0.0,0.0
23005,2,3005,[ 64  12 357 301 269],416,5,11318,3.7651363938789086,40.0,0.0
23006,2,3006,[238  64  82 222 191],711,3,11321,3.7648819421350184,20.0,0.0
23007,2,3007,[ 64  12 357 301 269],416,5,11326,3.765292553191489,40.0,0.0
23008,2,3008,[333 313  98 132 678],416,4,11330,3.765370555001662,20.0,40.0
23009,2,3009,[215 202 173 385 179],751,5,11335,3.76578073089701,0.0,0.0
23010,2,3010,[ 64  12 357 301 269],416,5,11340,3.7661906343407505,40.0,0.0
23011,2,3011,[161 216  79 186 496],230,5,11345,3.7666002656042497,0.0,0.0
23012,2,3012,[ 64  12 357 301 269],416,5,11350,3.767009624958513,40.0,0.0
23013,2,3013,[ 64  12 357 301 269],416,5,11355,3.767418712674187,40.0,0.0
23014,2,3014,[546 508 234 258 568],417,2,11357,3.766832504145937,0.0,0.0
23015,2,3015,[ 64  12 357 301 269],416,5,11362,3.7672413793103448,40.0,0.0
23016,2,3016,[127  28 204 186  89],373,3,11365,3.7669870732515744,0.0,0.0
23017,2,3017,[ 64  12 357 301 269],416,5,11370,3.7673956262425445,40.0,0.0
23018,2,3018,[191 238 187 132 234],198,4,11374,3.7674726730705532,0.0,0.0
23019,2,3019,[ 71 286 204 238  56],345,3,11377,3.767218543046358,0.0,0.0
23020,2,3020,[678  25 568 269  71],416,4,11381,3.7672955974842766,0.0,0.0
23021,2,3021,[ 64  12 357 301 269],416,5,11386,3.767703507610854,40.0,0.0
23022,2,3022,[ 64  12 357 301 269],416,5,11391,3.768111147866358,40.0,0.0
23023,2,3023,[ 64  12 357 301 269],416,5,11396,3.7685185185185186,40.0,0.0
23024,2,3024,[ 64  12 357 301 269],416,5,11401,3.7689256198347105,40.0,0.0
23025,2,3025,[ 79 405 144 423 125],854,3,11404,3.76867151354924,0.0,0.0
23026,2,3026,[ 64  12 357 301 269],416,5,11409,3.769078295341923,40.0,0.0
23027,2,3027,[ 64  12 357 301 269],416,5,11414,3.7694848084544255,40.0,0.0
23028,2,3028,[742 282 302   1 423],416,5,11419,3.7698910531528558,0.0,0.0
23029,2,3029,[ 28 161 357 235 423],805,1,11420,3.768976897689769,0.0,0.0
23030,2,3030,[194  50 211  70  89],405,1,11421,3.768063345430551,0.0,20.0
23031,2,3031,[275 423 282  56 100],854,4,11425,3.7681398416886545,0.0,0.0
23032,2,3032,[ 96 183 182 202  82],405,2,11427,3.7675568743818,0.0,0.0
23033,2,3033,[301 742 568  95  82],751,3,11430,3.7673038892551087,0.0,0.0
23034,2,3034,[ 50 282 182 195  89],297,2,11432,3.7667215815485995,0.0,20.0
23035,2,3035,[216 234 176 318  64],198,4,11436,3.766798418972332,40.0,0.0
23036,2,3036,[286 245   9 273 258],416,4,11440,3.7668752057951926,0.0,0.0
23037,2,3037,[ 50 187 197 313 655],416,5,11445,3.7672811059907834,20.0,40.0
23038,2,3038,[ 82 187 197 191 496],618,4,11449,3.7673576834485027,0.0,0.0
23039,2,3039,[515 238 588  96  11],416,5,11454,3.767763157894737,0.0,0.0
23040,2,3040,[ 64  12 357 301 269],416,5,11459,3.7681683656691876,40.0,0.0
23041,2,3041,[ 64  12 357 301 269],416,5,11464,3.7685733070348455,40.0,0.0
23042,2,3042,[144 180 216  56 282],854,2,11466,3.767992113046336,0.0,0.0
23043,2,3043,[269 200 323   4 210],805,3,11469,3.7677398160315376,0.0,0.0
23044,2,3044,[ 64  12 357 301 269],416,5,11474,3.768144499178982,40.0,0.0
23045,2,3045,[215  70 187  56   1],416,5,11479,3.76854891661195,0.0,0.0
23046,2,3046,[151  11 323 405  64],417,3,11482,3.768296685264194,20.0,0.0
23047,2,3047,[ 64  12 357 301 269],416,5,11487,3.768700787401575,40.0,0.0
23048,2,3048,[174 471  97 125 237],588,1,11488,3.7677927189242375,0.0,0.0
23049,2,3049,[ 64  12 357 301 269],416,5,11493,3.7681967213114755,40.0,0.0
23050,2,3050,[ 64  12 357 301 269],416,5,11498,3.7686004588659454,40.0,0.0
23051,2,3051,[ 64  12 357 301 269],416,5,11503,3.7690039318479687,40.0,0.0
23052,2,3052,[100 202 275 186   7],43,4,11507,3.7690795938421227,0.0,0.0
23053,2,3053,[172 185 127 210 183],416,5,11512,3.7694826457105437,0.0,0.0
23054,2,3054,[ 15 269 195 151 748],654,4,11516,3.7695581014729953,0.0,0.0
23055,2,3055,[ 64  12 357 301 269],416,5,11521,3.769960732984293,40.0,0.0
23056,2,3056,[210 195 483  82  79],618,3,11524,3.769708864900229,20.0,0.0
23057,2,3057,[427 191 265   1 121],705,3,11527,3.7694571615434924,0.0,0.0
23058,2,3058,[ 64  12 357 301 269],416,5,11532,3.7698594311866622,40.0,0.0
23059,2,3059,[515 179 127  64  11],405,3,11535,3.769607843137255,20.0,0.0
23060,2,3060,[ 64  12 357 301 269],416,5,11540,3.7700098007187193,40.0,0.0
23061,2,3061,[ 64  12 357 301 269],416,5,11545,3.770411495754409,40.0,0.0
23062,2,3062,[ 64  12 357 301 269],416,5,11550,3.7708129285014693,40.0,0.0
23063,2,3063,[ 64  12 357 301 269],416,5,11555,3.77121409921671,40.0,0.0
23064,2,3064,[210 187 195 153  79],416,5,11560,3.7716150081566067,0.0,0.0
23065,2,3065,[179  98 151  11 515],417,5,11565,3.7720156555772992,0.0,20.0
23066,2,3066,[195 181 176  98 276],198,3,11568,3.771763938702315,0.0,40.0
23067,2,3067,[275 237 210  50 257],43,5,11573,3.7721642764015644,0.0,20.0
23068,2,3068,[ 64  12 357 301 269],416,5,11578,3.7725643532095146,40.0,0.0
23069,2,3069,[ 64  12 357 301 269],416,5,11583,3.7729641693811073,40.0,0.0
23070,2,3070,[ 64  12 357 301 269],416,5,11588,3.773363725170954,40.0,0.0
23071,2,3071,[ 64  12 357 301 269],416,5,11593,3.7737630208333335,40.0,0.0
23072,2,3072,[237 204 678 238 143],416,3,11596,3.773511226814188,0.0,0.0
23073,2,3073,[ 56 191  15 135 196],618,4,11600,3.7735849056603774,0.0,0.0
23074,2,3074,[ 64  12 357 301 269],416,5,11605,3.7739837398373983,40.0,0.0
23075,2,3075,[318 118   7 597 132],588,3,11608,3.773732119635891,20.0,0.0
23076,2,3076,[ 64  12 357 301 269],416,5,11613,3.774130646733832,40.0,0.0
23077,2,3077,[125 471 286 385  56],416,5,11618,3.774528914879792,0.0,0.0
23078,2,3078,[ 64  12 357 301 269],416,5,11623,3.77492692432608,40.0,0.0
23079,2,3079,[423 151  64 546 588],705,1,11624,3.774025974025974,20.0,0.0
23080,2,3080,[222 300 121 322  82],128,3,11627,3.7737747484582926,0.0,0.0
23081,2,3081,[215 237 289  12 210],588,3,11630,3.773523685918235,20.0,0.0
23082,2,3082,[216   8 121 172  82],43,5,11635,3.7739215050275705,0.0,0.0
23083,2,3083,[ 64  12 357 301 269],416,5,11640,3.77431906614786,40.0,0.0
23084,2,3084,[ 89 210   4  22   8],642,3,11643,3.774068071312804,0.0,0.0
23085,2,3085,[196   8 427 132  15],618,3,11646,3.7738172391445235,0.0,0.0
23086,2,3086,[144 603  56 174 742],805,2,11648,3.7732426303854876,0.0,0.0
23087,2,3087,[ 64  12 357 301 269],416,5,11653,3.773639896373057,40.0,0.0
23088,2,3088,[111 118 100 742 168],588,2,11655,3.7730657170605375,0.0,0.0
23089,2,3089,[179 127 195 183 180],805,2,11657,3.7724919093851135,0.0,0.0
23090,2,3090,[ 64  12 357 301 269],416,5,11662,3.7728890326755096,40.0,0.0
23091,2,3091,[ 96 271 151 228 405],62,2,11664,3.772315653298836,0.0,0.0
23092,2,3092,[ 96 475  98 191 323],417,3,11667,3.7720659553831233,0.0,20.0
23093,2,3093,[ 64  12 357 301 269],416,5,11672,3.7724628312863606,40.0,0.0
23094,2,3094,[211  79 508 235  11],417,2,11674,3.7718901453958,0.0,0.0
23095,2,3095,[228 144 273 568 483],417,1,11675,3.770994832041344,20.0,0.0
23096,2,3096,[  4 135 322 294  50],805,2,11677,3.7704229899903132,0.0,20.0
23097,2,3097,[196 180 357 176 200],417,5,11682,3.770819883795997,0.0,0.0
23098,2,3098,[ 64  12 357 301 269],416,5,11687,3.771216521458535,40.0,0.0
23099,2,3099,[ 64  12 357 301 269],416,5,11692,3.7716129032258063,40.0,0.0
23100,2,3100,[228  82   8 333 328],721,4,11696,3.7716865527249275,0.0,0.0
23101,2,3101,[ 64  12 357 301 269],416,5,11701,3.7720825274016763,40.0,0.0
23102,2,3102,[ 64  12 357 301 269],416,5,11706,3.7724782468578795,40.0,0.0
23103,2,3103,[471 282 144 174   8],297,2,11708,3.7719072164948453,0.0,0.0
23104,2,3104,[ 71 258   7 175 151],198,3,11711,3.771658615136876,0.0,0.0
23105,2,3105,[678 143   8 210 179],805,2,11713,3.771088216355441,0.0,0.0
23106,2,3106,[222 258 211 215  22],297,4,11717,3.7711618925008046,0.0,0.0
23107,2,3107,[118 302  64 268 153],416,4,11721,3.7712355212355213,20.0,0.0
23108,2,3108,[ 64  12 357 301 269],416,5,11726,3.771630749437118,40.0,0.0
23109,2,3109,[215 132  64  82 568],711,2,11728,3.7710610932475883,20.0,0.0
23110,2,3110,[423 588 127  79   7],43,5,11733,3.7714561234329795,0.0,0.0
23111,2,3111,[322 196  96  79 323],417,1,11734,3.770565552699229,0.0,0.0
23112,2,3112,[ 89 275 173 318 269],373,5,11739,3.770960488274976,20.0,0.0
23113,2,3113,[ 64  12 357 301 269],416,5,11744,3.771355170199101,40.0,0.0
23114,2,3114,[118 161 143 204 655],751,2,11746,3.7707865168539327,0.0,0.0
23115,2,3115,[258  82 174 288  89],922,3,11749,3.7705391527599486,0.0,20.0
23116,2,3116,[174 269   9   8 204],805,1,11750,3.7696503047802374,0.0,0.0
23117,2,3117,[ 25  69 588 174  71],128,3,11753,3.76940346375882,0.0,0.0
23118,2,3118,[ 50 153 603  69 168],437,3,11756,3.7691567810195576,0.0,20.0
23119,2,3119,[117   7  15  70 210],618,2,11758,3.7685897435897435,0.0,0.0
23120,2,3120,[121 125  22 196  69],416,5,11763,3.768984299903877,0.0,0.0
23121,2,3121,[ 64  12 357 301 269],416,5,11768,3.769378603459321,40.0,0.0
23122,2,3122,[568 186 234 196 173],618,4,11772,3.7694524495677233,0.0,0.0
23123,2,3123,[ 64  12 357 301 269],416,5,11777,3.769846350832266,40.0,0.0
23124,2,3124,[588 234 191   8 294],601,1,11778,3.76896,0.0,0.0
23125,2,3125,[ 64  12 357 301 269],416,5,11783,3.76935380678183,40.0,0.0
23126,2,3126,[475  50 202 204 127],416,4,11787,3.7694275663575314,0.0,20.0
23127,2,3127,[427 216 288 195 385],405,3,11790,3.7691815856777495,0.0,20.0
23128,2,3128,[ 64  12 357 301 269],416,5,11795,3.7695749440715884,40.0,0.0
23129,2,3129,[403 258 121 276   9],43,5,11800,3.769968051118211,0.0,0.0
23130,2,3130,[475 153 496 258 276],416,3,11803,3.769722133503673,0.0,0.0
23131,2,3131,[ 64  12 357 301 269],416,5,11808,3.7701149425287355,40.0,0.0
23132,2,3132,[318 286  70 202 603],416,5,11813,3.770507500797957,20.0,0.0
23133,2,3133,[ 64  12 357 301 269],416,5,11818,3.770899808551372,40.0,0.0
23134,2,3134,[258  69 748 357  11],198,4,11822,3.7709728867623604,0.0,0.0
23135,2,3135,[ 64  12 357 301 269],416,5,11827,3.7713647959183674,40.0,0.0
23136,2,3136,[496   7 286 742 143],588,3,11830,3.771118903410902,0.0,0.0
23137,2,3137,[ 64  12 357 301 269],416,5,11835,3.77151051625239,40.0,0.0
23138,2,3138,[144  28 508 100 300],654,3,11838,3.771264733991717,0.0,0.0
23139,2,3139,[568 118 423 215 200],618,4,11842,3.7713375796178346,0.0,0.0
23140,2,3140,[234 435 211 200 655],405,2,11844,3.7707736389684814,0.0,0.0
23141,2,3141,[ 64  12 357 301 269],416,5,11849,3.771164863144494,40.0,0.0
23142,2,3142,[196 215 144  15 471],373,3,11852,3.7709195036589245,0.0,0.0
23143,2,3143,[265 258 222 182  22],297,3,11855,3.770674300254453,0.0,0.0
23144,2,3144,[ 64  12 357 301 269],416,5,11860,3.7710651828298887,40.0,0.0
23145,2,3145,[ 64  12 357 301 269],416,5,11865,3.7714558169103625,40.0,0.0
23146,2,3146,[121 300 210  97 173],654,4,11869,3.7715284397839213,0.0,0.0
23147,2,3147,[ 64  12 357 301 269],416,5,11874,3.771918678526048,40.0,0.0
23148,2,3148,[742 237 385 655  15],588,2,11876,3.7713559860273103,0.0,0.0
23149,2,3149,[385 183 100 245  50],416,4,11880,3.7714285714285714,0.0,20.0
23150,2,3150,[ 64  12 357 301 269],416,5,11885,3.7718184703268802,40.0,0.0
23151,2,3151,[678 118 179  22 197],805,3,11888,3.771573604060914,0.0,0.0
23152,2,3152,[ 97 172 318  95 265],705,3,11891,3.7713288931176656,20.0,0.0
23153,2,3153,[121 216 172  88 237],416,3,11894,3.7710843373493974,0.0,0.0
23154,2,3154,[127 222 508 151   9],62,5,11899,3.771473851030111,0.0,0.0
23155,2,3155,[ 98  79  15 186 135],437,4,11903,3.7715462610899873,0.0,20.0
23156,2,3156,[191  79 195 302 385],417,3,11906,3.7713018688628446,0.0,0.0
23157,2,3157,[  9 322  98   7  56],805,3,11909,3.7710576314122863,0.0,20.0
23158,2,3158,[195  22 172  25 132],230,3,11912,3.7708135485913266,0.0,0.0
23159,2,3159,[111 546 276 282 132],416,3,11915,3.7705696202531644,0.0,0.0
23160,2,3160,[196 117 269 357 100],214,4,11919,3.770642201834862,0.0,0.0
23161,2,3161,[181 508 151  50 215],128,3,11922,3.7703984819734346,0.0,40.0
23162,2,3162,[273 471   9 195 211],416,5,11927,3.7707872273158394,0.0,0.0
23163,2,3163,[ 64  12 357 301 269],416,5,11932,3.771175726927939,40.0,0.0
23164,2,3164,[215 748 275 403 301],416,5,11937,3.7715639810426542,0.0,0.0
23165,2,3165,[ 64  12 357 301 269],416,5,11942,3.771951989892609,40.0,0.0
23166,2,3166,[182   8  97 483 282],907,4,11946,3.77202399747395,20.0,0.0
23167,2,3167,[197 423 176 194 603],405,2,11948,3.7714646464646466,0.0,0.0
23168,2,3168,[183   4 515  22  64],405,3,11951,3.7712212054275795,20.0,0.0
23169,2,3169,[ 95 215 173 742 313],751,3,11954,3.7709779179810727,20.0,20.0
23170,2,3170,[289 269 588   7  98],416,4,11958,3.771050141911069,0.0,20.0
23171,2,3171,[ 64  12 357 301 269],416,5,11963,3.771437578814628,40.0,0.0
23172,2,3172,[ 64  12 357 301 269],416,5,11968,3.7718247715096123,40.0,0.0
23173,2,3173,[597 191 174 423 222],43,4,11972,3.7718966603654693,0.0,0.0
23174,2,3174,[603 294  25 174 257],854,1,11973,3.771023622047244,0.0,0.0
23175,2,3175,[ 64  12 357 301 269],416,5,11978,3.7714105793450883,40.0,0.0
23176,2,3176,[568 202 173  82  50],642,4,11982,3.7714825306893296,0.0,20.0
23177,2,3177,[180 216 423 176 151],437,4,11986,3.7715544367526745,0.0,0.0
23178,2,3178,[182  15 234  82  88],618,4,11990,3.7716262975778547,0.0,0.0
23179,2,3179,[195 211 111 117 200],297,2,11992,3.771069182389937,0.0,0.0
23180,2,3180,[ 64  12 357 301 269],416,5,11997,3.771455517132977,40.0,0.0
23181,2,3181,[ 64  12 357 301 269],416,5,12002,3.7718416090509113,40.0,0.0
23182,2,3182,[ 64  12 357 301 269],416,5,12007,3.7722274583726043,40.0,0.0
23183,2,3183,[ 64  12 357 301 269],416,5,12012,3.772613065326633,40.0,0.0
23184,2,3184,[286  50 313 265  22],588,5,12017,3.7729984301412873,20.0,40.0
23185,2,3185,[ 79 197 121  82 194],416,5,12022,3.77338355304457,0.0,0.0
23186,2,3186,[ 79  15 195  82 200],437,3,12025,3.7731408848446817,0.0,0.0
23187,2,3187,[ 64  12 357 301 269],416,5,12030,3.773525721455458,40.0,0.0
23188,2,3188,[174  71 144 216 179],373,3,12033,3.773283160865475,0.0,0.0
23189,2,3189,[ 64  12 357 301 269],416,5,12038,3.7736677115987463,40.0,0.0
23190,2,3190,[173 508 202 301 435],297,3,12041,3.7734252585396426,0.0,0.0
23191,2,3191,[195 423 333 118  12],416,4,12045,3.773496240601504,20.0,0.0
23192,2,3192,[210  88 496 181 172],588,4,12049,3.7735671782023177,0.0,20.0
23193,2,3193,[ 64  12 357 301 269],416,5,12054,3.7739511584220415,40.0,0.0
23194,2,3194,[ 64  12 357 301 269],416,5,12059,3.77433489827856,40.0,0.0
23195,2,3195,[125   7  89 322  82],417,3,12062,3.774092615769712,0.0,0.0
23196,2,3196,[288 313  71 234 294],588,5,12067,3.7744760713168595,20.0,40.0
23197,2,3197,[ 22 282  98 655 196],618,4,12071,3.7745465916197625,0.0,20.0
23198,2,3198,[333 135 405 180 195],854,3,12074,3.774304470146921,0.0,0.0
23199,2,3199,[ 64  12 357 301 269],416,5,12079,3.7746875,40.0,0.0
23200,2,3200,[183  12  64   8 135],601,3,12082,3.774445485785692,40.0,0.0
23201,2,3201,[ 96  12 265 196  71],405,1,12083,3.773579013116802,20.0,0.0
23202,2,3202,[ 64 357  12 301 269],416,5,12088,3.7739619107087106,40.0,0.0
23203,2,3203,[318 151 742 204 515],416,4,12092,3.774032459425718,20.0,0.0
23204,2,3204,[ 50   8 132  98 289],416,4,12096,3.7741029641185646,0.0,40.0
23205,2,3205,[191   7 655  22 195],416,5,12101,3.7744853399875233,0.0,0.0
23206,2,3206,[275 508 234 100  22],297,4,12105,3.774555659494855,0.0,0.0
23207,2,3207,[ 64 357  12 301 269],416,5,12110,3.774937655860349,40.0,0.0
23208,2,3208,[235 202 180   7 121],417,2,12112,3.7743845434714864,0.0,0.0
23209,2,3209,[ 64 357  12 301 269],416,5,12117,3.774766355140187,40.0,0.0
23210,2,3210,[568  96 234 678 111],416,4,12121,3.7748364995328556,0.0,0.0
23211,2,3211,[294 238 323 168 127],417,4,12125,3.774906600249066,0.0,0.0
23212,2,3212,[ 64 357  12 301 269],416,5,12130,3.775287892934952,40.0,0.0
23213,2,3213,[ 64 357  12 301 269],416,5,12135,3.7756689483509644,40.0,0.0
23214,2,3214,[ 64 357  12 301 269],416,5,12140,3.776049766718507,40.0,0.0
23215,2,3215,[302 117 265 269 568],654,5,12145,3.7764303482587063,0.0,0.0
23216,2,3216,[588 144  69 568  88],588,3,12148,3.776188995958968,0.0,0.0
23217,2,3217,[258 161 435  98 496],505,2,12150,3.7756370416407705,0.0,20.0
23218,2,3218,[ 70  25 144 294 237],654,3,12153,3.7753960857409132,0.0,0.0
23219,2,3219,[245 187  95 678 302],416,2,12155,3.7748447204968945,0.0,0.0
23220,2,3220,[ 64 357  12 301 269],416,5,12160,3.7752250853772122,40.0,0.0
23221,2,3221,[ 70  56 196 173 117],416,5,12165,3.7756052141527,0.0,0.0
23222,2,3222,[132 258 187 238 200],416,5,12170,3.7759851070431276,0.0,0.0
23223,2,3223,[ 64 357  12 301 269],416,5,12175,3.7763647642679903,40.0,0.0
23224,2,3224,[357  12 302  88  70],416,4,12179,3.776434108527132,20.0,0.0
23225,2,3225,[234 289  15  11 385],345,3,12182,3.776193428394296,0.0,0.0
23226,2,3226,[603 288 385 144 181],805,1,12183,3.775333126743105,0.0,40.0
23227,2,3227,[300 742   9 100 282],274,5,12188,3.775712515489467,0.0,0.0
23228,2,3228,[ 64 357  12 301 269],416,5,12193,3.776091669247445,40.0,0.0
23229,2,3229,[238 181 183  89 204],405,3,12196,3.7758513931888547,0.0,20.0
23230,2,3230,[ 64 357  12 301 269],416,5,12201,3.776230269266481,40.0,0.0
23231,2,3231,[161 196  82 655 172],416,5,12206,3.776608910891089,0.0,0.0
23232,2,3232,[678 172 313 289 173],588,3,12209,3.7763686978038975,20.0,20.0
23233,2,3233,[  1 187  69 174 176],198,5,12214,3.7767470624613484,0.0,0.0
23234,2,3234,[185 153 144  89 483],854,4,12218,3.7768160741885626,20.0,0.0
23235,2,3235,[302 273  25 153 125],417,2,12220,3.776266996291718,0.0,0.0
23236,2,3236,[405  98 183 196  82],805,2,12222,3.7757182576459685,0.0,20.0
23237,2,3237,[257 300 211  11 603],416,4,12226,3.775787523162446,0.0,0.0
23238,2,3238,[268 234 144 515   7],416,5,12231,3.776165483173819,0.0,0.0
23239,2,3239,[ 64 403  82  25 210],416,5,12236,3.776543209876543,20.0,0.0
23240,2,3240,[ 64 357  12 301 269],416,5,12241,3.7769207034865784,40.0,0.0
23241,2,3241,[ 50   8 172 168 742],43,5,12246,3.7772979642196174,0.0,20.0
23242,2,3242,[ 64 357  12 301 269],416,5,12251,3.7776749922910886,40.0,0.0
23243,2,3243,[191  89 194 588 288],405,2,12253,3.7771270036991367,0.0,20.0
23244,2,3244,[ 50 211 302 191 423],297,3,12256,3.776887519260401,0.0,20.0
23245,2,3245,[ 64 357  12 301 269],416,5,12261,3.777264325323475,40.0,0.0
23246,2,3246,[294  28 423 258 301],297,3,12264,3.777024946104096,0.0,0.0
23247,2,3247,[172 228 216 135  89],805,3,12267,3.7767857142857144,0.0,0.0
23248,2,3248,[ 70   9 603 234 100],416,5,12272,3.7771622037550014,0.0,0.0
23249,2,3249,[168 475 257  98  95],417,4,12276,3.777230769230769,0.0,20.0
23250,2,3250,[ 64 357  12 301 269],416,5,12281,3.7776068901876347,40.0,0.0
23251,2,3251,[ 64 357  12 301 269],416,5,12286,3.777982779827798,40.0,0.0
23252,2,3252,[ 22  89 328 135 186],373,4,12290,3.778051029818629,0.0,0.0
23253,2,3253,[302 588 288  70  28],405,3,12293,3.777811923786109,0.0,20.0
23254,2,3254,[ 12   7  25 276 121],618,3,12296,3.777572964669739,20.0,0.0
23255,2,3255,[265 258 183 423 151],417,4,12300,3.7776412776412776,0.0,0.0
23256,2,3256,[ 22 357 176  95  69],416,4,12304,3.777709548664415,0.0,0.0
23257,2,3257,[172 181 132 182 258],62,5,12309,3.778084714548803,0.0,20.0
23258,2,3258,[546  15 333 200 289],416,3,12312,3.777845965019945,0.0,0.0
23259,2,3259,[ 64 357  12 301 269],416,5,12317,3.7782208588957054,40.0,0.0
23260,2,3260,[ 64 357  12 301 269],416,5,12322,3.7785955228457526,40.0,0.0
23261,2,3261,[215 508 742 174 197],297,2,12324,3.778050275904353,0.0,0.0
23262,2,3262,[ 70 191 275  22 357],373,5,12329,3.7784247624885077,0.0,0.0
23263,2,3263,[ 64 357  12 301 269],416,5,12334,3.778799019607843,40.0,0.0
23264,2,3264,[ 64 357  12 301 269],416,5,12339,3.7791730474732006,40.0,0.0
23265,2,3265,[ 64 357  12 301 269],416,5,12344,3.7795468462951622,40.0,0.0
23266,2,3266,[118 748 742 655  28],805,0,12344,3.778389960208142,0.0,0.0
23267,2,3267,[588 117 210 204 282],416,5,12349,3.778763769889841,0.0,0.0
23268,2,3268,[202 127 144 269 176],805,2,12351,3.7782196390333436,0.0,0.0
23269,2,3269,[174 185  82 269 294],805,2,12353,3.7776758409785933,0.0,0.0
23270,2,3270,[ 98 118 323 151 173],416,2,12355,3.777132375420361,0.0,20.0
23271,2,3271,[ 64 357  12 301 269],416,5,12360,3.7775061124694376,40.0,0.0
23272,2,3272,[ 64 357  12 301 269],416,5,12365,3.7778796211426826,40.0,0.0
23273,2,3273,[111 423 603 132 176],437,3,12368,3.7776420281001832,0.0,0.0
23274,2,3274,[135  70  56 183 194],405,2,12370,3.7770992366412215,0.0,0.0
23275,2,3275,[ 64 357  12 301 269],416,5,12375,3.7774725274725274,40.0,0.0
23276,2,3276,[333 268 191 748  98],345,3,12378,3.777235276167226,0.0,20.0
23277,2,3277,[328 257  50 185  88],416,3,12381,3.776998169615619,0.0,20.0
23278,2,3278,[ 70 121 423 302 200],416,5,12386,3.7773711497407745,0.0,0.0
23279,2,3279,[222 258  71 275 191],43,5,12391,3.7777439024390245,0.0,0.0
23280,2,3280,[  1 204 125 151  15],314,5,12396,3.7781164279183175,0.0,0.0
23281,2,3281,[ 64 357  12 301 269],416,5,12401,3.7784887263863496,40.0,0.0
23282,2,3282,[ 64 357  12 301 269],416,5,12406,3.7788607980505633,40.0,0.0
23283,2,3283,[385 202 427 357 183],416,5,12411,3.7792326431181484,0.0,0.0
23284,2,3284,[288 174  71 196 121],618,4,12415,3.7792998477929984,0.0,20.0
23285,2,3285,[ 64 357  12 301 269],416,5,12420,3.7796713329275717,40.0,0.0
23286,2,3286,[357  82 172 144 196],373,3,12423,3.779434134469121,0.0,0.0
23287,2,3287,[ 64 357  12 301 269],416,5,12428,3.7798053527980535,40.0,0.0
23288,2,3288,[210  89 286 135 211],373,3,12431,3.779568257829127,0.0,0.0
23289,2,3289,[403 423  28  88 294],416,4,12435,3.7796352583586628,0.0,0.0
23290,2,3290,[268 144 183 273 173],416,5,12440,3.780006077180188,0.0,0.0
23291,2,3291,[ 64 357  12 301 269],416,5,12445,3.7803766707168895,40.0,0.0
23292,2,3292,[ 64 357  12 301 269],416,5,12450,3.7807470391740057,40.0,0.0
23293,2,3293,[ 64 357  12 301 269],416,5,12455,3.781117182756527,40.0,0.0
23294,2,3294,[195 179 187  25 300],416,4,12459,3.7811836115326254,0.0,0.0
23295,2,3295,[127 196  56 172 215],721,4,12463,3.78125,0.0,0.0
23296,2,3296,[111 300  95 568 268],416,4,12467,3.781316348195329,0.0,0.0
23297,2,3297,[ 64 357  12 301 269],416,5,12472,3.7816858702243783,40.0,0.0
23298,2,3298,[144 118 202  12 403],588,1,12473,3.780842679599879,20.0,0.0
23299,2,3299,[276  88 588 385 333],416,3,12476,3.7806060606060607,0.0,0.0
23300,2,3300,[ 64 357  12 301 269],416,5,12481,3.780975461981218,40.0,0.0
23301,2,3301,[ 64 357  12 301 269],416,5,12486,3.7813446396123562,40.0,0.0
23302,2,3302,[172 496 185  11 276],230,5,12491,3.7817135937026944,0.0,0.0
23303,2,3303,[588 289 197   8 151],416,3,12494,3.7814769975786926,0.0,0.0
23304,2,3304,[195   9  96 357 288],630,3,12497,3.7812405446293496,0.0,20.0
23305,2,3305,[  9 603 265 269 100],416,5,12502,3.781609195402299,0.0,0.0
23306,2,3306,[ 64 655 237 181 301],345,5,12507,3.781977623223465,20.0,20.0
23307,2,3307,[748  22 215  56 268],297,3,12510,3.7817412333736398,0.0,0.0
23308,2,3308,[175 318 222 111 194],721,5,12515,3.782109398609852,20.0,0.0
23309,2,3309,[515 185 204 258 276],416,4,12519,3.782175226586103,0.0,0.0
23310,2,3310,[204 357  22   1 237],62,2,12521,3.7816369676834793,0.0,0.0
23311,2,3311,[ 64  12 301 357 269],416,5,12526,3.782004830917874,40.0,0.0
23312,2,3312,[748 483  95 168  70],437,3,12529,3.781768789616662,20.0,0.0
23313,2,3313,[ 64  12 301 357 269],416,5,12534,3.7821363910681955,40.0,0.0
23314,2,3314,[175 403 173 328 181],49,1,12535,3.7812971342383106,0.0,20.0
23315,2,3315,[211 423 196 288 568],416,5,12540,3.781664656212304,0.0,20.0
23316,2,3316,[268 275  25  82 294],128,3,12543,3.7814290021103405,0.0,0.0
23317,2,3317,[286 132 276 508 288],62,3,12546,3.7811934900542497,0.0,20.0
23318,2,3318,[ 64  12 301 357 269],416,5,12551,3.7815607110575473,40.0,0.0
23319,2,3319,[ 64  12 301 357 269],416,5,12556,3.7819277108433735,40.0,0.0
23320,2,3320,[ 64  12 301 357 269],416,5,12561,3.7822944896115627,40.0,0.0
23321,2,3321,[174 275 144  97 318],416,5,12566,3.7826610475617097,20.0,0.0
23322,2,3322,[ 64  12 301 357 269],416,5,12571,3.783027384893169,40.0,0.0
23323,2,3323,[ 64  12 301 357 269],416,5,12576,3.783393501805054,40.0,0.0
23324,2,3324,[ 50 168 328 238  82],373,4,12580,3.783458646616541,0.0,20.0
23325,2,3325,[ 89 655 357 168 318],62,4,12584,3.7835237522549607,20.0,0.0
23326,2,3326,[ 64  12 301 357 269],416,5,12589,3.7838893898406973,40.0,0.0
23327,2,3327,[127 588 258 196 357],416,5,12594,3.7842548076923075,0.0,0.0
23328,2,3328,[183 237 235 135   9],62,4,12598,3.7843196155001504,0.0,0.0
23329,2,3329,[181 475  71 180 196],198,2,12600,3.7837837837837838,0.0,20.0
23330,2,3330,[275 117 597 288 300],416,4,12604,3.78384869408586,0.0,20.0
23331,2,3331,[496 153 258 302 215],43,5,12609,3.7842136854741897,0.0,0.0
23332,2,3332,[257   8 173 172  71],654,4,12613,3.7842784278427843,0.0,0.0
23333,2,3333,[100 597 111 258 385],416,4,12617,3.7843431313737255,0.0,0.0
23334,2,3334,[300 294  88  71   8],43,5,12622,3.7847076461769116,0.0,0.0
23335,2,3335,[678 216 117 385 196],654,5,12627,3.7850719424460433,0.0,0.0
23336,2,3336,[127 179 172  15   1],417,4,12631,3.7851363500149837,0.0,0.0
23337,2,3337,[  4  69 196 357 748],198,2,12633,3.7846015578190535,0.0,0.0
23338,2,3338,[127  97  12 286  71],43,5,12638,3.7849655585504642,20.0,0.0
23339,2,3339,[ 64  12 301 357 269],416,5,12643,3.7853293413173654,40.0,0.0
23340,2,3340,[423 318   8 258  28],887,3,12646,3.7850942831487577,20.0,0.0
23341,2,3341,[268 197 258 228 265],297,2,12648,3.784560143626571,0.0,0.0
23342,2,3342,[185 258 117 179   7],49,3,12651,3.7843254561770863,0.0,0.0
23343,2,3343,[100   8 210 117 238],437,3,12654,3.784090909090909,0.0,0.0
23344,2,3344,[144 357 132   7 423],416,5,12659,3.7844544095665174,0.0,0.0
23345,2,3345,[ 64  12 301 357 269],416,5,12664,3.7848176927674837,40.0,0.0
23346,2,3346,[200  12 168 187 748],416,5,12669,3.785180758888557,20.0,0.0
23347,2,3347,[ 96 176   9 127  82],62,5,12674,3.7855436081242533,0.0,0.0
23348,2,3348,[  1 597 322 328 286],223,3,12677,3.7853090474768587,0.0,0.0
23349,2,3349,[ 70  56 222 471 301],721,3,12680,3.7850746268656716,0.0,0.0
23350,2,3350,[143  88  98 200 496],416,4,12684,3.785138764547896,0.0,20.0
23351,2,3351,[385 135  95 179  25],805,3,12687,3.784904534606205,0.0,0.0
23352,2,3352,[268 275  79 286 185],416,5,12692,3.785266925141664,0.0,0.0
23353,2,3353,[183   9 318 195 475],62,5,12697,3.785629099582588,20.0,0.0
23354,2,3354,[423  50  69   8 174],297,3,12700,3.7853949329359167,0.0,20.0
23355,2,3355,[ 64  12 301 357 269],416,5,12705,3.7857568533969013,40.0,0.0
23356,2,3356,[276 202 132   8 275],416,4,12709,3.785820673220137,0.0,0.0
23357,2,3357,[ 64  12 301 357 269],416,5,12714,3.7861822513400836,40.0,0.0
23358,2,3358,[257 191 121 172 313],711,3,12717,3.785948198868711,20.0,20.0
23359,2,3359,[ 64  12 301 357 269],416,5,12722,3.786309523809524,40.0,0.0
23360,2,3360,[ 64  12 301 357 269],416,5,12727,3.7866706337399583,40.0,0.0
23361,2,3361,[265 186  12 151 117],437,2,12729,3.786139202855443,20.0,0.0
23362,2,3362,[301 179 153   9 204],342,5,12734,3.786500148676777,0.0,0.0
23363,2,3363,[568 194  11 181  79],405,4,12738,3.786563614744352,0.0,20.0
23364,2,3364,[172 257 405 143 300],654,5,12743,3.786924219910847,0.0,0.0
23365,2,3365,[ 64  12 301 357 269],416,5,12748,3.7872846108140226,40.0,0.0
23366,2,3366,[111 143 271 182 546],297,1,12749,3.7864567864567866,0.0,0.0
23367,2,3367,[ 64  12 301 357 269],416,5,12754,3.7868171021377672,40.0,0.0
23368,2,3368,[ 64  12 301 357 269],416,5,12759,3.7871772039180764,40.0,0.0
23369,2,3369,[168  69  95 161 257],711,3,12762,3.7869436201780418,0.0,0.0
23370,2,3370,[100  79 204 403 603],373,3,12765,3.7867101750222485,0.0,0.0
23371,2,3371,[ 56 603 257   7 313],751,3,12768,3.786476868327402,20.0,20.0
23372,2,3372,[ 64  12 301 357 269],416,5,12773,3.786836643937148,40.0,0.0
23373,2,3373,[ 64  12 301 357 269],416,5,12778,3.787196206283343,40.0,0.0
23374,2,3374,[191 655 215 197 678],416,4,12782,3.787259259259259,0.0,0.0
23375,2,3375,[  1 111  64 234 191],345,4,12786,3.7873222748815167,20.0,0.0
23376,2,3376,[173 127  64 588 185],618,4,12790,3.7873852531832988,20.0,0.0
23377,2,3377,[ 97  11 237 172  96],198,3,12793,3.787152161042037,0.0,0.0
23378,2,3378,[210  88  97 168 471],128,4,12797,3.787215152411956,0.0,0.0
23379,2,3379,[269 294 300  11 245],297,2,12799,3.7866863905325445,0.0,0.0
23380,2,3380,[173 302 258 235 328],854,2,12801,3.7861579414374447,0.0,0.0
23381,2,3381,[  1   8 276 168 173],62,4,12805,3.78622117090479,0.0,0.0
23382,2,3382,[423  88 174 144 187],373,2,12807,3.785693171741058,0.0,0.0
23383,2,3383,[127 258 179 181 475],198,5,12812,3.786052009456265,0.0,20.0
23384,2,3384,[180 655 118 423 175],198,1,12813,3.7852289512555393,0.0,0.0
23385,2,3385,[423 286 100  50 748],373,2,12815,3.7847017129356173,0.0,20.0
23386,2,3386,[ 64  12 301 357 269],416,5,12820,3.785060525538825,40.0,0.0
23387,2,3387,[ 64  12 301 357 269],416,5,12825,3.7854191263282173,40.0,0.0
23388,2,3388,[318 181 135 268  98],354,2,12827,3.78489229861316,20.0,40.0
23389,2,3389,[ 64  12 301 357 269],416,5,12832,3.785250737463127,40.0,0.0
23390,2,3390,[ 50 655 258 269  28],721,3,12835,3.7850191683869063,0.0,20.0
23391,2,3391,[ 64  12 301 357 269],416,5,12840,3.785377358490566,40.0,0.0
23392,2,3392,[742 176   9  12  15],416,5,12845,3.7857353374594753,20.0,0.0
23393,2,3393,[323 294  28 475 111],416,3,12848,3.7855038302887447,0.0,0.0
23394,2,3394,[ 71 265  82 588 180],437,1,12849,3.784683357879234,0.0,0.0
23395,2,3395,[ 64  12 301 357 269],416,5,12854,3.7850412249705534,40.0,0.0
23396,2,3396,[ 64  12 301 357 269],416,5,12859,3.785398881365911,40.0,0.0
23397,2,3397,[216 385 222 100 179],805,3,12862,3.785167745732784,0.0,0.0
23398,2,3398,[174 210 179  22 181],262,2,12864,3.784642541924095,0.0,20.0
23399,2,3399,[ 64  12 301 357 269],416,5,12869,3.785,40.0,0.0
23400,2,3400,[427 100  79 135 185],214,4,12873,3.78506321670097,0.0,0.0
23401,2,3401,[ 64 127  69 183 135],198,5,12878,3.7854203409758966,20.0,0.0
23402,2,3402,[ 22 275 183 385 132],618,4,12882,3.7854833970026447,0.0,0.0
23403,2,3403,[  9 546   7 269 742],43,5,12887,3.785840188014101,0.0,0.0
23404,2,3404,[  7  22  25 655 144],314,3,12890,3.7856093979442,0.0,0.0
23405,2,3405,[ 98 182  25 153 196],417,4,12894,3.785672342924251,0.0,20.0
23406,2,3406,[237 257 168 258 151],642,3,12897,3.7854417375990606,0.0,0.0
23407,2,3407,[185 144 238  25 546],416,4,12901,3.785504694835681,0.0,0.0
23408,2,3408,[117 496 235 172 515],416,4,12905,3.7855676151364035,0.0,0.0
23409,2,3409,[748  69 202 300 151],297,0,12905,3.7844574780058653,0.0,0.0
23410,2,3410,[427 168 172  28 196],373,4,12909,3.7845206684256816,0.0,0.0
23411,2,3411,[222 135  11 269 216],297,5,12914,3.7848769050410316,0.0,0.0
23412,2,3412,[ 64  12 301 357 269],416,5,12919,3.785232932903604,40.0,0.0
23413,2,3413,[  8 117 288  97  25],618,2,12921,3.7847100175746924,0.0,20.0
23414,2,3414,[161 172 234  11 385],198,2,12923,3.784187408491947,0.0,0.0
23415,2,3415,[179 194   8 427 118],416,3,12926,3.7839578454332554,0.0,0.0
23416,2,3416,[185 197 322  98   9],416,4,12930,3.784021071115013,0.0,20.0
23417,2,3417,[ 50 385 204 318  28],416,5,12935,3.78437682855471,20.0,20.0
23418,2,3418,[ 64  12 301 357 269],416,5,12940,3.7847323778882713,40.0,0.0
23419,2,3419,[ 64  12 301 357 269],416,5,12945,3.7850877192982457,40.0,0.0
23420,2,3420,[ 64  12 301 357 269],416,5,12950,3.785442852966969,40.0,0.0
23421,2,3421,[172  64  89  82 186],373,4,12954,3.7855055523085914,20.0,0.0
23422,2,3422,[135 603 111 271  79],297,2,12956,3.784983932223196,0.0,0.0
23423,2,3423,[  8 357 427 597 153],642,2,12958,3.78446261682243,0.0,0.0
23424,2,3424,[ 12 111   8 204  71],49,1,12959,3.7836496350364963,20.0,0.0
23425,2,3425,[ 64  12 301 269 357],416,5,12964,3.7840046701692938,40.0,0.0
23426,2,3426,[245   1 294 235 258],297,1,12965,3.783192296469215,0.0,0.0
23427,2,3427,[191 427 175 588 187],405,3,12968,3.7829638273045507,0.0,0.0
23428,2,3428,[202 216 121  12 117],588,4,12972,3.783027121609799,20.0,0.0
23429,2,3429,[194 323  15 269 135],721,3,12975,3.782798833819242,0.0,0.0
23430,2,3430,[228 237 276   4 183],62,3,12978,3.7825706791023026,0.0,0.0
23431,2,3431,[174 318 475 748 180],198,3,12981,3.7823426573426575,20.0,0.0
23432,2,3432,[322 216 121 118 357],630,3,12984,3.782114768424119,0.0,0.0
23433,2,3433,[301 185 132 173  95],437,4,12988,3.782178217821782,0.0,0.0
23434,2,3434,[161 238 180  97  50],711,5,12993,3.782532751091703,0.0,20.0
23435,2,3435,[117 546 211 748 222],417,3,12996,3.7823050058207217,0.0,0.0
23436,2,3436,[ 64  12 301 269 357],416,5,13001,3.7826592958975853,40.0,0.0
23437,2,3437,[ 69 191 132 258 405],262,3,13004,3.7824316463059917,0.0,0.0
23438,2,3438,[276 185  98  56 172],230,4,13008,3.782494911311428,0.0,20.0
23439,2,3439,[405 423 496 265 222],128,4,13012,3.7825581395348835,0.0,0.0
23440,2,3440,[483  88  98 655 238],342,3,13015,3.7823307178145886,20.0,20.0
23441,2,3441,[ 15 238  97 268 210],654,2,13017,3.7818128994770484,0.0,0.0
23442,2,3442,[121 508 403 235 385],345,1,13018,3.7810049375544583,0.0,0.0
23443,2,3443,[ 22 180 588  97 238],711,5,13023,3.7813588850174216,0.0,0.0
23444,2,3444,[175 121 194 195 191],854,2,13025,3.7808417997097243,0.0,0.0
23445,2,3445,[186  25   8 204  70],43,4,13029,3.780905397562391,0.0,0.0
23446,2,3446,[238 216 405   7 288],854,4,13033,3.7809689585146504,0.0,20.0
23447,2,3447,[ 11 173 238 237 301],297,5,13038,3.781322505800464,0.0,0.0
23448,2,3448,[ 64  12 301 269 357],416,5,13043,3.781675848071905,40.0,0.0
23449,2,3449,[ 64  12 301 269 357],416,5,13048,3.7820289855072464,40.0,0.0
23450,2,3450,[294 180  96 273 275],854,3,13051,3.781802376122863,0.0,0.0
23451,2,3451,[286 322 197 127 111],854,2,13053,3.7812862108922363,0.0,0.0
23452,2,3452,[  7  96 144 194  56],96,4,13057,3.7813495511149724,0.0,0.0
23453,2,3453,[ 98 151 195 294 118],417,5,13062,3.781702374059062,0.0,20.0
23454,2,3454,[ 64  12 301 269 357],416,5,13067,3.78205499276411,40.0,0.0
23455,2,3455,[ 64  12 301 269 357],416,5,13072,3.7824074074074074,40.0,0.0
23456,2,3456,[ 69 588 294 228 174],505,2,13074,3.7818918137113102,0.0,0.0
23457,2,3457,[125  22 197 238   7],618,2,13076,3.7813765182186234,0.0,0.0
23458,2,3458,[ 64  12 301 269 357],416,5,13081,3.7817288233593525,40.0,0.0
23459,2,3459,[ 28 215 176 273   8],297,4,13085,3.781791907514451,0.0,0.0
23460,2,3460,[423  56 603 216 286],854,3,13088,3.7815660213811038,0.0,0.0
23461,2,3461,[268 238 403 597 245],416,3,13091,3.7813402657423456,0.0,0.0
23462,2,3462,[161 403 180 275 655],711,5,13096,3.7816921744152467,0.0,0.0
23463,2,3463,[302 435 211 423 301],297,3,13099,3.7814665127020786,0.0,0.0
23464,2,3464,[ 64  12 301 269 357],416,5,13104,3.7818181818181817,40.0,0.0
23465,2,3465,[483  56 202 603 173],128,3,13107,3.7815926139642237,20.0,0.0
23466,2,3466,[423 135  69   4 127],417,2,13109,3.7810787424286127,0.0,0.0
23467,2,3467,[ 64  12 301 269 357],416,5,13114,3.781430219146482,40.0,0.0
23468,2,3468,[222 176 678 195 172],805,4,13118,3.781493225713462,0.0,0.0
23469,2,3469,[ 64  12 301 269 357],416,5,13123,3.781844380403458,40.0,0.0
23470,2,3470,[181  50 655  88 144],373,4,13127,3.7819072313454334,0.0,40.0
23471,2,3471,[313  56 200 276 234],618,4,13131,3.7819700460829493,20.0,20.0
23472,2,3472,[269 546 172  28   1],805,3,13134,3.7817448891448318,0.0,0.0
23473,2,3473,[132 161 237   7 180],198,2,13136,3.781232009211284,0.0,0.0
23474,2,3474,[143  88 234  69 216],437,3,13139,3.781007194244604,0.0,0.0
23475,2,3475,[143 294 588  95 235],642,4,13143,3.7810701956271577,0.0,0.0
23476,2,3476,[271  28 173  88 301],43,4,13147,3.7811331607707794,0.0,0.0
23477,2,3477,[132 180 237 265 182],128,4,13151,3.781196089706728,0.0,0.0
23478,2,3478,[ 28 111 127  64  96],416,5,13156,3.7815464213854555,20.0,0.0
23479,2,3479,[237  82  70 313   4],618,3,13159,3.78132183908046,20.0,20.0
23480,2,3480,[186 483 196 191 385],417,5,13164,3.781671933352485,20.0,0.0
23481,2,3481,[301  28 313 161 748],345,2,13166,3.7811602527283172,20.0,20.0
23482,2,3482,[216 161 186 144  69],588,3,13169,3.780935974734424,0.0,0.0
23483,2,3483,[117  50 100 135  11],437,3,13172,3.780711825487945,0.0,20.0
23484,2,3484,[ 25 210 194 300 257],751,4,13176,3.78077474892396,0.0,0.0
23485,2,3485,[288 269 318  88  25],711,4,13180,3.780837636259323,20.0,20.0
23486,2,3486,[ 64  12 301 269 357],416,5,13185,3.7811872669916835,40.0,0.0
23487,2,3487,[403 678 100 183  88],805,4,13189,3.78125,0.0,0.0
23488,2,3488,[182 175 186 183  96],405,1,13190,3.7804528518200056,0.0,0.0
23489,2,3489,[546 195 405 245 173],417,3,13193,3.7802292263610315,0.0,0.0
23490,2,3490,[ 64  12 301 269 357],416,5,13198,3.7805786307648237,40.0,0.0
23491,2,3491,[ 64  12 301 269 357],416,5,13203,3.7809278350515463,40.0,0.0
23492,2,3492,[204   8 215  88 403],618,3,13206,3.7807042656742054,0.0,0.0
23493,2,3493,[186 210 222  88 173],354,1,13207,3.779908414424728,0.0,0.0
23494,2,3494,[ 64  12 301 269 357],416,5,13212,3.780257510729614,40.0,0.0
23495,2,3495,[118 515 655  97 471],416,4,13216,3.780320366132723,0.0,0.0
23496,2,3496,[276 111  95   8 405],416,3,13219,3.7800972261938806,0.0,0.0
23497,2,3497,[196 496  22  95 313],618,4,13223,3.7801600914808464,20.0,20.0
23498,2,3498,[748   7 216 143 603],805,2,13225,3.779651328951129,0.0,0.0
23499,2,3499,[176 144 182 204 273],297,2,13227,3.7791428571428574,0.0,0.0
23500,2,3500,[471 323 597 275  50],416,3,13230,3.7789203084832903,0.0,20.0
23501,2,3501,[ 50 143 216  97 175],354,3,13233,3.778697886921759,0.0,20.0
23502,2,3502,[655 742 211 546 100],417,2,13235,3.778190122751927,0.0,0.0
23503,2,3503,[ 89 471 111 655 427],705,2,13237,3.7776826484018264,0.0,0.0
23504,2,3504,[125 210 161 423 288],417,2,13239,3.777175463623395,0.0,20.0
23505,2,3505,[300 176 405 151 182],198,3,13242,3.7769537934968627,0.0,0.0
23506,2,3506,[144 197 210   1 168],751,3,13245,3.776732249786142,0.0,0.0
23507,2,3507,[196 275 187 182  22],618,4,13249,3.7767958950969214,0.0,0.0
23508,2,3508,[132 211 228  95 216],230,4,13253,3.7768595041322315,0.0,0.0
23509,2,3509,[ 64  12 301 269 357],416,5,13258,3.7772079772079774,40.0,0.0
23510,2,3510,[222 153 215 174 313],654,5,13263,3.7775562517801196,20.0,20.0
23511,2,3511,[135 423  22 435 748],373,3,13266,3.7773348519362187,0.0,0.0
23512,2,3512,[ 64  12 301 269 357],416,5,13271,3.7776828921150014,40.0,0.0
23513,2,3513,[216 194 302  79  95],751,5,13276,3.778030734206033,0.0,0.0
23514,2,3514,[  7  50  22 151 655],618,4,13280,3.7780938833570414,0.0,20.0
23515,2,3515,[168  50 100 237 405],198,2,13282,3.777588168373151,0.0,20.0
23516,2,3516,[ 28 301   7 100 427],416,5,13287,3.7779357406880862,0.0,0.0
23517,2,3517,[ 64  12 301 269 357],416,5,13292,3.778283115406481,40.0,0.0
23518,2,3518,[ 96  88 202 496 185],907,5,13297,3.7786302926967887,0.0,0.0
23519,2,3519,[403  69 546 186 200],417,3,13300,3.778409090909091,0.0,0.0
23520,2,3520,[197 357 235 275 127],854,4,13304,3.7784720249928996,0.0,0.0
23521,2,3521,[237 276 117 196 313],654,4,13308,3.778534923339012,20.0,20.0
23522,2,3522,[ 64  12 301 269 357],416,5,13313,3.7788816349701957,40.0,0.0
23523,2,3523,[ 64  12 301 269 357],416,5,13318,3.779228149829739,40.0,0.0
23524,2,3524,[ 12   7 597 313  11],416,4,13322,3.779290780141844,40.0,20.0
23525,2,3525,[ 64  12 301 269 357],416,5,13327,3.779636982416336,40.0,0.0
23526,2,3526,[ 64  12 301 269 357],416,5,13332,3.77998298837539,40.0,0.0
23527,2,3527,[ 64  12 301 269 357],416,5,13337,3.7803287981859413,40.0,0.0
23528,2,3528,[322 289 258 144 111],416,3,13340,3.7801076792292436,0.0,0.0
23529,2,3529,[ 64  12 301 269 357],416,5,13345,3.7804532577903682,40.0,0.0
23530,2,3530,[216 179 265 568 228],198,2,13347,3.779949022939677,0.0,0.0
23531,2,3531,[196 322 268  28 318],314,4,13351,3.7800113250283127,20.0,0.0
23532,2,3532,[185 202 483 268   1],417,4,13355,3.7800735918482875,20.0,0.0
23533,2,3533,[ 64  12 301 269 357],416,5,13360,3.7804187889077534,40.0,0.0
23534,2,3534,[210 568 403 180 216],805,1,13361,3.77963224893918,0.0,0.0
23535,2,3535,[ 64  12 301 269 357],416,5,13366,3.7799773755656108,40.0,0.0
23536,2,3536,[215 127  50 216  70],373,4,13370,3.780039581566299,0.0,20.0
23537,2,3537,[210 678  98   9 172],345,4,13374,3.780101752402487,0.0,20.0
23538,2,3538,[216 173 588 742 172],417,1,13375,3.7793161910144106,0.0,0.0
23539,2,3539,[ 64  12 301 269 357],416,5,13380,3.7796610169491527,40.0,0.0
23540,2,3540,[ 64  12 301 269 357],416,5,13385,3.7800056481219992,40.0,0.0
23541,2,3541,[ 64  12 301 269 357],416,5,13390,3.780350084697911,40.0,0.0
23542,2,3542,[276 258   4 288 300],654,3,13393,3.7801298334744566,0.0,20.0
23543,2,3543,[ 64  12 301 269 357],416,5,13398,3.780474040632054,40.0,0.0
23544,2,3544,[174 202 678 168 568],588,2,13400,3.779971791255289,0.0,0.0
23545,2,3545,[ 64  12 301 269 357],416,5,13405,3.7803158488437676,40.0,0.0
23546,2,3546,[191 181 423 215 202],43,5,13410,3.780659712433042,0.0,20.0
23547,2,3547,[588  56 496 289 176],416,4,13414,3.780721533258174,0.0,0.0
23548,2,3548,[ 64  12 301 269 357],416,5,13419,3.7810650887573964,40.0,0.0
23549,2,3549,[275 318  25 121  56],654,4,13423,3.7811267605633803,20.0,0.0
23550,2,3550,[ 64  12 301 269 357],416,5,13428,3.7814700084483244,40.0,0.0
23551,2,3551,[182 748 228 161 204],505,0,13428,3.7804054054054053,0.0,0.0
23552,2,3552,[ 64  12 301 269 357],416,5,13433,3.7807486631016043,40.0,0.0
23553,2,3553,[ 64  12 301 269 357],416,5,13438,3.7810917276308387,40.0,0.0
23554,2,3554,[258 742 546 515 100],417,2,13440,3.780590717299578,0.0,0.0
23555,2,3555,[ 12 183 271 202 173],297,3,13443,3.7803712035995503,20.0,0.0
23556,2,3556,[ 64  12 301 269 357],416,5,13448,3.7807140849030083,40.0,0.0
23557,2,3557,[ 22   7 289 496 237],588,1,13449,3.7799325463743676,0.0,0.0
23558,2,3558,[588 197 135 127 228],373,1,13450,3.779151447035684,0.0,0.0
23559,2,3559,[197 204  82 181 173],373,3,13453,3.778932584269663,0.0,20.0
23560,2,3560,[748 475 204  96 173],805,3,13456,3.778713844425723,0.0,0.0
23561,2,3561,[186  95 318 357 151],198,4,13460,3.7787759685569906,20.0,0.0
23562,2,3562,[ 64  12 301 269 357],416,5,13465,3.779118720179624,40.0,0.0
23563,2,3563,[ 95 195 168 276 200],416,3,13468,3.7789001122334454,0.0,0.0
23564,2,3564,[ 64  12 301 269 357],416,5,13473,3.779242636746143,40.0,0.0
23565,2,3565,[161 385 168 135 186],373,3,13476,3.779024116657319,0.0,0.0
23566,2,3566,[508  64 176 111  88],175,3,13479,3.7788057190916735,20.0,0.0
23567,2,3567,[ 64  12 301 269 357],416,5,13484,3.7791479820627805,40.0,0.0
23568,2,3568,[655 238 202  97 195],618,2,13486,3.7786494816475202,0.0,0.0
23569,2,3569,[144 176  89 191 568],62,3,13489,3.7784313725490195,0.0,0.0
23570,2,3570,[ 64  12 301 269 357],416,5,13494,3.7787734528143377,40.0,0.0
23571,2,3571,[546 210 475 235 176],417,2,13496,3.778275475923852,0.0,0.0
23572,2,3572,[ 64  12 301 269 357],416,5,13501,3.77861740834033,40.0,0.0
23573,2,3573,[ 70 568 742  96  95],417,2,13503,3.7781197537772804,0.0,0.0
23574,2,3574,[ 64  12 301 269 357],416,5,13508,3.7784615384615385,40.0,0.0
23575,2,3575,[135 678 258 215 302],297,3,13511,3.7782438478747205,0.0,0.0
23576,2,3576,[ 95   9 257  22 161],416,3,13514,3.7780262790047527,0.0,0.0
23577,2,3577,[215 515 288 176 211],297,3,13517,3.7778088317495806,0.0,20.0
23578,2,3578,[ 64  12 301 269 357],416,5,13522,3.778150321318804,40.0,0.0
23579,2,3579,[ 64  12 301 269 357],416,5,13527,3.778491620111732,40.0,0.0
23580,2,3580,[173 588 204 202 191],805,2,13529,3.7779949734710976,0.0,0.0
23581,2,3581,[ 64  12 301 269 357],416,5,13534,3.7783361250697935,40.0,0.0
23582,2,3582,[237 143  15 423 385],588,2,13536,3.7778397990510744,0.0,0.0
23583,2,3583,[ 64  12 301 269 357],416,5,13541,3.7781808035714284,40.0,0.0
23584,2,3584,[172 546 125 655 568],62,3,13544,3.777963737796374,0.0,0.0
23585,2,3585,[282 176 742 195  89],854,1,13545,3.7771890686001117,0.0,0.0
23586,2,3586,[ 64  12 301 269 357],416,5,13550,3.777529969333705,40.0,0.0
23587,2,3587,[ 71 182  64 323 385],416,4,13554,3.777591973244147,20.0,0.0
23588,2,3588,[257 121 276 597 385],416,2,13556,3.7770966843131792,0.0,0.0
23589,2,3589,[ 64  12 301 269 357],416,5,13561,3.7774373259052925,40.0,0.0
23590,2,3590,[ 22 475 191 423 273],416,4,13565,3.7774993038150932,0.0,0.0
23591,2,3591,[ 98  89 294 271  56],297,3,13568,3.77728285077951,0.0,20.0
23592,2,3592,[ 64  12 301 269 357],416,5,13573,3.777623156136933,40.0,0.0
23593,2,3593,[ 64 173  25 204  22],711,3,13576,3.777406789092933,20.0,0.0
23594,2,3594,[289 597 258 179 183],416,2,13578,3.776912378303199,0.0,0.0
23595,2,3595,[  8  79 127 403  96],405,4,13582,3.7769744160177976,0.0,0.0
23596,2,3596,[ 64  12 301 269 357],416,5,13587,3.7773144286905755,40.0,0.0
23597,2,3597,[288 273 294 742 174],805,0,13587,3.7762645914396886,0.0,20.0
23598,2,3598,[111 568 176   9 210],62,3,13590,3.776048902472909,0.0,0.0
23599,2,3599,[ 69  64 172  70 194],721,4,13594,3.776111111111111,20.0,0.0
23600,2,3600,[294 100 118 423  95],416,3,13597,3.7758955845598443,0.0,0.0
23601,2,3601,[ 64  12 301 269 357],416,5,13602,3.77623542476402,40.0,0.0
23602,2,3602,[222 135  71  98 508],601,3,13605,3.7760199833472106,0.0,20.0
23603,2,3603,[185 405  96 200 286],416,5,13610,3.7763596004439512,0.0,0.0
23604,2,3604,[ 12 111 204 197 471],345,4,13614,3.776421636615811,20.0,0.0
23605,2,3605,[655 588  95 191  71],618,4,13618,3.776483638380477,0.0,0.0
23606,2,3606,[191 216 318 238 405],854,4,13622,3.776545605766565,20.0,0.0
23607,2,3607,[ 64  12 301 269 357],416,5,13627,3.7768847006651884,40.0,0.0
23608,2,3608,[678 161 151  12 385],805,3,13630,3.776669437517318,20.0,0.0
23609,2,3609,[234  71  11 181 111],345,4,13634,3.776731301939058,0.0,20.0
23610,2,3610,[174  97   7 191 294],43,5,13639,3.7770700636942673,0.0,0.0
23611,2,3611,[258 496 288 427 195],601,3,13642,3.776854928017719,0.0,20.0
23612,2,3612,[ 64  12 301 269 357],416,5,13647,3.7771934680321064,40.0,0.0
23613,2,3613,[ 64  12 301 269 357],416,5,13652,3.7775318206972885,40.0,0.0
23614,2,3614,[258  82 175 748 294],721,2,13654,3.777040110650069,0.0,0.0
23615,2,3615,[ 64  12 301 269 357],416,5,13659,3.777378318584071,40.0,0.0
23616,2,3616,[187 181 313  25 183],618,4,13663,3.777439867293337,20.0,40.0
23617,2,3617,[185 197 515  97 496],354,1,13664,3.7766721945826425,0.0,0.0
23618,2,3618,[234 117 216 268  79],416,5,13669,3.7770102238187344,0.0,0.0
23619,2,3619,[ 64  12 301 269 357],416,5,13674,3.7773480662983427,40.0,0.0
23620,2,3620,[286 294  98 191 273],854,3,13677,3.7771333885666944,0.0,20.0
23621,2,3621,[ 11 144 202 127 121],417,3,13680,3.776918829376035,0.0,0.0
23622,2,3622,[258 301 423 216 181],43,5,13685,3.7772564173337013,0.0,20.0
23623,2,3623,[ 64  12 301 269 357],416,5,13690,3.7775938189845473,40.0,0.0
23624,2,3624,[117 175  71 186  69],198,2,13692,3.777103448275862,0.0,0.0
23625,2,3625,[286   7 258  11  96],416,5,13697,3.7774407060121344,0.0,0.0
23626,2,3626,[742 603 471 427 655],128,3,13700,3.7772263578715193,0.0,0.0
23627,2,3627,[313  88 100 135 151],354,1,13701,3.7764608599779494,20.0,20.0
23628,2,3628,[197 475  79 100   1],416,4,13705,3.7765224579774044,0.0,0.0
23629,2,3629,[ 56 300 742  96 546],416,4,13709,3.7765840220385676,0.0,0.0
23630,2,3630,[132 237  95 172 215],588,4,13713,3.7766455521894793,0.0,0.0
23631,2,3631,[ 64  12 301 269 357],416,5,13718,3.7769823788546257,40.0,0.0
23632,2,3632,[ 64  12 301 269 357],416,5,13723,3.7773190200935867,40.0,0.0
23633,2,3633,[ 64  12 301 269 357],416,5,13728,3.7776554760594387,40.0,0.0
23634,2,3634,[ 64  12 301 269 357],416,5,13733,3.7779917469050894,40.0,0.0
23635,2,3635,[168  25 181  69  82],128,4,13737,3.7780528052805282,0.0,20.0
23636,2,3636,[ 11  12 100 294 748],297,3,13740,3.7778388781963157,20.0,0.0
23637,2,3637,[ 64  12 301 269 357],416,5,13745,3.7781748213304014,40.0,0.0
23638,2,3638,[127 328 211 204 179],416,4,13749,3.7782357790601813,0.0,0.0
23639,2,3639,[237 216 655 257 172],751,3,13752,3.778021978021978,0.0,0.0
23640,2,3640,[385 271  82  95 597],805,0,13752,3.7769843449601757,0.0,0.0
23641,2,3641,[ 64  12 301 269 357],416,5,13757,3.7773201537616696,40.0,0.0
23642,2,3642,[161 151 357  96   7],417,2,13759,3.776832281087016,0.0,0.0
23643,2,3643,[ 64  12 301 269 357],416,5,13764,3.7771679473106476,40.0,0.0
23644,2,3644,[ 56  98 127 135 144],417,3,13767,3.776954732510288,0.0,20.0
23645,2,3645,[245 197 269 216 185],416,4,13771,3.7770159078442127,0.0,0.0
23646,2,3646,[ 70  56 100   7 597],62,3,13774,3.7768028516588976,0.0,0.0
23647,2,3647,[323 215 183 286 191],416,4,13778,3.776864035087719,0.0,0.0
23648,2,3648,[172 179  50 475 357],805,5,13783,3.777199232666484,0.0,20.0
23649,2,3649,[161 175 172 181  89],373,4,13787,3.777260273972603,0.0,20.0
23650,2,3650,[265 257 333 423 597],416,3,13790,3.77704738427828,0.0,0.0
23651,2,3651,[127 175 597 238 546],43,2,13792,3.7765607886089816,0.0,0.0
23652,2,3652,[ 64  12 301 269 357],416,5,13797,3.776895702162606,40.0,0.0
23653,2,3653,[161 276 216  50 275],43,5,13802,3.7772304324028463,0.0,20.0
23654,2,3654,[ 64  12 301 269 357],416,5,13807,3.777564979480164,40.0,0.0
23655,2,3655,[405   7 286  25  50],854,3,13810,3.777352297592998,0.0,20.0
23656,2,3656,[175 597 117  12 197],854,3,13813,3.7771397320207822,20.0,0.0
23657,2,3657,[ 64  12 301 269 357],416,5,13818,3.7774740295243303,40.0,0.0
23658,2,3658,[273 183 144 238 742],805,2,13820,3.7769882481552335,0.0,0.0
23659,2,3659,[175 323 195 191 405],198,1,13821,3.7762295081967214,0.0,0.0
23660,2,3660,[ 64  12 301 269 357],416,5,13826,3.776563780387872,40.0,0.0
23661,2,3661,[ 64  12 301 269 357],416,5,13831,3.7768978700163847,40.0,0.0
23662,2,3662,[175 234 117 265 197],198,1,13832,3.776139776139776,0.0,0.0
23663,2,3663,[ 64  12 301 269 357],416,5,13837,3.7764737991266375,40.0,0.0
23664,2,3664,[173  97 185 288 328],416,5,13842,3.776807639836289,0.0,20.0
23665,2,3665,[ 64  12 301 269 357],416,5,13847,3.7771412984178943,40.0,0.0
23666,2,3666,[117 475 245 151  79],416,2,13849,3.7766566675756748,0.0,0.0
23667,2,3667,[176 286 475 173  95],437,2,13851,3.7761723009814614,0.0,0.0
23668,2,3668,[427 323 200 215  25],198,3,13854,3.775960752248569,0.0,0.0
23669,2,3669,[ 64  12 301 269 357],416,5,13859,3.7762942779291553,40.0,0.0
23670,2,3670,[187 202 496 172  70],618,3,13862,3.7760828112231,0.0,0.0
23671,2,3671,[ 12  25 238 257  11],297,4,13866,3.776143790849673,20.0,0.0
23672,2,3672,[176 121 238 742 125],417,3,13869,3.7759324802613667,0.0,0.0
23673,2,3673,[191  79 174 216 289],345,4,13873,3.7759934676102342,0.0,0.0
23674,2,3674,[204 144 132 288 483],342,5,13878,3.776326530612245,20.0,20.0
23675,2,3675,[ 64  12 301 269 357],416,5,13883,3.7766594124047876,40.0,0.0
23676,2,3676,[182 228 179 265  82],417,3,13886,3.7764481914604295,0.0,0.0
23677,2,3677,[282 117 132 222 191],854,3,13889,3.776237085372485,0.0,0.0
23678,2,3678,[301 475 111 211 118],416,3,13892,3.7760260940472956,0.0,0.0
23679,2,3679,[ 64  12 301 269 357],416,5,13897,3.7763586956521737,40.0,0.0
23680,2,3680,[ 64  12 301 269 357],416,5,13902,3.7766911165444172,40.0,0.0
23681,2,3681,[257 204 127  98 515],416,4,13906,3.776751765344921,0.0,20.0
23682,2,3682,[597 153 127 182 132],417,4,13910,3.7768123812109695,0.0,0.0
23683,2,3683,[ 89 191 173 118 286],297,3,13913,3.776601520086862,0.0,0.0
23684,2,3684,[ 64  12 301 269 357],416,5,13918,3.776933514246947,40.0,0.0
23685,2,3685,[172 117   9  11  50],630,2,13920,3.776451437873033,0.0,20.0
23686,2,3686,[117  98 475 245 238],417,5,13925,3.776783292649851,0.0,20.0
23687,2,3687,[276  71 100 546 125],630,0,13925,3.775759219088937,0.0,0.0
23688,2,3688,[496 204  50  70 301],437,3,13928,3.775548929249119,0.0,20.0
23689,2,3689,[172  15 181 168 153],417,3,13931,3.7753387533875338,0.0,20.0
23690,2,3690,[168 245 301  56 742],297,3,13934,3.7751286914115414,0.0,0.0
23691,2,3691,[ 64  12 269 301 357],416,5,13939,3.7754604550379196,40.0,0.0
23692,2,3692,[655 144 423 258 748],416,5,13944,3.7757920389926887,0.0,0.0
23693,2,3693,[ 64  12 269 301 357],416,5,13949,3.776123443421765,40.0,0.0
23694,2,3694,[  7  69 282  15  25],588,3,13952,3.775913396481732,0.0,0.0
23695,2,3695,[204  50  22 269 216],262,1,13953,3.7751623376623376,0.0,20.0
23696,2,3696,[ 64  12 301 269 357],416,5,13958,3.7754936434947255,40.0,0.0
23697,2,3697,[125 678 273 210 597],416,3,13961,3.7752839372633855,0.0,0.0
23698,2,3698,[ 64  12 301 269 357],416,5,13966,3.7756150310894836,40.0,0.0
23699,2,3699,[ 64  12 301 269 357],416,5,13971,3.775945945945946,40.0,0.0
23700,2,3700,[143 678  82 216 597],805,1,13972,3.775195893001891,0.0,0.0
23701,2,3701,[427 568 195 237  11],198,2,13974,3.7747163695299837,0.0,0.0
23702,2,3702,[118  22 173 100   7],416,4,13978,3.774777207669457,0.0,0.0
23703,2,3703,[235 127  22 405  79],416,4,13982,3.774838012958963,0.0,0.0
23704,2,3704,[197 515  70 258 268],416,5,13987,3.7751686909581648,0.0,0.0
23705,2,3705,[ 64  12 301 269 357],416,5,13992,3.775499190501889,40.0,0.0
23706,2,3706,[173 118 135  89 200],805,4,13996,3.775559751820879,0.0,0.0
23707,2,3707,[ 98 121 175   8 275],854,4,14000,3.7756202804746493,0.0,20.0
23708,2,3708,[385   7 568 185 196],230,2,14002,3.7751415475869505,0.0,0.0
23709,2,3709,[174  50  70 405 200],345,5,14007,3.7754716981132077,0.0,20.0
23710,2,3710,[ 64  12 301 269 357],416,5,14012,3.7758016707087037,40.0,0.0
23711,2,3711,[ 64  12 301 269 357],416,5,14017,3.7761314655172415,40.0,0.0
23712,2,3712,[200 176 273 197 144],854,3,14020,3.7759224346889306,0.0,0.0
23713,2,3713,[153 546 258  70  98],297,4,14024,3.7759827679052234,0.0,20.0
23714,2,3714,[423 276  64 268  88],416,3,14027,3.7757738896366084,20.0,0.0
23715,2,3715,[ 64  12 301 269 357],416,5,14032,3.776103336921421,40.0,0.0
23716,2,3716,[ 64  12 301 269 357],416,5,14037,3.7764326069410816,40.0,0.0
23717,2,3717,[238 423 118 265 175],198,1,14038,3.7756858526089294,0.0,0.0
23718,2,3718,[328 127 216  97 175],721,5,14043,3.7760150578112395,0.0,0.0
23719,2,3719,[  1 196 257 588 748],417,3,14046,3.7758064516129033,0.0,0.0
23720,2,3720,[588 175 143 235 161],922,2,14048,3.7753292125772644,0.0,0.0
23721,2,3721,[210  64 181 294 238],62,4,14052,3.775389575497045,20.0,20.0
23722,2,3722,[  1  88 168 588   8],618,4,14056,3.775449905989793,0.0,0.0
23723,2,3723,[ 79 496 127   7 144],505,1,14057,3.774704618689581,0.0,0.0
23724,2,3724,[ 64  12 301 269 357],416,5,14062,3.7750335570469797,40.0,0.0
23725,2,3725,[ 64  12 301 269 357],416,5,14067,3.7753623188405796,40.0,0.0
23726,2,3726,[ 64  12 301 269 357],416,5,14072,3.7756909042125035,40.0,0.0
23727,2,3727,[568  96 195 100  69],262,2,14074,3.7752145922746783,0.0,0.0
23728,2,3728,[ 64  12 301 269 357],416,5,14079,3.7755430410297666,40.0,0.0
23729,2,3729,[111  70 588 187 294],416,5,14084,3.7758713136729223,0.0,0.0
23730,2,3730,[197 322 357  96 127],854,3,14087,3.7756633610292147,0.0,0.0
23731,2,3731,[ 96 294 195 176 132],230,3,14090,3.77545551982851,0.0,0.0
23732,2,3732,[748 191 228  97 235],417,3,14093,3.775247789981248,0.0,0.0
23733,2,3733,[238 405 294  15 318],43,4,14097,3.775307980717729,20.0,0.0
23734,2,3734,[222 174 175   4 258],43,4,14101,3.775368139223561,0.0,0.0
23735,2,3735,[ 64  12 301 269 357],416,5,14106,3.7756959314775163,40.0,0.0
23736,2,3736,[471   8 186  98 318],588,4,14110,3.7757559539737757,20.0,20.0
23737,2,3737,[ 96 546 405 234 174],417,1,14111,3.7750133761369717,0.0,0.0
23738,2,3738,[282 161 403  25 172],416,5,14116,3.775341000267451,0.0,0.0
23739,2,3739,[385 181 168  79 216],751,5,14121,3.775668449197861,0.0,20.0
23740,2,3740,[ 64  12 301 269 357],416,5,14126,3.7759957230686982,40.0,0.0
23741,2,3741,[ 50  28 174 405  22],642,4,14130,3.77605558524853,0.0,20.0
23742,2,3742,[181 313 282 234 423],618,4,14134,3.776115415442159,20.0,40.0
23743,2,3743,[  1 328 282 151 385],416,4,14138,3.776175213675214,0.0,0.0
23744,2,3744,[ 64  12 301 269 357],416,5,14143,3.776502002670227,40.0,0.0
23745,2,3745,[ 64  12 301 269 357],416,5,14148,3.776828617191671,40.0,0.0
23746,2,3746,[ 64  12 301 269 357],416,5,14153,3.7771550573792365,40.0,0.0
23747,2,3747,[328 187 286 144 568],373,2,14155,3.7766808964781218,0.0,0.0
23748,2,3748,[435 427 238 127 135],405,4,14159,3.7767404641237663,0.0,0.0
23749,2,3749,[ 12 300 204 508  96],49,1,14160,3.776,20.0,0.0
23750,2,3750,[ 64  12 301 269 357],416,5,14165,3.7763263129832043,40.0,0.0
23751,2,3751,[100 111  50  88 237],907,5,14170,3.776652452025586,0.0,20.0
23752,2,3752,[ 25   8  95 271  88],43,4,14174,3.7767119637623234,0.0,0.0
23753,2,3753,[200 302  96 121 237],854,1,14175,3.7759722962173683,0.0,0.0
23754,2,3754,[127 179  11  95 168],805,2,14177,3.775499334221039,0.0,0.0
23755,2,3755,[  1 143 300 174 471],43,4,14181,3.77555910543131,0.0,0.0
23756,2,3756,[ 22 202 186 588 568],230,4,14185,3.775618844822997,0.0,0.0
23757,2,3757,[210 275   1 496  64],262,3,14188,3.775412453432677,20.0,0.0
23758,2,3758,[132  98 173   7 179],416,4,14192,3.7754722000532057,0.0,20.0
23759,2,3759,[ 64  12 301 269 357],416,5,14197,3.7757978723404255,40.0,0.0
23760,2,3760,[ 64  12 301 269 357],416,5,14202,3.7761233714437648,40.0,0.0
23761,2,3761,[245 357 132 515 234],416,4,14206,3.776182881446039,0.0,0.0
23762,2,3762,[ 71 471  22 202 405],416,5,14211,3.7765081052351848,0.0,0.0
23763,2,3763,[197 204 186  98 288],437,3,14214,3.7763018065887355,0.0,40.0
23764,2,3764,[ 64  12 301 357 269],416,5,14219,3.7766268260292164,40.0,0.0
23765,2,3765,[117 216 271 121 322],854,1,14220,3.7758895379713224,0.0,0.0
23766,2,3766,[ 95 172 173  56 197],198,4,14224,3.775949031059198,0.0,0.0
23767,2,3767,[181  88 286 195  11],437,1,14225,3.775212314225053,0.0,20.0
23768,2,3768,[191 202 117 234 385],416,5,14230,3.775537277792518,0.0,0.0
23769,2,3769,[174 238  25 200 196],618,3,14233,3.7753315649867374,0.0,0.0
23770,2,3770,[ 15 191 168 215 301],43,5,14238,3.775656324582339,0.0,0.0
23771,2,3771,[202 168 313 191 172],405,4,14242,3.7757158006362674,20.0,20.0
23772,2,3772,[ 64  12 301 357 269],416,5,14247,3.776040286244368,40.0,0.0
23773,2,3773,[ 71 405  69  98 748],416,5,14252,3.776364599894012,0.0,20.0
23774,2,3774,[179 172 100 111  56],751,4,14256,3.7764238410596027,0.0,0.0
23775,2,3775,[322 210 313 100   7],416,4,14260,3.7764830508474576,20.0,20.0
23776,2,3776,[258 275 289 301 302],43,5,14265,3.776806989674345,0.0,0.0
23777,2,3777,[ 64   8 294 328 318],314,5,14270,3.777130757014293,40.0,0.0
23778,2,3778,[ 64  12 301 357 269],416,5,14275,3.77745435300344,40.0,0.0
23779,2,3779,[273   9 168 111 118],62,3,14278,3.7772486772486773,0.0,0.0
23780,2,3780,[ 64  12 301 357 269],416,5,14283,3.7775720708807192,40.0,0.0
23781,2,3781,[  4 427 215 286 235],416,4,14287,3.7776308831306187,0.0,0.0
23782,2,3782,[185 318 483 151 245],907,5,14292,3.7779540047581284,40.0,0.0
23783,2,3783,[ 64  12 301 357 269],416,5,14297,3.778276955602537,40.0,0.0
23784,2,3784,[568 323 175 403  15],43,3,14300,3.7780713342140024,0.0,0.0
23785,2,3785,[ 28 121 271 471 423],43,3,14303,3.777865821447438,0.0,0.0
23786,2,3786,[ 64  12 301 357 269],416,5,14308,3.77818853974122,40.0,0.0
23787,2,3787,[ 64  12 301 357 269],416,5,14313,3.7785110876451955,40.0,0.0
23788,2,3788,[ 64  12 301 357 269],416,5,14318,3.778833465294273,40.0,0.0
23789,2,3789,[ 64  12 301 357 269],416,5,14323,3.779155672823219,40.0,0.0
23790,2,3790,[ 22 216 144 222 200],854,2,14325,3.7786863624373517,0.0,0.0
23791,2,3791,[191 197 258 405  22],854,4,14329,3.7787447257383966,0.0,0.0
23792,2,3792,[ 50 222 427   4  12],253,5,14334,3.7790667018191404,20.0,20.0
23793,2,3793,[234 385 127 357 153],416,5,14339,3.779388508170796,0.0,0.0
23794,2,3794,[111 172 202  97 161],618,3,14342,3.7791831357048746,0.0,0.0
23795,2,3795,[423 182 181 603 143],416,5,14347,3.779504741833509,0.0,20.0
23796,2,3796,[185 357 211  56 265],416,5,14352,3.779826178562023,0.0,0.0
23797,2,3797,[ 70 144 151 121  12],437,2,14354,3.7793575566087414,20.0,0.0
23798,2,3798,[313 301 273 182 515],416,5,14359,3.779678862858647,20.0,20.0
23799,2,3799,[228 258 127 508 179],601,5,14364,3.78,0.0,0.0
23800,2,3800,[ 64  12 301 357 269],416,5,14369,3.780320968166272,40.0,0.0
23801,2,3801,[ 64  12 301 357 269],416,5,14374,3.780641767490794,40.0,0.0
23802,2,3802,[ 98 172 568  79 302],751,4,14378,3.780699447804365,0.0,20.0
23803,2,3803,[ 64  12 301 357 269],416,5,14383,3.7810199789695056,40.0,0.0
23804,2,3804,[ 97 265 196  70   4],198,0,14383,3.7800262812089356,0.0,0.0
23805,2,3805,[748 161 168 742 234],417,3,14386,3.7798213347346294,0.0,0.0
23806,2,3806,[ 64  12 301 357 269],416,5,14391,3.780141843971631,40.0,0.0
23807,2,3807,[471 172  98 216  50],618,3,14394,3.779936974789916,0.0,40.0
23808,2,3808,[ 64  12 301 357 269],416,5,14399,3.7802572853767393,40.0,0.0
23809,2,3809,[ 95 265 508 204 237],654,4,14403,3.780314960629921,0.0,0.0
23810,2,3810,[204 183 172 174 655],405,4,14407,3.780372605615324,0.0,0.0
23811,2,3811,[ 98 265 183  79  97],505,3,14410,3.780167890870934,0.0,20.0
23812,2,3812,[ 64  12 301 357 269],416,5,14415,3.7804878048780486,40.0,0.0
23813,2,3813,[ 64  12 301 357 269],416,5,14420,3.7808075511274253,40.0,0.0
23814,2,3814,[175 179  89 127  98],214,5,14425,3.781127129750983,0.0,20.0
23815,2,3815,[427 117 257 173 265],416,4,14429,3.7811844863731654,0.0,0.0
23816,2,3816,[185 405 245 204 288],416,4,14433,3.7812418129421013,0.0,20.0
23817,2,3817,[ 64  12 301 357 269],416,5,14438,3.7815610267155577,40.0,0.0
23818,2,3818,[508 228  96 475 496],417,1,14439,3.780832678711705,0.0,0.0
23819,2,3819,[215 173 357 228  71],198,3,14442,3.7806282722513087,0.0,0.0
23820,2,3820,[333  11 318 204 172],496,3,14445,3.7804239727819944,20.0,0.0
23821,2,3821,[174 215 268 471 168],297,3,14448,3.78021978021978,0.0,0.0
23822,2,3822,[186 172  28 483 144],437,2,14450,3.7797541198012032,20.0,0.0
23823,2,3823,[ 28 282 132  79 269],345,3,14453,3.779550209205021,0.0,0.0
23824,2,3824,[257 181  12 194 127],416,4,14457,3.779607843137255,20.0,20.0
23825,2,3825,[204 588 237  50 118],43,5,14462,3.7799268165185573,0.0,20.0
23826,2,3826,[269 151  79 175 423],354,3,14465,3.779723020642801,0.0,0.0
23827,2,3827,[ 64  12 301 357 269],416,5,14470,3.7800417972831766,40.0,0.0
23828,2,3828,[742   7  12 183   8],297,4,14474,3.7800992426220947,20.0,0.0
23829,2,3829,[313 173 301  50 318],711,4,14478,3.7801566579634467,40.0,40.0
23830,2,3830,[ 69 405 215  64  50],198,4,14482,3.780214043330723,20.0,20.0
23831,2,3831,[ 96 234  64   8 153],642,3,14485,3.780010438413361,20.0,0.0
23832,2,3832,[ 64  12 301 357 269],416,5,14490,3.7803287242368904,40.0,0.0
23833,2,3833,[ 96 328  70 161 288],416,5,14495,3.780646844027126,0.0,20.0
23834,2,3834,[ 64  12 301 357 269],416,5,14500,3.7809647979139505,40.0,0.0
23835,2,3835,[204 196  70 302 200],416,5,14505,3.7812825860271118,0.0,0.0
23836,2,3836,[ 71 197 161 323 357],416,4,14509,3.7813395882199634,0.0,0.0
23837,2,3837,[144 546 302  82 161],43,5,14514,3.781657113079729,0.0,0.0
23838,2,3838,[ 64  12 301 357 269],416,5,14519,3.7819744725188853,40.0,0.0
23839,2,3839,[288 294 151 111 132],921,2,14521,3.781510416666667,0.0,20.0
23840,2,3840,[ 15  96  71   7 318],618,3,14524,3.781306951314762,20.0,0.0
23841,2,3841,[742 204 748 357 427],416,5,14529,3.7816241540864133,0.0,0.0
23842,2,3842,[181 276 323 185 194],416,3,14532,3.7814207650273226,0.0,20.0
23843,2,3843,[ 64  12 301 357 269],416,5,14537,3.7817377731529658,40.0,0.0
23844,2,3844,[179  50 180  96 176],805,4,14541,3.7817945383615084,0.0,20.0
23845,2,3845,[  7  25  12 235 603],805,4,14545,3.781851274050962,20.0,0.0
23846,2,3846,[ 64  12 301 357 269],416,5,14550,3.7821679230569276,40.0,0.0
23847,2,3847,[195   9 568 300 100],416,5,14555,3.7824844074844073,0.0,0.0
23848,2,3848,[245 182 423  70 748],417,5,14560,3.7828007274616784,0.0,0.0
23849,2,3849,[603 100 276 655 179],437,5,14565,3.7831168831168833,0.0,0.0
23850,2,3850,[  8 183 127 210 202],805,1,14566,3.7823941833290053,0.0,0.0
23851,2,3851,[ 70 357  28 423 135],230,4,14570,3.7824506749740396,0.0,0.0
23852,2,3852,[195 183 318 423 257],705,2,14572,3.7819880612509733,20.0,0.0
23853,2,3853,[215 168 282  98 597],416,4,14576,3.782044628956928,0.0,20.0
23854,2,3854,[ 64  12 301 357 269],416,5,14581,3.782360570687419,40.0,0.0
23855,2,3855,[ 64  12 301 357 269],416,5,14586,3.7826763485477177,40.0,0.0
23856,2,3856,[ 64  12 301 357 269],416,5,14591,3.782991962665284,40.0,0.0
23857,2,3857,[302 385 245  11 111],417,3,14594,3.782789009849663,0.0,0.0
23858,2,3858,[ 64  12 301 357 269],416,5,14599,3.7831044311997926,40.0,0.0
23859,2,3859,[655  22 273 202 197],416,5,14604,3.783419689119171,0.0,0.0
23860,2,3860,[215 180 222 117  89],62,4,14608,3.7834757834757835,0.0,0.0
23861,2,3861,[117  56 405 172 168],805,3,14611,3.7832729155877782,0.0,0.0
23862,2,3862,[ 64  12 301 357 269],416,5,14616,3.7835878850634224,40.0,0.0
23863,2,3863,[111 234 153 748   7],416,5,14621,3.783902691511387,0.0,0.0
23864,2,3864,[ 64  12 301 357 269],416,5,14626,3.784217335058215,40.0,0.0
23865,2,3865,[196 118 144   9 257],416,3,14629,3.7840144852560784,0.0,0.0
23866,2,3866,[210 294  69 172 515],416,5,14634,3.7843289371605895,0.0,0.0
23867,2,3867,[195 174  79  96   7],618,3,14637,3.784126163391934,0.0,0.0
23868,2,3868,[ 64  12 301 357 269],416,5,14642,3.78444042388214,40.0,0.0
23869,2,3869,[588 405 117  25 273],417,1,14643,3.7837209302325583,0.0,0.0
23870,2,3870,[174 286 742 471 238],854,1,14644,3.783001808318264,0.0,0.0
23871,2,3871,[357 215 172 173  28],373,4,14648,3.7830578512396693,0.0,0.0
23872,2,3872,[  4 286 161  96 174],373,4,14652,3.783113865220759,0.0,0.0
23873,2,3873,[ 64  12 301 357 269],416,5,14657,3.7834279814145586,40.0,0.0
23874,2,3874,[183  98   4  12 180],417,4,14661,3.783483870967742,20.0,20.0
23875,2,3875,[471 174 294  28 423],588,3,14664,3.78328173374613,0.0,0.0
23876,2,3876,[ 64  12 301 357 269],416,5,14669,3.7835955635800875,40.0,0.0
23877,2,3877,[ 64  12 301 357 269],416,5,14674,3.783909231562661,40.0,0.0
23878,2,3878,[ 64  12 301 357 269],416,5,14679,3.7842227378190256,40.0,0.0
23879,2,3879,[568 196 210 216 195],230,3,14682,3.784020618556701,0.0,0.0
23880,2,3880,[271 179 183 423 202],805,2,14684,3.7835609379026023,0.0,0.0
23881,2,3881,[ 64  12 301 357 269],416,5,14689,3.7838742916022667,40.0,0.0
23882,2,3882,[588 117 405  11 195],230,4,14693,3.783929951068761,0.0,0.0
23883,2,3883,[173 282  98   1 176],416,5,14698,3.7842430484037077,0.0,20.0
23884,2,3884,[ 64  12 301 357 269],416,5,14703,3.7845559845559844,40.0,0.0
23885,2,3885,[294  71 168  25 471],887,3,14706,3.784354091610911,0.0,0.0
23886,2,3886,[  4 172 568  56  50],654,5,14711,3.784666838178544,0.0,20.0
23887,2,3887,[496  88 174 357 144],416,4,14715,3.7847222222222223,0.0,0.0
23888,2,3888,[ 64  12 301 357 269],416,5,14720,3.7850347132939057,40.0,0.0
23889,2,3889,[483 568  56 210 204],128,4,14724,3.7850899742930593,20.0,0.0
23890,2,3890,[ 50 200  15 181 275],618,3,14727,3.7848882035466462,0.0,40.0
23891,2,3891,[ 64  12 301 357 269],416,5,14732,3.7852004110996917,40.0,0.0
23892,2,3892,[333 196 302 121 258],416,5,14737,3.7855124582584123,0.0,0.0
23893,2,3893,[ 64  12 301 357 269],416,5,14742,3.785824345146379,40.0,0.0
23894,2,3894,[197 427 215 161 111],128,3,14745,3.785622593068036,0.0,0.0
23895,2,3895,[ 71 405  11 173  28],43,5,14750,3.7859342915811087,0.0,0.0
23896,2,3896,[ 64  12 301 357 269],416,5,14755,3.7862458301257376,40.0,0.0
23897,2,3897,[235 588 423 111 118],416,3,14758,3.786044125192406,0.0,0.0
23898,2,3898,[294 286  22 546 235],297,2,14760,3.7855860477045398,0.0,0.0
23899,2,3899,[168 268 153 100  98],854,4,14764,3.785641025641026,0.0,20.0
23900,2,3900,[195  56 181 475 245],297,3,14767,3.785439630863881,0.0,20.0
23901,2,3901,[132  79 195 313 173],618,3,14770,3.7852383393131728,20.0,20.0
23902,2,3902,[ 64  12 301 357 269],416,5,14775,3.7855495772482706,40.0,0.0
23903,2,3903,[385 357 333 257 181],416,4,14779,3.7856045081967213,0.0,20.0
23904,2,3904,[ 88 172 132 179 655],373,3,14782,3.785403329065301,0.0,0.0
23905,2,3905,[ 64  12 301 357 269],416,5,14787,3.7857142857142856,40.0,0.0
23906,2,3906,[265  70 228 151 273],297,2,14789,3.7852572306117227,0.0,0.0
23907,2,3907,[ 64  12 301 357 269],416,5,14794,3.785568065506653,40.0,0.0
23908,2,3908,[ 64  12 301 357 269],416,5,14799,3.785878741366078,40.0,0.0
23909,2,3909,[276  64  70 603 235],416,3,14802,3.7856777493606137,20.0,0.0
23910,2,3910,[121 174  82 300   7],49,1,14803,3.7849654819739196,0.0,0.0
23911,2,3911,[ 64  12 301 357 269],416,5,14808,3.785276073619632,40.0,0.0
23912,2,3912,[496  22 742 423 172],588,3,14811,3.7850753897265523,0.0,0.0
23913,2,3913,[427 405 257  71 127],416,4,14815,3.78513030148186,0.0,0.0
23914,2,3914,[ 64  12 301 357 269],416,5,14820,3.78544061302682,40.0,0.0
23915,2,3915,[508 135 168 483 173],854,5,14825,3.785750766087845,20.0,0.0
23916,2,3916,[191 588 237  89 271],297,3,14828,3.785550165943324,0.0,0.0
23917,2,3917,[176  11 265 568  70],230,4,14832,3.785604900459418,0.0,0.0
23918,2,3918,[496  98  96 211 172],416,5,14837,3.785914774177086,0.0,20.0
23919,2,3919,[ 25 216 245 118 117],345,2,14839,3.7854591836734692,0.0,0.0
23920,2,3920,[286 257 200 269 228],711,3,14842,3.7852588625350676,0.0,0.0
23921,2,3921,[ 64  12 301 357 269],416,5,14847,3.78556858745538,40.0,0.0
23922,2,3922,[597   4 197 427   7],416,4,14851,3.785623247514657,0.0,0.0
23923,2,3923,[ 64  12 301 357 269],416,5,14856,3.785932721712538,40.0,0.0
23924,2,3924,[191  71 323 282 546],630,1,14857,3.785222929936306,0.0,0.0
23925,2,3925,[161 151   9 333 588],416,4,14861,3.785277636271014,0.0,0.0
23926,2,3926,[ 64  12 301 357 269],416,5,14866,3.7855869620575504,40.0,0.0
23927,2,3927,[135 200 286  22 174],297,4,14870,3.7856415478615073,0.0,0.0
23928,2,3928,[301 187 153  88 237],416,3,14873,3.785441588190379,0.0,0.0
23929,2,3929,[405  71 151 161 294],314,5,14878,3.7857506361323154,0.0,0.0
23930,2,3930,[ 64  12 301 357 269],416,5,14883,3.786059526837955,40.0,0.0
23931,2,3931,[ 64  12 301 357 269],416,5,14888,3.7863682604272633,40.0,0.0
23932,2,3932,[ 69 222 228 508 172],62,4,14892,3.7864225781845917,0.0,0.0
23933,2,3933,[185 111 273 100  25],618,3,14895,3.78622267412303,0.0,0.0
23934,2,3934,[ 71 118 588  15  56],642,4,14899,3.786277001270648,0.0,0.0
23935,2,3935,[ 50  82 204 100 385],43,5,14904,3.7865853658536586,0.0,20.0
23936,2,3936,[216  82 210 196  11],654,5,14909,3.7868935737871476,0.0,0.0
23937,2,3937,[ 64  12 301 357 269],416,5,14914,3.787201625190452,40.0,0.0
23938,2,3938,[ 22   8   4  50 268],854,2,14916,3.786747905559787,0.0,20.0
23939,2,3939,[ 64  12 301 357 269],416,5,14921,3.787055837563452,40.0,0.0
23940,2,3940,[ 25 258 187 195 183],416,5,14926,3.787363613296118,0.0,0.0
23941,2,3941,[ 50 238 496 182   7],618,4,14930,3.787417554540842,0.0,20.0
23942,2,3942,[ 64  12 301 357 269],416,5,14935,3.78772508242455,40.0,0.0
23943,2,3943,[ 79 111 294 132 313],921,4,14939,3.7877789046653145,20.0,20.0
23944,2,3944,[237 496 275 294  96],907,5,14944,3.78808618504436,0.0,0.0
23945,2,3945,[197  82 151 385 196],373,2,14946,3.787633046122656,0.0,0.0
23946,2,3946,[286 204 210 197   1],416,5,14951,3.7879402077527238,0.0,0.0
23947,2,3947,[118  89 323  79 204],198,1,14952,3.7872340425531914,0.0,0.0
23948,2,3948,[ 64  12 301 357 269],416,5,14957,3.7875411496581415,40.0,0.0
23949,2,3949,[471 294 546 211 200],416,4,14961,3.7875949367088606,0.0,0.0
23950,2,3950,[181 300  56 318  28],721,4,14965,3.7876486965325236,20.0,20.0
23951,2,3951,[172 282 161  69   7],588,3,14968,3.7874493927125505,0.0,0.0
23952,2,3952,[ 64  12 301 357 269],416,5,14973,3.7877561345813304,40.0,0.0
23953,2,3953,[100 195 196 282  69],618,3,14976,3.7875569044006068,0.0,0.0
23954,2,3954,[ 64  12 301 357 269],416,5,14981,3.7878634639696585,40.0,0.0
23955,2,3955,[ 64 385 191  70 172],417,4,14985,3.787917087967644,20.0,0.0
23956,2,3956,[ 64  12 301 357 269],416,5,14990,3.7882234015668437,40.0,0.0
23957,2,3957,[117 144 302 748 215],297,2,14992,3.7877716018191006,0.0,0.0
23958,2,3958,[ 64  12 301 357 269],416,5,14997,3.788077797423592,40.0,0.0
23959,2,3959,[ 82 234 423 748 508],417,4,15001,3.7881313131313132,0.0,0.0
23960,2,3960,[302 127 568  95 200],416,4,15005,3.7881848018177227,0.0,0.0
23961,2,3961,[210 127 237 191 742],416,4,15009,3.788238263503281,0.0,0.0
23962,2,3962,[151 191 603 405 173],128,4,15013,3.788291698208428,0.0,0.0
23963,2,3963,[196 179 151 328 181],128,2,15015,3.787840565085772,0.0,20.0
23964,2,3964,[111 288 471 168 235],297,1,15016,3.787137452711223,0.0,20.0
23965,2,3965,[143  22  98 210 111],297,4,15020,3.7871911245587495,0.0,20.0
23966,2,3966,[118 197  69 204 215],128,4,15024,3.787244769347114,0.0,0.0
23967,2,3967,[ 71 588 678  82 328],38,5,15029,3.7875504032258065,0.0,0.0
23968,2,3968,[172  82 197 196 179],405,3,15032,3.7873519778281683,0.0,0.0
23969,2,3969,[ 64  12 301 357 269],416,5,15037,3.7876574307304787,40.0,0.0
23970,2,3970,[185 275 748 245 546],297,2,15039,3.7872072525812137,0.0,0.0
23971,2,3971,[ 64  12 301 357 269],416,5,15044,3.787512588116818,40.0,0.0
23972,2,3972,[ 64  12 301 357 269],416,5,15049,3.7878177699471434,40.0,0.0
23973,2,3973,[318 161 333 234 385],345,2,15051,3.7873678912934072,20.0,0.0
23974,2,3974,[ 97 258 191 742 182],62,3,15054,3.7871698113207546,0.0,0.0
23975,2,3975,[ 64  12 301 357 269],416,5,15059,3.7874748490945676,40.0,0.0
23976,2,3976,[282  22 175  95 143],297,3,15062,3.7872768418405833,0.0,0.0
23977,2,3977,[ 64  12 301 357 269],416,5,15067,3.787581699346405,40.0,0.0
23978,2,3978,[ 64  12 301 357 269],416,5,15072,3.787886403619,40.0,0.0
23979,2,3979,[ 64  12 301 357 269],416,5,15077,3.7881909547738695,40.0,0.0
23980,2,3980,[ 15 172 216 202 183],417,3,15080,3.787992966591309,0.0,0.0
23981,2,3981,[300  11 197 202 204],416,5,15085,3.788297338021095,0.0,0.0
23982,2,3982,[257 288 237 127 294],630,3,15088,3.7880994225458196,0.0,20.0
23983,2,3983,[181 153 475 318  98],62,5,15093,3.7884036144578315,20.0,40.0
23984,2,3984,[179 235 185 195 318],416,3,15096,3.7882057716436637,20.0,0.0
23985,2,3985,[ 64  12 301 357 269],416,5,15101,3.788509784244857,40.0,0.0
23986,2,3986,[ 88 423  69   8 191],642,4,15105,3.788562829194883,0.0,0.0
23987,2,3987,[  8 222   4  50  15],62,4,15109,3.7886158475426277,0.0,20.0
23988,2,3988,[ 82 568 111 100 257],654,4,15113,3.788668839308097,0.0,0.0
23989,2,3989,[216 196 568 234 475],416,4,15117,3.7887218045112783,0.0,0.0
23990,2,3990,[174 180 742 117 135],854,2,15119,3.788273615635179,0.0,0.0
23991,2,3991,[423 174 228  71   8],62,3,15122,3.788076152304609,0.0,0.0
23992,2,3992,[275 172  79 161 173],711,4,15126,3.788129226145755,0.0,0.0
23993,2,3993,[228 180 475 118 423],62,2,15128,3.787681522283425,0.0,0.0
23994,2,3994,[300 168 322 197 275],128,4,15132,3.7877346683354194,0.0,0.0
23995,2,3995,[ 98 588 333 288 302],416,5,15137,3.788038038038038,0.0,40.0
23996,2,3996,[196 269  89 144 143],751,4,15141,3.788091068301226,0.0,0.0
23997,2,3997,[  1 237 117 135  22],297,4,15145,3.788144072036018,0.0,0.0
23998,2,3998,[ 64  12 301 357 269],416,5,15150,3.7884471117779444,40.0,0.0
23999,2,3999,[435 200   8 191 195],297,1,15151,3.78775,0.0,0.0
24000,2,4000,[ 64  12 301 357 269],416,5,15156,3.7880529867533115,40.0,0.0
24001,2,4001,[135 173  69  12 603],373,4,15160,3.788105947026487,20.0,0.0
24002,2,4002,[  1 237 234 471 333],345,2,15162,3.787659255558331,0.0,0.0
24003,2,4003,[ 64  12 301 357 269],416,5,15167,3.787962037962038,40.0,0.0
24004,2,4004,[ 69  98 161  22 742],505,3,15170,3.787765293383271,0.0,20.0
24005,2,4005,[121 179  79  82 655],417,3,15173,3.7875686470294556,0.0,0.0
24006,2,4006,[216 143  98 228  69],711,3,15176,3.7873720988270527,0.0,20.0
24007,2,4007,[238  56 181  12 173],62,5,15181,3.787674650698603,20.0,20.0
24008,2,4008,[301 289 269  64 117],416,4,15185,3.78772761287104,20.0,0.0
24009,2,4009,[471 117 168  56 286],416,5,15190,3.7880299251870326,0.0,0.0
24010,2,4010,[ 64  12 301 357 269],416,5,15195,3.788332086761406,40.0,0.0
24011,2,4011,[ 25 568 435 228  28],230,2,15197,3.7878863409770687,0.0,0.0
24012,2,4012,[289 125  56 405 546],416,3,15200,3.787690007475704,0.0,0.0
24013,2,4013,[302 597 273 176  12],62,3,15203,3.7874937717987045,20.0,0.0
24014,2,4014,[100 301 405 269 117],345,5,15208,3.7877957658779575,0.0,0.0
24015,2,4015,[294 234 172   1 185],417,3,15211,3.7875996015936253,0.0,0.0
24016,2,4016,[187  95 215 151 328],416,3,15214,3.7874035349763506,0.0,0.0
24017,2,4017,[ 69  71 265 125  25],588,3,15217,3.7872075659532105,0.0,0.0
24018,2,4018,[268  25 423  97 258],654,2,15219,3.7867628763373973,0.0,0.0
24019,2,4019,[ 64  12 301 357 269],416,5,15224,3.7870646766169154,40.0,0.0
24020,2,4020,[235 423 172 237  22],62,3,15227,3.7868689380751057,0.0,0.0
24021,2,4021,[ 64  12 301 357 269],416,5,15232,3.7871705619094977,40.0,0.0
24022,2,4022,[ 64  12 301 357 269],416,5,15237,3.7874720357941833,40.0,0.0
24023,2,4023,[ 64  12 301 357 269],416,5,15242,3.7877733598409544,40.0,0.0
24024,2,4024,[ 64  12 301 357 269],416,5,15247,3.7880745341614905,40.0,0.0
24025,2,4025,[ 64  12 301 357 269],416,5,15252,3.788375558867362,40.0,0.0
24026,2,4026,[181 179 200 151 172],437,5,15257,3.788676434070027,0.0,20.0
24027,2,4027,[ 64  12 301 357 269],416,5,15262,3.788977159880834,40.0,0.0
24028,2,4028,[289 328  22  69 678],721,3,15265,3.7887813353189377,0.0,0.0
24029,2,4029,[ 64  12 301 357 269],416,5,15270,3.7890818858560795,40.0,0.0
24030,2,4030,[135 153 211 405 185],230,4,15274,3.7891342098734806,0.0,0.0
24031,2,4031,[135 168 423 475 196],198,3,15277,3.788938492063492,0.0,0.0
24032,2,4032,[302 546  22 182 597],416,3,15280,3.788742871311679,0.0,0.0
24033,2,4033,[ 64  12 301 357 269],416,5,15285,3.789043133366386,40.0,0.0
24034,2,4034,[191 143  12  98  22],297,4,15289,3.78909541511772,20.0,20.0
24035,2,4035,[ 95 135 238 508 176],417,3,15292,3.7888999008919724,0.0,0.0
24036,2,4036,[197 200 742  79 153],805,4,15296,3.788952192221947,0.0,0.0
24037,2,4037,[ 82 161 568  69  70],405,3,15299,3.7887568103021296,0.0,0.0
24038,2,4038,[ 82  89 121 118  11],751,2,15301,3.788313939093835,0.0,0.0
24039,2,4039,[191 245  64 181 228],62,3,15304,3.788118811881188,20.0,20.0
24040,2,4040,[ 64  12 301 357 269],416,5,15309,3.7884187082405347,40.0,0.0
24041,2,4041,[ 25 288 135  96 228],417,0,15309,3.7874814448292926,0.0,20.0
24042,2,4042,[ 64  12 301 357 269],416,5,15314,3.787781350482315,40.0,0.0
24043,2,4043,[215 125 210 405 153],416,5,15319,3.7880811078140453,0.0,0.0
24044,2,4044,[ 64  12 301 357 269],416,5,15324,3.788380716934487,40.0,0.0
24045,2,4045,[ 64  12 301 357 269],416,5,15329,3.7886801779535344,40.0,0.0
24046,2,4046,[ 64  12 301 357 269],416,5,15334,3.7889794909809735,40.0,0.0
24047,2,4047,[ 50 172 222   8 168],541,5,15339,3.7892786561264824,0.0,20.0
24048,2,4048,[ 56  79 678 333 748],345,2,15341,3.7888367498147693,0.0,0.0
24049,2,4049,[ 64  12 301 357 269],416,5,15346,3.789135802469136,40.0,0.0
24050,2,4050,[135 496   4  97 313],642,3,15349,3.788941002221674,20.0,20.0
24051,2,4051,[ 64  12 301 357 269],416,5,15354,3.7892398815399804,40.0,0.0
24052,2,4052,[ 64  12 301 357 269],416,5,15359,3.78953861337281,40.0,0.0
24053,2,4053,[588  97 603 111 168],128,3,15362,3.7893438579181056,0.0,0.0
24054,2,4054,[ 64  12 301 357 269],416,5,15367,3.7896424167694205,40.0,0.0
24055,2,4055,[ 64  12 301 357 269],416,5,15372,3.789940828402367,40.0,0.0
24056,2,4056,[196 678 471 179 301],416,3,15375,3.78974611782105,0.0,0.0
24057,2,4057,[143  88 151 655   7],416,3,15378,3.7895515032035485,0.0,0.0
24058,2,4058,[ 64  12 301 357 269],416,5,15383,3.789849716678985,40.0,0.0
24059,2,4059,[ 64  12 301 357 269],416,5,15388,3.7901477832512316,40.0,0.0
24060,2,4060,[ 69 117 323 183   7],417,2,15390,3.7897069687269145,0.0,0.0
24061,2,4061,[132 117   9 269 197],854,4,15394,3.7897587395371737,0.0,0.0
24062,2,4062,[174 173  50 121 301],437,3,15397,3.7895643613093775,0.0,20.0
24063,2,4063,[100  12 508 288 269],345,4,15401,3.7896161417322833,20.0,20.0
24064,2,4064,[179 143 174  70 318],373,3,15404,3.7894218942189424,20.0,0.0
24065,2,4065,[568  22 125 195  95],416,4,15408,3.789473684210526,0.0,0.0
24066,2,4066,[ 79  71 238 174 211],437,4,15412,3.7895254487337104,0.0,0.0
24067,2,4067,[215 258  50 197 294],721,3,15415,3.789331366764995,0.0,20.0
24068,2,4068,[742 210  71   4  12],654,4,15419,3.7893831408208407,20.0,0.0
24069,2,4069,[185 483 282  69   4],618,3,15422,3.789189189189189,20.0,0.0
24070,2,4070,[235  82  71 200 111],49,0,15422,3.7882584131662984,0.0,0.0
24071,2,4071,[215 132 181 173 179],437,4,15426,3.788310412573674,0.0,20.0
24072,2,4072,[202 301 100 173   1],49,1,15427,3.7876258286275473,0.0,0.0
24073,2,4073,[ 82 235 496 288 127],417,2,15429,3.787187039764359,0.0,20.0
24074,2,4074,[118  82   7  89 288],62,3,15432,3.786993865030675,0.0,20.0
24075,2,4075,[ 64  12 357 269 301],416,5,15437,3.7872914622178606,40.0,0.0
24076,2,4076,[ 71  50 258 204 143],49,0,15437,3.786362521461859,0.0,20.0
24077,2,4077,[ 64  12 357 269 301],416,5,15442,3.786660127513487,40.0,0.0
24078,2,4078,[215 302 475 132 357],62,3,15445,3.7864672713900465,0.0,0.0
24079,2,4079,[196 288 111 135  25],297,3,15448,3.7862745098039214,0.0,20.0
24080,2,4080,[357 175 185 127 191],805,4,15452,3.786326880666503,0.0,0.0
24081,2,4081,[ 64  12 357 269 301],416,5,15457,3.786624203821656,40.0,0.0
24082,2,4082,[ 79 185 153 588 515],416,5,15462,3.786921381337252,0.0,0.0
24083,2,4083,[496 258 153 210 202],417,3,15465,3.786728697355534,0.0,0.0
24084,2,4084,[ 64  12 357 269 301],416,5,15470,3.7870257037943698,40.0,0.0
24085,2,4085,[  1 117 269 183 294],805,3,15473,3.7868330885952033,0.0,0.0
24086,2,4086,[153 427  96 143 496],698,1,15474,3.7861512111573283,0.0,0.0
24087,2,4087,[ 25 588 215 748 603],297,3,15477,3.785958904109589,0.0,0.0
24088,2,4088,[ 64  12 357 269 301],416,5,15482,3.7862558082660795,40.0,0.0
24089,2,4089,[ 64  12 357 269 301],416,5,15487,3.786552567237164,40.0,0.0
24090,2,4090,[195  70  22 182 179],62,4,15491,3.786604742116842,0.0,0.0
24091,2,4091,[294  98  96 286 151],417,4,15495,3.786656891495601,0.0,20.0
24092,2,4092,[204 385  71 427 403],922,2,15497,3.7862203762521376,0.0,0.0
24093,2,4093,[ 64  12 357 269 301],416,5,15502,3.7865168539325844,40.0,0.0
24094,2,4094,[ 64  12 357 269 301],416,5,15507,3.7868131868131867,40.0,0.0
24095,2,4095,[216 196 111 328 174],416,5,15512,3.787109375,0.0,0.0
24096,2,4096,[172 245 385 597 161],416,3,15515,3.7869172565291676,0.0,0.0
24097,2,4097,[ 64  12 357 269 301],416,5,15520,3.7872132747681797,40.0,0.0
24098,2,4098,[202 603 275  88 323],416,3,15523,3.7870212246889485,0.0,0.0
24099,2,4099,[ 64  12 357 269 301],416,5,15528,3.7873170731707315,40.0,0.0
24100,2,4100,[143 496  70 174  11],43,5,15533,3.787612777371373,0.0,0.0
24101,2,4101,[ 64  12 357 269 301],416,5,15538,3.787908337396392,40.0,0.0
24102,2,4102,[742  98 294 237  25],345,3,15541,3.7877163051425784,0.0,20.0
24103,2,4103,[385 111 423  70  50],262,3,15544,3.787524366471735,0.0,20.0
24104,2,4104,[ 88 132  98 194 496],416,4,15548,3.7875761266747867,0.0,20.0
24105,2,4105,[ 64  12 357 269 301],416,5,15553,3.7878714076960547,40.0,0.0
24106,2,4106,[ 98 385 186  88 197],618,4,15557,3.7879230581933285,0.0,20.0
24107,2,4107,[ 64  12 357 269 301],416,5,15562,3.788218111002921,40.0,0.0
24108,2,4108,[237  98 204 273 568],62,2,15564,3.787782915551229,0.0,20.0
24109,2,4109,[ 79 515 323 127  56],416,4,15568,3.7878345498783457,0.0,0.0
24110,2,4110,[ 64  12 357 269 301],416,5,15573,3.788129408902943,40.0,0.0
24111,2,4111,[ 64  12 357 269 301],416,5,15578,3.7884241245136185,40.0,0.0
24112,2,4112,[ 64  12 357 269 301],416,5,15583,3.788718696814977,40.0,0.0
24113,2,4113,[471 275 265   4 187],618,2,15585,3.788283908604764,0.0,0.0
24114,2,4114,[748 258 191 195 385],417,5,15590,3.7885783718104498,0.0,0.0
24115,2,4115,[ 64  12 357 269 301],416,5,15595,3.7888726919339164,40.0,0.0
24116,2,4116,[127 179 197  97 234],416,4,15599,3.7889239737673064,0.0,0.0
24117,2,4117,[144 742 196 546 168],416,4,15603,3.7889752306945117,0.0,0.0
24118,2,4118,[ 64  12 357 269 301],416,5,15608,3.789269240106822,40.0,0.0
24119,2,4119,[172 423 238  88 234],805,3,15611,3.7890776699029125,0.0,0.0
24120,2,4120,[100 125 268  71   4],416,5,15616,3.789371511768988,0.0,0.0
24121,2,4121,[603  71  11 588 196],437,2,15618,3.7889374090247454,0.0,0.0
24122,2,4122,[265 271 234  25  11],297,2,15620,3.788503516856658,0.0,0.0
24123,2,4123,[ 64  12 357 269 301],416,5,15625,3.7887972841901068,40.0,0.0
24124,2,4124,[174 195 235 168 100],416,4,15629,3.7888484848484847,0.0,0.0
24125,2,4125,[328 423 496 211 603],373,4,15633,3.788899660688318,0.0,0.0
24126,2,4126,[ 64  12 357 269 301],416,5,15638,3.7891931184880057,40.0,0.0
24127,2,4127,[ 64  12 357 269 301],416,5,15643,3.789486434108527,40.0,0.0
24128,2,4128,[ 50 210 288 275 100],62,4,15647,3.78953741826108,0.0,40.0
24129,2,4129,[175 238 197 180 151],198,3,15650,3.7893462469733654,0.0,0.0
24130,2,4130,[ 22  64  79 181 286],373,4,15654,3.7893972403776326,20.0,20.0
24131,2,4131,[ 89 271 197 210   7],297,3,15657,3.7892061955469507,0.0,0.0
24132,2,4132,[ 64  12 357 269 301],416,5,15662,3.7894991531575126,40.0,0.0
24133,2,4133,[268 323 127 515 288],782,2,15664,3.7890662796323173,0.0,20.0
24134,2,4134,[153 423 237  50 179],262,2,15666,3.78863361547763,0.0,20.0
24135,2,4135,[173 471  15  97 655],705,1,15667,3.7879593810444874,0.0,0.0
24136,2,4136,[385 196 118  11 191],618,4,15671,3.788010635726372,0.0,0.0
24137,2,4137,[174 357 423 210 161],405,4,15675,3.788061865635573,0.0,0.0
24138,2,4138,[ 64  12 357 269 301],416,5,15680,3.7883546750422807,40.0,0.0
24139,2,4139,[245 597 235 269  97],416,2,15682,3.78792270531401,0.0,0.0
24140,2,4140,[ 64  12 357 269 301],416,5,15687,3.788215406906544,40.0,0.0
24141,2,4141,[237 173 286 144 235],416,3,15690,3.7880251086431675,0.0,0.0
24142,2,4142,[183 286 191 268 423],417,5,15695,3.788317644219165,0.0,0.0
24143,2,4143,[257 588 234 294  95],417,3,15698,3.788127413127413,0.0,0.0
24144,2,4144,[ 97   8 385 117 271],43,4,15702,3.7881785283474065,0.0,0.0
24145,2,4145,[ 64  12 357 269 301],416,5,15707,3.7884708152436084,40.0,0.0
24146,2,4146,[ 98 237 179  56 100],342,4,15711,3.7885218230045816,0.0,20.0
24147,2,4147,[ 64  12 357 269 301],416,5,15716,3.788813886210222,40.0,0.0
24148,2,4148,[ 64  12 357 269 301],416,5,15721,3.789105808628585,40.0,0.0
24149,2,4149,[151 161  64 245 318],416,3,15724,3.788915662650602,40.0,0.0
24150,2,4150,[ 50 161 117  95 313],416,4,15728,3.78896651409299,20.0,40.0
24151,2,4151,[197  56  96  12 288],618,2,15730,3.7885356454720616,20.0,20.0
24152,2,4152,[125  11 385 211 245],416,4,15734,3.788586563929689,0.0,0.0
24153,2,4153,[  7 385 197 181 151],805,3,15737,3.7883967260471834,0.0,20.0
24154,2,4154,[ 95 588 275 238  15],654,4,15741,3.788447653429603,0.0,0.0
24155,2,4155,[ 64  12 357 269 301],416,5,15746,3.7887391722810393,40.0,0.0
24156,2,4156,[475 100 588 655 143],416,4,15750,3.7887899927832573,0.0,0.0
24157,2,4157,[ 64  12 357 269 301],416,5,15755,3.789081289081289,40.0,0.0
24158,2,4158,[286 185 211  98   4],416,5,15760,3.789372445299351,0.0,20.0
24159,2,4159,[  4 288 216 132 302],854,2,15762,3.7889423076923077,0.0,20.0
24160,2,4160,[143 282 144   9 185],416,5,15767,3.789233357366018,0.0,0.0
24161,2,4161,[ 64  12 357 269 301],416,5,15772,3.7895242671792406,40.0,0.0
24162,2,4162,[235 153 748  71  56],642,3,15775,3.7893346144607256,0.0,0.0
24163,2,4163,[ 64  12 357 269 301],416,5,15780,3.7896253602305476,40.0,0.0
24164,2,4164,[  7 215 301  22 568],588,4,15784,3.7896758703481392,0.0,0.0
24165,2,4165,[ 64  12 357 269 301],416,5,15789,3.7899663946231397,40.0,0.0
24166,2,4166,[191  50 423 276 182],198,3,15792,3.7897768178545714,0.0,20.0
24167,2,4167,[ 64  12 357 269 301],416,5,15797,3.790067178502879,40.0,0.0
24168,2,4168,[313 125 182 328  96],505,3,15800,3.789877668505637,20.0,20.0
24169,2,4169,[202 186  88  96   4],373,4,15804,3.789928057553957,0.0,0.0
24170,2,4170,[318 423 132 168   4],416,5,15809,3.790218173099976,20.0,0.0
24171,2,4171,[ 64  12 357 269 301],416,5,15814,3.790508149568552,40.0,0.0
24172,2,4172,[ 64  12 357 269 301],416,5,15819,3.790797987059669,40.0,0.0
24173,2,4173,[211 286  64 196 182],417,5,15824,3.791087685673215,20.0,0.0
24174,2,4174,[475  56 268 471 483],588,4,15828,3.7911377245508984,20.0,0.0
24175,2,4175,[200 313 286 678 195],416,4,15832,3.7911877394636013,20.0,20.0
24176,2,4176,[257 483 144  69   7],62,3,15835,3.7909983241560927,20.0,0.0
24177,2,4177,[ 95  88 118 202 196],437,3,15838,3.790808999521302,0.0,0.0
24178,2,4178,[ 64  12 357 269 301],416,5,15843,3.7910983488872936,40.0,0.0
24179,2,4179,[ 25 294  97 237 222],128,2,15845,3.79066985645933,0.0,0.0
24180,2,4180,[ 56 427 322 258 302],416,4,15849,3.7907199234632865,0.0,0.0
24181,2,4181,[204 132  88 151  12],437,4,15853,3.7907699665231944,20.0,0.0
24182,2,4182,[ 64  12 357 269 301],416,5,15858,3.7910590485297635,40.0,0.0
24183,2,4183,[ 64  12 357 269 301],416,5,15863,3.7913479923518163,40.0,0.0
24184,2,4184,[  1  96  82 200 313],49,0,15863,3.790442054958184,20.0,20.0
24185,2,4185,[117 588 100 181 275],416,5,15868,3.7907310081223127,0.0,20.0
24186,2,4186,[276 100   8  79 258],354,3,15871,3.790542154287079,0.0,0.0
24187,2,4187,[ 64  12 357 269 301],416,5,15876,3.7908309455587395,40.0,0.0
24188,2,4188,[ 64  12 357 269 301],416,5,15881,3.79111959894963,40.0,0.0
24189,2,4189,[405 302 234 216  56],345,5,15886,3.7914081145584726,0.0,0.0
24190,2,4190,[ 64  12 357 269 301],416,5,15891,3.791696492483894,40.0,0.0
24191,2,4191,[ 64  12 357 269 301],416,5,15896,3.7919847328244276,40.0,0.0
24192,2,4192,[ 64  12 357 269 301],416,5,15901,3.792272835678512,40.0,0.0
24193,2,4193,[151  64 423 588 742],128,3,15904,3.792083929422985,20.0,0.0
24194,2,4194,[172 210 301 288 268],416,5,15909,3.7923718712753276,0.0,20.0
24195,2,4195,[ 64  12 357 269 301],416,5,15914,3.7926596758817923,40.0,0.0
24196,2,4196,[ 25 161 195  11 202],805,1,15915,3.7919942816297354,0.0,0.0
24197,2,4197,[125 245  64 597 121],62,3,15918,3.791805621724631,20.0,0.0
24198,2,4198,[318 194 257 748 183],416,4,15922,3.7918552036199094,20.0,0.0
24199,2,4199,[  1 161 202 174 268],49,0,15922,3.790952380952381,0.0,0.0
24200,2,4200,[ 64  12 357 269 301],416,5,15927,3.7912401809093073,40.0,0.0
24201,2,4201,[ 64  12 357 269 301],416,5,15932,3.791527843883865,40.0,0.0
24202,2,4202,[ 64  12 357 269 301],416,5,15937,3.791815369973828,40.0,0.0
24203,2,4203,[143 174  28  71 318],437,3,15940,3.79162702188392,20.0,0.0
24204,2,4204,[204 273 186  56 161],618,4,15944,3.7916765755053508,0.0,0.0
24205,2,4205,[748  56  79 216  98],417,3,15947,3.7914883499762246,0.0,20.0
24206,2,4206,[235 238 403  69 191],345,3,15950,3.7913002139291656,0.0,0.0
24207,2,4207,[ 50  25 174 427  79],618,4,15954,3.7913498098859315,0.0,20.0
24208,2,4208,[ 64  12 357 269 301],416,5,15959,3.7916369684010456,40.0,0.0
24209,2,4209,[508 275   1 204 210],654,4,15963,3.791686460807601,0.0,0.0
24210,2,4210,[181 742 132 238 435],230,4,15967,3.791735929707908,0.0,20.0
24211,2,4211,[ 64  12 357 269 301],416,5,15972,3.792022792022792,40.0,0.0
24212,2,4212,[200 183 195 237  11],297,3,15975,3.791834797056729,0.0,0.0
24213,2,4213,[117 215 385 234 275],588,3,15978,3.7916468913146653,0.0,0.0
24214,2,4214,[ 64  12 357 269 301],416,5,15983,3.7919335705812576,40.0,0.0
24215,2,4215,[ 64  12 357 269 301],416,5,15988,3.792220113851992,40.0,0.0
24216,2,4216,[ 11 405   1 678 121],654,5,15993,3.792506521223619,0.0,0.0
24217,2,4217,[ 64  12 357 269 301],416,5,15998,3.7927927927927927,40.0,0.0
24218,2,4218,[ 28 200 357 127 228],805,2,16000,3.7923678596823893,0.0,0.0
24219,2,4219,[742 222 210 228 196],417,1,16001,3.7917061611374407,0.0,0.0
24220,2,4220,[204  11 496 121 423],654,5,16006,3.7919924188580905,0.0,0.0
24221,2,4221,[ 64  12 357 269 301],416,5,16011,3.792278540975841,40.0,0.0
24222,2,4222,[222 294  89 204 191],62,3,16014,3.792090930618044,0.0,0.0
24223,2,4223,[ 64  12 357 269 301],416,5,16019,3.792376893939394,40.0,0.0
24224,2,4224,[215   7 161  64 302],43,5,16024,3.792662721893491,20.0,0.0
24225,2,4225,[135 127 111 100 143],618,4,16028,3.79271178419309,0.0,0.0
24226,2,4226,[222 125 483 475 195],62,5,16033,3.792997397681571,20.0,0.0
24227,2,4227,[117 168 423 282 197],416,5,16038,3.793282876064333,0.0,0.0
24228,2,4228,[234 182 294 588 175],297,2,16040,3.7928588318751477,0.0,0.0
24229,2,4229,[655 427  69 173 568],618,4,16044,3.7929078014184396,0.0,0.0
24230,2,4230,[196  98 121 132 100],618,5,16049,3.7931930985582603,0.0,20.0
24231,2,4231,[568 127 300 265 423],416,5,16054,3.7934782608695654,0.0,0.0
24232,2,4232,[ 25 181  98 276  88],618,3,16057,3.793290810300024,0.0,40.0
24233,2,4233,[ 64  12 357 269 301],416,5,16062,3.7935758148323098,40.0,0.0
24234,2,4234,[ 64  12 357 269 301],416,5,16067,3.7938606847697756,40.0,0.0
24235,2,4235,[313 483  11 183 385],618,5,16072,3.794145420207743,40.0,20.0
24236,2,4236,[385 168  79 313 200],405,2,16074,3.7937219730941703,20.0,20.0
24237,2,4237,[ 64  12 357 269 301],416,5,16079,3.7940066068900427,40.0,0.0
24238,2,4238,[ 64  12 357 269 301],416,5,16084,3.7942911063930174,40.0,0.0
24239,2,4239,[282 546 257   1 228],297,0,16084,3.793396226415094,0.0,0.0
24240,2,4240,[ 64  12 357 269 301],416,5,16089,3.793680735675548,40.0,0.0
24241,2,4241,[471   1  88 172 496],588,4,16093,3.793729372937294,0.0,0.0
24242,2,4242,[191  15 276 143  71],601,2,16095,3.7933066226726373,0.0,0.0
24243,2,4243,[179 269 301 405 174],751,4,16099,3.7933553251649386,0.0,0.0
24244,2,4244,[ 64  12 357 269 301],416,5,16104,3.7936395759717314,40.0,0.0
24245,2,4245,[211 118 301 748 100],416,4,16108,3.793688177107866,0.0,0.0
24246,2,4246,[ 64  12 357 269 301],416,5,16113,3.7939722156816575,40.0,0.0
24247,2,4247,[ 64  12 357 269 301],416,5,16118,3.794256120527307,40.0,0.0
24248,2,4248,[ 88 168 328 151 748],373,5,16123,3.7945398917392326,0.0,0.0
24249,2,4249,[483 185 273 588 186],618,5,16128,3.7948235294117647,20.0,0.0
24250,2,4250,[ 50 132 300   7  71],198,3,16131,3.794636556104446,0.0,20.0
24251,2,4251,[423 202  22 181 176],297,3,16134,3.79444967074318,0.0,20.0
24252,2,4252,[ 64  12 357 269 301],416,5,16139,3.794733129555608,40.0,0.0
24253,2,4253,[  1  50 301  88   4],416,4,16143,3.794781382228491,0.0,20.0
24254,2,4254,[153  56 181  22  89],297,5,16148,3.7950646298472384,0.0,20.0
24255,2,4255,[603 515 200 174  82],416,5,16153,3.7953477443609023,0.0,0.0
24256,2,4256,[  7   4 322 216  11],805,1,16154,3.7946910970166785,0.0,0.0
24257,2,4257,[748  96 216 100 151],416,4,16158,3.794739314232034,0.0,0.0
24258,2,4258,[ 11 235 121  50 176],854,2,16160,3.794317915003522,0.0,20.0
24259,2,4259,[294 742   7 357 196],62,3,16163,3.794131455399061,0.0,0.0
24260,2,4260,[271 245 194 515 282],297,1,16164,3.793475709927247,0.0,0.0
24261,2,4261,[196 179   8 194 655],342,3,16167,3.793289535429376,0.0,0.0
24262,2,4262,[117   8   4 210 222],805,1,16168,3.7926342950973493,0.0,0.0
24263,2,4263,[ 64  12 357 269 301],416,5,16173,3.7929174484052535,40.0,0.0
24264,2,4264,[204 323 273  56 111],416,4,16177,3.792966002344666,0.0,0.0
24265,2,4265,[ 64  12 357 269 301],416,5,16182,3.7932489451476794,40.0,0.0
24266,2,4266,[282 508 125 234  98],345,3,16185,3.7930630419498477,0.0,20.0
24267,2,4267,[ 64  12 357 269 301],416,5,16190,3.793345829428304,40.0,0.0
24268,2,4268,[ 64  12 357 269 301],416,5,16195,3.7936284844225816,40.0,0.0
24269,2,4269,[ 64  12 357 269 301],416,5,16200,3.7939110070257613,40.0,0.0
24270,2,4270,[151  15 237 423 111],437,4,16204,3.7939592601264343,0.0,0.0
24271,2,4271,[216 174  95 168 300],43,5,16209,3.794241573033708,0.0,0.0
24272,2,4272,[181 238 161 210 186],437,2,16211,3.793821670957173,0.0,20.0
24273,2,4273,[125 196 234 191 568],417,4,16215,3.7938699110903134,0.0,0.0
24274,2,4274,[181  98 269 168 228],805,3,16218,3.7936842105263158,0.0,40.0
24275,2,4275,[322 328 200 655 678],416,3,16221,3.7934985968194574,0.0,0.0
24276,2,4276,[742 282 117 196 216],314,3,16224,3.7933130699088147,0.0,0.0
24277,2,4277,[ 15 302 318 144 174],854,1,16225,3.792660121552127,20.0,0.0
24278,2,4278,[475 172  96 127 151],417,3,16228,3.7924748773077823,0.0,0.0
24279,2,4279,[ 98 471 196  28 423],618,4,16232,3.7925233644859815,0.0,20.0
24280,2,4280,[475   4 357  56   7],417,3,16235,3.792338238729269,0.0,0.0
24281,2,4281,[ 82 204 475 194 276],416,3,16238,3.792153199439514,0.0,0.0
24282,2,4282,[216 185 215 238 127],618,3,16241,3.791968246556152,0.0,0.0
24283,2,4283,[294 202 153  97  28],38,4,16245,3.792016806722689,0.0,0.0
24284,2,4284,[100 195 294 423 121],416,5,16250,3.792298716452742,0.0,0.0
24285,2,4285,[ 64  12 357 269 301],416,5,16255,3.792580494633691,40.0,0.0
24286,2,4286,[405 258 168  96 100],416,5,16260,3.7928621413575927,0.0,0.0
24287,2,4287,[ 64  12 357 269 301],416,5,16265,3.793143656716418,40.0,0.0
24288,2,4288,[ 64  12 357 269 301],416,5,16270,3.7934250408020516,40.0,0.0
24289,2,4289,[135 173  95 200 174],618,3,16273,3.7932400932400934,0.0,0.0
24290,2,4290,[238 385 185 135  71],618,4,16277,3.7932882777907246,0.0,0.0
24291,2,4291,[ 64  12 357 269 301],416,5,16282,3.7935694315004658,40.0,0.0
24292,2,4292,[ 64  12 357 269 301],416,5,16287,3.7938504542278126,40.0,0.0
24293,2,4293,[546 405 174 323 161],417,0,16287,3.7929669306008384,0.0,0.0
24294,2,4294,[ 64  12 357 269 301],416,5,16292,3.7932479627473805,40.0,0.0
24295,2,4295,[294 475 179 161 185],805,3,16295,3.7930633147113593,0.0,0.0
24296,2,4296,[ 97   4 357 132  56],62,4,16299,3.793111473120782,0.0,0.0
24297,2,4297,[568  25  95 195 748],805,1,16300,3.7924616100511868,0.0,0.0
24298,2,4298,[ 64  12 357 269 301],416,5,16305,3.792742498255408,40.0,0.0
24299,2,4299,[ 64  12 357 269 301],416,5,16310,3.7930232558139534,40.0,0.0
24300,2,4300,[427 174  12 151 173],618,3,16313,3.792838874680307,20.0,0.0
24301,2,4301,[118 301 678 191  12],416,3,16316,3.792654579265458,20.0,0.0
24302,2,4302,[323 234 195   7  28],805,3,16319,3.7924703695096444,0.0,0.0
24303,2,4303,[144 151 235 111 204],43,4,16323,3.7925185873605947,0.0,0.0
24304,2,4304,[ 64  12 357 269 301],416,5,16328,3.792799070847851,40.0,0.0
24305,2,4305,[ 64  12 357 269 301],416,5,16333,3.793079424059452,40.0,0.0
24306,2,4306,[118 323 235 194 597],416,1,16334,3.7924309263988856,0.0,0.0
24307,2,4307,[385 127 196 568 313],416,5,16339,3.792711234911792,20.0,20.0
24308,2,4308,[273 742 237 568 328],253,4,16343,3.7927593409143654,0.0,0.0
24309,2,4309,[ 64  12 357 269 301],416,5,16348,3.7930394431554526,40.0,0.0
24310,2,4310,[ 64  12 357 269 301],416,5,16353,3.7933194154488517,40.0,0.0
24311,2,4311,[ 64  12 357 269 301],416,5,16358,3.793599257884972,40.0,0.0
24312,2,4312,[ 64  12 357 269 301],416,5,16363,3.7938789705541387,40.0,0.0
24313,2,4313,[238  28 185 300 200],416,5,16368,3.7941585535465925,0.0,0.0
24314,2,4314,[ 64  12 357 269 301],416,5,16373,3.7944380069524914,40.0,0.0
24315,2,4315,[597 471  56 235  25],887,2,16375,3.7940222428174235,0.0,0.0
24316,2,4316,[118 271  79   4  71],805,1,16376,3.793375028955293,0.0,0.0
24317,2,4317,[ 69 678 282 289  71],588,2,16378,3.792959703566466,0.0,0.0
24318,2,4318,[180 427 100   7 258],887,3,16381,3.7927761055799953,0.0,0.0
24319,2,4319,[276 300  11   9  79],24,5,16386,3.7930555555555556,0.0,0.0
24320,2,4320,[174 228 258 265 183],417,2,16388,3.79264059245545,0.0,0.0
24321,2,4321,[187 151 475 238 245],416,2,16390,3.7922258213789912,0.0,0.0
24322,2,4322,[302 174 271 322 151],854,2,16392,3.7918112421929218,0.0,0.0
24323,2,4323,[302 200 100 238 174],617,3,16395,3.791628122109158,0.0,0.0
24324,2,4324,[ 64  12 357 269 301],416,5,16400,3.791907514450867,40.0,0.0
24325,2,4325,[185 202 245 180 268],417,4,16404,3.7919556171983357,0.0,0.0
24326,2,4326,[ 22 275 111 117   9],416,5,16409,3.7922348047145826,0.0,0.0
24327,2,4327,[132 161   7 742   4],417,1,16410,3.7915896487985212,0.0,0.0
24328,2,4328,[ 64  12 357 269 301],416,5,16415,3.791868791868792,40.0,0.0
24329,2,4329,[  9 185 118 173 176],601,3,16418,3.791685912240185,0.0,0.0
24330,2,4330,[ 79  15 144  97 294],417,3,16421,3.791503117063034,0.0,0.0
24331,2,4331,[435  98 588 121 100],230,5,16426,3.791782086795937,0.0,20.0
24332,2,4332,[ 64  12 357 269 301],416,5,16431,3.792060927763674,40.0,0.0
24333,2,4333,[ 64  12 357 269 301],416,5,16436,3.792339640055376,40.0,0.0
24334,2,4334,[ 71 153 496  64 185],262,3,16439,3.792156862745098,20.0,0.0
24335,2,4335,[175  89 289 333 168],854,3,16442,3.7919741697416973,0.0,0.0
24336,2,4336,[357 275 121 496 100],214,4,16446,3.79202213511644,0.0,0.0
24337,2,4337,[ 11 132 172 168 245],416,4,16450,3.792070078377132,0.0,0.0
24338,2,4338,[269 265  70 180 151],373,4,16454,3.792117999539064,0.0,0.0
24339,2,4339,[ 89 151 117 185  25],854,3,16457,3.791935483870968,0.0,0.0
24340,2,4340,[603 423 235 153 143],805,2,16459,3.79152269062428,0.0,0.0
24341,2,4341,[403 182 210 318 172],405,4,16463,3.7915707047443576,20.0,0.0
24342,2,4342,[294  22 144 111 173],734,0,16463,3.7906976744186047,0.0,0.0
24343,2,4343,[294 245 135 483 423],62,2,16465,3.7902854511970534,20.0,0.0
24344,2,4344,[597   7 328 471 269],854,2,16467,3.789873417721519,0.0,0.0
24345,2,4345,[748 118 132 258 405],642,1,16468,3.7892314772204325,0.0,0.0
24346,2,4346,[ 69  22 200 173 427],416,5,16473,3.7895100069013115,0.0,0.0
24347,2,4347,[  7 175 144 471  11],297,3,16476,3.7893284268629257,0.0,0.0
24348,2,4348,[175 185 275 153 269],297,5,16481,3.789606806162336,0.0,0.0
24349,2,4349,[302 286 228  50 597],417,1,16482,3.788965517241379,0.0,20.0
24350,2,4350,[  1 423 204 127  28],721,5,16487,3.789243851988049,0.0,0.0
24351,2,4351,[ 64  12 357 269 301],416,5,16492,3.7895220588235294,40.0,0.0
24352,2,4352,[216  64  56 181 508],345,5,16497,3.789800137835975,20.0,20.0
24353,2,4353,[385 282 117  25 286],416,5,16502,3.7900780891134587,0.0,0.0
24354,2,4354,[385 168 282 496 403],618,4,16506,3.790126291618829,0.0,0.0
24355,2,4355,[118  11 117   1 172],198,3,16509,3.7899449035812673,0.0,0.0
24356,2,4356,[172 173 144 151   1],62,3,16512,3.7897635988065184,0.0,0.0
24357,2,4357,[ 64  12 357 269 301],416,5,16517,3.7900413033501605,40.0,0.0
24358,2,4358,[318 268 121 323 210],345,3,16520,3.789860059646708,20.0,0.0
24359,2,4359,[ 64  12 357 269 301],416,5,16525,3.790137614678899,40.0,0.0
24360,2,4360,[ 64  12 357 269 301],416,5,16530,3.790415042421463,40.0,0.0
24361,2,4361,[ 89 496 202 151 153],373,4,16534,3.790463090325539,0.0,0.0
24362,2,4362,[742 127 568  97 546],417,2,16536,3.7900527160210866,0.0,0.0
24363,2,4363,[435 588 286 144 328],373,2,16538,3.7896425297891843,0.0,0.0
24364,2,4364,[173 161  98 168 423],805,3,16541,3.7894616265750285,0.0,20.0
24365,2,4365,[143 144  88 118  71],588,3,16544,3.7892808062299586,0.0,0.0
24366,2,4366,[265 172 111 568 294],588,4,16548,3.7893290588504693,0.0,0.0
24367,2,4367,[ 69  12 176   4 568],416,5,16553,3.789606227106227,20.0,0.0
24368,2,4368,[318 194 191 197 111],416,5,16558,3.78988326848249,20.0,0.0
24369,2,4369,[ 15 483 118  79 117],854,2,16560,3.789473684210526,20.0,0.0
24370,2,4370,[ 64  12 357 269 301],416,5,16565,3.7897506291466483,40.0,0.0
24371,2,4371,[132  15 176 403 210],416,5,16570,3.7900274473924975,0.0,0.0
24372,2,4372,[403 153 282   8 127],721,5,16575,3.7903041390349874,0.0,0.0
24373,2,4373,[204 181  56 179 483],437,5,16580,3.790580704160951,20.0,20.0
24374,2,4374,[191  28 202  69 597],642,4,16584,3.7906285714285715,0.0,0.0
24375,2,4375,[ 22 111  70  69 222],62,3,16587,3.7904478976234004,0.0,0.0
24376,2,4376,[275 357 483   8  98],214,4,16591,3.790495773360749,20.0,20.0
24377,2,4377,[269 216 748 195 200],805,2,16593,3.790086797624486,0.0,0.0
24378,2,4378,[153 323 228 200  56],198,3,16596,3.7899063713176524,0.0,0.0
24379,2,4379,[ 64  12 357 269 301],416,5,16601,3.7901826484018266,40.0,0.0
24380,2,4380,[597  71 204 187 234],416,4,16605,3.790230540972381,0.0,0.0
24381,2,4381,[ 64  12 357 269 301],416,5,16610,3.7905066179826563,40.0,0.0
24382,2,4382,[143 210 546 245 603],297,3,16613,3.790326260552133,0.0,0.0
24383,2,4383,[216 475 195 100 237],297,4,16617,3.790374087591241,0.0,0.0
24384,2,4384,[127 496 111 196 191],417,3,16620,3.790193842645382,0.0,0.0
24385,2,4385,[ 98 174 496  64 385],230,4,16624,3.7902416780665753,20.0,20.0
24386,2,4386,[ 64  12 357 269 301],416,5,16629,3.790517437884659,40.0,0.0
24387,2,4387,[ 79 173  71   4 515],405,3,16632,3.7903372835004556,0.0,0.0
24388,2,4388,[ 64  12 357 269 301],416,5,16637,3.7906128958760537,40.0,0.0
24389,2,4389,[181 302 196 202 179],751,5,16642,3.790888382687927,0.0,20.0
24390,2,4390,[ 64  12 357 269 301],416,5,16647,3.791163744021863,40.0,0.0
24391,2,4391,[655 357 215 228 100],62,2,16649,3.7907559198542806,0.0,0.0
24392,2,4392,[168 318 210 257  22],62,4,16653,3.790803551104029,20.0,0.0
24393,2,4393,[271 588 183 173   1],922,3,16656,3.790623577605826,0.0,0.0
24394,2,4394,[  7 423 302 168   8],43,5,16661,3.7908987485779293,0.0,0.0
24395,2,4395,[ 64  12 357 269 301],416,5,16666,3.7911737943585075,40.0,0.0
24396,2,4396,[ 64  12 357 269 301],416,5,16671,3.791448715032977,40.0,0.0
24397,2,4397,[144 151  12 196 161],417,3,16674,3.791268758526603,20.0,0.0
24398,2,4398,[ 96 161 508 179 268],417,2,16676,3.7908615594453283,0.0,0.0
24399,2,4399,[125 323 181 237 288],345,2,16678,3.7904545454545455,0.0,40.0
24400,2,4400,[385 117 168 235 202],642,3,16681,3.7902749375142015,0.0,0.0
24401,2,4401,[ 64  12 357 269 301],416,5,16686,3.7905497501135845,40.0,0.0
24402,2,4402,[ 64 228  82 168 153],417,4,16690,3.7905973200090846,20.0,0.0
24403,2,4403,[111  96  70 144 265],618,2,16692,3.790190735694823,0.0,0.0
24404,2,4404,[435 180  22 216 568],373,4,16696,3.790238365493757,0.0,0.0
24405,2,4405,[313 161  28 273 144],416,5,16701,3.7905129369042214,20.0,20.0
24406,2,4406,[200  12 328 289  95],49,2,16703,3.7901066485137282,20.0,0.0
24407,2,4407,[257 588 508 357 238],297,4,16707,3.790154264972777,0.0,0.0
24408,2,4408,[195 237 546 265 257],654,5,16712,3.7904286686323427,0.0,0.0
24409,2,4409,[228 222   9 423 111],62,2,16714,3.7900226757369615,0.0,0.0
24410,2,4410,[237 153 318 195 144],437,3,16717,3.789843572885967,20.0,0.0
24411,2,4411,[ 50 215 234 748 258],416,5,16722,3.79011786038078,0.0,20.0
24412,2,4412,[237   1  11 568 172],630,4,16726,3.790165420348969,0.0,0.0
24413,2,4413,[318 172 313 132 333],416,5,16731,3.7904395106479383,40.0,20.0
24414,2,4414,[ 56  15  97 222  82],721,4,16735,3.7904869762174407,0.0,0.0
24415,2,4415,[174 183 173 322 357],416,4,16739,3.790534420289855,0.0,0.0
24416,2,4416,[204 328 257 568 282],416,4,16743,3.790581842879783,0.0,0.0
24417,2,4417,[ 64  12 357 269 301],416,5,16748,3.790855590765052,40.0,0.0
24418,2,4418,[ 64  12 357 269 301],416,5,16753,3.7911292147544695,40.0,0.0
24419,2,4419,[333  22 294 196 197],721,3,16756,3.7909502262443437,0.0,0.0
24420,2,4420,[ 15  64 204 161   4],345,4,16760,3.7909975118751413,20.0,0.0
24421,2,4421,[ 64  12 357 269 301],416,5,16765,3.79127091813659,40.0,0.0
24422,2,4422,[ 64  12 357 269 301],416,5,16770,3.7915442007687092,40.0,0.0
24423,2,4423,[ 64  12 357 269 301],416,5,16775,3.7918173598553344,40.0,0.0
24424,2,4424,[144   1 288 127  98],805,2,16777,3.791412429378531,0.0,40.0
24425,2,4425,[301 237 300  97 202],416,4,16781,3.791459557162223,0.0,0.0
24426,2,4426,[ 64  12 357 269 301],416,5,16786,3.7917325502597694,40.0,0.0
24427,2,4427,[275 195 121  50  96],262,2,16788,3.7913279132791327,0.0,20.0
24428,2,4428,[ 64  12 357 269 301],416,5,16793,3.7916008128245653,40.0,0.0
24429,2,4429,[  1 228 282 200 176],297,1,16794,3.7909706546275395,0.0,0.0
24430,2,4430,[ 64  12 357 269 301],416,5,16799,3.7912435116226586,40.0,0.0
24431,2,4431,[258 403 118 405 237],642,2,16801,3.7908393501805056,0.0,0.0
24432,2,4432,[216 403 318 194  69],721,5,16806,3.791112113692759,20.0,0.0
24433,2,4433,[183 111 257 222 173],705,3,16809,3.790933694181326,0.0,0.0
24434,2,4434,[275   1 228 117   8],705,3,16812,3.7907553551296505,0.0,0.0
24435,2,4435,[179   9 318  15 151],62,4,16816,3.7908025247971144,20.0,0.0
24436,2,4436,[216 568 151 174 173],922,3,16819,3.79062429569529,0.0,0.0
24437,2,4437,[268  22 216 302 174],214,3,16822,3.7904461469130237,0.0,0.0
24438,2,4438,[144 172  70 508  95],654,4,16826,3.7904933543590897,0.0,0.0
24439,2,4439,[234 276 288 405 328],416,4,16830,3.7905405405405403,0.0,20.0
24440,2,4440,[568 742 546 313 125],416,4,16834,3.7905877054717405,20.0,20.0
24441,2,4441,[ 15 273 200 245 655],416,4,16838,3.790634849167042,0.0,0.0
24442,2,4442,[  1 135 403 286 588],417,3,16841,3.79045689849201,0.0,0.0
24443,2,4443,[496 427  50   1 318],416,5,16846,3.7907290729072907,20.0,20.0
24444,2,4444,[187  25  11 173  22],416,5,16851,3.7910011248593927,0.0,0.0
24445,2,4445,[ 64  12 357 269 301],416,5,16856,3.791273054430949,40.0,0.0
24446,2,4446,[ 64  12 357 269 301],416,5,16861,3.7915448617045198,40.0,0.0
24447,2,4447,[ 64  12 357 269 301],416,5,16866,3.7918165467625897,40.0,0.0
24448,2,4448,[  1 216 151  56  69],764,5,16871,3.7920881096875703,0.0,0.0
24449,2,4449,[588 301  22 423 118],588,3,16874,3.7919101123595507,0.0,0.0
24450,2,4450,[ 69 588 265  70 237],297,3,16877,3.7917321950123566,0.0,0.0
24451,2,4451,[  4 187 427 257   8],416,4,16881,3.7917789757412397,0.0,0.0
24452,2,4452,[ 64  12 357 269 301],416,5,16886,3.7920503031664046,40.0,0.0
24453,2,4453,[196  97 111  95 286],416,4,16890,3.792096991468343,0.0,0.0
24454,2,4454,[294 427 211  25 127],416,5,16895,3.792368125701459,0.0,0.0
24455,2,4455,[742 182 748   8 153],416,5,16900,3.7926391382405744,0.0,0.0
24456,2,4456,[ 70 211  95 568  64],417,4,16904,3.792685663002019,20.0,0.0
24457,2,4457,[161  95 173  88   4],405,2,16906,3.7922835352175865,0.0,0.0
24458,2,4458,[ 64  12 357 269 301],416,5,16911,3.792554384391119,40.0,0.0
24459,2,4459,[ 12 194  69  96 286],854,2,16913,3.792152466367713,20.0,0.0
24460,2,4460,[655 423  22 211  64],405,4,16917,3.792199058507061,20.0,0.0
24461,2,4461,[  8 300  11 515  69],416,5,16922,3.7924697445091886,0.0,0.0
24462,2,4462,[ 64  12 357 269 301],416,5,16927,3.7927403092090524,40.0,0.0
24463,2,4463,[357 568 238   4 121],198,2,16929,3.7923387096774195,0.0,0.0
24464,2,4464,[ 79 475  96 483 144],854,3,16932,3.792161254199328,20.0,0.0
24465,2,4465,[174 294  12 204  79],345,4,16936,3.792207792207792,20.0,0.0
24466,2,4466,[111 144 288 282  82],416,5,16941,3.7924781732706516,0.0,20.0
24467,2,4467,[ 64  12 357 269 301],416,5,16946,3.7927484333034913,40.0,0.0
24468,2,4468,[258  70  69 588 185],711,4,16950,3.792794808682032,0.0,0.0
24469,2,4469,[174 195  64  15 196],601,2,16952,3.792393736017897,20.0,0.0
24470,2,4470,[ 64  12 357 269 301],416,5,16957,3.792663833594274,40.0,0.0
24471,2,4471,[237  71   7 313  97],505,3,16960,3.7924865831842576,20.0,20.0
24472,2,4472,[ 64  12 357 269 301],416,5,16965,3.7927565392354126,40.0,0.0
24473,2,4473,[471 282 318  50 475],416,4,16969,3.7928028609745192,20.0,20.0
24474,2,4474,[ 64  12 357 269 301],416,5,16974,3.793072625698324,40.0,0.0
24475,2,4475,[ 64  12 357 269 301],416,5,16979,3.793342269883825,40.0,0.0
24476,2,4476,[ 64  12 357 269 301],416,5,16984,3.7936117936117935,40.0,0.0
24477,2,4477,[ 64  12 357 269 301],416,5,16989,3.79388119696293,40.0,0.0
24478,2,4478,[ 64  12 357 269 301],416,5,16994,3.794150480017861,40.0,0.0
24479,2,4479,[286 423 475 275 215],416,4,16998,3.7941964285714285,0.0,0.0
24480,2,4480,[ 50 678 328  82 245],721,3,17001,3.7940191921446105,0.0,20.0
24481,2,4481,[216  64 568 258 269],345,5,17006,3.794288264167782,20.0,0.0
24482,2,4482,[235 742 245  64 168],62,3,17009,3.794111086326121,20.0,0.0
24483,2,4483,[ 28 301   8 144 135],297,4,17013,3.794157002676182,0.0,0.0
24484,2,4484,[197 235 121 328 655],416,4,17017,3.794202898550725,0.0,0.0
24485,2,4485,[ 98 172 228 385 258],198,3,17020,3.7940258582255906,0.0,20.0
24486,2,4486,[ 71 135 175 748 215],373,3,17023,3.7938488968130155,0.0,0.0
24487,2,4487,[ 64  12 357 269 301],416,5,17028,3.7941176470588234,40.0,0.0
24488,2,4488,[ 64  12 357 269 301],416,5,17033,3.794386277567387,40.0,0.0
24489,2,4489,[204 286 196  28 235],297,3,17036,3.7942093541202673,0.0,0.0
24490,2,4490,[268  82  11 286 323],417,4,17040,3.794255177020708,0.0,0.0
24491,2,4491,[496 179 294  56  98],214,4,17044,3.794300979519145,0.0,20.0
24492,2,4492,[211 121 216 385 546],43,5,17049,3.794569330068996,0.0,0.0
24493,2,4493,[ 64  12 357 269 301],416,5,17054,3.7948375611927014,40.0,0.0
24494,2,4494,[ 64  12 357 269 301],416,5,17059,3.795105672969967,40.0,0.0
24495,2,4495,[204  79 153 197  98],297,2,17061,3.79470640569395,0.0,20.0
24496,2,4496,[200  12   1   7 222],805,5,17066,3.794974427396042,20.0,0.0
24497,2,4497,[ 64  12 357 269 301],416,5,17071,3.795242329924411,40.0,0.0
24498,2,4498,[ 95   1  69 100  82],198,2,17073,3.7948432985107803,0.0,0.0
24499,2,4499,[300 111 237 405 496],654,5,17078,3.7951111111111113,0.0,0.0
24500,2,4500,[ 64  12 357 269 301],416,5,17083,3.7953788047100643,40.0,0.0
24501,2,4501,[ 50 323 515 273  64],416,4,17087,3.7954242558862727,20.0,20.0
24502,2,4502,[ 28 191  50 117 195],297,3,17090,3.7952476127026427,0.0,20.0
24503,2,4503,[ 64  12 357 269 301],416,5,17095,3.7955150976909415,40.0,0.0
24504,2,4504,[ 64  12 357 269 301],416,5,17100,3.7957824639289677,40.0,0.0
24505,2,4505,[ 64  12 357 269 301],416,5,17105,3.796049711495783,40.0,0.0
24506,2,4506,[245 302  71 257 288],416,3,17108,3.795873086310184,0.0,20.0
24507,2,4507,[ 82 318 427  11 588],416,5,17113,3.796140195208518,20.0,0.0
24508,2,4508,[179 172 328  82   1],62,3,17116,3.7959636282989577,0.0,0.0
24509,2,4509,[ 64 427 597 125 132],618,4,17120,3.796008869179601,20.0,0.0
24510,2,4510,[  1  50 127 132  96],253,5,17125,3.7962757703391707,0.0,20.0
24511,2,4511,[ 64  12 357 269 301],416,5,17130,3.796542553191489,40.0,0.0
24512,2,4512,[ 95 117  28 204 168],230,5,17135,3.7968092178152006,0.0,0.0
24513,2,4513,[ 64  12 357 269 301],416,5,17140,3.797075764288879,40.0,0.0
24514,2,4514,[118 168 288 483 186],588,4,17144,3.797120708748616,20.0,20.0
24515,2,4515,[294 258 125 183 273],62,4,17148,3.7971656333038086,0.0,0.0
24516,2,4516,[ 64  12 357 269 301],416,5,17153,3.797431923843259,40.0,0.0
24517,2,4517,[195 238  70 183 273],416,5,17158,3.7976980965028773,0.0,0.0
24518,2,4518,[318 357   8  56   7],62,5,17163,3.7979641513609206,20.0,0.0
24519,2,4519,[ 64  12 357 269 301],416,5,17168,3.798230088495575,40.0,0.0
24520,2,4520,[215 197 328  88 168],128,3,17171,3.798053527980535,0.0,0.0
24521,2,4521,[187 588 111 135 183],618,4,17175,3.7980981866430783,0.0,0.0
24522,2,4522,[234 216 238  12 286],417,4,17179,3.7981428255582577,20.0,0.0
24523,2,4523,[132 200 238  82 222],198,3,17182,3.7979664014146772,0.0,0.0
24524,2,4524,[ 25 111  79 357 100],417,1,17183,3.7973480662983428,0.0,0.0
24525,2,4525,[161 176 179 215 197],416,4,17187,3.797392841361025,0.0,0.0
24526,2,4526,[471 273 276 186 275],618,2,17189,3.7969958029600175,0.0,0.0
24527,2,4527,[191  56 143 194 135],405,4,17193,3.7970406360424027,0.0,0.0
24528,2,4528,[385  71 125 210 100],262,1,17194,3.796423051446235,0.0,0.0
24529,2,4529,[121 144 286  69 143],588,3,17197,3.7962472406181016,0.0,0.0
24530,2,4530,[ 64  12 357 269 301],416,5,17202,3.7965129110571616,40.0,0.0
24531,2,4531,[655 185 204 127   9],416,5,17207,3.7967784642541926,0.0,0.0
24532,2,4532,[185 269 235 237  96],416,3,17210,3.796602691374366,0.0,0.0
24533,2,4533,[ 64  12 357 269 301],416,5,17215,3.7968681076312305,40.0,0.0
24534,2,4534,[ 64  12 357 269 301],416,5,17220,3.797133406835722,40.0,0.0
24535,2,4535,[127  28  56 323 174],43,4,17224,3.797178130511464,0.0,0.0
24536,2,4536,[269 187 245 546  11],416,3,17227,3.797002424509588,0.0,0.0
24537,2,4537,[588  22   1  82 333],253,3,17230,3.7968267959453503,0.0,0.0
24538,2,4538,[ 12 183 215   8 276],62,4,17234,3.7968715576118086,20.0,0.0
24539,2,4539,[ 64  12 357 269 301],416,5,17239,3.797136563876652,40.0,0.0
24540,2,4540,[196 202   8 172 194],405,3,17242,3.796961021801365,0.0,0.0
24541,2,4541,[176 175  97   1 234],297,3,17245,3.7967855570233375,0.0,0.0
24542,2,4542,[323 234 427   9  98],416,4,17249,3.796830288355712,0.0,20.0
24543,2,4543,[197 151  69 143 276],416,3,17252,3.796654929577465,0.0,0.0
24544,2,4544,[ 70  12  97  98 117],417,5,17257,3.796919691969197,20.0,20.0
24545,2,4545,[  1  89  70 153 742],642,2,17259,3.7965244170699517,0.0,0.0
24546,2,4546,[ 50 100 144  95 118],416,3,17262,3.7963492412579725,0.0,20.0
24547,2,4547,[ 64  12 357 269 301],416,5,17267,3.7966138962181177,40.0,0.0
24548,2,4548,[678  69 568 275 288],588,2,17269,3.796218949219609,0.0,20.0
24549,2,4549,[144 286   1 357 135],854,2,17271,3.7958241758241758,0.0,0.0
24550,2,4550,[288 204  88  50 496],496,1,17272,3.7952098439903317,0.0,40.0
24551,2,4551,[ 22 289 294 125 238],416,4,17276,3.795254833040422,0.0,0.0
24552,2,4552,[ 98  96 475  12 174],49,3,17279,3.795080166922908,20.0,20.0
24553,2,4553,[ 64  12 357 269 301],416,5,17284,3.795344751866491,40.0,0.0
24554,2,4554,[215  89 302 235 197],297,2,17286,3.7949506037321625,0.0,0.0
24555,2,4555,[183 172 196  12 176],417,4,17290,3.794995610184372,20.0,0.0
24556,2,4556,[ 22 179 196  64 238],601,3,17293,3.794821154268159,20.0,0.0
24557,2,4557,[ 64  12 357 269 301],416,5,17298,3.795085563843791,40.0,0.0
24558,2,4558,[228  50 597   1 151],62,2,17300,3.794691818381224,0.0,20.0
24559,2,4559,[313 183 179 121 742],416,4,17304,3.794736842105263,20.0,20.0
24560,2,4560,[385 185 275  28 191],618,4,17308,3.7947818460863845,0.0,0.0
24561,2,4561,[ 64  12 357 269 301],416,5,17313,3.7950460324419115,40.0,0.0
24562,2,4562,[ 64  12 357 269 301],416,5,17318,3.795310103002411,40.0,0.0
24563,2,4563,[100 200 168  15 294],417,4,17322,3.7953549517966696,0.0,0.0
24564,2,4564,[ 64  12 357 269 301],416,5,17327,3.795618838992333,40.0,0.0
24565,2,4565,[ 64  12 357 269 301],416,5,17332,3.7958826106000876,40.0,0.0
24566,2,4566,[655  28 597 173 210],62,2,17334,3.7954893803372016,0.0,0.0
24567,2,4567,[271 655   8 200  12],805,2,17336,3.7950963222416814,20.0,0.0
24568,2,4568,[471 300 176 181  70],416,5,17341,3.7953600350186036,0.0,20.0
24569,2,4569,[475 118 204  97 117],416,3,17344,3.7951859956236325,0.0,0.0
24570,2,4570,[125  56 568 182 508],417,3,17347,3.7950120323780356,0.0,0.0
24571,2,4571,[ 64  12 357 269 301],416,5,17352,3.795275590551181,40.0,0.0
24572,2,4572,[275 127 135   9  98],854,5,17357,3.795539033457249,0.0,20.0
24573,2,4573,[ 64  12 357 269 301],416,5,17362,3.795802361171841,40.0,0.0
24574,2,4574,[508  71  12 204 546],49,1,17363,3.795191256830601,20.0,0.0
24575,2,4575,[235  64  69 257 194],854,2,17365,3.7947989510489513,20.0,0.0
24576,2,4576,[ 70 118 117 161 405],345,3,17368,3.794625300415119,0.0,0.0
24577,2,4577,[588 132 228 172  50],128,2,17370,3.7942332896461335,0.0,20.0
24578,2,4578,[ 64  12 357 269 301],416,5,17375,3.794496614981437,40.0,0.0
24579,2,4579,[ 15  25  28 655 118],345,2,17377,3.79410480349345,0.0,0.0
24580,2,4580,[ 64  12 357 269 301],416,5,17382,3.794368041912246,40.0,0.0
24581,2,4581,[ 64  12 357 269 301],416,5,17387,3.7946311654299434,40.0,0.0
24582,2,4582,[265 588  69 288 435],297,1,17388,3.794021383373336,0.0,20.0
24583,2,4583,[ 64  12 357 269 301],416,5,17393,3.794284467713787,40.0,0.0
24584,2,4584,[294 191 471 234  15],416,5,17398,3.794547437295529,0.0,0.0
24585,2,4585,[  8 235 258 318  79],416,4,17402,3.7945922372437852,20.0,0.0
24586,2,4586,[ 64  12 357 269 301],416,5,17407,3.7948550250708526,40.0,0.0
24587,2,4587,[234  56 143 204  97],416,5,17412,3.7951176983435047,0.0,0.0
24588,2,4588,[ 64  12 357 269 301],416,5,17417,3.795380257136631,40.0,0.0
24589,2,4589,[121  79   4 173 183],253,5,17422,3.7956427015250545,0.0,0.0
24590,2,4590,[ 69  64 200 588 191],262,4,17426,3.795687214114572,20.0,0.0
24591,2,4591,[132 269 275 176 196],416,5,17431,3.7959494773519165,0.0,0.0
24592,2,4592,[269 568  71 588 172],345,3,17434,3.795776181145221,0.0,0.0
24593,2,4593,[ 64  12 357 269 301],416,5,17439,3.7960383108402262,40.0,0.0
24594,2,4594,[ 64  12 357 269 301],416,5,17444,3.7963003264417847,40.0,0.0
24595,2,4595,[ 64  12 357 269 301],416,5,17449,3.796562228024369,40.0,0.0
24596,2,4596,[ 64  12 357 269 301],416,5,17454,3.7968240156623887,40.0,0.0
24597,2,4597,[678 182  50 257 179],416,2,17456,3.7964332318399303,0.0,20.0
24598,2,4598,[ 64  12 357 269 301],416,5,17461,3.796694933681235,40.0,0.0
24599,2,4599,[200  25 173 300 423],49,0,17461,3.7958695652173913,0.0,0.0
24600,2,4600,[172   7 258 568 121],62,4,17465,3.7959139317539665,0.0,0.0
24601,2,4601,[ 64  12 357 269 301],416,5,17470,3.796175575836593,40.0,0.0
24602,2,4602,[ 64  12 357 269 301],416,5,17475,3.796437106235064,40.0,0.0
24603,2,4603,[ 64  12 357 269 301],416,5,17480,3.796698523023458,40.0,0.0
24604,2,4604,[ 56 288 197 245 118],345,2,17482,3.7963083604777417,0.0,20.0
24605,2,4605,[174  56 357 204 238],405,5,17487,3.7965696917064697,0.0,0.0
24606,2,4606,[ 64  12 357 269 301],416,5,17492,3.7968309094855655,40.0,0.0
24607,2,4607,[111 204 222 117 655],588,2,17494,3.7964409722222223,0.0,0.0
24608,2,4608,[173 471  88 174 210],128,4,17498,3.7964851377739204,0.0,0.0
24609,2,4609,[ 64  12 357 269 301],416,5,17503,3.796746203904555,40.0,0.0
24610,2,4610,[ 64  12 357 269 301],416,5,17508,3.797007156798959,40.0,0.0
24611,2,4611,[ 64  12 357 269 301],416,5,17513,3.797267996530789,40.0,0.0
24612,2,4612,[471 182 153  79 168],297,2,17515,3.7968783871667027,0.0,0.0
24613,2,4613,[ 64  12 357 269 301],416,5,17520,3.7971391417425226,40.0,0.0
24614,2,4614,[ 64  12 357 269 301],416,5,17525,3.797399783315276,40.0,0.0
24615,2,4615,[ 64  12 357 269 301],416,5,17530,3.7976603119584054,40.0,0.0
24616,2,4616,[ 98   1 180 318  25],887,3,17533,3.797487546025558,20.0,20.0
24617,2,4617,[ 28 117 215   1  22],62,2,17535,3.797098310957124,0.0,0.0
24618,2,4618,[ 64  12 357 269 301],416,5,17540,3.7973587356570686,40.0,0.0
24619,2,4619,[234 187 183 210 153],416,5,17545,3.7976190476190474,0.0,0.0
24620,2,4620,[ 64  12 357 269 301],416,5,17550,3.797879246916252,40.0,0.0
24621,2,4621,[313 151 191 294 215],345,4,17554,3.797922977066205,20.0,20.0
24622,2,4622,[282 333 174 127 185],416,5,17559,3.7981829980532122,0.0,0.0
24623,2,4623,[222  82 183 185 196],601,3,17562,3.7980103806228374,0.0,0.0
24624,2,4624,[121  69 173   7   4],618,3,17565,3.7978378378378377,0.0,0.0
24625,2,4625,[ 64  12 357 269 301],416,5,17570,3.798097708603545,40.0,0.0
24626,2,4626,[ 64  12 357 269 301],416,5,17575,3.7983574670412796,40.0,0.0
24627,2,4627,[135 222 216 333 127],854,3,17578,3.798184961106309,0.0,0.0
24628,2,4628,[286 228  98 271  71],62,2,17580,3.797796500324044,0.0,20.0
24629,2,4629,[ 64  12 357 269 301],416,5,17585,3.7980561555075596,40.0,0.0
24630,2,4630,[ 64  12 357 269 301],416,5,17590,3.7983156985532283,40.0,0.0
24631,2,4631,[111 196 289 313 191],345,4,17594,3.7983592400690847,20.0,20.0
24632,2,4632,[ 70 235 405 172 196],417,2,17596,3.7979710770559034,0.0,0.0
24633,2,4633,[200 286 143  95 194],297,2,17598,3.797583081570997,0.0,0.0
24634,2,4634,[ 64 515 222  50 238],417,3,17601,3.797411003236246,20.0,20.0
24635,2,4635,[202 234 286 174 143],416,5,17606,3.797670405522002,0.0,0.0
24636,2,4636,[515 235 211  69 216],417,2,17608,3.7972827259003665,0.0,0.0
24637,2,4637,[ 64  12 357 269 301],416,5,17613,3.797542043984476,40.0,0.0
24638,2,4638,[ 64  12 357 269 301],416,5,17618,3.7978012502694547,40.0,0.0
24639,2,4639,[200 435 216 515 245],297,2,17620,3.7974137931034484,0.0,0.0
24640,2,4640,[ 64  12 357 269 301],416,5,17625,3.797672915319974,40.0,0.0
24641,2,4641,[  1 471 195 405  82],416,5,17630,3.7979319258940114,0.0,0.0
24642,2,4642,[ 64  12 357 269 301],416,5,17635,3.7981908248976954,40.0,0.0
24643,2,4643,[180 655 508 153  97],417,4,17639,3.7982342807924203,0.0,0.0
24644,2,4644,[ 64  12 357 269 301],416,5,17644,3.7984930032292787,40.0,0.0
24645,2,4645,[202 204 235 100 222],43,4,17648,3.798536375376668,0.0,0.0
24646,2,4646,[ 64  12 357 269 301],416,5,17653,3.798794921454702,40.0,0.0
24647,2,4647,[172 588 603 180  97],437,3,17656,3.7986230636833045,0.0,0.0
24648,2,4648,[265 238 143 175 181],373,3,17659,3.798451279845128,0.0,20.0
24649,2,4649,[302 748 117 301 385],751,4,17663,3.798494623655914,0.0,0.0
24650,2,4650,[173  79 238 294 357],805,4,17667,3.798537948828209,0.0,0.0
24651,2,4651,[655 111 403 357 288],805,2,17669,3.7981513327601033,0.0,20.0
24652,2,4652,[ 64  12 357 269 301],416,5,17674,3.7984096281968625,40.0,0.0
24653,2,4653,[  7  11 117 275 187],618,4,17678,3.79845294370434,0.0,0.0
24654,2,4654,[ 64  12 357 269 301],416,5,17683,3.7987110633727177,40.0,0.0
24655,2,4655,[ 71 127  88 176 313],416,4,17687,3.798754295532646,20.0,20.0
24656,2,4656,[ 50 471 117   8 195],618,2,17689,3.798368048099635,0.0,20.0
24657,2,4657,[ 64  12 357 269 301],416,5,17694,3.7986260197509663,40.0,0.0
24658,2,4658,[ 89 111 135  88 151],711,4,17698,3.7986692423266795,0.0,0.0
24659,2,4659,[121 168 423 181  88],43,5,17703,3.7989270386266094,0.0,20.0
24660,2,4660,[ 64  12 357 269 301],416,5,17708,3.7991847243080885,40.0,0.0
24661,2,4661,[179  25  11  98  56],751,4,17712,3.799227799227799,0.0,20.0
24662,2,4662,[  9 405 269 135 271],805,2,17714,3.7988419472442634,0.0,0.0
24663,2,4663,[275   8 655  50 258],354,4,17718,3.7988850771869638,0.0,20.0
24664,2,4664,[301 202  98  11  71],416,5,17723,3.7991425509110397,0.0,20.0
24665,2,4665,[403 210 179  28 475],805,3,17726,3.7989712816116588,0.0,0.0
24666,2,4666,[211   1 181 515  97],416,5,17731,3.7992286265266766,0.0,20.0
24667,2,4667,[ 64  12 357 269 301],416,5,17736,3.7994858611825193,40.0,0.0
24668,2,4668,[ 64  12 357 269 301],416,5,17741,3.799742985650032,40.0,0.0
24669,2,4669,[ 64  12 357 269 301],416,5,17746,3.8,40.0,0.0
24670,2,4670,[234  96 403 423 301],416,5,17751,3.800256904303147,0.0,0.0
24671,2,4671,[111 234 273 228   4],805,1,17752,3.7996575342465753,0.0,0.0
24672,2,4672,[179 204  89 132 357],62,4,17756,3.799700406591055,0.0,0.0
24673,2,4673,[118  71 185 271 405],805,1,17757,3.799101412066752,0.0,0.0
24674,2,4674,[  7 288  28 196 185],297,4,17761,3.799144385026738,0.0,20.0
24675,2,4675,[ 25 195  11 273 210],618,2,17763,3.798759623609923,0.0,0.0
24676,2,4676,[ 69   1 276  64 118],764,3,17766,3.7985888389993585,20.0,0.0
24677,2,4677,[ 25 245 125 194 210],921,1,17767,3.797990594271056,0.0,0.0
24678,2,4678,[ 79 200 118 496  69],417,2,17769,3.7976063261380637,0.0,0.0
24679,2,4679,[ 64  12 357 269 301],416,5,17774,3.7978632478632477,40.0,0.0
24680,2,4680,[282 118  79  71 403],588,3,17777,3.7976928006836146,0.0,0.0
24681,2,4681,[132 471  22 403 168],618,4,17781,3.797736010252029,0.0,0.0
24682,2,4682,[144 423 515 294 222],417,3,17784,3.797565663036515,0.0,0.0
24683,2,4683,[286 202  12 357 191],417,5,17789,3.7978223740392827,20.0,0.0
24684,2,4684,[322 475  56 194 318],854,3,17792,3.7976520811099252,20.0,0.0
24685,2,4685,[196 483   4  98 117],62,5,17797,3.7979086641058473,20.0,20.0
24686,2,4686,[ 71 288 742 200  69],345,3,17800,3.797738425432046,0.0,20.0
24687,2,4687,[289 748  95 276 257],416,1,17801,3.797141638225256,0.0,0.0
24688,2,4688,[ 64  12 357 269 301],416,5,17806,3.7973981659202387,40.0,0.0
24689,2,4689,[235  25 597 328  96],854,0,17806,3.796588486140725,0.0,0.0
24690,2,4690,[191 286 196 200   4],416,5,17811,3.796845022383287,0.0,0.0
24691,2,4691,[742 273 183 173 200],416,5,17816,3.7971014492753623,0.0,0.0
24692,2,4692,[  4 238 181  22 268],297,4,17820,3.7971446835712763,0.0,20.0
24693,2,4693,[111 322 546 100 216],417,0,17820,3.7963357477631017,0.0,0.0
24694,2,4694,[ 64  12 357 269 301],416,5,17825,3.796592119275825,40.0,0.0
24695,2,4695,[678 258 100 475 238],805,4,17829,3.796635434412266,0.0,0.0
24696,2,4696,[403 204 132 268 302],345,4,17833,3.7966787311049606,0.0,0.0
24697,2,4697,[ 64  12 357 269 301],416,5,17838,3.796934865900383,40.0,0.0
24698,2,4698,[ 11  12 173  88 111],416,4,17842,3.7969780804426474,20.0,0.0
24699,2,4699,[ 64  12 357 269 301],416,5,17847,3.7972340425531916,40.0,0.0
24700,2,4700,[ 96 197 202 273 423],805,2,17849,3.7968517336736864,0.0,0.0
24701,2,4701,[211 276 282 288 174],416,4,17853,3.7968949383241175,0.0,20.0
24702,2,4702,[ 64  12 357 269 301],416,5,17858,3.7971507548373378,40.0,0.0
24703,2,4703,[313 174 318 301 151],345,5,17863,3.797406462585034,40.0,20.0
24704,2,4704,[ 64  12 357 269 301],416,5,17868,3.797662061636557,40.0,0.0
24705,2,4705,[288 271 357 111 161],805,1,17869,3.797067573310667,0.0,20.0
24706,2,4706,[ 69 185 273 172 655],618,5,17874,3.797323135755258,0.0,0.0
24707,2,4707,[471  97 168   4 275],297,3,17877,3.7971537807986406,0.0,0.0
24708,2,4708,[678 196 265 144 515],297,2,17879,3.7967721384582713,0.0,0.0
24709,2,4709,[333 265  98 195 273],416,5,17884,3.797027600849257,0.0,20.0
24710,2,4710,[ 64  12 357 269 301],416,5,17889,3.7972829547866693,40.0,0.0
24711,2,4711,[ 95 121  79 196  64],198,1,17890,3.7966893039049237,20.0,0.0
24712,2,4712,[405 258 237 568 234],642,2,17892,3.7963080840229155,0.0,0.0
24713,2,4713,[568 172 183 204 202],230,3,17895,3.796139159949088,0.0,0.0
24714,2,4714,[403  89  56 125 568],62,4,17899,3.7961823966065746,0.0,0.0
24715,2,4715,[ 64  12 357 269 301],416,5,17904,3.796437659033079,40.0,0.0
24716,2,4716,[ 88 588 496 216 182],618,4,17908,3.7964808140767436,0.0,0.0
24717,2,4717,[228 173 222 111 323],921,4,17912,3.7965239508266215,0.0,0.0
24718,2,4718,[202 210 238 185 435],354,2,17914,3.796143250688705,0.0,0.0
24719,2,4719,[237 427 471 197 143],618,3,17917,3.7959745762711865,0.0,0.0
24720,2,4720,[215 423 174  95 153],373,4,17921,3.7960177928405,0.0,0.0
24721,2,4721,[187 333 200 471 323],416,4,17925,3.7960609911054637,0.0,0.0
24722,2,4722,[237 405 135 186 143],198,2,17927,3.795680711412238,0.0,0.0
24723,2,4723,[135 185 423 385  64],405,4,17931,3.7957239627434376,20.0,0.0
24724,2,4724,[235   1 153 196 435],297,2,17933,3.7953439153439152,0.0,0.0
24725,2,4725,[100  22 216 588 333],253,4,17937,3.795387219636056,0.0,0.0
24726,2,4726,[  7 172 568 234 191],198,3,17940,3.795218954939708,0.0,0.0
24727,2,4727,[ 56  25 496  88 197],128,3,17943,3.7950507614213196,0.0,0.0
24728,2,4728,[174 100 151 185  98],416,4,17947,3.7950941002326073,0.0,20.0
24729,2,4729,[385 302 216  70 161],751,4,17951,3.795137420718816,0.0,0.0
24730,2,4730,[100 508 118  12 183],601,3,17954,3.794969351088565,20.0,0.0
24731,2,4731,[118 588 568  88 742],43,5,17959,3.7952240067624685,0.0,0.0
24732,2,4732,[210 323 269 174 118],345,3,17962,3.7950559898584406,0.0,0.0
24733,2,4733,[  7 151 168 597 496],417,2,17964,3.79467680608365,0.0,0.0
24734,2,4734,[ 64  12 357 269 301],416,5,17969,3.79493136219641,40.0,0.0
24735,2,4735,[ 64  12 357 269 301],416,5,17974,3.795185810810811,40.0,0.0
24736,2,4736,[ 64  12 357 269 301],416,5,17979,3.7954401519949337,40.0,0.0
24737,2,4737,[ 64  12 357 269 301],416,5,17984,3.7956943858168004,40.0,0.0
24738,2,4738,[678 215 313  56 125],345,3,17987,3.795526482380249,20.0,20.0
24739,2,4739,[117 100 742 151 258],52,5,17992,3.7957805907172997,0.0,0.0
24740,2,4740,[245 275 121 237 186],128,4,17996,3.7958236658932716,0.0,0.0
24741,2,4741,[151 186  70 302 546],417,3,17999,3.7956558414171235,0.0,0.0
24742,2,4742,[ 64  12 357 269 301],416,5,18004,3.795909761754164,40.0,0.0
24743,2,4743,[748 322 475 185 200],805,3,18007,3.795741989881956,0.0,0.0
24744,2,4744,[ 64  12 357 269 301],416,5,18012,3.795995785036881,40.0,0.0
24745,2,4745,[204 200 132 161 222],198,2,18014,3.795617361989043,0.0,0.0
24746,2,4746,[ 22 405 357 117 197],416,5,18019,3.795871076469349,0.0,0.0
24747,2,4747,[588 211 210 405 515],417,2,18021,3.795492839090143,0.0,0.0
24748,2,4748,[ 64  12 357 269 301],416,5,18026,3.795746472941672,40.0,0.0
24749,2,4749,[ 64  12 357 269 301],416,5,18031,3.796,40.0,0.0
24750,2,4750,[ 70 210 191  56  71],345,4,18035,3.796042938328773,0.0,0.0
24751,2,4751,[ 56 100  11   1 475],198,4,18039,3.7960858585858586,0.0,0.0
24752,2,4752,[ 64  12 357 269 301],416,5,18044,3.7963391542183884,40.0,0.0
24753,2,4753,[ 64  12 357 269 301],416,5,18049,3.796592343289861,40.0,0.0
24754,2,4754,[ 64  12 357 269 301],416,5,18054,3.7968454258675077,40.0,0.0
24755,2,4755,[427 210 216 111 403],416,5,18059,3.797098402018503,0.0,0.0
24756,2,4756,[ 64  12 357 269 301],416,5,18064,3.7973512718099642,40.0,0.0
24757,2,4757,[588 183  15 496  95],253,5,18069,3.7976040353089533,0.0,0.0
24758,2,4758,[655 117 181 275 173],128,4,18073,3.7976465644042867,0.0,20.0
24759,2,4759,[117 403 125 471  25],373,3,18076,3.7974789915966385,0.0,0.0
24760,2,4760,[121   4  95  79 153],654,5,18081,3.7977315689981097,0.0,0.0
24761,2,4761,[182 191 144 132 127],417,4,18085,3.7977740445191097,0.0,0.0
24762,2,4762,[168  50 174 100 204],43,5,18090,3.7980264539155995,0.0,20.0
24763,2,4763,[235  95 238 151 385],417,4,18094,3.7980688497061292,0.0,0.0
24764,2,4764,[ 64  12 357 269 301],416,5,18099,3.798321091290661,40.0,0.0
24765,2,4765,[127 202 257 286 121],416,4,18103,3.798363407469576,0.0,0.0
24766,2,4766,[ 64  12 357 269 301],416,5,18108,3.7986154814348647,40.0,0.0
24767,2,4767,[ 64  12 357 269 301],416,5,18113,3.7988674496644297,40.0,0.0
24768,2,4768,[471 357 435 174  22],721,5,18118,3.7991193122247853,0.0,0.0
24769,2,4769,[423 211  70 196 202],43,5,18123,3.79937106918239,0.0,0.0
24770,2,4770,[195 179 508  50 318],214,4,18127,3.7994131209390063,20.0,20.0
24771,2,4771,[ 64  12 357 269 301],416,5,18132,3.7996647108130763,40.0,0.0
24772,2,4772,[144 173  70 222  98],417,3,18135,3.799497171590195,0.0,20.0
24773,2,4773,[ 64  12 357 269 301],416,5,18140,3.7997486384583157,40.0,0.0
24774,2,4774,[173 238 144 196 204],43,4,18144,3.7997905759162305,0.0,0.0
24775,2,4775,[ 64  12 357 269 301],416,5,18149,3.800041876046901,40.0,0.0
24776,2,4776,[ 64  12 357 269 301],416,5,18154,3.800293070965041,40.0,0.0
24777,2,4777,[118 127 385 276  28],43,5,18159,3.80054416073671,0.0,0.0
24778,2,4778,[288 143 357   8 144],805,1,18160,3.799958150240636,0.0,20.0
24779,2,4779,[ 64  12 357 269 301],416,5,18165,3.8002092050209204,40.0,0.0
24780,2,4780,[168 216  69  98 257],654,5,18170,3.800460154779335,0.0,20.0
24781,2,4781,[286 210  69  95 195],437,1,18171,3.799874529485571,0.0,0.0
24782,2,4782,[ 64  12 357 269 301],416,5,18176,3.8001254442818313,40.0,0.0
24783,2,4783,[  8 121 181  22 186],711,3,18179,3.799958193979933,0.0,20.0
24784,2,4784,[ 97 121 603 276 117],437,2,18181,3.799582027168234,0.0,0.0
24785,2,4785,[ 64  12 357 269 301],416,5,18186,3.7998328458002506,40.0,0.0
24786,2,4786,[ 64  12 357 269 301],416,5,18191,3.8000835596406937,40.0,0.0
24787,2,4787,[ 97 483 269 265  69],711,3,18194,3.799916457811195,20.0,0.0
24788,2,4788,[ 64  12 357 269 301],416,5,18199,3.8001670494884108,40.0,0.0
24789,2,4789,[302  11 357 235 121],416,4,18203,3.800208768267223,0.0,0.0
24790,2,4790,[191 181 742 294 403],416,5,18208,3.800459194322688,0.0,20.0
24791,2,4791,[191 385 173 185  64],417,4,18212,3.800500834724541,20.0,0.0
24792,2,4792,[  8  15 328  56 118],416,4,18216,3.8005424577508866,0.0,0.0
24793,2,4793,[302 234 257 286 196],417,3,18219,3.8003754693366707,0.0,0.0
24794,2,4794,[200 204 173 161   7],618,3,18222,3.800208550573514,0.0,0.0
24795,2,4795,[ 64  12 357 269 301],416,5,18227,3.80045871559633,40.0,0.0
24796,2,4796,[ 25 161 588 174  88],128,3,18230,3.800291849072337,0.0,0.0
24797,2,4797,[143 121 275  25 597],654,4,18234,3.8003334722801165,0.0,0.0
24798,2,4798,[  4 172 546   1 151],654,5,18239,3.800583454886435,0.0,0.0
24799,2,4799,[111  70 276 508 237],128,3,18242,3.8004166666666666,0.0,0.0
24800,2,4800,[ 82 258 153 100 172],805,3,18245,3.800249947927515,0.0,0.0
24801,2,4801,[ 79 125  82 174  88],505,3,18248,3.8000832986255726,0.0,0.0
24802,2,4802,[ 64  12 357 269 301],416,5,18253,3.800333125130127,40.0,0.0
24803,2,4803,[ 12 215 301 471 202],297,2,18255,3.7999583680266444,20.0,0.0
24804,2,4804,[ 64  12 357 269 301],416,5,18260,3.8002081165452655,40.0,0.0
24805,2,4805,[357 228 286 245 175],297,3,18263,3.8000416146483564,0.0,0.0
24806,2,4806,[ 64  12 357 269 301],416,5,18268,3.8002912419388393,40.0,0.0
24807,2,4807,[ 98 222 173 357  82],601,3,18271,3.800124792013311,0.0,20.0
24808,2,4808,[222 180 132 245  11],417,4,18275,3.8001663547515077,0.0,0.0
24809,2,4809,[508  70 216 132 265],417,2,18277,3.7997920997921,0.0,0.0
24810,2,4810,[211 258 143  69 294],297,3,18280,3.799625857410102,0.0,0.0
24811,2,4811,[515 121 125  64 357],416,5,18285,3.7998753117206983,20.0,0.0
24812,2,4812,[186 294 742  97 471],43,3,18288,3.799709121130272,0.0,0.0
24813,2,4813,[ 64  12 357 269 301],416,5,18293,3.799958454507686,40.0,0.0
24814,2,4814,[ 64  12 357 269 301],416,5,18298,3.800207684319834,40.0,0.0
24815,2,4815,[210 294 328 196 204],62,2,18300,3.7998338870431896,0.0,0.0
24816,2,4816,[135 195  79 175 357],373,3,18303,3.7996678430558437,0.0,0.0
24817,2,4817,[238  12 282 268  95],654,3,18306,3.7995018679950188,20.0,0.0
24818,2,4818,[228 508 125 268  69],417,2,18308,3.7991284498858686,0.0,0.0
24819,2,4819,[ 64  12 357 269 301],416,5,18313,3.7993775933609957,40.0,0.0
24820,2,4820,[ 64  12 357 269 301],416,5,18318,3.7996266334785314,40.0,0.0
24821,2,4821,[215  79   8 275 172],437,4,18322,3.799668187474077,0.0,0.0
24822,2,4822,[111 183  97 195  79],297,2,18324,3.7992950445780633,0.0,0.0
24823,2,4823,[ 64  12 357 269 301],416,5,18329,3.7995439469320065,40.0,0.0
24824,2,4824,[  9  89 215 135 132],62,4,18333,3.7995854922279793,0.0,0.0
24825,2,4825,[ 64  12 357 269 301],416,5,18338,3.79983423124741,40.0,0.0
24826,2,4826,[ 22 588 257 151 258],711,4,18342,3.799875699192045,0.0,0.0
24827,2,4827,[215   8 385 423  12],405,4,18346,3.799917149958575,20.0,0.0
24828,2,4828,[ 82 268  96 322 282],416,4,18350,3.7999585835576726,0.0,0.0
24829,2,4829,[ 64  12 357 269 301],416,5,18355,3.800207039337474,40.0,0.0
24830,2,4830,[ 64  12 357 269 301],416,5,18360,3.8004553922583315,40.0,0.0
24831,2,4831,[117 234 176 245 143],297,3,18363,3.8002897350993377,0.0,0.0
24832,2,4832,[117 172 118   8 151],437,3,18366,3.8001241464928617,0.0,0.0
24833,2,4833,[127 195 276 174 161],198,2,18368,3.7997517583781546,0.0,0.0
24834,2,4834,[  4 235 238 655 322],416,3,18371,3.799586349534643,0.0,0.0
24835,2,4835,[ 50 185 196 228  69],230,4,18375,3.7996277915632755,0.0,20.0
24836,2,4836,[ 64  12 357 269 301],416,5,18380,3.7998759561711806,40.0,0.0
24837,2,4837,[385 151 174 269  95],416,3,18383,3.799710624224886,0.0,0.0
24838,2,4838,[ 64  12 357 269 301],416,5,18388,3.799958669146518,40.0,0.0
24839,2,4839,[175 588 172  25 187],698,2,18390,3.799586776859504,0.0,0.0
24840,2,4840,[423 318 237 222 111],854,3,18393,3.7994216071059697,20.0,0.0
24841,2,4841,[276 153  12  79 172],43,5,18398,3.7996695580338704,20.0,0.0
24842,2,4842,[318 191   1 385 181],198,4,18402,3.799710922981623,20.0,20.0
24843,2,4843,[313 588  95  89 597],751,2,18404,3.7993393889347646,20.0,20.0
24844,2,4844,[289 234 318 655 181],345,4,18408,3.7993808049535605,20.0,20.0
24845,2,4845,[  4 197 183   1  88],805,3,18411,3.7992158481221625,0.0,0.0
24846,2,4846,[323  70  12 183 181],416,4,18415,3.799257272539715,20.0,20.0
24847,2,4847,[ 64  12 357 269 301],416,5,18420,3.7995049504950495,40.0,0.0
24848,2,4848,[ 69 423 286 268 185],297,3,18423,3.79934007011755,0.0,0.0
24849,2,4849,[588 222 210 268 173],128,3,18426,3.799175257731959,0.0,0.0
24850,2,4850,[286 318  70 323 181],345,3,18429,3.7990105132962277,20.0,20.0
24851,2,4851,[ 64  12 357 269 301],416,5,18434,3.799258037922506,40.0,0.0
24852,2,4852,[111 222  95 204 258],297,2,18436,3.7988872862147125,0.0,0.0
24853,2,4853,[ 64  12 357 269 301],416,5,18441,3.7991347342398023,40.0,0.0
24854,2,4854,[ 64  12 357 269 301],416,5,18446,3.7993820803295573,40.0,0.0
24855,2,4855,[195 100 200 385 235],805,2,18448,3.799011532125206,0.0,0.0
24856,2,4856,[ 70 191  79 286  97],297,3,18451,3.7988470249124973,0.0,0.0
24857,2,4857,[ 64  12 357 269 301],416,5,18456,3.7990942774804446,40.0,0.0
24858,2,4858,[ 96 144 187 183 271],505,2,18458,3.798724017287508,0.0,0.0
24859,2,4859,[200 125  56  70 151],345,4,18462,3.7987654320987656,0.0,0.0
24860,2,4860,[302 144 286 100 546],416,4,18466,3.798806829870397,0.0,0.0
24861,2,4861,[ 64  12 357 269 301],416,5,18471,3.7990538872891815,40.0,0.0
24862,2,4862,[111 385 405  98 403],417,3,18474,3.798889574336829,0.0,20.0
24863,2,4863,[318 258 385 172 151],887,4,18478,3.7989309210526314,20.0,0.0
24864,2,4864,[196  50 568 655 323],198,2,18480,3.7985611510791366,0.0,20.0
24865,2,4865,[ 79 125  96 588 678],416,4,18484,3.7986025482942867,0.0,0.0
24866,2,4866,[403  69 273 151 216],618,3,18487,3.7984384631189645,0.0,0.0
24867,2,4867,[202 748   1  11 268],417,5,18492,3.7986852917009037,0.0,0.0
24868,2,4868,[357 175   4 117 153],198,2,18494,3.798315875949887,0.0,0.0
24869,2,4869,[ 89 238 475 202 183],805,4,18498,3.7983572895277207,0.0,0.0
24870,2,4870,[ 64  12 357 269 301],416,5,18503,3.7986039827550813,40.0,0.0
24871,2,4871,[385  95  12 132  97],416,4,18507,3.7986453201970445,20.0,0.0
24872,2,4872,[ 64  12 357 269 301],416,5,18512,3.7988918530679254,40.0,0.0
24873,2,4873,[546  98   7 471 183],297,3,18515,3.7987279441936805,0.0,20.0
24874,2,4874,[ 64  12 357 269 301],416,5,18520,3.798974358974359,40.0,0.0
24875,2,4875,[289 117 187 176 515],416,4,18524,3.7990155865463495,0.0,0.0
24876,2,4876,[  1 173 191 275 117],764,3,18527,3.798851753126922,0.0,0.0
24877,2,4877,[603 237  50 153 301],751,4,18531,3.7988929889298895,0.0,20.0
24878,2,4878,[ 64  12 357 269 301],416,5,18536,3.799139167862267,40.0,0.0
24879,2,4879,[245 323 172  96  82],417,2,18538,3.7987704918032787,0.0,0.0
24880,2,4880,[ 64  12 357 269 301],416,5,18543,3.799016594960049,40.0,0.0
24881,2,4881,[ 64  12 357 269 301],416,5,18548,3.79926259729619,40.0,0.0
24882,2,4882,[173  95 483 603  89],437,4,18552,3.7993037067376614,20.0,0.0
24883,2,4883,[ 64  12 357 269 301],416,5,18557,3.7995495495495497,40.0,0.0
24884,2,4884,[269 275 357 286 202],373,3,18560,3.7993858751279426,0.0,0.0
24885,2,4885,[144 176 204 111  82],416,5,18565,3.799631600491199,0.0,0.0
24886,2,4886,[100 238 568 588 215],43,4,18569,3.799672600777573,0.0,0.0
24887,2,4887,[ 64  12 357 269 301],416,5,18574,3.7999181669394435,40.0,0.0
24888,2,4888,[ 79  95 435  97 144],297,1,18575,3.7993454694211497,0.0,0.0
24889,2,4889,[ 88 210  96 742 258],805,1,18576,3.798773006134969,0.0,0.0
24890,2,4890,[151 742 143 273 597],805,1,18577,3.7982007769372315,0.0,0.0
24891,2,4891,[ 64  12 357 269 301],416,5,18582,3.7984464431725264,40.0,0.0
24892,2,4892,[228  82  12  56   8],62,4,18586,3.798487635397507,20.0,0.0
24893,2,4893,[ 64  12 357 269 301],416,5,18591,3.798733142623621,40.0,0.0
24894,2,4894,[269  12 181  56 508],297,5,18596,3.7989785495403474,20.0,20.0
24895,2,4895,[385   7 357 135 678],805,4,18600,3.799019607843137,0.0,0.0
24896,2,4896,[ 64  12 357 269 301],416,5,18605,3.7992648560343065,40.0,0.0
24897,2,4897,[ 64  12 357 269 301],416,5,18610,3.799510004083299,40.0,0.0
24898,2,4898,[118 179  28  79 174],437,3,18613,3.799346805470504,0.0,0.0
24899,2,4899,[153 483  12 294 289],342,3,18616,3.7991836734693876,40.0,0.0
24900,2,4900,[475 748 322 275 117],907,4,18620,3.799224648031014,0.0,0.0
24901,2,4901,[ 64  12 357 269 301],416,5,18625,3.799469604243166,40.0,0.0
24902,2,4902,[275 678 546 313 211],416,3,18628,3.7993065470120335,20.0,20.0
24903,2,4903,[597  28 235   4  71],43,3,18631,3.7991435562805873,0.0,0.0
24904,2,4904,[144  88 655 143 568],416,4,18635,3.799184505606524,0.0,0.0
24905,2,4905,[ 64  12 357 269 301],416,5,18640,3.7994292702812884,40.0,0.0
24906,2,4906,[ 64  12 357 269 301],416,5,18645,3.79967393519462,40.0,0.0
24907,2,4907,[268 100 496 182  88],907,5,18650,3.799918500407498,0.0,0.0
24908,2,4908,[125   8 427 173  95],416,4,18654,3.799959258504787,0.0,0.0
24909,2,4909,[ 64  12 357 269 301],416,5,18659,3.8002036659877803,40.0,0.0
24910,2,4910,[  1  79 196 282 357],416,5,18664,3.8004479739360617,0.0,0.0
24911,2,4911,[403 100   9 210 121],416,5,18669,3.8006921824104234,0.0,0.0
24912,2,4912,[180 132  22  98 200],887,3,18672,3.8005292082230815,0.0,20.0
24913,2,4913,[ 64  12 357 269 301],416,5,18677,3.800773300773301,40.0,0.0
24914,2,4914,[385 294 121   4 182],416,5,18682,3.8010172939979654,0.0,0.0
24915,2,4915,[ 12  71  70 191  95],405,2,18684,3.8006509357200975,20.0,0.0
24916,2,4916,[215 204 286  97 475],588,3,18687,3.800488102501525,0.0,0.0
24917,2,4917,[ 69 234 475 176 175],198,3,18690,3.8003253355022366,0.0,0.0
24918,2,4918,[153   1 328 300 181],43,5,18695,3.8005692213864606,0.0,20.0
24919,2,4919,[194 215 238  98 191],297,2,18697,3.8002032520325204,0.0,20.0
24920,2,4920,[288 100   8 257  79],214,3,18700,3.8000406421459054,0.0,20.0
24921,2,4921,[ 64  12 357 269 301],416,5,18705,3.800284437220642,40.0,0.0
24922,2,4922,[322 216  70 100 237],630,2,18707,3.799918748730449,0.0,0.0
24923,2,4923,[ 64  12 357 269 301],416,5,18712,3.800162469536962,40.0,0.0
24924,2,4924,[289 187 153 568 475],416,3,18715,3.8,0.0,0.0
24925,2,4925,[ 89 271  50 125 180],854,4,18719,3.8000406008932197,0.0,20.0
24926,2,4926,[ 28 496  98 144 182],416,5,18724,3.800284148569109,0.0,20.0
24927,2,4927,[ 64  12 357 269 301],416,5,18729,3.8005275974025974,40.0,0.0
24928,2,4928,[ 96  22 111 496 275],416,5,18734,3.8007709474538447,0.0,0.0
24929,2,4929,[546 153  56 216 215],62,4,18738,3.800811359026369,0.0,0.0
24930,2,4930,[ 64  12 357 269 301],416,5,18743,3.801054552829041,40.0,0.0
24931,2,4931,[117 182 211 265  25],417,3,18746,3.8008921330089214,0.0,0.0
24932,2,4932,[ 64  12 357 269 301],416,5,18751,3.8011352118386377,40.0,0.0
24933,2,4933,[257 245 181 174  25],297,3,18754,3.8009728415079045,0.0,20.0
24934,2,4934,[322 275 197 282 216],128,3,18757,3.80081053698075,0.0,0.0
24935,2,4935,[174 181 228 153 125],721,4,18761,3.8008508914100485,0.0,20.0
24936,2,4936,[222 191 172   7 121],805,4,18765,3.800891229491594,0.0,0.0
24937,2,4937,[151 215 313 323 181],416,3,18768,3.800729040097205,20.0,40.0
24938,2,4938,[475 234 268 294 288],297,2,18770,3.800364446244179,0.0,20.0
24939,2,4939,[210 423 175 300 222],43,4,18774,3.8004048582995953,0.0,0.0
24940,2,4940,[176 288 121 210 471],416,5,18779,3.800647642177697,0.0,20.0
24941,2,4941,[588 257   7 121 475],417,1,18780,3.800080938891137,0.0,0.0
24942,2,4942,[181 288 238 216 294],297,3,18783,3.7999190774833096,0.0,40.0
24943,2,4943,[118   7 200 276 111],416,3,18786,3.799757281553398,0.0,0.0
24944,2,4944,[288 125 427  11 185],416,5,18791,3.8,0.0,20.0
24945,2,4945,[197 211 186 151 135],373,3,18794,3.7998382531338457,0.0,0.0
24946,2,4946,[282 200 313  88 234],618,4,18798,3.7998787143723467,20.0,20.0
24947,2,4947,[294  71  82 111 546],654,3,18801,3.799717057396928,0.0,0.0
24948,2,4948,[ 64  12 357 269 301],416,5,18806,3.7999595877955143,40.0,0.0
24949,2,4949,[117 194 245 423 269],297,2,18808,3.7995959595959596,0.0,0.0
24950,2,4950,[ 50 289   1 118 286],588,3,18811,3.799434457685316,0.0,20.0
24951,2,4951,[ 64  12 357 269 301],416,5,18816,3.7996768982229403,40.0,0.0
24952,2,4952,[173 143 200  96   4],49,0,18816,3.7989097516656574,0.0,0.0
24953,2,4953,[ 64  12 357 269 301],416,5,18821,3.7991522002422284,40.0,0.0
24954,2,4954,[151 568  82   4 173],62,4,18825,3.7991927346115038,0.0,0.0
24955,2,4955,[215 143  56 385 174],416,5,18830,3.7994350282485874,0.0,0.0
24956,2,4956,[245 132 176 275   1],764,5,18835,3.7996772241274965,0.0,0.0
24957,2,4957,[ 88  12 143 568 271],43,4,18839,3.799717628075837,20.0,0.0
24958,2,4958,[ 64  12 357 269 301],416,5,18844,3.799959669288163,40.0,0.0
24959,2,4959,[173 182 475 238  22],214,4,18848,3.8,0.0,0.0
24960,2,4960,[234 237 204 191  64],345,5,18853,3.8002418867163876,20.0,0.0
24961,2,4961,[195 748 181 655 180],805,0,18853,3.799476017734784,0.0,20.0
24962,2,4962,[234 235 742 515 185],297,2,18855,3.7991134394519444,0.0,0.0
24963,2,4963,[127  82 179  79 678],805,3,18858,3.798952457695407,0.0,0.0
24964,2,4964,[275 234 183  98 273],297,4,18862,3.798992950654582,0.0,20.0
24965,2,4965,[257 111 143 403 471],43,4,18866,3.7990334273056785,0.0,0.0
24966,2,4966,[ 56  50 568 222  97],654,4,18870,3.7990738876585466,0.0,20.0
24967,2,4967,[ 96 100   1 117  82],230,4,18874,3.7991143317230276,0.0,0.0
24968,2,4968,[118 238  50 435 678],297,2,18876,3.7987522640370295,0.0,20.0
24969,2,4969,[546   4 655 211 588],416,4,18880,3.7987927565392354,0.0,0.0
24970,2,4970,[132 168 181 288 191],711,4,18884,3.7988332327499497,0.0,40.0
24971,2,4971,[ 79 568 235 121 144],416,4,18888,3.7988736926790025,0.0,0.0
24972,2,4972,[237  88  50 655 427],618,5,18893,3.7991152221998794,0.0,20.0
24973,2,4973,[ 70 127 211   4 588],417,3,18896,3.7989545637314035,0.0,0.0
24974,2,4974,[151 200  25 153 161],417,3,18899,3.798793969849246,0.0,0.0
24975,2,4975,[ 71 269 301 191  11],345,4,18903,3.7988344051446945,0.0,0.0
24976,2,4976,[ 64  12 357 269 301],416,5,18908,3.7990757484428372,40.0,0.0
24977,2,4977,[318 200 118   7  22],416,4,18912,3.7991161108879066,20.0,0.0
24978,2,4978,[202 185 191  82  50],405,5,18917,3.7993573006627837,0.0,20.0
24979,2,4979,[216 179 172 742 597],62,3,18920,3.7991967871485945,0.0,0.0
24980,2,4980,[ 64  12 357 269 301],416,5,18925,3.7994378638827544,40.0,0.0
24981,2,4981,[ 64  12 357 269 301],416,5,18930,3.799678843837816,40.0,0.0
24982,2,4982,[289 168 257 269  64],854,3,18933,3.79951836243227,20.0,0.0
24983,2,4983,[ 64  12 357 269 301],416,5,18938,3.7997592295345104,40.0,0.0
24984,2,4984,[ 64  12 357 269 301],416,5,18943,3.8,40.0,0.0
24985,2,4985,[ 64  12 357 269 301],416,5,18948,3.8002406738868832,40.0,0.0
24986,2,4986,[176  71 515  22 238],405,2,18950,3.7998796871866856,0.0,0.0
24987,2,4987,[  4 228 135 180 322],805,1,18951,3.799318364073777,0.0,0.0
24988,2,4988,[ 64  12 357 269 301],416,5,18956,3.7995590298657045,40.0,0.0
24989,2,4989,[ 64  12 357 269 301],416,5,18961,3.799799599198397,40.0,0.0
24990,2,4990,[ 64  12 357 269 301],416,5,18966,3.8000400721298337,40.0,0.0
24991,2,4991,[678 132 289 546 323],416,1,18967,3.7994791666666665,0.0,0.0
24992,2,4992,[288 237 172 200  11],922,3,18970,3.7993190466653313,0.0,20.0
24993,2,4993,[ 64  12 357 269 301],416,5,18975,3.799559471365639,40.0,0.0
24994,2,4994,[118 121  64 483 117],854,2,18977,3.799199199199199,40.0,0.0
24995,2,4995,[121 127  96 151 228],198,3,18980,3.799039231385108,0.0,0.0
24996,2,4996,[ 28 204  70 187  15],416,5,18985,3.7992795677406446,0.0,0.0
24997,2,4997,[427 132 216 228 357],405,3,18988,3.799119647859144,0.0,0.0
24998,2,4998,[ 64  12 357 269 301],416,5,18993,3.799359871974395,40.0,0.0
24999,2,4999,[ 64  12 357 269 301],416,5,18998,3.7996,40.0,0.0
25000,2,5000,[ 15 191 405 385 496],417,3,19001,3.7994401119776047,0.0,0.0
25001,2,5001,[276 211  11  98  89],437,3,19004,3.799280287884846,0.0,20.0
25002,2,5002,[265  82  96 216 204],373,4,19008,3.7993204077553466,0.0,0.0
25003,2,5003,[  7 196 173 222 191],62,5,19013,3.799560351718625,0.0,0.0
25004,2,5004,[  7 288 385   4 215],416,5,19018,3.7998001998002,0.0,20.0
25005,2,5005,[ 64  12 357 269 301],416,5,19023,3.800039952057531,40.0,0.0
25006,2,5006,[678 423   4 235 196],805,1,19024,3.799480726982225,0.0,0.0
25007,2,5007,[215 202 121 588 216],416,5,19029,3.799720447284345,0.0,0.0
25008,2,5008,[185 302 174 183 286],416,5,19034,3.799960071870633,0.0,0.0
25009,2,5009,[427  50  71 183 185],618,5,19039,3.800199600798403,0.0,20.0
25010,2,5010,[ 64  12 357 269 301],416,5,19044,3.800439034124925,40.0,0.0
25011,2,5011,[197 385 186 597 187],618,4,19048,3.8004788507581804,0.0,0.0
25012,2,5012,[238 508 100 288 180],62,4,19052,3.800518651506084,0.0,20.0
25013,2,5013,[174 333 216 125 211],416,5,19057,3.8007578779417632,0.0,0.0
25014,2,5014,[286 172 257 403  97],416,4,19061,3.8007976071784646,0.0,0.0
25015,2,5015,[546  98 475 276 176],62,5,19066,3.80103668261563,0.0,20.0
25016,2,5016,[ 64  12 357 269 301],416,5,19071,3.8012756627466615,40.0,0.0
25017,2,5017,[  4 173 496 276   9],416,4,19075,3.801315265045835,0.0,0.0
25018,2,5018,[ 64 286 132 238 294],24,3,19078,3.8011556086869893,20.0,0.0
25019,2,5019,[333 153 300 202   7],416,5,19083,3.801394422310757,0.0,0.0
25020,2,5020,[ 69 655  95 125 173],588,2,19085,3.801035650268871,0.0,0.0
25021,2,5021,[174 245  95 118 748],297,1,19086,3.8004778972520907,0.0,0.0
25022,2,5022,[288 597   1  97  79],417,2,19088,3.800119450527573,0.0,20.0
25023,2,5023,[405 294 257 318 216],38,3,19091,3.7999601910828025,20.0,0.0
25024,2,5024,[ 64  12 357 269 301],416,5,19096,3.8001990049751244,40.0,0.0
25025,2,5025,[172 328 191 216 180],62,4,19100,3.8002387584560284,0.0,0.0
25026,2,5026,[ 64  12 357 269 301],416,5,19105,3.8004774219216233,40.0,0.0
25027,2,5027,[  8  88   1 678 100],588,3,19108,3.800318217979316,0.0,0.0
25028,2,5028,[151 423 328 121 282],854,2,19110,3.7999602306621596,0.0,0.0
25029,2,5029,[153 216  56 235 269],854,3,19113,3.7998011928429425,0.0,0.0
25030,2,5030,[100 175 118 173 288],297,3,19116,3.7996422182468694,0.0,20.0
25031,2,5031,[144 151 273 196 202],618,3,19119,3.799483306836248,0.0,0.0
25032,2,5032,[ 64  12 357 269 301],416,5,19124,3.799721835883171,40.0,0.0
25033,2,5033,[ 64  12 357 269 301],416,5,19129,3.7999602701628925,40.0,0.0
25034,2,5034,[678 257 153 197 117],416,3,19132,3.799801390268123,0.0,0.0
25035,2,5035,[ 64  12 357 269 301],416,5,19137,3.800039714058777,40.0,0.0
25036,2,5036,[ 64  12 357 269 301],416,5,19142,3.8002779432201708,40.0,0.0
25037,2,5037,[182 568 202 475 235],416,3,19145,3.8001190948789203,0.0,0.0
25038,2,5038,[ 88 275   1 144 196],416,4,19149,3.8001587616590595,0.0,0.0
25039,2,5039,[ 96 191 288 151 195],417,3,19152,3.8,0.0,20.0
25040,2,5040,[182 678 179 197 427],416,3,19155,3.7998413013291015,0.0,0.0
25041,2,5041,[191 282 313   8 655],416,5,19160,3.8000793335977785,20.0,20.0
25042,2,5042,[568 168 121 235 471],416,4,19164,3.8001189767995243,0.0,0.0
25043,2,5043,[ 64  12 357 269 301],416,5,19169,3.80035685963521,40.0,0.0
25044,2,5044,[144  56 258  98 173],417,4,19173,3.800396432111001,0.0,20.0
25045,2,5045,[153 135 265   1 204],922,3,19176,3.8002378121284184,0.0,0.0
25046,2,5046,[  4 204  69   9 117],416,5,19181,3.8004755300178323,0.0,0.0
25047,2,5047,[265 313 427 215 182],618,5,19186,3.800713153724247,20.0,20.0
25048,2,5048,[ 25 328 161   7 597],43,4,19190,3.800752624282036,0.0,0.0
25049,2,5049,[ 64  12 357 269 301],416,5,19195,3.800990099009901,40.0,0.0
25050,2,5050,[ 64  12 357 269 301],416,5,19200,3.8012274797069887,40.0,0.0
25051,2,5051,[ 64  12 357 269 301],416,5,19205,3.8014647664291368,40.0,0.0
25052,2,5052,[ 95  70   8 238 313],405,3,19208,3.8013061547595486,20.0,20.0
25053,2,5053,[ 64  12 357 269 301],416,5,19213,3.801543332014246,40.0,0.0
25054,2,5054,[185 289 328 475 216],416,3,19216,3.8013847675568746,0.0,0.0
25055,2,5055,[ 64  12 357 269 301],416,5,19221,3.8016218354430378,40.0,0.0
25056,2,5056,[  7  71 228 234 265],230,3,19224,3.80146331817283,0.0,0.0
25057,2,5057,[191 546 258 135 515],297,3,19227,3.801304863582444,0.0,0.0
25058,2,5058,[273  69 258 185  98],297,4,19231,3.8013441391579366,0.0,20.0
25059,2,5059,[183 748 135 215 210],198,4,19235,3.8013833992094863,0.0,0.0
25060,2,5060,[ 69 197  98 333 508],854,4,19239,3.801422643746295,0.0,20.0
25061,2,5061,[182 294  97  82 174],128,3,19242,3.8012643224022127,0.0,0.0
25062,2,5062,[215 257   9  25 238],416,4,19246,3.80130357495556,0.0,0.0
25063,2,5063,[678 273  11  56 294],805,2,19248,3.800947867298578,0.0,0.0
25064,2,5064,[132 403 322 168 151],416,3,19251,3.8007897334649554,0.0,0.0
25065,2,5065,[ 50 258 276 546 471],416,3,19254,3.8006316620607974,0.0,20.0
25066,2,5066,[289 301  25 258 405],345,3,19257,3.8004736530491416,0.0,0.0
25067,2,5067,[ 64  12 357 269 301],416,5,19262,3.8007103393843726,40.0,0.0
25068,2,5068,[265  96 111  22 289],416,4,19266,3.800749654764253,0.0,0.0
25069,2,5069,[ 64  12 357 269 301],416,5,19271,3.8009861932938858,40.0,0.0
25070,2,5070,[118 195  95  28  25],618,1,19272,3.8004338394793926,0.0,0.0
25071,2,5071,[238 204 603  95 216],405,2,19274,3.800078864353312,0.0,0.0
25072,2,5072,[546  12 235 496 127],43,4,19278,3.8001182732111176,20.0,0.0
25073,2,5073,[ 64  12 357 269 301],416,5,19283,3.800354749704375,40.0,0.0
25074,2,5074,[ 64  12 357 269 301],416,5,19288,3.800591133004926,40.0,0.0
25075,2,5075,[385 168 211 318 427],405,2,19290,3.800236406619385,20.0,0.0
25076,2,5076,[172 153 191 185 294],417,3,19293,3.80007878668505,0.0,0.0
25077,2,5077,[245 294 475 180 144],417,4,19297,3.800118156754628,0.0,0.0
25078,2,5078,[ 64  12 357 269 301],416,5,19302,3.800354400472534,40.0,0.0
25079,2,5079,[302 117 323 210 313],43,4,19306,3.8003937007874016,20.0,20.0
25080,2,5080,[  8 655 300 423 197],721,4,19310,3.8004329856327494,0.0,0.0
25081,2,5081,[ 64  12 357 269 301],416,5,19315,3.800669027941755,40.0,0.0
25082,2,5082,[ 97  82 257 204 475],62,2,19317,3.800314774739327,0.0,0.0
25083,2,5083,[ 22 202  69  64  56],764,5,19322,3.8005507474429585,20.0,0.0
25084,2,5084,[ 64  12 357 269 301],416,5,19327,3.8007866273352997,40.0,0.0
25085,2,5085,[181 153 271 117 202],297,3,19330,3.80062917813606,0.0,20.0
25086,2,5086,[ 64  12 357 269 301],416,5,19335,3.8008649498722233,40.0,0.0
25087,2,5087,[ 64  12 357 269 301],416,5,19340,3.8011006289308176,40.0,0.0
25088,2,5088,[173 100  15 237 568],654,3,19343,3.8009432108469245,0.0,0.0
25089,2,5089,[286 323  56 234  64],345,3,19346,3.8007858546168958,20.0,0.0
25090,2,5090,[ 64  12 357 269 301],416,5,19351,3.801021410331958,40.0,0.0
25091,2,5091,[ 64  12 357 269 301],416,5,19356,3.8012568735271013,40.0,0.0
25092,2,5092,[210 496 235 423 222],43,4,19360,3.801295896328294,0.0,0.0
25093,2,5093,[175 183  56 202 403],922,1,19361,3.8007459756576365,0.0,0.0
25094,2,5094,[300 183 172 191 135],698,2,19363,3.8003925417075566,0.0,0.0
25095,2,5095,[ 64  12 357 269 301],416,5,19368,3.8006279434850865,40.0,0.0
25096,2,5096,[135 301  89 200 265],297,3,19371,3.8004708652148325,0.0,0.0
25097,2,5097,[286 117 144 273 172],417,2,19373,3.8001176932130245,0.0,0.0
25098,2,5098,[271   7 471 302 588],43,3,19376,3.7999607766228674,0.0,0.0
25099,2,5099,[ 64  12 357 269 301],416,5,19381,3.8001960784313726,40.0,0.0
25100,2,5100,[ 64  12 357 269 301],416,5,19386,3.8004312879827484,40.0,0.0
25101,2,5101,[ 64  12 357 269 301],416,5,19391,3.8006664053312424,40.0,0.0
25102,2,5102,[174 265  28  56 238],128,3,19394,3.800509504213208,0.0,0.0
25103,2,5103,[151 172 202 197 200],345,4,19398,3.800548589341693,0.0,0.0
25104,2,5104,[132 234 496   8 111],437,4,19402,3.8005876591576886,0.0,0.0
25105,2,5105,[  1 322 403 125 245],417,4,19406,3.800626713670192,0.0,0.0
25106,2,5106,[318 289  70 174 300],416,4,19410,3.8006657528881926,20.0,0.0
25107,2,5107,[ 56 269  98 144 385],416,5,19415,3.8009005481597495,0.0,20.0
25108,2,5108,[ 70  12 202 135 234],618,3,19418,3.8007437854766097,20.0,0.0
25109,2,5109,[ 64  12 357 269 301],416,5,19423,3.800978473581213,40.0,0.0
25110,2,5110,[ 64  12 357 269 301],416,5,19428,3.8012130698493447,40.0,0.0
25111,2,5111,[151 173  56 471 182],618,2,19430,3.8008607198748043,0.0,0.0
25112,2,5112,[111  82 294 288  98],417,3,19433,3.800704087619793,0.0,40.0
25113,2,5113,[ 98   8 181 121 125],620,3,19436,3.80054751662104,0.0,40.0
25114,2,5114,[ 64  12 357 269 301],416,5,19441,3.8007820136852395,40.0,0.0
25115,2,5115,[181 257 222 603 180],354,2,19443,3.800430023455825,0.0,20.0
25116,2,5116,[ 70 121 405 100  50],654,4,19447,3.80046902481923,0.0,20.0
25117,2,5117,[111 182 185 228 742],417,1,19448,3.799921844470496,0.0,0.0
25118,2,5118,[ 82 496 202 187 215],373,2,19450,3.7995702285602655,0.0,0.0
25119,2,5119,[357 117 125 153  64],62,5,19455,3.7998046875,20.0,0.0
25120,2,5120,[197  95 222 135   9],805,3,19458,3.7996485061511422,0.0,0.0
25121,2,5121,[483 200 186  56 328],854,3,19461,3.799492385786802,20.0,0.0
25122,2,5122,[ 64  12 357 269 301],416,5,19466,3.799726722623463,40.0,0.0
25123,2,5123,[ 64  12 357 269 301],416,5,19471,3.799960967993755,40.0,0.0
25124,2,5124,[100  95 185   8 183],230,4,19475,3.8,0.0,0.0
25125,2,5125,[300 215 471 117  69],705,3,19478,3.799843932891143,0.0,0.0
25126,2,5126,[ 64  12 357 269 301],416,5,19483,3.8000780183343084,40.0,0.0
25127,2,5127,[ 64  12 357 269 301],416,5,19488,3.800312012480499,40.0,0.0
25128,2,5128,[ 64  12 357 269 301],416,5,19493,3.8005459153831156,40.0,0.0
25129,2,5129,[302 211 328  97 588],43,5,19498,3.8007797270955166,0.0,0.0
25130,2,5130,[ 98 222 238 276 471],128,4,19502,3.800818553888131,0.0,20.0
25131,2,5131,[181  98 588 258 100],588,3,19505,3.80066250974279,0.0,40.0
25132,2,5132,[185 179 196 313 318],214,5,19510,3.8008961620884474,40.0,20.0
25133,2,5133,[211 265 238 111 546],416,4,19514,3.8009349435138295,0.0,0.0
25134,2,5134,[ 64  12 357 269 301],416,5,19519,3.801168451801363,40.0,0.0
25135,2,5135,[144 143 322  95 153],416,3,19522,3.80101246105919,0.0,0.0
25136,2,5136,[161 195 496 181 202],230,4,19526,3.8010511971968075,0.0,20.0
25137,2,5137,[  4 144 161 405   1],43,5,19531,3.801284546516154,0.0,0.0
25138,2,5138,[181 196 215 176 568],62,3,19534,3.8011286242459623,0.0,20.0
25139,2,5139,[ 64  12 357 269 301],416,5,19539,3.80136186770428,40.0,0.0
25140,2,5140,[ 64  12 357 269 301],416,5,19544,3.801595020424042,40.0,0.0
25141,2,5141,[210 742 471 588 195],297,2,19546,3.8012446518864254,0.0,0.0
25142,2,5142,[ 98  69 127 588 176],417,3,19549,3.8010888586428155,0.0,20.0
25143,2,5143,[ 64  12 357 269 301],416,5,19554,3.801321928460342,40.0,0.0
25144,2,5144,[655  70  50 258  15],345,5,19559,3.8015549076773567,0.0,20.0
25145,2,5145,[153 323  82 568 597],416,3,19562,3.8013991449669646,0.0,0.0
25146,2,5146,[121  97 515 286 269],416,5,19567,3.8016320186516417,0.0,0.0
25147,2,5147,[234   7 117 496  89],417,3,19570,3.8014763014763013,0.0,0.0
25148,2,5148,[ 25  69 245 132 183],417,3,19573,3.8013206447853953,0.0,0.0
25149,2,5149,[196 288 121 127 118],62,3,19576,3.801165048543689,0.0,20.0
25150,2,5150,[268 204 286  28  11],297,4,19580,3.8012036497767423,0.0,0.0
25151,2,5151,[568 100 144   8 153],416,5,19585,3.801436335403727,0.0,0.0
25152,2,5152,[ 69 127  50 215 197],618,4,19589,3.8014748690083446,0.0,20.0
25153,2,5153,[186   9 194 597 216],854,1,19590,3.80093131548312,0.0,0.0
25154,2,5154,[276 328   8 161 143],43,5,19595,3.8011639185257033,0.0,0.0
25155,2,5155,[ 64  12 357 269 301],416,5,19600,3.8013964313421256,40.0,0.0
25156,2,5156,[144  82 181  50 161],373,3,19603,3.801241031607524,0.0,40.0
25157,2,5157,[195   4 385 210 211],417,3,19606,3.801085692128732,0.0,0.0
25158,2,5158,[ 22 111 302 333 196],416,5,19611,3.8013180849001746,0.0,0.0
25159,2,5159,[ 98 182 603 117 546],297,3,19614,3.8011627906976746,0.0,20.0
25160,2,5160,[294 195   1 483 121],854,1,19615,3.8006200348769617,20.0,0.0
25161,2,5161,[ 64  12 357 269 301],416,5,19620,3.8008523827973653,40.0,0.0
25162,2,5162,[ 50 168 181 238  95],49,2,19622,3.800503583188069,0.0,40.0
25163,2,5163,[ 98  50   7 125 423],505,2,19624,3.8001549186676993,0.0,40.0
25164,2,5164,[238 196 515 210 180],405,2,19626,3.799806389157793,0.0,0.0
25165,2,5165,[215 202 175 196 294],43,4,19630,3.799845141308556,0.0,0.0
25166,2,5166,[268  79 173  97 385],588,3,19633,3.7996903425585447,0.0,0.0
25167,2,5167,[238 286  71  82 204],711,2,19635,3.799342105263158,0.0,0.0
25168,2,5168,[ 79 195 568 475 546],417,2,19637,3.7989940027084543,0.0,0.0
25169,2,5169,[ 22 228 294   7  28],230,3,19640,3.7988394584139265,0.0,0.0
25170,2,5170,[313 168 423 289  25],588,3,19643,3.798684973892864,20.0,20.0
25171,2,5171,[423  71 275 143 195],262,3,19646,3.7985305491105956,0.0,0.0
25172,2,5172,[258 403 173  79   4],43,5,19651,3.7987628068818866,0.0,0.0
25173,2,5173,[ 82 216 423 181 183],805,1,19652,3.7982218786238886,0.0,20.0
25174,2,5174,[508  70 200 268  96],417,3,19655,3.7980676328502416,0.0,0.0
25175,2,5175,[ 64  12 357 269 301],416,5,19660,3.7982998454404946,40.0,0.0
25176,2,5176,[ 71 185 328 234 471],416,5,19665,3.798531968321422,0.0,0.0
25177,2,5177,[  7 403 294 111  12],588,2,19667,3.798184627269216,20.0,0.0
25178,2,5178,[ 64  12 357 269 301],416,5,19672,3.798416682757289,40.0,0.0
25179,2,5179,[496  56 172   7 151],416,4,19676,3.7984555984555985,0.0,0.0
25180,2,5180,[333 288 204 301 483],588,5,19681,3.7986875120633083,20.0,20.0
25181,2,5181,[273 172 185 483   4],618,4,19685,3.7987263604785797,20.0,0.0
25182,2,5182,[273 179 318 182  97],62,4,19689,3.798765193903145,20.0,0.0
25183,2,5183,[186 111 318 301 237],43,4,19693,3.798804012345679,20.0,0.0
25184,2,5184,[181 121  50   1 196],541,4,19697,3.7988428158148504,0.0,40.0
25185,2,5185,[ 64  12 357 269 301],416,5,19702,3.7990744311608178,40.0,0.0
25186,2,5186,[100 385   7   1 471],588,2,19704,3.7987275882012725,0.0,0.0
25187,2,5187,[238  28 125 196  70],416,5,19709,3.798959136468774,0.0,0.0
25188,2,5188,[135  64 228 176  96],62,4,19713,3.7989978801310462,20.0,0.0
25189,2,5189,[ 64  12 357 269 301],416,5,19718,3.799229287090559,40.0,0.0
25190,2,5190,[268  89 180 508  50],354,3,19721,3.7990753226738585,0.0,20.0
25191,2,5191,[245 191 568 151 275],128,3,19724,3.7989214175654853,0.0,0.0
25192,2,5192,[238 588 127 191  97],416,5,19729,3.799152705565184,0.0,0.0
25193,2,5193,[282 568 265  95 427],705,4,19733,3.799191374663073,0.0,0.0
25194,2,5194,[ 64  12 357 269 301],416,5,19738,3.799422521655438,40.0,0.0
25195,2,5195,[ 64  12 357 269 301],416,5,19743,3.7996535796766744,40.0,0.0
25196,2,5196,[ 64  12 357 269 301],416,5,19748,3.799884548778141,40.0,0.0
25197,2,5197,[ 56  71 127 179 423],62,4,19752,3.7999230473258945,0.0,0.0
25198,2,5198,[  7 475 187 100  50],198,4,19756,3.799961531063666,0.0,20.0
25199,2,5199,[ 64  12 357 269 301],416,5,19761,3.8001923076923076,40.0,0.0
25200,2,5200,[655 100   1 200  25],417,3,19764,3.8000384541434338,0.0,0.0
25201,2,5201,[ 11 403 195 173  89],198,4,19768,3.800076893502499,0.0,0.0
25202,2,5202,[237 172  28 318 121],618,5,19773,3.8003075148952528,20.0,0.0
25203,2,5203,[265 423  64  22  50],618,5,19778,3.8005380476556496,20.0,20.0
25204,2,5204,[423 282 196 204 174],618,3,19781,3.800384245917387,0.0,0.0
25205,2,5205,[210 588 182 475  11],297,4,19785,3.800422589320015,0.0,0.0
25206,2,5206,[471 322  88 405 172],907,5,19790,3.8006529671595928,0.0,0.0
25207,2,5207,[181 546 125 282 161],416,4,19794,3.8006912442396312,0.0,20.0
25208,2,5208,[100 568 187 748 172],198,2,19796,3.8003455557688617,0.0,0.0
25209,2,5209,[194 174 196 234 300],416,5,19801,3.8005758157389637,0.0,0.0
25210,2,5210,[ 64  12 357 269 301],416,5,19806,3.800805987334485,40.0,0.0
25211,2,5211,[ 64  12 357 269 301],416,5,19811,3.801036070606293,40.0,0.0
25212,2,5212,[238 269 546 125  97],416,4,19815,3.801074237483215,0.0,0.0
25213,2,5213,[187 176 195  82 151],416,4,19819,3.8011123897199846,0.0,0.0
25214,2,5214,[ 64  12 357 269 301],416,5,19824,3.8013422818791947,40.0,0.0
25215,2,5215,[191 121  89 135 228],62,4,19828,3.8013803680981595,0.0,0.0
25216,2,5216,[181 161 143  95 427],198,2,19830,3.8010350776308224,0.0,20.0
25217,2,5217,[200  71 302 286   1],345,2,19832,3.8006899195093906,0.0,0.0
25218,2,5218,[173 271 258  56 151],805,3,19835,3.8005365012454493,0.0,0.0
25219,2,5219,[151 200 655 186   7],198,5,19840,3.8007662835249043,0.0,0.0
25220,2,5220,[ 56 423 168   1  70],679,3,19843,3.800612909404329,0.0,0.0
25221,2,5221,[ 64  12 357 269 301],416,5,19848,3.800842589046342,40.0,0.0
25222,2,5222,[288 515 357 603 427],416,5,19853,3.801072180739039,0.0,20.0
25223,2,5223,[ 64  12 357 269 301],416,5,19858,3.801301684532925,40.0,0.0
25224,2,5224,[ 71  88 748  82 294],505,3,19861,3.801148325358852,0.0,0.0
25225,2,5225,[ 22 127 197   7 508],854,4,19865,3.8011863758132414,0.0,0.0
25226,2,5226,[168  98 475 121 132],214,4,19869,3.801224411708437,0.0,20.0
25227,2,5227,[ 64  12 357 269 301],416,5,19874,3.8014537107880644,40.0,0.0
25228,2,5228,[ 64  12 357 269 301],416,5,19879,3.80168292216485,40.0,0.0
25229,2,5229,[ 64  12 357 269 301],416,5,19884,3.801912045889101,40.0,0.0
25230,2,5230,[318 117 276  69 216],198,3,19887,3.801758745937679,20.0,0.0
25231,2,5231,[181  69 655 117 180],373,4,19891,3.801796636085627,0.0,20.0
25232,2,5232,[318 568 258  70  82],198,2,19893,3.8014523218039367,20.0,0.0
25233,2,5233,[ 56 127  97 273  82],417,4,19897,3.8014902560183415,0.0,0.0
25234,2,5234,[ 64  12 357 269 301],416,5,19902,3.8017191977077363,40.0,0.0
25235,2,5235,[  9 245 118 181 185],416,3,19905,3.8015660809778455,0.0,20.0
25236,2,5236,[ 64  12 357 269 301],416,5,19910,3.801794920756158,40.0,0.0
25237,2,5237,[  4  79  50   1 204],805,3,19913,3.8016418480336007,0.0,20.0
25238,2,5238,[ 64  12 357 269 301],416,5,19918,3.801870585989693,40.0,0.0
25239,2,5239,[ 64  12 357 269 301],416,5,19923,3.8020992366412214,40.0,0.0
25240,2,5240,[ 64  12 357 269 301],416,5,19928,3.8023278000381606,40.0,0.0
25241,2,5241,[100 323  28 597 151],805,3,19931,3.8021747424647083,0.0,0.0
25242,2,5242,[ 22 328 294 403 168],62,3,19934,3.80202174327675,0.0,0.0
25243,2,5243,[ 82 135 210 185 475],198,3,19937,3.8018688024408847,0.0,0.0
25244,2,5244,[111 168  70 132 603],416,5,19942,3.802097235462345,0.0,0.0
25245,2,5245,[ 64  12 357 269 301],416,5,19947,3.802325581395349,40.0,0.0
25246,2,5246,[181 748 288  89 118],555,4,19951,3.802363255193444,0.0,40.0
25247,2,5247,[111  50  56 328 405],43,5,19956,3.8025914634146343,0.0,20.0
25248,2,5248,[655 168 143  98  50],887,3,19959,3.8024385597256622,0.0,40.0
25249,2,5249,[276  28 313 121 181],654,3,19962,3.8022857142857145,20.0,40.0
25250,2,5250,[ 64  12 357 269 301],416,5,19967,3.802513806893925,40.0,0.0
25251,2,5251,[161 173   7 258 186],43,4,19971,3.8025514089870525,0.0,0.0
25252,2,5252,[ 89 515 222 151  11],297,4,19975,3.802588996763754,0.0,0.0
25253,2,5253,[176 323 204  25 269],416,4,19979,3.802626570232204,0.0,0.0
25254,2,5254,[ 64  12 357 269 301],416,5,19984,3.8028544243577547,40.0,0.0
25255,2,5255,[ 64  12 357 269 301],416,5,19989,3.8030821917808217,40.0,0.0
25256,2,5256,[597 121 427  15 655],618,4,19993,3.8031196499904887,0.0,0.0
25257,2,5257,[357 222 183 546 748],297,3,19996,3.802966907569418,0.0,0.0
25258,2,5258,[111 273 195 216 275],416,5,20001,3.803194523673702,0.0,0.0
25259,2,5259,[ 64  12 357 269 301],416,5,20006,3.803422053231939,40.0,0.0
25260,2,5260,[185 588 182 234 655],618,5,20011,3.80364949629348,0.0,0.0
25261,2,5261,[427 597 194 471 273],416,4,20015,3.8036868110984416,0.0,0.0
25262,2,5262,[211 181 237 125 318],274,5,20020,3.8039141174235227,20.0,20.0
25263,2,5263,[125 275  12  50 216],416,5,20025,3.8041413373860182,20.0,20.0
25264,2,5264,[210  15   1 121  79],654,4,20029,3.804178537511871,0.0,0.0
25265,2,5265,[238 185 483 135 204],711,4,20033,3.804215723509305,20.0,0.0
25266,2,5266,[194 174 294 289 282],721,3,20036,3.804063033985191,0.0,0.0
25267,2,5267,[258   8 302 125 357],416,5,20041,3.804290053151101,0.0,0.0
25268,2,5268,[ 64  12 357 269 301],416,5,20046,3.8045169861453787,40.0,0.0
25269,2,5269,[ 64  12 357 269 301],416,5,20051,3.8047438330170777,40.0,0.0
25270,2,5270,[111  98 194  88 121],751,4,20055,3.804780876494024,0.0,20.0
25271,2,5271,[237 196 186 215 276],128,4,20059,3.804817905918058,0.0,0.0
25272,2,5272,[ 64  12 357 269 301],416,5,20064,3.805044566660345,40.0,0.0
25273,2,5273,[ 64  12 357 269 301],416,5,20069,3.805271141448616,40.0,0.0
25274,2,5274,[ 64  12 357 269 301],416,5,20074,3.8054976303317534,40.0,0.0
25275,2,5275,[ 70 204  69   4 385],345,4,20078,3.8055344958301744,0.0,0.0
25276,2,5276,[118  95 568 357  71],642,3,20081,3.8053818457456887,0.0,0.0
25277,2,5277,[ 64  12 269 357 301],416,5,20086,3.8056081849185297,40.0,0.0
25278,2,5278,[238 174 191 405  70],43,4,20090,3.805645008524342,0.0,0.0
25279,2,5279,[ 22  71 588 215 655],618,5,20095,3.805871212121212,0.0,0.0
25280,2,5280,[ 70 215  15 204 195],198,1,20096,3.805339897746639,0.0,0.0
25281,2,5281,[191 257 357  25 597],417,2,20098,3.804998106777736,0.0,0.0
25282,2,5282,[175 588 176 313 238],405,2,20100,3.80465644520159,20.0,20.0
25283,2,5283,[ 64  12 269 357 301],416,5,20105,3.804882664647994,40.0,0.0
25284,2,5284,[ 56  64  28 179  82],721,4,20109,3.8049195837275307,20.0,0.0
25285,2,5285,[191 172 211 181 185],405,4,20113,3.804956488838441,0.0,20.0
25286,2,5286,[222 204 182 475 181],297,3,20116,3.804804236807263,0.0,20.0
25287,2,5287,[ 64  12 269 357 301],416,5,20121,3.8050302571860817,40.0,0.0
25288,2,5288,[ 70 357   4 173 678],416,4,20125,3.8050671204386464,0.0,0.0
25289,2,5289,[  8 197 161 273 117],805,1,20126,3.804536862003781,0.0,0.0
25290,2,5290,[403 273   1  69   4],416,5,20131,3.8047628047628046,0.0,0.0
25291,2,5291,[ 64  12 269 357 301],416,5,20136,3.804988662131519,40.0,0.0
25292,2,5292,[257  70 546 168 204],62,2,20138,3.8046476478367657,0.0,0.0
25293,2,5293,[182 471  28 181 185],297,3,20141,3.8044956554590104,0.0,20.0
25294,2,5294,[ 64  12 269 357 301],416,5,20146,3.804721435316336,40.0,0.0
25295,2,5295,[ 64  12 269 357 301],416,5,20151,3.8049471299093653,40.0,0.0
25296,2,5296,[ 79 322  82  11  96],416,4,20155,3.804983953181046,0.0,0.0
25297,2,5297,[597  22 282  64   7],854,2,20157,3.804643261608154,20.0,0.0
25298,2,5298,[289 275  95 678 196],416,2,20159,3.8043026986223816,0.0,0.0
25299,2,5299,[385   1 216  95  50],416,4,20163,3.8043396226415096,0.0,20.0
25300,2,5300,[597 168 496 183 187],887,4,20167,3.8043765327296737,0.0,0.0
25301,2,5301,[ 64  12 269 357 301],416,5,20172,3.8046020369671822,40.0,0.0
25302,2,5302,[ 64  12 269 357 301],416,5,20177,3.804827456156892,40.0,0.0
25303,2,5303,[ 64  12 269 357 301],416,5,20182,3.805052790346908,40.0,0.0
25304,2,5304,[ 64  12 269 357 301],416,5,20187,3.8052780395852968,40.0,0.0
25305,2,5305,[ 28 435  64 210 211],373,4,20191,3.805314738032416,20.0,0.0
25306,2,5306,[215 286  89 144 271],297,2,20193,3.804974561899378,0.0,0.0
25307,2,5307,[ 64  12 269 357 301],416,5,20198,3.805199698568199,40.0,0.0
25308,2,5308,[483 265 333 742 588],588,5,20203,3.805424750423809,20.0,0.0
25309,2,5309,[ 64  12 269 357 301],416,5,20208,3.8056497175141244,40.0,0.0
25310,2,5310,[423 215 269 144  79],43,5,20213,3.805874599887027,0.0,0.0
25311,2,5311,[172  71 496  97 118],907,5,20218,3.8060993975903616,0.0,0.0
25312,2,5312,[597 275 196 172 161],416,4,20222,3.806135893092415,0.0,0.0
25313,2,5313,[151 202 204 237 153],43,5,20227,3.8063605570191945,0.0,0.0
25314,2,5314,[286 294 471  69 174],588,3,20230,3.80620884289746,0.0,0.0
25315,2,5315,[294 289 323   8 276],43,4,20234,3.806245297215952,0.0,0.0
25316,2,5316,[258   8 237 655 245],721,1,20235,3.8057175098739893,0.0,0.0
25317,2,5317,[ 64  12 269 357 301],416,5,20240,3.805942083490034,40.0,0.0
25318,2,5318,[ 22 300 286 144 237],297,3,20243,3.8057905621357397,0.0,0.0
25319,2,5319,[ 95 216 125 183 143],618,2,20245,3.805451127819549,0.0,0.0
25320,2,5320,[235 475  82 181 269],805,2,20247,3.805111821086262,0.0,20.0
25321,2,5321,[ 64  12 269 357 301],416,5,20252,3.805336339721909,40.0,0.0
25322,2,5322,[ 64  12 269 357 301],416,5,20257,3.8055607739996242,40.0,0.0
25323,2,5323,[ 97 288 265 118 121],588,3,20260,3.8054094665664913,0.0,20.0
25324,2,5324,[ 64  12 269 357 301],416,5,20265,3.8056338028169012,40.0,0.0
25325,2,5325,[ 64  12 269 357 301],416,5,20270,3.805858054825385,40.0,0.0
25326,2,5326,[  4 405 191 127 228],198,2,20272,3.8055190538764783,0.0,0.0
25327,2,5327,[ 64  12 269 357 301],416,5,20277,3.8057432432432434,40.0,0.0
25328,2,5328,[238  25 100 588 318],618,3,20280,3.8055920435353725,20.0,0.0
25329,2,5329,[  1 288 322 175 269],805,3,20283,3.805440900562852,0.0,20.0
25330,2,5330,[655   4 175 204 273],805,1,20284,3.8049146501594446,0.0,0.0
25331,2,5331,[144 238 168 183  28],230,2,20286,3.804576144036009,0.0,0.0
25332,2,5332,[228  88 135  69 185],711,3,20289,3.8044252765797864,0.0,0.0
25333,2,5333,[ 64  12 269 357 301],416,5,20294,3.804649418822647,40.0,0.0
25334,2,5334,[ 64  12 269 357 301],416,5,20299,3.8048734770384254,40.0,0.0
25335,2,5335,[196 265 183 179  11],437,2,20301,3.804535232383808,0.0,0.0
25336,2,5336,[ 64  12 269 357 301],416,5,20306,3.8047592280307287,40.0,0.0
25337,2,5337,[ 69 179 301 475  79],416,3,20309,3.804608467590858,0.0,0.0
25338,2,5338,[423 288 161 568 173],618,3,20312,3.8044577636261474,0.0,20.0
25339,2,5339,[ 64  12 269 357 301],416,5,20317,3.804681647940075,40.0,0.0
25340,2,5340,[385 423 195 427 204],698,2,20319,3.8043437558509643,0.0,0.0
25341,2,5341,[111 195 127 187 318],887,4,20323,3.804380381879446,20.0,0.0
25342,2,5342,[ 64  12 269 357 301],416,5,20328,3.8046041549691183,40.0,0.0
25343,2,5343,[ 64  12 269 357 301],416,5,20333,3.804827844311377,40.0,0.0
25344,2,5344,[286 121  71 328 100],416,5,20338,3.8050514499532273,0.0,0.0
25345,2,5345,[ 95 196 655 151 144],705,2,20340,3.8047138047138045,0.0,0.0
25346,2,5346,[ 64  12 269 357 301],416,5,20345,3.804937348045633,40.0,0.0
25347,2,5347,[ 64  12 269 357 301],416,5,20350,3.8051608077786088,40.0,0.0
25348,2,5348,[ 64  12 269 357 301],416,5,20355,3.8053841839596187,40.0,0.0
25349,2,5349,[588 210 186 742 161],230,5,20360,3.805607476635514,0.0,0.0
25350,2,5350,[323 423 125 111 357],417,3,20363,3.8054569239394507,0.0,0.0
25351,2,5351,[427 176 301  50 125],416,5,20368,3.805680119581465,0.0,20.0
25352,2,5352,[ 64  12 269 357 301],416,5,20373,3.8059032318326174,40.0,0.0
25353,2,5353,[ 64  12 269 357 301],416,5,20378,3.806126260739634,40.0,0.0
25354,2,5354,[ 64  12 269 357 301],416,5,20383,3.806349206349206,40.0,0.0
25355,2,5355,[174   4 210 172 276],62,5,20388,3.806572068707991,0.0,0.0
25356,2,5356,[ 64  12 269 357 301],416,5,20393,3.8067948478626095,40.0,0.0
25357,2,5357,[318 187 300 748  22],416,5,20398,3.807017543859649,20.0,0.0
25358,2,5358,[ 70 238  79 603  56],437,4,20402,3.8070535547676805,0.0,0.0
25359,2,5359,[ 64  12 269 357 301],416,5,20407,3.807276119402985,40.0,0.0
25360,2,5360,[ 50 151 196 195  11],297,3,20410,3.8071255362805445,0.0,20.0
25361,2,5361,[ 64  12 269 357 301],416,5,20415,3.807348004475942,40.0,0.0
25362,2,5362,[323 302   7 173 238],416,4,20419,3.8073839269065823,0.0,0.0
25363,2,5363,[100  70 185 117 238],417,3,20422,3.807233407904549,0.0,0.0
25364,2,5364,[276 168 181  88  56],43,5,20427,3.8074557315936626,0.0,20.0
25365,2,5365,[ 12 117  64 194 275],416,5,20432,3.8076779724189342,40.0,0.0
25366,2,5366,[ 11 282 423 302 200],297,2,20434,3.8073411589342276,0.0,0.0
25367,2,5367,[269 121  71 300 153],43,5,20439,3.807563338301043,0.0,0.0
25368,2,5368,[204  22 180 187 196],373,3,20442,3.807412926056994,0.0,0.0
25369,2,5369,[ 64  12 269 357 301],416,5,20447,3.807635009310987,40.0,0.0
25370,2,5370,[ 64  12 269 357 301],416,5,20452,3.8078570098678086,40.0,0.0
25371,2,5371,[ 28 202 603 172 111],734,4,20456,3.8078927773641102,0.0,0.0
25372,2,5372,[ 71 180 215  64 568],373,4,20460,3.807928531546622,20.0,0.0
25373,2,5373,[117 168 289 403 300],43,5,20465,3.8081503535541494,0.0,0.0
25374,2,5374,[183 385 179  50  25],416,4,20469,3.808186046511628,0.0,20.0
25375,2,5375,[ 64  12 269 357 301],416,5,20474,3.808407738095238,40.0,0.0
25376,2,5376,[234 268 328 322 568],416,4,20478,3.808443369908871,0.0,0.0
25377,2,5377,[216 168   1 204   7],751,3,20481,3.8082930457419115,0.0,0.0
25378,2,5378,[ 64  12 269 357 301],416,5,20486,3.8085145937906675,40.0,0.0
25379,2,5379,[238  28 228 204 202],230,3,20489,3.808364312267658,0.0,0.0
25380,2,5380,[ 64  12 269 357 301],416,5,20494,3.808585764727746,40.0,0.0
25381,2,5381,[172 153 168  96 235],416,4,20498,3.808621330360461,0.0,0.0
25382,2,5382,[276 323  95  56 318],416,2,20500,3.808285342745681,20.0,0.0
25383,2,5383,[210 275 143  56 286],43,5,20505,3.8085066864784545,0.0,0.0
25384,2,5384,[ 89 187 238 318  69],214,4,20509,3.808542246982358,20.0,0.0
25385,2,5385,[275  28  95  89 282],297,3,20512,3.8083921277385815,0.0,0.0
25386,2,5386,[323  12  95 546 238],805,3,20515,3.8082420642286987,20.0,0.0
25387,2,5387,[121 196  71 597 238],654,4,20519,3.8082776540460284,0.0,0.0
25388,2,5388,[176 748 194 174  69],297,2,20521,3.8079421042865094,0.0,0.0
25389,2,5389,[118 234 405  98  96],198,2,20523,3.8076066790352505,0.0,20.0
25390,2,5390,[ 64  12 269 357 301],416,5,20528,3.8078278612502316,40.0,0.0
25391,2,5391,[475 588 172  12 357],601,3,20531,3.807678041543027,20.0,0.0
25392,2,5392,[ 64  12 269 357 301],416,5,20536,3.807899128499907,40.0,0.0
25393,2,5393,[405  11 191 268   7],417,3,20539,3.807749351130886,0.0,0.0
25394,2,5394,[237  98 655 117 289],588,1,20540,3.8072289156626504,0.0,20.0
25395,2,5395,[ 64  12 269 357 301],416,5,20545,3.807449962935508,40.0,0.0
25396,2,5396,[ 64  12 269 357 301],416,5,20550,3.807670928293496,40.0,0.0
25397,2,5397,[275 265 195 151 282],618,1,20551,3.8071507965913303,0.0,0.0
25398,2,5398,[ 64  12 269 357 301],416,5,20556,3.8073717355065755,40.0,0.0
25399,2,5399,[322 121 313 423 182],416,4,20560,3.8074074074074074,20.0,20.0
25400,2,5400,[257 216 357  22 328],854,1,20561,3.806887613404925,0.0,0.0
25401,2,5401,[423 655 168 185 186],437,3,20564,3.8067382450944094,0.0,0.0
25402,2,5402,[483 179  56 186  71],128,3,20567,3.8065889320747734,20.0,0.0
25403,2,5403,[194 322 748 403   1],416,4,20571,3.806624722427831,0.0,0.0
25404,2,5404,[ 64  12 269 357 301],416,5,20576,3.806845513413506,40.0,0.0
25405,2,5405,[  7 195 403 515 546],416,4,20580,3.806881243063263,0.0,0.0
25406,2,5406,[216 215 235 515 132],416,4,20584,3.8069169594969483,0.0,0.0
25407,2,5407,[121 282 546  69 118],654,3,20587,3.80676775147929,0.0,0.0
25408,2,5408,[216 183  70 322 182],416,4,20591,3.806803475688667,0.0,0.0
25409,2,5409,[ 64  12 269 357 301],416,5,20596,3.8070240295748614,40.0,0.0
25410,2,5410,[ 64  12 269 357 301],416,5,20601,3.8072445019404917,40.0,0.0
25411,2,5411,[117 496  71 172 161],505,3,20604,3.8070953436807096,0.0,0.0
25412,2,5412,[144 301   7 475 300],297,3,20607,3.8069462405320524,0.0,0.0
25413,2,5413,[235  79 187  25 153],416,4,20611,3.8069818987809385,0.0,0.0
25414,2,5414,[302  89 175 475 322],854,3,20614,3.806832871652816,0.0,0.0
25415,2,5415,[215  79 117 183 182],416,5,20619,3.80705317577548,0.0,0.0
25416,2,5416,[235 234  98 423 121],805,2,20621,3.8067195864869854,0.0,20.0
25417,2,5417,[143   7  15   4 568],416,5,20626,3.806939830195644,0.0,0.0
25418,2,5418,[294 288 282  28 185],297,2,20628,3.806606384941871,0.0,20.0
25419,2,5419,[403 204  79  69 195],198,2,20630,3.8062730627306274,0.0,0.0
25420,2,5420,[ 64  12 269 357 301],416,5,20635,3.8064932669249214,40.0,0.0
25421,2,5421,[210 176  56 153 100],805,4,20639,3.8065289561047586,0.0,0.0
25422,2,5422,[  7 181 183  22 597],805,2,20641,3.8061958325650007,0.0,20.0
25423,2,5423,[172 187 191 173 202],416,5,20646,3.8064159292035398,0.0,0.0
25424,2,5424,[222 191 258   1 588],297,3,20649,3.806267281105991,0.0,0.0
25425,2,5425,[117  97 323 237 546],416,2,20651,3.8059343899741984,0.0,0.0
25426,2,5426,[ 64  12 269 357 301],416,5,20656,3.8061544131195872,40.0,0.0
25427,2,5427,[ 64  12 269 357 301],416,5,20661,3.8063743551952838,40.0,0.0
25428,2,5428,[172  71 216 127  50],922,3,20664,3.8062258242770306,0.0,20.0
25429,2,5429,[125  97 153  69  15],417,4,20668,3.8062615101289135,0.0,0.0
25430,2,5430,[174 173 168 222 655],588,2,20670,3.805928926532867,0.0,0.0
25431,2,5431,[282 328 322 546 318],416,3,20673,3.805780559646539,20.0,0.0
25432,2,5432,[423 357 183 174 200],416,5,20678,3.8060003681207437,0.0,0.0
25433,2,5433,[568 483 265 161  69],618,5,20683,3.8062200956937797,20.0,0.0
25434,2,5434,[174 403 655 245  64],417,4,20687,3.8062557497700094,20.0,0.0
25435,2,5435,[ 64  12 269 357 301],416,5,20692,3.806475349521707,40.0,0.0
25436,2,5436,[ 64  12 269 357 301],416,5,20697,3.8066948684936546,40.0,0.0
25437,2,5437,[ 64  12 269 357 301],416,5,20702,3.8069143067304156,40.0,0.0
25438,2,5438,[ 69  82 496  98 265],505,4,20706,3.806949806949807,0.0,20.0
25439,2,5439,[603 180 197 216 153],437,5,20711,3.807169117647059,0.0,0.0
25440,2,5440,[257 234 385 153  88],642,3,20714,3.807020768241132,0.0,0.0
25441,2,5441,[301 655 405 323 187],416,4,20718,3.8070562293274532,0.0,0.0
25442,2,5442,[ 64  12 269 357 301],416,5,20723,3.8072753995958113,40.0,0.0
25443,2,5443,[ 56 228 357 143  64],198,3,20726,3.8071271124173403,20.0,0.0
25444,2,5444,[ 64  12 269 357 301],416,5,20731,3.807346189164371,40.0,0.0
25445,2,5445,[ 64  12 269 357 301],416,5,20736,3.807565185457216,40.0,0.0
25446,2,5446,[257 204  82 269 111],416,4,20740,3.8076005140444282,0.0,0.0
25447,2,5447,[ 64  12 269 357 301],416,5,20745,3.807819383259912,40.0,0.0
25448,2,5448,[118 301  22  15  50],588,4,20749,3.807854652229767,0.0,20.0
25449,2,5449,[200 181 748  69 286],297,2,20751,3.8075229357798164,0.0,20.0
25450,2,5450,[ 50 176 179 100 423],416,4,20755,3.807558246193359,0.0,20.0
25451,2,5451,[117 211 173 269 748],416,5,20760,3.8077769625825386,0.0,0.0
25452,2,5452,[ 96 275  22 235  64],416,4,20764,3.8078122134604806,20.0,0.0
25453,2,5453,[222 125  95  79   1],417,3,20767,3.8076640997433078,0.0,0.0
25454,2,5454,[ 64  12 269 357 301],416,5,20772,3.8078826764436298,40.0,0.0
25455,2,5455,[245 168  12 289  70],416,3,20775,3.8077346041055717,20.0,0.0
25456,2,5456,[748 333  11 237 475],416,3,20778,3.8075865860362836,0.0,0.0
25457,2,5457,[174 168  82   7 228],417,2,20780,3.8072554049102236,0.0,0.0
25458,2,5458,[179 405  71 127  82],62,4,20784,3.8072907125847224,0.0,0.0
25459,2,5459,[ 56 238   8 182 191],342,5,20789,3.8075091575091573,0.0,0.0
25460,2,5460,[161 195 197 496 179],437,3,20792,3.8073612891411828,0.0,0.0
25461,2,5461,[ 64  12 269 357 301],416,5,20797,3.8075796411570852,40.0,0.0
25462,2,5462,[234  70 313 176 191],405,3,20800,3.8074318140215997,20.0,20.0
25463,2,5463,[300 186 323 173 228],198,2,20802,3.80710102489019,0.0,0.0
25464,2,5464,[  9 322  97  69  25],416,4,20806,3.807136322049405,0.0,0.0
25465,2,5465,[ 64  12 269 357 301],416,5,20811,3.8073545554335895,40.0,0.0
25466,2,5466,[ 64 179 121 153 228],417,3,20814,3.807206877629413,20.0,0.0
25467,2,5467,[  7 237 546 275 475],297,4,20818,3.8072421360643744,0.0,0.0
25468,2,5468,[117 118 174 191 508],297,3,20821,3.8070945328213566,0.0,0.0
25469,2,5469,[182 153 216  70 121],437,2,20823,3.806764168190128,0.0,0.0
25470,2,5470,[216 195 183 204 603],805,2,20825,3.8064339243282763,0.0,0.0
25471,2,5471,[ 64  12 269 357 301],416,5,20830,3.8066520467836256,40.0,0.0
25472,2,5472,[ 64  12 269 357 301],416,5,20835,3.806870089530422,40.0,0.0
25473,2,5473,[ 64  12 269 357 301],416,5,20840,3.8070880526123494,40.0,0.0
25474,2,5474,[ 64  12 269 357 301],416,5,20845,3.8073059360730594,40.0,0.0
25475,2,5475,[ 64  12 269 357 301],416,5,20850,3.8075237399561725,40.0,0.0
25476,2,5476,[ 56 257 423 403 508],417,3,20853,3.80737630089465,0.0,0.0
25477,2,5477,[ 64  12 269 357 301],416,5,20858,3.8075940124132894,40.0,0.0
25478,2,5478,[ 64  12 269 357 301],416,5,20863,3.807811644460668,40.0,0.0
25479,2,5479,[ 64  12 269 357 301],416,5,20868,3.808029197080292,40.0,0.0
25480,2,5480,[ 64  12 269 357 301],416,5,20873,3.808246670315636,40.0,0.0
25481,2,5481,[181  64 405 471 597],416,4,20877,3.8082816490331997,20.0,20.0
25482,2,5482,[ 64  12 269 357 301],416,5,20882,3.8084989968995075,40.0,0.0
25483,2,5483,[ 64  12 269 357 301],416,5,20887,3.808716265499635,40.0,0.0
25484,2,5484,[195 118 276 153 168],601,3,20890,3.8085688240656337,0.0,0.0
25485,2,5485,[427 210  82 191  71],416,5,20895,3.8087860007291288,0.0,0.0
25486,2,5486,[172 215 234 197 194],416,5,20900,3.809003098232185,0.0,0.0
25487,2,5487,[215 318 144  28 742],62,1,20901,3.808491253644315,20.0,0.0
25488,2,5488,[ 64  12 269 357 301],416,5,20906,3.8087083257423937,40.0,0.0
25489,2,5489,[403 222 132   1 202],588,2,20908,3.8083788706739528,0.0,0.0
25490,2,5490,[ 64  12 269 357 301],416,5,20913,3.808595884174103,40.0,0.0
25491,2,5491,[117 153   7 111 496],630,3,20916,3.808448652585579,0.0,0.0
25492,2,5492,[546 117 185 118 294],417,3,20919,3.8083014746040416,0.0,0.0
25493,2,5493,[655 173 181 153 216],416,5,20924,3.8085183836912995,0.0,20.0
25494,2,5494,[ 64  12 269 357 301],416,5,20929,3.8087352138307553,40.0,0.0
25495,2,5495,[ 64  12 269 357 301],416,5,20934,3.808951965065502,40.0,0.0
25496,2,5496,[172 127  69  15  22],630,0,20934,3.8082590503911224,0.0,0.0
25497,2,5497,[ 64  12 269 357 301],416,5,20939,3.808475809385231,40.0,0.0
25498,2,5498,[318 237 405 300  25],274,5,20944,3.8086924895435534,20.0,0.0
25499,2,5499,[ 64  12 269 357 301],416,5,20949,3.808909090909091,40.0,0.0
25500,2,5500,[118  70 423 257  79],416,3,20952,3.808762043264861,0.0,0.0
25501,2,5501,[  8 196  15 742 508],654,3,20955,3.8086150490730644,0.0,0.0
25502,2,5502,[301 204  98  71 195],437,2,20957,3.8082863892422316,0.0,20.0
25503,2,5503,[ 64  12 269 357 301],416,5,20962,3.808502906976744,40.0,0.0
25504,2,5504,[ 64  12 269 357 301],416,5,20967,3.8087193460490463,40.0,0.0
25505,2,5505,[294 185 197 276 100],416,4,20971,3.808754086451144,0.0,0.0
25506,2,5506,[ 64  12 269 357 301],416,5,20976,3.808970401307427,40.0,0.0
25507,2,5507,[ 69 258  71 173 204],128,4,20980,3.8090050835148874,0.0,0.0
25508,2,5508,[200 210   4 204 288],416,5,20985,3.8092212742784533,0.0,20.0
25509,2,5509,[ 70 132 174   9 275],62,4,20989,3.8092558983666063,0.0,0.0
25510,2,5510,[603  15 328 300 405],416,5,20994,3.8094719651605877,0.0,0.0
25511,2,5511,[ 64  12 269 357 301],416,5,20999,3.809687953555878,40.0,0.0
25512,2,5512,[222 655 215 161 204],721,4,21003,3.809722474152004,0.0,0.0
25513,2,5513,[301  95 475 216 111],416,3,21006,3.809575625680087,0.0,0.0
25514,2,5514,[161  98 568 265  96],417,1,21007,3.8090661831368995,0.0,20.0
25515,2,5515,[ 15 423 222  70  50],721,4,21011,3.809100797679478,0.0,20.0
25516,2,5516,[ 64  12 269 357 301],416,5,21016,3.80931665760377,40.0,0.0
25517,2,5517,[ 64  12 269 357 301],416,5,21021,3.8095324392895975,40.0,0.0
25518,2,5518,[568 161 273 125 238],417,2,21023,3.8092045660445732,0.0,0.0
25519,2,5519,[405 210 186 172 204],230,5,21028,3.8094202898550726,0.0,0.0
25520,2,5520,[  8 127 302 222 143],43,5,21033,3.8096359355189278,0.0,0.0
25521,2,5521,[471 282 357 294 216],721,4,21037,3.809670409272003,0.0,0.0
25522,2,5522,[183 173  22 179 118],62,4,21041,3.8097048705413723,0.0,0.0
25523,2,5523,[ 64  12 269 357 301],416,5,21046,3.8099203475742214,40.0,0.0
25524,2,5524,[202 288 588 258 323],416,4,21050,3.8099547511312215,0.0,20.0
25525,2,5525,[597  89 117   7 181],417,2,21052,3.8096272167933405,0.0,20.0
25526,2,5526,[ 64  12 269 357 301],416,5,21057,3.809842590917315,40.0,0.0
25527,2,5527,[385  88  22 173  11],505,4,21061,3.8098769898697538,0.0,0.0
25528,2,5528,[ 64  12 269 357 301],416,5,21066,3.8100922409115574,40.0,0.0
25529,2,5529,[180 588 182 435 127],405,1,21067,3.8095840867992767,0.0,0.0
25530,2,5530,[125 288 161  64 111],416,5,21072,3.809799312963298,20.0,20.0
25531,2,5531,[313 185 385 174 328],416,5,21077,3.81001446131598,20.0,20.0
25532,2,5532,[ 64  12 269 357 301],416,5,21082,3.810229531899512,40.0,0.0
25533,2,5533,[ 69 200 222 655 288],887,2,21084,3.809902421395013,0.0,20.0
25534,2,5534,[151 288 258 172 196],654,4,21088,3.809936766034327,0.0,20.0
25535,2,5535,[ 64  12 269 357 301],416,5,21093,3.8101517341040463,40.0,0.0
25536,2,5536,[ 70   9 313 181 182],416,5,21098,3.8103666245259165,20.0,40.0
25537,2,5537,[210  11 238 258 135],417,3,21101,3.810220296135789,0.0,0.0
25538,2,5538,[357 508 173 210 475],417,3,21104,3.8100740205813324,0.0,0.0
25539,2,5539,[ 64  12 269 357 301],416,5,21109,3.81028880866426,40.0,0.0
25540,2,5540,[ 64  12 269 357 301],416,5,21114,3.810503519220357,40.0,0.0
25541,2,5541,[ 64  12 269 357 301],416,5,21119,3.8107181522915914,40.0,0.0
25542,2,5542,[ 70 186  25 435 237],230,4,21123,3.8107523001984487,0.0,0.0
25543,2,5543,[ 97 181 174 202 588],230,5,21128,3.810966810966811,0.0,20.0
25544,2,5544,[ 64  12 269 357 301],416,5,21133,3.8111812443642923,40.0,0.0
25545,2,5545,[471 144 173 151 546],416,3,21136,3.811034980165885,0.0,0.0
25546,2,5546,[151 194 211 200 265],297,1,21137,3.810528213448711,0.0,0.0
25547,2,5547,[168 546  12 216 265],416,4,21141,3.81056236481615,20.0,0.0
25548,2,5548,[215 168 216 238 117],437,2,21143,3.8102360785727156,0.0,0.0
25549,2,5549,[180 176 181  11 276],198,3,21146,3.8100900900900903,0.0,20.0
25550,2,5550,[100   4 191 423 196],43,5,21151,3.810304449648712,0.0,0.0
25551,2,5551,[ 64  12 269 357 301],416,5,21156,3.8105187319884726,40.0,0.0
25552,2,5552,[173 423 196   1 258],128,4,21160,3.810552854312984,0.0,0.0
25553,2,5553,[186   7  70 196 121],198,2,21162,3.810226863521786,0.0,0.0
25554,2,5554,[ 96 202 546 173  95],49,0,21162,3.8095409540954095,0.0,0.0
25555,2,5555,[568 508 313   1 275],654,4,21166,3.8095752339812816,20.0,20.0
25556,2,5556,[318 423  98 127 181],405,5,21171,3.8097894547417672,20.0,40.0
25557,2,5557,[ 64  12 269 357 301],416,5,21176,3.8100035984166967,40.0,0.0
25558,2,5558,[288  97   8 403 496],416,5,21181,3.8102176650476705,0.0,20.0
25559,2,5559,[ 22 211 187  56 313],416,5,21186,3.810431654676259,20.0,20.0
25560,2,5560,[ 50 328  25  79 216],416,5,21191,3.810645567344003,0.0,20.0
25561,2,5561,[294  50 275  64 174],764,3,21194,3.810499820208558,20.0,20.0
25562,2,5562,[603 144 385 403   7],805,3,21197,3.810354125471868,0.0,0.0
25563,2,5563,[546  98 403 191 475],805,4,21201,3.8103882099209203,0.0,20.0
25564,2,5564,[ 64  12 269 357 301],416,5,21206,3.8106019766397123,40.0,0.0
25565,2,5565,[ 64  12 269 357 301],416,5,21211,3.8108156665468917,40.0,0.0
25566,2,5566,[ 64  12 269 357 301],416,5,21216,3.811029279683851,40.0,0.0
25567,2,5567,[  8 294 111  70 238],416,5,21221,3.811242816091954,0.0,0.0
25568,2,5568,[ 64  12 269 357 301],416,5,21226,3.811456275812534,40.0,0.0
25569,2,5569,[118 496  15 276  98],416,3,21229,3.811310592459605,0.0,20.0
25570,2,5570,[ 64  12 269 357 301],416,5,21234,3.8115239633817986,40.0,0.0
25571,2,5571,[289 515  79  50 200],416,4,21238,3.8115577889447234,0.0,20.0
25572,2,5572,[302  64 245 237 183],416,3,21241,3.81141216579939,20.0,0.0
25573,2,5573,[294 597 742  69 678],654,4,21245,3.8114459992823826,0.0,0.0
25574,2,5574,[ 64  12 269 357 301],416,5,21250,3.811659192825112,40.0,0.0
25575,2,5575,[ 64  12 269 357 301],416,5,21255,3.8118723098995697,40.0,0.0
25576,2,5576,[ 64  12 269 357 301],416,5,21260,3.812085350546889,40.0,0.0
25577,2,5577,[ 64  12 269 357 301],416,5,21265,3.812298314808175,40.0,0.0
25578,2,5578,[179  98 191 118 237],128,4,21269,3.812331959132461,0.0,20.0
25579,2,5579,[ 50 181 185 234 172],417,1,21270,3.8118279569892475,0.0,40.0
25580,2,5580,[ 64  12 269 357 301],416,5,21275,3.812040852893747,40.0,0.0
25581,2,5581,[ 64  12 269 357 301],416,5,21280,3.8122536725188105,40.0,0.0
25582,2,5582,[153 173  98  70 181],297,5,21285,3.812466415905427,0.0,40.0
25583,2,5583,[678 257 333 313 271],507,5,21290,3.812679083094556,20.0,20.0
25584,2,5584,[216 742 275 125 496],588,2,21292,3.812354521038496,0.0,0.0
25585,2,5585,[180 143 678 202 748],805,1,21293,3.8118510562119585,0.0,0.0
25586,2,5586,[ 64  12 269 357 301],416,5,21298,3.8120637193484876,40.0,0.0
25587,2,5587,[ 70 222 135 275 301],297,5,21303,3.8122763063707947,0.0,0.0
25588,2,5588,[153 603 257   1 176],854,2,21305,3.8119520486670244,0.0,0.0
25589,2,5589,[294 322 276 216 273],630,3,21308,3.8118067978533094,0.0,0.0
25590,2,5590,[ 64  12 269 357 301],416,5,21313,3.812019316759077,40.0,0.0
25591,2,5591,[ 64  12 269 357 301],416,5,21318,3.8122317596566524,40.0,0.0
25592,2,5592,[ 56 286 222 176 508],297,5,21323,3.8124441265868048,0.0,0.0
25593,2,5593,[268 258 235 742 132],417,3,21326,3.812298891669646,0.0,0.0
25594,2,5594,[294 204 125 288 245],345,1,21327,3.8117962466487936,0.0,20.0
25595,2,5595,[  1 385 237 125 186],588,2,21329,3.8114724803431024,0.0,0.0
25596,2,5596,[ 64  12 269 357 301],416,5,21334,3.8116848311595497,40.0,0.0
25597,2,5597,[435 302  98 202 603],297,3,21337,3.811539835655591,0.0,20.0
25598,2,5598,[222 132 183  96 175],253,4,21341,3.811573495267012,0.0,0.0
25599,2,5599,[ 64  12 269 357 301],416,5,21346,3.811785714285714,40.0,0.0
25600,2,5600,[568 111 117  88 483],751,3,21349,3.8116407784324227,20.0,0.0
25601,2,5601,[265 222 471 357 603],297,3,21352,3.811495894323456,0.0,0.0
25602,2,5602,[181  22 234 100 200],262,1,21353,3.8109941102980547,0.0,20.0
25603,2,5603,[ 64  12 269 357 301],416,5,21358,3.8112062812276943,40.0,0.0
25604,2,5604,[ 64  12 269 357 301],416,5,21363,3.8114183764495984,40.0,0.0
25605,2,5605,[238  64 286 191 100],62,4,21367,3.811452015697467,20.0,0.0
25606,2,5606,[118   8  22 153 496],601,3,21370,3.811307294453362,0.0,0.0
25607,2,5607,[ 64  12 269 357 301],416,5,21375,3.811519258202568,40.0,0.0
25608,2,5608,[179  98 215 286  70],416,4,21379,3.811552861472633,0.0,20.0
25609,2,5609,[210 271 302 143 200],297,3,21382,3.811408199643494,0.0,0.0
25610,2,5610,[ 25 172 117 197 403],805,4,21386,3.811441810728925,0.0,0.0
25611,2,5611,[ 64  12 269 357 301],416,5,21391,3.811653599429793,40.0,0.0
25612,2,5612,[144  96 588 357   1],417,2,21393,3.8113308391234635,0.0,0.0
25613,2,5613,[185   4  50 245 258],417,2,21395,3.8110081938012113,0.0,20.0
25614,2,5614,[ 64  12 269 357 301],416,5,21400,3.811219946571683,40.0,0.0
25615,2,5615,[ 64  12 269 357 301],416,5,21405,3.811431623931624,40.0,0.0
25616,2,5616,[568 197 289 286 300],345,2,21407,3.8111091329891402,0.0,0.0
25617,2,5617,[ 64  12 269 357 301],416,5,21412,3.811320754716981,40.0,0.0
25618,2,5618,[ 64  12 269 357 301],416,5,21417,3.811532301121196,40.0,0.0
25619,2,5619,[ 64  12 269 357 301],416,5,21422,3.811743772241993,40.0,0.0
25620,2,5620,[211 143 588 172  11],43,5,21427,3.811955168119552,0.0,0.0
25621,2,5621,[216 742 328 282 568],314,4,21431,3.811988616150836,0.0,0.0
25622,2,5622,[ 64  12 269 357 301],416,5,21436,3.8121998932953938,40.0,0.0
25623,2,5623,[191  98 300 200  69],297,1,21437,3.8116998577524894,0.0,20.0
25624,2,5624,[318 210 597 144  71],416,4,21441,3.811733333333333,20.0,0.0
25625,2,5625,[118 185  98 117 132],417,4,21445,3.8117667970138642,0.0,20.0
25626,2,5626,[ 12 111  97 185 403],416,5,21450,3.8119779633907944,20.0,0.0
25627,2,5627,[427 176  98 132 328],416,5,21455,3.8121890547263684,0.0,20.0
25628,2,5628,[ 64  12 269 357 301],416,5,21460,3.812400071060579,40.0,0.0
25629,2,5629,[196 269 568 151  22],711,4,21464,3.8124333925399645,0.0,0.0
25630,2,5630,[ 64  12 269 357 301],416,5,21469,3.812644290534541,40.0,0.0
25631,2,5631,[222 288  89 475  69],711,2,21471,3.8123224431818183,0.0,20.0
25632,2,5632,[ 64  12 269 357 301],416,5,21476,3.812533285993254,40.0,0.0
25633,2,5633,[ 64  12 269 357 301],416,5,21481,3.8127440539581117,40.0,0.0
25634,2,5634,[181 117 204   9 176],62,4,21485,3.812777284826974,0.0,20.0
25635,2,5635,[ 98 385 471 568  79],345,3,21488,3.8126330731014906,0.0,20.0
25636,2,5636,[ 64  12 269 357 301],416,5,21493,3.8128437111938975,40.0,0.0
25637,2,5637,[ 79 100 294 176   9],854,3,21496,3.8126995388435616,0.0,0.0
25638,2,5638,[238 179 289  96 204],49,3,21499,3.8125554176272387,0.0,0.0
25639,2,5639,[588 257 289 318 301],43,5,21504,3.8127659574468087,20.0,0.0
25640,2,5640,[ 64  12 269 357 301],416,5,21509,3.812976422620103,40.0,0.0
25641,2,5641,[ 64  12 269 357 301],416,5,21514,3.8131868131868134,40.0,0.0
25642,2,5642,[ 70  56 121 111  11],654,5,21519,3.813397129186603,0.0,0.0
25643,2,5643,[235 288  88 121   4],416,3,21522,3.8132530120481927,0.0,20.0
25644,2,5644,[ 12 322 323 151  50],805,4,21526,3.813286093888397,20.0,20.0
25645,2,5645,[186  96 748  97 185],198,2,21528,3.812964930924548,0.0,0.0
25646,2,5646,[245 238  96 200 125],417,4,21532,3.812998052063042,0.0,0.0
25647,2,5647,[204 187 151 125 161],618,2,21534,3.8126770538243626,0.0,0.0
25648,2,5648,[357  70   7 202 588],230,4,21538,3.812710214197203,0.0,0.0
25649,2,5649,[186 132 318 427 196],405,4,21542,3.8127433628318586,20.0,0.0
25650,2,5650,[ 64  12 269 357 301],416,5,21547,3.812953459564679,40.0,0.0
25651,2,5651,[ 64  12 269 357 301],416,5,21552,3.813163481953291,40.0,0.0
25652,2,5652,[ 64  12 269 357 301],416,5,21557,3.8133734300371485,40.0,0.0
25653,2,5653,[  7 328 357  28 181],416,5,21562,3.8135833038556775,0.0,20.0
25654,2,5654,[ 64  12 269 357 301],416,5,21567,3.8137931034482757,40.0,0.0
25655,2,5655,[405 144 174  70 237],751,3,21570,3.8136492220650635,0.0,0.0
25656,2,5656,[546 258 271  11 185],297,3,21573,3.813505391550292,0.0,0.0
25657,2,5657,[ 64  12 269 357 301],416,5,21578,3.813715093672676,40.0,0.0
25658,2,5658,[202 173 211   7 323],416,4,21582,3.8137480120162572,0.0,0.0
25659,2,5659,[111  79 265 423 328],416,5,21587,3.813957597173145,0.0,0.0
25660,2,5660,[161 475 215 265 204],711,2,21589,3.813637166578343,0.0,0.0
25661,2,5661,[597 185 588 202 172],417,1,21590,3.8131402331331685,0.0,0.0
25662,2,5662,[202 268 197 117 204],128,3,21593,3.8129966448878685,0.0,0.0
25663,2,5663,[ 64  12 269 357 301],416,5,21598,3.8132062146892656,40.0,0.0
25664,2,5664,[245 100 265 328 179],416,3,21601,3.81306266548985,0.0,0.0
25665,2,5665,[172  22  89  95  82],805,2,21603,3.812742675608895,0.0,0.0
25666,2,5666,[ 28 294 143 191 427],262,2,21605,3.8124227986589023,0.0,0.0
25667,2,5667,[603  79 210  69 427],405,4,21609,3.8124558927311223,0.0,0.0
25668,2,5668,[403 180  95 196  22],405,2,21611,3.812136179220321,0.0,0.0
25669,2,5669,[174 588 222 302 176],417,1,21612,3.8116402116402117,0.0,0.0
25670,2,5670,[ 22  82 172  64 197],373,3,21615,3.8114970904602363,20.0,0.0
25671,2,5671,[238 302 269 742  79],854,3,21618,3.8113540197461213,0.0,0.0
25672,2,5672,[  4 151 202 286  12],373,3,21621,3.811210999471179,20.0,0.0
25673,2,5673,[ 64  12 269 357 301],416,5,21626,3.811420514628128,40.0,0.0
25674,2,5674,[186 132 181  98 276],230,5,21631,3.8116299559471365,0.0,40.0
25675,2,5675,[ 11 161 300 427 423],416,5,21636,3.8118393234672303,0.0,0.0
25676,2,5676,[273 483  97 125 182],417,4,21640,3.811872467852739,20.0,0.0
25677,2,5677,[118 195  22 174   7],618,3,21643,3.8117294822120464,0.0,0.0
25678,2,5678,[173  70 237 172  89],198,3,21646,3.811586546927276,0.0,0.0
25679,2,5679,[ 56 294 204 588 313],642,5,21651,3.811795774647887,20.0,20.0
25680,2,5680,[ 64  12 269 357 301],416,5,21656,3.8120049287097344,40.0,0.0
25681,2,5681,[185  11  98  12  50],214,4,21660,3.812038014783527,20.0,40.0
25682,2,5682,[ 82 161 294  12 403],416,5,21665,3.8122470526130563,20.0,0.0
25683,2,5683,[202  97  82 328 210],416,5,21670,3.8124560168895143,0.0,0.0
25684,2,5684,[588  22 258 215 275],416,5,21675,3.812664907651715,0.0,0.0
25685,2,5685,[  9 216  88 603  71],416,4,21679,3.8126978543791767,0.0,0.0
25686,2,5686,[111 151 403 143  88],345,4,21683,3.8127307895199576,0.0,0.0
25687,2,5687,[655  25  88 302  11],345,4,21687,3.8127637130801686,0.0,0.0
25688,2,5688,[228  50 276 135  82],62,4,21691,3.812796625065917,0.0,20.0
25689,2,5689,[237 200 423 318 182],618,5,21696,3.813005272407733,20.0,0.0
25690,2,5690,[ 64  12 269 357 301],416,5,21701,3.8132138464241785,40.0,0.0
25691,2,5691,[125 202   1 568 427],618,3,21704,3.8130709768095574,0.0,0.0
25692,2,5692,[ 64  12 269 357 301],416,5,21709,3.8132794660108904,40.0,0.0
25693,2,5693,[ 88  89  11 191 210],805,2,21711,3.8129610115911485,0.0,0.0
25694,2,5694,[216 175 269  12 318],373,4,21715,3.812993854258121,40.0,0.0
25695,2,5695,[ 64  12 269 357 301],416,5,21720,3.813202247191011,40.0,0.0
25696,2,5696,[ 64  12 269 357 301],416,5,21725,3.8134105669650693,40.0,0.0
25697,2,5697,[258 678 151 175 405],805,3,21728,3.8132678132678133,0.0,0.0
25698,2,5698,[180 294  22  79 655],805,1,21729,3.8127741709071765,0.0,0.0
25699,2,5699,[234  79 742  82  69],588,4,21733,3.8128070175438595,0.0,0.0
25700,2,5700,[187 117 273  70 174],416,5,21738,3.8130152604806176,0.0,0.0
25701,2,5701,[  1 121 294 235 175],49,1,21739,3.8125219221325852,0.0,0.0
25702,2,5702,[269 313  97 276 268],354,2,21741,3.8122041031036296,20.0,20.0
25703,2,5703,[ 88 655 286  98 257],416,3,21744,3.8120617110799437,0.0,20.0
25704,2,5704,[ 64  12 269 357 301],416,5,21749,3.812269938650307,40.0,0.0
25705,2,5705,[ 56 258 204 195 228],62,3,21752,3.8121275849982474,0.0,0.0
25706,2,5706,[ 64  12 269 357 301],416,5,21757,3.812335728053268,40.0,0.0
25707,2,5707,[286 265 222  50 333],588,4,21761,3.8123686054660126,0.0,20.0
25708,2,5708,[174  89 117 153  97],62,4,21765,3.812401471361009,0.0,0.0
25709,2,5709,[237 508  64 282  95],314,4,21769,3.812434325744308,20.0,0.0
25710,2,5710,[200 183 204 235 172],416,4,21773,3.8124671686219576,0.0,0.0
25711,2,5711,[ 64  12 269 357 301],416,5,21778,3.8126750700280114,40.0,0.0
25712,2,5712,[ 64  12 269 357 301],416,5,21783,3.8128828986521968,40.0,0.0
25713,2,5713,[ 64  12 269 357 301],416,5,21788,3.8130906545327266,40.0,0.0
25714,2,5714,[183 318   1 186  69],618,5,21793,3.8132983377077867,20.0,0.0
25715,2,5715,[234 210 748 211 294],417,4,21797,3.8133310006997903,0.0,0.0
25716,2,5716,[ 64  12 269 357 301],416,5,21802,3.8135385691796397,40.0,0.0
25717,2,5717,[ 64  12 269 357 301],416,5,21807,3.8137460650577126,40.0,0.0
25718,2,5718,[100 273 173 282 202],764,3,21810,3.8136037768840705,0.0,0.0
25719,2,5719,[ 64  12 269 357 301],416,5,21815,3.8138111888111887,40.0,0.0
25720,2,5720,[273 215   4 288 300],297,1,21816,3.8133193497640274,0.0,20.0
25721,2,5721,[ 64  12 269 357 301],416,5,21821,3.813526738902482,40.0,0.0
25722,2,5722,[ 64  12 269 357 301],416,5,21826,3.813734055565263,40.0,0.0
25723,2,5723,[ 64  12 269 357 301],416,5,21831,3.8139412997903563,40.0,0.0
25724,2,5724,[168   1 276 742 153],62,3,21834,3.8137991266375546,0.0,0.0
25725,2,5725,[111  15 183 471 313],618,2,21836,3.8134823611596227,20.0,20.0
25726,2,5726,[ 64  12 269 357 301],416,5,21841,3.8136895407717826,40.0,0.0
25727,2,5727,[ 64  12 269 357 301],416,5,21846,3.8138966480446927,40.0,0.0
25728,2,5728,[ 56 100 323 568 302],417,1,21847,3.8134054808867166,0.0,0.0
25729,2,5729,[ 64  12 269 357 301],416,5,21852,3.8136125654450264,40.0,0.0
25730,2,5730,[475 275 655  12 151],437,4,21856,3.813645088117257,20.0,0.0
25731,2,5731,[ 64  12 269 357 301],416,5,21861,3.8138520586182834,40.0,0.0
25732,2,5732,[185 423  97 186 143],711,3,21864,3.813710099424385,0.0,0.0
25733,2,5733,[ 64  12 269 357 301],416,5,21869,3.8139169863969307,40.0,0.0
25734,2,5734,[100  97  56 546 117],654,3,21872,3.8137750653879685,0.0,0.0
25735,2,5735,[196 132 174 238 185],214,5,21877,3.813981868898187,0.0,0.0
25736,2,5736,[ 88 588 100 276  69],43,5,21882,3.8141886003137526,0.0,0.0
25737,2,5737,[ 64  12 269 357 301],416,5,21887,3.81439525967236,40.0,0.0
25738,2,5738,[ 88 174   9 273 191],416,4,21891,3.814427600627287,0.0,0.0
25739,2,5739,[ 64  12 269 357 301],416,5,21896,3.8146341463414632,40.0,0.0
25740,2,5740,[197  82 496  95 286],373,2,21898,3.8143180630552167,0.0,0.0
25741,2,5741,[235  97 117 313 302],43,4,21902,3.8143504005572972,20.0,20.0
25742,2,5742,[172 100 135 181   9],698,1,21903,3.813860351732544,0.0,20.0
25743,2,5743,[  8 151 118 185 258],601,2,21905,3.8135445682451254,0.0,0.0
25744,2,5744,[294 405 357 403 191],642,3,21908,3.8134029590948653,0.0,0.0
25745,2,5745,[121 405  89 204 258],805,1,21909,3.8129133310128784,0.0,0.0
25746,2,5746,[ 64  12 269 357 301],416,5,21914,3.81311988863755,40.0,0.0
25747,2,5747,[ 64  12 269 357 301],416,5,21919,3.8133263743910923,40.0,0.0
25748,2,5748,[117 127 151  25  56],805,3,21922,3.8131849017220385,0.0,0.0
25749,2,5749,[172 282 515  88 258],416,4,21926,3.813217391304348,0.0,0.0
25750,2,5750,[588  22 168 318  98],405,3,21929,3.813075986784907,20.0,20.0
25751,2,5751,[ 64  12 269 357 301],416,5,21934,3.8132823365785815,40.0,0.0
25752,2,5752,[328 172 111   1 258],721,4,21938,3.8133147922822874,0.0,0.0
25753,2,5753,[197 173 168   1  50],128,5,21943,3.813521028849496,0.0,20.0
25754,2,5754,[ 95 127 196  82 357],373,3,21946,3.8133796698523024,0.0,0.0
25755,2,5755,[195  71 265 427 144],373,4,21950,3.813412091730368,0.0,0.0
25756,2,5756,[475 117 385  56 423],198,2,21952,3.8130970991836026,0.0,0.0
25757,2,5757,[ 11  70 111 182 215],297,2,21954,3.8127822160472387,0.0,0.0
25758,2,5758,[475 228   4 176 271],297,2,21956,3.812467442264282,0.0,0.0
25759,2,5759,[423  98 204  22 318],887,3,21959,3.8123263888888888,20.0,20.0
25760,2,5760,[ 64  12 269 357 301],416,5,21964,3.812532546432911,40.0,0.0
25761,2,5761,[ 64  12 269 357 301],416,5,21969,3.8127386324192987,40.0,0.0
25762,2,5762,[423 568 176 127  82],62,3,21972,3.812597605413847,0.0,0.0
25763,2,5763,[238 144 328 275 117],373,4,21976,3.8126301179736295,0.0,0.0
25764,2,5764,[ 71  25 210 191 268],128,3,21979,3.812489158716392,0.0,0.0
25765,2,5765,[117 191 655  97  96],705,2,21981,3.812174817898023,0.0,0.0
25766,2,5766,[ 64  11 215 271  56],43,4,21985,3.812207386856251,20.0,0.0
25767,2,5767,[153 191 423 234 125],262,2,21987,3.811893203883495,0.0,0.0
25768,2,5768,[475 588 210 271   7],297,4,21991,3.811925810365748,0.0,0.0
25769,2,5769,[546 588  82 268  70],654,4,21995,3.8119584055459272,0.0,0.0
25770,2,5770,[173  12 100 300 357],24,5,22000,3.812164269623982,20.0,0.0
25771,2,5771,[ 64  12 269 357 301],416,5,22005,3.8123700623700625,40.0,0.0
25772,2,5772,[ 79  25 475 174  97],417,2,22007,3.812056123332756,0.0,0.0
25773,2,5773,[ 56 185  97   7 118],198,2,22009,3.8117422930377556,0.0,0.0
25774,2,5774,[ 95 186  82 357  97],642,4,22013,3.811774891774892,0.0,0.0
25775,2,5775,[302  79 742  70 588],417,1,22014,3.811288088642659,0.0,0.0
25776,2,5776,[ 56 179 238  95 234],417,5,22019,3.8114938549420114,0.0,0.0
25777,2,5777,[180 195 161 568 385],373,3,22022,3.8113534094842505,0.0,0.0
25778,2,5778,[ 64  12 269 301 357],416,5,22027,3.8115590932687318,40.0,0.0
25779,2,5779,[423 222  96 200 179],198,3,22030,3.811418685121107,0.0,0.0
25780,2,5780,[475  79 286 144 288],417,2,22032,3.811105345096004,0.0,20.0
25781,2,5781,[132 143  70  64 117],198,2,22034,3.810792113455552,20.0,0.0
25782,2,5782,[268 202  97 228  98],128,1,22035,3.810306069514093,0.0,20.0
25783,2,5783,[ 64  12 269 301 357],416,5,22040,3.8105117565698476,40.0,0.0
25784,2,5784,[323 111  98  12 194],416,4,22044,3.810544511668107,20.0,20.0
25785,2,5785,[655 403 180 301 222],711,4,22048,3.8105772554441755,0.0,0.0
25786,2,5786,[182  79 216 269 508],297,3,22051,3.8104371867979956,0.0,0.0
25787,2,5787,[196   4 100  12 204],297,3,22054,3.8102971665514858,20.0,0.0
25788,2,5788,[237  82 301 322 100],416,3,22057,3.8101571946795647,0.0,0.0
25789,2,5789,[168  96 202 181 385],416,5,22062,3.810362694300518,0.0,20.0
25790,2,5790,[ 79 269 588 168  69],373,4,22066,3.810395441201865,0.0,0.0
25791,2,5791,[313 328   7 204 258],43,5,22071,3.8106008287292816,20.0,20.0
25792,2,5792,[ 64  12 269 301 357],416,5,22076,3.8108061453478337,40.0,0.0
25793,2,5793,[323 333 257 238 200],416,3,22079,3.810666206420435,0.0,0.0
25794,2,5794,[294 172 144  71 135],62,3,22082,3.8105263157894735,0.0,0.0
25795,2,5795,[ 64  12 269 301 357],416,5,22087,3.8107315389924086,40.0,0.0
25796,2,5796,[228  69 118 195 385],198,1,22088,3.810246679316888,0.0,0.0
25797,2,5797,[143 111 597  56 385],43,4,22092,3.8102794066919627,0.0,0.0
25798,2,5798,[ 64  12 269 301 357],416,5,22097,3.8104845663045355,40.0,0.0
25799,2,5799,[748 143  88 127 183],416,4,22101,3.8105172413793102,0.0,0.0
25800,2,5800,[185 175 200 300 143],297,3,22104,3.810377521117049,0.0,0.0
25801,2,5801,[ 11 427 173 168 237],618,4,22108,3.8104102033781455,0.0,0.0
25802,2,5802,[ 95  22 195 204 288],887,5,22113,3.8106151990349817,0.0,20.0
25803,2,5803,[100 423 183 238 121],416,5,22118,3.810820124052378,0.0,0.0
25804,2,5804,[ 64  12 269 301 357],416,5,22123,3.811024978466839,40.0,0.0
25805,2,5805,[ 82 245  97 276 357],416,3,22126,3.810885291078195,0.0,0.0
25806,2,5806,[ 97 313 161  79  64],618,5,22131,3.8110900637162044,40.0,20.0
25807,2,5807,[ 64  12 269 301 357],416,5,22136,3.8112947658402203,40.0,0.0
25808,2,5808,[ 64  12 269 301 357],416,5,22141,3.8114993974866587,40.0,0.0
25809,2,5809,[ 64 271 172 216  50],62,4,22145,3.8115318416523234,20.0,20.0
25810,2,5810,[ 82 204 135  25  56],230,2,22147,3.8112200998107038,0.0,0.0
25811,2,5811,[ 64  12 269 301 357],416,5,22152,3.811424638678596,40.0,0.0
25812,2,5812,[  7  95 191  15 182],416,4,22156,3.8114570789609497,0.0,0.0
25813,2,5813,[403  82  25 176 191],618,4,22160,3.8114895080839353,0.0,0.0
25814,2,5814,[174 125  95 403 100],588,1,22161,3.811006018916595,0.0,0.0
25815,2,5815,[597 173  79 228 174],705,3,22164,3.8108665749656123,0.0,0.0
25816,2,5816,[ 71 100  15  28 655],437,3,22167,3.810727178958226,0.0,0.0
25817,2,5817,[ 64  12 269 301 357],416,5,22172,3.810931591612238,40.0,0.0
25818,2,5818,[ 64  12 269 301 357],416,5,22177,3.81113593400928,40.0,0.0
25819,2,5819,[182 234 496 742  50],417,2,22179,3.810824742268041,0.0,20.0
25820,2,5820,[ 64  12 269 301 357],416,5,22184,3.8110290328122316,40.0,0.0
25821,2,5821,[ 64  12 269 301 357],416,5,22189,3.811233253177602,40.0,0.0
25822,2,5822,[ 25   7 118 117 125],618,2,22191,3.8109222050489437,0.0,0.0
25823,2,5823,[ 64  12 269 301 357],416,5,22196,3.8111263736263736,40.0,0.0
25824,2,5824,[ 64  12 269 301 357],416,5,22201,3.811330472103004,40.0,0.0
25825,2,5825,[265   9  28 118 127],618,3,22204,3.8111912118091316,0.0,0.0
25826,2,5826,[ 64  12 269 301 357],416,5,22209,3.8113952291058864,40.0,0.0
25827,2,5827,[  1 237 286 288  50],416,4,22213,3.8114275909402884,0.0,40.0
25828,2,5828,[ 64  12 269 301 357],416,5,22218,3.811631497683994,40.0,0.0
25829,2,5829,[ 64  12 269 301 357],416,5,22223,3.811835334476844,40.0,0.0
25830,2,5830,[ 64  12 269 301 357],416,5,22228,3.8120391013548276,40.0,0.0
25831,2,5831,[222 191 237  50 471],854,3,22231,3.811899862825789,0.0,20.0
25832,2,5832,[258 186   7  25 180],198,3,22234,3.8117606720384023,0.0,0.0
25833,2,5833,[ 64  12 269 301 357],416,5,22239,3.8119643469317794,40.0,0.0
25834,2,5834,[ 79 151 238 173  98],214,5,22244,3.81216795201371,0.0,20.0
25835,2,5835,[ 64  12 269 301 357],416,5,22249,3.8123714873200822,40.0,0.0
25836,2,5836,[237   8 118 194 403],416,3,22252,3.8122323111187253,0.0,0.0
25837,2,5837,[ 97  64 302 161 174],417,2,22254,3.811921891058582,20.0,0.0
25838,2,5838,[ 64  12 269 301 357],416,5,22259,3.8121253639321804,40.0,0.0
25839,2,5839,[ 64  12 269 301 357],416,5,22264,3.8123287671232875,40.0,0.0
25840,2,5840,[215   4 181  15 568],618,3,22267,3.812189693545626,0.0,20.0
25841,2,5841,[ 64  12 269 301 357],416,5,22272,3.81239301609038,40.0,0.0
25842,2,5842,[ 64  12 269 301 357],416,5,22277,3.8125962690398767,40.0,0.0
25843,2,5843,[153 471  56 288 186],854,3,22280,3.812457221081451,0.0,20.0
25844,2,5844,[ 70 202  50 197 546],416,4,22284,3.8124893071000856,0.0,20.0
25845,2,5845,[  8 435 678 357 153],721,4,22288,3.8125213821416355,0.0,0.0
25846,2,5846,[546 204 191 288  50],805,2,22290,3.8122113904566444,0.0,40.0
25847,2,5847,[ 64  12 269 301 357],416,5,22295,3.8124145006839947,40.0,0.0
25848,2,5848,[186 200 357 273 597],417,3,22298,3.8122756026671225,0.0,0.0
25849,2,5849,[187 161  50 265 176],416,5,22303,3.8124786324786326,0.0,20.0
25850,2,5850,[200  25 144 153 176],417,3,22306,3.8123397709793196,0.0,0.0
25851,2,5851,[ 64  12 269 301 357],416,5,22311,3.8125427204374573,40.0,0.0
25852,2,5852,[357 276 191 228 132],601,5,22316,3.812745600546728,0.0,0.0
25853,2,5853,[ 64  12 269 301 357],416,5,22321,3.8129484113426715,40.0,0.0
25854,2,5854,[ 64  12 269 301 357],416,5,22326,3.8131511528608026,40.0,0.0
25855,2,5855,[ 69  71  56 318  96],62,5,22331,3.813353825136612,20.0,0.0
25856,2,5856,[216 357 111 197 143],805,2,22333,3.813044220590746,0.0,0.0
25857,2,5857,[ 64  12 269 301 357],416,5,22338,3.813246841925572,40.0,0.0
25858,2,5858,[172 385  64 258  11],416,5,22343,3.8134493940945555,20.0,0.0
25859,2,5859,[238 186  56 202 174],43,3,22346,3.813310580204778,0.0,0.0
25860,2,5860,[ 64  12 269 301 357],416,5,22351,3.8135130523801397,40.0,0.0
25861,2,5861,[ 64  12 269 301 357],416,5,22356,3.813715455475947,40.0,0.0
25862,2,5862,[475 546 496  88 117],416,2,22358,3.8134061060890327,0.0,0.0
25863,2,5863,[ 64  12 269 301 357],416,5,22363,3.8136084583901773,40.0,0.0
25864,2,5864,[ 64  50 273 200   1],253,4,22367,3.8136402387041772,20.0,20.0
25865,2,5865,[ 12  70  79 176   1],618,4,22371,3.813672008182748,20.0,0.0
25866,2,5866,[151 222 211  79 186],354,1,22372,3.813192432248168,0.0,0.0
25867,2,5867,[174  15 588 173 175],922,4,22376,3.8132242672119974,0.0,0.0
25868,2,5868,[357  28 588  82  79],416,5,22381,3.813426478105299,0.0,0.0
25869,2,5869,[ 79 194 357 181 191],373,5,22386,3.8136286201022145,0.0,20.0
25870,2,5870,[ 64  12 269 301 357],416,5,22391,3.813830693237949,40.0,0.0
25871,2,5871,[ 64 748 196 273 100],417,3,22394,3.813692098092643,20.0,0.0
25872,2,5872,[ 64  12 269 301 357],416,5,22399,3.813894091605653,40.0,0.0
25873,2,5873,[117 273  64  11  25],618,4,22403,3.813925774599932,20.0,0.0
25874,2,5874,[ 11 181 117 175 275],297,5,22408,3.814127659574468,0.0,20.0
25875,2,5875,[200 144 245 748 294],416,4,22412,3.814159292035398,0.0,0.0
25876,2,5876,[  8 204 385  11 323],416,4,22416,3.8141909137314958,0.0,0.0
25877,2,5877,[ 89 174 385 176 172],922,3,22419,3.8140523987750936,0.0,0.0
25878,2,5878,[300 181 196  50 275],654,4,22423,3.8140840278959005,0.0,40.0
25879,2,5879,[ 64  12 269 301 357],416,5,22428,3.8142857142857145,40.0,0.0
25880,2,5880,[678 234 273 191  82],416,4,22432,3.814317292977385,0.0,0.0
25881,2,5881,[215 144 435 118 228],297,0,22432,3.813668820129208,0.0,0.0
25882,2,5882,[748 423  97 181  98],505,3,22435,3.813530511643719,0.0,40.0
25883,2,5883,[496 323 300 125   1],630,3,22438,3.813392250169952,0.0,0.0
25884,2,5884,[588 173 357 568 427],416,5,22443,3.813593882752761,0.0,0.0
25885,2,5885,[176 597   7 185 228],805,3,22446,3.8134556574923546,0.0,0.0
25886,2,5886,[ 64  12 269 301 357],416,5,22451,3.8136572108034654,40.0,0.0
25887,2,5887,[125 405 216 423   1],230,5,22456,3.813858695652174,0.0,0.0
25888,2,5888,[ 64  12 269 301 357],416,5,22461,3.8140601120733573,40.0,0.0
25889,2,5889,[ 64  12 269 301 357],416,5,22466,3.8142614601018674,40.0,0.0
25890,2,5890,[ 64  12 269 301 357],416,5,22471,3.8144627397725346,40.0,0.0
25891,2,5891,[ 98 282 173   4  95],297,2,22473,3.814154786150713,0.0,20.0
25892,2,5892,[204 385  28 275 143],262,1,22474,3.81367724418802,0.0,0.0
25893,2,5893,[151 275  25  70  22],373,5,22479,3.813878520529352,0.0,0.0
25894,2,5894,[323 403 183 179 508],417,3,22482,3.813740458015267,0.0,0.0
25895,2,5895,[ 64  12 269 301 357],416,5,22487,3.813941655359566,40.0,0.0
25896,2,5896,[ 64  12 269 301 357],416,5,22492,3.8141427844666778,40.0,0.0
25897,2,5897,[ 64  12 269 301 357],416,5,22497,3.814343845371312,40.0,0.0
25898,2,5898,[187 173  97 125  88],505,2,22499,3.8140362773351417,0.0,0.0
25899,2,5899,[ 82 357 153 475   7],805,4,22503,3.8140677966101695,0.0,0.0
25900,2,5900,[111 176  70   7 588],764,5,22508,3.814268768005423,0.0,0.0
25901,2,5901,[ 64  12 269 301 357],416,5,22513,3.814469671297865,40.0,0.0
25902,2,5902,[568 194 185 168   8],416,5,22518,3.8146705065221074,0.0,0.0
25903,2,5903,[265 357  88 228 132],405,2,22520,3.8143631436314362,0.0,0.0
25904,2,5904,[ 64  12 269 301 357],416,5,22525,3.8145639288738358,40.0,0.0
25905,2,5905,[216  69 172  88 357],416,4,22529,3.814595326786319,0.0,0.0
25906,2,5906,[405 237   1  71 121],642,4,22533,3.814626714068055,0.0,0.0
25907,2,5907,[ 95  15  89  96 153],642,3,22536,3.814488828706838,0.0,0.0
25908,2,5908,[403 275 161   9 143],416,5,22541,3.814689456760873,0.0,0.0
25909,2,5909,[546  50 195 179 172],262,1,22542,3.814213197969543,0.0,20.0
25910,2,5910,[286  11 173  56 144],43,5,22547,3.8144138047707665,0.0,0.0
25911,2,5911,[185   7 294 483 234],417,3,22550,3.814276048714479,20.0,0.0
25912,2,5912,[100 301 269  64  25],416,5,22555,3.8144765770336546,20.0,0.0
25913,2,5913,[ 12 318 172 151 258],654,5,22560,3.814677037538045,40.0,0.0
25914,2,5914,[ 28  95 196  89 172],373,4,22564,3.8147083685545224,0.0,0.0
25915,2,5915,[357 228 475 200 302],417,3,22567,3.8145706558485464,0.0,0.0
25916,2,5916,[168 132  64 176 161],230,5,22572,3.814770998816968,20.0,0.0
25917,2,5917,[ 64  12 269 301 357],416,5,22577,3.8149712740790807,40.0,0.0
25918,2,5918,[748 515 121 143 176],416,5,22582,3.815171481669201,0.0,0.0
25919,2,5919,[ 64  12 269 301 357],416,5,22587,3.8153716216216216,40.0,0.0
25920,2,5920,[385  64  15  28 245],642,5,22592,3.8155716939706132,20.0,0.0
25921,2,5921,[269 180  56 144 258],854,4,22596,3.8156028368794326,0.0,0.0
25922,2,5922,[ 22 191 475 172   1],805,4,22600,3.8156339692723282,0.0,0.0
25923,2,5923,[ 98  12  56 215 496],43,5,22605,3.8158338960162053,20.0,20.0
25924,2,5924,[ 64  12 269 301 357],416,5,22610,3.816033755274262,40.0,0.0
25925,2,5925,[257  82 173 286 546],416,3,22613,3.815896051299359,0.0,0.0
25926,2,5926,[ 64  12 269 301 357],416,5,22618,3.8160958326303356,40.0,0.0
25927,2,5927,[172 117 265  82 385],416,5,22623,3.8162955465587043,0.0,0.0
25928,2,5928,[204 655  88 597 183],618,4,22627,3.816326530612245,0.0,0.0
25929,2,5929,[ 96 117 258 333 357],416,5,22632,3.8165261382799325,0.0,0.0
25930,2,5930,[121   8 204 405  96],601,0,22632,3.815882650480526,0.0,0.0
25931,2,5931,[195 496 603 176 135],698,3,22635,3.8157451112609575,0.0,0.0
25932,2,5932,[125 471 202 282 588],618,1,22636,3.8152705208157762,0.0,0.0
25933,2,5933,[435 496  95 174  97],437,3,22639,3.815133131108864,0.0,0.0
25934,2,5934,[ 89 273 748 211 127],417,4,22643,3.8151642796967145,0.0,0.0
25935,2,5935,[275 288 301 265 132],588,4,22647,3.8151954177897576,0.0,20.0
25936,2,5936,[ 64  12 269 301 357],416,5,22652,3.815394980629948,40.0,0.0
25937,2,5937,[ 64  12 269 301 357],416,5,22657,3.815594476254631,40.0,0.0
25938,2,5938,[546 100  15 196 423],416,4,22661,3.815625526182859,0.0,0.0
25939,2,5939,[173 655 191 117 597],618,4,22665,3.8156565656565657,0.0,0.0
25940,2,5940,[ 82 269  98  79 228],805,3,22668,3.8155192728496887,0.0,20.0
25941,2,5941,[234 496 258 427 588],642,2,22670,3.815213732749916,0.0,0.0
25942,2,5942,[ 64  12 269 301 357],416,5,22675,3.8154130910314654,40.0,0.0
25943,2,5943,[ 56 423 183 180 216],437,4,22679,3.815444145356662,0.0,0.0
25944,2,5944,[282 117 234  28 471],618,3,22682,3.8153069806560134,0.0,0.0
25945,2,5945,[257  95 475 238 216],342,4,22686,3.8153380423814327,0.0,0.0
25946,2,5946,[294 168 245 127 405],417,4,22690,3.8153690936606695,0.0,0.0
25947,2,5947,[ 64  12 269 301 357],416,5,22695,3.8155682582380632,40.0,0.0
25948,2,5948,[405 111 423 302 288],854,3,22698,3.815431164901664,0.0,20.0
25949,2,5949,[174  98 185 132 603],416,5,22703,3.8156302521008403,0.0,20.0
25950,2,5950,[238 265 161 100  28],618,4,22707,3.8156612334061504,0.0,0.0
25951,2,5951,[257 427 194  82 172],416,4,22711,3.8156922043010755,0.0,0.0
25952,2,5952,[179  69 132 117 195],437,2,22713,3.815387199731228,0.0,0.0
25953,2,5953,[403  96 175 174  11],805,3,22716,3.8152502519314746,0.0,0.0
25954,2,5954,[216 385   7 742 118],43,5,22721,3.8154492023509654,0.0,0.0
25955,2,5955,[ 64  12 269 301 357],416,5,22726,3.815648085963734,40.0,0.0
25956,2,5956,[496 313   8 100   7],43,5,22731,3.8158469028034245,20.0,20.0
25957,2,5957,[132 302 238 222 385],417,3,22734,3.8157099697885197,0.0,0.0
25958,2,5958,[ 64  12 269 301 357],416,5,22739,3.8159087095150195,40.0,0.0
25959,2,5959,[202 588  25 111 210],43,5,22744,3.8161073825503355,0.0,0.0
25960,2,5960,[ 25 172 286 318 117],907,5,22749,3.816305988928032,20.0,0.0
25961,2,5961,[144  95 405 427 237],230,4,22753,3.8163367997316335,0.0,0.0
25962,2,5962,[ 71 273 568  96 597],805,1,22754,3.815864497736039,0.0,0.0
25963,2,5963,[215  82 202 427 273],416,5,22759,3.8160630449362842,0.0,0.0
25964,2,5964,[ 64  12 269 301 357],416,5,22764,3.8162615255658006,40.0,0.0
25965,2,5965,[ 64  12 269 301 357],416,5,22769,3.8164599396580625,40.0,0.0
25966,2,5966,[ 64  12 269 301 357],416,5,22774,3.8166582872465225,40.0,0.0
25967,2,5967,[ 64  12 269 301 357],416,5,22779,3.8168565683646114,40.0,0.0
25968,2,5968,[  1 151 117 282 100],203,2,22781,3.816552186295862,0.0,0.0
25969,2,5969,[302 191 127 235  71],416,4,22785,3.8165829145728645,0.0,0.0
25970,2,5970,[ 97  11 423 182  50],618,5,22790,3.8167811086920116,0.0,20.0
25971,2,5971,[ 79 144 191 118 121],705,3,22793,3.816644340254521,0.0,0.0
25972,2,5972,[ 50 216 237 268  22],416,4,22797,3.816675037669513,0.0,20.0
25973,2,5973,[ 64  12 269 301 357],416,5,22802,3.8168731168396386,40.0,0.0
25974,2,5974,[173 603   1 168  28],416,5,22807,3.817071129707113,0.0,0.0
25975,2,5975,[588 194 191 257 143],297,2,22809,3.8167670682730925,0.0,0.0
25976,2,5976,[405 588 475  70 111],417,2,22811,3.816463108582901,0.0,0.0
25977,2,5977,[483  88 385 265 144],588,3,22814,3.816326530612245,20.0,0.0
25978,2,5978,[ 64  12 269 301 357],416,5,22819,3.8165245024251546,40.0,0.0
25979,2,5979,[268 423 282 508 265],128,3,22822,3.816387959866221,0.0,0.0
25980,2,5980,[202 496 174 204  89],373,4,22826,3.816418659087109,0.0,0.0
25981,2,5981,[ 64  12 269 301 357],416,5,22831,3.8166165162153125,40.0,0.0
25982,2,5982,[204  95 471 118 423],416,3,22834,3.816480026742437,0.0,0.0
25983,2,5983,[300  98 257 222   1],630,4,22838,3.8165106951871657,0.0,20.0
25984,2,5984,[200  69 318  22 127],405,4,22842,3.8165413533834585,20.0,0.0
25985,2,5985,[ 64  12 269 301 357],416,5,22847,3.816739057801537,40.0,0.0
25986,2,5986,[328  64 313 273  98],416,5,22852,3.8169366961750457,40.0,40.0
25987,2,5987,[ 64  12 269 301 357],416,5,22857,3.817134268537074,40.0,0.0
25988,2,5988,[ 64  12 269 301 357],416,5,22862,3.817331774920688,40.0,0.0
25989,2,5989,[ 64  12 269 301 357],416,5,22867,3.8175292153589315,40.0,0.0
25990,2,5990,[181  82   9 210  98],416,5,22872,3.817726589884827,0.0,40.0
25991,2,5991,[ 82 185 111 121 300],416,5,22877,3.817923898531375,0.0,0.0
25992,2,5992,[ 64  12 269 301 357],416,5,22882,3.8181211413315537,40.0,0.0
25993,2,5993,[  8 135 174 127 216],805,1,22883,3.817650984317651,0.0,0.0
25994,2,5994,[176 121 300 111 216],416,5,22888,3.8178482068390327,0.0,0.0
25995,2,5995,[ 64  12 269 301 357],416,5,22893,3.818045363575717,40.0,0.0
25996,2,5996,[ 64  12 269 301 357],416,5,22898,3.8182424545606137,40.0,0.0
25997,2,5997,[ 15 323  79 748 483],417,3,22901,3.818106035345115,20.0,0.0
25998,2,5998,[ 64  12 269 301 357],416,5,22906,3.818303050508418,40.0,0.0
25999,2,5999,[215 200 471  15 175],922,1,22907,3.817833333333333,0.0,0.0
26000,2,6000,[ 22 269 127 435 175],721,5,22912,3.81803032827862,0.0,0.0
26001,2,6001,[ 64  12 269 301 357],416,5,22917,3.8182272575808063,40.0,0.0
26002,2,6002,[238 200 204 179 603],437,5,22922,3.818424121272697,0.0,0.0
26003,2,6003,[ 64  12 269 301 357],416,5,22927,3.8186209193870755,40.0,0.0
26004,2,6004,[202 168 135  11 176],618,4,22931,3.8186511240632806,0.0,0.0
26005,2,6005,[173 588  71 187 125],505,2,22933,3.8183483183483182,0.0,0.0
26006,2,6006,[  8  98 328 597 238],416,4,22937,3.818378558348593,0.0,20.0
26007,2,6007,[ 64  12 269 301 357],416,5,22942,3.8185752330226364,40.0,0.0
26008,2,6008,[196   7 179 546 191],417,3,22945,3.818439008154435,0.0,0.0
26009,2,6009,[100 210 597 483 121],751,4,22949,3.81846921797005,20.0,0.0
26010,2,6010,[185 333 111  25 235],416,4,22953,3.818499417734154,0.0,0.0
26011,2,6011,[ 64  12 269 301 357],416,5,22958,3.8186959414504327,40.0,0.0
26012,2,6012,[151 597 176 144  79],805,3,22961,3.8185597871278896,0.0,0.0
26013,2,6013,[  4 385 181 475 588],49,2,22963,3.818257399401397,0.0,20.0
26014,2,6014,[ 82  50 427 655  70],198,3,22966,3.8181213632585203,0.0,20.0
26015,2,6015,[151 245 282  69 678],921,2,22968,3.81781914893617,0.0,0.0
26016,2,6016,[427 313  79 197 121],711,4,22972,3.817849426624564,20.0,20.0
26017,2,6017,[ 12  22 195 289  96],854,1,22973,3.817381189764041,20.0,0.0
26018,2,6018,[ 64  12 269 301 357],416,5,22978,3.81757767070942,40.0,0.0
26019,2,6019,[568 202 546 289 182],416,3,22981,3.817441860465116,0.0,0.0
26020,2,6020,[ 64  12 269 301 357],416,5,22986,3.8176382660687596,40.0,0.0
26021,2,6021,[143 197 215 597  98],618,4,22990,3.817668548654932,0.0,20.0
26022,2,6022,[ 71  88 168 127 546],805,1,22991,3.817200730532957,0.0,0.0
26023,2,6023,[173 135 222 200 385],922,2,22993,3.816899070385126,0.0,0.0
26024,2,6024,[ 64  12 269 301 357],416,5,22998,3.817095435684647,40.0,0.0
26025,2,6025,[ 64  12 269 301 357],416,5,23003,3.8172917358114837,40.0,0.0
26026,2,6026,[496  82 180 135 211],373,2,23005,3.816990210718434,0.0,0.0
26027,2,6027,[ 64  12 269 301 357],416,5,23010,3.817186463171865,40.0,0.0
26028,2,6028,[ 89  95  96 385 173],698,4,23014,3.8172167855365733,0.0,0.0
26029,2,6029,[423 318 195 475 144],416,4,23018,3.817247097844113,20.0,0.0
26030,2,6030,[423 185  79  98  28],230,5,23023,3.817443210081247,0.0,20.0
26031,2,6031,[ 64  12 269 301 357],416,5,23028,3.8176392572944295,40.0,0.0
26032,2,6032,[238 357 182 294 111],416,5,23033,3.8178352395159956,0.0,0.0
26033,2,6033,[ 28 268 405 210 202],128,3,23036,3.817699701690421,0.0,0.0
26034,2,6034,[ 64  12 269 301 357],416,5,23041,3.8178956089478047,40.0,0.0
26035,2,6035,[ 50 276  97 144 269],654,3,23044,3.8177601060304838,0.0,20.0
26036,2,6036,[100 300 385  95 117],751,4,23048,3.8177902931919827,0.0,0.0
26037,2,6037,[204 215 194  88 269],416,4,23052,3.817820470354422,0.0,0.0
26038,2,6038,[ 64  12 269 301 357],416,5,23057,3.8180162278522936,40.0,0.0
26039,2,6039,[ 64  12 269 301 357],416,5,23062,3.8182119205298015,40.0,0.0
26040,2,6040,[655 496 202 286 748],437,4,23066,3.8182420129117696,0.0,0.0
26041,2,6041,[405 289 143  50 655],887,4,23070,3.8182720953326714,0.0,20.0
26042,2,6042,[546 194 288 181 143],297,2,23072,3.8179712063544597,0.0,40.0
26043,2,6043,[ 98 121 216 568   9],630,4,23076,3.818001323626737,0.0,20.0
26044,2,6044,[151 222  11 289 168],43,5,23081,3.8181968569065345,0.0,0.0
26045,2,6045,[ 64  12 269 301 357],416,5,23086,3.818392325504466,40.0,0.0
26046,2,6046,[117 121 216 302 144],854,0,23086,3.817760873160245,0.0,0.0
26047,2,6047,[125 144 282 174  95],588,2,23088,3.8174603174603177,0.0,0.0
26048,2,6048,[ 64  98 144   7 357],416,5,23093,3.817655810877831,20.0,20.0
26049,2,6049,[655 222  82 176 546],417,3,23096,3.8175206611570247,0.0,0.0
26050,2,6050,[ 64  12 269 301 357],416,5,23101,3.817716079986779,40.0,0.0
26051,2,6051,[ 25 211  96 194  70],416,5,23106,3.817911434236616,0.0,0.0
26052,2,6052,[  8 245 191 194 151],416,3,23109,3.8177763092681314,0.0,0.0
26053,2,6053,[ 15 357 286 111 655],62,1,23110,3.817310868847043,0.0,0.0
26054,2,6054,[ 64  12 269 301 357],416,5,23115,3.8175061932287364,40.0,0.0
26055,2,6055,[ 64  12 269 301 357],416,5,23120,3.8177014531043594,40.0,0.0
26056,2,6056,[588 265  28  50 273],618,5,23125,3.817896648505861,0.0,20.0
26057,2,6057,[ 64  12 269 301 357],416,5,23130,3.81809177946517,40.0,0.0
26058,2,6058,[ 64  12 269 301 357],416,5,23135,3.818286846014194,40.0,0.0
26059,2,6059,[ 64  12 269 301 357],416,5,23140,3.8184818481848186,40.0,0.0
26060,2,6060,[289 237 118 144 515],416,2,23142,3.8181818181818183,0.0,0.0
26061,2,6061,[ 64  12 269 301 357],416,5,23147,3.8183767733421314,40.0,0.0
26062,2,6062,[ 56 111 546 568 300],654,5,23152,3.818571664192644,0.0,0.0
26063,2,6063,[ 88 238 182 288 197],405,3,23155,3.8184366754617414,0.0,20.0
26064,2,6064,[269 172 357 127 318],416,5,23160,3.818631492168178,20.0,0.0
26065,2,6065,[748 603  11 234 153],805,3,23163,3.818496538081108,0.0,0.0
26066,2,6066,[289  69 182 144  88],416,3,23166,3.8183616284819517,0.0,0.0
26067,2,6067,[597 385  98   4  25],417,2,23168,3.818061964403428,0.0,20.0
26068,2,6068,[ 97 175 275 135 191],373,2,23170,3.817762399077278,0.0,0.0
26069,2,6069,[176 143 748 187  89],198,3,23173,3.817627677100494,0.0,0.0
26070,2,6070,[ 64  12 269 301 357],416,5,23178,3.81782243452479,40.0,0.0
26071,2,6071,[222 423 153 202 186],180,3,23181,3.8176877470355732,0.0,0.0
26072,2,6072,[ 96   8 143 180 597],887,5,23186,3.817882430429771,0.0,0.0
26073,2,6073,[ 64  12 269 301 357],416,5,23191,3.8180770497201184,40.0,0.0
26074,2,6074,[294 405 301 271 313],907,5,23196,3.8182716049382717,20.0,20.0
26075,2,6075,[179 405  12  69  82],417,3,23199,3.818136932192232,20.0,0.0
26076,2,6076,[210 234 245 237 318],345,4,23203,3.8181668586473587,20.0,0.0
26077,2,6077,[471  22  97 143  64],416,5,23208,3.8183613030602173,20.0,0.0
26078,2,6078,[ 56 179  28 211 195],416,4,23212,3.8183911827603225,0.0,0.0
26079,2,6079,[135  88 313 237 597],618,5,23217,3.8185855263157893,20.0,20.0
26080,2,6080,[ 64  12 269 301 357],416,5,23222,3.818779805952968,40.0,0.0
26081,2,6081,[ 64  12 269 301 357],416,5,23227,3.818974021703387,40.0,0.0
26082,2,6082,[191 185 288 176 588],601,2,23229,3.8186749958901856,0.0,20.0
26083,2,6083,[234  70  95 475 603],297,3,23232,3.8185404339250493,0.0,0.0
26084,2,6084,[151 515 176 125 121],416,4,23236,3.818570254724733,0.0,0.0
26085,2,6085,[273  71 179 175 258],805,2,23238,3.8182714426552744,0.0,0.0
26086,2,6086,[257 202 196 258 302],297,3,23241,3.818137013307048,0.0,0.0
26087,2,6087,[ 64  12 269 301 357],416,5,23246,3.8183311432325886,40.0,0.0
26088,2,6088,[ 64  12 269 301 357],416,5,23251,3.818525209393989,40.0,0.0
26089,2,6089,[301  28 127 282 172],721,5,23256,3.81871921182266,0.0,0.0
26090,2,6090,[173  50 127  88  71],405,3,23259,3.818584797241832,0.0,20.0
26091,2,6091,[322 471 235 210 179],416,2,23261,3.818286277084701,0.0,0.0
26092,2,6092,[483 328   4  15 300],253,5,23266,3.818480223206959,20.0,0.0
26093,2,6093,[405 202  22 276 257],416,3,23269,3.818345914013784,0.0,0.0
26094,2,6094,[427  25 204 403 195],198,2,23271,3.818047579983593,0.0,0.0
26095,2,6095,[210 276 275  69 144],62,4,23275,3.8180774278215224,0.0,0.0
26096,2,6096,[ 64  12 269 301 357],416,5,23280,3.8182712809578483,40.0,0.0
26097,2,6097,[ 64  12 269 301 357],416,5,23285,3.818465070514923,40.0,0.0
26098,2,6098,[742 245 153 121 125],417,3,23288,3.8183308739137565,0.0,0.0
26099,2,6099,[  9  88 204 151 588],618,2,23290,3.818032786885246,0.0,0.0
26100,2,6100,[ 64  12 269 301 357],416,5,23295,3.8182265202425834,40.0,0.0
26101,2,6101,[186  89   1 508 268],417,4,23299,3.818256309406752,0.0,0.0
26102,2,6102,[427 238 202 357  82],416,5,23304,3.818449942651155,0.0,0.0
26103,2,6103,[ 64  12 269 301 357],416,5,23309,3.8186435124508518,40.0,0.0
26104,2,6104,[ 50 655 172 515   8],416,5,23314,3.818837018837019,0.0,20.0
26105,2,6105,[471 515 289  97  12],416,4,23318,3.8188666885031117,20.0,0.0
26106,2,6106,[ 64  12 269 301 357],416,5,23323,3.819060094972982,40.0,0.0
26107,2,6107,[ 64  12 269 301 357],416,5,23328,3.819253438113949,40.0,0.0
26108,2,6108,[125 301 302 655 179],416,4,23332,3.8192830250450154,0.0,0.0
26109,2,6109,[ 64  12 269 301 357],416,5,23337,3.819476268412439,40.0,0.0
26110,2,6110,[215 318 588 161 168],43,5,23342,3.819669448535428,20.0,0.0
26111,2,6111,[ 64  12 269 301 357],416,5,23347,3.819862565445026,40.0,0.0
26112,2,6112,[ 64  12 269 301 357],416,5,23352,3.8200556191722557,40.0,0.0
26113,2,6113,[ 64  12 269 301 357],416,5,23357,3.820248609748119,40.0,0.0
26114,2,6114,[168 423  97 194  70],297,3,23360,3.8201144726083403,0.0,0.0
26115,2,6115,[173 237   1  89   8],642,4,23364,3.820143884892086,0.0,0.0
26116,2,6116,[  8 179   4  88  11],805,1,23365,3.8196828510707865,0.0,0.0
26117,2,6117,[258 269 257 238 100],654,4,23369,3.819712324288983,0.0,0.0
26118,2,6118,[111 403   1 427 597],618,4,23373,3.8197417878738356,0.0,0.0
26119,2,6119,[294  71  25 172 181],230,4,23377,3.8197712418300656,0.0,20.0
26120,2,6120,[ 64  12 269 301 357],416,5,23382,3.8199640581604313,40.0,0.0
26121,2,6121,[496 202 385 258 748],416,5,23387,3.82015681149951,0.0,0.0
26122,2,6122,[ 64  12 269 301 357],416,5,23392,3.820349501878164,40.0,0.0
26123,2,6123,[143 748 300 111 210],751,2,23394,3.8200522534291315,0.0,0.0
26124,2,6124,[385 175  22 135 151],373,2,23396,3.8197551020408165,0.0,0.0
26125,2,6125,[ 64  12 269 301 357],416,5,23401,3.8199477636304278,40.0,0.0
26126,2,6126,[181 204 228 153  95],297,2,23403,3.8196507262934554,0.0,20.0
26127,2,6127,[ 64  12 269 301 357],416,5,23408,3.8198433420365534,40.0,0.0
26128,2,6128,[271 173 286 117 471],854,2,23410,3.8195464186653614,0.0,0.0
26129,2,6129,[588 195  71 182 216],405,1,23411,3.8190864600326266,0.0,0.0
26130,2,6130,[508 265 135 200 294],297,2,23413,3.8187897569727616,0.0,0.0
26131,2,6131,[302 194 257 597 222],854,1,23414,3.8183300717547293,0.0,0.0
26132,2,6132,[ 64  12 269 301 357],416,5,23419,3.818522745801402,40.0,0.0
26133,2,6133,[300 588  70 168 496],416,5,23424,3.8187153570264103,0.0,0.0
26134,2,6134,[ 70 288 173 125 405],62,2,23426,3.8184189079054605,0.0,20.0
26135,2,6135,[ 11  12 215 216 172],43,5,23431,3.8186114732724903,20.0,0.0
26136,2,6136,[172 125 282 496 210],588,3,23434,3.8184780837542776,0.0,0.0
26137,2,6137,[ 69 435 257 282 271],297,0,23434,3.8178559791463016,0.0,0.0
26138,2,6138,[678   1 132 273 257],416,3,23437,3.8177227561492098,0.0,0.0
26139,2,6139,[ 64  12 269 301 357],416,5,23442,3.817915309446254,40.0,0.0
26140,2,6140,[ 98 144  96 132 121],505,4,23446,3.8179449601042177,0.0,20.0
26141,2,6141,[ 64  12 269 301 357],416,5,23451,3.8181374145229565,40.0,0.0
26142,2,6142,[127 234  97 118 288],417,4,23455,3.8181670193716424,0.0,20.0
26143,2,6143,[ 64  12 269 301 357],416,5,23460,3.818359375,40.0,0.0
26144,2,6144,[228 196 385  82  69],405,2,23462,3.8180634662327093,0.0,0.0
26145,2,6145,[ 64  12 269 301 357],416,5,23467,3.818255776114546,40.0,0.0
26146,2,6146,[ 25 168 496 196 125],373,5,23472,3.8184480234260616,0.0,0.0
26147,2,6147,[ 64  12 269 301 357],416,5,23477,3.8186402081977877,40.0,0.0
26148,2,6148,[655 204  88 245 258],416,3,23480,3.818507074321028,0.0,0.0
26149,2,6149,[276 121 515 288 185],416,4,23484,3.8185365853658535,0.0,20.0
26150,2,6150,[ 97 204 196  82 143],416,5,23489,3.818728662006178,0.0,0.0
26151,2,6151,[210  25 202 328  69],43,5,23494,3.8189206762028607,0.0,0.0
26152,2,6152,[173 204 187 238 196],405,4,23498,3.8189501056395256,0.0,0.0
26153,2,6153,[ 64  12 269 301 357],416,5,23503,3.819142021449464,40.0,0.0
26154,2,6154,[ 88  15 323 216 603],416,3,23506,3.8190089358245327,0.0,0.0
26155,2,6155,[301 143 238 288 258],711,4,23510,3.8190383365821963,0.0,20.0
26156,2,6156,[423 275   9 202 191],416,5,23515,3.8192301445509176,0.0,0.0
26157,2,6157,[588 289 258  79 748],416,4,23519,3.8192594998376097,0.0,0.0
26158,2,6158,[  1 300 179 265 185],198,2,23521,3.8189641175515505,0.0,0.0
26159,2,6159,[202 268 423  98 100],417,4,23525,3.8189935064935066,0.0,20.0
26160,2,6160,[ 64  12 269 301 357],416,5,23530,3.8191851972082453,40.0,0.0
26161,2,6161,[132  70 655 211 172],437,4,23534,3.8192145407335283,0.0,0.0
26162,2,6162,[ 64  12 269 301 357],416,5,23539,3.8194061333766025,40.0,0.0
26163,2,6163,[ 64  12 269 301 357],416,5,23544,3.81959766385464,40.0,0.0
26164,2,6164,[  8 222 191 288 423],805,2,23546,3.819302514193025,0.0,20.0
26165,2,6165,[546 288  70 200  95],417,3,23549,3.819169639961077,0.0,20.0
26166,2,6166,[100 385 333 211 471],416,5,23554,3.819361115615372,0.0,0.0
26167,2,6167,[175 301 135 288 174],721,3,23557,3.8192282749675748,0.0,20.0
26168,2,6168,[ 64  12 269 301 357],416,5,23562,3.819419679040363,40.0,0.0
26169,2,6169,[ 64  12 269 301 357],416,5,23567,3.819611021069692,40.0,0.0
26170,2,6170,[ 64  12 269 301 357],416,5,23572,3.8198023010857236,40.0,0.0
26171,2,6171,[151 204 125 258  96],642,3,23575,3.8196694750486064,0.0,0.0
26172,2,6172,[475   1 237 125 597],854,1,23576,3.819212700469788,0.0,0.0
26173,2,6173,[ 64  12 269 301 357],416,5,23581,3.819403952057013,40.0,0.0
26174,2,6174,[211 179 475   9 300],416,3,23584,3.8192712550607286,0.0,0.0
26175,2,6175,[385 179 144 301 403],416,4,23588,3.819300518134715,0.0,0.0
26176,2,6176,[588  69 132 294 143],314,5,23593,3.8194916626193947,0.0,0.0
26177,2,6177,[196 228 234 183 265],297,2,23595,3.819197151181612,0.0,0.0
26178,2,6178,[183  50 100 588 216],618,4,23599,3.8192264120407833,0.0,20.0
26179,2,6179,[191 588 385  96 151],373,3,23602,3.819093851132686,0.0,0.0
26180,2,6180,[276  82 289 258 288],416,3,23605,3.8189613331176187,0.0,20.0
26181,2,6181,[  4 194 168 435 603],297,2,23607,3.8186670980265287,0.0,0.0
26182,2,6182,[ 64  12 269 301 357],416,5,23612,3.8188581594695132,40.0,0.0
26183,2,6183,[471 179 245   4   1],416,3,23615,3.81872574385511,0.0,0.0
26184,2,6184,[ 64  12 269 301 357],416,5,23620,3.818916734033953,40.0,0.0
26185,2,6185,[174 175 655 515 435],354,3,23623,3.8187843517620434,0.0,0.0
26186,2,6186,[ 89  97  25 655 234],198,2,23625,3.8184903830612575,0.0,0.0
26187,2,6187,[ 64  12 269 301 357],416,5,23630,3.818681318681319,40.0,0.0
26188,2,6188,[ 64  12 269 301 357],416,5,23635,3.8188721925997737,40.0,0.0
26189,2,6189,[202 269 151 181 300],297,2,23637,3.818578352180937,0.0,20.0
26190,2,6190,[100 286 153 245  50],297,4,23641,3.8186076562752382,0.0,20.0
26191,2,6191,[ 64  12 269 301 357],416,5,23646,3.818798449612403,40.0,0.0
26192,2,6192,[  1 161 568 183 143],230,3,23649,3.8186662360729855,0.0,0.0
26193,2,6193,[100 197 427 151 234],416,4,23653,3.818695511785599,0.0,0.0
26194,2,6194,[ 22 515 322   4  71],416,4,23657,3.818724778046812,0.0,0.0
26195,2,6195,[ 98 238  28  97 313],43,4,23661,3.818754034861201,20.0,40.0
26196,2,6196,[135 153 245 273 132],62,4,23665,3.8187832822333387,0.0,0.0
26197,2,6197,[ 64  12 269 301 357],416,5,23670,3.818973862536302,40.0,0.0
26198,2,6198,[ 64  12 269 301 357],416,5,23675,3.819164381351831,40.0,0.0
26199,2,6199,[588  96 179  71 294],262,4,23679,3.819193548387097,0.0,0.0
26200,2,6200,[174  56 288 289  50],588,3,23682,3.819061441702951,0.0,40.0
26201,2,6201,[282 127   1 265 318],618,4,23686,3.819090615930345,20.0,0.0
26202,2,6202,[100 357 238 187 655],416,5,23691,3.81928099306787,0.0,0.0
26203,2,6203,[100  98 286 515  28],297,5,23696,3.819471308833011,0.0,20.0
26204,2,6204,[508 258 302 357 174],854,3,23699,3.8193392425463335,0.0,0.0
26205,2,6205,[210 174   8 121 144],62,4,23703,3.819368353206574,0.0,0.0
26206,2,6206,[ 64  12 269 301 357],416,5,23708,3.81955856291284,40.0,0.0
26207,2,6207,[515 568   1 202 234],416,5,23713,3.819748711340206,0.0,0.0
26208,2,6208,[288 475 271 210  50],62,3,23716,3.8196166854565954,0.0,40.0
26209,2,6209,[118  89 135 323 235],805,3,23719,3.8194847020933977,0.0,0.0
26210,2,6210,[ 64  12 269 301 357],416,5,23724,3.8196747705683465,40.0,0.0
26211,2,6211,[ 64  12 269 301 357],416,5,23729,3.819864777849324,40.0,0.0
26212,2,6212,[211  69 302  79 215],43,5,23734,3.820054723965878,0.0,0.0
26213,2,6213,[ 64  12 269 301 357],416,5,23739,3.820244608947538,40.0,0.0
26214,2,6214,[111   1 568 546  11],43,5,23744,3.8204344328238133,0.0,0.0
26215,2,6215,[153 508 228 111 475],297,3,23747,3.8203024453024454,0.0,0.0
26216,2,6216,[ 50 588 265 237 286],297,4,23751,3.8203313495254947,0.0,20.0
26217,2,6217,[483  82  70 174 435],437,2,23753,3.8200385976198135,20.0,0.0
26218,2,6218,[ 64  12 269 301 357],416,5,23758,3.8202283325293456,40.0,0.0
26219,2,6219,[ 64  12 269 301 357],416,5,23763,3.8204180064308684,40.0,0.0
26220,2,6220,[ 64  12 269 301 357],416,5,23768,3.8206076193538014,40.0,0.0
26221,2,6221,[211 117  98 508 173],297,5,23773,3.8207971713275475,0.0,20.0
26222,2,6222,[174 302  97 121   8],416,5,23778,3.820986662381488,0.0,0.0
26223,2,6223,[100 161 546 144 265],416,4,23782,3.8210154241645244,0.0,0.0
26224,2,6224,[ 64  12 269 301 357],416,5,23787,3.8212048192771086,40.0,0.0
26225,2,6225,[187 183 237 174 300],198,3,23790,3.8210729200128495,0.0,0.0
26226,2,6226,[515 265 196  97 257],297,3,23793,3.820941063112253,0.0,0.0
26227,2,6227,[475  71 333  15 144],907,4,23797,3.82096981374438,0.0,0.0
26228,2,6228,[ 64  12 269 301 357],416,5,23802,3.821159094557714,40.0,0.0
26229,2,6229,[ 64  12 269 301 357],416,5,23807,3.8213483146067415,40.0,0.0
26230,2,6230,[ 64  12 269 301 357],416,5,23812,3.821537473920719,40.0,0.0
26231,2,6231,[357 144 423 118 655],62,1,23813,3.821084724005135,0.0,0.0
26232,2,6232,[181 597 121 294  15],62,2,23815,3.8207925557516447,0.0,20.0
26233,2,6233,[ 64  12 269 301 357],416,5,23820,3.8209817131857555,40.0,0.0
26234,2,6234,[ 70 515 185 496  15],416,5,23825,3.8211708099438653,0.0,0.0
26235,2,6235,[183 216 403  71  98],805,3,23828,3.821039127645927,0.0,20.0
26236,2,6236,[191 202 195  96 187],505,1,23829,3.8205868205868208,0.0,0.0
26237,2,6237,[144 168 234  79  96],805,4,23833,3.820615581917281,0.0,0.0
26238,2,6238,[294 216 318 328  71],62,3,23836,3.820484051931399,20.0,0.0
26239,2,6239,[194 546 168  50   4],297,2,23838,3.8201923076923077,0.0,20.0
26240,2,6240,[ 97 172 181 176 405],230,5,23843,3.8203813491427656,0.0,20.0
26241,2,6241,[161 588 196  82 117],437,1,23844,3.819929509772509,0.0,0.0
26242,2,6242,[ 64  12 269 301 357],416,5,23849,3.8201185327566876,40.0,0.0
26243,2,6243,[ 64  12 269 301 357],416,5,23854,3.8203074951953875,40.0,0.0
26244,2,6244,[318 197 748  95 273],416,4,23858,3.820336269015212,20.0,0.0
26245,2,6245,[197  56 168 238 143],416,5,23863,3.8205251360870958,0.0,0.0
26246,2,6246,[ 64  12 269 301 357],416,5,23868,3.8207139426924925,40.0,0.0
26247,2,6247,[ 64  12 269 301 357],416,5,23873,3.820902688860435,40.0,0.0
26248,2,6248,[ 64  12 269 301 357],416,5,23878,3.821091374619939,40.0,0.0
26249,2,6249,[ 28 172 195 333 268],496,3,23881,3.82096,0.0,0.0
26250,2,6250,[125 275 471 597 300],274,4,23885,3.8209886418173094,0.0,0.0
26251,2,6251,[216 323  82 313   4],43,4,23889,3.821017274472169,20.0,20.0
26252,2,6252,[ 64  12 269 301 357],416,5,23894,3.821205821205821,40.0,0.0
26253,2,6253,[ 64  12 269 301 357],416,5,23899,3.8213943076431085,40.0,0.0
26254,2,6254,[179 143 257  70 111],416,3,23902,3.8212629896083135,0.0,0.0
26255,2,6255,[ 11 100 191 302 273],417,2,23904,3.8209718670076724,0.0,0.0
26256,2,6256,[185 168 496 111  70],417,2,23906,3.8206808374620427,0.0,0.0
26257,2,6257,[ 64 483 125 121   8],618,3,23909,3.8205496963886225,40.0,0.0
26258,2,6258,[175 228 135  28 435],698,0,23909,3.8199392874261062,0.0,0.0
26259,2,6259,[294 655 403  69 144],416,5,23914,3.8201277955271564,0.0,0.0
26260,2,6260,[ 64  12 269 301 357],416,5,23919,3.820316243411596,40.0,0.0
26261,2,6261,[172 215 294 546  98],43,5,23924,3.820504631108272,0.0,20.0
26262,2,6262,[  8 161  79 471 385],705,4,23928,3.820533290755229,0.0,0.0
26263,2,6263,[210  15 195 568 196],417,3,23931,3.8204022988505746,0.0,0.0
26264,2,6264,[245 143 125 323 403],416,3,23934,3.8202713487629687,0.0,0.0
26265,2,6265,[196 132 183  25 172],416,5,23939,3.820459623364188,0.0,0.0
26266,2,6266,[143 181 427 121  70],416,5,23944,3.820647837880964,0.0,20.0
26267,2,6267,[ 64  12 269 301 357],416,5,23949,3.820835992342055,40.0,0.0
26268,2,6268,[238 168  64 117 588],618,4,23953,3.820864571702026,20.0,0.0
26269,2,6269,[176  64 144 174 238],854,2,23955,3.8205741626794256,20.0,0.0
26270,2,6270,[ 50 265 357 257 135],417,1,23956,3.820124382076224,0.0,20.0
26271,2,6271,[174 168 182 237 176],62,4,23960,3.82015306122449,0.0,0.0
26272,2,6272,[127 200  28 238  98],618,4,23964,3.820181731229077,0.0,20.0
26273,2,6273,[ 64  12 269 301 357],416,5,23969,3.820369780044629,40.0,0.0
26274,2,6274,[ 64  12 269 301 357],416,5,23974,3.820557768924303,40.0,0.0
26275,2,6275,[186 151  97 175 385],43,3,23977,3.820427023581899,0.0,0.0
26276,2,6276,[496 153 185 546 121],262,1,23978,3.8199776963517604,0.0,0.0
26277,2,6277,[385 185 258 215 275],416,5,23983,3.8201656578528196,0.0,0.0
26278,2,6278,[  9 135 483 117  88],618,4,23987,3.820194298455168,20.0,0.0
26279,2,6279,[238 405 185   4 265],198,1,23988,3.8197452229299365,0.0,0.0
26280,2,6280,[132 496 168 222 204],711,3,23991,3.819614711033275,0.0,0.0
26281,2,6281,[ 64  12 269 301 357],416,5,23996,3.8198026106335563,40.0,0.0
26282,2,6282,[ 64  12 269 301 357],416,5,24001,3.819990450421773,40.0,0.0
26283,2,6283,[ 64  12 269 301 357],416,5,24006,3.82017823042648,40.0,0.0
26284,2,6284,[202 302 269 111 328],43,5,24011,3.820365950676213,0.0,0.0
26285,2,6285,[211 132 301 403 153],416,5,24016,3.820553611199491,0.0,0.0
26286,2,6286,[ 64  12 269 301 357],416,5,24021,3.820741212024813,40.0,0.0
26287,2,6287,[197 100 153  25 143],416,5,24026,3.8209287531806617,0.0,0.0
26288,2,6288,[ 64  12 269 301 357],416,5,24031,3.8211162346955,40.0,0.0
26289,2,6289,[655 195 181 100 111],416,5,24036,3.8213036565977743,0.0,20.0
26290,2,6290,[215 172  79 183  28],618,5,24041,3.8214910189159115,0.0,0.0
26291,2,6291,[121  82 275 132 234],262,1,24042,3.8210425937698664,0.0,0.0
26292,2,6292,[200 211  69  12 603],405,2,24044,3.8207532178611157,20.0,0.0
26293,2,6293,[ 64  12 269 301 357],416,5,24049,3.820940578328567,40.0,0.0
26294,2,6294,[257 237  22 176   7],416,3,24052,3.820810166799047,0.0,0.0
26295,2,6295,[ 96 742 597 302 216],416,4,24056,3.820838627700127,0.0,0.0
26296,2,6296,[173   4  22 121  70],416,5,24061,3.8210258853422263,0.0,0.0
26297,2,6297,[ 64  12 269 301 357],416,5,24066,3.821213083518577,40.0,0.0
26298,2,6298,[187  22 121  12 471],618,4,24070,3.821241466899508,20.0,0.0
26299,2,6299,[174 238 185 143   1],262,1,24071,3.8207936507936506,0.0,0.0
26300,2,6300,[195 603  64 200 204],416,5,24076,3.8209807966989366,20.0,0.0
26301,2,6301,[179 245 161 168 427],416,3,24079,3.820850523643288,0.0,0.0
26302,2,6302,[ 64  12 269 301 357],416,5,24084,3.8210376011423133,40.0,0.0
26303,2,6303,[238 603 174 568 301],416,5,24089,3.82122461928934,0.0,0.0
26304,2,6304,[202 405  98 121 435],230,5,24094,3.8214115781126092,0.0,20.0
26305,2,6305,[ 71 180 276 471 222],128,4,24098,3.821439898509356,0.0,0.0
26306,2,6306,[385 187  22 202 228],405,3,24101,3.821309655937847,0.0,0.0
26307,2,6307,[ 70  64 471  25  95],618,1,24102,3.820862396956246,20.0,0.0
26308,2,6308,[118 187 173 183 288],618,2,24104,3.820573783483912,0.0,20.0
26309,2,6309,[435 318 385 161 180],405,1,24105,3.8201267828843104,20.0,0.0
26310,2,6310,[ 56 117  70 300 127],198,2,24107,3.8198383774362226,0.0,0.0
26311,2,6311,[357 202 144 143 204],698,1,24108,3.8193916349809887,0.0,0.0
26312,2,6312,[100 294  56  82 121],253,3,24111,3.8192618406462855,0.0,0.0
26313,2,6313,[174 175 143   8  11],297,5,24116,3.819448843839088,0.0,0.0
26314,2,6314,[185  79 222 273 132],417,1,24117,3.819002375296912,0.0,0.0
26315,2,6315,[ 12 427  95 183 121],416,4,24121,3.8190310322989234,20.0,0.0
26316,2,6316,[258 268 275  71  50],128,3,24124,3.81890137723603,0.0,20.0
26317,2,6317,[ 98 121 127   7  97],43,5,24129,3.819088319088319,0.0,20.0
26318,2,6318,[237  79 245  71 568],345,3,24132,3.818958695996202,0.0,0.0
26319,2,6319,[286  82 118 143 100],588,3,24135,3.8188291139240507,0.0,0.0
26320,2,6320,[ 64  12 269 301 357],416,5,24140,3.819015978484417,40.0,0.0
26321,2,6321,[742 118   9 258  50],708,3,24143,3.8188864283454604,0.0,20.0
26322,2,6322,[173 748  98 195 183],505,1,24144,3.8184406136327693,0.0,20.0
26323,2,6323,[181 195 197 403 603],405,4,24148,3.818469323213156,0.0,20.0
26324,2,6324,[  7 194 269  56 301],297,4,24152,3.818498023715415,0.0,0.0
26325,2,6325,[257 588 271  70 216],43,4,24156,3.8185267151438507,0.0,0.0
26326,2,6326,[265 127  69 238  25],198,3,24159,3.818397344713134,0.0,0.0
26327,2,6327,[200 172  12 268 302],416,5,24164,3.8185840707964602,20.0,0.0
26328,2,6328,[301   8 144 111 471],297,2,24166,3.818296729341128,0.0,0.0
26329,2,6329,[ 56 125  95 174  28],262,1,24167,3.817851500789889,0.0,0.0
26330,2,6330,[ 64  12 269 301 357],416,5,24172,3.8180382246090665,40.0,0.0
26331,2,6331,[ 79 237  88 655 313],588,3,24175,3.8179090334807326,20.0,20.0
26332,2,6332,[ 64  12 269 301 357],416,5,24180,3.8180956892468023,40.0,0.0
26333,2,6333,[  1 568 222 300 228],705,4,24184,3.818124407957057,0.0,0.0
26334,2,6334,[ 64  12 269 301 357],416,5,24189,3.8183109707971585,40.0,0.0
26335,2,6335,[603 117 313  11 118],416,4,24193,3.8183396464646466,20.0,20.0
26336,2,6336,[118 269 257  97   1],297,2,24195,3.8180527063279155,0.0,0.0
26337,2,6337,[ 64  12 269 301 357],416,5,24200,3.8182391921741874,40.0,0.0
26338,2,6338,[191  64 603  88 238],128,5,24205,3.8184256191828365,20.0,0.0
26339,2,6339,[161 211 568  89 172],373,5,24210,3.8186119873817033,0.0,0.0
26340,2,6340,[ 97 210  69 182  70],437,0,24210,3.8180097776375965,0.0,0.0
26341,2,6341,[275 194 234 515 318],416,5,24215,3.818196152633239,20.0,0.0
26342,2,6342,[ 64  12 269 301 357],416,5,24220,3.8183824688633137,40.0,0.0
26343,2,6343,[100 222 215 271 742],62,2,24222,3.818095838587642,0.0,0.0
26344,2,6344,[ 64  12 269 301 357],416,5,24227,3.818282111899133,40.0,0.0
26345,2,6345,[ 15   1 202 323 211],416,4,24231,3.818310746927198,0.0,0.0
26346,2,6346,[ 64  12 269 301 357],416,5,24236,3.8184969276823697,40.0,0.0
26347,2,6347,[286 238 135 288 117],437,2,24238,3.8182104599873976,0.0,20.0
26348,2,6348,[ 64  12 269 301 357],416,5,24243,3.818396597889431,40.0,0.0
26349,2,6349,[121 588  12 191 318],43,5,24248,3.818582677165354,40.0,0.0
26350,2,6350,[ 64  12 269 301 357],416,5,24253,3.8187686978428594,40.0,0.0
26351,2,6351,[235 151  69 181 144],297,1,24254,3.818324937027708,0.0,20.0
26352,2,6352,[ 64  12 269 301 357],416,5,24259,3.818510939713521,40.0,0.0
26353,2,6353,[173 475 186 121 143],437,2,24261,3.8182247403210576,0.0,0.0
26354,2,6354,[ 64  12 269 301 357],416,5,24266,3.8184107002360346,40.0,0.0
26355,2,6355,[ 64  12 269 301 357],416,5,24271,3.818596601636249,40.0,0.0
26356,2,6356,[ 64  12 269 301 357],416,5,24276,3.8187824445493157,40.0,0.0
26357,2,6357,[288 597 655 286 302],416,4,24280,3.8188109468386284,0.0,20.0
26358,2,6358,[ 64  12 269 301 357],416,5,24285,3.818996697593961,40.0,0.0
26359,2,6359,[ 70 313 196  28 151],654,5,24290,3.819182389937107,20.0,20.0
26360,2,6360,[403 117 282 405 294],345,2,24292,3.818896399937117,0.0,0.0
26361,2,6361,[568 118 121 182 257],417,2,24294,3.8186104998428165,0.0,0.0
26362,2,6362,[597   9 176 153 403],62,4,24298,3.8186390067578184,0.0,0.0
26363,2,6363,[597 179  96 385  70],417,3,24301,3.818510370835952,0.0,0.0
26364,2,6364,[175 742  25 168 191],43,4,24305,3.8185388845247448,0.0,0.0
26365,2,6365,[427 515 471 132 153],416,5,24310,3.8187244737668866,0.0,0.0
26366,2,6366,[ 64  12 269 301 357],416,5,24315,3.818910004711795,40.0,0.0
26367,2,6367,[ 28 151 237 143 742],654,5,24320,3.819095477386935,0.0,0.0
26368,2,6368,[ 64  12 269 301 357],416,5,24325,3.819280891819752,40.0,0.0
26369,2,6369,[228   9 121 181 288],887,4,24329,3.819309262166405,0.0,40.0
26370,2,6370,[ 64  12 269 301 357],416,5,24334,3.8194945848375452,40.0,0.0
26371,2,6371,[ 11 118 385   9 603],805,1,24335,3.819052102950408,0.0,0.0
26372,2,6372,[ 82 357  71 546  64],62,5,24340,3.8192374078142164,20.0,0.0
26373,2,6373,[  1  70 172 385  82],416,5,24345,3.8194226545340446,0.0,0.0
26374,2,6374,[ 64  12 269 301 357],416,5,24350,3.819607843137255,40.0,0.0
26375,2,6375,[ 12  71 515  11 211],416,5,24355,3.819792973651192,20.0,0.0
26376,2,6376,[237 323 603 403 318],416,3,24358,3.819664419005802,20.0,0.0
26377,2,6377,[  4 403 215   8 173],405,5,24363,3.819849482596425,0.0,0.0
26378,2,6378,[182 125 403 127 483],618,4,24367,3.8198777237811568,20.0,0.0
26379,2,6379,[  7  69  79 172 216],417,0,24367,3.819278996865204,0.0,0.0
26380,2,6380,[ 79 323 405 294 210],416,4,24371,3.8193073186021,0.0,0.0
26381,2,6381,[286 333  69 275  89],854,3,24374,3.819178940770918,0.0,0.0
26382,2,6382,[282 276  25 496 568],314,3,24377,3.8190506031646563,0.0,0.0
26383,2,6383,[172 204 197  82  25],128,3,24380,3.818922305764411,0.0,0.0
26384,2,6384,[191   9 176 508 228],601,4,24384,3.8189506656225527,0.0,0.0
26385,2,6385,[655 151 194 210 301],416,4,24388,3.81897901659881,0.0,0.0
26386,2,6386,[ 50 235   1 496 125],417,2,24390,3.818694222639737,0.0,20.0
26387,2,6387,[151  97 427 300 143],416,4,24394,3.8187226048841576,0.0,0.0
26388,2,6388,[ 96  82  11 100 143],230,4,24398,3.8187509782438567,0.0,0.0
26389,2,6389,[151 275 185  69  98],854,5,24403,3.8189358372456965,0.0,20.0
26390,2,6390,[ 88 180   7 276 153],354,1,24404,3.8184947582537943,0.0,0.0
26391,2,6391,[ 64  12 269 301 357],416,5,24409,3.818679599499374,40.0,0.0
26392,2,6392,[ 64  12 269 301 357],416,5,24414,3.8188643829188176,40.0,0.0
26393,2,6393,[196 568 204 210  69],62,3,24417,3.8187363152955895,0.0,0.0
26394,2,6394,[202 197  22 385  25],373,2,24419,3.8184519155590304,0.0,0.0
26395,2,6395,[ 64  12 269 301 357],416,5,24424,3.8186366479049405,40.0,0.0
26396,2,6396,[ 64  12 269 301 357],416,5,24429,3.8188213224949195,40.0,0.0
26397,2,6397,[318 655 168 187 405],887,4,24433,3.8188496405126604,20.0,0.0
26398,2,6398,[258 289 294  71 286],875,2,24435,3.818565400843882,0.0,0.0
26399,2,6399,[ 11 181 182 282 196],297,3,24438,3.8184375,0.0,20.0
26400,2,6400,[ 64  12 269 301 357],416,5,24443,3.818622090298391,40.0,0.0
26401,2,6401,[ 64  12 269 301 357],416,5,24448,3.8188066229303343,40.0,0.0
26402,2,6402,[216 153 289  50   1],721,4,24452,3.81883492113072,0.0,20.0
26403,2,6403,[ 64  12 269 301 357],416,5,24457,3.8190193628981888,40.0,0.0
26404,2,6404,[405 179 423  11   9],416,4,24461,3.8190476190476192,0.0,0.0
26405,2,6405,[568  15 181 183 168],417,3,24464,3.8189197627224476,0.0,20.0
26406,2,6406,[ 28 202 153 678 742],38,4,24468,3.8189480255970034,0.0,0.0
26407,2,6407,[ 82  71 245 182 132],505,4,24472,3.8189762796504367,0.0,0.0
26408,2,6408,[385 196 234 144 257],417,3,24475,3.8188484943048837,0.0,0.0
26409,2,6409,[276 197 161 125  79],618,2,24477,3.818564742589704,0.0,0.0
26410,2,6410,[ 64  12 269 301 357],416,5,24482,3.8187490251130867,40.0,0.0
26411,2,6411,[180   8 196 202 318],711,5,24487,3.8189332501559576,20.0,0.0
26412,2,6412,[ 64  12 269 301 357],416,5,24492,3.819117417745205,40.0,0.0
26413,2,6413,[204  79  56 111  95],588,4,24496,3.819145618958528,0.0,0.0
26414,2,6414,[ 64  12 269 301 357],416,5,24501,3.8193296960249414,40.0,0.0
26415,2,6415,[197 228 435 185 748],297,1,24502,3.8188902743142146,0.0,0.0
26416,2,6416,[  8 144  95 268 100],654,3,24505,3.8187626616799126,0.0,0.0
26417,2,6417,[ 64  12 269 301 357],416,5,24510,3.818946712371455,40.0,0.0
26418,2,6418,[143 222 195 191 185],198,1,24511,3.8185075556940333,0.0,0.0
26419,2,6419,[197   4 269 100 328],416,5,24516,3.8186915887850468,0.0,0.0
26420,2,6420,[ 97   8  69 597 173],705,1,24517,3.8182526086279394,0.0,0.0
26421,2,6421,[173 546  28 318 258],223,4,24521,3.818280909374027,20.0,0.0
26422,2,6422,[294 210   1 282 215],345,2,24523,3.8179978203331775,0.0,0.0
26423,2,6423,[ 64  12 269 301 357],416,5,24528,3.8181818181818183,40.0,0.0
26424,2,6424,[ 64  12 269 301 357],416,5,24533,3.818365758754864,40.0,0.0
26425,2,6425,[ 64  12 269 301 357],416,5,24538,3.818549642079054,40.0,0.0
26426,2,6426,[204 603 143  50 174],297,4,24542,3.8185778745915666,0.0,20.0
26427,2,6427,[161 427  79 172 187],198,3,24545,3.818450528935905,0.0,0.0
26428,2,6428,[ 64  12 269 301 357],416,5,24550,3.8186343132680043,40.0,0.0
26429,2,6429,[405 132 228 597 294],887,5,24555,3.818818040435459,0.0,0.0
26430,2,6430,[ 98  56 275 597 151],618,3,24558,3.8186907168403046,0.0,20.0
26431,2,6431,[187 127 211 132  15],416,5,24563,3.8188743781094527,0.0,0.0
26432,2,6432,[234 302 742 286 475],416,4,24567,3.818902533810042,0.0,0.0
26433,2,6433,[ 64  12 269 301 357],416,5,24572,3.8190861050668325,40.0,0.0
26434,2,6434,[ 69 597 385 496   7],887,5,24577,3.8192696192696194,0.0,0.0
26435,2,6435,[357 176   1 302 173],416,5,24582,3.8194530764449968,0.0,0.0
26436,2,6436,[ 64  12 269 301 357],416,5,24587,3.8196364766195434,40.0,0.0
26437,2,6437,[423 235 173 118 265],417,3,24590,3.8195091643367505,0.0,0.0
26438,2,6438,[153 182 215 427 475],416,4,24594,3.8195371952166486,0.0,0.0
26439,2,6439,[ 70 323 302 191 173],416,4,24598,3.8195652173913044,0.0,0.0
26440,2,6440,[111 216 172 117 234],416,5,24603,3.8197484862598974,0.0,0.0
26441,2,6441,[496 276 216   4 508],654,3,24606,3.8196212356411055,0.0,0.0
26442,2,6442,[ 64  12 269 301 357],416,5,24611,3.819804438925966,40.0,0.0
26443,2,6443,[183  69 588 197   4],416,5,24616,3.819987585350714,0.0,0.0
26444,2,6444,[423 191 276 161 173],618,3,24619,3.8198603568657874,0.0,0.0
26445,2,6445,[ 64  12 269 301 357],416,5,24624,3.820043437790878,40.0,0.0
26446,2,6446,[ 97 125 238 181  28],373,3,24627,3.81991624011168,0.0,20.0
26447,2,6447,[216 185  95 385 191],805,2,24629,3.8196339950372207,0.0,0.0
26448,2,6448,[ 98 125 143 483 318],618,4,24633,3.8196619630950535,40.0,20.0
26449,2,6449,[173  50 357 191 195],373,5,24638,3.8198449612403103,0.0,20.0
26450,2,6450,[ 64  12 269 301 357],416,5,24643,3.820027902650752,40.0,0.0
26451,2,6451,[100 144  64 475 176],854,3,24646,3.819900805951643,20.0,0.0
26452,2,6452,[273  64 174 288 228],62,3,24649,3.8197737486440415,20.0,20.0
26453,2,6453,[  1  25 405  69 118],417,2,24651,3.819491788038426,0.0,0.0
26454,2,6454,[546 748 269 271 588],297,2,24653,3.8192099147947327,0.0,0.0
26455,2,6455,[405 202  22 143  50],642,3,24656,3.81908302354399,0.0,20.0
26456,2,6456,[ 50 186 508   4 173],417,2,24658,3.818801300913737,0.0,20.0
26457,2,6457,[257 318  96 168 186],601,3,24661,3.8186745122328896,20.0,0.0
26458,2,6458,[ 15 748 276 144 174],416,4,24665,3.8187025855395573,0.0,0.0
26459,2,6459,[318 210 135 228  56],198,4,24669,3.818730650154799,20.0,0.0
26460,2,6460,[183 111 322 135  88],805,2,24671,3.8184491564773255,0.0,0.0
26461,2,6461,[ 95 328 132 117  12],373,4,24675,3.8184772516248837,20.0,0.0
26462,2,6462,[ 96 186 144 603 286],373,3,24678,3.8183506111712826,0.0,0.0
26463,2,6463,[ 98 288 204  11 153],654,4,24682,3.818378712871287,0.0,40.0
26464,2,6464,[117  15  56  69 125],314,4,24686,3.8184068058778036,0.0,0.0
26465,2,6465,[ 64  12 269 301 357],416,5,24691,3.81858954531395,40.0,0.0
26466,2,6466,[ 64  12 269 301 357],416,5,24696,3.818772228235658,40.0,0.0
26467,2,6467,[200   9 748 237 125],416,4,24700,3.818800247371676,0.0,0.0
26468,2,6468,[ 64  12 269 301 357],416,5,24705,3.8189828412428506,40.0,0.0
26469,2,6469,[ 88 268   7  22 187],416,4,24709,3.8190108191653787,0.0,0.0
26470,2,6470,[238 568  82 172 194],416,5,24714,3.819193324061196,0.0,0.0
26471,2,6471,[168 258 174  82  79],654,5,24719,3.8193757725587143,0.0,0.0
26472,2,6472,[ 22 235 215 238 100],416,4,24723,3.8194036768113704,0.0,0.0
26473,2,6473,[222  22 151   8 215],62,4,24727,3.8194315724436207,0.0,0.0
26474,2,6474,[ 64  12 269 301 357],416,5,24732,3.8196138996138997,40.0,0.0
26475,2,6475,[ 25 176 100 228 323],805,4,24736,3.8196417541692402,0.0,0.0
26476,2,6476,[117 176  96 195  71],805,2,24738,3.8193608151922187,0.0,0.0
26477,2,6477,[ 64  12 269 301 357],416,5,24743,3.81954306884841,40.0,0.0
26478,2,6478,[ 64  12 269 301 357],416,5,24748,3.8197252662447907,40.0,0.0
26479,2,6479,[318 186 496 172 300],43,4,24752,3.819753086419753,20.0,0.0
26480,2,6480,[121 143 568 135 211],230,3,24755,3.819626600833205,0.0,0.0
26481,2,6481,[202 276 135 237  56],618,3,24758,3.8195001542733724,0.0,0.0
26482,2,6482,[ 64  12 269 301 357],416,5,24763,3.8196822458738238,40.0,0.0
26483,2,6483,[ 89 151 568   7 186],198,4,24767,3.8197100555212833,0.0,0.0
26484,2,6484,[ 64  12 269 301 357],416,5,24772,3.819892058596762,40.0,0.0
26485,2,6485,[186 222 168 100 111],854,3,24775,3.8197656490903484,0.0,0.0
26486,2,6486,[ 64  12 269 301 357],416,5,24780,3.8199475874826576,40.0,0.0
26487,2,6487,[ 71 175 135  79 183],198,2,24782,3.819667077681874,0.0,0.0
26488,2,6488,[ 56 174 655  12 179],437,5,24787,3.819848975188781,20.0,0.0
26489,2,6489,[181 127  82 301 153],721,5,24792,3.820030816640986,0.0,20.0
26490,2,6490,[597 143 288  56  22],588,5,24797,3.8202126020643967,0.0,20.0
26491,2,6491,[496  69  79 161 176],416,5,24802,3.8203943314849047,0.0,0.0
26492,2,6492,[161  69   8 144 181],416,5,24807,3.8205760049283843,0.0,20.0
26493,2,6493,[ 64  12 269 301 357],416,5,24812,3.820757622420696,40.0,0.0
26494,2,6494,[328  11  12 135 282],854,3,24815,3.8206312548113934,20.0,0.0
26495,2,6495,[588 288 196 322 678],805,1,24816,3.8201970443349755,0.0,20.0
26496,2,6496,[276 173 196 183 471],618,2,24818,3.8199168847160228,0.0,0.0
26497,2,6497,[125 200 202 118   9],887,3,24821,3.819790704832256,0.0,0.0
26498,2,6498,[475 182 174 191  79],214,5,24826,3.8199723034312973,0.0,0.0
26499,2,6499,[ 64  12 269 301 357],416,5,24831,3.820153846153846,40.0,0.0
26500,2,6500,[173   8 748  25  56],416,5,24836,3.8203353330256884,0.0,0.0
26501,2,6501,[216  71 179 483 151],128,3,24839,3.8202091664103355,20.0,0.0
26502,2,6502,[144 273 269 135  50],854,4,24843,3.8202368137782563,0.0,20.0
26503,2,6503,[ 79 546 323 235 496],43,3,24846,3.8201107011070112,0.0,0.0
26504,2,6504,[483  15   8 238 322],854,3,24849,3.8199846272098386,20.0,0.0
26505,2,6505,[ 64  12 269 301 357],416,5,24854,3.820166000614817,40.0,0.0
26506,2,6506,[423 322 655 268 151],128,1,24855,3.819732595666206,0.0,0.0
26507,2,6507,[234 153  71 182 143],437,3,24858,3.8196066379840197,0.0,0.0
26508,2,6508,[273 172 125  70 195],62,4,24862,3.8196343524350898,0.0,0.0
26509,2,6509,[181   8 597 385 258],654,4,24866,3.819662058371736,0.0,20.0
26510,2,6510,[588 111 483 603 195],437,2,24868,3.8193825833205346,20.0,0.0
26511,2,6511,[ 64  12 269 301 357],416,5,24873,3.819563882063882,40.0,0.0
26512,2,6512,[ 64  12 269 301 357],416,5,24878,3.8197451251343466,40.0,0.0
26513,2,6513,[742 215  28 475 153],297,3,24881,3.8196192815474364,0.0,0.0
26514,2,6514,[357  71 183  15 403],62,4,24885,3.819646968534152,0.0,0.0
26515,2,6515,[ 64  12 269 301 357],416,5,24890,3.819828115408226,40.0,0.0
26516,2,6516,[265 173 313 603 288],416,5,24895,3.820009206690195,20.0,40.0
26517,2,6517,[ 64  12 269 301 357],416,5,24900,3.820190242405646,40.0,0.0
26518,2,6518,[ 64  12 269 301 357],416,5,24905,3.8203712225801505,40.0,0.0
26519,2,6519,[ 64  12 269 301 357],416,5,24910,3.8205521472392636,40.0,0.0
26520,2,6520,[143 100  11   9  56],764,5,24915,3.8207330164085263,0.0,0.0
26521,2,6521,[ 79 117 483 127  15],253,5,24920,3.820913830113462,20.0,0.0
26522,2,6522,[210 265  89  97 234],198,2,24922,3.8206346772957227,0.0,0.0
26523,2,6523,[508 194  96 275 597],854,2,24924,3.8203556100551808,0.0,0.0
26524,2,6524,[ 50  97 153  82  95],416,4,24928,3.820383141762452,0.0,20.0
26525,2,6525,[175  95 176 275 257],698,2,24930,3.820104198590254,0.0,0.0
26526,2,6526,[748 118 117 288 300],345,1,24931,3.819672131147541,0.0,20.0
26527,2,6527,[302 496 172 191   4],416,5,24936,3.8198529411764706,0.0,0.0
26528,2,6528,[678 182 185 111 143],297,2,24938,3.8195742073824475,0.0,0.0
26529,2,6529,[210 276  82 202 191],43,5,24943,3.8197549770290964,0.0,0.0
26530,2,6530,[125 180 276 153 135],62,5,24948,3.819935691318328,0.0,0.0
26531,2,6531,[ 64  12 269 301 357],416,5,24953,3.8201163502755664,40.0,0.0
26532,2,6532,[322 245 153 258 333],416,3,24956,3.819990815857952,0.0,0.0
26533,2,6533,[238 483   4 235 257],854,2,24958,3.819712274257729,20.0,0.0
26534,2,6534,[186 183 176   4 143],198,3,24961,3.819586840091813,0.0,0.0
26535,2,6535,[135  22 328 258 172],721,3,24964,3.8194614443084456,0.0,0.0
26536,2,6536,[237 318 176 357 655],416,4,24968,3.819489062260976,20.0,0.0
26537,2,6537,[  4 100 195  89 273],417,2,24970,3.819210767818905,0.0,0.0
26538,2,6538,[143 300 202 200 515],297,2,24972,3.8189325584951828,0.0,0.0
26539,2,6539,[ 71 191  64 180   4],198,2,24974,3.8186544342507647,20.0,0.0
26540,2,6540,[132 196  98  82  22],601,2,24976,3.818376395046629,0.0,20.0
26541,2,6541,[ 64  12 269 301 357],416,5,24981,3.818557016202996,40.0,0.0
26542,2,6542,[235 173 118 182 151],297,1,24982,3.818126241785114,0.0,0.0
26543,2,6543,[ 64  12 269 301 357],416,5,24987,3.81830684596577,40.0,0.0
26544,2,6544,[  4 153 173 176 111],854,2,24989,3.8180290297937356,0.0,0.0
26545,2,6545,[ 64  12 269 301 357],416,5,24994,3.818209593644974,40.0,0.0
26546,2,6546,[405 294   1  28 357],642,3,24997,3.818084618909424,0.0,0.0
26547,2,6547,[222 268  95 216 125],588,3,25000,3.8179596823457542,0.0,0.0
26548,2,6548,[ 97 323 183 475  82],417,4,25004,3.817987479004428,0.0,0.0
26549,2,6549,[234  88  96 180 197],805,3,25007,3.8178625954198475,0.0,0.0
26550,2,6550,[168 597 121  25  12],618,4,25011,3.817890398412456,20.0,0.0
26551,2,6551,[181 211 100 403 151],43,5,25016,3.8180708180708183,0.0,20.0
26552,2,6552,[183 313 197 289 597],416,3,25019,3.817945978940943,20.0,20.0
26553,2,6553,[ 64  12 269 301 357],416,5,25024,3.818126335062557,40.0,0.0
26554,2,6554,[118 135 182 234  56],198,3,25027,3.818001525553013,0.0,0.0
26555,2,6555,[294  89 568 161 195],805,1,25028,3.8175716900549115,0.0,0.0
26556,2,6556,[ 64  12 269 301 357],416,5,25033,3.817752020741193,40.0,0.0
26557,2,6557,[ 64  12 269 301 357],416,5,25038,3.817932296431839,40.0,0.0
26558,2,6558,[ 64  12 269 301 357],416,5,25043,3.818112517152005,40.0,0.0
26559,2,6559,[228 318   8 245 435],721,4,25047,3.8181402439024392,20.0,0.0
26560,2,6560,[588 117 118 151 403],805,2,25049,3.8178631306203323,0.0,0.0
26561,2,6561,[328 245 196  97 187],416,4,25053,3.817890886924718,0.0,0.0
26562,2,6562,[202   1  95 125  88],588,3,25056,3.817766265427396,0.0,0.0
26563,2,6563,[742  70 144 235  25],43,4,25060,3.817794028031688,0.0,0.0
26564,2,6564,[ 64  12 269 301 357],416,5,25065,3.817974105102818,40.0,0.0
26565,2,6565,[111  22 172 475 423],805,2,25067,3.8176972281449895,0.0,0.0
26566,2,6566,[151  82 172  71 191],705,2,25069,3.8174204355108876,0.0,0.0
26567,2,6567,[ 64  12 269 301 357],416,5,25074,3.8176004872107185,40.0,0.0
26568,2,6568,[125  11  97 265  25],618,3,25077,3.817476023747907,0.0,0.0
26569,2,6569,[ 64  12 269 301 357],416,5,25082,3.81765601217656,40.0,0.0
26570,2,6570,[265 268 568  64 546],416,4,25086,3.8176837619844775,20.0,0.0
26571,2,6571,[ 64  12 269 301 357],416,5,25091,3.8178636640292147,40.0,0.0
26572,2,6572,[ 12 180 357 323 100],417,3,25094,3.817739236269588,20.0,0.0
26573,2,6573,[ 64  12 269 301 357],416,5,25099,3.8179190751445087,40.0,0.0
26574,2,6574,[ 64  12 269 301 357],416,5,25104,3.8180988593155893,40.0,0.0
26575,2,6575,[211 132   4 515  98],405,3,25107,3.8179744525547443,0.0,20.0
26576,2,6576,[235 151 288 176 323],805,3,25110,3.817850083624753,0.0,20.0
26577,2,6577,[ 64  12 269 301 357],416,5,25115,3.818029796290666,40.0,0.0
26578,2,6578,[ 64  12 269 301 357],416,5,25120,3.818209454324365,40.0,0.0
26579,2,6579,[ 64  12 269 301 357],416,5,25125,3.81838905775076,40.0,0.0
26580,2,6580,[ 64  12 269 301 357],416,5,25130,3.8185686065947424,40.0,0.0
26581,2,6581,[ 88 276 546 144 597],314,3,25133,3.8184442418717714,0.0,0.0
26582,2,6582,[ 64  12 269 301 357],416,5,25138,3.8186237277836854,40.0,0.0
26583,2,6583,[ 89  11  50 322 282],854,3,25141,3.8184993924665855,0.0,20.0
26584,2,6584,[286 144   1  25 234],416,5,25146,3.8186788154897493,0.0,0.0
26585,2,6585,[100 174  89   7   4],62,5,25151,3.8188581840267233,0.0,0.0
26586,2,6586,[ 22  95 276  11 143],223,4,25155,3.818885683922878,0.0,0.0
26587,2,6587,[ 25 405 257  69  98],887,3,25158,3.8187613843351547,0.0,20.0
26588,2,6588,[742 191 196  12 568],417,3,25161,3.818637122476855,20.0,0.0
26589,2,6589,[ 64  12 269 301 357],416,5,25166,3.8188163884673747,40.0,0.0
26590,2,6590,[475 173 238  79 204],297,3,25169,3.8186921559702625,0.0,0.0
26591,2,6591,[185 245 276 132 313],416,3,25172,3.8185679611650487,20.0,20.0
26592,2,6592,[238 151 118 111 318],416,3,25175,3.8184438040345823,20.0,0.0
26593,2,6593,[300  95 496  98 237],654,5,25180,3.818622990597513,0.0,20.0
26594,2,6594,[ 64  12 269 301 357],416,5,25185,3.8188021228203186,40.0,0.0
26595,2,6595,[  1 588 385 216   7],230,3,25188,3.818677986658581,0.0,0.0
26596,2,6596,[588 173  79 181  11],405,4,25192,3.8187054721843263,0.0,20.0
26597,2,6597,[ 64  12 269 301 357],416,5,25197,3.8188845104577145,40.0,0.0
26598,2,6598,[238 121 282 268 194],854,1,25198,3.818457342021518,0.0,0.0
26599,2,6599,[ 64  12 269 301 357],416,5,25203,3.818636363636364,40.0,0.0
26600,2,6600,[153 100 132  25 204],198,2,25205,3.8183608544159977,0.0,0.0
26601,2,6601,[ 69  79  11   4 294],416,5,25210,3.818539836413208,0.0,0.0
26602,2,6602,[181  96 597 197  98],416,4,25214,3.8185673178858095,0.0,40.0
26603,2,6603,[ 64  12 269 301 357],416,5,25219,3.8187462144155058,40.0,0.0
26604,2,6604,[ 64  12 269 301 357],416,5,25224,3.8189250567751705,40.0,0.0
26605,2,6605,[245  25 475 174 302],297,4,25228,3.8189524674538298,0.0,0.0
26606,2,6606,[ 64  12 269 301 357],416,5,25233,3.819131224458907,40.0,0.0
26607,2,6607,[ 11 603 427 185  12],405,4,25237,3.8191585956416465,20.0,0.0
26608,2,6608,[276  69 172   1 471],128,4,25241,3.8191859585413828,0.0,0.0
26609,2,6609,[268  70   4 678  15],654,3,25244,3.8190620272314675,0.0,0.0
26610,2,6610,[125 257 135  64 423],642,3,25247,3.818938133414007,20.0,0.0
26611,2,6611,[176  95 385 234 215],405,2,25249,3.8186630369026013,0.0,0.0
26612,2,6612,[ 64  12 269 301 357],416,5,25254,3.818841675487676,40.0,0.0
26613,2,6613,[ 64  12 269 301 357],416,5,25259,3.81902026005443,40.0,0.0
26614,2,6614,[ 64  12 269 301 357],416,5,25264,3.819198790627362,40.0,0.0
26615,2,6615,[ 64  12 269 301 357],416,5,25269,3.8193772672309554,40.0,0.0
26616,2,6616,[ 64  12 269 301 357],416,5,25274,3.819555689889678,40.0,0.0
26617,2,6617,[ 64  12 269 301 357],416,5,25279,3.819734058627984,40.0,0.0
26618,2,6618,[ 64  12 269 301 357],416,5,25284,3.819912373470313,40.0,0.0
26619,2,6619,[195 183 238 265  70],416,5,25289,3.8200906344410877,0.0,0.0
26620,2,6620,[ 64  12 269 301 357],416,5,25294,3.8202688415647184,40.0,0.0
26621,2,6621,[ 64  12 269 301 357],416,5,25299,3.8204469948655997,40.0,0.0
26622,2,6622,[ 64  12 269 301 357],416,5,25304,3.8206250943681113,40.0,0.0
26623,2,6623,[318 182  25   1 245],416,4,25308,3.8206521739130435,20.0,0.0
26624,2,6624,[ 97  56 282 183 275],270,4,25312,3.820679245283019,0.0,0.0
26625,2,6625,[125 202 357 118 172],642,2,25314,3.8204044672502264,0.0,0.0
26626,2,6626,[475  28  11 588  88],805,1,25315,3.8199788743020973,0.0,0.0
26627,2,6627,[286 318 132 655 323],345,3,25318,3.81985515992758,20.0,0.0
26628,2,6628,[180 228   7 357 168],62,4,25322,3.8198823351938453,0.0,0.0
26629,2,6629,[176  89  56  70 288],405,2,25324,3.819607843137255,0.0,20.0
26630,2,6630,[215  71 237 300  50],128,4,25328,3.819635047504147,0.0,20.0
26631,2,6631,[197 238 216 127 475],416,4,25332,3.819662243667069,0.0,0.0
26632,2,6632,[ 97 302 258  56 257],654,4,25336,3.81968943162973,0.0,0.0
26633,2,6633,[ 95 288 132 275 186],711,3,25339,3.8195658727766055,0.0,20.0
26634,2,6634,[125 294 191 273 195],62,4,25343,3.819593067068576,0.0,0.0
26635,2,6635,[ 64  12 269 301 357],416,5,25348,3.819770946353225,40.0,0.0
26636,2,6636,[ 64  12 269 301 357],416,5,25353,3.8199487720355583,40.0,0.0
26637,2,6637,[173  89 135 546  11],417,3,25356,3.819825248568846,0.0,0.0
26638,2,6638,[ 64  12 269 301 357],416,5,25361,3.820003012501883,40.0,0.0
26639,2,6639,[ 64  12 269 301 357],416,5,25366,3.8201807228915663,40.0,0.0
26640,2,6640,[ 69 385 135 265  56],618,5,25371,3.820358379762084,0.0,0.0
26641,2,6641,[195  98 318 180 181],437,4,25375,3.820385426076483,20.0,40.0
26642,2,6642,[194 328 322 333 405],854,1,25376,3.8199608610567513,0.0,0.0
26643,2,6643,[496   1 427 195 181],698,2,25378,3.8196869355809753,0.0,20.0
26644,2,6644,[100  56  95 235  25],805,3,25381,3.819563581640331,0.0,0.0
26645,2,6645,[118 196 125 135 357],417,4,25385,3.8195907312669273,0.0,0.0
26646,2,6646,[ 22   9  71 118 216],805,0,25385,3.819016097487588,0.0,0.0
26647,2,6647,[168 100 427 568 300],198,2,25387,3.8187424789410347,0.0,0.0
26648,2,6648,[405 282  64 132 268],314,5,25392,3.8189201383666718,20.0,0.0
26649,2,6649,[172 333 187   1 403],416,5,25397,3.8190977443609024,0.0,0.0
26650,2,6650,[286 222 179   1 268],721,5,25402,3.8192752969478274,0.0,0.0
26651,2,6651,[ 95  70 276  89 200],198,2,25404,3.8190018039687312,0.0,0.0
26652,2,6652,[151  25  56 196 245],345,3,25407,3.8188787013377423,0.0,0.0
26653,2,6653,[ 64  12 269 301 357],416,5,25412,3.8190562067929066,40.0,0.0
26654,2,6654,[100  15 423 200 215],416,5,25417,3.81923365890308,0.0,0.0
26655,2,6655,[234 144 268 286 179],416,4,25421,3.8192608173076925,0.0,0.0
26656,2,6656,[ 64  12 269 301 357],416,5,25426,3.8194381853687847,40.0,0.0
26657,2,6657,[ 64  12 269 301 357],416,5,25431,3.8196155001501952,40.0,0.0
26658,2,6658,[ 89 117   7 597 176],854,2,25433,3.819342243580117,0.0,0.0
26659,2,6659,[176 211 323 172 385],417,3,25436,3.819219219219219,0.0,0.0
26660,2,6660,[568 333 742 118 234],588,4,25440,3.819246359405495,0.0,0.0
26661,2,6661,[ 64  12 269 301 357],416,5,25445,3.8194235965175625,40.0,0.0
26662,2,6662,[265 111  56 211 234],437,3,25448,3.8193006153384363,0.0,0.0
26663,2,6663,[405 183 318 185 204],601,3,25451,3.8191776710684273,20.0,0.0
26664,2,6664,[ 64  12 269 301 357],416,5,25456,3.8193548387096774,40.0,0.0
26665,2,6665,[135 161 168 313 275],711,5,25461,3.8195319531953196,20.0,20.0
26666,2,6666,[265 322  64 143 257],416,3,25464,3.8194090295485226,20.0,0.0
26667,2,6667,[ 64  12 269 301 357],416,5,25469,3.8195860827834434,40.0,0.0
26668,2,6668,[ 64  12 269 301 357],416,5,25474,3.8197630829209777,40.0,0.0
26669,2,6669,[ 69 588 603 153 144],373,3,25477,3.819640179910045,0.0,0.0
26670,2,6670,[ 97  69 357 268  88],416,4,25481,3.8196672163093988,0.0,0.0
26671,2,6671,[215   4 678 195 323],416,3,25484,3.8195443645083933,0.0,0.0
26672,2,6672,[100   7 187 322 179],416,3,25487,3.8194215495279487,0.0,0.0
26673,2,6673,[258 204 172 742 748],654,5,25492,3.8195984417141147,0.0,0.0
26674,2,6674,[ 64  12 269 301 357],416,5,25497,3.8197752808988765,40.0,0.0
26675,2,6675,[132 568 173 238 143],345,5,25502,3.8199520671060516,0.0,0.0
26676,2,6676,[ 64  12 269 301 357],416,5,25507,3.8201288003594427,40.0,0.0
26677,2,6677,[268 195 323   4 111],417,2,25509,3.819856244384546,0.0,0.0
26678,2,6678,[ 69 515 289 294 187],416,4,25513,3.819883216050307,0.0,0.0
26679,2,6679,[ 89 143 313 117 168],642,4,25517,3.8199101796407184,20.0,20.0
26680,2,6680,[100 282  50 427 143],416,5,25522,3.8200868133512946,0.0,20.0
26681,2,6681,[ 64  12 269 301 357],416,5,25527,3.8202633941933555,40.0,0.0
26682,2,6682,[ 56 275 180  71 204],437,4,25531,3.8202902887924584,0.0,0.0
26683,2,6683,[168 191  64 300 100],416,5,25536,3.8204667863554755,20.0,0.0
26684,2,6684,[ 64  12 269 301 357],416,5,25541,3.820643231114435,40.0,0.0
26685,2,6685,[ 64  12 269 301 357],416,5,25546,3.8208196230930302,40.0,0.0
26686,2,6686,[216 597 322 405 238],417,1,25547,3.8203977867504113,0.0,0.0
26687,2,6687,[ 50 222 117 568 210],654,5,25552,3.8205741626794256,0.0,20.0
26688,2,6688,[216 179 186 191  15],437,4,25556,3.8206009866945734,0.0,0.0
26689,2,6689,[ 69 180 286 318 302],854,3,25559,3.820478325859492,20.0,0.0
26690,2,6690,[204 318 588 100 132],345,4,25563,3.820505156179943,20.0,0.0
26691,2,6691,[ 64  12 269 301 357],416,5,25568,3.8206814106395695,40.0,0.0
26692,2,6692,[ 64  12 269 301 357],416,5,25573,3.820857612430898,40.0,0.0
26693,2,6693,[ 64  12 269 301 357],416,5,25578,3.821033761577532,40.0,0.0
26694,2,6694,[269   1 276 294   4],416,4,25582,3.8210604929051533,0.0,0.0
26695,2,6695,[ 50 235 427 302 385],416,4,25586,3.8210872162485066,0.0,20.0
26696,2,6696,[257 182 151 655 117],416,3,25589,3.8209646110198596,0.0,0.0
26697,2,6697,[118 197 127 322 238],805,2,25591,3.8206927441027174,0.0,0.0
26698,2,6698,[273 210 200 294 385],416,5,25596,3.820868786386028,0.0,0.0
26699,2,6699,[ 64 161 176 125 508],417,3,25599,3.8207462686567166,20.0,0.0
26700,2,6700,[121  22 172 655  56],887,4,25603,3.820773018952395,0.0,0.0
26701,2,6701,[151 111  69 294 323],417,2,25605,3.8205013428827215,0.0,0.0
26702,2,6702,[245 678   1  71 173],345,1,25606,3.8200805609428614,0.0,0.0
26703,2,6703,[200 276 179  11 333],416,3,25609,3.819958233890215,0.0,0.0
26704,2,6704,[301 100 179 215  98],416,4,25613,3.819985085756898,0.0,20.0
26705,2,6705,[ 64  12 269 301 357],416,5,25618,3.820161049806144,40.0,0.0
26706,2,6706,[ 64  12 269 301 357],416,5,25623,3.820336961383629,40.0,0.0
26707,2,6707,[176  15 200 151 237],854,2,25625,3.820065593321407,0.0,0.0
26708,2,6708,[  7 288 172 202 423],588,2,25627,3.81979430615591,0.0,20.0
26709,2,6709,[748 258 132 118  70],416,4,25631,3.8198211624441134,0.0,0.0
26710,2,6710,[ 64  12 269 301 357],416,5,25636,3.8199970198182087,40.0,0.0
26711,2,6711,[196   1 265 275 202],416,5,25641,3.820172824791418,0.0,0.0
26712,2,6712,[ 64  12 269 301 357],416,5,25646,3.820348577387159,40.0,0.0
26713,2,6713,[  1 180  97 195  96],62,3,25649,3.820226392612452,0.0,0.0
26714,2,6714,[ 64  12 269 301 357],416,5,25654,3.8204020848845865,40.0,0.0
26715,2,6715,[132 118 568  82  71],62,3,25657,3.8202799285288864,0.0,0.0
26716,2,6716,[ 64  12 269 301 357],416,5,25662,3.8204555605180883,40.0,0.0
26717,2,6717,[173 237 196 181 179],62,4,25666,3.8204822863947605,0.0,20.0
26718,2,6718,[ 64  12 269 301 357],416,5,25671,3.820657835987498,40.0,0.0
26719,2,6719,[196 191 144 181 151],705,2,25673,3.8203869047619046,0.0,20.0
26720,2,6720,[132 282  15 216 235],345,3,25676,3.8202648415414373,0.0,0.0
26721,2,6721,[202 289   8 385 302],416,4,25680,3.8202915798869386,0.0,0.0
26722,2,6722,[ 12 603 238 323 322],416,3,25683,3.820169567157519,20.0,0.0
26723,2,6723,[275 151  96  15 125],907,5,25688,3.82034503271862,0.0,0.0
26724,2,6724,[245  69 268 385 118],345,2,25690,3.820074349442379,0.0,0.0
26725,2,6725,[ 64  12 269 301 357],416,5,25695,3.820249776984835,40.0,0.0
26726,2,6726,[202 216  11 333 288],345,2,25697,3.8199791883454735,0.0,20.0
26727,2,6727,[172 496 483  71 215],437,3,25700,3.8198573127229487,20.0,0.0
26728,2,6728,[ 64  12 269 301 357],416,5,25705,3.8200326943082183,40.0,0.0
26729,2,6729,[588 132 210 161 216],373,3,25708,3.819910846953938,0.0,0.0
26730,2,6730,[275 222   8 435  22],297,4,25712,3.819937602139355,0.0,0.0
26731,2,6731,[678 294  12 202 235],345,1,25713,3.81951871657754,20.0,0.0
26732,2,6732,[ 64  12 269 301 357],416,5,25718,3.819694044259617,40.0,0.0
26733,2,6733,[ 64  12 269 301 357],416,5,25723,3.8198693198693197,40.0,0.0
26734,2,6734,[173 603  89 405 238],805,4,25727,3.8198960653303637,0.0,0.0
26735,2,6735,[ 64  12 269 301 357],416,5,25732,3.8200712589073635,40.0,0.0
26736,2,6736,[153   9 238 294 245],416,4,25736,3.820097966453911,0.0,0.0
26737,2,6737,[100 117 234 200 235],805,3,25739,3.81997625408133,0.0,0.0
26738,2,6738,[117 151 182 275 276],618,2,25741,3.8197061878617005,0.0,0.0
26739,2,6739,[182  15  96 597 288],416,4,25745,3.81973293768546,0.0,20.0
26740,2,6740,[ 50 153 427  79 328],373,5,25750,3.819908025515502,0.0,20.0
26741,2,6741,[ 64  12 269 301 357],416,5,25755,3.8200830614061108,40.0,0.0
26742,2,6742,[ 82 144  71 185 176],437,1,25756,3.8196648376093725,0.0,0.0
26743,2,6743,[276 405  96   1 202],230,4,25760,3.8196915776986953,0.0,0.0
26744,2,6744,[  9 174 215 678 204],416,4,25764,3.8197183098591547,0.0,0.0
26745,2,6745,[  8 196 144 269 204],297,3,25767,3.8195967981025793,0.0,0.0
26746,2,6746,[222 237 282  64  69],630,3,25770,3.819475322365496,20.0,0.0
26747,2,6747,[ 82 234 313 742 294],38,5,25775,3.8196502667457026,20.0,20.0
26748,2,6748,[182 655 237 742  69],416,4,25779,3.819676989183583,0.0,0.0
26749,2,6749,[ 64  12 269 301 357],416,5,25784,3.819851851851852,40.0,0.0
26750,2,6750,[173  25 222 286 174],43,5,25789,3.8200266627166344,0.0,0.0
26751,2,6751,[496  88 286 471 143],416,4,25793,3.820053317535545,0.0,0.0
26752,2,6752,[200 121 258 153 174],198,4,25797,3.82007996446024,0.0,0.0
26753,2,6753,[302 237 127 423 235],43,4,25801,3.8201066034942257,0.0,0.0
26754,2,6754,[ 64  12 269 301 357],416,5,25806,3.820281273131014,40.0,0.0
26755,2,6755,[ 56 234 210   7 200],805,4,25810,3.820307874481942,0.0,0.0
26756,2,6756,[173 471 195 121 742],416,5,25815,3.8204824626313454,0.0,0.0
26757,2,6757,[328 405 195 385  28],416,5,25820,3.8206569991121633,0.0,0.0
26758,2,6758,[125 245  71 216 135],642,3,25823,3.820535582186714,0.0,0.0
26759,2,6759,[405  89  11 185 186],198,3,25826,3.820414201183432,0.0,0.0
26760,2,6760,[515 483 175   9 181],354,3,25829,3.8202928560863776,20.0,20.0
26761,2,6761,[403 179 118 210  28],62,3,25832,3.8201715468796213,0.0,0.0
26762,2,6762,[ 64  12 269 301 357],416,5,25837,3.820346000295727,40.0,0.0
26763,2,6763,[ 64  12 269 301 357],416,5,25842,3.820520402128918,40.0,0.0
26764,2,6764,[ 25 273 742 322 216],805,1,25843,3.8201034737620105,0.0,0.0
26765,2,6765,[257 265 237  69 301],416,3,25846,3.8199822642624888,0.0,0.0
26766,2,6766,[ 64  12 269 301 357],416,5,25851,3.8201566425299247,40.0,0.0
26767,2,6767,[302 357 118 742 328],416,4,25855,3.8201832151300237,0.0,0.0
26768,2,6768,[ 64  25  88 655 588],711,5,25860,3.8203575121879156,20.0,0.0
26769,2,6769,[  7 318  64 235 282],416,4,25864,3.820384047267356,40.0,0.0
26770,2,6770,[ 64  12 269 301 357],416,5,25869,3.820558263181214,40.0,0.0
26771,2,6771,[182 282  96 183 328],416,5,25874,3.820732427643237,0.0,0.0
26772,2,6772,[546   4 195 176 288],805,1,25875,3.8203159604311234,0.0,20.0
26773,2,6773,[357 588 176 302 496],417,2,25877,3.8200472394449365,0.0,0.0
26774,2,6774,[  9  82  98 228  69],62,4,25881,3.8200738007380073,0.0,20.0
26775,2,6775,[222 151 215 313  25],711,3,25884,3.819952774498229,20.0,20.0
26776,2,6776,[ 64  12 269 301 357],416,5,25889,3.8201268998081748,40.0,0.0
26777,2,6777,[ 12 111   9 234 655],618,3,25892,3.820005901445854,20.0,0.0
26778,2,6778,[  9 143  56  82 294],43,5,25897,3.820179967546836,0.0,0.0
26779,2,6779,[ 64  12 269 301 357],416,5,25902,3.820353982300885,40.0,0.0
26780,2,6780,[ 64  12 269 301 357],416,5,25907,3.820527945730718,40.0,0.0
26781,2,6781,[ 96  98  50  71 197],198,4,25911,3.8205544087289884,0.0,40.0
26782,2,6782,[546 121 173 118 257],416,2,25913,3.8202860091404984,0.0,0.0
26783,2,6783,[ 64  12 269 301 357],416,5,25918,3.8204599056603774,40.0,0.0
26784,2,6784,[301 313 216  96 300],751,3,25921,3.8203389830508474,20.0,20.0
26785,2,6785,[238 318 275 328 211],416,5,25926,3.8205128205128207,20.0,0.0
26786,2,6786,[121 258 191 185 323],198,2,25928,3.8202445852364817,0.0,0.0
26787,2,6787,[ 64  12 269 301 357],416,5,25933,3.8204183853859752,40.0,0.0
26788,2,6788,[ 64  12 269 301 357],416,5,25938,3.820592134334954,40.0,0.0
26789,2,6789,[182 100 742 318 195],416,5,25943,3.8207658321060385,20.0,0.0
26790,2,6790,[ 64  12 269 301 357],416,5,25948,3.820939478721838,40.0,0.0
26791,2,6791,[179 322  95 127 181],417,3,25951,3.8208186101295643,0.0,20.0
26792,2,6792,[117 276 238 197 173],198,3,25954,3.8206977771235096,0.0,0.0
26793,2,6793,[ 64  12 269 301 357],416,5,25959,3.8208713570797763,40.0,0.0
26794,2,6794,[475 328 403 288 597],416,3,25962,3.8207505518763796,0.0,20.0
26795,2,6795,[ 50 357 258 257 286],297,4,25966,3.820776927604473,0.0,20.0
26796,2,6796,[ 64  12 269 301 357],416,5,25971,3.8209504193026333,40.0,0.0
26797,2,6797,[191   1 202 237  71],922,4,25975,3.820976757869962,0.0,0.0
26798,2,6798,[273 357 100 245 143],416,4,25979,3.821003088689513,0.0,0.0
26799,2,6799,[568 257 179 196 194],751,4,25983,3.8210294117647057,0.0,0.0
26800,2,6800,[288 265 323 172 245],416,3,25986,3.8209086898985443,0.0,20.0
26801,2,6801,[202 118  12 588  79],345,2,25988,3.820640987944722,20.0,0.0
26802,2,6802,[ 12  89  50 118 161],437,2,25990,3.8203733646920477,20.0,20.0
26803,2,6803,[ 64  12 269 301 357],416,5,25995,3.820546737213404,40.0,0.0
26804,2,6804,[318 597 257  98 111],62,2,25997,3.820279206465834,20.0,20.0
26805,2,6805,[ 64  12 269 301 357],416,5,26002,3.8204525418748165,40.0,0.0
26806,2,6806,[ 64  12 269 301 357],416,5,26007,3.8206258263552226,40.0,0.0
26807,2,6807,[125 200 405 322  82],417,3,26010,3.820505287896592,0.0,0.0
26808,2,6808,[ 64  12 269 301 357],416,5,26015,3.8206785137318255,40.0,0.0
26809,2,6809,[ 89 357 269 546   7],555,4,26019,3.820704845814978,0.0,0.0
26810,2,6810,[153  71 238 216 173],198,4,26023,3.820731170165908,0.0,0.0
26811,2,6811,[ 64  12 269 301 357],416,5,26028,3.8209042865531413,40.0,0.0
26812,2,6812,[ 64  12 269 301 357],416,5,26033,3.821077352120945,40.0,0.0
26813,2,6813,[328   9 210 215 100],62,3,26036,3.820956853536836,0.0,0.0
26814,2,6814,[471 282 197 118 678],345,1,26037,3.820542920029347,0.0,0.0
26815,2,6815,[269  28 197 588  88],345,3,26040,3.8204225352112675,0.0,0.0
26816,2,6816,[ 50 143  56 318 125],642,4,26044,3.8204488778054864,20.0,20.0
26817,2,6817,[ 95 118 210 183 143],887,4,26048,3.820475212672338,0.0,0.0
26818,2,6818,[276 508 282  69 202],314,3,26051,3.8203548907464437,0.0,0.0
26819,2,6819,[ 64  12 269 301 357],416,5,26056,3.8205278592375365,40.0,0.0
26820,2,6820,[211  28 313 275 235],43,4,26060,3.820554170942677,20.0,20.0
26821,2,6821,[ 64  12 269 301 357],416,5,26065,3.8207270595133394,40.0,0.0
26822,2,6822,[268 508  98 302 313],345,5,26070,3.820899897405833,20.0,40.0
26823,2,6823,[ 64  12 269 301 357],416,5,26075,3.8210726846424383,40.0,0.0
26824,2,6824,[258 302 151 144  82],417,3,26078,3.820952380952381,0.0,0.0
26825,2,6825,[117 215 174  98 318],618,5,26083,3.821125109874011,20.0,20.0
26826,2,6826,[ 64  12 269 301 357],416,5,26088,3.821297788193936,40.0,0.0
26827,2,6827,[ 64  12 269 301 357],416,5,26093,3.821470415934388,40.0,0.0
26828,2,6828,[294 423 235 161 275],416,4,26097,3.821496558793381,0.0,0.0
26829,2,6829,[427 132 655  71  88],405,3,26100,3.821376281112738,0.0,0.0
26830,2,6830,[161 588 176 196 215],405,1,26101,3.8209632557458644,0.0,0.0
26831,2,6831,[655 174 185 385  82],417,3,26104,3.8208430913348947,0.0,0.0
26832,2,6832,[269 275 173 301 111],416,5,26109,3.821015659300454,0.0,0.0
26833,2,6833,[ 64  12 269 301 357],416,5,26114,3.8211881767632425,40.0,0.0
26834,2,6834,[237 183 228 191 144],297,2,26116,3.820921726408193,0.0,0.0
26835,2,6835,[ 11  70 172  96 175],49,1,26117,3.8205090696313633,0.0,0.0
26836,2,6836,[423 282 276 143 588],416,4,26121,3.8205353225098726,0.0,0.0
26837,2,6837,[100 333   1 182 588],253,3,26124,3.820415326118748,0.0,0.0
26838,2,6838,[ 64  12 269 301 357],416,5,26129,3.8205878052346836,40.0,0.0
26839,2,6839,[237 175 174 748  22],297,4,26133,3.8206140350877194,0.0,0.0
26840,2,6840,[405 210 258 238 222],601,3,26136,3.820494079812893,0.0,0.0
26841,2,6841,[195 568 508 475 182],214,5,26141,3.8206664717918737,0.0,0.0
26842,2,6842,[427  95 568 186  12],405,4,26145,3.820692678649715,20.0,0.0
26843,2,6843,[172 143 210 111  50],437,3,26148,3.820572764465225,0.0,20.0
26844,2,6844,[ 64  12 269 301 357],416,5,26153,3.820745069393718,40.0,0.0
26845,2,6845,[ 64  12 269 301 357],416,5,26158,3.8209173239848084,40.0,0.0
26846,2,6846,[  7 282 197 125 191],854,3,26161,3.8207974295311815,0.0,0.0
26847,2,6847,[174 151 235 187 234],416,3,26164,3.820677570093458,0.0,0.0
26848,2,6848,[588 151 245  69 475],417,3,26167,3.8205577456563002,0.0,0.0
26849,2,6849,[ 64  12 269 301 357],416,5,26172,3.8207299270072994,40.0,0.0
26850,2,6850,[204  95 175 161  79],805,2,26174,3.8204641658152094,0.0,0.0
26851,2,6851,[ 64  12 269 301 357],416,5,26179,3.820636310566258,40.0,0.0
26852,2,6852,[ 64  12 269 301 357],416,5,26184,3.820808405078068,40.0,0.0
26853,2,6853,[ 64  12 269 301 357],416,5,26189,3.820980449372629,40.0,0.0
26854,2,6854,[ 56 588 357 180 191],805,3,26192,3.8208606856309264,0.0,0.0
26855,2,6855,[294   7 286 176 268],417,4,26196,3.820886814469078,0.0,0.0
26856,2,6856,[  1 204  64   9 118],43,5,26201,3.8210587720577514,20.0,0.0
26857,2,6857,[748 174 179 423 234],805,2,26203,3.820793234179061,0.0,0.0
26858,2,6858,[301 496 288 153 117],416,5,26208,3.8209651552704478,0.0,20.0
26859,2,6859,[323 423 496  97 151],417,3,26211,3.8208454810495627,0.0,0.0
26860,2,6860,[210 143  82  79 228],805,1,26212,3.820434339017636,0.0,0.0
26861,2,6861,[ 64  12 269 301 357],416,5,26217,3.8206062372486156,40.0,0.0
26862,2,6862,[143 427 403 100 210],198,3,26220,3.8204866676380593,0.0,0.0
26863,2,6863,[ 64  12 269 301 357],416,5,26225,3.820658508158508,40.0,0.0
26864,2,6864,[ 64  12 269 301 357],416,5,26230,3.820830298616169,40.0,0.0
26865,2,6865,[  4  28 125 216 118],764,3,26233,3.8207107486163707,0.0,0.0
26866,2,6866,[228 323 258 748 181],417,2,26235,3.820445609436435,0.0,20.0
26867,2,6867,[ 70 385 187 282 183],416,5,26240,3.8206173558532326,0.0,0.0
26868,2,6868,[475 118 222 235 597],805,2,26242,3.820352307468336,0.0,0.0
26869,2,6869,[211 265 183  97  82],437,1,26243,3.8199417758369725,0.0,0.0
26870,2,6870,[ 64  12 269 301 357],416,5,26248,3.8201135205938,40.0,0.0
26871,2,6871,[ 11 161 186 588 238],405,3,26251,3.8199941792782304,0.0,0.0
26872,2,6872,[153 204 237  15 191],342,4,26255,3.8200203695620543,0.0,0.0
26873,2,6873,[ 64  12 269 301 357],416,5,26260,3.8201920279313355,40.0,0.0
26874,2,6874,[  4  71 238 202  50],416,5,26265,3.8203636363636364,0.0,20.0
26875,2,6875,[ 64  12 269 301 357],416,5,26270,3.8205351948807444,40.0,0.0
26876,2,6876,[ 64  12 269 301 357],416,5,26275,3.820706703504435,40.0,0.0
26877,2,6877,[ 64  12 269 301 357],416,5,26280,3.82087816225647,40.0,0.0
26878,2,6878,[ 95 191 151 196 313],43,5,26285,3.8210495711585986,20.0,20.0
26879,2,6879,[385  70 211 603 496],416,5,26290,3.821220930232558,0.0,0.0
26880,2,6880,[275 238 568 210 172],654,5,26295,3.8213922395000726,0.0,0.0
26881,2,6881,[ 64  12 269 301 357],416,5,26300,3.821563498982854,40.0,0.0
26882,2,6882,[ 64  12 269 301 357],416,5,26305,3.821734708702601,40.0,0.0
26883,2,6883,[748 405 191   9 121],416,5,26310,3.8219058686809992,0.0,0.0
26884,2,6884,[269 300 471 282 234],297,1,26311,3.821496005809731,0.0,0.0
26885,2,6885,[273 151 173 403 258],62,5,26316,3.821667150740633,0.0,0.0
26886,2,6886,[ 64  12 269 301 357],416,5,26321,3.8218382459706692,40.0,0.0
26887,2,6887,[ 64  12 269 301 357],416,5,26326,3.8220092915214865,40.0,0.0
26888,2,6888,[235  22 294   1 471],854,0,26326,3.821454492669473,0.0,0.0
26889,2,6889,[ 64  12 269 301 357],416,5,26331,3.8216255442670537,40.0,0.0
26890,2,6890,[ 64  12 269 301 357],416,5,26336,3.8217965462197068,40.0,0.0
26891,2,6891,[ 64  12 269 301 357],416,5,26341,3.8219674985490424,40.0,0.0
26892,2,6892,[ 64  12 269 301 357],416,5,26346,3.8221384012766575,40.0,0.0
26893,2,6893,[385  98 748 127 181],416,5,26351,3.822309254424137,0.0,40.0
26894,2,6894,[ 64  12 269 301 357],416,5,26356,3.822480058013053,40.0,0.0
26895,2,6895,[748 153  25 357  22],805,3,26359,3.8223607888631093,0.0,0.0
26896,2,6896,[ 89 288 143  97  98],405,3,26362,3.8222415542989707,0.0,40.0
26897,2,6897,[117 180  11 121 135],854,3,26365,3.8221223543055958,0.0,0.0
26898,2,6898,[271  79 597 328 161],43,3,26368,3.822003188867952,0.0,0.0
26899,2,6899,[269  56 100 288 132],416,5,26373,3.8221739130434784,0.0,20.0
26900,2,6900,[237 151 403  97  95],43,5,26378,3.8223445877409072,0.0,0.0
26901,2,6901,[258 405 235 273 271],62,3,26381,3.822225441900898,0.0,0.0
26902,2,6902,[194 237 185 216 515],297,4,26385,3.822251195132551,0.0,0.0
26903,2,6903,[ 64  12 269 301 357],416,5,26390,3.8224217844727693,40.0,0.0
26904,2,6904,[ 64  12 269 301 357],416,5,26395,3.8225923244026068,40.0,0.0
26905,2,6905,[ 64  12 269 301 357],416,5,26400,3.8227628149435273,40.0,0.0
26906,2,6906,[ 64  12 269 301 357],416,5,26405,3.8229332561169826,40.0,0.0
26907,2,6907,[475   4 508 127 202],417,3,26408,3.8228141285466126,0.0,0.0
26908,2,6908,[237   8 161  15 179],721,4,26412,3.8228397742075555,0.0,0.0
26909,2,6909,[  7 194 385 288  22],416,5,26417,3.82301013024602,0.0,20.0
26910,2,6910,[195   8 100 471  11],297,3,26420,3.8228910432643612,0.0,0.0
26911,2,6911,[ 64  12 269 301 357],416,5,26425,3.8230613425925926,40.0,0.0
26912,2,6912,[ 12 234 153 294  88],416,4,26429,3.823086937653696,20.0,0.0
26913,2,6913,[121 323 125 215  25],416,4,26433,3.8231125253109632,0.0,0.0
26914,2,6914,[568 151 186 168 181],373,5,26438,3.823282718727404,0.0,20.0
26915,2,6915,[151 216 742 180 258],62,4,26442,3.8233082706766917,0.0,0.0
26916,2,6916,[ 64  12 269 301 357],416,5,26447,3.823478386583779,40.0,0.0
26917,2,6917,[ 64  12 269 301 357],416,5,26452,3.8236484533102053,40.0,0.0
26918,2,6918,[ 64  12 269 301 357],416,5,26457,3.823818470877294,40.0,0.0
26919,2,6919,[ 64  12 269 301 357],416,5,26462,3.8239884393063583,40.0,0.0
26920,2,6920,[ 64  12 269 301 357],416,5,26467,3.8241583586186967,40.0,0.0
26921,2,6921,[ 64  12 269 301 357],416,5,26472,3.8243282288355966,40.0,0.0
26922,2,6922,[222  89 216 182 288],417,2,26474,3.8240647118301316,0.0,20.0
26923,2,6923,[127 144  25 238 282],618,2,26476,3.8238012709416522,0.0,0.0
26924,2,6924,[ 70  25 179 515 294],417,4,26480,3.823826714801444,0.0,0.0
26925,2,6925,[196 546 357 197 132],416,4,26484,3.82385215131389,0.0,0.0
26926,2,6926,[ 64  12 269 301 357],416,5,26489,3.8240219431211204,40.0,0.0
26927,2,6927,[678 423  98 257 111],416,3,26492,3.8239030023094687,0.0,20.0
26928,2,6928,[ 69 228 210  79 588],505,2,26494,3.823639774859287,0.0,0.0
26929,2,6929,[435 179 186 195 197],405,3,26497,3.8235209235209235,0.0,0.0
26930,2,6930,[ 64  12 269 301 357],416,5,26502,3.823690665127687,40.0,0.0
26931,2,6931,[ 11 282 196 403   4],345,3,26505,3.8235718407386035,0.0,0.0
26932,2,6932,[175 385 427 194 568],373,3,26508,3.823453050627434,0.0,0.0
26933,2,6933,[ 70  12  71 286  79],437,2,26510,3.8231900778771273,20.0,0.0
26934,2,6934,[  8 496 228  50 276],230,4,26514,3.823215573179524,0.0,20.0
26935,2,6935,[ 64  12 269 301 357],416,5,26519,3.8233852364475203,40.0,0.0
26936,2,6936,[ 64  12 269 301 357],416,5,26524,3.8235548508000576,40.0,0.0
26937,2,6937,[118 202 385 183 161],416,4,26528,3.823580282502162,0.0,0.0
26938,2,6938,[ 70   4   8   9 127],62,4,26532,3.8236057068741895,0.0,0.0
26939,2,6939,[ 64  12 269 301 357],416,5,26537,3.8237752161383285,40.0,0.0
26940,2,6940,[ 89 423 173 257 153],297,3,26540,3.8236565336406856,0.0,0.0
26941,2,6941,[357 132 568  97 655],417,4,26544,3.8236819360414867,0.0,0.0
26942,2,6942,[ 64  12 269 301 357],416,5,26549,3.823851361083105,40.0,0.0
26943,2,6943,[  8 195 423 161 197],437,3,26552,3.8237327188940093,0.0,0.0
26944,2,6944,[  9  25 496 475 176],416,4,26556,3.8237580993520517,0.0,0.0
26945,2,6945,[ 95 182 515 210 197],416,4,26560,3.8237834725021593,0.0,0.0
26946,2,6946,[151  82 174 180 100],805,2,26562,3.8235209442925004,0.0,0.0
26947,2,6947,[ 64  12 269 301 357],416,5,26567,3.823690270581462,40.0,0.0
26948,2,6948,[275 496  50  79 483],618,4,26571,3.823715642538495,20.0,20.0
26949,2,6949,[175 423   8  97 435],721,5,26576,3.823884892086331,0.0,0.0
26950,2,6950,[238 286 235 271 475],62,3,26579,3.823766364551863,0.0,0.0
26951,2,6951,[111 132 216 265 435],437,2,26581,3.8235040276179517,0.0,0.0
26952,2,6952,[117 678 333 118  88],588,3,26584,3.8233855889544084,0.0,0.0
26953,2,6953,[195 118 111 144 100],805,1,26585,3.8229795800977855,0.0,0.0
26954,2,6954,[174 195 257 173 313],654,5,26590,3.8231488138030194,20.0,20.0
26955,2,6955,[216  71 204  22 275],711,3,26593,3.8230304772857964,0.0,0.0
26956,2,6956,[228  97 258 195 403],417,4,26597,3.8230559149058503,0.0,0.0
26957,2,6957,[118 678 197 100 655],416,3,26600,3.8229376257545273,0.0,0.0
26958,2,6958,[181  11 183 180  98],417,4,26604,3.8229630694065238,0.0,40.0
26959,2,6959,[ 64  12 269 301 357],416,5,26609,3.823132183908046,40.0,0.0
26960,2,6960,[181 210  11 265 742],654,4,26613,3.8231575922999568,0.0,20.0
26961,2,6961,[258 286 268 151 234],588,5,26618,3.8233266302786557,0.0,0.0
26962,2,6962,[ 64  12 269 301 357],416,5,26623,3.8234956197041505,40.0,0.0
26963,2,6963,[132 286 276 117 245],764,4,26627,3.823520964962665,0.0,0.0
26964,2,6964,[ 64  12 269 301 357],416,5,26632,3.8236898779612347,40.0,0.0
26965,2,6965,[ 64  12 269 301 357],416,5,26637,3.8238587424633934,40.0,0.0
26966,2,6966,[183 202  22 275 282],416,5,26642,3.8240275584900245,0.0,0.0
26967,2,6967,[ 56  50 273  11 118],764,2,26644,3.8237657864523538,0.0,20.0
26968,2,6968,[202 211 210  64 748],416,5,26649,3.8239345673697804,20.0,0.0
26969,2,6969,[258   8 143 200  82],887,3,26652,3.823816355810617,0.0,0.0
26970,2,6970,[405 179  98 111 603],751,3,26655,3.8236981781666906,0.0,20.0
26971,2,6971,[ 64  12 269 301 357],416,5,26660,3.8238668961560527,40.0,0.0
26972,2,6972,[ 64  12 269 301 357],416,5,26665,3.824035565753621,40.0,0.0
26973,2,6973,[275  70  25 655 132],373,4,26669,3.824060797246917,0.0,0.0
26974,2,6974,[237 216 183 222 135],62,4,26673,3.8240860215053765,0.0,0.0
26975,2,6975,[202  71 172 183 301],416,5,26678,3.8242545871559632,0.0,0.0
26976,2,6976,[173 175 211 238  50],43,3,26681,3.824136448330228,0.0,20.0
26977,2,6977,[ 64  12 269 301 357],416,5,26686,3.824304958440814,40.0,0.0
26978,2,6978,[258 357 180   1 222],62,4,26690,3.8243301332569137,0.0,0.0
26979,2,6979,[588 144 118  88 294],416,3,26693,3.824212034383954,0.0,0.0
26980,2,6980,[ 64  12 269 301 357],416,5,26698,3.8243804612519696,40.0,0.0
26981,2,6981,[ 69 269  98 216  15],262,2,26700,3.824119163563449,0.0,20.0
26982,2,6982,[258 121  97 210 118],417,3,26703,3.82400114563941,0.0,0.0
26983,2,6983,[182 597 196  22 496],618,5,26708,3.8241695303550975,0.0,0.0
26984,2,6984,[ 64  12 269 301 357],416,5,26713,3.824337866857552,40.0,0.0
26985,2,6985,[ 64  12 269 301 357],416,5,26718,3.824506155167478,40.0,0.0
26986,2,6986,[173 215   4  88 258],345,5,26723,3.8246743953055673,0.0,0.0
26987,2,6987,[111 302 211 234  82],416,5,26728,3.8248425872925016,0.0,0.0
26988,2,6988,[423 568 175 111 210],43,4,26732,3.8248676491629703,0.0,0.0
26989,2,6989,[ 98 179 174 276 111],437,4,26736,3.824892703862661,0.0,20.0
26990,2,6990,[302   9 118 181   1],345,3,26739,3.824774710341868,0.0,20.0
26991,2,6991,[235 181  50 234 742],297,2,26741,3.8245137299771166,0.0,40.0
26992,2,6992,[ 64  12 269 301 357],416,5,26746,3.8246818246818246,40.0,0.0
26993,2,6993,[176 187 265 194 210],405,2,26748,3.8244209322276235,0.0,0.0
26994,2,6994,[ 64  12 269 301 357],416,5,26753,3.8245889921372407,40.0,0.0
26995,2,6995,[ 98 286 180 215   8],62,3,26756,3.8244711263579187,0.0,20.0
26996,2,6996,[ 64  12 269 301 357],416,5,26761,3.8246391310561667,40.0,0.0
26997,2,6997,[238  12  15 286 144],373,3,26764,3.8245212917976565,20.0,0.0
26998,2,6998,[143 603 180 179 168],437,4,26768,3.8245463637662525,0.0,0.0
26999,2,6999,[174 323 301 427 127],416,4,26772,3.8245714285714287,0.0,0.0
27000,2,7000,[ 64  12 269 301 357],416,5,26777,3.8247393229538638,40.0,0.0
27001,2,7001,[273 127 603  79 153],805,3,26780,3.824621536703799,0.0,0.0
27002,2,7002,[ 64  12 269 301 357],416,5,26785,3.824789375981722,40.0,0.0
27003,2,7003,[268 405 187 117  64],416,5,26790,3.8249571673329528,20.0,0.0
27004,2,7004,[ 64  12 269 301 357],416,5,26795,3.825124910778016,40.0,0.0
27005,2,7005,[234   1 294 216  71],416,5,26800,3.825292606337425,0.0,0.0
27006,2,7006,[ 64  12 269 301 357],416,5,26805,3.8254602540316824,40.0,0.0
27007,2,7007,[ 64  12 269 301 357],416,5,26810,3.8256278538812785,40.0,0.0
27008,2,7008,[168  25 172 273 237],416,4,26814,3.8256527322014553,0.0,0.0
27009,2,7009,[ 64  12 269 301 357],416,5,26819,3.8258202567760344,40.0,0.0
27010,2,7010,[603 182  89  50 191],405,2,26821,3.825559834545714,0.0,20.0
27011,2,7011,[183 168 117   1 245],417,5,26826,3.825727324586423,0.0,0.0
27012,2,7012,[ 64  12 269 301 357],416,5,26831,3.825894766861543,40.0,0.0
27013,2,7013,[597 271 289 125 127],854,2,26833,3.8256344453949245,0.0,0.0
27014,2,7014,[ 64  12 269 301 357],416,5,26838,3.825801853171775,40.0,0.0
27015,2,7015,[ 64  12 269 301 357],416,5,26843,3.82596921322691,40.0,0.0
27016,2,7016,[568 121 132  71 496],642,4,26847,3.8259940145361266,0.0,0.0
27017,2,7017,[282  28 655  71  56],416,5,26852,3.8261612995155314,0.0,0.0
27018,2,7018,[ 64  12 269 301 357],416,5,26857,3.826328536828608,40.0,0.0
27019,2,7019,[286 176  69  79 211],297,3,26860,3.826210826210826,0.0,0.0
27020,2,7020,[ 22 588 748  50  97],416,5,26865,3.826378008830651,0.0,20.0
27021,2,7021,[172 228 125 385 496],417,2,26867,3.826117915123896,0.0,0.0
27022,2,7022,[ 56 423  25 588 182],416,5,26872,3.826285063363235,0.0,0.0
27023,2,7023,[ 69 258 100 423 655],62,3,26875,3.8261674259681095,0.0,0.0
27024,2,7024,[403   8 196 172 118],62,4,26879,3.8261921708185054,0.0,0.0
27025,2,7025,[ 98  97 742 655 127],24,5,26884,3.8263592371192714,0.0,20.0
27026,2,7026,[143   1 275 204 403],416,5,26889,3.8265262558702147,0.0,0.0
27027,2,7027,[245  98 515  70 234],417,5,26894,3.8266932270916336,0.0,20.0
27028,2,7028,[135  28 185 268 174],875,5,26899,3.826860150803813,0.0,0.0
27029,2,7029,[196 132 179 515 121],417,4,26903,3.8268847795163583,0.0,0.0
27030,2,7030,[200  25 195 318  69],887,3,26906,3.8267671739439626,20.0,0.0
27031,2,7031,[100 151 268  69  25],297,3,26909,3.8266496018202503,0.0,0.0
27032,2,7032,[ 56 151 196 202 423],416,4,26913,3.8266742499644533,0.0,0.0
27033,2,7033,[483 179 135 222 258],601,5,26918,3.826841057719647,20.0,0.0
27034,2,7034,[  9 176 191 151 268],854,3,26921,3.826723525230988,0.0,0.0
27035,2,7035,[286  25 403 742  97],588,3,26924,3.8266060261512225,0.0,0.0
27036,2,7036,[ 64  12 269 301 357],416,5,26929,3.826772772488276,40.0,0.0
27037,2,7037,[ 64  12 269 301 357],416,5,26934,3.8269394714407503,40.0,0.0
27038,2,7038,[ 56 302  22 322  15],721,3,26937,3.8268219917601933,0.0,0.0
27039,2,7039,[ 56 322  89 118 235],805,2,26939,3.8265625,0.0,0.0
27040,2,7040,[ 22 318 118 301 322],416,3,26942,3.8264451072290866,20.0,0.0
27041,2,7041,[288 748 405 471 286],345,1,26943,3.826043737574553,0.0,20.0
27042,2,7042,[174 118 427  28 276],416,3,26946,3.82592645179611,0.0,0.0
27043,2,7043,[  4 423 328 405  25],43,5,26951,3.8260931289040316,0.0,0.0
27044,2,7044,[ 64  12 269 301 357],416,5,26956,3.826259758694109,40.0,0.0
27045,2,7045,[143 187 313 194 318],405,4,26960,3.8262844166903207,40.0,20.0
27046,2,7046,[ 64  12 269 301 357],416,5,26965,3.826450972044842,40.0,0.0
27047,2,7047,[435  71 168 153 238],373,5,26970,3.8266174801362087,0.0,0.0
27048,2,7048,[181  28 174 168 185],618,5,26975,3.826783940984537,0.0,20.0
27049,2,7049,[ 64  12 269 301 357],416,5,26980,3.826950354609929,40.0,0.0
27050,2,7050,[302  79 228 435 182],297,1,26981,3.826549425613388,0.0,0.0
27051,2,7051,[ 64  12 269 301 357],416,5,26986,3.826715825297788,40.0,0.0
27052,2,7052,[ 64  12 269 301 357],416,5,26991,3.826882177796682,40.0,0.0
27053,2,7053,[ 64  12 269 301 357],416,5,26996,3.827048483130139,40.0,0.0
27054,2,7054,[ 12 748  22 333  71],416,5,27001,3.827214741318214,20.0,0.0
27055,2,7055,[ 64  12 269 301 357],416,5,27006,3.8273809523809526,40.0,0.0
27056,2,7056,[  4 210 588 180 435],373,3,27009,3.8272637097916964,0.0,0.0
27057,2,7057,[275 496 300 228 282],128,3,27012,3.82714650042505,0.0,0.0
27058,2,7058,[143   8 196 282 121],618,3,27015,3.8270293242668934,0.0,0.0
27059,2,7059,[ 64  12 269 301 357],416,5,27020,3.8271954674220963,40.0,0.0
27060,2,7060,[195 294  89 118 257],62,2,27022,3.82693669451919,0.0,0.0
27061,2,7061,[435  69 100 183 196],297,3,27025,3.8268195978476354,0.0,0.0
27062,2,7062,[ 12 357  70  96 216],416,5,27030,3.8269857001274246,20.0,0.0
27063,2,7063,[153 318  15 195 172],262,1,27031,3.8265855039637597,20.0,0.0
27064,2,7064,[508 588  12 282 144],654,3,27034,3.826468506723284,20.0,0.0
27065,2,7065,[ 64  12 269 301 357],416,5,27039,3.826634588168695,40.0,0.0
27066,2,7066,[127 323 172 216 174],43,4,27043,3.8266591198528372,0.0,0.0
27067,2,7067,[ 64  12 269 301 357],416,5,27048,3.826825127334465,40.0,0.0
27068,2,7068,[210 235 195  15 597],416,3,27051,3.826708162399208,0.0,0.0
27069,2,7069,[385 180 168 174  88],373,3,27054,3.8265912305516268,0.0,0.0
27070,2,7070,[211 302  89 435  70],405,1,27055,3.8261914863527084,0.0,0.0
27071,2,7071,[127 300 132 275  56],416,5,27060,3.8263574660633486,0.0,0.0
27072,2,7072,[318 202 111 118  12],618,2,27062,3.826099250671568,40.0,0.0
27073,2,7073,[172 286  22  70 200],711,5,27067,3.8262651964942043,0.0,0.0
27074,2,7074,[ 64  12 269 301 357],416,5,27072,3.8264310954063605,40.0,0.0
27075,2,7075,[ 64  12 269 301 357],416,5,27077,3.8265969474279253,40.0,0.0
27076,2,7076,[ 82  56 302 269 204],721,3,27080,3.8264801469549243,0.0,0.0
27077,2,7077,[ 28 282 273 496 191],764,3,27083,3.8263633794857306,0.0,0.0
27078,2,7078,[174 435 475 168 175],297,4,27087,3.8263879078965957,0.0,0.0
27079,2,7079,[357 174 144 153 258],62,4,27091,3.826412429378531,0.0,0.0
27080,2,7080,[ 64  12 269 301 357],416,5,27096,3.8265781669255756,40.0,0.0
27081,2,7081,[  7 183  25 216 143],230,2,27098,3.826320248517368,0.0,0.0
27082,2,7082,[269 265  25 173  98],416,5,27103,3.826485952280107,0.0,20.0
27083,2,7083,[174 181 168  70 118],654,3,27106,3.826369282891022,0.0,20.0
27084,2,7084,[117 496 257 603 357],416,4,27110,3.826393789696542,0.0,0.0
27085,2,7085,[288 117  28 508 237],62,2,27112,3.826136042901496,0.0,20.0
27086,2,7086,[181   8  82   9 471],618,2,27114,3.825878368844363,0.0,20.0
27087,2,7087,[288 191 515 125 222],417,3,27117,3.8257618510158014,0.0,20.0
27088,2,7088,[ 12 588 173 328  25],314,3,27120,3.825645366060093,20.0,0.0
27089,2,7089,[257  70  95 265 127],417,3,27123,3.825528913963329,0.0,0.0
27090,2,7090,[313  88   9 172 121],618,4,27127,3.825553518544634,20.0,20.0
27091,2,7091,[222 216 100 471 121],43,4,27131,3.8255781161872533,0.0,0.0
27092,2,7092,[187 196   8 282 546],416,4,27135,3.825602706894121,0.0,0.0
27093,2,7093,[194  95 204 179 603],416,3,27138,3.825486326473076,0.0,0.0
27094,2,7094,[ 64  12 269 301 357],416,5,27143,3.8256518675123328,40.0,0.0
27095,2,7095,[172 265 196 282  71],705,4,27147,3.8256764374295376,0.0,0.0
27096,2,7096,[313 423 385 294  71],654,3,27150,3.825560095815133,20.0,20.0
27097,2,7097,[ 64  12 269 301 357],416,5,27155,3.8257255564947874,40.0,0.0
27098,2,7098,[ 64  12 269 301 357],416,5,27160,3.8258909705592337,40.0,0.0
27099,2,7099,[ 11 385 195 172  69],654,5,27165,3.826056338028169,0.0,0.0
27100,2,7100,[357 405 196 294 435],230,5,27170,3.8262216589212787,0.0,0.0
27101,2,7101,[181 597   9 111 318],274,4,27174,3.8262461278513094,20.0,20.0
27102,2,7102,[174 186 202  11 176],618,4,27178,3.826270589891595,0.0,0.0
27103,2,7103,[ 64  12 269 301 357],416,5,27183,3.826435810810811,40.0,0.0
27104,2,7104,[286  69   1  82  98],588,3,27186,3.826319493314567,0.0,20.0
27105,2,7105,[ 98 185 245  11 191],416,4,27190,3.826343934703068,0.0,20.0
27106,2,7106,[  8 234 118 117  88],805,1,27191,3.8259462501758827,0.0,0.0
27107,2,7107,[ 64  12 269 301 357],416,5,27196,3.8261114237478897,40.0,0.0
27108,2,7108,[385 405 168  97  88],642,4,27200,3.8261358840905895,0.0,0.0
27109,2,7109,[ 64  12 269 301 357],416,5,27205,3.8263009845288325,40.0,0.0
27110,2,7110,[ 64  12 269 301 357],416,5,27210,3.826466038531852,40.0,0.0
27111,2,7111,[ 69 183 276 202 197],618,2,27212,3.826209223847019,0.0,0.0
27112,2,7112,[ 64  12 269 301 357],416,5,27217,3.8263742443413467,40.0,0.0
27113,2,7113,[181  69 496 318 237],588,2,27219,3.8261175147596287,20.0,20.0
27114,2,7114,[180 195 357   1 204],805,2,27221,3.82586085734364,0.0,0.0
27115,2,7115,[546 121 100  22   9],805,1,27222,3.8254637436762224,0.0,0.0
27116,2,7116,[ 64  12 269 301 357],416,5,27227,3.8256287761697343,40.0,0.0
27117,2,7117,[  1 174 216  82 144],62,3,27230,3.825512784490025,0.0,0.0
27118,2,7118,[ 64  12 269 301 357],416,5,27235,3.825677763730861,40.0,0.0
27119,2,7119,[ 12 238 678  97 294],416,4,27239,3.8257022471910114,20.0,0.0
27120,2,7120,[  1   4 515 678 228],297,1,27240,3.8253054346299677,0.0,0.0
27121,2,7121,[183 588  95  28 471],705,3,27243,3.825189553496209,0.0,0.0
27122,2,7122,[ 64  12 269 301 357],416,5,27248,3.8253544854696053,40.0,0.0
27123,2,7123,[ 64  12 269 301 357],416,5,27253,3.825519371139809,40.0,0.0
27124,2,7124,[ 70 597   4 588 215],43,4,27257,3.8255438596491227,0.0,0.0
27125,2,7125,[ 64 333 286 125  69],721,3,27260,3.825428010103845,20.0,0.0
27126,2,7126,[318 182 168 265  56],198,4,27264,3.8254525045601233,20.0,0.0
27127,2,7127,[748 258  70 121  56],416,5,27269,3.825617283950617,0.0,0.0
27128,2,7128,[183  89 471 216  95],297,3,27272,3.825501472857343,0.0,0.0
27129,2,7129,[245 183 196  96 268],416,4,27276,3.8255259467040674,0.0,0.0
27130,2,7130,[ 64  12 269 301 357],416,5,27281,3.8256906464731455,40.0,0.0
27131,2,7131,[  4 182  88  82 234],618,4,27285,3.825715086932137,0.0,0.0
27132,2,7132,[ 64  12 269 301 357],416,5,27290,3.8258797140053273,40.0,0.0
27133,2,7133,[ 12 268 194 423  71],416,5,27295,3.826044294925708,20.0,0.0
27134,2,7134,[200 173 405 127 234],417,4,27299,3.8260686755430973,0.0,0.0
27135,2,7135,[210  88 168 568  97],416,4,27303,3.8260930493273544,0.0,0.0
27136,2,7136,[ 64  12 269 301 357],416,5,27308,3.826257531175564,40.0,0.0
27137,2,7137,[185 183  11 496 195],437,2,27310,3.826001681143177,0.0,0.0
27138,2,7138,[ 64  12 269 301 357],416,5,27315,3.8261661297100433,40.0,0.0
27139,2,7139,[423 168  15 235 100],62,3,27318,3.8260504201680674,0.0,0.0
27140,2,7140,[403 588 237  98  69],43,5,27323,3.8262148158521216,0.0,20.0
27141,2,7141,[588  11  88 144 357],805,1,27324,3.8258190982917952,0.0,0.0
27142,2,7142,[111 175 117 742 237],854,1,27325,3.8254234915301693,0.0,0.0
27143,2,7143,[ 64  12 269 301 357],416,5,27330,3.8255879059350506,40.0,0.0
27144,2,7144,[282 216 183 132 174],618,3,27333,3.825472358292512,0.0,0.0
27145,2,7145,[268 588 144 301 168],297,4,27337,3.825496781416177,0.0,0.0
27146,2,7146,[ 69 385  71 216 196],198,2,27339,3.8252413600111934,0.0,0.0
27147,2,7147,[276 183   9 210  88],416,3,27342,3.8251259093452714,0.0,0.0
27148,2,7148,[ 64  12 269 301 357],416,5,27347,3.8252902503846693,40.0,0.0
27149,2,7149,[237 385  71   4 172],618,4,27351,3.825314685314685,0.0,0.0
27150,2,7150,[238 183 127 748 258],198,4,27355,3.825339113410712,0.0,0.0
27151,2,7151,[237  69 655 318  56],721,2,27357,3.8250838926174495,20.0,0.0
27152,2,7152,[168 271 180 286  12],62,3,27360,3.8249685446665733,20.0,0.0
27153,2,7153,[135 191 403 200  11],922,1,27361,3.8245736650824713,0.0,0.0
27154,2,7154,[ 88 222 183 678 216],805,3,27364,3.8244584206848358,0.0,0.0
27155,2,7155,[ 64  12 269 301 357],416,5,27369,3.824622694242594,40.0,0.0
27156,2,7156,[ 64  12 269 301 357],416,5,27374,3.8247869218946486,40.0,0.0
27157,2,7157,[ 64  12 269 301 357],416,5,27379,3.8249511036602404,40.0,0.0
27158,2,7158,[135  96  89  56 427],198,5,27384,3.8251152395585977,0.0,0.0
27159,2,7159,[258 508 191 181 282],297,3,27387,3.825,0.0,20.0
27160,2,7160,[ 69 235 191 313 222],43,4,27391,3.825024437927664,20.0,20.0
27161,2,7161,[300 385   7 328 496],43,5,27396,3.8251884948338453,0.0,0.0
27162,2,7162,[ 64  12 269 301 357],416,5,27401,3.8253525059332683,40.0,0.0
27163,2,7163,[ 82  96 234 568  95],405,3,27404,3.8252372975991067,0.0,0.0
27164,2,7164,[  1 196 168 179 245],62,3,27407,3.825122121423587,0.0,0.0
27165,2,7165,[ 64  12 269 301 357],416,5,27412,3.825286073123081,40.0,0.0
27166,2,7166,[118  95 257  70 276],416,1,27413,3.824891865494628,0.0,0.0
27167,2,7167,[294  56 151  98   7],43,5,27418,3.8250558035714284,0.0,20.0
27168,2,7168,[588 144 237  98 204],297,3,27421,3.8249407169758682,0.0,20.0
27169,2,7169,[ 64  12 269 301 357],416,5,27426,3.8251046025104602,40.0,0.0
27170,2,7170,[195 742  69  12 405],416,5,27431,3.8252684423371917,20.0,0.0
27171,2,7171,[175 222 174 546 100],805,3,27434,3.8251533742331287,0.0,0.0
27172,2,7172,[111  71 117 173   1],345,3,27437,3.8250383382127424,0.0,0.0
27173,2,7173,[ 64  12 269 301 357],416,5,27442,3.825202118762197,40.0,0.0
27174,2,7174,[ 64  12 269 301 357],416,5,27447,3.8253658536585364,40.0,0.0
27175,2,7175,[ 64  12 269 301 357],416,5,27452,3.8255295429208473,40.0,0.0
27176,2,7176,[568 423 174  88 187],505,4,27456,3.8255538525846453,0.0,0.0
27177,2,7177,[185 268 328 273 258],854,3,27459,3.825438840902758,0.0,0.0
27178,2,7178,[655 268 294  56 238],417,5,27464,3.82560245159493,0.0,0.0
27179,2,7179,[ 12 271 121   9 318],854,4,27468,3.825626740947075,40.0,0.0
27180,2,7180,[143 597   7  70  12],416,4,27472,3.8256510235343266,20.0,0.0
27181,2,7181,[235 357 268   4 234],417,3,27475,3.8255360623781676,0.0,0.0
27182,2,7182,[153 143  64 117 288],930,1,27476,3.8251426980370318,20.0,20.0
27183,2,7183,[ 97 211  79  56 195],416,5,27481,3.8253062360801784,0.0,0.0
27184,2,7184,[ 64  12 269 301 357],416,5,27486,3.8254697286012527,40.0,0.0
27185,2,7185,[135 179  69 196 211],373,3,27489,3.825354856665739,0.0,0.0
27186,2,7186,[153 286 288 174 100],679,2,27491,3.825100876582719,0.0,20.0
27187,2,7187,[117 403 228 742 483],417,3,27494,3.8249860879243185,20.0,0.0
27188,2,7188,[268 288 269 174 216],654,3,27497,3.824871331200445,0.0,20.0
27189,2,7189,[271 323 161 228 210],805,1,27498,3.8244784422809457,0.0,0.0
27190,2,7190,[196 173 197 161 288],405,3,27501,3.824363788068419,0.0,20.0
27191,2,7191,[ 64  12 269 301 357],416,5,27506,3.8245272525027807,40.0,0.0
27192,2,7192,[ 64  12 269 301 357],416,5,27511,3.824690671486167,40.0,0.0
27193,2,7193,[210  69 385 125 235],642,4,27515,3.8247150403113706,0.0,0.0
27194,2,7194,[ 64  12 269 301 357],416,5,27520,3.8248783877692842,40.0,0.0
27195,2,7195,[313 405 286 118 202],907,5,27525,3.8250416898276822,20.0,20.0
27196,2,7196,[ 28  88  12 125 265],618,4,27529,3.8250659997221064,20.0,0.0
27197,2,7197,[ 64  12 269 301 357],416,5,27534,3.8252292303417614,40.0,0.0
27198,2,7198,[ 82 742 172 100 174],620,4,27538,3.825253507431588,0.0,0.0
27199,2,7199,[ 64  12 269 301 357],416,5,27543,3.8254166666666665,40.0,0.0
27200,2,7200,[ 64  12 269 301 357],416,5,27548,3.82557978058603,40.0,0.0
27201,2,7201,[ 64  12 269 301 357],416,5,27553,3.8257428492085532,40.0,0.0
27202,2,7202,[ 64  12 269 301 357],416,5,27558,3.8259058725531028,40.0,0.0
27203,2,7203,[ 64  12 269 301 357],416,5,27563,3.826068850638534,40.0,0.0
27204,2,7204,[286 181 268  50  28],297,5,27568,3.826231783483692,0.0,40.0
27205,2,7205,[328 323 235 286 273],416,3,27571,3.8261171246183734,0.0,0.0
27206,2,7206,[ 64  12 269 301 357],416,5,27576,3.8262800055501596,40.0,0.0
27207,2,7207,[ 64  12 269 301 357],416,5,27581,3.8264428412874585,40.0,0.0
27208,2,7208,[655 471 125 475   1],416,4,27585,3.8264669163545566,0.0,0.0
27209,2,7209,[144  56 423 215  22],62,2,27587,3.82621359223301,0.0,0.0
27210,2,7210,[748  22 173 655 132],373,4,27591,3.826237692414367,0.0,0.0
27211,2,7211,[ 64  12 269 301 357],416,5,27596,3.8264004437049364,40.0,0.0
27212,2,7212,[328 185 100 210 603],416,5,27601,3.8265631498682935,0.0,0.0
27213,2,7213,[215  15 282   1 118],128,3,27604,3.826448572220682,0.0,0.0
27214,2,7214,[748 168 204 742 258],642,4,27608,3.8264726264726265,0.0,0.0
27215,2,7215,[127 173  97 427 748],198,3,27611,3.8263580931263856,0.0,0.0
27216,2,7216,[185   1 127 117 168],805,3,27614,3.826243591520022,0.0,0.0
27217,2,7217,[215 153 318 216  69],721,5,27619,3.8264062067054585,20.0,0.0
27218,2,7218,[132 151  56 603 173],437,5,27624,3.826568776838897,0.0,0.0
27219,2,7219,[275  15  56 301  97],43,5,27629,3.8267313019390583,0.0,0.0
27220,2,7220,[191 748 286  11   1],297,2,27631,3.8264783271015097,0.0,0.0
27221,2,7221,[ 64  12 269 301 357],416,5,27636,3.8266408197175297,40.0,0.0
27222,2,7222,[258  71 200 204 216],345,4,27640,3.8266648207116156,0.0,0.0
27223,2,7223,[ 64  12 269 301 357],416,5,27645,3.826827242524917,40.0,0.0
27224,2,7224,[ 64  12 269 301 357],416,5,27650,3.8269896193771626,40.0,0.0
27225,2,7225,[176 144  98 125 153],62,4,27654,3.8270135621367283,0.0,20.0
27226,2,7226,[ 64  12 269 301 357],416,5,27659,3.8271758682717585,40.0,0.0
27227,2,7227,[ 64  12 269 301 357],416,5,27664,3.827338129496403,40.0,0.0
27228,2,7228,[265  95 742 125 196],416,4,27668,3.8273620141098355,0.0,0.0
27229,2,7229,[179 234 238 121 258],601,2,27670,3.827109266943292,0.0,0.0
27230,2,7230,[ 64  12 269 301 357],416,5,27675,3.827271470059466,40.0,0.0
27231,2,7231,[403  22  15 322 143],416,4,27679,3.8272953539823007,0.0,0.0
27232,2,7232,[475   4 151  95 286],417,4,27683,3.8273192313009816,0.0,0.0
27233,2,7233,[175  11  95 191 173],43,4,27687,3.827343102018247,0.0,0.0
27234,2,7234,[202 194 302  28 121],751,5,27692,3.827505183137526,0.0,0.0
27235,2,7235,[ 64  12 269 301 357],416,5,27697,3.8276672194582644,40.0,0.0
27236,2,7236,[ 56 187 357  71 195],416,5,27702,3.827829210999033,0.0,0.0
27237,2,7237,[269 196  97 173  70],654,4,27706,3.827852998065764,0.0,0.0
27238,2,7238,[215 423 258 294 174],62,2,27708,3.827600497306258,0.0,0.0
27239,2,7239,[175 173 191 111 301],43,4,27712,3.8276243093922653,0.0,0.0
27240,2,7240,[  1  15  71 588 174],262,2,27714,3.827371909957188,0.0,0.0
27241,2,7241,[ 25 125 322 588 168],417,2,27716,3.827119580226457,0.0,0.0
27242,2,7242,[238  79 172 118 151],128,3,27719,3.827005384509181,0.0,0.0
27243,2,7243,[318  98 301 423  69],437,3,27722,3.826891220320265,20.0,20.0
27244,2,7244,[180  28 323 181 748],805,1,27723,3.8265010351966873,0.0,20.0
27245,2,7245,[125  50 216  79   8],253,4,27727,3.8265249792989233,0.0,20.0
27246,2,7246,[ 64  12 269 301 357],416,5,27732,3.8266869049261762,40.0,0.0
27247,2,7247,[181 197 179 100 186],373,2,27734,3.8264348785871967,0.0,20.0
27248,2,7248,[ 64  12 269 301 357],416,5,27739,3.826596771968547,40.0,0.0
27249,2,7249,[ 64  12 269 301 357],416,5,27744,3.826758620689655,40.0,0.0
27250,2,7250,[222 273   7 322 100],417,0,27744,3.8262308647083163,0.0,0.0
27251,2,7251,[ 64  12 269 301 357],416,5,27749,3.826392719249862,40.0,0.0
27252,2,7252,[ 50 211 515 222 597],417,2,27751,3.8261409072108092,0.0,20.0
27253,2,7253,[183   7 228 597 153],62,3,27754,3.8260270195754065,0.0,0.0
27254,2,7254,[655 191 271 427 235],922,1,27755,3.8256374913852516,0.0,0.0
27255,2,7255,[168  89 196 191 282],297,3,27758,3.8255237045203967,0.0,0.0
27256,2,7256,[ 64  12 269 301 357],416,5,27763,3.825685544991043,40.0,0.0
27257,2,7257,[125 276 742 151 257],62,3,27766,3.825571782860292,0.0,0.0
27258,2,7258,[195 588 125 135 183],230,2,27768,3.825320292051247,0.0,0.0
27259,2,7259,[ 64  12 269 301 357],416,5,27773,3.825482093663912,40.0,0.0
27260,2,7260,[ 64  12 269 301 357],416,5,27778,3.8256438507092687,40.0,0.0
27261,2,7261,[286  56 215  25 202],345,2,27780,3.8253924538694575,0.0,0.0
27262,2,7262,[ 15 294 245  97 118],128,3,27783,3.825278810408922,0.0,0.0
27263,2,7263,[234  64 186 385  97],642,4,27787,3.8253028634361232,20.0,0.0
27264,2,7264,[ 56 302 508 127 144],854,3,27790,3.8251892635925673,0.0,0.0
27265,2,7265,[215 289 678 258 286],588,3,27793,3.8250756950178917,0.0,0.0
27266,2,7266,[ 88   8  50 127 173],43,5,27798,3.8252373744323656,0.0,20.0
27267,2,7267,[588 222  95 546 174],417,1,27799,3.8248486516235554,0.0,0.0
27268,2,7268,[194 235 313 100 288],416,4,27803,3.8248727472829827,20.0,40.0
27269,2,7269,[ 70 245   4 282 655],416,4,27807,3.8248968363136178,0.0,0.0
27270,2,7270,[132 174   9 181 125],62,5,27812,3.8250584513822035,0.0,20.0
27271,2,7271,[238 168 333 302 475],854,3,27815,3.82494499449945,0.0,0.0
27272,2,7272,[ 64  12 269 301 357],416,5,27820,3.8251065585040562,40.0,0.0
27273,2,7273,[322 546 357  96 748],805,2,27822,3.8248556502612043,0.0,0.0
27274,2,7274,[427 202  64  25 258],128,2,27824,3.8246048109965636,20.0,0.0
27275,2,7275,[ 64  12 269 301 357],416,5,27829,3.824766355140187,40.0,0.0
27276,2,7276,[176 238 357 294 655],417,5,27834,3.8249278548852548,0.0,0.0
27277,2,7277,[  1   7 100   8 496],43,5,27839,3.8250893102500685,0.0,0.0
27278,2,7278,[333   1  64  82  70],416,5,27844,3.825250721252919,20.0,0.0
27279,2,7279,[ 11 257   7 196 301],297,4,27848,3.8252747252747255,0.0,0.0
27280,2,7280,[483 174   9  15 144],62,3,27851,3.8251613789314654,20.0,0.0
27281,2,7281,[ 69  56   9  88 161],618,4,27855,3.8251853886294973,0.0,0.0
27282,2,7282,[118 496 286 302  97],416,4,27859,3.8252093917341754,0.0,0.0
27283,2,7283,[181 172 118 196 655],751,3,27862,3.825096101043383,0.0,20.0
27284,2,7284,[273 118   1 427 302],416,4,27866,3.8251201098146876,0.0,0.0
27285,2,7285,[258 182 174  50 161],505,1,27867,3.824732363436728,0.0,20.0
27286,2,7286,[235 200 403 271 216],805,2,27869,3.824481954164951,0.0,0.0
27287,2,7287,[151 135  11   8 100],214,4,27873,3.8245060373216244,0.0,0.0
27288,2,7288,[423 742  22 210 196],416,5,27878,3.8246673069008095,0.0,0.0
27289,2,7289,[ 56 257 508 265  98],654,4,27882,3.8246913580246913,0.0,20.0
27290,2,7290,[405 117 286 204 153],43,5,27887,3.824852557948155,0.0,0.0
27291,2,7291,[257  22 597 172 328],62,2,27889,3.8246023038946793,0.0,0.0
27292,2,7292,[ 22 111  96 144  64],416,5,27894,3.8247634718222954,20.0,0.0
27293,2,7293,[ 64  12 269 301 357],416,5,27899,3.824924595557993,40.0,0.0
27294,2,7294,[ 64  12 269 301 357],416,5,27904,3.8250856751199453,40.0,0.0
27295,2,7295,[174 210 125 546 568],417,1,27905,3.824698464912281,0.0,0.0
27296,2,7296,[100 216 127 237 288],618,3,27908,3.824585446073729,0.0,20.0
27297,2,7297,[216 153   4 211  64],373,5,27913,3.8247465058920254,20.0,0.0
27298,2,7298,[515 678 183  70 173],416,4,27917,3.824770516509111,0.0,0.0
27299,2,7299,[603 403 100 234 197],416,5,27922,3.8249315068493153,0.0,0.0
27300,2,7300,[173 210 143  25 196],416,5,27927,3.825092453088618,0.0,0.0
27301,2,7301,[245 323 200 597  70],417,3,27930,3.8249794576828267,0.0,0.0
27302,2,7302,[ 22 403 127  56 597],618,5,27935,3.8251403532794743,0.0,0.0
27303,2,7303,[ 97 237 153 294  50],62,2,27937,3.8248904709748084,0.0,20.0
27304,2,7304,[515 186 191 211  97],417,5,27942,3.8250513347022586,0.0,0.0
27305,2,7305,[597 143 222  22 271],805,1,27943,3.824664659184232,0.0,0.0
27306,2,7306,[ 64  12 269 301 357],416,5,27948,3.8248255097851374,40.0,0.0
27307,2,7307,[ 64  12 269 301 357],416,5,27953,3.8249863163656266,40.0,0.0
27308,2,7308,[ 98 191 597  96   7],417,2,27955,3.824736626077439,0.0,20.0
27309,2,7309,[ 79 144 182 265  98],618,5,27960,3.8248974008207934,0.0,20.0
27310,2,7310,[ 64  12 269 301 357],416,5,27965,3.825058131582547,40.0,0.0
27311,2,7311,[222 471 204 265  95],922,2,27967,3.824808533916849,0.0,0.0
27312,2,7312,[125 269 202   4  98],345,3,27970,3.82469574729933,0.0,20.0
27313,2,7313,[168 132 215  64 118],198,4,27974,3.8247197156138912,20.0,0.0
27314,2,7314,[ 64  12 269 301 357],416,5,27979,3.8248803827751194,40.0,0.0
27315,2,7315,[269 302 127 323  56],721,2,27981,3.824630945872061,0.0,0.0
27316,2,7316,[ 64  12 269 301 357],416,5,27986,3.824791581249146,40.0,0.0
27317,2,7317,[ 64  12 269 301 357],416,5,27991,3.8249521727247884,40.0,0.0
27318,2,7318,[173   9 235 143  25],43,4,27995,3.8249760896297307,0.0,0.0
27319,2,7319,[181 202 215 200 117],618,4,27999,3.825,0.0,20.0
27320,2,7320,[ 64  12 269 301 357],416,5,28004,3.8251604971998363,40.0,0.0
27321,2,7321,[ 82 211 143  11 204],437,3,28007,3.8250478011472278,0.0,0.0
27322,2,7322,[210 100 258 135 143],198,3,28010,3.824935135873276,0.0,0.0
27323,2,7323,[216   4 196 100 294],297,3,28013,3.8248225013653743,0.0,0.0
27324,2,7324,[216  82 144 301 111],416,5,28018,3.824982935153584,0.0,0.0
27325,2,7325,[ 28 678 286  22 174],721,4,28022,3.825006825006825,0.0,0.0
27326,2,7326,[  1 121 294 742 186],417,3,28025,3.824894226832264,0.0,0.0
27327,2,7327,[ 64  12 269 301 357],416,5,28030,3.8250545851528384,40.0,0.0
27328,2,7328,[318 151 200 588 748],416,4,28034,3.8250784554509485,20.0,0.0
27329,2,7329,[ 64  12 269 301 357],416,5,28039,3.825238744884038,40.0,0.0
27330,2,7330,[ 64  12 269 301 357],416,5,28044,3.825398990587914,40.0,0.0
27331,2,7331,[ 12 173 748 597 265],417,3,28047,3.8252864157119477,20.0,0.0
27332,2,7332,[ 96 100 210 135 238],601,3,28050,3.8251738715396155,0.0,0.0
27333,2,7333,[ 64  12 269 301 357],416,5,28055,3.825334060539951,40.0,0.0
27334,2,7334,[125 588 483  96  97],618,3,28058,3.825221540558964,20.0,0.0
27335,2,7335,[655 197 118  82   4],618,2,28060,3.8249727371864775,0.0,0.0
27336,2,7336,[151 143   1 187 228],887,5,28065,3.825132888101404,0.0,0.0
27337,2,7337,[ 64  12 269 301 357],416,5,28070,3.825292995366585,40.0,0.0
27338,2,7338,[245 196 603 151 300],128,3,28073,3.8251805423082166,0.0,0.0
27339,2,7339,[ 15  25  79 197 216],618,1,28074,3.8247956403269754,0.0,0.0
27340,2,7340,[195   8 483  96 288],854,3,28077,3.824683285655905,20.0,20.0
27341,2,7341,[289 210  79  50 322],416,3,28080,3.824570961590847,0.0,20.0
27342,2,7342,[273 185 125 496 111],416,5,28085,3.82473103636116,0.0,0.0
27343,2,7343,[ 64  12 269 301 357],416,5,28090,3.8248910675381262,40.0,0.0
27344,2,7344,[234 216  22 202   8],253,5,28095,3.825051055139551,0.0,0.0
27345,2,7345,[258 200 222 181   4],297,3,28098,3.824938742172611,0.0,20.0
27346,2,7346,[135 121  64 483 597],854,3,28101,3.824826459779502,40.0,0.0
27347,2,7347,[238 210  96 121  50],751,4,28105,3.8248502994011977,0.0,20.0
27348,2,7348,[235 245 180 508 200],417,3,28108,3.8247380595999454,0.0,0.0
27349,2,7349,[ 64  12 269 301 357],416,5,28113,3.8248979591836734,40.0,0.0
27350,2,7350,[ 50   4 222 294 135],854,3,28116,3.824785743436267,0.0,20.0
27351,2,7351,[117 182 237  98 200],437,3,28119,3.8246735582154514,0.0,20.0
27352,2,7352,[568 200 118 176 546],417,3,28122,3.824561403508772,0.0,0.0
27353,2,7353,[191 121 153 195 180],417,4,28126,3.8245852597225998,0.0,0.0
27354,2,7354,[143   4  25  71 216],416,5,28131,3.8247450713800135,0.0,0.0
27355,2,7355,[423 265 215 191  28],128,4,28135,3.824768896139206,0.0,0.0
27356,2,7356,[ 64  12 269 301 357],416,5,28140,3.824928639391056,40.0,0.0
27357,2,7357,[ 64  12 269 301 357],416,5,28145,3.825088339222615,40.0,0.0
27358,2,7358,[ 64  12 269 301 357],416,5,28150,3.825247995651583,40.0,0.0
27359,2,7359,[ 50 117 257 100 216],417,1,28151,3.824864130434783,0.0,20.0
27360,2,7360,[ 64  12 269 301 357],416,5,28156,3.825023773943758,40.0,0.0
27361,2,7361,[ 64  12 269 301 357],416,5,28161,3.82518337408313,40.0,0.0
27362,2,7362,[135 118 100 483 186],417,3,28164,3.825071302458237,20.0,0.0
27363,2,7363,[ 64  12 269 301 357],416,5,28169,3.8252308527973926,40.0,0.0
27364,2,7364,[195 245 294  97   7],417,4,28173,3.825254582484725,0.0,0.0
27365,2,7365,[302 173 678 216 100],345,4,28177,3.825278305729025,0.0,0.0
27366,2,7366,[471 405 168 323  12],43,3,28180,3.8251662820686847,20.0,0.0
27367,2,7367,[143 191 204 423 286],416,5,28185,3.8253257328990227,0.0,0.0
27368,2,7368,[ 64  12 269 301 357],416,5,28190,3.82548514045325,40.0,0.0
27369,2,7369,[ 70 288 132 181 200],262,1,28191,3.825101763907734,0.0,40.0
27370,2,7370,[275 313 403 258 215],43,5,28196,3.825261158594492,20.0,20.0
27371,2,7371,[ 64  12 269 301 357],416,5,28201,3.8254205100379814,40.0,0.0
27372,2,7372,[ 64  12 269 301 357],416,5,28206,3.825579818255798,40.0,0.0
27373,2,7373,[ 11 121 174 173 328],416,5,28211,3.8257390832655274,0.0,0.0
27374,2,7374,[ 28 181   8 125  97],642,5,28216,3.825898305084746,0.0,20.0
27375,2,7375,[ 64  12 269 301 357],416,5,28221,3.8260574837310197,40.0,0.0
27376,2,7376,[603  69 471 568 483],128,5,28226,3.826216619221906,20.0,0.0
27377,2,7377,[ 64  12 269 301 357],416,5,28231,3.8263757115749524,40.0,0.0
27378,2,7378,[168  64 173 748 385],416,5,28236,3.8265347608076974,20.0,0.0
27379,2,7379,[ 71 180 286 471  25],373,2,28238,3.8262872628726288,0.0,0.0
27380,2,7380,[183   7 568 117 603],805,3,28241,3.826175314997968,0.0,0.0
27381,2,7381,[238  70 174 180 483],128,3,28244,3.8260633974532645,20.0,0.0
27382,2,7382,[ 64  12 269 301 357],416,5,28249,3.826222402817283,40.0,0.0
27383,2,7383,[ 64  12 269 301 357],416,5,28254,3.8263813651137593,40.0,0.0
27384,2,7384,[ 64  12 269 301 357],416,5,28259,3.8265402843601897,40.0,0.0
27385,2,7385,[655 125 258  82 268],417,5,28264,3.826699160574059,0.0,0.0
27386,2,7386,[588  96 235   7 153],805,3,28267,3.826587247867876,0.0,0.0
27387,2,7387,[ 64  12 269 301 357],416,5,28272,3.8267460747157553,40.0,0.0
27388,2,7388,[234 328 748 191 742],416,5,28277,3.8269048585735552,0.0,0.0
27389,2,7389,[357 191  82 405 258],417,4,28281,3.8269282814614343,0.0,0.0
27390,2,7390,[ 64  12 269 301 357],416,5,28286,3.8270869976999053,40.0,0.0
27391,2,7391,[273  71 161 257 286],416,4,28290,3.8271103896103895,0.0,0.0
27392,2,7392,[ 64  12 269 301 357],416,5,28295,3.8272690382794536,40.0,0.0
27393,2,7393,[ 64  12 269 301 357],416,5,28300,3.8274276440357045,40.0,0.0
27394,2,7394,[294 132 300 282 202],253,5,28305,3.8275862068965516,0.0,0.0
27395,2,7395,[427 269   1 172 403],416,5,28310,3.8277447268793945,0.0,0.0
27396,2,7396,[588 121   9  71 168],416,5,28315,3.8279032040016223,0.0,0.0
27397,2,7397,[ 64  12 269 301 357],416,5,28320,3.8280616382806163,40.0,0.0
27398,2,7398,[ 64  12 269 301 357],416,5,28325,3.828220029733748,40.0,0.0
27399,2,7399,[ 64  12 269 301 357],416,5,28330,3.8283783783783782,40.0,0.0
27400,2,7400,[  9 265  95  15 132],416,4,28334,3.8284015673557628,0.0,0.0
27401,2,7401,[ 64  12 269 301 357],416,5,28339,3.8285598486895434,40.0,0.0
27402,2,7402,[111 118 323 127 271],43,3,28342,3.828447926516277,0.0,0.0
27403,2,7403,[ 98 588 471 100 405],345,3,28345,3.828336034575905,0.0,20.0
27404,2,7404,[405 194  64  79   1],854,3,28348,3.8282241728561783,20.0,0.0
27405,2,7405,[121  69 161 258 125],416,5,28353,3.8283823926546043,0.0,0.0
27406,2,7406,[588 180 153 318 182],437,3,28356,3.8282705548805183,20.0,0.0
27407,2,7407,[ 64  12 269 301 357],416,5,28361,3.828428725701944,40.0,0.0
27408,2,7408,[194 191  69 655 175],721,3,28364,3.8283169118639493,0.0,0.0
27409,2,7409,[ 64  12 269 301 357],416,5,28369,3.8284750337381914,40.0,0.0
27410,2,7410,[191 186 172 173 568],128,4,28373,3.828498178383484,0.0,0.0
27411,2,7411,[ 64  12 269 301 357],416,5,28378,3.828656233135456,40.0,0.0
27412,2,7412,[  1 204 194  11 210],297,2,28380,3.828409550789154,0.0,0.0
27413,2,7413,[282   1 655 508 268],128,2,28382,3.8281629349878608,0.0,0.0
27414,2,7414,[ 64  12 269 301 357],416,5,28387,3.8283209710047204,40.0,0.0
27415,2,7415,[174 268 118 183   1],416,4,28391,3.8283441208198488,0.0,0.0
27416,2,7416,[ 64  12 269 301 357],416,5,28396,3.828502089793717,40.0,0.0
27417,2,7417,[181 125 202 194 268],416,5,28401,3.828660016176867,0.0,20.0
27418,2,7418,[ 64  12 269 301 357],416,5,28406,3.8288178999865212,40.0,0.0
27419,2,7419,[288 483 173 132  12],618,3,28409,3.8287061994609166,40.0,20.0
27420,2,7420,[182 179 385  11 172],49,1,28410,3.8283250235817277,0.0,0.0
27421,2,7421,[ 64  12 269 301 357],416,5,28415,3.828482888709243,40.0,0.0
27422,2,7422,[742 151 211 385  98],416,4,28419,3.828505994880776,0.0,20.0
27423,2,7423,[300   7 742 127 125],505,2,28421,3.828259698275862,0.0,0.0
27424,2,7424,[ 64  12 269 301 357],416,5,28426,3.8284175084175085,40.0,0.0
27425,2,7425,[322 172  71 215 678],416,3,28429,3.8283059520603286,0.0,0.0
27426,2,7426,[ 88 508 268 603 185],354,2,28431,3.8280597818769353,0.0,0.0
27427,2,7427,[237 153   9 294 238],43,4,28435,3.828082929456112,0.0,0.0
27428,2,7428,[195 132 143 483  70],618,3,28438,3.827971463184816,20.0,0.0
27429,2,7429,[ 64  12 269 301 357],416,5,28443,3.8281292059219383,40.0,0.0
27430,2,7430,[742 174 423 222 288],734,4,28447,3.828152334813619,0.0,20.0
27431,2,7431,[275 515  28  88  11],416,4,28451,3.8281754574811626,0.0,0.0
27432,2,7432,[ 64  12 269 301 357],416,5,28456,3.8283331091080317,40.0,0.0
27433,2,7433,[202 135  88 423 144],711,3,28459,3.8282216841538874,0.0,0.0
27434,2,7434,[153 265 161 496 174],373,5,28464,3.828379287155346,0.0,0.0
27435,2,7435,[ 97  70   8 210 173],618,1,28465,3.8279989241527703,0.0,0.0
27436,2,7436,[515 588 234 269 742],416,5,28470,3.8281565147236787,0.0,0.0
27437,2,7437,[ 64  12 269 301 357],416,5,28475,3.82831406292014,40.0,0.0
27438,2,7438,[ 64  12 269 301 357],416,5,28480,3.828471568759242,40.0,0.0
27439,2,7439,[117 235 196 294 269],416,4,28484,3.828494623655914,0.0,0.0
27440,2,7440,[ 64  12 269 301 357],416,5,28489,3.828652062894772,40.0,0.0
27441,2,7441,[ 69 210 235 357 423],417,2,28491,3.8284063423810806,0.0,0.0
27442,2,7442,[ 64  12 269 301 357],416,5,28496,3.828563751175601,40.0,0.0
27443,2,7443,[ 64  12 269 301 357],416,5,28501,3.8287211176786675,40.0,0.0
27444,2,7444,[181   4 175 168 196],43,4,28505,3.828744123572868,0.0,20.0
27445,2,7445,[135 181 151 143   7],354,3,28508,3.8286328229922106,0.0,20.0
27446,2,7446,[ 64  12 269 301 357],416,5,28513,3.828790116825567,40.0,0.0
27447,2,7447,[ 64  12 269 301 357],416,5,28518,3.8289473684210527,40.0,0.0
27448,2,7448,[ 12  69 328  50 427],416,5,28523,3.829104577795677,20.0,20.0
27449,2,7449,[ 64  12 269 301 357],416,5,28528,3.829261744966443,40.0,0.0
27450,2,7450,[322 182  64 471 328],128,3,28531,3.82915044960408,20.0,0.0
27451,2,7451,[ 88 168 117 185 655],618,5,28536,3.8293075684380034,0.0,0.0
27452,2,7452,[245 273 118 405 322],417,2,28538,3.8290621226351806,0.0,0.0
27453,2,7453,[ 64  12 269 301 357],416,5,28543,3.829219211161792,40.0,0.0
27454,2,7454,[161 153 318 423 180],437,4,28547,3.8292421193829647,20.0,0.0
27455,2,7455,[546 173 117 238 748],417,4,28551,3.8292650214592276,0.0,0.0
27456,2,7456,[ 71 318 204  82 423],373,3,28554,3.829153815207188,20.0,0.0
27457,2,7457,[  7 151 496  79 196],43,5,28559,3.8293108071869133,0.0,0.0
27458,2,7458,[ 64  12 269 301 357],416,5,28564,3.8294677570719937,40.0,0.0
27459,2,7459,[ 64  12 269 301 357],416,5,28569,3.8296246648793564,40.0,0.0
27460,2,7460,[588 143 211 174  71],43,5,28574,3.8297815306259215,0.0,0.0
27461,2,7461,[ 25 204 546 127 405],805,1,28575,3.829402305012061,0.0,0.0
27462,2,7462,[237 118 172 275 588],128,4,28579,3.829425164143106,0.0,0.0
27463,2,7463,[ 64  12 269 301 357],416,5,28584,3.829581993569132,40.0,0.0
27464,2,7464,[ 64  12 269 301 357],416,5,28589,3.829738780977897,40.0,0.0
27465,2,7465,[ 69  64 405 182 357],198,4,28593,3.82976158585588,20.0,0.0
27466,2,7466,[258 268 300 568 216],345,4,28597,3.8297843846256865,0.0,0.0
27467,2,7467,[275 216  50 185  64],262,2,28599,3.829539367970005,20.0,20.0
27468,2,7468,[196 185 151 288 135],214,3,28602,3.829428303655108,0.0,20.0
27469,2,7469,[748 125 179 357   4],417,4,28606,3.829451137884873,0.0,0.0
27470,2,7470,[385 210 132 322 265],417,2,28608,3.829206264221657,0.0,0.0
27471,2,7471,[195 181 597 196  22],805,0,28608,3.828693790149893,0.0,20.0
27472,2,7472,[ 64  12 269 301 357],416,5,28613,3.828850528569517,40.0,0.0
27473,2,7473,[ 64  12 269 301 357],416,5,28618,3.829007225046829,40.0,0.0
27474,2,7474,[ 64  12 269 301 357],416,5,28623,3.8291638795986622,40.0,0.0
27475,2,7475,[245  71  15 294  56],128,3,28626,3.8290529695024076,0.0,0.0
27476,2,7476,[ 70  89 204 172  15],373,5,28631,3.8292095760331684,0.0,0.0
27477,2,7477,[ 64  12 269 301 357],416,5,28636,3.8293661406793262,40.0,0.0
27478,2,7478,[ 64  12 269 301 357],416,5,28641,3.8295226634576816,40.0,0.0
27479,2,7479,[288 174 318 276 222],601,4,28645,3.8295454545454546,20.0,20.0
27480,2,7480,[ 64  12 269 301 357],416,5,28650,3.8297019115091566,40.0,0.0
27481,2,7481,[144  89 186   9 153],854,3,28653,3.8295910184442663,0.0,0.0
27482,2,7482,[ 64  12 269 301 357],416,5,28658,3.8297474275023387,40.0,0.0
27483,2,7483,[ 64  12 269 301 357],416,5,28663,3.8299037947621595,40.0,0.0
27484,2,7484,[238 237 132 269 215],345,5,28668,3.830060120240481,0.0,0.0
27485,2,7485,[275 258 483 202 173],907,5,28673,3.8302164039540476,20.0,0.0
27486,2,7486,[ 70 318 222 151 181],198,3,28676,3.830105516228129,20.0,20.0
27487,2,7487,[300 100 289  70 258],345,3,28679,3.829994658119658,0.0,0.0
27488,2,7488,[211  79 508  69 176],417,2,28681,3.8297503004406463,0.0,0.0
27489,2,7489,[ 64  12 269 301 357],416,5,28686,3.829906542056075,40.0,0.0
27490,2,7490,[ 64  12 269 301 357],416,5,28691,3.8300627419570152,40.0,0.0
27491,2,7491,[ 64  12 269 301 357],416,5,28696,3.8302189001601707,40.0,0.0
27492,2,7492,[ 64  12 269 301 357],416,5,28701,3.8303750166822366,40.0,0.0
27493,2,7493,[ 64  12 269 301 357],416,5,28706,3.8305310915398985,40.0,0.0
27494,2,7494,[ 25  22 282 185 515],297,4,28710,3.830553702468312,0.0,0.0
27495,2,7495,[182 742  11  50 117],505,3,28713,3.8304429028815368,0.0,20.0
27496,2,7496,[568 546  98 200 475],805,3,28716,3.8303321328531412,0.0,20.0
27497,2,7497,[ 64  12 269 301 357],416,5,28721,3.8304881301680447,40.0,0.0
27498,2,7498,[196 183  69 234 302],417,3,28724,3.8303773836511534,0.0,0.0
27499,2,7499,[ 64  12 269 301 357],416,5,28729,3.8305333333333333,40.0,0.0
27500,2,7500,[179   4 276 111 121],416,3,28732,3.830422610318624,0.0,0.0
27501,2,7501,[237  56 301  97 181],43,5,28737,3.830578512396694,0.0,20.0
27502,2,7502,[471 174  69 196 195],705,3,28740,3.83046781287485,0.0,0.0
27503,2,7503,[ 64  12 269 301 357],416,5,28745,3.830623667377399,40.0,0.0
27504,2,7504,[143  88 172 176  64],618,5,28750,3.8307794803464357,20.0,0.0
27505,2,7505,[ 64  12 269 301 357],416,5,28755,3.8309352517985613,40.0,0.0
27506,2,7506,[ 64  12 269 301 357],416,5,28760,3.8310909817503664,40.0,0.0
27507,2,7507,[ 64  12 269 301 357],416,5,28765,3.831246670218434,40.0,0.0
27508,2,7508,[183 300 405 132 117],198,2,28767,3.831002796644027,0.0,0.0
27509,2,7509,[ 64  12 269 301 357],416,5,28772,3.8311584553928095,40.0,0.0
27510,2,7510,[515 204   1  56  69],416,5,28777,3.831314072693383,0.0,0.0
27511,2,7511,[ 64  12 269 301 357],416,5,28782,3.8314696485623,40.0,0.0
27512,2,7512,[ 64  12 269 301 357],416,5,28787,3.831625183016105,40.0,0.0
27513,2,7513,[238  89   4 385 144],805,2,28789,3.831381421346819,0.0,0.0
27514,2,7514,[ 64  12 269 301 357],416,5,28794,3.8315369261477046,40.0,0.0
27515,2,7515,[ 64  12 269 301 357],416,5,28799,3.8316923895689197,40.0,0.0
27516,2,7516,[ 64  12 269 301 357],416,5,28804,3.8318478116269787,40.0,0.0
27517,2,7517,[185 125 286 135 655],417,3,28807,3.831737164139399,0.0,0.0
27518,2,7518,[144 471 318 168 173],618,3,28810,3.831626546083256,20.0,0.0
27519,2,7519,[294  71  98 546 568],262,2,28812,3.831382978723404,0.0,20.0
27520,2,7520,[ 64  12 269 301 357],416,5,28817,3.831538359260737,40.0,0.0
27521,2,7521,[ 64  12 269 301 357],416,5,28822,3.8316936984844454,40.0,0.0
27522,2,7522,[185  79 174 302   7],854,3,28825,3.831583145021933,0.0,0.0
27523,2,7523,[ 64  12 269 301 357],416,5,28830,3.831738437001595,40.0,0.0
27524,2,7524,[294 125 597 234 318],588,4,28834,3.8317607973421928,20.0,0.0
27525,2,7525,[143 302 200 603 333],416,5,28839,3.8319160244485784,0.0,0.0
27526,2,7526,[ 64  12 269 301 357],416,5,28844,3.8320712103095524,40.0,0.0
27527,2,7527,[603 111  69 276 183],437,2,28846,3.83182784272051,0.0,0.0
27528,2,7528,[ 64  12 269 301 357],416,5,28851,3.8319829990702616,40.0,0.0
27529,2,7529,[269 181 294 182 302],416,5,28856,3.8321381142098274,0.0,20.0
27530,2,7530,[197 222 237 117  89],854,3,28859,3.8320276191740805,0.0,0.0
27531,2,7531,[ 82 143  64 235 172],642,4,28863,3.832049920339883,20.0,0.0
27532,2,7532,[ 64  12 269 301 357],416,5,28868,3.8322049648214525,40.0,0.0
27533,2,7533,[238  98 258 546 289],43,4,28872,3.832227236527741,0.0,20.0
27534,2,7534,[546 185 100 235  22],297,3,28875,3.832116788321168,0.0,0.0
27535,2,7535,[ 64  12 269 301 357],416,5,28880,3.8322717622080678,40.0,0.0
27536,2,7536,[238  69 196 403 216],198,4,28884,3.8322940161868115,0.0,0.0
27537,2,7537,[300 179  25 273 117],416,4,28888,3.832316264261077,0.0,0.0
27538,2,7538,[265 234 100 405 222],417,1,28889,3.8319405756731664,0.0,0.0
27539,2,7539,[ 64  12 269 301 357],416,5,28894,3.8320954907161804,40.0,0.0
27540,2,7540,[268 603 176  97 194],416,5,28899,3.8322503646731203,0.0,0.0
27541,2,7541,[ 64  12 269 301 357],416,5,28904,3.832405197560329,40.0,0.0
27542,2,7542,[300 118 568 286 174],705,4,28908,3.8324274161474214,0.0,0.0
27543,2,7543,[173 202 403 210 228],805,2,28910,3.832184517497349,0.0,0.0
27544,2,7544,[302 742  70 222 275],43,5,28915,3.832339297548045,0.0,0.0
27545,2,7545,[ 96  12 197 294  88],805,3,28918,3.8322289954943014,20.0,0.0
27546,2,7546,[ 15 191  11 100 357],416,5,28923,3.832383728633894,0.0,0.0
27547,2,7547,[ 70 294   9 179 289],416,3,28926,3.8322734499205087,0.0,0.0
27548,2,7548,[ 25 588 117 100 282],297,4,28930,3.832295668300437,0.0,0.0
27549,2,7549,[153 186  50 121 181],642,4,28934,3.832317880794702,0.0,40.0
27550,2,7550,[ 88  70  12 286 288],437,1,28935,3.831942789034565,20.0,20.0
27551,2,7551,[ 96  88 144 238 318],416,4,28939,3.8319650423728815,20.0,0.0
27552,2,7552,[ 64  12 269 301 357],416,5,28944,3.832119687541374,40.0,0.0
27553,2,7553,[588 288 153 168 276],922,2,28946,3.8318771511781837,0.0,20.0
27554,2,7554,[185 238  56  28   9],618,3,28949,3.8317670416942424,0.0,0.0
27555,2,7555,[  8 143  88 196 176],416,4,28953,3.8317893065113817,0.0,0.0
27556,2,7556,[176 385 111 181 125],416,5,28958,3.831943893079264,0.0,20.0
27557,2,7557,[302 117 215  95 118],43,5,28963,3.8320984387404073,0.0,0.0
27558,2,7558,[ 28 175 471  56 127],721,4,28967,3.832120650879746,0.0,0.0
27559,2,7559,[ 64  12 269 301 357],416,5,28972,3.8322751322751323,40.0,0.0
27560,2,7560,[  7 603  11 234 302],297,4,28976,3.832297315169951,0.0,0.0
27561,2,7561,[194 176 423 118 286],416,4,28980,3.8323194921978314,0.0,0.0
27562,2,7562,[258 286  12 238 475],416,4,28984,3.8323416633611003,20.0,0.0
27563,2,7563,[176 127   4 228  96],417,2,28986,3.8320994182971972,0.0,0.0
27564,2,7564,[ 70 118 405 245 385],416,3,28989,3.8319894249834765,0.0,0.0
27565,2,7565,[161 471 483 202  82],588,4,28993,3.8320116309807033,20.0,0.0
27566,2,7566,[ 64  12 269 301 357],416,5,28998,3.832165983877362,40.0,0.0
27567,2,7567,[302 194 125 268 286],416,5,29003,3.8323202959830867,0.0,0.0
27568,2,7568,[257 265 186 183 216],417,2,29005,3.83207821376668,0.0,0.0
27569,2,7569,[200 357  96 181 185],416,5,29010,3.83223249669749,0.0,20.0
27570,2,7570,[ 64  12 269 301 357],416,5,29015,3.8323867388720116,40.0,0.0
27571,2,7571,[168  56  95 132 204],405,3,29018,3.8322768092974115,0.0,0.0
27572,2,7572,[ 64  12 269 301 357],416,5,29023,3.8324310048857786,40.0,0.0
27573,2,7573,[ 64  12 269 301 357],416,5,29028,3.8325851597570635,40.0,0.0
27574,2,7574,[ 28  95 597 588 294],43,4,29032,3.8326072607260726,0.0,0.0
27575,2,7575,[216   4 265 204 235],416,4,29036,3.8326293558606124,0.0,0.0
27576,2,7576,[289 151  22   8 508],854,3,29039,3.8325194668074434,0.0,0.0
27577,2,7577,[ 64  12 269 301 357],416,5,29044,3.832673528635524,40.0,0.0
27578,2,7578,[742 546 271 603 151],805,2,29046,3.832431719224172,0.0,0.0
27579,2,7579,[286  12 475 151 153],417,5,29051,3.832585751978892,20.0,0.0
27580,2,7580,[ 69 194 237  95 181],297,2,29053,3.832344017939586,0.0,20.0
27581,2,7581,[ 64  12 269 301 357],416,5,29058,3.832498021630177,40.0,0.0
27582,2,7582,[196 182 210 427 357],198,4,29062,3.8325201107741,0.0,0.0
27583,2,7583,[294  95   4 258  11],805,0,29062,3.8320147679324896,0.0,0.0
27584,2,7584,[508 125   1 678 597],324,4,29066,3.8320369149637443,0.0,0.0
27585,2,7585,[ 64  12 269 301 357],416,5,29071,3.8321908779330345,40.0,0.0
27586,2,7586,[237 678 228 151 111],921,2,29073,3.8319493871095296,0.0,0.0
27587,2,7587,[ 64  12 269 301 357],416,5,29078,3.8321033210332103,40.0,0.0
27588,2,7588,[118  98  88 186 275],437,2,29080,3.8318619053893794,0.0,20.0
27589,2,7589,[423 597  11 153 301],43,4,29084,3.8318840579710143,0.0,0.0
27590,2,7590,[125   4 173 427  56],253,3,29087,3.8317744697668292,0.0,0.0
27591,2,7591,[385 234 282   8 301],588,4,29091,3.8317966280295046,0.0,0.0
27592,2,7592,[ 95 216 200 176 496],437,4,29095,3.831818780455683,0.0,0.0
27593,2,7593,[ 64  12 269 301 357],416,5,29100,3.8319726099552276,40.0,0.0
27594,2,7594,[588  82  28  22  71],654,4,29104,3.831994733377222,0.0,0.0
27595,2,7595,[176 268  98 144  12],416,5,29109,3.8321484992101107,20.0,20.0
27596,2,7596,[ 97 161 132 294 202],416,5,29114,3.8323022245623273,0.0,0.0
27597,2,7597,[ 50 222 174 175  97],721,5,29119,3.8324559094498554,0.0,20.0
27598,2,7598,[ 96   8 161 118 174],618,2,29121,3.8322147651006713,0.0,0.0
27599,2,7599,[318 423 328 403 276],62,3,29124,3.832105263157895,20.0,0.0
27600,2,7600,[ 64  12 269 301 357],416,5,29129,3.8322589133008815,40.0,0.0
27601,2,7601,[ 89  25 143 111  95],764,4,29133,3.8322809786898184,0.0,0.0
27602,2,7602,[ 64  12 269 301 357],416,5,29138,3.8324345653031697,40.0,0.0
27603,2,7603,[423  50 174 161 204],588,3,29141,3.8323250920568124,0.0,20.0
27604,2,7604,[132 183 568  11  88],416,4,29145,3.8323471400394475,0.0,0.0
27605,2,7605,[655 180  15  28 275],373,3,29148,3.832237707073363,0.0,0.0
27606,2,7606,[471 200 173  98   9],416,5,29153,3.832391218614434,0.0,20.0
27607,2,7607,[ 64  12 269 301 357],416,5,29158,3.8325446898002102,40.0,0.0
27608,2,7608,[174 515 181 144 678],416,4,29162,3.8325666973321066,0.0,20.0
27609,2,7609,[238 186 168 135 196],354,3,29165,3.8324572930354797,0.0,0.0
27610,2,7610,[195 318 144 273 328],62,3,29168,3.8323479174878465,20.0,0.0
27611,2,7611,[655 173 151 237 127],618,3,29171,3.832238570677877,0.0,0.0
27612,2,7612,[ 64  12 269 301 357],416,5,29176,3.8323919611191384,40.0,0.0
27613,2,7613,[ 71 294   7  95 258],262,3,29179,3.832282637247176,0.0,0.0
27614,2,7614,[180 265 153 168  50],417,3,29182,3.832173342087984,0.0,20.0
27615,2,7615,[ 64  12 269 301 357],416,5,29187,3.832326680672269,40.0,0.0
27616,2,7616,[172 200 258 196 132],345,5,29192,3.8324799789943547,0.0,0.0
27617,2,7617,[ 97 211 175 235 257],297,3,29195,3.8323707009713837,0.0,0.0
27618,2,7618,[269 655 175 202 435],354,3,29198,3.8322614516340727,0.0,0.0
27619,2,7619,[111 405 302 568 222],654,5,29203,3.83241469816273,0.0,0.0
27620,2,7620,[ 82 144 265 121 234],416,5,29208,3.8325679044744785,0.0,0.0
27621,2,7621,[  8 174 168 100 143],654,4,29212,3.832589871424823,0.0,0.0
27622,2,7622,[423 546 135 286 237],297,3,29215,3.8324806506624687,0.0,0.0
27623,2,7623,[ 64  12 269 301 357],416,5,29220,3.8326337880377754,40.0,0.0
27624,2,7624,[125  96 300 100  50],416,5,29225,3.8327868852459015,0.0,20.0
27625,2,7625,[228 245 655 742  15],417,3,29228,3.8326776816155257,0.0,0.0
27626,2,7626,[ 15 286  11   8 328],854,2,29230,3.832437393470565,0.0,0.0
27627,2,7627,[210 161 313  95 328],505,4,29234,3.832459360251704,20.0,20.0
27628,2,7628,[180 234 204 475  82],437,3,29237,3.83235024249574,0.0,0.0
27629,2,7629,[403 118   7 405 300],43,5,29242,3.8325032765399736,0.0,0.0
27630,2,7630,[ 64  12 269 301 357],416,5,29247,3.8326562704756912,40.0,0.0
27631,2,7631,[ 95 181  79  89 135],198,3,29250,3.832547169811321,0.0,20.0
27632,2,7632,[  1   9 588 235  28],416,4,29254,3.8325691078213024,0.0,0.0
27633,2,7633,[ 64  12 269 301 357],416,5,29259,3.8327220330102176,40.0,0.0
27634,2,7634,[ 95 121 288 282 237],618,2,29261,3.8324819908316963,0.0,20.0
27635,2,7635,[ 64  12 269 301 357],416,5,29266,3.832634887375589,40.0,0.0
27636,2,7636,[ 64  12 269 301 357],416,5,29271,3.8327877438784865,40.0,0.0
27637,2,7637,[ 64  12 269 301 357],416,5,29276,3.832940560356114,40.0,0.0
27638,2,7638,[ 64  12 269 301 357],416,5,29281,3.8330933368241915,40.0,0.0
27639,2,7639,[ 97  98 222 186 143],43,4,29285,3.8331151832460733,0.0,20.0
27640,2,7640,[161 288 127  95  69],618,3,29288,3.8330061510273525,0.0,20.0
27641,2,7641,[181 153 258 200 588],297,4,29292,3.833028003140539,0.0,20.0
27642,2,7642,[ 64  12 269 301 357],416,5,29297,3.8331806882114354,40.0,0.0
27643,2,7643,[ 96 597 496   1  28],642,5,29302,3.8333333333333335,0.0,0.0
27644,2,7644,[ 64  12 269 301 357],416,5,29307,3.8334859385219096,40.0,0.0
27645,2,7645,[185 475 175 168 197],198,3,29310,3.8333769291132618,0.0,0.0
27646,2,7646,[ 64  12 269 301 357],416,5,29315,3.8335294886883746,40.0,0.0
27647,2,7647,[ 71 210  50 301 385],416,5,29320,3.833682008368201,0.0,20.0
27648,2,7648,[313 125 288 210  12],345,3,29323,3.8335730160805332,40.0,40.0
27649,2,7649,[ 64  12 269 301 357],416,5,29328,3.8337254901960782,40.0,0.0
27650,2,7650,[ 71 195 483 121  97],62,4,29332,3.833747222585283,20.0,0.0
27651,2,7651,[ 64  12 269 301 357],416,5,29337,3.833899634082593,40.0,0.0
27652,2,7652,[ 50 168  71  89 176],198,4,29341,3.833921338037371,0.0,20.0
27653,2,7653,[185 161 286 168 496],711,5,29346,3.8340736869610663,0.0,0.0
27654,2,7654,[ 64  12 269 301 357],416,5,29351,3.834225996080993,40.0,0.0
27655,2,7655,[475  96 100 258 153],417,3,29354,3.8341170323928946,0.0,0.0
27656,2,7656,[ 64  12 269 301 357],416,5,29359,3.8342692960689564,40.0,0.0
27657,2,7657,[144  69 385 742 318],416,5,29364,3.8344215199791067,20.0,0.0
27658,2,7658,[168 258 300 322  11],416,4,29368,3.8344431387909648,0.0,0.0
27659,2,7659,[ 64  12 269 301 357],416,5,29373,3.8345953002610966,40.0,0.0
27660,2,7660,[ 64  12 269 301 357],416,5,29378,3.834747422007571,40.0,0.0
27661,2,7661,[515 100 197 508 318],354,2,29380,3.8345079613677893,20.0,0.0
27662,2,7662,[ 64  12 269 301 357],416,5,29385,3.8346600548088214,40.0,0.0
27663,2,7663,[179 471 174 323 597],416,2,29387,3.834420668058455,0.0,0.0
27664,2,7664,[ 64  12 269 301 357],416,5,29392,3.83457273320287,40.0,0.0
27665,2,7665,[100 286 151 211 238],43,4,29396,3.8345943125489175,0.0,0.0
27666,2,7666,[ 64  12 269 301 357],416,5,29401,3.8347463153775925,40.0,0.0
27667,2,7667,[ 64  12 269 301 357],416,5,29406,3.8348982785602503,40.0,0.0
27668,2,7668,[234 117 168  97   9],416,5,29411,3.8350502021124004,0.0,0.0
27669,2,7669,[ 56 172 742 268 195],416,5,29416,3.8352020860495437,0.0,0.0
27670,2,7670,[175 143 174 182 273],297,4,29420,3.8352235692869248,0.0,0.0
27671,2,7671,[185 191   1 117 258],416,5,29425,3.835375391032325,0.0,0.0
27672,2,7672,[173  82  12 496 423],618,4,29429,3.83539684608367,20.0,0.0
27673,2,7673,[  7 216 568 313 318],416,5,29434,3.835548605681522,40.0,20.0
27674,2,7674,[ 64  12 269 301 357],416,5,29439,3.835700325732899,40.0,0.0
27675,2,7675,[ 64  12 269 301 357],416,5,29444,3.835852006253257,40.0,0.0
27676,2,7676,[ 64  12 269 301 357],416,5,29449,3.8360036472580434,40.0,0.0
27677,2,7677,[100  96 181 427 323],416,4,29453,3.8360250065121124,0.0,20.0
27678,2,7678,[546 238 234 100 191],417,3,29456,3.8359161349134,0.0,0.0
27679,2,7679,[  1 195 294 181  22],262,1,29457,3.835546875,0.0,20.0
27680,2,7680,[ 64  12 269 301 357],416,5,29462,3.8356984767608386,40.0,0.0
27681,2,7681,[496 475   8 143 185],416,4,29466,3.835719864618589,0.0,0.0
27682,2,7682,[153 222 121 423 210],43,5,29471,3.8358714043993234,0.0,0.0
27683,2,7683,[181 144 175 196 197],373,2,29473,3.8356324830817283,0.0,20.0
27684,2,7684,[475  25   8 294 111],805,2,29475,3.8353936239427457,0.0,0.0
27685,2,7685,[132 125 471 151 175],854,3,29478,3.8352849336455894,0.0,0.0
27686,2,7686,[ 64  12 269 301 357],416,5,29483,3.8354364511512946,40.0,0.0
27687,2,7687,[276  71  64 100 196],62,5,29488,3.8355879292403747,20.0,0.0
27688,2,7688,[289 117 286 197 195],416,4,29492,3.835609312004162,0.0,0.0
27689,2,7689,[172   8 655 568 202],805,1,29493,3.8352405721716516,0.0,0.0
27690,2,7690,[ 64  12 269 301 357],416,5,29498,3.8353920166428295,40.0,0.0
27691,2,7691,[275  11  56 496 204],262,4,29502,3.8354134165366616,0.0,0.0
27692,2,7692,[275  71 196 161 173],437,3,29505,3.835304822565969,0.0,0.0
27693,2,7693,[405 174  50 127  69],62,4,29509,3.8353262282297895,0.0,20.0
27694,2,7694,[ 64  12 269 301 357],416,5,29514,3.835477582846004,40.0,0.0
27695,2,7695,[ 64  12 269 301 357],416,5,29519,3.835628898128898,40.0,0.0
27696,2,7696,[313  50 258 181 151],642,3,29522,3.835520332597116,20.0,60.0
27697,2,7697,[ 56 179 195 172 118],437,3,29525,3.835411795271499,0.0,0.0
27698,2,7698,[ 64  12 269 301 357],416,5,29530,3.8355630601376802,40.0,0.0
27699,2,7699,[302  11 655  64 132],417,4,29534,3.8355844155844157,20.0,0.0
27700,2,7700,[588 174  82  88 655],128,3,29537,3.8354759122191924,0.0,0.0
27701,2,7701,[ 64  12 269 301 357],416,5,29542,3.8356271098415995,40.0,0.0
27702,2,7702,[ 70  97 245 172 196],416,4,29546,3.8356484486563676,0.0,0.0
27703,2,7703,[204 597  69 111 202],887,5,29551,3.8357995846313604,0.0,0.0
27704,2,7704,[ 64  12 269 301 357],416,5,29556,3.83595068137573,40.0,0.0
27705,2,7705,[ 64  12 269 301 357],416,5,29561,3.8361017389047496,40.0,0.0
27706,2,7706,[286 132   1 187 300],416,5,29566,3.8362527572336838,0.0,0.0
27707,2,7707,[288 257 182   8 117],297,2,29568,3.8360145303580695,0.0,20.0
27708,2,7708,[ 22   4 125   7 275],618,2,29570,3.8357763652873267,0.0,0.0
27709,2,7709,[173  64   7  97 273],62,4,29574,3.83579766536965,20.0,0.0
27710,2,7710,[  8 237 196  50 191],416,4,29578,3.8358189599273764,0.0,20.0
27711,2,7711,[ 64  12 269 301 357],416,5,29583,3.835969917012448,40.0,0.0
27712,2,7712,[210 313 237 275  79],654,5,29588,3.8361208349539737,20.0,20.0
27713,2,7713,[191 151 405  28  64],705,3,29591,3.836012444905367,20.0,0.0
27714,2,7714,[238 483 132 258 135],711,5,29596,3.836163318211277,20.0,0.0
27715,2,7715,[ 50 742 196 597 323],805,2,29598,3.8359253499222397,0.0,20.0
27716,2,7716,[496 238 211  28 234],230,4,29602,3.8359466113774783,0.0,0.0
27717,2,7717,[ 8 79  9 89 25],805,3,29605,3.8358383000777403,0.0,0.0
27718,2,7718,[121 211 181 357  12],417,3,29608,3.83573001684156,20.0,20.0
27719,2,7719,[ 64  12 269 301 357],416,5,29613,3.835880829015544,40.0,0.0
27720,2,7720,[289 423  11  70 121],43,5,29618,3.836031602124077,0.0,0.0
27721,2,7721,[  7 238 273 100 276],618,3,29621,3.835923335923336,0.0,0.0
27722,2,7722,[294 187 603 286 202],416,5,29626,3.836074064482714,0.0,0.0
27723,2,7723,[588 276 182 655 186],128,4,29630,3.836095287415847,0.0,0.0
27724,2,7724,[216   7 127 222  71],805,2,29632,3.8358576051779933,0.0,0.0
27725,2,7725,[ 56 475 273 168 182],417,4,29636,3.8358788506342223,0.0,0.0
27726,2,7726,[186 118 228 508 195],417,3,29639,3.8357706742590914,0.0,0.0
27727,2,7727,[508 265 748 268 245],297,2,29641,3.835533126293996,0.0,0.0
27728,2,7728,[568 588 121  95  88],314,5,29646,3.8356837883296673,0.0,0.0
27729,2,7729,[ 98 151 144 135 313],711,4,29650,3.835705045278137,20.0,40.0
27730,2,7730,[288 318  28 125 153],62,3,29653,3.8355969473548055,20.0,20.0
27731,2,7731,[268 235  79 202 117],907,5,29658,3.8357475426797722,0.0,0.0
27732,2,7732,[ 64  12 269 301 357],416,5,29663,3.835898099055994,40.0,0.0
27733,2,7733,[161 153 200 405 234],38,5,29668,3.836048616498578,0.0,0.0
27734,2,7734,[ 64  12 269 301 357],416,5,29673,3.8361990950226246,40.0,0.0
27735,2,7735,[ 64  12 269 301 357],416,5,29678,3.8363495346432264,40.0,0.0
27736,2,7736,[151 174  95 191   7],805,3,29681,3.83624143724958,0.0,0.0
27737,2,7737,[ 64  12 269 301 357],416,5,29686,3.836391832514862,40.0,0.0
27738,2,7738,[ 12 204 168 125 282],618,2,29688,3.836154541930482,20.0,0.0
27739,2,7739,[ 64  12 269 301 357],416,5,29693,3.8363049095607233,40.0,0.0
27740,2,7740,[183 322  50 235 182],417,2,29695,3.8360676915127243,0.0,20.0
27741,2,7741,[125 282 273 275   1],618,2,29697,3.835830534745544,0.0,0.0
27742,2,7742,[172 546 143  79  95],654,5,29702,3.8359808859615137,0.0,0.0
27743,2,7743,[568  96 322 121 294],416,4,29706,3.8360020661157024,0.0,0.0
27744,2,7744,[ 50 333 215 168 282],416,5,29711,3.8361523563589413,0.0,20.0
27745,2,7745,[ 56 174 271 121 111],854,2,29713,3.8359153111283244,0.0,0.0
27746,2,7746,[588  50 475 269 222],805,4,29717,3.835936491545114,0.0,20.0
27747,2,7747,[222  25  82 748 100],654,3,29720,3.835828600929272,0.0,0.0
27748,2,7748,[ 12 245 678 257 655],416,2,29722,3.8355916892502258,20.0,0.0
27749,2,7749,[333 269 742   1  71],416,5,29727,3.835741935483871,0.0,0.0
27750,2,7750,[ 64  12 269 301 357],416,5,29732,3.8358921429492967,40.0,0.0
27751,2,7751,[191  88  50 182 143],618,5,29737,3.8360423116615068,0.0,20.0
27752,2,7752,[ 71 174 111  15 153],416,5,29742,3.8361924416354958,0.0,0.0
27753,2,7753,[ 64  12 269 301 357],416,5,29747,3.836342532886252,40.0,0.0
27754,2,7754,[ 64  12 269 301 357],416,5,29752,3.8364925854287555,40.0,0.0
27755,2,7755,[289 118 200  15 273],416,3,29755,3.836384734399175,0.0,0.0
27756,2,7756,[ 64  12 269 301 357],416,5,29760,3.836534742812943,40.0,0.0
27757,2,7757,[ 64  12 269 301 357],416,5,29765,3.8366847125547823,40.0,0.0
27758,2,7758,[ 56 132  25 588 265],618,4,29769,3.836705761051682,0.0,0.0
27759,2,7759,[333 153 294  56  50],416,5,29774,3.836855670103093,0.0,20.0
27760,2,7760,[ 25  71   9 215 204],618,2,29776,3.836618992397887,0.0,0.0
27761,2,7761,[ 64  12 269 301 357],416,5,29781,3.836768874001546,40.0,0.0
27762,2,7762,[ 97 294  79 238 471],43,3,29784,3.83666108463223,0.0,0.0
27763,2,7763,[ 64  12 269 301 357],416,5,29789,3.836810922205049,40.0,0.0
27764,2,7764,[ 12  70   8 288 195],437,2,29791,3.836574372182872,20.0,20.0
27765,2,7765,[ 64  12 269 301 357],416,5,29796,3.8367241823332474,40.0,0.0
27766,2,7766,[318 181  70 153 237],43,5,29801,3.8368739539075576,20.0,20.0
27767,2,7767,[328 186  25 118 603],854,1,29802,3.836508753861998,0.0,0.0
27768,2,7768,[ 64  12 269 301 357],416,5,29807,3.836658514609345,40.0,0.0
27769,2,7769,[ 64  12 269 301 357],416,5,29812,3.836808236808237,40.0,0.0
27770,2,7770,[194 153  56 197 294],416,5,29817,3.8369579204735555,0.0,0.0
27771,2,7771,[204 176 568 182 186],618,4,29821,3.836978898610396,0.0,0.0
27772,2,7772,[143 196 234 204 276],198,0,29821,3.836485269522707,0.0,0.0
27773,2,7773,[286 195 187 302   8],416,5,29826,3.8366349369693853,0.0,0.0
27774,2,7774,[ 64  12 269 301 357],416,5,29831,3.836784565916399,40.0,0.0
27775,2,7775,[ 64  12 269 301 357],416,5,29836,3.836934156378601,40.0,0.0
27776,2,7776,[568  88  79  71 245],345,3,29839,3.836826539796837,0.0,0.0
27777,2,7777,[202 245 237 176 216],297,3,29842,3.8367189508871173,0.0,0.0
27778,2,7778,[ 64  12 269 301 357],416,5,29847,3.8368684920940996,40.0,0.0
27779,2,7779,[ 64  12 269 301 357],416,5,29852,3.837017994858612,40.0,0.0
27780,2,7780,[288 210 118 286  89],437,0,29852,3.83652486826886,0.0,20.0
27781,2,7781,[ 64  12 269 301 357],416,5,29857,3.836674376766898,40.0,0.0
27782,2,7782,[655 204 121  69 196],416,5,29862,3.8368238468456894,0.0,0.0
27783,2,7783,[182 176 282 313  98],618,4,29866,3.8368448098663928,20.0,40.0
27784,2,7784,[ 64  12 269 301 357],416,5,29871,3.836994219653179,40.0,0.0
27785,2,7785,[ 64  12 269 301 357],416,5,29876,3.8371435910608787,40.0,0.0
27786,2,7786,[ 25 357 191 282 546],416,4,29880,3.8371645049441376,0.0,0.0
27787,2,7787,[ 64  12 269 301 357],416,5,29885,3.8373138161273754,40.0,0.0
27788,2,7788,[168 183 228 568   4],805,2,29887,3.8370779304146874,0.0,0.0
27789,2,7789,[117  25 196 176  96],230,3,29890,3.8369704749679077,0.0,0.0
27790,2,7790,[ 15 173 210 271   8],62,3,29893,3.8368630471056346,0.0,0.0
27791,2,7791,[121 202 204 313 265],588,4,29897,3.8368839835728954,20.0,20.0
27792,2,7792,[ 64  12 269 301 357],416,5,29902,3.8370332349544465,40.0,0.0
27793,2,7793,[496 302 742 172 195],416,5,29907,3.8371824480369514,0.0,0.0
27794,2,7794,[ 64  12 269 301 357],416,5,29912,3.837331622835151,40.0,0.0
27795,2,7795,[268 151 161 289 471],416,3,29915,3.83722421754746,0.0,0.0
27796,2,7796,[ 64  12 269 301 357],416,5,29920,3.8373733487238684,40.0,0.0
27797,2,7797,[ 64  12 269 301 357],416,5,29925,3.8375224416517058,40.0,0.0
27798,2,7798,[294   8 271  64 568],43,4,29929,3.8375432747788176,20.0,0.0
27799,2,7799,[172  88  98  82   4],805,2,29931,3.837307692307692,0.0,20.0
27800,2,7800,[294  95 385 222   8],43,5,29936,3.837456736315857,0.0,0.0
27801,2,7801,[ 64  12 269 301 357],416,5,29941,3.8376057421174057,40.0,0.0
27802,2,7802,[238 202 265 483 204],128,4,29945,3.8376265538895296,20.0,0.0
27803,2,7803,[435 196 210 135  22],297,4,29949,3.8376473603280368,0.0,0.0
27804,2,7804,[ 64  12 269 301 357],416,5,29954,3.8377962844330558,40.0,0.0
27805,2,7805,[ 15   1  64 111  82],62,2,29956,3.8375608506277223,20.0,0.0
27806,2,7806,[ 56  98  11 174  12],654,5,29961,3.8377097476623545,20.0,20.0
27807,2,7807,[ 64  12 269 301 357],416,5,29966,3.837858606557377,40.0,0.0
27808,2,7808,[288 237 742 748 121],52,4,29970,3.837879369957741,0.0,20.0
27809,2,7809,[271 238  28 748   9],805,1,29971,3.837516005121639,0.0,0.0
27810,2,7810,[ 64  12 269 301 357],416,5,29976,3.8376648316476762,40.0,0.0
27811,2,7811,[678 173 135 127   1],805,4,29980,3.8376856118791602,0.0,0.0
27812,2,7812,[174 153  56   8 588],805,2,29982,3.8374504031741967,0.0,0.0
27813,2,7813,[216  79 186 175 135],854,3,29985,3.8373432300998207,0.0,0.0
27814,2,7814,[211   8 333 215  97],416,5,29990,3.837492002559181,0.0,0.0
27815,2,7815,[515 191 176 185  15],416,5,29995,3.8376407369498464,0.0,0.0
27816,2,7816,[678 118 215 144 568],416,3,29998,3.8375335806575412,0.0,0.0
27817,2,7817,[475 173 234  22 172],805,4,30002,3.8375543617293424,0.0,0.0
27818,2,7818,[173 427  15 275  97],705,1,30003,3.8371914567080188,0.0,0.0
27819,2,7819,[ 64  12 269 301 357],416,5,30008,3.8373401534526854,40.0,0.0
27820,2,7820,[ 28 118 182 234 179],437,2,30010,3.8371052295102928,0.0,0.0
27821,2,7821,[  1 210  82  56  28],43,5,30015,3.8372538992585015,0.0,0.0
27822,2,7822,[186   4 322  22 288],854,1,30016,3.8368912182027355,0.0,20.0
27823,2,7823,[182 282 144 328 471],416,5,30021,3.8370398773006134,0.0,0.0
27824,2,7824,[301  25  82 197   7],416,5,30026,3.837188498402556,0.0,0.0
27825,2,7825,[ 64  12 269 301 357],416,5,30031,3.837337081523128,40.0,0.0
27826,2,7826,[ 64  12 269 301 357],416,5,30036,3.8374856266768878,40.0,0.0
27827,2,7827,[ 11 194 144 195 118],297,1,30037,3.8371231476750127,0.0,0.0
27828,2,7828,[ 50 185  56 186 269],854,4,30041,3.8371439519734323,0.0,20.0
27829,2,7829,[294 181  95 100 546],262,0,30041,3.836653895274585,0.0,20.0
27830,2,7830,[258 237 328 168  25],43,5,30046,3.8368024517941515,0.0,0.0
27831,2,7831,[ 64  12 269 301 357],416,5,30051,3.8369509703779365,40.0,0.0
27832,2,7832,[588  15 333 153 742],253,3,30054,3.836844121026427,0.0,0.0
27833,2,7833,[ 64  12 269 301 357],416,5,30059,3.8369925963747766,40.0,0.0
27834,2,7834,[257 175 423  79 483],854,4,30063,3.8370134014039565,20.0,0.0
27835,2,7835,[ 89 175 195 151 483],854,4,30067,3.837034201123022,20.0,0.0
27836,2,7836,[195 200 245 211 175],297,2,30069,3.836799795840245,0.0,0.0
27837,2,7837,[269 286 333   8 204],416,5,30074,3.836948201071702,0.0,0.0
27838,2,7838,[ 22 183 237 282  79],297,3,30077,3.8368414338563595,0.0,0.0
27839,2,7839,[ 79  82 174 179 269],805,3,30080,3.836734693877551,0.0,0.0
27840,2,7840,[ 22 678 322  56   7],805,3,30083,3.8366279811248565,0.0,0.0
27841,2,7841,[200 176  71 185 196],198,2,30085,3.8363937770976793,0.0,0.0
27842,2,7842,[143 237 197 111 200],416,4,30089,3.836414637256152,0.0,0.0
27843,2,7843,[ 64  12 269 301 357],416,5,30094,3.836562978072412,40.0,0.0
27844,2,7844,[185 742 655 275  88],416,4,30098,3.8365838113448056,0.0,0.0
27845,2,7845,[ 64  12 269 301 357],416,5,30103,3.836732092786133,40.0,0.0
27846,2,7846,[427 216  25 275  50],416,5,30108,3.836880336434306,0.0,20.0
27847,2,7847,[ 95 216 302 475 286],417,3,30111,3.83677370030581,0.0,0.0
27848,2,7848,[194 282 185 215 546],297,1,30112,3.83641228181934,0.0,0.0
27849,2,7849,[403 195 161 183 271],805,2,30114,3.8361783439490447,0.0,0.0
27850,2,7850,[ 79 202 181 496 258],416,5,30119,3.8363265826009427,0.0,20.0
27851,2,7851,[ 64  12 269 301 357],416,5,30124,3.836474783494651,40.0,0.0
27852,2,7852,[245 238 268 603 655],416,4,30128,3.836495606774481,0.0,0.0
27853,2,7853,[269  12 181 300  98],875,4,30132,3.8365164247517187,20.0,40.0
27854,2,7854,[  4  71  82  96 234],618,3,30135,3.836409929980904,0.0,0.0
27855,2,7855,[153  56 405  97 151],43,5,30140,3.8365580448065173,0.0,0.0
27856,2,7856,[216 237 258  96 153],198,4,30144,3.8365788468881252,0.0,0.0
27857,2,7857,[210 161 238 176  15],417,3,30147,3.8364723848307456,0.0,0.0
27858,2,7858,[  7 153 117 655 202],416,5,30152,3.836620435169869,0.0,0.0
27859,2,7859,[100 168 132  71 125],601,3,30155,3.8365139949109417,0.0,0.0
27860,2,7860,[742  79  95  69 423],505,3,30158,3.836407581732604,0.0,0.0
27861,2,7861,[172 234  28  70 197],405,4,30162,3.836428389722717,0.0,0.0
27862,2,7862,[405 204 210 294 181],345,4,30166,3.8364491924201958,0.0,20.0
27863,2,7863,[204 202 403  98 289],345,2,30168,3.836215666327569,0.0,20.0
27864,2,7864,[172 269   4  79  28],43,5,30173,3.8363636363636364,0.0,0.0
27865,2,7865,[ 64  12 269 301 357],416,5,30178,3.836511568777015,40.0,0.0
27866,2,7866,[ 64  12 269 301 357],416,5,30183,3.8366594635820515,40.0,0.0
27867,2,7867,[216  12 182  11 603],297,4,30187,3.8366802236909,20.0,0.0
27868,2,7868,[121   7  82  71 174],198,2,30189,3.836446816622188,0.0,0.0
27869,2,7869,[ 64  12 269 301 357],416,5,30194,3.8365946632782717,40.0,0.0
27870,2,7870,[ 64  12 269 301 357],416,5,30199,3.8367424723669163,40.0,0.0
27871,2,7871,[153 655  50 183 125],253,3,30202,3.8366361788617884,0.0,20.0
27872,2,7872,[ 64  12 269 301 357],416,5,30207,3.836783945128922,40.0,0.0
27873,2,7873,[289  88 313 215   8],416,3,30210,3.836677673355347,20.0,20.0
27874,2,7874,[ 64  12 269 301 357],416,5,30215,3.8368253968253967,40.0,0.0
27875,2,7875,[318 471 100 276 196],416,4,30219,3.8368461147790756,20.0,0.0
27876,2,7876,[118 655   4  69  15],345,4,30223,3.836866827472388,0.0,0.0
27877,2,7877,[211 144 181 423  22],416,5,30228,3.837014470677837,0.0,20.0
27878,2,7878,[222  71 204  95 215],541,5,30233,3.8371620764056353,0.0,0.0
27879,2,7879,[ 64  12 269 301 357],416,5,30238,3.837309644670051,40.0,0.0
27880,2,7880,[ 64  12 269 301 357],416,5,30243,3.8374571754853446,40.0,0.0
27881,2,7881,[273 100 471 257 153],416,4,30247,3.8374777975133214,0.0,0.0
27882,2,7882,[483 301  25  28 313],751,4,30251,3.837498414309273,40.0,20.0
27883,2,7883,[ 98 121 265   8 238],230,4,30255,3.8375190258751903,0.0,20.0
27884,2,7884,[245  82 403 258 118],642,3,30258,3.837412809131262,0.0,0.0
27885,2,7885,[204 515 194 258 195],416,5,30263,3.8375602333248797,0.0,0.0
27886,2,7886,[ 64  12 269 301 357],416,5,30268,3.8377076201343985,40.0,0.0
27887,2,7887,[172 588  56 234 197],416,5,30273,3.8378549695740367,0.0,0.0
27888,2,7888,[  7 301 202 100 196],43,5,30278,3.838002281658005,0.0,0.0
27889,2,7889,[268 100 748 204 195],654,3,30281,3.8378960709759187,0.0,0.0
27890,2,7890,[ 64  56 121  98 357],198,4,30285,3.8379166138638956,20.0,20.0
27891,2,7891,[191 215  12  15   8],416,5,30290,3.838063862138875,20.0,0.0
27892,2,7892,[179 228 748 202 216],417,3,30293,3.8379576840238188,0.0,0.0
27893,2,7893,[ 64  12 269 301 357],416,5,30298,3.838104889789714,40.0,0.0
27894,2,7894,[ 28 318  95 655 385],588,3,30301,3.8379987333755543,20.0,0.0
27895,2,7895,[288  96 195 234 185],805,3,30304,3.8378926038500505,0.0,20.0
27896,2,7896,[183 117 187 194 275],416,5,30309,3.838039761934912,0.0,0.0
27897,2,7897,[322  56 273 328 216],854,2,30311,3.8378070397569006,0.0,0.0
27898,2,7898,[234 237 132 210  50],642,3,30314,3.8377009748069377,0.0,20.0
27899,2,7899,[111 144 185 194 655],416,5,30319,3.837848101265823,0.0,0.0
27900,2,7900,[ 97  28   8 195 211],405,3,30322,3.837742057967346,0.0,0.0
27901,2,7901,[288  98 655  97 245],417,4,30326,3.837762591748924,0.0,40.0
27902,2,7902,[ 64  12 269 301 357],416,5,30331,3.837909654561559,40.0,0.0
27903,2,7903,[597 135 185 234  96],805,4,30335,3.8379301619433197,0.0,0.0
27904,2,7904,[300 181 546 234 288],416,4,30339,3.8379506641366223,0.0,40.0
27905,2,7905,[100   9  56  95 289],416,3,30342,3.8378446749304325,0.0,0.0
27906,2,7906,[475 200  11  95 143],437,3,30345,3.8377387125331985,0.0,0.0
27907,2,7907,[276 135  89 216 238],62,5,30350,3.8378856853818917,0.0,0.0
27908,2,7908,[ 22 215 403 204 125],373,4,30354,3.8379061828296877,0.0,0.0
27909,2,7909,[ 64  12 269 301 357],416,5,30359,3.838053097345133,40.0,0.0
27910,2,7910,[ 64  12 269 301 357],416,5,30364,3.838199974718746,40.0,0.0
27911,2,7911,[ 69 196 204 318 174],618,4,30368,3.8382204246713854,20.0,0.0
27912,2,7912,[ 11 403 265   8  22],416,5,30373,3.8383672437760645,0.0,0.0
27913,2,7913,[427 183 323 216 118],198,3,30376,3.8382613090725295,0.0,0.0
27914,2,7914,[328   4  95 282 357],416,4,30380,3.8382817435249525,0.0,0.0
27915,2,7915,[322 153 210 228 196],805,1,30381,3.8379231935320868,0.0,0.0
27916,2,7916,[127  22   1 175  95],922,2,30383,3.8376910445875962,0.0,0.0
27917,2,7917,[127 135  79  11 483],618,5,30388,3.8378378378378377,20.0,0.0
27918,2,7918,[ 64  12 269 301 357],416,5,30393,3.837984594014396,40.0,0.0
27919,2,7919,[ 98 328 179  71 483],128,3,30396,3.837878787878788,20.0,20.0
27920,2,7920,[ 64  12 269 301 357],416,5,30401,3.838025501830577,40.0,0.0
27921,2,7921,[ 64  12 269 301 357],416,5,30406,3.8381721787427416,40.0,0.0
27922,2,7922,[ 70  64 238 216 328],128,3,30409,3.838066388994068,20.0,0.0
27923,2,7923,[ 12 282 385   4 568],416,5,30414,3.838213023725391,20.0,0.0
27924,2,7924,[ 64  12 269 301 357],416,5,30419,3.838359621451104,40.0,0.0
27925,2,7925,[172 269 313   4 475],416,4,30423,3.8383800151400456,20.0,20.0
27926,2,7926,[ 25 121 181  50 204],805,2,30425,3.838148101425508,0.0,40.0
27927,2,7927,[ 98 174  97 143  88],416,4,30429,3.8381685166498487,0.0,20.0
27928,2,7928,[ 64  12 269 301 357],416,5,30434,3.838315046033548,40.0,0.0
27929,2,7929,[ 64  12 269 301 357],416,5,30439,3.8384615384615386,40.0,0.0
27930,2,7930,[568  69 185 597 228],417,0,30439,3.8379775564241583,0.0,0.0
27931,2,7931,[568 118  79 333  12],345,3,30442,3.8378719112455877,20.0,0.0
27932,2,7932,[ 64  12 269 301 357],416,5,30447,3.8380184041346275,40.0,0.0
27933,2,7933,[234 294 161 588 742],230,5,30452,3.83816486009579,0.0,0.0
27934,2,7934,[191  28 385  79 125],345,2,30454,3.837933207309389,0.0,0.0
27935,2,7935,[ 64  12 269 301 357],416,5,30459,3.838079637096774,40.0,0.0
27936,2,7936,[ 82 597  79 742 151],416,3,30462,3.8379740456091724,0.0,0.0
27937,2,7937,[ 15 132 237   4 318],618,3,30465,3.8378684807256236,20.0,0.0
27938,2,7938,[204 301 286 168 135],711,4,30469,3.8378889028844942,0.0,0.0
27939,2,7939,[173 197 318 216 288],711,3,30472,3.8377833753148614,20.0,20.0
27940,2,7940,[ 64  12 269 301 357],416,5,30477,3.8379297317718173,40.0,0.0
27941,2,7941,[ 96  50  70 181 111],630,2,30479,3.837698312767565,0.0,40.0
27942,2,7942,[186 288 546 132  70],417,3,30482,3.8375928490494777,0.0,20.0
27943,2,7943,[ 64  12 269 301 357],416,5,30487,3.8377391742195366,40.0,0.0
27944,2,7944,[268 475  98  96 603],416,4,30491,3.837759597230963,0.0,20.0
27945,2,7945,[294  88 405  71 328],43,5,30496,3.8379058645859554,0.0,0.0
27946,2,7946,[423 678 174 235 191],297,1,30497,3.837548760538568,0.0,0.0
27947,2,7947,[ 64 121 215 172 258],62,4,30501,3.8375691997986916,20.0,0.0
27948,2,7948,[111 508 215 597  15],62,1,30502,3.8372122279532017,0.0,0.0
27949,2,7949,[385   8 655 118 121],705,3,30505,3.8371069182389936,0.0,0.0
27950,2,7950,[245 197 215  11   9],416,4,30509,3.837127405357817,0.0,0.0
27951,2,7951,[222 176 168  28 742],297,4,30513,3.8371478873239435,0.0,0.0
27952,2,7952,[ 98 204 210 117  97],416,5,30518,3.8372941028542686,0.0,20.0
27953,2,7953,[ 64  12 269 301 357],416,5,30523,3.837440281619311,40.0,0.0
27954,2,7954,[ 64  12 269 301 357],416,5,30528,3.8375864236329353,40.0,0.0
27955,2,7955,[ 64  12 269 301 357],416,5,30533,3.8377325289089996,40.0,0.0
27956,2,7956,[496 144 210 302 322],416,4,30537,3.8377529219555107,0.0,0.0
27957,2,7957,[144 173  69  56 237],618,4,30541,3.8377733098768534,0.0,0.0
27958,2,7958,[174 222 181   8 132],588,3,30544,3.837668048749843,0.0,20.0
27959,2,7959,[185 475 172 222  82],417,2,30546,3.837437185929648,0.0,0.0
27960,2,7960,[143 191 179 302   9],416,4,30550,3.8374576058284133,0.0,0.0
27961,2,7961,[215 111  79  12  71],654,4,30554,3.83747802059784,20.0,0.0
27962,2,7962,[ 79  64 180 132 269],711,5,30559,3.8376240110511115,20.0,0.0
27963,2,7963,[471  15 237 403 153],721,4,30563,3.837644399799096,0.0,0.0
27964,2,7964,[ 64  12 269 301 357],416,5,30568,3.837790332705587,40.0,0.0
27965,2,7965,[185  28 215  64   1],618,5,30573,3.837936228973136,20.0,0.0
27966,2,7966,[ 64  12 269 301 357],416,5,30578,3.838082088615539,40.0,0.0
27967,2,7967,[168 125 127 588 423],417,4,30582,3.8381024096385543,0.0,0.0
27968,2,7968,[275 313 282 423  97],654,3,30585,3.8379972393022963,20.0,20.0
27969,2,7969,[ 64  12 269 301 357],416,5,30590,3.838143036386449,40.0,0.0
27970,2,7970,[ 64  12 269 301 357],416,5,30595,3.8382887968887216,40.0,0.0
27971,2,7971,[144 204 174 300 195],297,1,30596,3.8379327646763675,0.0,0.0
27972,2,7972,[185 258 186 151 508],854,4,30600,3.837953091684435,0.0,0.0
27973,2,7973,[ 98 568 195  96 200],417,3,30603,3.8378480060195637,0.0,20.0
27974,2,7974,[181 237 195  11 204],505,1,30604,3.8374921630094043,0.0,20.0
27975,2,7975,[ 89 603 216 748  11],805,2,30606,3.837261785356068,0.0,0.0
27976,2,7976,[ 64  12 269 301 357],416,5,30611,3.837407546696753,40.0,0.0
27977,2,7977,[  7 300 323 216 200],416,4,30615,3.8374279267986964,0.0,0.0
27978,2,7978,[ 64  12 269 301 357],416,5,30620,3.8375736307807995,40.0,0.0
27979,2,7979,[183 179  28 275 195],62,4,30624,3.837593984962406,0.0,0.0
27980,2,7980,[153  22  82 515 168],230,5,30629,3.8377396316251096,0.0,0.0
27981,2,7981,[  9 200  95 211 603],416,4,30633,3.837759959909797,0.0,0.0
27982,2,7982,[ 64  12 269 301 357],416,5,30638,3.837905549292246,40.0,0.0
27983,2,7983,[ 64  12 269 301 357],416,5,30643,3.838051102204409,40.0,0.0
27984,2,7984,[496 191 603  22 194],698,2,30645,3.8378209142141517,0.0,0.0
27985,2,7985,[ 64  12 269 301 357],416,5,30650,3.8379664412722265,40.0,0.0
27986,2,7986,[245  95   4 235 100],297,1,30651,3.837611118066859,0.0,0.0
27987,2,7987,[ 64  12 269 301 357],416,5,30656,3.8377566349524286,40.0,0.0
27988,2,7988,[168  79 237 423 282],654,4,30660,3.8377769432970332,0.0,0.0
27989,2,7989,[234  12  82  69  56],618,5,30665,3.8379224030037546,20.0,0.0
27990,2,7990,[ 64  12 269 301 357],416,5,30670,3.838067826304593,40.0,0.0
27991,2,7991,[603  95   1 301 210],751,4,30674,3.838088088088088,0.0,0.0
27992,2,7992,[ 28 143 202 258 182],297,3,30677,3.8379832353309147,0.0,0.0
27993,2,7993,[435 300  95 258 151],505,2,30679,3.8377533149862395,0.0,0.0
27994,2,7994,[655  70  22 182   7],416,5,30684,3.8378986866791744,0.0,0.0
27995,2,7995,[ 96  98 185 125 496],262,3,30687,3.837793896948474,0.0,20.0
27996,2,7996,[144 282  97 423   4],297,1,30688,3.837439039639865,0.0,0.0
27997,2,7997,[257 100 210 173  15],601,3,30691,3.837334333583396,0.0,0.0
27998,2,7998,[ 64  12 269 301 357],416,5,30696,3.83747968496062,40.0,0.0
27999,2,7999,[ 96 271 168 222  50],854,4,30700,3.8375,0.0,20.0
28000,2,8000,[161 748  69 202 143],437,3,30703,3.837395325584302,0.0,0.0
28001,2,8001,[423 742 153 238 176],416,5,30708,3.8375406148462883,0.0,0.0
28002,2,8002,[143   8 127  95 153],805,1,30709,3.837186055229289,0.0,0.0
28003,2,8003,[196 111 216 191 168],417,3,30712,3.837081459270365,0.0,0.0
28004,2,8004,[276 435 405 100 195],230,4,30716,3.837101811367895,0.0,0.0
28005,2,8005,[ 64  12 269 301 357],416,5,30721,3.837247064701474,40.0,0.0
28006,2,8006,[168 301 216 196 515],416,5,30726,3.837392281753466,0.0,0.0
28007,2,8007,[ 64  12 269 301 357],416,5,30731,3.8375374625374628,40.0,0.0
28008,2,8008,[ 70  71 204 471 273],618,2,30733,3.8373080284679735,0.0,0.0
28009,2,8009,[ 64  12 269 301 357],416,5,30738,3.837453183520599,40.0,0.0
28010,2,8010,[ 64  12 269 301 357],416,5,30743,3.8375983023342903,40.0,0.0
28011,2,8011,[496 271 276  28 568],43,4,30747,3.8376185721417873,0.0,0.0
28012,2,8012,[742 282 118 210 216],128,3,30750,3.837514039685511,0.0,0.0
28013,2,8013,[185 118 245 210 194],297,2,30752,3.837284751684552,0.0,0.0
28014,2,8014,[ 64  12 269 301 357],416,5,30757,3.8374298190892078,40.0,0.0
28015,2,8015,[ 64  12 269 301 357],416,5,30762,3.837574850299401,40.0,0.0
28016,2,8016,[237 118 191  79 135],198,2,30764,3.837345640513908,0.0,0.0
28017,2,8017,[568 268  71  15 318],588,5,30769,3.837490646046396,20.0,0.0
28018,2,8018,[ 96 405 180 216   4],198,2,30771,3.8372615039281706,0.0,0.0
28019,2,8019,[597 471 127 300  25],630,3,30774,3.83715710723192,0.0,0.0
28020,2,8020,[172 117  88  50 288],907,5,30779,3.837302082034659,0.0,40.0
28021,2,8021,[195 235  96   7 546],417,1,30780,3.836948391922214,0.0,0.0
28022,2,8022,[ 64  12 269 301 357],416,5,30785,3.837093356599776,40.0,0.0
28023,2,8023,[ 64  12 269 301 357],416,5,30790,3.8372382851445663,40.0,0.0
28024,2,8024,[427 196 294 202  69],128,4,30794,3.837258566978193,0.0,0.0
28025,2,8025,[ 96 405 234 215 143],416,5,30799,3.8374034388238227,0.0,0.0
28026,2,8026,[ 64  12 269 301 357],416,5,30804,3.837548274573315,40.0,0.0
28027,2,8027,[ 64  12 269 301 357],416,5,30809,3.8376930742401596,40.0,0.0
28028,2,8028,[121 269  98 111 173],751,4,30813,3.8377132893261927,0.0,20.0
28029,2,8029,[ 64 288  69 742 302],417,1,30814,3.837359900373599,20.0,20.0
28030,2,8030,[245 257 197  22 357],416,3,30817,3.8372556344166355,0.0,0.0
28031,2,8031,[ 22  64 258 132 294],416,5,30822,3.8374003984063747,20.0,0.0
28032,2,8032,[  1  28 496  98 187],887,4,30826,3.837420639860575,0.0,20.0
28033,2,8033,[294  56 118 318 121],642,3,30829,3.83731640527757,20.0,0.0
28034,2,8034,[748 151 118 515 588],297,2,30831,3.837087741132545,0.0,0.0
28035,2,8035,[200 546  50 143  56],49,1,30832,3.836734693877551,0.0,20.0
28036,2,8036,[258 222 197  98 238],198,4,30836,3.8367550080875947,0.0,20.0
28037,2,8037,[  9 405 118 483 403],62,3,30839,3.8366509081861158,20.0,0.0
28038,2,8038,[ 64  12 269 301 357],416,5,30844,3.8367956213459387,40.0,0.0
28039,2,8039,[100 174 282  79 286],297,3,30847,3.8366915422885572,0.0,0.0
28040,2,8040,[168 125 196 597  71],416,4,30851,3.8367118517597314,0.0,0.0
28041,2,8041,[ 64  12 269 301 357],416,5,30856,3.8368565033573736,40.0,0.0
28042,2,8042,[118 286 161 191 328],43,5,30861,3.8370011189854534,0.0,0.0
28043,2,8043,[175 121 173 435 427],698,1,30862,3.836648433615117,0.0,0.0
28044,2,8044,[ 64  12 269 301 357],416,5,30867,3.8367930391547547,40.0,0.0
28045,2,8045,[423  97 282 182 191],416,5,30872,3.836937608749689,0.0,0.0
28046,2,8046,[237 546   9 322 496],630,1,30873,3.8365850627563067,0.0,0.0
28047,2,8047,[ 64  12 269 301 357],416,5,30878,3.8367296222664016,40.0,0.0
28048,2,8048,[ 64  12 269 301 357],416,5,30883,3.836874145856628,40.0,0.0
28049,2,8049,[153 144 185 748 603],416,5,30888,3.8370186335403726,0.0,0.0
28050,2,8050,[ 64  12 269 301 357],416,5,30893,3.8371630853310146,40.0,0.0
28051,2,8051,[ 64  12 269 301 357],416,5,30898,3.8373075012419275,40.0,0.0
28052,2,8052,[ 64  12 269 301 357],416,5,30903,3.8374518812864773,40.0,0.0
28053,2,8053,[187  71 179 302  70],416,4,30907,3.8374720635708965,0.0,0.0
28054,2,8054,[195   7   9 210 118],805,1,30908,3.8371198013656116,0.0,0.0
28055,2,8055,[ 64  12 269 301 357],416,5,30913,3.8372641509433962,40.0,0.0
28056,2,8056,[748 181   7  12 405],416,5,30918,3.8374084646890902,20.0,20.0
28057,2,8057,[ 64  12 269 301 357],416,5,30923,3.8375527426160336,40.0,0.0
28058,2,8058,[135 216 117 172 237],618,4,30927,3.8375728998635066,0.0,0.0
28059,2,8059,[ 64  12 269 301 357],416,5,30932,3.8377171215880894,40.0,0.0
28060,2,8060,[301  89 111 294 427],342,2,30934,3.8374891452673365,0.0,0.0
28061,2,8061,[  1   7 603   9 237],416,4,30938,3.8375093029025056,0.0,0.0
28062,2,8062,[235  70 153  11  88],416,3,30941,3.8374054322212574,0.0,0.0
28063,2,8063,[ 64  12 269 301 357],416,5,30946,3.8375496031746033,40.0,0.0
28064,2,8064,[ 50 301 125  97 423],721,4,30950,3.837569745815251,0.0,20.0
28065,2,8065,[ 69 423  12  96 204],373,4,30954,3.837589883461443,20.0,0.0
28066,2,8066,[ 64  12 269 301 357],416,5,30959,3.837733977934796,40.0,0.0
28067,2,8067,[ 64  12 269 301 357],416,5,30964,3.8378780366881506,40.0,0.0
28068,2,8068,[186  70 204 216  89],437,2,30966,3.8376502664518526,0.0,0.0
28069,2,8069,[294 333 328 403  98],416,5,30971,3.837794299876084,0.0,20.0
28070,2,8070,[ 64  12 269 301 357],416,5,30976,3.8379382976087224,40.0,0.0
28071,2,8071,[182 172 211   8 238],405,3,30979,3.837834489593657,0.0,0.0
28072,2,8072,[286 405  97 655 204],62,0,30979,3.8373590982286636,0.0,0.0
28073,2,8073,[ 64  12 269 301 357],416,5,30984,3.8375030963586823,40.0,0.0
28074,2,8074,[ 64  12 269 301 357],416,5,30989,3.8376470588235296,40.0,0.0
28075,2,8075,[235 211 318  15  98],43,4,30993,3.837667161961367,20.0,20.0
28076,2,8076,[191 215 179   7 100],198,4,30997,3.8376872601213323,0.0,0.0
28077,2,8077,[161 588 435 357  97],373,3,31000,3.8375835602871997,0.0,0.0
28078,2,8078,[ 64  12 269 301 357],416,5,31005,3.837727441515039,40.0,0.0
28079,2,8079,[204 496 210 161 111],416,5,31010,3.837871287128713,0.0,0.0
28080,2,8080,[172 144  95   1  64],416,4,31014,3.8378913500804357,20.0,0.0
28081,2,8081,[183 161 125 186 196],618,4,31018,3.8379114080673102,0.0,0.0
28082,2,8082,[ 64  12 269 301 357],416,5,31023,3.838055177533094,40.0,0.0
28083,2,8083,[127  50  98 176  56],96,5,31028,3.838198911429985,0.0,40.0
28084,2,8084,[ 64  12 269 301 357],416,5,31033,3.838342609771181,40.0,0.0
28085,2,8085,[328 222 168 302 603],854,3,31036,3.83823893148652,0.0,0.0
28086,2,8086,[234 748 288 118  11],417,4,31040,3.838258934091752,0.0,20.0
28087,2,8087,[ 64  12 269 301 357],416,5,31045,3.838402571711177,40.0,0.0
28088,2,8088,[ 88 111 186 245 276],128,3,31048,3.8382989244653234,0.0,0.0
28089,2,8089,[ 95  25 328  22  56],314,3,31051,3.8381953028430162,0.0,0.0
28090,2,8090,[228 427 180 181 588],711,4,31055,3.8382153009516746,0.0,20.0
28091,2,8091,[ 25 174 132 181 118],198,3,31058,3.838111715274345,0.0,20.0
28092,2,8092,[176 742 228 403 153],805,3,31061,3.8380081551958485,0.0,0.0
28093,2,8093,[191 174 603 211 151],373,5,31066,3.8381517173214728,0.0,0.0
28094,2,8094,[300  50 515 143 313],416,5,31071,3.8382952439777642,20.0,40.0
28095,2,8095,[ 71  88 403 202 268],588,3,31074,3.838191699604743,0.0,0.0
28096,2,8096,[228 111 471 222 196],128,2,31076,3.8379646782759047,0.0,0.0
28097,2,8097,[121 546 222 238 168],62,5,31081,3.8381081748579895,0.0,0.0
28098,2,8098,[215 183 191  25  98],416,5,31086,3.838251636004445,0.0,20.0
28099,2,8099,[216 200 228 427 288],922,2,31088,3.8380246913580245,0.0,20.0
28100,2,8100,[286 323 288 603 258],416,4,31092,3.838044685841254,0.0,20.0
28101,2,8101,[200  98 238 427 276],198,4,31096,3.838064675388793,0.0,20.0
28102,2,8102,[ 64  12 269 301 357],416,5,31101,3.8382080710847832,40.0,0.0
28103,2,8103,[ 28 151 196 301 313],416,4,31105,3.838228035538006,20.0,20.0
28104,2,8104,[ 15 191   9   7 238],62,4,31109,3.838247995064775,0.0,0.0
28105,2,8105,[ 71  98 143 168 318],416,5,31114,3.838391315075253,20.0,20.0
28106,2,8106,[151 174 238 135 228],805,3,31117,3.838287899346244,0.0,0.0
28107,2,8107,[196 288  56 655 168],618,4,31121,3.838307844104588,0.0,20.0
28108,2,8108,[ 64 216 200 151 258],24,5,31126,3.838451103711925,20.0,0.0
28109,2,8109,[ 22 238 196 174 202],618,3,31129,3.838347718865598,0.0,0.0
28110,2,8110,[ 64  12 269 301 357],416,5,31134,3.8384909382320305,40.0,0.0
28111,2,8111,[423  25 515 748 202],416,5,31139,3.8386341222879685,0.0,0.0
28112,2,8112,[ 64  12 269 301 357],416,5,31144,3.8387772710464687,40.0,0.0
28113,2,8113,[ 64  12 269 301 357],416,5,31149,3.838920384520582,40.0,0.0
28114,2,8114,[ 70 403 125 318 179],373,3,31152,3.8388170055452866,20.0,0.0
28115,2,8115,[ 64  12 269 301 357],416,5,31157,3.8389600788565796,40.0,0.0
28116,2,8116,[ 98 176  12   8 288],62,4,31161,3.8389799186891707,20.0,40.0
28117,2,8117,[385 496 228 216 196],417,2,31163,3.8387533875338753,0.0,0.0
28118,2,8118,[ 64  12 269 301 357],416,5,31168,3.8388964158147556,40.0,0.0
28119,2,8119,[ 15 186  70   8 238],618,1,31169,3.8385467980295567,0.0,0.0
28120,2,8120,[143 294 245 200 289],416,3,31172,3.8384435414357836,0.0,0.0
28121,2,8121,[ 64  12 269 301 357],416,5,31177,3.8385865550357057,40.0,0.0
28122,2,8122,[ 28 568 215 588 435],373,3,31180,3.8384833189708236,0.0,0.0
28123,2,8123,[234 313 275 328 172],416,5,31185,3.838626292466765,20.0,20.0
28124,2,8124,[ 64  12 269 301 357],416,5,31190,3.838769230769231,40.0,0.0
28125,2,8125,[168 135 318 151 180],198,4,31194,3.8387890721142015,20.0,0.0
28126,2,8126,[117 294 475  97 235],62,3,31197,3.8386858619416757,0.0,0.0
28127,2,8127,[588 182 294  56 268],297,3,31200,3.838582677165354,0.0,0.0
28128,2,8128,[144 471  96  88 496],618,3,31203,3.8384795177758644,0.0,0.0
28129,2,8129,[ 56 323 294  89  50],417,3,31206,3.838376383763838,0.0,20.0
28130,2,8130,[313  95 132 181  22],642,4,31210,3.838396261222482,20.0,40.0
28131,2,8131,[ 64  12 269 301 357],416,5,31215,3.838539104771274,40.0,0.0
28132,2,8132,[ 64  12 269 301 357],416,5,31220,3.8386819131931635,40.0,0.0
28133,2,8133,[ 64  12 269 301 357],416,5,31225,3.8388246865011064,40.0,0.0
28134,2,8134,[265 496 215 275 216],373,5,31230,3.8389674247080516,0.0,0.0
28135,2,8135,[174 195 318 423 385],373,3,31233,3.838864306784661,20.0,0.0
28136,2,8136,[ 64  12 269 301 357],416,5,31238,3.839007005038712,40.0,0.0
28137,2,8137,[182 135 282  79 568],618,4,31242,3.839026787908577,0.0,0.0
28138,2,8138,[ 96  70 603  25 111],416,5,31247,3.839169431134046,0.0,0.0
28139,2,8139,[210 588 151 568 276],922,2,31249,3.838943488943489,0.0,0.0
28140,2,8140,[328 153   8 234 276],416,4,31253,3.8389632723252674,0.0,0.0
28141,2,8141,[ 64  12 269 301 357],416,5,31258,3.839105870793417,40.0,0.0
28142,2,8142,[ 64  12 269 301 357],416,5,31263,3.8392484342379958,40.0,0.0
28143,2,8143,[ 64  12 269 301 357],416,5,31268,3.8393909626719056,40.0,0.0
28144,2,8144,[ 98 172 176 186  56],405,4,31272,3.839410681399632,0.0,20.0
28145,2,8145,[185 288 181 200 546],416,4,31276,3.83943039528603,0.0,40.0
28146,2,8146,[176 200 268 748  70],417,5,31281,3.8395728489014362,0.0,0.0
28147,2,8147,[194 153 294 121 257],416,4,31285,3.8395925380461464,0.0,0.0
28148,2,8148,[ 64  12 269 301 357],416,5,31290,3.8397349368020617,40.0,0.0
28149,2,8149,[200 245 187 588 496],416,4,31294,3.839754601226994,0.0,0.0
28150,2,8150,[ 64  12 269 301 357],416,5,31299,3.839896945160103,40.0,0.0
28151,2,8151,[300 173 385 215 423],654,5,31304,3.8400392541707555,0.0,0.0
28152,2,8152,[269 191  50 173 186],854,4,31308,3.840058874034098,0.0,20.0
28153,2,8153,[313 475 269 568  64],214,4,31312,3.8400784890851116,40.0,20.0
28154,2,8154,[127   9 132  50 655],62,4,31316,3.840098099325567,0.0,20.0
28155,2,8155,[180  56 111 195 176],437,2,31318,3.8398724865129967,0.0,0.0
28156,2,8156,[328 546 181  95   4],43,5,31323,3.840014711290916,0.0,20.0
28157,2,8157,[ 64  12 269 301 357],416,5,31328,3.840156901201275,40.0,0.0
28158,2,8158,[ 96 483   8 117  82],618,3,31331,3.840053928177473,20.0,0.0
28159,2,8159,[ 64  12 269 301 357],416,5,31336,3.8401960784313727,40.0,0.0
28160,2,8160,[ 64  12 269 301 357],416,5,31341,3.840338193848793,40.0,0.0
28161,2,8161,[258 196 597 144 202],43,4,31345,3.840357755452095,0.0,0.0
28162,2,8162,[ 64  12 269 301 357],416,5,31350,3.840499816244028,40.0,0.0
28163,2,8163,[ 64  12 269 301 357],416,5,31355,3.840641842234199,40.0,0.0
28164,2,8164,[258  98 546 318 405],274,4,31359,3.8406613594611145,20.0,20.0
28165,2,8165,[597  79 588 403 151],416,3,31362,3.840558412931668,0.0,0.0
28166,2,8166,[172 546  22 742 385],805,1,31363,3.840210603648831,0.0,0.0
28167,2,8167,[216  50 200 195 742],854,2,31365,3.8399853085210576,0.0,20.0
28168,2,8168,[168 603 269 275  64],416,5,31370,3.8401273105643288,20.0,0.0
28169,2,8169,[ 64  12 269 301 357],416,5,31375,3.840269277845777,40.0,0.0
28170,2,8170,[ 64  12 269 301 357],416,5,31380,3.840411210378167,40.0,0.0
28171,2,8171,[191 245 496  64 313],416,4,31384,3.840430739109153,40.0,20.0
28172,2,8172,[ 64  12 269 301 357],416,5,31389,3.8405726171540437,40.0,0.0
28173,2,8173,[  7 194 144  28  95],416,4,31393,3.840592121360411,0.0,0.0
28174,2,8174,[132  15  97  96  28],416,5,31398,3.8407339449541285,0.0,0.0
28175,2,8175,[144  28 405 204 237],416,4,31402,3.8407534246575343,0.0,0.0
28176,2,8176,[471 265  11 322 234],416,4,31406,3.840772899596429,0.0,0.0
28177,2,8177,[ 64  12 269 301 357],416,5,31411,3.8409146490584494,40.0,0.0
28178,2,8178,[257 216 132  89 286],711,4,31415,3.840934099523169,0.0,0.0
28179,2,8179,[ 89 176 196  25  95],417,4,31419,3.840953545232274,0.0,0.0
28180,2,8180,[204 282 144  64   8],416,5,31424,3.8410952206331745,20.0,0.0
28181,2,8181,[ 50 191   1 185 181],198,4,31428,3.841114641896847,0.0,40.0
28182,2,8182,[ 56 496 211 678 187],416,4,31432,3.8411340584137847,0.0,0.0
28183,2,8183,[153 302 276 121  69],43,5,31437,3.841275659824047,0.0,0.0
28184,2,8184,[265 385 173 546   8],654,5,31442,3.841417226634087,0.0,0.0
28185,2,8185,[ 64  12 269 301 357],416,5,31447,3.8415587588565843,40.0,0.0
28186,2,8186,[173 423 125  96 234],642,3,31450,3.841455966776597,0.0,0.0
28187,2,8187,[191 237 111  69 294],764,3,31453,3.8413531998045922,0.0,0.0
28188,2,8188,[357  11 195 289 322],854,2,31455,3.841128342899011,0.0,0.0
28189,2,8189,[ 64  12 269 301 357],416,5,31460,3.8412698412698414,40.0,0.0
28190,2,8190,[ 64  12 269 301 357],416,5,31465,3.8414113050909533,40.0,0.0
28191,2,8191,[ 64  12 269 301 357],416,5,31470,3.841552734375,40.0,0.0
28192,2,8192,[ 11 185 403  70 161],618,4,31474,3.8415720737214696,0.0,0.0
28193,2,8193,[237 257  22 173 222],922,5,31479,3.8417134488650233,0.0,0.0
28194,2,8194,[597 294  82 318 234],588,5,31484,3.8418547895057964,20.0,0.0
28195,2,8195,[183 228 127  50  98],198,4,31488,3.841874084919473,0.0,40.0
28196,2,8196,[ 64  12 269 301 357],416,5,31493,3.8420153714773697,40.0,0.0
28197,2,8197,[118 282 144  11 182],416,4,31497,3.8420346425957552,0.0,0.0
28198,2,8198,[174 269 435 197 153],297,3,31500,3.841931942919868,0.0,0.0
28199,2,8199,[ 64  12 269 301 357],416,5,31505,3.8420731707317075,40.0,0.0
28200,2,8200,[ 64  12 269 301 357],416,5,31510,3.8422143641019386,40.0,0.0
28201,2,8201,[237  97 161 276 216],128,4,31514,3.842233601560595,0.0,0.0
28202,2,8202,[ 64  12 269 301 357],416,5,31519,3.8423747409484337,40.0,0.0
28203,2,8203,[237 174 268 678 181],654,3,31522,3.8422720624085813,0.0,20.0
28204,2,8204,[318 245 742 172 125],907,5,31527,3.8424131627056672,20.0,0.0
28205,2,8205,[174 294 282 118 603],854,1,31528,3.842066780404582,0.0,0.0
28206,2,8206,[179 118 222 655  98],417,4,31532,3.8420860241257464,0.0,20.0
28207,2,8207,[ 64  28 185 313 403],618,5,31537,3.842227095516569,40.0,20.0
28208,2,8208,[ 64  12 269 301 357],416,5,31542,3.842368132537459,40.0,0.0
28209,2,8209,[ 64  12 269 301 357],416,5,31547,3.8425091352009746,40.0,0.0
28210,2,8210,[183  95 182  11  69],437,1,31548,3.8421629521373766,0.0,0.0
28211,2,8211,[269 603  15 275 333],416,5,31553,3.842303945445689,0.0,0.0
28212,2,8212,[ 64  12 269 301 357],416,5,31558,3.842444904419822,40.0,0.0
28213,2,8213,[ 28  70 238 179 125],262,3,31561,3.8423423423423424,0.0,0.0
28214,2,8214,[333 121 588 125 385],345,0,31561,3.841874619598296,0.0,0.0
28215,2,8215,[ 71 185 405 318  98],416,5,31566,3.8420155793573514,20.0,20.0
28216,2,8216,[ 64 161 385 195  88],373,4,31570,3.8420348058902274,20.0,0.0
28217,2,8217,[318  96 195 228 276],12,5,31575,3.842175711852032,20.0,0.0
28218,2,8218,[ 64  12 269 301 357],416,5,31580,3.8423165835259763,40.0,0.0
28219,2,8219,[ 64  12 269 301 357],416,5,31585,3.8424574209245743,40.0,0.0
28220,2,8220,[100 127 265 118 180],198,1,31586,3.8421116652475367,0.0,0.0
28221,2,8221,[ 71 195 265 117 161],373,5,31591,3.84225249331063,0.0,0.0
28222,2,8222,[168 748  56  15 151],416,4,31595,3.842271677003527,0.0,0.0
28223,2,8223,[ 64  12 269 301 357],416,5,31600,3.842412451361868,40.0,0.0
28224,2,8224,[471 288 475 216  98],588,3,31603,3.842310030395137,0.0,40.0
28225,2,8225,[ 50 204 185 111 197],416,5,31608,3.8424507658643328,0.0,20.0
28226,2,8226,[ 28 322 132 405  79],128,3,31611,3.842348365139176,0.0,0.0
28227,2,8227,[301 286 515 318 185],416,5,31616,3.8424890617403986,20.0,0.0
28228,2,8228,[ 64  12 269 301 357],416,5,31621,3.842629724146312,40.0,0.0
28229,2,8229,[323  79 181  89 238],751,2,31623,3.8424058323207775,0.0,20.0
28230,2,8230,[117 276 143 403 258],198,2,31625,3.8421819948973392,0.0,0.0
28231,2,8231,[ 88 111 194 300 235],416,3,31628,3.8420796890184645,0.0,0.0
28232,2,8232,[302 215 257 194  89],751,4,31632,3.8420988703996115,0.0,0.0
28233,2,8233,[202 197 597 191  22],618,3,31635,3.8419965994656304,0.0,0.0
28234,2,8234,[ 50  69 257 294 268],417,2,31637,3.841772920461445,0.0,20.0
28235,2,8235,[ 64  12 269 301 357],416,5,31642,3.84191355026712,40.0,0.0
28236,2,8236,[546 151 323 234 181],416,2,31644,3.8416899356561856,0.0,20.0
28237,2,8237,[ 22  79 111 151 194],297,1,31645,3.8413449866472447,0.0,0.0
28238,2,8238,[ 64  12 269 301 357],416,5,31650,3.8414856171865517,40.0,0.0
28239,2,8239,[471 121  95 268 318],416,4,31654,3.841504854368932,20.0,0.0
28240,2,8240,[132 174   8 197 191],405,5,31659,3.841645431379687,0.0,0.0
28241,2,8241,[294  88 181 175 222],43,4,31663,3.841664644503761,0.0,20.0
28242,2,8242,[588 185  97   4  50],297,4,31667,3.841683852966153,0.0,20.0
28243,2,8243,[ 64  12 269 301 357],416,5,31672,3.8418243571082,40.0,0.0
28244,2,8244,[ 71  56 275 483 172],618,4,31676,3.8418435415403276,20.0,0.0
28245,2,8245,[100 269 496  12 121],214,4,31680,3.8418627213194276,20.0,0.0
28246,2,8246,[237 286 100  15  89],342,3,31683,3.841760640232812,0.0,0.0
28247,2,8247,[483 265 153 180  69],437,3,31686,3.841658583899127,20.0,0.0
28248,2,8248,[ 64 191 117 194 265],416,5,31691,3.841799005940114,20.0,0.0
28249,2,8249,[ 11 294 168  98 546],43,5,31696,3.841939393939394,0.0,20.0
28250,2,8250,[ 64  12 269 301 357],416,5,31701,3.8420797479093443,40.0,0.0
28251,2,8251,[357 678  50 748 168],416,4,31705,3.842098885118759,0.0,20.0
28252,2,8252,[ 64  12 269 301 357],416,5,31710,3.842239185750636,40.0,0.0
28253,2,8253,[172 405 204 153 475],416,4,31714,3.8422582990065424,0.0,0.0
28254,2,8254,[258 143 496   9 204],43,5,31719,3.8423985463355543,0.0,0.0
28255,2,8255,[100 182 191 405 181],198,3,31722,3.842296511627907,0.0,20.0
28256,2,8256,[204 423  98  15 168],654,4,31726,3.8423156109967302,0.0,20.0
28257,2,8257,[ 64  12 269 301 357],416,5,31731,3.842455800435941,40.0,0.0
28258,2,8258,[ 64  12 269 301 357],416,5,31736,3.8425959559268676,40.0,0.0
28259,2,8259,[258  50 301 173 294],345,4,31740,3.8426150121065374,0.0,20.0
28260,2,8260,[ 64  12 269 301 357],416,5,31745,3.8427551143929306,40.0,0.0
28261,2,8261,[ 11 257 265 143 268],654,4,31749,3.8427741466957155,0.0,0.0
28262,2,8262,[238   7  50 197 597],618,3,31752,3.8426721529710757,0.0,20.0
28263,2,8263,[204 118 168 271  56],43,4,31756,3.8426911907066796,0.0,0.0
28264,2,8264,[ 64  12 269 301 357],416,5,31761,3.842831215970962,40.0,0.0
28265,2,8265,[ 64  12 269 301 357],416,5,31766,3.842971207355432,40.0,0.0
28266,2,8266,[ 64  12 269 301 357],416,5,31771,3.843111164872384,40.0,0.0
28267,2,8267,[174 121 100  56 118],43,5,31776,3.8432510885341076,0.0,0.0
28268,2,8268,[202 195 215 357 175],373,3,31779,3.8431491111379854,0.0,0.0
28269,2,8269,[603   8 185  12 276],437,5,31784,3.8432889963724306,20.0,0.0
28270,2,8270,[121 143 127 185 318],618,5,31789,3.843428847781405,20.0,0.0
28271,2,8271,[423 204  82 191 603],128,5,31794,3.843568665377176,0.0,0.0
28272,2,8272,[ 64  12 269 301 357],416,5,31799,3.8437084491720053,40.0,0.0
28273,2,8273,[144 234 269  69 174],297,2,31801,3.8434856175972927,0.0,0.0
28274,2,8274,[204  12 180 121 144],437,3,31804,3.843383685800604,20.0,0.0
28275,2,8275,[174 423 204 597 173],416,4,31808,3.8434026099565006,0.0,0.0
28276,2,8276,[ 64  12 269 301 357],416,5,31813,3.8435423462607226,40.0,0.0
28277,2,8277,[ 98 405   8 301 496],416,5,31818,3.843682048804059,0.0,20.0
28278,2,8278,[191 475 180   9 111],854,4,31822,3.8437009300640175,0.0,0.0
28279,2,8279,[ 64  12 269 301 357],416,5,31827,3.843840579710145,40.0,0.0
28280,2,8280,[ 15  70 144 211 216],43,5,31832,3.8439801956285473,0.0,0.0
28281,2,8281,[117 111 300 385 153],654,5,31837,3.8441197778314415,0.0,0.0
28282,2,8282,[222 235  95 286  50],297,3,31840,3.8440178679222505,0.0,20.0
28283,2,8283,[ 98 100 568   7 185],618,5,31845,3.8441574118783195,0.0,20.0
28284,2,8284,[ 64  12 269 301 357],416,5,31850,3.844296922148461,40.0,0.0
28285,2,8285,[323 161 200 268 289],416,3,31853,3.8441950277576633,0.0,0.0
28286,2,8286,[318  79  89 269 515],354,2,31855,3.843972487027875,20.0,0.0
28287,2,8287,[118 125 496 216  70],630,2,31857,3.84375,0.0,0.0
28288,2,8288,[183 191 483 742 405],62,3,31860,3.8436482084690553,20.0,0.0
28289,2,8289,[ 64  12 269 301 357],416,5,31865,3.8437876960193003,40.0,0.0
28290,2,8290,[ 89 191 121 546 385],705,2,31867,3.843565311783862,0.0,0.0
28291,2,8291,[ 64  12 269 301 357],416,5,31872,3.8437047756874096,40.0,0.0
28292,2,8292,[ 64  12 269 301 357],416,5,31877,3.843844205956831,40.0,0.0
28293,2,8293,[ 64  12 269 301 357],416,5,31882,3.8439836026042924,40.0,0.0
28294,2,8294,[ 64  12 269 301 357],416,5,31887,3.844122965641953,40.0,0.0
28295,2,8295,[ 64  12 269 301 357],416,5,31892,3.8442622950819674,40.0,0.0
28296,2,8296,[ 82 588 117 318 475],588,4,31896,3.8442810654453416,20.0,0.0
28297,2,8297,[228 186 257 127 357],601,4,31900,3.844299831284647,0.0,0.0
28298,2,8298,[132 180  98 286 168],437,3,31903,3.8441980961561635,0.0,20.0
28299,2,8299,[153  97 196 204 288],297,3,31906,3.844096385542169,0.0,20.0
28300,2,8300,[ 64  12 269 301 357],416,5,31911,3.8442356342609325,40.0,0.0
28301,2,8301,[ 96 179 143 273 200],805,3,31914,3.8441339436280413,0.0,0.0
28302,2,8302,[588 238  56 185  70],405,3,31917,3.8440322774900637,0.0,0.0
28303,2,8303,[ 50 655 215 245 300],345,3,31920,3.8439306358381504,0.0,20.0
28304,2,8304,[174 322 258 328 238],128,1,31921,3.8435881998795907,0.0,0.0
28305,2,8305,[322 172 294 275 173],907,5,31926,3.8437274259571392,0.0,0.0
28306,2,8306,[176 323   1  15 186],417,4,31930,3.8437462381124354,0.0,0.0
28307,2,8307,[183 271 144 111 302],297,2,31932,3.8435243139142994,0.0,0.0
28308,2,8308,[121 234 182 568 288],416,5,31937,3.8436634974124444,0.0,20.0
28309,2,8309,[ 11 176 568  89 222],805,3,31940,3.8435619735258726,0.0,0.0
28310,2,8310,[ 64  12 269 301 357],416,5,31945,3.843701118998917,40.0,0.0
28311,2,8311,[ 96 228 195 174 313],405,3,31948,3.843599615014437,20.0,20.0
28312,2,8312,[ 97 111 118 333 181],588,2,31950,3.84337784193432,0.0,20.0
28313,2,8313,[300 211  56 471 423],416,5,31955,3.843516959345682,0.0,0.0
28314,2,8314,[117 174   1 125 288],588,3,31958,3.843415514131088,0.0,20.0
28315,2,8315,[ 64  12 269 301 357],416,5,31963,3.8435545935545936,40.0,0.0
28316,2,8316,[194 135 328 204 196],721,4,31967,3.8435734038715883,0.0,0.0
28317,2,8317,[258 182  95 222 471],297,2,31969,3.843351767251743,0.0,0.0
28318,2,8318,[151 216 161 144 237],416,3,31972,3.843250390671956,0.0,0.0
28319,2,8319,[100 258   1 210 294],262,1,31973,3.8429086538461537,0.0,0.0
28320,2,8320,[  7 210 121 118  88],43,5,31978,3.8430477106117054,0.0,0.0
28321,2,8321,[301 357  82 385 182],416,5,31983,3.8431867339581833,0.0,0.0
28322,2,8322,[ 64  12 269 301 357],416,5,31988,3.843325723897633,40.0,0.0
28323,2,8323,[403 323 179 121 423],416,3,31991,3.8432244113407017,0.0,0.0
28324,2,8324,[ 64  12 269 301 357],416,5,31996,3.8433633633633635,40.0,0.0
28325,2,8325,[ 79 235 258 153 515],416,4,32000,3.843382176315157,0.0,0.0
28326,2,8326,[568 423 276 475 300],416,3,32003,3.843280893479044,0.0,0.0
28327,2,8327,[ 64  12 269 301 357],416,5,32008,3.8434197886647454,40.0,0.0
28328,2,8328,[328 235 195 271 194],854,1,32009,3.8430784007683996,0.0,0.0
28329,2,8329,[168  56 300 215 748],654,5,32014,3.843217286914766,0.0,0.0
28330,2,8330,[ 64  12 269 301 357],416,5,32019,3.843356139719121,40.0,0.0
28331,2,8331,[273 276 222 318   4],764,2,32021,3.8431349015842535,20.0,0.0
28332,2,8332,[174 216   1 194 286],297,3,32024,3.843033721348854,0.0,0.0
28333,2,8333,[ 64  12 269 301 357],416,5,32029,3.843172546196304,40.0,0.0
28334,2,8334,[ 64  12 269 301 357],416,5,32034,3.8433113377324535,40.0,0.0
28335,2,8335,[ 11   4 403 216 322],416,4,32038,3.843330134357006,0.0,0.0
28336,2,8336,[161  98 173  89 216],711,4,32042,3.8433489264723524,0.0,20.0
28337,2,8337,[ 64  12 269 301 357],416,5,32047,3.843487646917726,40.0,0.0
28338,2,8338,[127 288 568 475 237],416,3,32050,3.8433864971819163,0.0,20.0
28339,2,8339,[ 64  12 269 301 357],416,5,32055,3.843525179856115,40.0,0.0
28340,2,8340,[187  82 191 471  95],373,2,32057,3.843304160172641,0.0,0.0
28341,2,8341,[ 64  12 269 301 357],416,5,32062,3.8434428194677537,40.0,0.0
28342,2,8342,[257 191 288 175 196],214,3,32065,3.843341723600623,0.0,20.0
28343,2,8343,[ 22 237 125 127 174],505,2,32067,3.8431208053691277,0.0,0.0
28344,2,8344,[288 678  15 294 588],654,2,32069,3.8428999400838824,0.0,20.0
28345,2,8345,[194  95 117 496 328],416,4,32073,3.8429187634795112,0.0,0.0
28346,2,8346,[  9 151 195 179 403],62,5,32078,3.8430573858871453,0.0,0.0
28347,2,8347,[748 742 179 196  89],805,2,32080,3.8428366075706757,0.0,0.0
28348,2,8348,[ 12 200 211 172 238],417,4,32084,3.842855431788238,20.0,0.0
28349,2,8349,[ 64  12 269 301 357],416,5,32089,3.8429940119760477,40.0,0.0
28350,2,8350,[196 168  96  22 515],416,5,32094,3.843132558974973,0.0,0.0
28351,2,8351,[748 282 210  50  22],416,5,32099,3.843271072796935,0.0,20.0
28352,2,8352,[ 71  50 144 200   1],618,5,32104,3.843409553453849,0.0,20.0
28353,2,8353,[216 271 265 471 196],297,2,32106,3.8431888915489587,0.0,0.0
28354,2,8354,[135 588 173 238 191],297,4,32110,3.8432076600837823,0.0,0.0
28355,2,8355,[ 64  12 269 301 357],416,5,32115,3.843346098611776,40.0,0.0
28356,2,8356,[496 185 257 597 176],417,1,32116,3.8430058633480915,0.0,0.0
28357,2,8357,[475 182  56 568  69],416,4,32120,3.8430246470447473,0.0,0.0
28358,2,8358,[ 28 168 471 328 286],43,4,32124,3.8430434262471587,0.0,0.0
28359,2,8359,[118  11 197 151 288],618,1,32125,3.8427033492822966,0.0,20.0
28360,2,8360,[568  95 357 175 222],698,2,32127,3.8424829565841407,0.0,0.0
28361,2,8361,[ 64  12 269 301 357],416,5,32132,3.842621382444391,40.0,0.0
28362,2,8362,[ 64  12 269 301 357],416,5,32137,3.842759775200287,40.0,0.0
28363,2,8363,[257 288 195 176 742],297,1,32138,3.842419894787183,0.0,20.0
28364,2,8364,[ 64  12 269 301 357],416,5,32143,3.842558278541542,40.0,0.0
28365,2,8365,[405 228 237  82  25],128,3,32146,3.8424575663399474,0.0,0.0
28366,2,8366,[  1 268 111 276  97],416,4,32150,3.8424763953627346,0.0,0.0
28367,2,8367,[195 175 403   8 655],405,4,32154,3.842495219885277,0.0,0.0
28368,2,8368,[125 275 196 265 216],416,5,32159,3.8426335284980286,0.0,0.0
28369,2,8369,[ 64  12 269 301 357],416,5,32164,3.8427718040621266,40.0,0.0
28370,2,8370,[ 64  12 269 301 357],416,5,32169,3.8429100465894157,40.0,0.0
28371,2,8371,[ 64  12 269 301 357],416,5,32174,3.8430482560917345,40.0,0.0
28372,2,8372,[282 125  82 289 204],588,3,32177,3.842947569568852,0.0,0.0
28373,2,8373,[174 245 210 294 328],921,4,32181,3.8429663243372345,0.0,0.0
28374,2,8374,[ 64  12 269 301 357],416,5,32186,3.8431044776119405,40.0,0.0
28375,2,8375,[ 64  12 269 301 357],416,5,32191,3.8432425978987586,40.0,0.0
28376,2,8376,[ 71 176   1 153 286],62,3,32194,3.8431419362540287,0.0,0.0
28377,2,8377,[ 98 483   1  22 496],588,3,32197,3.8430412986392932,20.0,20.0
28378,2,8378,[ 64  12 269 301 357],416,5,32202,3.8431793770139633,40.0,0.0
28379,2,8379,[ 64  12 269 301 357],416,5,32207,3.8433174224343674,40.0,0.0
28380,2,8380,[  8  71 168 215 121],654,4,32211,3.8433361174084237,0.0,0.0
28381,2,8381,[ 64  12 269 301 357],416,5,32216,3.8434741111906465,40.0,0.0
28382,2,8382,[ 98 144 173 286 268],417,4,32220,3.8434927830132413,0.0,20.0
28383,2,8383,[748  98 118   9 191],805,2,32222,3.843272900763359,0.0,20.0
28384,2,8384,[ 64  12 269 301 357],416,5,32227,3.8434108527131783,40.0,0.0
28385,2,8385,[ 64  12 269 301 357],416,5,32232,3.8435487717624612,40.0,0.0
28386,2,8386,[322 143 118 238 117],128,4,32236,3.84356742577799,0.0,0.0
28387,2,8387,[ 97 333  79 483 588],253,4,32240,3.843586075345732,20.0,0.0
28388,2,8388,[ 95 143 100 258 471],416,4,32244,3.8436047204672787,0.0,0.0
28389,2,8389,[127 172 475 228 245],62,3,32247,3.843504171632896,0.0,0.0
28390,2,8390,[ 12 546  15  28 173],62,3,32250,3.8434036467643904,20.0,0.0
28391,2,8391,[385 210 588 215 151],345,3,32253,3.8433031458531937,0.0,0.0
28392,2,8392,[508 322  15 186 144],417,2,32255,3.8430835219826047,0.0,0.0
28393,2,8393,[ 64  12 269 301 357],416,5,32260,3.8432213485823206,40.0,0.0
28394,2,8394,[ 64  12 269 301 357],416,5,32265,3.843359142346635,40.0,0.0
28395,2,8395,[ 64  12 269 301 357],416,5,32270,3.8434969032872797,40.0,0.0
28396,2,8396,[ 64  12 269 301 357],416,5,32275,3.843634631415982,40.0,0.0
28397,2,8397,[405  50 181 117 238],345,5,32280,3.843772326744463,0.0,40.0
28398,2,8398,[269  98 333 200  11],416,5,32285,3.843909989284439,0.0,20.0
28399,2,8399,[202  69 144 268 301],416,5,32290,3.844047619047619,0.0,0.0
28400,2,8400,[174 568  89 257 191],642,4,32294,3.84406618259731,0.0,0.0
28401,2,8401,[161  64  50 286 265],416,5,32299,3.8442037610092834,20.0,20.0
28402,2,8402,[323  56   7 496  69],43,4,32303,3.844222301558967,0.0,0.0
28403,2,8403,[ 82 121  56 200 357],416,5,32308,3.8443598286530225,0.0,0.0
28404,2,8404,[238 151 508 168  69],417,3,32311,3.8442593694229625,0.0,0.0
28405,2,8405,[174  70  28 271 117],43,4,32315,3.8442778967404236,0.0,0.0
28406,2,8406,[151 257 153 483 173],854,4,32319,3.8442964196502913,20.0,0.0
28407,2,8407,[496  79  22 475  12],588,3,32322,3.8441960038058993,20.0,0.0
28408,2,8408,[ 64  12 269 301 357],416,5,32327,3.844333452253538,40.0,0.0
28409,2,8409,[195  56 234 748 568],198,1,32328,3.8439952437574316,0.0,0.0
28410,2,8410,[216 202 403 151 496],711,5,32333,3.844132683390798,0.0,0.0
28411,2,8411,[ 64  12 269 301 357],416,5,32338,3.844270090347123,40.0,0.0
28412,2,8412,[151 313 117  28 323],43,4,32342,3.844288600974682,20.0,20.0
28413,2,8413,[222 100 234 403 323],417,2,32344,3.8440694081293083,0.0,0.0
28414,2,8414,[ 88 258 200 174 322],805,1,32345,3.843731431966726,0.0,0.0
28415,2,8415,[  7 202   4 423 216],297,2,32347,3.8435123574144487,0.0,0.0
28416,2,8416,[ 64  12 269 301 357],416,5,32352,3.843649756445289,40.0,0.0
28417,2,8417,[174 357 117 195  97],62,4,32356,3.8436683297695415,0.0,0.0
28418,2,8418,[ 64  12 269 301 357],416,5,32361,3.8438056776339233,40.0,0.0
28419,2,8419,[ 96  69 496  70 471],373,4,32365,3.8438242280285038,0.0,0.0
28420,2,8420,[ 64  12 269 301 357],416,5,32370,3.84396152475953,40.0,0.0
28421,2,8421,[597 210 132 100  12],588,4,32374,3.8439800522441225,20.0,0.0
28422,2,8422,[496 191 117 132  50],505,3,32377,3.8438798527840436,0.0,20.0
28423,2,8423,[ 64  12 269 301 357],416,5,32382,3.844017094017094,40.0,0.0
28424,2,8424,[742 235 237 183 603],416,3,32385,3.8439169139465874,0.0,0.0
28425,2,8425,[ 64  12 269 301 357],416,5,32390,3.844054118205554,40.0,0.0
28426,2,8426,[176 210 238 288 483],62,4,32394,3.844072623709505,20.0,20.0
28427,2,8427,[258 313 282 245 328],416,4,32398,3.8440911248220218,20.0,20.0
28428,2,8428,[215 117 288  82  98],62,3,32401,3.843990983509313,0.0,40.0
28429,2,8429,[125 222 323 117  98],630,4,32405,3.8440094899169632,0.0,20.0
28430,2,8430,[168 318 289 282 132],854,3,32408,3.843909382042462,20.0,0.0
28431,2,8431,[385 268 235 288 302],417,2,32410,3.8436907020872866,0.0,20.0
28432,2,8432,[ 64  12 269 301 357],416,5,32415,3.8438278192813944,40.0,0.0
28433,2,8433,[ 64  12 269 301 357],416,5,32420,3.843964903960161,40.0,0.0
28434,2,8434,[328 423 196 435 111],721,5,32425,3.8441019561351513,0.0,0.0
28435,2,8435,[ 71 181 183 200 385],618,5,32430,3.844238975817923,0.0,20.0
28436,2,8436,[  8 282 174 238  97],416,5,32435,3.8443759630200307,0.0,0.0
28437,2,8437,[318 603 301 257  98],416,4,32439,3.844394406257407,20.0,20.0
28438,2,8438,[ 64  12 269 301 357],416,5,32444,3.8445313425761345,40.0,0.0
28439,2,8439,[ 64  12 269 301 357],416,5,32449,3.8446682464454978,40.0,0.0
28440,2,8440,[186 405 127 195  64],198,3,32452,3.844568179125696,20.0,0.0
28441,2,8441,[ 64  12 269 301 357],416,5,32457,3.8447050461975834,40.0,0.0
28442,2,8442,[ 64  12 269 301 357],416,5,32462,3.84484188084804,40.0,0.0
28443,2,8443,[ 64  12 269 301 357],416,5,32467,3.8449786830885837,40.0,0.0
28444,2,8444,[ 64  12 269 301 357],416,5,32472,3.8451154529307283,40.0,0.0
28445,2,8445,[172  12  96 202  56],618,3,32475,3.8450153919014918,20.0,0.0
28446,2,8446,[  9 268 294  96 328],854,1,32476,3.8446785841127027,0.0,0.0
28447,2,8447,[588 186 121 258 289],43,4,32480,3.8446969696969697,0.0,0.0
28448,2,8448,[475 161  15  79  98],416,4,32484,3.844715350929104,0.0,20.0
28449,2,8449,[ 50 748 215 405 121],345,3,32487,3.8446153846153845,0.0,20.0
28450,2,8450,[196  25  11 132 194],416,5,32492,3.844752100343155,0.0,0.0
28451,2,8451,[200  15 125 405  56],262,1,32493,3.844415522953147,0.0,0.0
28452,2,8452,[202 222 215 742   7],297,2,32495,3.8441973263929965,0.0,0.0
28453,2,8453,[655  50 245 202 111],417,3,32498,3.844097468653892,0.0,20.0
28454,2,8454,[588 597 265 235  50],417,0,32498,3.8436428149024247,0.0,20.0
28455,2,8455,[132  69  70 191 228],417,3,32501,3.843543046357616,0.0,0.0
28456,2,8456,[ 64  12 269 301 357],416,5,32506,3.8436797918883765,40.0,0.0
28457,2,8457,[ 64  12 269 301 357],416,5,32511,3.8438165050839443,40.0,0.0
28458,2,8458,[333 275  82 288 268],416,5,32516,3.8439531859557867,0.0,20.0
28459,2,8459,[258   7 235 245 197],416,3,32519,3.843853427895981,0.0,0.0
28460,2,8460,[168  69 655 294 275],588,2,32521,3.843635504077532,0.0,0.0
28461,2,8461,[ 64  12 269 301 357],416,5,32526,3.8437721578822974,40.0,0.0
28462,2,8462,[ 64  12 269 301 357],416,5,32531,3.8439087793926503,40.0,0.0
28463,2,8463,[234  88 235 597 195],416,2,32533,3.8436909262759924,0.0,0.0
28464,2,8464,[222 568  95 185   8],711,3,32536,3.8435912581216773,0.0,0.0
28465,2,8465,[ 64  12 269 301 357],416,5,32541,3.843727852586818,40.0,0.0
28466,2,8466,[185 265  79  70  50],405,3,32544,3.843628203614031,0.0,20.0
28467,2,8467,[ 64  12 269 301 357],416,5,32549,3.843764761454889,40.0,0.0
28468,2,8468,[515   1 273 323 302],416,4,32553,3.8437832093517534,0.0,0.0
28469,2,8469,[ 64  12 269 301 357],416,5,32558,3.8439197166469894,40.0,0.0
28470,2,8470,[202 174 301 265 191],416,5,32563,3.844056191712903,0.0,0.0
28471,2,8471,[173 186  69 118 185],417,3,32566,3.8439565627950896,0.0,0.0
28472,2,8472,[197 322 125 271 742],854,2,32568,3.8437389354419924,0.0,0.0
28473,2,8473,[174  64 423 191  88],128,4,32572,3.843757375501534,20.0,0.0
28474,2,8474,[ 64  12 269 301 357],416,5,32577,3.8438938053097345,40.0,0.0
28475,2,8475,[151 176 357 288  15],417,4,32581,3.8439122227465785,0.0,20.0
28476,2,8476,[475 200  70 132   1],417,5,32586,3.8440486020997993,0.0,0.0
28477,2,8477,[ 64  12 269 301 357],416,5,32591,3.8441849492804905,40.0,0.0
28478,2,8478,[ 96 125  69   8 202],230,4,32595,3.8442033258638992,0.0,0.0
28479,2,8479,[ 64  12 269 301 357],416,5,32600,3.8443396226415096,40.0,0.0
28480,2,8480,[ 64  12 269 301 357],416,5,32605,3.8444758872774436,40.0,0.0
28481,2,8481,[216 357 588 215  22],373,4,32609,3.844494223060599,0.0,0.0
28482,2,8482,[ 98 258 168   9 195],62,5,32614,3.8446304373452787,0.0,20.0
28483,2,8483,[144 289 423  56 161],43,5,32619,3.8447666195190946,0.0,0.0
28484,2,8484,[  7 125 333 168  97],588,2,32621,3.8445492044784912,0.0,0.0
28485,2,8485,[ 97 135 185   7 144],297,4,32625,3.844567522979024,0.0,0.0
28486,2,8486,[185   9   4 228 151],805,2,32627,3.8443501826322612,0.0,0.0
28487,2,8487,[234 151 161 111   1],345,3,32630,3.8442507068803016,0.0,0.0
28488,2,8488,[ 64  12 269 301 357],416,5,32635,3.844386853575215,40.0,0.0
28489,2,8489,[ 56  22 294  79 234],588,5,32640,3.8445229681978796,0.0,0.0
28490,2,8490,[ 79 204 216 322 210],128,4,32644,3.8445412790012954,0.0,0.0
28491,2,8491,[151 597  88 245 118],642,3,32647,3.8444418276024495,0.0,0.0
28492,2,8492,[385 195 174 100  12],654,4,32651,3.84446014364771,20.0,0.0
28493,2,8493,[234 257  25 300 275],297,2,32653,3.844242995055333,0.0,0.0
28494,2,8494,[475 191 151 195 288],297,1,32654,3.8439081812831075,0.0,20.0
28495,2,8495,[ 64  12 269 301 357],416,5,32659,3.8440442561205272,40.0,0.0
28496,2,8496,[318 204 121 405 357],601,2,32661,3.8438272331411087,20.0,0.0
28497,2,8497,[125 216 204 118 471],416,4,32665,3.843845610731937,0.0,0.0
28498,2,8498,[ 64  12 269 301 357],416,5,32670,3.8439816448994,40.0,0.0
28499,2,8499,[204 216  89 269 143],805,2,32672,3.8437647058823528,0.0,0.0
28500,2,8500,[282 423 211 265 655],416,5,32677,3.8439007175626396,0.0,0.0
28501,2,8501,[258 288   4 234 118],417,3,32680,3.8438014584803577,0.0,20.0
28502,2,8502,[322 423  11 748 135],417,3,32683,3.8437022227449136,0.0,0.0
28503,2,8503,[ 64  12 269 301 357],416,5,32688,3.843838193791157,40.0,0.0
28504,2,8504,[ 64  12 269 301 357],416,5,32693,3.8439741328630217,40.0,0.0
28505,2,8505,[ 88 125  11 161 196],345,3,32696,3.8438749118269455,0.0,0.0
28506,2,8506,[ 64  12 269 301 357],416,5,32701,3.8440108146232514,40.0,0.0
28507,2,8507,[ 64  12 269 301 357],416,5,32706,3.8441466854724964,40.0,0.0
28508,2,8508,[ 69 135 515 200 273],297,3,32709,3.8440474791397343,0.0,0.0
28509,2,8509,[405  88  95 258 211],43,5,32714,3.8441833137485313,0.0,0.0
28510,2,8510,[655 405 180  89 385],805,1,32715,3.8438491364117024,0.0,0.0
28511,2,8511,[ 64  12 269 301 357],416,5,32720,3.843984962406015,40.0,0.0
28512,2,8512,[144 258 237 182 471],907,5,32725,3.844120756490074,0.0,0.0
28513,2,8513,[ 97  22 196  12  69],297,4,32729,3.8441390650692977,20.0,0.0
28514,2,8514,[322 175 185 222 742],854,3,32732,3.844039929536113,0.0,0.0
28515,2,8515,[ 28  25 161 234   7],618,4,32736,3.844058243306717,0.0,0.0
28516,2,8516,[ 64  12 269 301 357],416,5,32741,3.8441939650111543,40.0,0.0
28517,2,8517,[288  69 423 323  70],417,2,32743,3.8439774594975344,0.0,20.0
28518,2,8518,[471 275 273 153 276],416,4,32747,3.843995774151896,0.0,0.0
28519,2,8519,[ 64  12 269 301 357],416,5,32752,3.844131455399061,40.0,0.0
28520,2,8520,[ 64  12 269 301 357],416,5,32757,3.844267104799906,40.0,0.0
28521,2,8521,[  8   9 187 333 275],416,5,32762,3.844402722365642,0.0,0.0
28522,2,8522,[ 64  12 269 301 357],416,5,32767,3.8445383081074738,40.0,0.0
28523,2,8523,[423 144  71 204 196],314,3,32770,3.844439230408259,0.0,0.0
28524,2,8524,[ 64  12 269 301 357],416,5,32775,3.844574780058651,40.0,0.0
28525,2,8525,[181 196 179 475  70],62,4,32779,3.84459300961764,0.0,20.0
28526,2,8526,[210  88 748 289  98],345,3,32782,3.8444939603612056,0.0,20.0
28527,2,8527,[132 191 195 269  70],262,2,32784,3.844277673545966,0.0,0.0
28528,2,8528,[ 64  12 301 269 357],416,5,32789,3.8444131785672413,40.0,0.0
28529,2,8529,[588 204  22 313 427],711,4,32793,3.8444314185228605,20.0,20.0
28530,2,8530,[ 56  22 172 185 222],805,4,32797,3.8444496542023208,0.0,0.0
28531,2,8531,[ 64  12 301 269 357],416,5,32802,3.8445850914205346,40.0,0.0
28532,2,8532,[ 64  12 301 269 357],416,5,32807,3.8447204968944098,40.0,0.0
28533,2,8533,[121  95 276 318 185],198,1,32808,3.8443871572533395,20.0,0.0
28534,2,8534,[ 64  12 301 269 357],416,5,32813,3.844522554188635,40.0,0.0
28535,2,8535,[475 185 588  69 143],297,4,32817,3.8445407685098405,0.0,0.0
28536,2,8536,[423  69 132 245 215],128,2,32819,3.8443247042286517,0.0,0.0
28537,2,8537,[234 200 161  96 111],618,3,32822,3.8442258140079644,0.0,0.0
28538,2,8538,[318 403 191 196 197],345,4,32826,3.8442440566811102,20.0,0.0
28539,2,8539,[475  50  70 742 403],416,4,32830,3.8442622950819674,0.0,20.0
28540,2,8540,[ 96 174 228 423 143],405,3,32833,3.844163446903173,0.0,0.0
28541,2,8541,[ 50 135 268 357  12],854,4,32837,3.8441816904706156,20.0,20.0
28542,2,8542,[ 28 204 196 111 496],654,5,32842,3.844316984665808,0.0,0.0
28543,2,8543,[318 117 179 191  69],214,4,32846,3.8443352059925093,20.0,0.0
28544,2,8544,[275 257 423  79 286],43,5,32851,3.8444704505558804,0.0,0.0
28545,2,8545,[237  98 655 210 132],62,3,32854,3.844371635853031,0.0,20.0
28546,2,8546,[111   1 403  25  56],345,2,32856,3.844155844155844,0.0,0.0
28547,2,8547,[385 546  70 196 742],654,5,32861,3.8442910622367807,0.0,0.0
28548,2,8548,[179  89 655 265 180],373,3,32864,3.844192303193356,0.0,0.0
28549,2,8549,[195 678 172  79  82],416,4,32868,3.8442105263157895,0.0,0.0
28550,2,8550,[174   1 423 357 597],805,2,32870,3.8439948544029936,0.0,0.0
28551,2,8551,[ 15 318   1  50 168],253,4,32874,3.8440130963517305,20.0,20.0
28552,2,8552,[118 265 173 151 245],416,2,32876,3.8437974979539344,0.0,0.0
28553,2,8553,[427  97 211 144 127],416,5,32881,3.843932663081599,0.0,0.0
28554,2,8554,[216  50 318  12 172],416,5,32886,3.8440677966101693,40.0,20.0
28555,2,8555,[265 197  64 294  79],128,5,32891,3.8442028985507246,20.0,0.0
28556,2,8556,[546  15 118 135  96],62,3,32894,3.8441042421409373,0.0,0.0
28557,2,8557,[174 121 294  98  12],588,3,32897,3.8440056087871,20.0,20.0
28558,2,8558,[ 64 282 197 181 265],416,5,32902,3.8441406706390935,20.0,20.0
28559,2,8559,[568 111  82 588 238],654,5,32907,3.8442757009345794,0.0,0.0
28560,2,8560,[ 64  12 301 269 357],416,5,32912,3.8444106996846164,40.0,0.0
28561,2,8561,[195 427  56  69 288],642,2,32914,3.8441952814762907,0.0,20.0
28562,2,8562,[268  11 195 187 269],416,5,32919,3.844330258087119,0.0,0.0
28563,2,8563,[210 655 323 135 748],198,3,32922,3.844231667445119,0.0,0.0
28564,2,8564,[ 64  12 301 269 357],416,5,32927,3.8443666082895507,40.0,0.0
28565,2,8565,[ 64  96 132 176  79],198,4,32931,3.8443847770254496,20.0,0.0
28566,2,8566,[ 64  12 301 269 357],416,5,32936,3.8445196684953893,40.0,0.0
28567,2,8567,[195 202 403  97  22],373,2,32938,3.8443043884220356,0.0,0.0
28568,2,8568,[ 96 202 204 597 603],805,2,32940,3.8440891585949353,0.0,0.0
28569,2,8569,[172 132  82   4 258],417,3,32943,3.843990665110852,0.0,0.0
28570,2,8570,[ 64  12 301 269 357],416,5,32948,3.844125539610314,40.0,0.0
28571,2,8571,[ 64  12 301 269 357],416,5,32953,3.844260382641157,40.0,0.0
28572,2,8572,[294  11 121 210 742],654,4,32957,3.844278548932696,0.0,0.0
28573,2,8573,[ 64  12 301 269 357],416,5,32962,3.8444133426638674,40.0,0.0
28574,2,8574,[  8 294 423 204 597],43,4,32966,3.8444314868804663,0.0,0.0
28575,2,8575,[ 64  12 301 269 357],416,5,32971,3.8445662313432836,40.0,0.0
28576,2,8576,[282 258  25 216   7],630,2,32973,3.8443511717383703,0.0,0.0
28577,2,8577,[423 183 313 202 181],416,5,32978,3.84448589414782,20.0,40.0
28578,2,8578,[ 11  56 237 143 286],437,3,32981,3.844387457745658,0.0,0.0
28579,2,8579,[174 182 202 245  88],128,2,32983,3.844172494172494,0.0,0.0
28580,2,8580,[151 678 238 471 289],345,2,32985,3.84395758070155,0.0,0.0
28581,2,8581,[597 121 143 182 568],416,4,32989,3.8439757632253553,0.0,0.0
28582,2,8582,[  9 161 127 403 197],618,3,32992,3.843877432133287,0.0,0.0
28583,2,8583,[ 64  12 301 269 357],416,5,32997,3.8440121155638396,40.0,0.0
28584,2,8584,[ 82 151 191 275 182],62,5,33002,3.8441467676179384,0.0,0.0
28585,2,8585,[ 64  12 301 269 357],416,5,33007,3.8442813883065456,40.0,0.0
28586,2,8586,[  7 181 202 313 175],354,3,33010,3.844183067427507,20.0,40.0
28587,2,8587,[ 64  12 301 269 357],416,5,33015,3.8443176525384257,40.0,0.0
28588,2,8588,[423 118 121 222 288],588,2,33017,3.844102922342531,0.0,20.0
28589,2,8589,[121  70 288 313 111],654,4,33021,3.8441210710128058,20.0,40.0
28590,2,8590,[ 64  12 301 269 357],416,5,33026,3.8442556163426844,40.0,0.0
28591,2,8591,[127  79 175 268  64],854,4,33030,3.84427374301676,20.0,0.0
28592,2,8592,[ 64  12 301 269 357],416,5,33035,3.8444082392645176,40.0,0.0
28593,2,8593,[117 515 182 202 286],417,5,33040,3.844542704212241,0.0,0.0
28594,2,8594,[183 403 187   8 238],618,3,33043,3.8444444444444446,0.0,0.0
28595,2,8595,[ 64  12 301 269 357],416,5,33048,3.844578873894835,40.0,0.0
28596,2,8596,[237 204 151 202 546],297,1,33049,3.8442479934861,0.0,0.0
28597,2,8597,[ 64  12 301 269 357],416,5,33054,3.8443824145150036,40.0,0.0
28598,2,8598,[181  56 161 403  89],405,3,33057,3.8442842190952438,0.0,20.0
28599,2,8599,[121 127 182 475 172],198,4,33061,3.8443023255813955,0.0,0.0
28600,2,8600,[ 56  79  25 275 423],128,3,33064,3.8442041623067085,0.0,0.0
28601,2,8601,[ 56 235 471 143 215],922,1,33065,3.843873517786561,0.0,0.0
28602,2,8602,[ 98 176 117 323  11],416,4,33069,3.8438916656980124,0.0,20.0
28603,2,8603,[183 318 568 187 288],416,5,33074,3.8440260344026034,20.0,20.0
28604,2,8604,[238 173 273  97 403],416,5,33079,3.8441603718768156,0.0,0.0
28605,2,8605,[318  64 483 195  15],618,3,33082,3.8440622821287476,60.0,0.0
28606,2,8606,[748 191 153  15  82],417,5,33087,3.844196584175671,0.0,0.0
28607,2,8607,[ 64  12 301 269 357],416,5,33092,3.8443308550185873,40.0,0.0
28608,2,8608,[471 173 174 357 323],721,4,33096,3.844348937158787,0.0,0.0
28609,2,8609,[275   7  50 186   9],354,4,33100,3.8443670150987224,0.0,20.0
28610,2,8610,[265 194 678   1  50],297,1,33101,3.8440366972477062,0.0,20.0
28611,2,8611,[435 748 318 191  71],437,3,33104,3.8439386901997215,20.0,0.0
28612,2,8612,[ 50   9 111 289 258],43,5,33109,3.8440729130384304,0.0,20.0
28613,2,8613,[ 79  11 135 195  98],214,4,33113,3.844091014627351,0.0,20.0
28614,2,8614,[191  96 268   1  56],854,2,33115,3.8438769587928032,0.0,0.0
28615,2,8615,[143 191 100 151 197],345,5,33120,3.8440111420612815,0.0,0.0
28616,2,8616,[ 64  12 301 269 357],416,5,33125,3.8441452941859118,40.0,0.0
28617,2,8617,[302 175 174 333  22],854,1,33126,3.8438152703643538,0.0,0.0
28618,2,8618,[300 182 100 235 196],297,2,33128,3.843601345863789,0.0,0.0
28619,2,8619,[405 174 235 597 328],854,1,33129,3.8432714617169372,0.0,0.0
28620,2,8620,[323 151 318 742  82],43,4,33133,3.843289641572903,20.0,0.0
28621,2,8621,[ 64  12 301 269 357],416,5,33138,3.8434237995824634,40.0,0.0
28622,2,8622,[111 301 271   8 197],297,2,33140,3.8432100197147165,0.0,0.0
28623,2,8623,[121 117 118 215 132],416,4,33144,3.8432282003710574,0.0,0.0
28624,2,8624,[235 181 294 268 300],345,2,33146,3.8430144927536234,0.0,20.0
28625,2,8625,[180 118  89 237 111],437,2,33148,3.8428008346858333,0.0,0.0
28626,2,8626,[204  50 237 143 427],642,4,33152,3.842819056450678,0.0,20.0
28627,2,8627,[ 50 204  89 173 174],805,3,33155,3.84272137227631,0.0,20.0
28628,2,8628,[ 22 215 185 357 111],416,5,33160,3.8428554873102327,0.0,0.0
28629,2,8629,[ 64  12 301 269 357],416,5,33165,3.8429895712630358,40.0,0.0
28630,2,8630,[197  15 357 423 182],198,3,33168,3.842891901286062,0.0,0.0
28631,2,8631,[216 238 187 403 202],373,2,33170,3.842678405931418,0.0,0.0
28632,2,8632,[161  12 496 172  56],618,5,33175,3.842812463801691,20.0,0.0
28633,2,8633,[186 204   8 323  69],43,3,33178,3.8427148482742646,0.0,0.0
28634,2,8634,[742 655  56 268 300],416,5,33183,3.8428488708743487,0.0,0.0
28635,2,8635,[216 195  98  11 127],417,4,33187,3.8428670680870773,0.0,20.0
28636,2,8636,[286 174 405 175 216],854,2,33189,3.8426536992011116,0.0,0.0
28637,2,8637,[151 181 202  71  11],618,3,33192,3.8425561472563095,0.0,20.0
28638,2,8638,[ 64  12 301 269 357],416,5,33197,3.842690126172011,40.0,0.0
28639,2,8639,[132 143 210 182 294],128,4,33201,3.8427083333333334,0.0,0.0
28640,2,8640,[ 70 496 588 275  12],618,3,33204,3.8426108089341513,20.0,0.0
28641,2,8641,[655 211 423  96 403],373,3,33207,3.842513307104837,0.0,0.0
28642,2,8642,[427 180 403 187  71],198,3,33210,3.842415827837556,0.0,0.0
28643,2,8643,[168 200 173 143 181],805,3,33213,3.8423183711244793,0.0,20.0
28644,2,8644,[496 211 181   4  98],43,5,33218,3.8424522845575475,0.0,40.0
28645,2,8645,[ 69 496  28  50 161],128,5,33223,3.842586167013648,0.0,20.0
28646,2,8646,[ 64  12 301 269 357],416,5,33228,3.842720018503527,40.0,0.0
28647,2,8647,[ 64  12 301 269 357],416,5,33233,3.842853839037928,40.0,0.0
28648,2,8648,[282  69  97 258 153],416,5,33238,3.842987628627587,0.0,0.0
28649,2,8649,[ 89 111 237 210 204],437,2,33240,3.8427745664739885,0.0,0.0
28650,2,8650,[268  50  70 475 423],416,4,33244,3.842792740723616,0.0,20.0
28651,2,8651,[ 11 286 111 742  28],297,3,33247,3.8426953305594083,0.0,0.0
28652,2,8652,[143 257 275  15 172],416,4,33251,3.8427135097653995,0.0,0.0
28653,2,8653,[435 475 153 265 288],297,2,33253,3.8425005777675065,0.0,20.0
28654,2,8654,[  9 427 268  12   4],416,5,33258,3.84263431542461,20.0,0.0
28655,2,8655,[179 125 427  82  22],601,3,33261,3.84253696857671,0.0,0.0
28656,2,8656,[  7   9 111  22 427],416,5,33266,3.842670671133187,0.0,0.0
28657,2,8657,[ 64  12 301 269 357],416,5,33271,3.842804342804343,40.0,0.0
28658,2,8658,[ 71 588 204 173 748],805,1,33272,3.8424760364938213,0.0,0.0
28659,2,8659,[191  28 357 144 161],416,5,33277,3.8426096997690533,0.0,0.0
28660,2,8660,[151 180  25 194  88],373,4,33281,3.8426278720702,0.0,0.0
28661,2,8661,[135 111 423 173 471],297,2,33283,3.8424151466174092,0.0,0.0
28662,2,8662,[ 64  12 301 269 357],416,5,33288,3.8425487706337296,40.0,0.0
28663,2,8663,[ 70  12 222  82 568],417,3,33291,3.8424515235457064,20.0,0.0
28664,2,8664,[748 257 216 200  25],416,4,33295,3.842469705712637,0.0,0.0
28665,2,8665,[204  82 151   4  22],618,2,33297,3.842257096699746,0.0,0.0
28666,2,8666,[ 64  12 301 269 357],416,5,33302,3.842390677281643,40.0,0.0
28667,2,8667,[265 597 143 222  15],705,3,33305,3.8422934933087216,0.0,0.0
28668,2,8668,[202 182   7 286 234],297,2,33307,3.8420809781981773,0.0,0.0
28669,2,8669,[588 275 135 181 100],437,4,33311,3.8420991926182237,0.0,20.0
28670,2,8670,[427 127 200 180 172],887,3,33314,3.8420020758851345,0.0,0.0
28671,2,8671,[174 195 172 135  15],198,3,33317,3.8419049815498156,0.0,0.0
28672,2,8672,[117 216 323 200  89],417,3,33320,3.84180790960452,0.0,0.0
28673,2,8673,[ 64  12 301 269 357],416,5,33325,3.841941434171086,40.0,0.0
28674,2,8674,[ 64  50 183 228 143],496,1,33326,3.841613832853026,20.0,20.0
28675,2,8675,[235 200 322 423 403],417,3,33329,3.841516828031351,0.0,0.0
28676,2,8676,[294 144  22 117 357],805,1,33330,3.8411893511582345,0.0,0.0
28677,2,8677,[ 64  12 301 269 357],416,5,33335,3.841322885457479,40.0,0.0
28678,2,8678,[423  69 282 258 216],721,4,33339,3.841341168337366,0.0,0.0
28679,2,8679,[294 175 202  96 222],805,3,33342,3.841244239631336,0.0,0.0
28680,2,8680,[161 200 588 204 276],922,1,33343,3.840916945052413,0.0,0.0
28681,2,8681,[172 471 269  56 237],345,4,33347,3.840935268371343,0.0,0.0
28682,2,8682,[222 288 172  28 111],887,4,33351,3.8409535874697687,0.0,20.0
28683,2,8683,[  4 174 172 121 111],416,5,33356,3.841087056655919,0.0,0.0
28684,2,8684,[  1 200 655 143 228],805,2,33358,3.840875071963155,0.0,0.0
28685,2,8685,[678 173 289 300 182],416,3,33361,3.840778263872899,0.0,0.0
28686,2,8686,[ 64  12 301 269 357],416,5,33366,3.8409117071486127,40.0,0.0
28687,2,8687,[ 64 168   1 257 427],416,4,33370,3.840930018416206,20.0,0.0
28688,2,8688,[273   8 237 300 202],416,4,33374,3.840948325468984,0.0,0.0
28689,2,8689,[ 71  11   4 475 357],805,2,33376,3.8407364787111624,0.0,0.0
28690,2,8690,[301 185  82  25 117],49,1,33377,3.8404096191462433,0.0,0.0
28691,2,8691,[168 196 202  28 173],618,3,33380,3.840312931431201,0.0,0.0
28692,2,8692,[204 191  69  28  71],62,3,33383,3.8402162659611183,0.0,0.0
28693,2,8693,[  7 588  95 405 204],262,2,33385,3.840004600874166,0.0,0.0
28694,2,8694,[ 64  12 269 301 357],416,5,33390,3.8401380103507763,40.0,0.0
28695,2,8695,[405 121 174 302 275],43,5,33395,3.8402713891444344,0.0,0.0
28696,2,8696,[435 125  96   1 385],230,3,33398,3.8401747729101987,0.0,0.0
28697,2,8697,[ 64  12 269 301 357],416,5,33403,3.840308116808462,40.0,0.0
28698,2,8698,[301 268  15 215 423],721,5,33408,3.840441430049431,0.0,0.0
28699,2,8699,[301 117 515 174 258],297,5,33413,3.840574712643678,0.0,0.0
28700,2,8700,[483 202 180 323 173],417,4,33417,3.840593035283301,20.0,0.0
28701,2,8701,[ 64  12 269 301 357],416,5,33422,3.8407262698230293,40.0,0.0
28702,2,8702,[182  79 174 265   7],505,2,33424,3.840514765023555,0.0,0.0
28703,2,8703,[215 546 427  95 181],416,3,33427,3.8404181985294117,0.0,20.0
28704,2,8704,[357   1 185  96 183],198,4,33431,3.8404365307294657,0.0,0.0
28705,2,8705,[ 89  82   4 204 135],805,2,33433,3.8402251320928094,0.0,0.0
28706,2,8706,[ 64  12 269 301 357],416,5,33438,3.840358332376249,40.0,0.0
28707,2,8707,[ 28 238 258 475 301],416,4,33442,3.8403766651355076,0.0,0.0
28708,2,8708,[328 144 195 238  70],416,5,33447,3.8405098174302448,0.0,0.0
28709,2,8709,[ 56 144  98 183 176],230,2,33449,3.8402985074626868,0.0,20.0
28710,2,8710,[ 64  12 269 301 357],416,5,33454,3.84043163815865,40.0,0.0
28711,2,8711,[  1 195 179 176 286],416,4,33458,3.8404499540863175,0.0,0.0
28712,2,8712,[ 64  12 269 301 357],416,5,33463,3.840583036841501,40.0,0.0
28713,2,8713,[121 143 742 423  28],654,5,33468,3.8407160890521,0.0,0.0
28714,2,8714,[ 64  12 269 301 357],416,5,33473,3.840849110728629,40.0,0.0
28715,2,8715,[655 202 228 237  50],128,2,33475,3.8406379072969252,0.0,20.0
28716,2,8716,[222 588  89  22  97],705,2,33477,3.840426752323047,0.0,0.0
28717,2,8717,[117 234 603   1 678],297,2,33479,3.8402156457903187,0.0,0.0
28718,2,8718,[ 64  12 269 301 357],416,5,33484,3.840348663837596,40.0,0.0
28719,2,8719,[ 64  12 269 301 357],416,5,33489,3.840481651376147,40.0,0.0
28720,2,8720,[483 357  96 151 546],62,5,33494,3.840614608416466,20.0,0.0
28721,2,8721,[ 64  12 269 301 357],416,5,33499,3.8407475349690436,40.0,0.0
28722,2,8722,[204 172  50 185 275],262,1,33500,3.8404218732087583,0.0,20.0
28723,2,8723,[127 187 276  69  25],198,3,33503,3.8403255387436954,0.0,0.0
28724,2,8724,[ 64  12 269 301 357],416,5,33508,3.840458452722063,40.0,0.0
28725,2,8725,[333 597   1 385  95],588,4,33512,3.8404767361906944,0.0,0.0
28726,2,8726,[748 118 210  79  50],417,2,33514,3.8402658416408846,0.0,20.0
28727,2,8727,[ 64  12 269 301 357],416,5,33519,3.8403987167736022,40.0,0.0
28728,2,8728,[144 118 174 173 245],297,2,33521,3.840187879482186,0.0,0.0
28729,2,8729,[  7  97 174  28 196],618,5,33526,3.8403207331042384,0.0,0.0
28730,2,8730,[196  56 357   7 257],417,3,33529,3.840224487458481,0.0,0.0
28731,2,8731,[742 568  50 496 655],417,1,33530,3.8398992212551533,0.0,20.0
28732,2,8732,[ 64  12 269 301 357],416,5,33535,3.8400320622924538,40.0,0.0
28733,2,8733,[742 597 245 215 302],62,0,33535,3.839592397526906,0.0,0.0
28734,2,8734,[655 385 117 100 161],416,5,33540,3.8397252432741844,0.0,0.0
28735,2,8735,[ 64  12 269 301 357],416,5,33545,3.8398580586080584,40.0,0.0
28736,2,8736,[ 64  12 269 301 357],416,5,33550,3.8399908435389722,40.0,0.0
28737,2,8737,[172  88 186 742 216],43,4,33554,3.840009155413138,0.0,0.0
28738,2,8738,[ 64  12 269 301 357],416,5,33559,3.8401418926650646,40.0,0.0
28739,2,8739,[ 95 121 125 132 588],887,5,33564,3.840274599542334,0.0,0.0
28740,2,8740,[273  69 153 748  82],417,3,33567,3.840178469282691,0.0,0.0
28741,2,8741,[ 64  12 269 301 357],416,5,33572,3.840311141615191,40.0,0.0
28742,2,8742,[  8 496 288 121  82],588,4,33576,3.840329406382249,0.0,20.0
28743,2,8743,[597   1  15  56 235],417,3,33579,3.8402333028362308,0.0,0.0
28744,2,8744,[385  56 202 194 215],405,3,33582,3.8401372212692966,0.0,0.0
28745,2,8745,[ 11 496 202   7 268],416,5,33587,3.840269837640064,0.0,0.0
28746,2,8746,[197 121 515 151 275],416,4,33591,3.8402880987767234,0.0,0.0
28747,2,8747,[238 234 118  71 265],437,2,33593,3.840077732053041,0.0,0.0
28748,2,8748,[289 423 273 257 427],416,3,33596,3.8399817121956796,0.0,0.0
28749,2,8749,[ 64  12 269 301 357],416,5,33601,3.840114285714286,40.0,0.0
28750,2,8750,[302 202   7  25 237],416,4,33605,3.8401325562792823,0.0,0.0
28751,2,8751,[183   4 172 181 174],618,4,33609,3.8401508226691043,0.0,20.0
28752,2,8752,[ 64  12 269 301 357],416,5,33614,3.8402833314292244,40.0,0.0
28753,2,8753,[300 153 748 222  56],297,3,33617,3.840187342928947,0.0,0.0
28754,2,8754,[ 64  12 269 301 357],416,5,33622,3.840319817247287,40.0,0.0
28755,2,8755,[ 64  12 269 301 357],416,5,33627,3.840452261306533,40.0,0.0
28756,2,8756,[ 64  12 269 301 357],416,5,33632,3.840584675117049,40.0,0.0
28757,2,8757,[183  97 742 588  15],417,3,33635,3.8404886960493263,0.0,0.0
28758,2,8758,[ 64  12 269 301 357],416,5,33640,3.840621075465236,40.0,0.0
28759,2,8759,[  7 568 183 357 222],805,4,33644,3.8406392694063927,0.0,0.0
28760,2,8760,[117 588 143 204  69],230,5,33649,3.8407716014153634,0.0,0.0
28761,2,8761,[ 50 475  69   8 238],416,4,33653,3.8407897740241954,0.0,20.0
28762,2,8762,[ 64  12 269 301 357],416,5,33658,3.8409220586557113,40.0,0.0
28763,2,8763,[294 423 153 168 202],297,2,33660,3.840712003651301,0.0,0.0
28764,2,8764,[127 655 153 515 282],416,5,33665,3.840844266970907,0.0,0.0
28765,2,8765,[258  28 151 186 235],642,2,33667,3.840634268765686,0.0,0.0
28766,2,8766,[ 96 275 210 194 588],416,5,33672,3.8407665107790576,0.0,0.0
28767,2,8767,[ 64  12 269 301 357],416,5,33677,3.8408987226277373,40.0,0.0
28768,2,8768,[294 655  50 286 257],62,1,33678,3.840574751967157,0.0,20.0
28769,2,8769,[ 12 135 176  64 202],417,4,33682,3.8405929304446977,40.0,0.0
28770,2,8770,[ 64  12 269 301 357],416,5,33687,3.8407251168623873,40.0,0.0
28771,2,8771,[210 258 403 234   1],805,3,33690,3.8406292749658,0.0,0.0
28772,2,8772,[ 64  12 269 301 357],416,5,33695,3.840761427105893,40.0,0.0
28773,2,8773,[ 64  12 269 301 357],416,5,33700,3.840893549122407,40.0,0.0
28774,2,8774,[204  15 111  12 301],416,5,33705,3.841025641025641,20.0,0.0
28775,2,8775,[ 64  12 269 301 357],416,5,33710,3.841157702825889,40.0,0.0
28776,2,8776,[ 64  12 269 301 357],416,5,33715,3.8412897345334396,40.0,0.0
28777,2,8777,[ 64  12 269 301 357],416,5,33720,3.841421736158578,40.0,0.0
28778,2,8778,[175  56 245 153 127],721,3,33723,3.8413258913315866,0.0,0.0
28779,2,8779,[435 748 197 271 282],297,0,33723,3.840888382687927,0.0,0.0
28780,2,8780,[ 56 117 238 216   9],618,2,33725,3.840678738184717,0.0,0.0
28781,2,8781,[ 64  12 269 301 357],416,5,33730,3.8408107492598496,40.0,0.0
28782,2,8782,[237 100  56 174 132],854,3,33733,3.8407150176477285,0.0,0.0
28783,2,8783,[ 64  12 269 301 357],416,5,33738,3.8408469945355193,40.0,0.0
28784,2,8784,[121 151 235 322 153],417,2,33740,3.8406374501992033,0.0,0.0
28785,2,8785,[176   4 174 200 151],297,2,33742,3.840427953562486,0.0,0.0
28786,2,8786,[183 568 603  98   9],805,3,33745,3.8403323090929784,0.0,20.0
28787,2,8787,[ 64  12 269 301 357],416,5,33750,3.8404642694583524,40.0,0.0
28788,2,8788,[172 216 328 197 318],721,5,33755,3.8405961997951987,20.0,0.0
28789,2,8789,[ 64  12 269 301 357],416,5,33760,3.8407281001137656,40.0,0.0
28790,2,8790,[ 12 181 508 294 100],654,1,33761,3.840404959617791,20.0,20.0
28791,2,8791,[117 182 181 202  79],297,2,33763,3.8401956323930846,0.0,20.0
28792,2,8792,[655  96 597 475  70],62,2,33765,3.839986352780621,0.0,0.0
28793,2,8793,[ 64  12 269 301 357],416,5,33770,3.8401182624516714,40.0,0.0
28794,2,8794,[191 288 234  22 228],805,2,33772,3.8399090392268334,0.0,20.0
28795,2,8795,[ 64  12 269 301 357],416,5,33777,3.8400409276944067,40.0,0.0
28796,2,8796,[ 64  12 269 301 357],416,5,33782,3.840172786177106,40.0,0.0
28797,2,8797,[ 64  12 269 301 357],416,5,33787,3.840304614685156,40.0,0.0
28798,2,8798,[ 64  12 269 301 357],416,5,33792,3.840436413228776,40.0,0.0
28799,2,8799,[143 301 216 508 655],345,5,33797,3.8405681818181816,0.0,0.0
28800,2,8800,[ 64  12 269 301 357],416,5,33802,3.840699920463584,40.0,0.0
28801,2,8801,[ 64  12 269 301 357],416,5,33807,3.8408316291751876,40.0,0.0
28802,2,8802,[196 176 151 265 568],417,3,33810,3.840736112688856,0.0,0.0
28803,2,8803,[70  8 12 64 95],314,4,33814,3.840754202635166,40.0,0.0
28804,2,8804,[475 483 151  28 313],588,4,33818,3.8407722884724587,40.0,20.0
28805,2,8805,[385 117 118  69  71],416,4,33822,3.840790370202135,0.0,0.0
28806,2,8806,[ 64  12 269 301 357],416,5,33827,3.8409219938685135,40.0,0.0
28807,2,8807,[273 176 210 228   4],805,1,33828,3.8405994550408717,0.0,0.0
28808,2,8808,[191 125 286 588 405],416,5,33833,3.8407310704960835,0.0,0.0
28809,2,8809,[ 71 328 202 197 200],416,5,33838,3.8408626560726447,0.0,0.0
28810,2,8810,[ 64  12 269 301 357],416,5,33843,3.8409942117807288,40.0,0.0
28811,2,8811,[100 328 269 132 403],373,2,33845,3.840785292782569,0.0,0.0
28812,2,8812,[ 64  12 269 301 357],416,5,33850,3.8409168274140475,40.0,0.0
28813,2,8813,[237  25 508  89 357],297,5,33855,3.8410483321987745,0.0,0.0
28814,2,8814,[144  98 127  97 181],618,5,33860,3.8411798071469088,0.0,40.0
28815,2,8815,[423  64 132 286 197],711,4,33864,3.841197822141561,20.0,0.0
28816,2,8816,[180 111 357 496 176],417,3,33867,3.8411024157876827,0.0,0.0
28817,2,8817,[117 196 173 215 237],416,4,33871,3.8411204354728965,0.0,0.0
28818,2,8818,[ 64  12 269 301 357],416,5,33876,3.8412518426125413,40.0,0.0
28819,2,8819,[289 234  69 678 182],416,3,33879,3.841156462585034,0.0,0.0
28820,2,8820,[ 64  12 269 301 357],416,5,33884,3.841287835846276,40.0,0.0
28821,2,8821,[  7 135 302  25 471],854,2,33886,3.841079120380866,0.0,0.0
28822,2,8822,[ 25 180 228 187 204],887,4,33890,3.841097132494616,0.0,0.0
28823,2,8823,[ 64  12 269 301 357],416,5,33895,3.84122846781505,40.0,0.0
28824,2,8824,[ 64  12 269 301 357],416,5,33900,3.8413597733711047,40.0,0.0
28825,2,8825,[403 215 323   9   4],416,4,33904,3.8413777475640156,0.0,0.0
28826,2,8826,[276  98  71 173 174],764,3,33907,3.841282428911295,0.0,20.0
28827,2,8827,[ 64  12 269 301 357],416,5,33912,3.841413683733575,40.0,0.0
28828,2,8828,[ 64  12 269 301 357],416,5,33917,3.841544908823196,40.0,0.0
28829,2,8829,[ 64  12 269 301 357],416,5,33922,3.8416761041902605,40.0,0.0
28830,2,8830,[313   7   4 289 210],43,5,33927,3.841807269844865,20.0,20.0
28831,2,8831,[161 234 100  28 323],805,3,33930,3.8417119565217392,0.0,0.0
28832,2,8832,[ 64  12 269 301 357],416,5,33935,3.8418430884184307,40.0,0.0
28833,2,8833,[471 174  79 222 275],128,3,33938,3.841747792619425,0.0,0.0
28834,2,8834,[ 64  12 269 301 357],416,5,33943,3.8418788907753254,40.0,0.0
28835,2,8835,[ 64  12 269 301 357],416,5,33948,3.8420099592575827,40.0,0.0
28836,2,8836,[ 64  12 269 301 357],416,5,33953,3.84214099807627,40.0,0.0
28837,2,8837,[237 423   1 294 118],128,5,33958,3.842272007241457,0.0,0.0
28838,2,8838,[183 181 475  96 144],416,4,33962,3.8422898517931894,0.0,20.0
28839,2,8839,[ 64  12 269 301 357],416,5,33967,3.842420814479638,40.0,0.0
28840,2,8840,[237  70  88 161 603],416,3,33970,3.8423255287863363,0.0,0.0
28841,2,8841,[ 64  12 269 301 357],416,5,33975,3.842456457814974,40.0,0.0
28842,2,8842,[ 64  12 269 301 357],416,5,33980,3.8425873572317086,40.0,0.0
28843,2,8843,[ 97 127 405 313 118],38,4,33984,3.8426051560379917,20.0,20.0
28844,2,8844,[ 56 173 168 186 215],437,2,33986,3.8423968343697004,0.0,0.0
28845,2,8845,[144   7 118 257 678],416,2,33988,3.84218855980104,0.0,0.0
28846,2,8846,[568  28 273  95 216],805,0,33988,3.841754266983158,0.0,0.0
28847,2,8847,[ 89 546 181 215  12],62,4,33992,3.8417721518987342,20.0,20.0
28848,2,8848,[181 222 405 118 568],805,1,33993,3.841451011413719,0.0,20.0
28849,2,8849,[118  12 286 289 100],416,3,33996,3.8413559322033897,20.0,0.0
28850,2,8850,[ 64  12 269 301 357],416,5,34001,3.841486837645464,40.0,0.0
28851,2,8851,[ 11 245   4 197 111],297,1,34002,3.841165838228649,0.0,0.0
28852,2,8852,[ 64  12 269 301 357],416,5,34007,3.8412967355698635,40.0,0.0
28853,2,8853,[385 588 294 323 655],416,4,34011,3.8413146600406596,0.0,0.0
28854,2,8854,[ 64  12 269 301 357],416,5,34016,3.8414455110107286,40.0,0.0
28855,2,8855,[ 64  12 269 301 357],416,5,34021,3.841576332429991,40.0,0.0
28856,2,8856,[ 71 313 471  11 172],345,3,34024,3.8414813142147453,20.0,20.0
28857,2,8857,[ 89 471 385 603 238],373,3,34027,3.8413863174531495,0.0,0.0
28858,2,8858,[475 153 238 301  28],416,4,34031,3.841404221695451,0.0,0.0
28859,2,8859,[235 234 132 216 196],416,4,34035,3.8414221218961626,0.0,0.0
28860,2,8860,[196  82 235  28 144],62,3,34038,3.841327163976978,0.0,0.0
28861,2,8861,[286 179 302 257 238],416,3,34041,3.8412322274881516,0.0,0.0
28862,2,8862,[144 118 179 238  70],437,2,34043,3.841024483809094,0.0,0.0
28863,2,8863,[ 82  56 151 215 286],588,5,34048,3.8411552346570397,0.0,0.0
28864,2,8864,[211 228 144 258 135],417,2,34050,3.8409475465313028,0.0,0.0
28865,2,8865,[  4 151 168  98   9],43,5,34055,3.8410782765621474,0.0,20.0
28866,2,8866,[ 64  12 269 301 357],416,5,34060,3.841208977106124,40.0,0.0
28867,2,8867,[ 64  12 269 301 357],416,5,34065,3.841339648173207,40.0,0.0
28868,2,8868,[276  69 202 181  28],618,3,34068,3.8412447852069005,0.0,20.0
28869,2,8869,[ 69  97  56 403 515],417,4,34072,3.841262683201804,0.0,0.0
28870,2,8870,[211 475 385  56 143],416,4,34076,3.8412805771615375,0.0,0.0
28871,2,8871,[ 64  12 269 301 357],416,5,34081,3.8414111812443643,40.0,0.0
28872,2,8872,[153 118  97 273 294],417,4,34085,3.841429054434802,0.0,0.0
28873,2,8873,[ 64  12 269 301 357],416,5,34090,3.841559612350687,40.0,0.0
28874,2,8874,[235  22 125   7 174],854,1,34091,3.8412394366197185,0.0,0.0
28875,2,8875,[174 180 238 118 182],62,4,34095,3.841257323118522,0.0,0.0
28876,2,8876,[196 172 181   8 423],230,5,34100,3.841387856257745,0.0,20.0
28877,2,8877,[405 100 200 185 748],417,2,34102,3.841180446046407,0.0,0.0
28878,2,8878,[ 97   1 300  79  50],253,5,34107,3.841310958441266,0.0,20.0
28879,2,8879,[ 64  12 269 301 357],416,5,34112,3.8414414414414413,40.0,0.0
28880,2,8880,[234 117 196 180  82],437,3,34115,3.841346695191983,0.0,0.0
28881,2,8881,[496 237 427  89 153],642,2,34117,3.841139383021842,0.0,0.0
28882,2,8882,[ 64  12 269 301 357],416,5,34122,3.8412698412698414,40.0,0.0
28883,2,8883,[ 64  12 269 301 357],416,5,34127,3.841400270148582,40.0,0.0
28884,2,8884,[183 143 228 118 125],601,2,34129,3.841193021947102,0.0,0.0
28885,2,8885,[ 64  12 269 301 357],416,5,34134,3.8413234301147874,40.0,0.0
28886,2,8886,[ 64  12 269 301 357],416,5,34139,3.8414538089343986,40.0,0.0
28887,2,8887,[181 427 191 215 186],373,5,34144,3.8415841584158414,0.0,20.0
28888,2,8888,[568 294 257 121  25],887,3,34147,3.841489481381483,0.0,0.0
28889,2,8889,[151 588  50 475 357],416,3,34150,3.8413948256467942,0.0,20.0
28890,2,8890,[234 508  70 117 405],417,3,34153,3.841300191204589,0.0,0.0
28891,2,8891,[151 597  97 172 742],642,4,34157,3.8413180386864596,0.0,0.0
28892,2,8892,[ 64  12 269 301 357],416,5,34162,3.841448330147307,40.0,0.0
28893,2,8893,[118  15 568 210 235],416,3,34165,3.841353721610074,0.0,0.0
28894,2,8894,[ 64  12 269 301 357],416,5,34170,3.8414839797639124,40.0,0.0
28895,2,8895,[286  88 258 202  56],416,4,34174,3.841501798561151,0.0,0.0
28896,2,8896,[423 187 313 678 132],416,4,34178,3.8415196133528156,20.0,20.0
28897,2,8897,[ 97 258 151 118 196],297,3,34181,3.841425039334682,0.0,0.0
28898,2,8898,[216 173 202  82 275],711,3,34184,3.841330486571525,0.0,0.0
28899,2,8899,[ 64  12 269 301 357],416,5,34189,3.8414606741573034,40.0,0.0
28900,2,8900,[ 64  12 269 301 357],416,5,34194,3.8415908324907315,40.0,0.0
28901,2,8901,[ 64  12 269 301 357],416,5,34199,3.841720961581667,40.0,0.0
28902,2,8902,[ 64  12 269 301 357],416,5,34204,3.841851061439964,40.0,0.0
28903,2,8903,[196 313  88 186  97],405,2,34206,3.841644204851752,20.0,20.0
28904,2,8904,[ 56  96 423 678   7],805,4,34210,3.841661987647389,0.0,0.0
28905,2,8905,[127  69  97   7 173],62,4,34214,3.8416797664495848,0.0,0.0
28906,2,8906,[ 64  12 269 301 357],416,5,34219,3.841809812507017,40.0,0.0
28907,2,8907,[ 64  12 269 301 357],416,5,34224,3.8419398293668614,40.0,0.0
28908,2,8908,[151  88 748 144 161],416,3,34227,3.8418453249522955,0.0,0.0
28909,2,8909,[ 64  12 269 301 357],416,5,34232,3.8419753086419752,40.0,0.0
28910,2,8910,[211 117 282 546  15],416,4,34236,3.841993042307261,0.0,0.0
28911,2,8911,[ 64  12 269 301 357],416,5,34241,3.8421229802513466,40.0,0.0
28912,2,8912,[748 132 173  70 238],198,3,34244,3.8420284976999888,0.0,0.0
28913,2,8913,[ 64  12 269 301 357],416,5,34249,3.842158402512901,40.0,0.0
28914,2,8914,[118 508  89  25 275],854,3,34252,3.8420639371845207,0.0,0.0
28915,2,8915,[302 322  70 328 588],416,4,34256,3.842081650964558,0.0,0.0
28916,2,8916,[ 64  12 269 301 357],416,5,34261,3.842211506111921,40.0,0.0
28917,2,8917,[ 64  12 269 301 357],416,5,34266,3.8423413321372504,40.0,0.0
28918,2,8918,[ 79 191  25 100  97],417,2,34268,3.842134768471802,0.0,0.0
28919,2,8919,[ 98 187 323 655  82],198,3,34271,3.8420403587443945,0.0,20.0
28920,2,8920,[215 508 294 423  22],654,3,34274,3.841945970182715,0.0,0.0
28921,2,8921,[197  69 238 191 186],198,5,34279,3.842075767765075,0.0,0.0
28922,2,8922,[ 64  12 269 301 357],416,5,34284,3.842205536254623,40.0,0.0
28923,2,8923,[ 50 144 568 588 742],654,5,34289,3.8423352756611386,0.0,20.0
28924,2,8924,[183 179 172 144 546],417,2,34291,3.8421288515406165,0.0,0.0
28925,2,8925,[ 64  12 269 301 357],416,5,34296,3.842258570468295,40.0,0.0
28926,2,8926,[ 64  12 269 301 357],416,5,34301,3.8423882603338186,40.0,0.0
28927,2,8927,[ 64  12 269 301 357],416,5,34306,3.8425179211469533,40.0,0.0
28928,2,8928,[111 238  70 195 603],416,5,34311,3.8426475529174597,0.0,0.0
28929,2,8929,[288 196  97 742 323],416,4,34315,3.8426651735722284,0.0,20.0
28930,2,8930,[143 228 603 100 257],698,1,34316,3.842346881648192,0.0,0.0
28931,2,8931,[176 135 100 132 301],437,3,34319,3.8422525750111958,0.0,0.0
28932,2,8932,[300 286 100 588 328],416,5,34324,3.842382178439494,0.0,0.0
28933,2,8933,[161   7 100 588 183],618,5,34329,3.8425117528542647,0.0,0.0
28934,2,8934,[235 508 471 423  96],854,2,34331,3.842305540011192,0.0,0.0
28935,2,8935,[ 64  12 269 357 301],416,5,34336,3.8424350940017904,40.0,0.0
28936,2,8936,[ 11   1  70 172 183],230,4,34340,3.842452724627951,0.0,0.0
28937,2,8937,[ 15 183 603 322 268],416,4,34344,3.8424703513090175,0.0,0.0
28938,2,8938,[ 88  28 215 597  97],588,4,34348,3.842487974046314,0.0,0.0
28939,2,8939,[ 64  12 269 357 301],416,5,34353,3.8426174496644294,40.0,0.0
28940,2,8940,[245 748 300 151 328],46,3,34356,3.8425232076948888,0.0,0.0
28941,2,8941,[ 64  12 269 357 301],416,5,34361,3.8426526504137777,40.0,0.0
28942,2,8942,[546 282 515 117 435],297,2,34363,3.842446606284245,0.0,0.0
28943,2,8943,[ 64  12 269 357 301],416,5,34368,3.84257602862254,40.0,0.0
28944,2,8944,[100 132  69 275 111],764,5,34373,3.8427054220234766,0.0,0.0
28945,2,8945,[ 69 153  56  82 222],922,2,34375,3.8424994410909905,0.0,0.0
28946,2,8946,[204 257 191 318 313],416,4,34379,3.8425170448194925,40.0,20.0
28947,2,8947,[117  82   8 179 172],416,4,34383,3.8425346446133215,0.0,0.0
28948,2,8948,[471  70 174 276 597],416,3,34386,3.8424404961448206,0.0,0.0
28949,2,8949,[100  15  22  95 268],588,4,34390,3.8424581005586593,0.0,0.0
28950,2,8950,[ 12 496  64 597 268],416,4,34394,3.8424757010389903,40.0,0.0
28951,2,8951,[ 64  28   1 269 204],345,3,34397,3.8423815907059873,20.0,0.0
28952,2,8952,[ 64  12 269 357 301],416,5,34402,3.8425108902044007,40.0,0.0
28953,2,8953,[132  89 204 191 168],373,4,34406,3.8425284788921155,0.0,0.0
28954,2,8954,[273 475 322 151 127],416,2,34408,3.842322724734785,0.0,0.0
28955,2,8955,[603 132 475 289 269],416,3,34411,3.842228673514962,0.0,0.0
28956,2,8956,[121   1 127 195 245],62,3,34414,3.842134643295746,0.0,0.0
28957,2,8957,[185 265 588 328 286],416,5,34419,3.8422638981915607,0.0,0.0
28958,2,8958,[ 15 181  82 423  96],373,3,34422,3.8421698850318116,0.0,20.0
28959,2,8959,[265 228 588 121 196],230,4,34426,3.8421875,0.0,0.0
28960,2,8960,[ 89 385 195 186 204],642,3,34429,3.842093516348622,0.0,0.0
28961,2,8961,[186  89 423 257 235],642,2,34431,3.8418879714349474,0.0,0.0
28962,2,8962,[182 172 286  79 423],416,5,34436,3.842017181747183,0.0,0.0
28963,2,8963,[ 64  12 269 357 301],416,5,34441,3.8421463632307007,40.0,0.0
28964,2,8964,[ 64  12 269 357 301],416,5,34446,3.842275515895148,40.0,0.0
28965,2,8965,[748 496 151 161  82],373,4,34450,3.8422931072942226,0.0,0.0
28966,2,8966,[655 322 100 269  11],805,2,34452,3.8420876547340246,0.0,0.0
28967,2,8967,[238 318 168 194 121],854,3,34455,3.841993755575379,20.0,0.0
28968,2,8968,[ 64  12 269 357 301],416,5,34460,3.842122867655257,40.0,0.0
28969,2,8969,[125 118  95 210 180],887,5,34465,3.842251950947603,0.0,0.0
28970,2,8970,[ 64  12 269 357 301],416,5,34470,3.842381005462044,40.0,0.0
28971,2,8971,[222 271 300 216 603],297,3,34473,3.842287115470352,0.0,0.0
28972,2,8972,[ 64  12 269 357 301],416,5,34478,3.8424161373007912,40.0,0.0
28973,2,8973,[153 216 181  89  15],198,4,34482,3.842433697347894,0.0,20.0
28974,2,8974,[ 64  12 269 357 301],416,5,34487,3.8425626740947076,40.0,0.0
28975,2,8975,[183 294 175 655 200],805,3,34490,3.8424688057040997,0.0,0.0
28976,2,8976,[ 64  12 269 357 301],416,5,34495,3.842597749805057,40.0,0.0
28977,2,8977,[ 64  12 269 357 301],416,5,34500,3.842726665181555,40.0,0.0
28978,2,8978,[302 194 200  69 195],416,5,34505,3.8428555518431895,0.0,0.0
28979,2,8979,[ 89 153  97  50 258],354,3,34508,3.8427616926503343,0.0,20.0
28980,2,8980,[127 181  15 118 294],601,2,34510,3.842556508183944,0.0,20.0
28981,2,8981,[ 64  12 269 357 301],416,5,34515,3.8426853707414828,40.0,0.0
28982,2,8982,[423 405 202 588 135],230,4,34519,3.8427028832238674,0.0,0.0
28983,2,8983,[ 64  12 269 357 301],416,5,34524,3.8428317008014248,40.0,0.0
28984,2,8984,[ 64  12 269 357 301],416,5,34529,3.842960489705064,40.0,0.0
28985,2,8985,[ 64  12 269 357 301],416,5,34534,3.843089249944358,40.0,0.0
28986,2,8986,[748 185  79 385 276],198,0,34534,3.842661622343385,0.0,0.0
28987,2,8987,[257 111 269 216 588],297,3,34537,3.842567868268803,0.0,0.0
28988,2,8988,[151   1 300 748 742],654,5,34542,3.842696629213483,0.0,0.0
28989,2,8989,[ 64  12 269 357 301],416,5,34547,3.842825361512792,40.0,0.0
28990,2,8990,[ 64  12 269 357 301],416,5,34552,3.8429540651762872,40.0,0.0
28991,2,8991,[ 64  12 269 357 301],416,5,34557,3.8430827402135233,40.0,0.0
28992,2,8992,[568 168   9 215  71],618,4,34561,3.843100189035917,0.0,0.0
28993,2,8993,[ 98 257 237   7 151],416,2,34563,3.842895263509006,0.0,20.0
28994,2,8994,[186 197  79 179 216],128,4,34567,3.8429127292940524,0.0,0.0
28995,2,8995,[655 294 568 202  97],417,4,34571,3.8429301911960874,0.0,0.0
28996,2,8996,[ 64  12 269 357 301],416,5,34576,3.8430587973769033,40.0,0.0
28997,2,8997,[ 64  12 269 357 301],416,5,34581,3.843187374972216,40.0,0.0
28998,2,8998,[ 64  12 269 357 301],416,5,34586,3.8433159239915544,40.0,0.0
28999,2,8999,[323 322 168 405 385],416,3,34589,3.8432222222222223,0.0,0.0
29000,2,9000,[ 64  12 269 357 301],416,5,34594,3.8433507388067993,40.0,0.0
29001,2,9001,[  7  22 151 357 173],297,4,34598,3.8433681404132414,0.0,0.0
29002,2,9002,[ 64  12 269 357 301],416,5,34603,3.843496612240364,40.0,0.0
29003,2,9003,[ 82 265 275 186 597],588,4,34607,3.843513993780542,0.0,0.0
29004,2,9004,[111   1 268  56 222],417,3,34610,3.8434203220433094,0.0,0.0
29005,2,9005,[ 88  69 191 186  95],405,3,34613,3.84332667110815,0.0,0.0
29006,2,9006,[194  15 172 127 215],373,4,34617,3.843344065726657,0.0,0.0
29007,2,9007,[ 64  12 269 357 301],416,5,34622,3.8434724689165187,40.0,0.0
29008,2,9008,[ 64  12 269 357 301],416,5,34627,3.8436008436008438,40.0,0.0
29009,2,9009,[ 64  12 269 357 301],416,5,34632,3.8437291897891233,40.0,0.0
29010,2,9010,[ 82 117 195  28 191],373,3,34635,3.8436355565420044,0.0,0.0
29011,2,9011,[ 28 245 269  97 211],416,4,34639,3.843652907234798,0.0,0.0
29012,2,9012,[ 89 191  69  82 125],417,4,34643,3.843670254077444,0.0,0.0
29013,2,9013,[ 64  12 269 357 301],416,5,34648,3.8437985356112714,40.0,0.0
29014,2,9014,[546  25 185 678 597],805,3,34651,3.8437049362174154,0.0,0.0
29015,2,9015,[ 25 294  98 268 228],297,3,34654,3.843611357586513,0.0,20.0
29016,2,9016,[385 275  12 257 405],416,4,34658,3.8436287013419097,20.0,0.0
29017,2,9017,[ 56 405  11 127 181],198,4,34662,3.8436460412508318,0.0,20.0
29018,2,9018,[357 204 508 435 275],297,3,34665,3.8435525002771924,0.0,0.0
29019,2,9019,[  1   4 603 300  95],416,4,34669,3.843569844789357,0.0,0.0
29020,2,9020,[  7 597 181  12 323],630,4,34673,3.843587185456158,20.0,20.0
29021,2,9021,[ 64  12 269 357 301],416,5,34678,3.843715362447351,40.0,0.0
29022,2,9022,[ 64  12 269 357 301],416,5,34683,3.8438435110273743,40.0,0.0
29023,2,9023,[ 12 176 508 183 282],297,4,34687,3.843860815602837,20.0,0.0
29024,2,9024,[ 64  12 269 357 301],416,5,34692,3.84398891966759,40.0,0.0
29025,2,9025,[588 202 234 655  28],805,1,34693,3.8436738311544425,0.0,0.0
29026,2,9026,[ 64  12 269 357 301],416,5,34698,3.843801927550681,40.0,0.0
29027,2,9027,[174 435 197 588 742],297,2,34700,3.8435976960567126,0.0,0.0
29028,2,9028,[496 187 282 127 276],618,3,34703,3.8435042640380996,0.0,0.0
29029,2,9029,[ 64  12 269 357 301],416,5,34708,3.8436323366555927,40.0,0.0
29030,2,9030,[288 678 403 202 597],588,2,34710,3.8434281917838558,0.0,20.0
29031,2,9031,[174 568 742 204 269],345,5,34715,3.8435562444641276,0.0,0.0
29032,2,9032,[ 28  64  96 100 294],416,5,34720,3.8436842687922064,20.0,0.0
29033,2,9033,[ 12 204 423  88 117],618,4,34724,3.8437015718397167,20.0,0.0
29034,2,9034,[173 405 175 117 144],854,3,34727,3.84360819037078,0.0,0.0
29035,2,9035,[ 12 185 603 496 435],437,4,34731,3.843625498007968,20.0,0.0
29036,2,9036,[328   1 294 403  88],38,4,34735,3.8436428018147617,0.0,0.0
29037,2,9037,[228  15 257   7 100],62,2,34737,3.84343881389688,0.0,0.0
29038,2,9038,[173 195  12 200 288],854,4,34741,3.843456134528156,20.0,20.0
29039,2,9039,[357 427 100 195 215],198,3,34744,3.843362831858407,0.0,0.0
29040,2,9040,[173 423 269 111 196],721,5,34749,3.843490764295985,0.0,0.0
29041,2,9041,[132 168 135 275 257],711,4,34753,3.8435080734350806,0.0,0.0
29042,2,9042,[ 64  12 269 357 301],416,5,34758,3.8436359615171956,40.0,0.0
29043,2,9043,[202 269 294 210  95],43,5,34763,3.8437638213180008,0.0,0.0
29044,2,9044,[275 234 132 196 179],416,4,34767,3.843781094527363,0.0,0.0
29045,2,9045,[318 269 288 238 191],854,5,34772,3.8439089100154766,20.0,20.0
29046,2,9046,[ 64  12 269 357 301],416,5,34777,3.8440366972477062,40.0,0.0
29047,2,9047,[ 64  12 269 357 301],416,5,34782,3.844164456233422,40.0,0.0
29048,2,9048,[  8 185  70 161 144],711,4,34786,3.844181677533429,0.0,0.0
29049,2,9049,[ 97 125 286 181 742],417,3,34789,3.8440883977900553,0.0,20.0
29050,2,9050,[322 318  11 268 237],854,2,34791,3.8438846536294333,20.0,0.0
29051,2,9051,[275 603 143 168 204],297,4,34795,3.8439019001325674,0.0,0.0
29052,2,9052,[ 15 187  88 127 318],416,4,34799,3.8439191428255826,20.0,0.0
29053,2,9053,[197 186 111 238 423],128,4,34803,3.8439363817097414,0.0,0.0
29054,2,9054,[182  25 176 265 268],416,5,34808,3.844064053009387,0.0,0.0
29055,2,9055,[ 64  12 269 357 301],416,5,34813,3.844191696113074,40.0,0.0
29056,2,9056,[ 64  12 269 357 301],416,5,34818,3.8443193110301426,40.0,0.0
29057,2,9057,[471 588 168 210 153],922,2,34820,3.844115698829764,0.0,0.0
29058,2,9058,[ 64  12 269 357 301],416,5,34825,3.844243293961806,40.0,0.0
29059,2,9059,[ 64  12 269 357 301],416,5,34830,3.8443708609271523,40.0,0.0
29060,2,9060,[275  64 288 153  12],416,5,34835,3.8444983997351287,40.0,20.0
29061,2,9061,[ 25 202   8 423 273],618,2,34837,3.8442948576473186,0.0,0.0
29062,2,9062,[172 234 127 132  71],175,4,34841,3.8443120379565263,0.0,0.0
29063,2,9063,[196  97 132  89  22],496,2,34843,3.844108561341571,0.0,0.0
29064,2,9064,[ 64  12 269 357 301],416,5,34848,3.8442360728075013,40.0,0.0
29065,2,9065,[143 427  95 405 294],230,5,34853,3.844363556143834,0.0,0.0
29066,2,9066,[ 56 282 258   9 475],854,4,34857,3.844380721297011,0.0,0.0
29067,2,9067,[174   9 294  97 742],416,5,34862,3.8445081605646227,0.0,0.0
29068,2,9068,[ 64  12 269 357 301],416,5,34867,3.844635571727864,40.0,0.0
29069,2,9069,[200 271 211 286 235],297,2,34869,3.8444321940463064,0.0,0.0
29070,2,9070,[475 568   9  12 269],805,3,34872,3.84433910263477,20.0,0.0
29071,2,9071,[ 64  12 269 357 301],416,5,34877,3.8444664902998236,40.0,0.0
29072,2,9072,[228 176  98 508  25],417,2,34879,3.844263198501047,0.0,20.0
29073,2,9073,[182  96 215 111  56],416,5,34884,3.8443905664536038,0.0,0.0
29074,2,9074,[125 288 268 323 385],417,3,34887,3.844297520661157,0.0,20.0
29075,2,9075,[238 276   1  97 191],128,4,34891,3.8443146760687528,0.0,0.0
29076,2,9076,[196   1  70 568 174],62,2,34893,3.8441114905805884,0.0,0.0
29077,2,9077,[ 64  12 269 357 301],416,5,34898,3.844238819123155,40.0,0.0
29078,2,9078,[ 64  12 269 357 301],416,5,34903,3.844366119616698,40.0,0.0
29079,2,9079,[ 50 294 748 182 185],416,5,34908,3.8444933920704845,0.0,20.0
29080,2,9080,[ 71 181  95 588 235],43,4,34912,3.8445105164629445,0.0,20.0
29081,2,9081,[ 11   4 238 323 210],805,2,34914,3.8443074212728474,0.0,0.0
29082,2,9082,[269 117  98  50 176],416,5,34919,3.8444346581525926,0.0,40.0
29083,2,9083,[322 161 655 197 403],805,2,34921,3.8442316160281815,0.0,0.0
29084,2,9084,[742 286  15 268  12],588,5,34926,3.844358833241607,20.0,0.0
29085,2,9085,[ 15 265 179 174 222],198,2,34928,3.844155844155844,0.0,0.0
29086,2,9086,[ 64  12 269 357 301],416,5,34933,3.8442830417079343,40.0,0.0
29087,2,9087,[271 144 176   7 181],297,3,34936,3.8441901408450705,0.0,20.0
29088,2,9088,[187 111  88 183 132],416,4,34940,3.844207283529541,0.0,0.0
29089,2,9089,[238 144 258 405 195],416,5,34945,3.8443344334433442,0.0,0.0
29090,2,9090,[405  82   9  69  11],416,5,34950,3.8444615553844463,0.0,0.0
29091,2,9091,[423 568  15 288 181],416,5,34955,3.8445886493620764,0.0,40.0
29092,2,9092,[ 79 179 127 678 322],416,2,34957,3.8443857912680084,0.0,0.0
29093,2,9093,[151  98 483 496 234],437,5,34962,3.844512865625687,20.0,20.0
29094,2,9094,[ 64  12 269 357 301],416,5,34967,3.844639912039582,40.0,0.0
29095,2,9095,[ 28 186 172 742 568],128,3,34970,3.844547053649956,0.0,0.0
29096,2,9096,[ 98 173 135 423 568],618,4,34974,3.8445641420248435,0.0,20.0
29097,2,9097,[ 25 174 496  95 568],698,0,34974,3.844141569575731,0.0,0.0
29098,2,9098,[427 588  22  88 161],405,2,34976,3.843938894383998,0.0,0.0
29099,2,9099,[ 64  12 269 357 301],416,5,34981,3.844065934065934,40.0,0.0
29100,2,9100,[515 183 268 257 403],416,4,34985,3.844083067794748,0.0,0.0
29101,2,9101,[ 97 200   7 265 475],417,3,34988,3.8439903317952098,0.0,0.0
29102,2,9102,[  1  98 257 175  64],43,4,34992,3.8440074700648137,20.0,20.0
29103,2,9103,[318 181 603 161 471],416,5,34997,3.844134446397188,20.0,20.0
29104,2,9104,[ 56 182 168 180 385],198,3,35000,3.844041735310269,0.0,0.0
29105,2,9105,[168   1 185 238 568],416,5,35005,3.8441686799912147,0.0,0.0
29106,2,9106,[183 100 168 181  50],601,5,35010,3.844295596793675,0.0,40.0
29107,2,9107,[ 64  12 269 357 301],416,5,35015,3.8444224857268336,40.0,0.0
29108,2,9108,[216 172 185 275 181],618,3,35018,3.8443297837303767,0.0,20.0
29109,2,9109,[ 64  12 269 357 301],416,5,35023,3.844456641053787,40.0,0.0
29110,2,9110,[196 288 222 151 173],805,3,35026,3.844363955657996,0.0,20.0
29111,2,9111,[ 64  12 269 357 301],416,5,35031,3.8444907813871816,40.0,0.0
29112,2,9112,[ 64  12 269 357 301],416,5,35036,3.844617579282344,40.0,0.0
29113,2,9113,[185  64 405 288  71],262,2,35038,3.8444151854290105,20.0,20.0
29114,2,9114,[238 471 245  97 173],416,4,35042,3.844432254525507,0.0,0.0
29115,2,9115,[ 64  12 269 357 301],416,5,35047,3.844559017112769,40.0,0.0
29116,2,9116,[ 64  12 269 357 301],416,5,35052,3.8446857518920696,40.0,0.0
29117,2,9117,[ 64  12 269 357 301],416,5,35057,3.8448124588725596,40.0,0.0
29118,2,9118,[ 64  12 269 357 301],416,5,35062,3.844939138063384,40.0,0.0
29119,2,9119,[ 64  12 269 357 301],416,5,35067,3.845065789473684,40.0,0.0
29120,2,9120,[176 172 118 185   9],618,3,35070,3.8449731389102073,0.0,0.0
29121,2,9121,[ 64  12 269 357 301],416,5,35075,3.8450997588248192,40.0,0.0
29122,2,9122,[ 64  12 269 357 301],416,5,35080,3.845226350981037,40.0,0.0
29123,2,9123,[ 64  12 269 357 301],416,5,35085,3.8453529153879877,40.0,0.0
29124,2,9124,[197 182   4  89 143],405,3,35088,3.845260273972603,0.0,0.0
29125,2,9125,[ 88 235 742 125 187],416,3,35091,3.8451676528599608,0.0,0.0
29126,2,9126,[ 64  12 269 357 301],416,5,35096,3.8452941820970747,40.0,0.0
29127,2,9127,[195 194 328  12  64],416,5,35101,3.8454206836108678,40.0,0.0
29128,2,9128,[ 64  12 269 357 301],416,5,35106,3.8455471574104503,40.0,0.0
29129,2,9129,[245 597 322 153 288],417,2,35108,3.845345016429354,0.0,20.0
29130,2,9130,[132 301 496 546  71],416,4,35112,3.8453619537838133,0.0,0.0
29131,2,9131,[435 742 181 588 161],230,5,35117,3.8454883924660535,0.0,20.0
29132,2,9132,[ 64  12 269 357 301],416,5,35122,3.84561480345998,40.0,0.0
29133,2,9133,[ 64  12 269 357 301],416,5,35127,3.845741186774688,40.0,0.0
29134,2,9134,[  7  96 318 200   1],96,5,35132,3.8458675424192665,20.0,0.0
29135,2,9135,[ 64  12 269 357 301],416,5,35137,3.8459938704028023,40.0,0.0
29136,2,9136,[300 197  22 748 200],297,1,35138,3.845682390281274,0.0,0.0
29137,2,9137,[191 210  56 288 403],922,0,35138,3.845261545195885,0.0,20.0
29138,2,9138,[ 64  12 269 357 301],416,5,35143,3.845387898019477,40.0,0.0
29139,2,9139,[100 742 322 568 323],416,3,35146,3.8452954048140042,0.0,0.0
29140,2,9140,[742 568 204 172 275],416,5,35151,3.8454217262881523,0.0,0.0
29141,2,9141,[258  89 194 508 257],297,3,35154,3.8453292496171514,0.0,0.0
29142,2,9142,[ 56 405 100 655  88],416,4,35158,3.845346166466149,0.0,0.0
29143,2,9143,[100 117  69 568 294],654,3,35161,3.8452537182852145,0.0,0.0
29144,2,9144,[ 64  12 269 357 301],416,5,35166,3.845379989065063,40.0,0.0
29145,2,9145,[ 98 237 176 121 423],437,3,35169,3.845287557402143,0.0,20.0
29146,2,9146,[ 64  12 269 357 301],416,5,35174,3.845413796873292,40.0,0.0
29147,2,9147,[405 275 546 174 195],262,1,35175,3.845102754700481,0.0,0.0
29148,2,9148,[117 176 234 174 191],618,5,35180,3.845228986774511,0.0,0.0
29149,2,9149,[ 69 588 196 318 748],437,3,35183,3.8451366120218577,20.0,0.0
29150,2,9150,[ 64  12 269 357 301],416,5,35188,3.8452628128073436,40.0,0.0
29151,2,9151,[ 64  12 269 357 301],416,5,35193,3.845388986013986,40.0,0.0
29152,2,9152,[111 423 210 318  82],43,5,35198,3.8455151316508247,20.0,0.0
29153,2,9153,[127 423 153   1 161],38,4,35202,3.845532007865414,0.0,0.0
29154,2,9154,[  1 173 196  96 286],416,5,35207,3.8456581103222285,0.0,0.0
29155,2,9155,[202 168 161 210  71],618,3,35210,3.845565749235474,0.0,0.0
29156,2,9156,[ 64  12 269 357 301],416,5,35215,3.845691820465218,40.0,0.0
29157,2,9157,[405  88 143 597 111],805,0,35215,3.845271893426512,0.0,0.0
29158,2,9158,[210 568  11 181 265],505,4,35219,3.8452887869854786,0.0,20.0
29159,2,9159,[222 215 328  56 216],128,1,35220,3.8449781659388647,0.0,0.0
29160,2,9160,[678 588  97 144 294],38,5,35225,3.845104246261325,0.0,0.0
29161,2,9161,[187  95 121 237 151],505,2,35227,3.844902859637634,0.0,0.0
29162,2,9162,[143 496  97 301  71],43,5,35232,3.8450289206591726,0.0,0.0
29163,2,9163,[168 204 357  89 235],642,2,35234,3.8448275862068964,0.0,0.0
29164,2,9164,[ 64  12 269 301 357],416,5,35239,3.8449536279323513,40.0,0.0
29165,2,9165,[181  56 234 588 483],417,3,35242,3.844861444468689,20.0,20.0
29166,2,9166,[  1  82 211  70 204],43,5,35247,3.8449874550016365,0.0,0.0
29167,2,9167,[ 64  12 269 301 357],416,5,35252,3.845113438045375,40.0,0.0
29168,2,9168,[ 64  12 269 301 357],416,5,35257,3.8452393936088995,40.0,0.0
29169,2,9169,[427 228  70  71  97],128,2,35259,3.8450381679389314,0.0,0.0
29170,2,9170,[496 216 125  71 121],416,5,35264,3.8451641042416314,0.0,0.0
29171,2,9171,[508 144 234 222  97],417,2,35266,3.844962930658526,0.0,0.0
29172,2,9172,[153 748 568  70 210],416,5,35271,3.8450888477052216,0.0,0.0
29173,2,9173,[ 82  71  15 176 568],198,1,35272,3.844778722476564,0.0,0.0
29174,2,9174,[ 79  56 323 210 385],805,3,35275,3.844686648501362,0.0,0.0
29175,2,9175,[121 202 183 238 475],805,3,35278,3.8445945945945947,0.0,0.0
29176,2,9176,[ 64  12 269 301 357],416,5,35283,3.8447204968944098,40.0,0.0
29177,2,9177,[100 568 168 111 121],62,3,35286,3.8446284593593374,0.0,0.0
29178,2,9178,[153  96  82 144 186],373,3,35289,3.8445364418782004,0.0,0.0
29179,2,9179,[ 64  12 269 301 357],416,5,35294,3.8446623093681915,40.0,0.0
29180,2,9180,[588 471  12  22 245],416,4,35298,3.844679228842174,20.0,0.0
29181,2,9181,[183  82 191  89 200],405,2,35300,3.8444783271618386,0.0,0.0
29182,2,9182,[191 222  95 179   7],417,3,35303,3.8443863661112925,0.0,0.0
29183,2,9183,[742 182 121 238  69],62,4,35307,3.8444033101045294,0.0,0.0
29184,2,9184,[294 117  64  96 357],417,4,35311,3.8444202504082745,20.0,0.0
29185,2,9185,[117 121 475 195 179],805,2,35313,3.8442194644023515,0.0,0.0
29186,2,9186,[117 271   7 100 211],297,4,35317,3.844236421029716,0.0,0.0
29187,2,9187,[265 197 289 288 211],416,4,35321,3.8442533739660427,0.0,20.0
29188,2,9188,[265 427 176 357 118],416,4,35325,3.8442703232125366,0.0,0.0
29189,2,9189,[ 64  12 269 301 357],416,5,35330,3.8443960826985855,40.0,0.0
29190,2,9190,[196  12 195 288 323],416,4,35334,3.8444130127298446,20.0,20.0
29191,2,9191,[ 64  12 269 301 357],416,5,35339,3.844538729329852,40.0,0.0
29192,2,9192,[ 69 313  71 143 172],654,4,35343,3.844555640160992,20.0,20.0
29193,2,9193,[ 64  12 269 301 357],416,5,35348,3.8446813139003697,40.0,0.0
29194,2,9194,[ 71 215 216 172  22],416,5,35353,3.8448069603045134,0.0,0.0
29195,2,9195,[ 64  12 269 301 357],416,5,35358,3.8449325793823403,40.0,0.0
29196,2,9196,[117 173 153  97 204],654,4,35362,3.844949440034794,0.0,0.0
29197,2,9197,[238 222  15 515 181],417,3,35365,3.84485757773429,0.0,20.0
29198,2,9198,[ 64  12 269 301 357],416,5,35370,3.8449831503424283,40.0,0.0
29199,2,9199,[153 173  56 174 197],805,4,35374,3.845,0.0,0.0
29200,2,9200,[301 483  15 195  97],437,2,35376,3.844799478317574,20.0,0.0
29201,2,9201,[143 196  28 282 568],705,4,35380,3.844816344272984,0.0,0.0
29202,2,9202,[  1  79   7 357 204],805,4,35384,3.8448332065630773,0.0,0.0
29203,2,9203,[ 64  12 269 357 301],416,5,35389,3.8449587136027814,40.0,0.0
29204,2,9204,[191 258 168  69 237],642,4,35393,3.844975556762629,0.0,0.0
29205,2,9205,[ 64  12 269 357 301],416,5,35398,3.845101021073213,40.0,0.0
29206,2,9206,[302 568 288 127 132],405,5,35403,3.8452264581296838,0.0,20.0
29207,2,9207,[ 64  12 269 357 301],416,5,35408,3.845351867940921,40.0,0.0
29208,2,9208,[ 98 258 185 125 678],416,4,35412,3.8453686610924094,0.0,20.0
29209,2,9209,[238 182 179 568 357],198,4,35416,3.845385450597177,0.0,0.0
29210,2,9210,[357 151 273 196 194],297,3,35419,3.8452936706112255,0.0,0.0
29211,2,9211,[273  89 174 144  25],805,2,35421,3.8450933564915326,0.0,0.0
29212,2,9212,[ 69 282 191 204 423],618,3,35424,3.8450016281341584,0.0,0.0
29213,2,9213,[ 56  50  82 748 385],751,4,35428,3.8450184501845017,0.0,20.0
29214,2,9214,[ 97 471 318 423 234],588,3,35431,3.8449267498643516,20.0,0.0
29215,2,9215,[ 28  56  64 286 143],43,5,35436,3.8450520833333335,20.0,0.0
29216,2,9216,[ 82 153 182 403   9],416,5,35441,3.8451773896061625,0.0,0.0
29217,2,9217,[196 191 111  12  96],618,3,35444,3.8450857018876112,20.0,0.0
29218,2,9218,[222  79 282 196 185],921,3,35447,3.844994034060093,0.0,0.0
29219,2,9219,[ 64  12 269 357 301],416,5,35452,3.845119305856833,40.0,0.0
29220,2,9220,[ 69 204 211 289 568],43,5,35457,3.8452445504825943,0.0,0.0
29221,2,9221,[187 235 194 322 475],416,2,35459,3.845044458902624,0.0,0.0
29222,2,9222,[125 194  50 238  71],416,5,35464,3.845169684484441,0.0,20.0
29223,2,9223,[ 25 100 302 216 294],43,5,35469,3.845294882914137,0.0,0.0
29224,2,9224,[496 318  98 302 196],43,5,35474,3.845420054200542,20.0,20.0
29225,2,9225,[268 222 186 475  97],588,2,35476,3.845220030349014,0.0,0.0
29226,2,9226,[ 64  12 269 357 301],416,5,35481,3.845345182616235,40.0,0.0
29227,2,9227,[ 64  12 269 357 301],416,5,35486,3.8454703077589945,40.0,0.0
29228,2,9228,[216  69 275 742 603],297,3,35489,3.8453786975837034,0.0,0.0
29229,2,9229,[ 64  12 269 357 301],416,5,35494,3.845503791982665,40.0,0.0
29230,2,9230,[151 100 257  50 471],297,2,35496,3.845303867403315,0.0,20.0
29231,2,9231,[288 423 234  12 132],437,4,35500,3.845320623916811,20.0,20.0
29232,2,9232,[318   1 200 238 153],854,4,35504,3.8453373768006065,20.0,0.0
29233,2,9233,[ 22  11 143  69 655],262,4,35508,3.8453541260558803,0.0,0.0
29234,2,9234,[405 161 144 568 211],43,5,35513,3.8454791553871144,0.0,0.0
29235,2,9235,[258  15 111 180 568],128,3,35516,3.845387613685578,0.0,0.0
29236,2,9236,[515   7 174  64 333],416,5,35521,3.845512612320017,20.0,0.0
29237,2,9237,[215 268 174 333 125],416,5,35526,3.8456375838926173,0.0,0.0
29238,2,9238,[318  82 196 245 235],62,4,35530,3.845654291589999,20.0,0.0
29239,2,9239,[174 403 238 179 357],405,4,35534,3.8456709956709956,0.0,0.0
29240,2,9240,[121 286 117 172 258],417,3,35537,3.8455794827399634,0.0,0.0
29241,2,9241,[  1 568 210 471 118],128,5,35542,3.8457043929885306,0.0,0.0
29242,2,9242,[238  70 210 496 323],416,4,35546,3.845721086227415,0.0,0.0
29243,2,9243,[ 64  12 269 357 301],416,5,35551,3.84584595413241,40.0,0.0
29244,2,9244,[121 216 234  89 265],198,2,35553,3.845646295294754,0.0,0.0
29245,2,9245,[483 172  98   1 132],128,3,35556,3.845554834523037,20.0,20.0
29246,2,9246,[ 64  12 269 357 301],416,5,35561,3.8456796798961825,40.0,0.0
29247,2,9247,[435 357 222 187 515],698,3,35564,3.8455882352941178,0.0,0.0
29248,2,9248,[ 25 127  79 405 322],854,3,35567,3.8454968104659963,0.0,0.0
29249,2,9249,[258 202 748 215 265],416,5,35572,3.8456216216216217,0.0,0.0
29250,2,9250,[176 228  56 568 210],405,3,35575,3.8455302129499516,0.0,0.0
29251,2,9251,[ 82  25  96 268   1],49,0,35575,3.845114569822741,0.0,0.0
29252,2,9252,[161 202  28 427 568],128,4,35579,3.8451313087647248,0.0,0.0
29253,2,9253,[288 245 191 135 197],297,1,35580,3.844823859952453,0.0,20.0
29254,2,9254,[125  56 268  11 742],345,4,35584,3.8448406266882764,0.0,0.0
29255,2,9255,[ 64  12 269 357 301],416,5,35589,3.8449654278305965,40.0,0.0
29256,2,9256,[ 71 196 238  95 186],618,3,35592,3.844874149292427,0.0,0.0
29257,2,9257,[403  50  12 405 117],345,4,35596,3.844890905163102,20.0,20.0
29258,2,9258,[183 257 143 427 195],922,3,35599,3.844799654390323,0.0,0.0
29259,2,9259,[ 64  12 269 357 301],416,5,35604,3.8449244060475163,40.0,0.0
29260,2,9260,[483 196 508 568 111],62,3,35607,3.8448331713637836,20.0,0.0
29261,2,9261,[ 64  12 269 357 301],416,5,35612,3.844957892463831,40.0,0.0
29262,2,9262,[ 64  12 269 357 301],416,5,35617,3.8450825866349994,40.0,0.0
29263,2,9263,[597 111 265  22 289],588,3,35620,3.8449913644214164,0.0,0.0
29264,2,9264,[ 64  12 269 357 301],416,5,35625,3.845116028062601,40.0,0.0
29265,2,9265,[ 64  12 269 357 301],416,5,35630,3.8452406647960284,40.0,0.0
29266,2,9266,[475 143  28  22  82],588,4,35634,3.845257364842991,0.0,0.0
29267,2,9267,[385   1 211 175  69],43,4,35638,3.845274061286146,0.0,0.0
29268,2,9268,[ 25   8 151 273 111],854,3,35641,3.8451828676232602,0.0,0.0
29269,2,9269,[ 64  12 269 357 301],416,5,35646,3.8453074433656957,40.0,0.0
29270,2,9270,[ 64  12 269 357 301],416,5,35651,3.8454319922338476,40.0,0.0
29271,2,9271,[  1 313  56  12 151],618,4,35655,3.845448662640207,40.0,20.0
29272,2,9272,[ 64  12 269 357 301],416,5,35660,3.845573169416586,40.0,0.0
29273,2,9273,[302 276 496 121  56],214,4,35664,3.84558982100496,0.0,0.0
29274,2,9274,[427 161 275 204 195],373,5,35669,3.8457142857142856,0.0,0.0
29275,2,9275,[196   7 195 496 237],618,4,35673,3.845730918499353,0.0,0.0
29276,2,9276,[182 568 265  69 121],505,3,35676,3.8456397542308935,0.0,0.0
29277,2,9277,[ 64  12 269 357 301],416,5,35681,3.845764173313214,40.0,0.0
29278,2,9278,[ 64  12 269 357 301],416,5,35686,3.8458885655781874,40.0,0.0
29279,2,9279,[276  50  64  69 483],601,4,35690,3.845905172413793,40.0,20.0
29280,2,9280,[ 64  12 269 357 301],416,5,35695,3.8460295226807455,40.0,0.0
29281,2,9281,[ 64  12 269 357 301],416,5,35700,3.8461538461538463,40.0,0.0
29282,2,9282,[ 15 258 153  56 211],43,5,35705,3.846278142841754,0.0,0.0
29283,2,9283,[  1 323 173 151  95],805,4,35709,3.8462947005601036,0.0,0.0
29284,2,9284,[191 125  56  98 483],618,4,35713,3.846311254711901,20.0,20.0
29285,2,9285,[ 64  12 269 357 301],416,5,35718,3.8464354942924834,40.0,0.0
29286,2,9286,[471  25 118 100 234],297,2,35720,3.846236674921934,0.0,0.0
29287,2,9287,[ 64  12 269 357 301],416,5,35725,3.8463608957795006,40.0,0.0
29288,2,9288,[ 64  12 269 357 301],416,5,35730,3.846485089891269,40.0,0.0
29289,2,9289,[245  69   7 202 435],297,1,35731,3.846178686759957,0.0,0.0
29290,2,9290,[ 64  12 269 357 301],416,5,35736,3.846302873748789,40.0,0.0
29291,2,9291,[265  82  25 121 125],618,3,35739,3.846211795092553,0.0,0.0
29292,2,9292,[153  70  56 275 144],62,3,35742,3.846120736037878,0.0,0.0
29293,2,9293,[546 179  22 200 269],262,2,35744,3.8459221002797506,0.0,0.0
29294,2,9294,[323   7 269 427 125],416,4,35748,3.8459386767079073,0.0,0.0
29295,2,9295,[ 64  12 269 357 301],416,5,35753,3.8460628227194493,40.0,0.0
29296,2,9296,[289 275 333  82 210],416,4,35757,3.846079380445305,0.0,0.0
29297,2,9297,[328 301 748 282 496],416,5,35762,3.8462034846203483,0.0,0.0
29298,2,9298,[568 100 118  79 211],417,2,35764,3.8460049467684696,0.0,0.0
29299,2,9299,[168 143 111 294 202],588,3,35767,3.8459139784946235,0.0,0.0
29300,2,9300,[508  70  79 121 568],345,4,35771,3.8459305451026773,0.0,0.0
29301,2,9301,[ 70 151 117 216 742],297,3,35774,3.8458396043861534,0.0,0.0
29302,2,9302,[ 64  12 269 357 301],416,5,35779,3.8459636676340967,40.0,0.0
29303,2,9303,[202 655 180 161 483],437,4,35783,3.845980223559759,20.0,0.0
29304,2,9304,[185 238 318 403 288],416,5,35788,3.846104245029554,20.0,20.0
29305,2,9305,[ 64  12 269 357 301],416,5,35793,3.846228239845261,40.0,0.0
29306,2,9306,[313  50  64 435  22],405,4,35797,3.8462447620070916,40.0,40.0
29307,2,9307,[ 64  12 269 357 301],416,5,35802,3.846368715083799,40.0,0.0
29308,2,9308,[ 64  12 269 357 301],416,5,35807,3.8464926415297023,40.0,0.0
29309,2,9309,[ 64  12 269 357 301],416,5,35812,3.8466165413533835,40.0,0.0
29310,2,9310,[ 64  12 269 357 301],416,5,35817,3.8467404145634196,40.0,0.0
29311,2,9311,[ 64  12 269 357 301],416,5,35822,3.8468642611683848,40.0,0.0
29312,2,9312,[ 97 496 204 237 121],43,5,35827,3.8469880811768498,0.0,0.0
29313,2,9313,[742 588 174 234 655],416,5,35832,3.8471118745973802,0.0,0.0
29314,2,9314,[  1  50   4 144 288],805,2,35834,3.8469135802469134,0.0,40.0
29315,2,9315,[195  11 228  56 385],405,3,35837,3.846822670674109,0.0,0.0
29316,2,9316,[ 64  12 269 357 301],416,5,35842,3.846946441987764,40.0,0.0
29317,2,9317,[597 197 135   7 175],854,4,35846,3.8469628675681475,0.0,0.0
29318,2,9318,[172   8 323 216 403],805,3,35849,3.8468719819723147,0.0,0.0
29319,2,9319,[508 100 144 742 153],417,1,35850,3.84656652360515,0.0,0.0
29320,2,9320,[288 216 269 202 144],711,3,35853,3.8464757000321854,0.0,20.0
29321,2,9321,[153  70 172 111 678],654,5,35858,3.8465994421797896,0.0,0.0
29322,2,9322,[288   1  71 132 508],345,2,35860,3.8464013729486215,0.0,20.0
29323,2,9323,[568  22  56 546   1],654,5,35865,3.8465250965250966,0.0,0.0
29324,2,9324,[ 64  12 269 357 301],416,5,35870,3.8466487935656835,40.0,0.0
29325,2,9325,[323 144   1 289  95],416,2,35872,3.846450782757881,0.0,0.0
29326,2,9326,[153 508 265 185 405],417,1,35873,3.8461455987991853,0.0,0.0
29327,2,9327,[143   7 294  69 403],588,2,35875,3.8459476843910805,0.0,0.0
29328,2,9328,[168  98 496  95 265],416,4,35879,3.845964197663201,0.0,20.0
29329,2,9329,[597 100 172 265 210],417,0,35879,3.8455519828510183,0.0,0.0
29330,2,9330,[ 64  12 269 357 301],416,5,35884,3.845675704640446,40.0,0.0
29331,2,9331,[  4 151  50 302 197],345,5,35889,3.8457993999142737,0.0,20.0
29332,2,9332,[ 64  12 269 357 301],416,5,35894,3.8459230686810244,40.0,0.0
29333,2,9333,[ 96 427 179  50  64],373,4,35898,3.8459395757445898,20.0,20.0
29334,2,9334,[ 64  12 269 357 301],416,5,35903,3.8460632029994644,40.0,0.0
29335,2,9335,[403  11 294 132 195],417,5,35908,3.8461868037703515,0.0,0.0
29336,2,9336,[195  71 197 151 234],805,3,35911,3.8460961765020887,0.0,0.0
29337,2,9337,[288 191 245   4 117],417,3,35914,3.8460055686442494,0.0,20.0
29338,2,9338,[294 172 168 588 300],49,2,35916,3.8458079023450047,0.0,0.0
29339,2,9339,[121 176 427 546  64],416,4,35920,3.845824411134904,20.0,0.0
29340,2,9340,[ 69 151 288 603 508],214,3,35923,3.8457338614709347,0.0,20.0
29341,2,9341,[ 50 202 385 173  56],43,5,35928,3.8458574181117533,0.0,20.0
29342,2,9342,[204 135 211  56 357],405,4,35932,3.845873916300974,0.0,0.0
29343,2,9343,[153 211  28 257 204],297,3,35935,3.845783390410959,0.0,0.0
29344,2,9344,[  4 275 200  79 475],297,2,35937,3.845585874799358,0.0,0.0
29345,2,9345,[  8 211  96 144 515],416,5,35942,3.845709394393323,0.0,0.0
29346,2,9346,[168  22 210  15 153],373,5,35947,3.845832887557505,0.0,0.0
29347,2,9347,[588  22  64 180 202],711,5,35952,3.845956354300385,20.0,0.0
29348,2,9348,[282 202 265 144 121],416,5,35957,3.846079794630442,0.0,0.0
29349,2,9349,[ 88 202 182 183 423],505,2,35959,3.8458823529411763,0.0,0.0
29350,2,9350,[ 97 111 135 183 748],437,2,35961,3.845684953480911,0.0,0.0
29351,2,9351,[ 70  64 323 100 211],417,3,35964,3.845594525235244,20.0,0.0
29352,2,9352,[302 282  69 100 238],297,3,35967,3.8455041163263126,0.0,0.0
29353,2,9353,[194 435 197 357 210],297,2,35969,3.845306820611503,0.0,0.0
29354,2,9354,[ 28  88 143 655 215],345,4,35973,3.8453233564938536,0.0,0.0
29355,2,9355,[222 427 132 294 603],698,4,35977,3.845339888841385,0.0,0.0
29356,2,9356,[ 64  12 269 357 301],416,5,35982,3.8454632895158705,40.0,0.0
29357,2,9357,[ 64  12 269 357 301],416,5,35987,3.845586663817055,40.0,0.0
29358,2,9358,[143 228  50 742  98],128,3,35990,3.8454963137087295,0.0,40.0
29359,2,9359,[179 196  22 180 187],405,2,35992,3.8452991452991454,0.0,0.0
29360,2,9360,[403 200 191 318 275],618,4,35996,3.845315671402628,20.0,0.0
29361,2,9361,[568 238 234 496 276],230,3,35999,3.84522537919248,0.0,0.0
29362,2,9362,[234 385 588   1  95],588,4,36003,3.845241909644345,0.0,0.0
29363,2,9363,[127 238  70  12 100],618,3,36006,3.8451516445963265,20.0,0.0
29364,2,9364,[ 97 742 151  69   1],417,3,36009,3.845061398825414,0.0,0.0
29365,2,9365,[ 15 196  69 258 197],128,4,36013,3.8450779414904974,0.0,0.0
29366,2,9366,[ 88 288   8 204 215],416,4,36017,3.8450944806234655,0.0,20.0
29367,2,9367,[ 64  12 269 357 301],416,5,36022,3.845217762596072,40.0,0.0
29368,2,9368,[ 64  12 269 357 301],416,5,36027,3.845341018251681,40.0,0.0
29369,2,9369,[125 204  70 153 135],230,4,36031,3.845357524012807,0.0,0.0
29370,2,9370,[748 174 151 194 286],297,2,36033,3.8451606018567923,0.0,0.0
29371,2,9371,[ 28 210 288 275 273],416,5,36038,3.8452838241570637,0.0,20.0
29372,2,9372,[ 64  12 269 357 301],416,5,36043,3.8454070201643016,40.0,0.0
29373,2,9373,[ 28 143 546 118 294],43,5,36048,3.8455301898869214,0.0,0.0
29374,2,9374,[257 385 568 234  69],416,4,36052,3.8455466666666664,0.0,0.0
29375,2,9375,[508 151  88 318 269],345,5,36057,3.845669795221843,20.0,0.0
29376,2,9376,[181  69   1 742  25],588,4,36061,3.845686253599232,0.0,20.0
29377,2,9377,[204  82  71  98 265],416,5,36066,3.8458093410108765,0.0,20.0
29378,2,9378,[168 215  70  97 275],416,5,36071,3.845932402175072,0.0,0.0
29379,2,9379,[ 69 496  82  12 181],417,2,36073,3.8457356076759064,20.0,20.0
29380,2,9380,[173 275 111 125   7],588,1,36074,3.8454322566890524,0.0,0.0
29381,2,9381,[ 70 496 181 282  98],630,1,36075,3.8451289703687914,0.0,40.0
29382,2,9382,[ 64  12 269 357 301],416,5,36080,3.8452520515826496,40.0,0.0
29383,2,9383,[111 196  97 117 427],416,5,36085,3.845375106564365,0.0,0.0
29384,2,9384,[269 195 237 197 216],854,2,36087,3.8451784762919554,0.0,0.0
29385,2,9385,[151   8  79  96 403],805,4,36091,3.8451949712337523,0.0,0.0
29386,2,9386,[655 742  88 216 302],416,4,36095,3.845211462661127,0.0,0.0
29387,2,9387,[588 100  82 117 144],417,2,36097,3.8450149126544524,0.0,0.0
29388,2,9388,[286 328 323 204  82],721,4,36101,3.845031419746512,0.0,0.0
29389,2,9389,[546 483 153   1 222],62,4,36105,3.8450479233226837,20.0,0.0
29390,2,9390,[ 64  12 269 357 301],416,5,36110,3.845170908316473,40.0,0.0
29391,2,9391,[742 282   1 294 475],907,4,36114,3.8451873935264054,0.0,0.0
29392,2,9392,[ 22 269 180 187 183],875,4,36118,3.845203875226232,0.0,0.0
29393,2,9393,[ 64  12 269 357 301],416,5,36123,3.845326804343198,40.0,0.0
29394,2,9394,[121 655  97 216   4],198,2,36125,3.845130388504524,0.0,0.0
29395,2,9395,[471 742  79  95 313],43,4,36129,3.84514687100894,20.0,20.0
29396,2,9396,[173 143   8 185  79],805,3,36132,3.8450569330637436,0.0,0.0
29397,2,9397,[483 100  70 187 655],618,4,36136,3.8450734198765697,20.0,0.0
29398,2,9398,[200 546 234  98 288],805,3,36139,3.844983508883924,0.0,40.0
29399,2,9399,[ 22 234  71 185 172],262,2,36141,3.844787234042553,0.0,0.0
29400,2,9400,[742 121  71 238 313],416,5,36146,3.8449101159451122,20.0,20.0
29401,2,9401,[191 597 294   4  15],642,4,36150,3.844926611359285,0.0,0.0
29402,2,9402,[269 603 185 144 200],854,4,36154,3.8449431032649155,0.0,0.0
29403,2,9403,[143 211  70 234 471],297,3,36157,3.844853253934496,0.0,0.0
29404,2,9404,[  8  97 173   7  50],43,5,36162,3.844976076555024,0.0,20.0
29405,2,9405,[ 64  12 269 357 301],416,5,36167,3.845098873059749,40.0,0.0
29406,2,9406,[568 322 294 176 546],417,2,36169,3.8449027320080793,0.0,0.0
29407,2,9407,[ 64  12 269 357 301],416,5,36174,3.845025510204082,40.0,0.0
29408,2,9408,[238 153 515 403 235],417,4,36178,3.845041981081943,0.0,0.0
29409,2,9409,[ 95 172 174 423 153],805,2,36180,3.844845908607864,0.0,0.0
29410,2,9410,[100 655 151 185 183],437,4,36184,3.8448623950695993,0.0,0.0
29411,2,9411,[ 64  12 269 357 301],416,5,36189,3.8449851253718657,40.0,0.0
29412,2,9412,[153 172 210 183 357],198,5,36194,3.8451078295973655,0.0,0.0
29413,2,9413,[ 25  98 237 269 204],297,4,36198,3.8451242829827916,0.0,20.0
29414,2,9414,[ 64  12 269 357 301],416,5,36203,3.845246946362188,40.0,0.0
29415,2,9415,[ 95 678  88 204 475],805,2,36205,3.845050977060323,0.0,0.0
29416,2,9416,[ 50 117 318 111 276],43,5,36210,3.8451736221726667,20.0,20.0
29417,2,9417,[ 64  12 269 357 301],416,5,36215,3.8452962412401783,40.0,0.0
29418,2,9418,[181 273 235 118  98],805,1,36216,3.8449941607389317,0.0,40.0
29419,2,9419,[ 97 403 174 168 180],62,4,36220,3.8450106157112525,0.0,0.0
29420,2,9420,[748 328 185 195 151],416,4,36224,3.8450270671903195,0.0,0.0
29421,2,9421,[ 64  12 269 357 301],416,5,36229,3.8451496497558906,40.0,0.0
29422,2,9422,[588 153 323  97 268],416,4,36233,3.8451660829884324,0.0,0.0
29423,2,9423,[ 15 173 151 403 286],43,5,36238,3.8452886247877758,0.0,0.0
29424,2,9424,[228 200 186  70  25],198,2,36240,3.8450928381962863,0.0,0.0
29425,2,9425,[187 183 318  11 515],416,5,36245,3.8452153617653297,20.0,0.0
29426,2,9426,[ 64  12 269 357 301],416,5,36250,3.845337859340193,40.0,0.0
29427,2,9427,[276 318 161 588  22],618,4,36254,3.8453542638947815,20.0,0.0
29428,2,9428,[ 79   7   8 172 187],618,4,36258,3.8453706649697743,0.0,0.0
29429,2,9429,[117 269 151 181 211],43,5,36263,3.8454931071049843,0.0,20.0
29430,2,9430,[172 483  97  15 234],417,4,36267,3.845509489979854,20.0,0.0
29431,2,9431,[ 50 215 323 185   4],416,4,36271,3.845525869380831,0.0,20.0
29432,2,9432,[ 64  12 269 357 301],416,5,36276,3.8456482561221246,40.0,0.0
29433,2,9433,[ 64  12 269 357 301],416,5,36281,3.8457706169175325,40.0,0.0
29434,2,9434,[515 235 175 228 185],297,3,36284,3.8456809750927397,0.0,0.0
29435,2,9435,[ 25  89  71   8 423],711,3,36287,3.84559135226791,0.0,0.0
29436,2,9436,[742 546 111 294 748],872,3,36290,3.845501748437003,0.0,0.0
29437,2,9437,[ 88 202 117 265 195],618,3,36293,3.845412163593982,0.0,0.0
29438,2,9438,[  7 300 597 175 323],43,2,36295,3.8452166543066,0.0,0.0
29439,2,9439,[ 50 161 211 176 597],416,4,36299,3.8452330508474577,0.0,20.0
29440,2,9440,[268  28  70 471 603],297,4,36303,3.8452494439148395,0.0,0.0
29441,2,9441,[ 50  25 238  95  12],373,5,36308,3.84537174327473,20.0,20.0
29442,2,9442,[182 288 333 185  96],907,5,36313,3.845494016731971,0.0,20.0
29443,2,9443,[185 182 475  25  22],297,4,36317,3.8455103769589156,0.0,0.0
29444,2,9444,[ 64  12 269 357 301],416,5,36322,3.8456326098464797,40.0,0.0
29445,2,9445,[ 64  12 269 357 301],416,5,36327,3.845754816853695,40.0,0.0
29446,2,9446,[ 64  12 269 357 301],416,5,36332,3.8458769979887797,40.0,0.0
29447,2,9447,[271  11 286 275 127],43,4,36336,3.8458933107535986,0.0,0.0
29448,2,9448,[135 568 216  82 294],922,1,36337,3.8455921261509154,0.0,0.0
29449,2,9449,[210 144 475 200 322],417,2,36339,3.8453968253968256,0.0,0.0
29450,2,9450,[210 269 174 313  56],654,5,36344,3.8455189926991853,20.0,20.0
29451,2,9451,[ 15 276 168 183  71],437,2,36346,3.8453237410071943,0.0,0.0
29452,2,9452,[ 64 168 257 568 235],62,3,36349,3.8452343171479955,20.0,0.0
29453,2,9453,[748 191 282 471 153],297,1,36350,3.8449333615400887,0.0,0.0
29454,2,9454,[234 273 121 173 323],805,3,36353,3.844843997884717,0.0,0.0
29455,2,9455,[ 64  12 269 357 301],416,5,36358,3.8449661590524533,40.0,0.0
29456,2,9456,[ 64  12 269 357 301],416,5,36363,3.8450882943851115,40.0,0.0
29457,2,9457,[135   9 257  98 180],354,0,36363,3.84468175089871,0.0,20.0
29458,2,9458,[ 64  12 269 357 301],416,5,36368,3.8448038904746804,40.0,0.0
29459,2,9459,[204 175 655 265 187],405,3,36371,3.8447145877378435,0.0,0.0
29460,2,9460,[ 64  12 269 357 301],416,5,36376,3.8448366980234647,40.0,0.0
29461,2,9461,[238 215 111 275  79],297,2,36378,3.8446417247939126,0.0,0.0
29462,2,9462,[258 471  28 216  64],345,3,36381,3.8445524675050193,20.0,0.0
29463,2,9463,[210 257   9 385 328],43,5,36386,3.844674556213018,0.0,0.0
29464,2,9464,[742 597 271 222  50],708,2,36388,3.8444796619123087,0.0,20.0
29465,2,9465,[ 64  12 269 357 301],416,5,36393,3.8446017325163746,40.0,0.0
29466,2,9466,[ 64  12 269 357 301],416,5,36398,3.844723777331784,40.0,0.0
29467,2,9467,[ 64  12 269 357 301],416,5,36403,3.844845796366709,40.0,0.0
29468,2,9468,[ 64  12 269 357 301],416,5,36408,3.8449677896293166,40.0,0.0
29469,2,9469,[187 204 195  96 742],505,2,36410,3.8447729672650475,0.0,0.0
29470,2,9470,[ 25   7 748  15 289],159,3,36413,3.84468377151304,0.0,0.0
29471,2,9471,[423 100 588  56 168],679,2,36415,3.84448902027027,0.0,0.0
29472,2,9472,[ 64  12 269 357 301],416,5,36420,3.8446109996833107,40.0,0.0
29473,2,9473,[210 483 323 195 202],417,3,36423,3.844521849271691,20.0,0.0
29474,2,9474,[ 64  12 269 357 301],416,5,36428,3.8446437994722955,40.0,0.0
29475,2,9475,[515   4 302 238  15],416,5,36433,3.8447657239341493,0.0,0.0
29476,2,9476,[ 64  12 269 357 301],416,5,36438,3.8448876226654005,40.0,0.0
29477,2,9477,[678 265 289 597 568],416,2,36440,3.8446929732010973,0.0,0.0
29478,2,9478,[ 64  12 269 357 301],416,5,36445,3.844814853887541,40.0,0.0
29479,2,9479,[ 64  12 269 357 301],416,5,36450,3.8449367088607596,40.0,0.0
29480,2,9480,[ 12 302 204 678 238],345,4,36454,3.8449530640227825,20.0,0.0
29481,2,9481,[ 64  12 269 357 301],416,5,36459,3.84507487871757,40.0,0.0
29482,2,9482,[  1 313  25 132 182],618,4,36463,3.8450912158599597,20.0,20.0
29483,2,9483,[183 135 210   8  82],805,2,36465,3.8448966680725434,0.0,0.0
29484,2,9484,[568 235  12   1 100],805,3,36468,3.844807590933052,20.0,0.0
29485,2,9485,[181 275  98 195 179],437,4,36472,3.844823951085811,0.0,40.0
29486,2,9486,[179 121  82 294 403],805,2,36474,3.844629492990408,0.0,0.0
29487,2,9487,[ 64  12 269 357 301],416,5,36479,3.8447512647554807,40.0,0.0
29488,2,9488,[258 173 265 215  50],416,5,36484,3.844873010854674,0.0,20.0
29489,2,9489,[ 64  12 269 357 301],416,5,36489,3.8449947312961013,40.0,0.0
29490,2,9490,[ 64  12 269 357 301],416,5,36494,3.8451164260878725,40.0,0.0
29491,2,9491,[ 64  12 269 357 301],416,5,36499,3.8452380952380953,40.0,0.0
29492,2,9492,[ 79   7 195 273  28],805,2,36501,3.845043716422627,0.0,0.0
29493,2,9493,[  9 125 186 286 289],854,1,36502,3.8447440488729723,0.0,0.0
29494,2,9494,[597   7 313 742  50],751,1,36503,3.8444444444444446,20.0,40.0
29495,2,9495,[ 64  12 269 357 301],416,5,36508,3.8445661331086773,40.0,0.0
29496,2,9496,[ 64  12 269 357 301],416,5,36513,3.8446877961461516,40.0,0.0
29497,2,9497,[  8 235 273 234 135],805,2,36515,3.844493577595283,0.0,0.0
29498,2,9498,[ 82 276 273  96 111],416,4,36519,3.844509948415623,0.0,0.0
29499,2,9499,[111 294 202  25 151],128,1,36520,3.8442105263157895,0.0,0.0
29500,2,9500,[357  71 568 176 265],198,2,36522,3.844016419324282,0.0,0.0
29501,2,9501,[ 64  12 269 357 301],416,5,36527,3.8441380761944854,40.0,0.0
29502,2,9502,[ 11  95 186   4  82],198,2,36529,3.843944017678628,0.0,0.0
29503,2,9503,[174 204 181 121 258],541,4,36533,3.8439604377104377,0.0,20.0
29504,2,9504,[ 64  12 269 357 301],416,5,36538,3.8440820620725935,40.0,0.0
29505,2,9505,[174 597 282 286 191],854,1,36539,3.843782873974332,0.0,0.0
29506,2,9506,[ 64  12 269 357 301],416,5,36544,3.8439044914273692,40.0,0.0
29507,2,9507,[144 202 289 588 173],43,5,36549,3.8440260832982753,0.0,0.0
29508,2,9508,[ 64  12 269 357 301],416,5,36554,3.8441476495951203,40.0,0.0
29509,2,9509,[100 265 144 294 195],417,2,36556,3.8439537329127234,0.0,0.0
29510,2,9510,[172 100  11 496 302],417,1,36557,3.843654715592472,0.0,0.0
29511,2,9511,[ 15 117   1 237 313],348,5,36562,3.843776282590412,20.0,20.0
29512,2,9512,[ 64  12 269 357 301],416,5,36567,3.8438978240302744,40.0,0.0
29513,2,9513,[568 268 333  25 403],588,4,36571,3.8439142316586086,0.0,0.0
29514,2,9514,[100   8 176 475 742],854,3,36574,3.8438255386232263,0.0,0.0
29515,2,9515,[144  79 568  64 475],711,3,36577,3.8437368642286676,20.0,0.0
29516,2,9516,[ 82  98  56 161  25],805,3,36580,3.8436482084690553,0.0,20.0
29517,2,9517,[289 405 191 195 168],854,3,36583,3.8435595713385164,0.0,0.0
29518,2,9518,[ 64  12 269 357 301],416,5,36588,3.843681058934762,40.0,0.0
29519,2,9519,[276 655 151 168   8],618,2,36590,3.8434873949579833,0.0,0.0
29520,2,9520,[515 245 237 546 228],297,2,36592,3.8432937716626405,0.0,0.0
29521,2,9521,[121 268  70 125   1],314,4,36596,3.843310228943499,0.0,0.0
29522,2,9522,[603 302  82 185 204],405,4,36600,3.8433266827680352,0.0,0.0
29523,2,9523,[318 180 603 286 202],354,2,36602,3.843133137337253,20.0,0.0
29524,2,9524,[282 173 423  22 496],314,4,36606,3.8431496062992125,0.0,0.0
29525,2,9525,[172 173 151 403 265],588,4,36610,3.843166071803485,0.0,0.0
29526,2,9526,[269 111 202 204 288],297,1,36611,3.8428676393408208,0.0,20.0
29527,2,9527,[ 64  12 269 357 301],416,5,36616,3.842989084802687,40.0,0.0
29528,2,9528,[179 300 748 333 191],721,2,36618,3.8427956763563857,0.0,0.0
29529,2,9529,[ 64  12 269 357 301],416,5,36623,3.8429171038824763,40.0,0.0
29530,2,9530,[151 385 275 405 323],416,3,36626,3.8428286643584095,0.0,0.0
29531,2,9531,[ 88  89 496 186 196],354,2,36628,3.8426353336130927,0.0,0.0
29532,2,9532,[196 144 186 200 151],437,3,36631,3.842546942200776,0.0,0.0
29533,2,9533,[286  22 257 111 215],416,4,36635,3.842563457100902,0.0,0.0
29534,2,9534,[ 64  12 269 357 301],416,5,36640,3.8426848453067644,40.0,0.0
29535,2,9535,[268 100 210 173 265],416,5,36645,3.842806208053691,0.0,0.0
29536,2,9536,[237 191 174 204  88],437,4,36649,3.8428226905735556,0.0,0.0
29537,2,9537,[ 64  12 269 357 301],416,5,36654,3.8429440134200044,40.0,0.0
29538,2,9538,[153 286  11  25 282],854,2,36656,3.8427508124541356,0.0,0.0
29539,2,9539,[ 64  12 269 357 301],416,5,36661,3.8428721174004195,40.0,0.0
29540,2,9540,[237 132  95 405 546],262,0,36661,3.8424693428361807,0.0,0.0
29541,2,9541,[ 25 385   4 210 234],198,1,36662,3.842171452525676,0.0,0.0
29542,2,9542,[172  97 245  64 196],416,4,36666,3.8421879911977364,20.0,0.0
29543,2,9543,[385 483 121  69 471],588,3,36669,3.84209974853311,20.0,0.0
29544,2,9544,[173  69  70 135 294],62,3,36672,3.842011524358303,0.0,0.0
29545,2,9545,[ 64  12 269 357 301],416,5,36677,3.8421328305049234,40.0,0.0
29546,2,9546,[181  96  95 172 237],230,4,36681,3.8421493662930764,0.0,20.0
29547,2,9547,[ 64  12 269 357 301],416,5,36686,3.8422706325932134,40.0,0.0
29548,2,9548,[275 173 282 117 286],854,2,36688,3.8420777044716723,0.0,0.0
29549,2,9549,[ 64  12 269 357 301],416,5,36693,3.8421989528795812,40.0,0.0
29550,2,9550,[175 427 288 357 144],342,4,36697,3.842215474819391,0.0,20.0
29551,2,9551,[195 423 210  25 588],417,2,36699,3.8420226130653266,0.0,0.0
29552,2,9552,[405 195  11 181  98],416,5,36704,3.8421438291636134,0.0,40.0
29553,2,9553,[288 546 215 173 603],297,2,36706,3.8419510152815572,0.0,20.0
29554,2,9554,[181 294  64 195 132],262,1,36707,3.8416535845107274,20.0,20.0
29555,2,9555,[515 174  56 300 234],297,3,36710,3.841565508580996,0.0,0.0
29556,2,9556,[ 64  12 269 301 357],416,5,36715,3.8416867217746153,40.0,0.0
29557,2,9557,[ 64  12 269 301 357],416,5,36720,3.84180790960452,40.0,0.0
29558,2,9558,[385 191  79 271  11],43,4,36724,3.8418244586253794,0.0,0.0
29559,2,9559,[471 191 238 318 302],43,3,36727,3.84173640167364,20.0,0.0
29560,2,9560,[ 64  12 269 301 357],416,5,36732,3.8418575462817697,40.0,0.0
29561,2,9561,[546 153 357  96 121],417,2,36734,3.841664923656139,0.0,0.0
29562,2,9562,[ 64  12 269 301 357],416,5,36739,3.841786050402593,40.0,0.0
29563,2,9563,[ 64  12 269 301 357],416,5,36744,3.8419071518193224,40.0,0.0
29564,2,9564,[ 12 302 273 742  50],62,3,36747,3.8418191322530055,20.0,20.0
29565,2,9565,[301 200 132 125 288],416,5,36752,3.841940204892327,0.0,20.0
29566,2,9566,[ 64  12 269 301 357],416,5,36757,3.842061252221177,40.0,0.0
29567,2,9567,[ 64  12 269 301 357],416,5,36762,3.8421822742474916,40.0,0.0
29568,2,9568,[202  82 546 111 294],416,4,36766,3.8421987668512907,0.0,0.0
29569,2,9569,[ 64  12 269 301 357],416,5,36771,3.842319749216301,40.0,0.0
29570,2,9570,[546 121 200 176 322],417,2,36773,3.842127259429527,0.0,0.0
29571,2,9571,[ 64  12 269 301 357],416,5,36778,3.8422482239866276,40.0,0.0
29572,2,9572,[ 15 168 405 195  89],198,2,36780,3.8420557818865557,0.0,0.0
29573,2,9573,[588 191 238 173 153],805,4,36784,3.8420722790892,0.0,0.0
29574,2,9574,[ 64  12 269 301 357],416,5,36789,3.8421932114882504,40.0,0.0
29575,2,9575,[597 403 313 173  15],588,4,36793,3.8422096908939016,20.0,20.0
29576,2,9576,[117 475 200 655 210],437,2,36795,3.8420173331941108,0.0,0.0
29577,2,9577,[175 191 181 172 276],43,4,36799,3.842033827521403,0.0,20.0
29578,2,9578,[ 64  12 269 301 357],416,5,36804,3.8421547134356406,40.0,0.0
29579,2,9579,[195 174 117  50 197],416,5,36809,3.842275574112735,0.0,20.0
29580,2,9580,[228  96 483 210 475],62,4,36813,3.842292036321887,20.0,0.0
29581,2,9581,[ 64  12 269 301 357],416,5,36818,3.8424128574410354,40.0,0.0
29582,2,9582,[174  28 121 100  97],654,3,36821,3.8423249504330586,0.0,0.0
29583,2,9583,[289 215 111 678 173],721,3,36824,3.842237061769616,0.0,0.0
29584,2,9584,[  8 182 173 258   7],49,1,36825,3.8419405320813773,0.0,0.0
29585,2,9585,[186 257  56  28 118],43,4,36829,3.841957020655122,0.0,0.0
29586,2,9586,[144 168 588 603 294],416,5,36834,3.8420778137060605,0.0,0.0
29587,2,9587,[211 210 181 483  69],417,2,36836,3.841885690446391,20.0,20.0
29588,2,9588,[117  12 318 175  89],253,4,36840,3.8419021795807695,40.0,0.0
29589,2,9589,[117 385  95  64 318],705,5,36845,3.8420229405630866,40.0,0.0
29590,2,9590,[ 69 323 161 121  50],345,2,36847,3.841830883119591,0.0,20.0
29591,2,9591,[265 357 588 185 258],297,4,36851,3.8418473728106757,0.0,0.0
29592,2,9592,[ 82  64 265 475 200],416,4,36855,3.841863859063901,20.0,0.0
29593,2,9593,[181 742 286  98 210],417,2,36857,3.841671878257244,0.0,40.0
29594,2,9594,[195 173 127 423 258],698,3,36860,3.8415841584158414,0.0,0.0
29595,2,9595,[ 64  12 269 301 357],416,5,36865,3.8417048770320967,40.0,0.0
29596,2,9596,[ 64  12 269 301 357],416,5,36870,3.841825570490778,40.0,0.0
29597,2,9597,[215 153 258 176 204],62,3,36873,3.8417378620545946,0.0,0.0
29598,2,9598,[210 111 180 748  25],417,2,36875,3.841545994374414,0.0,0.0
29599,2,9599,[ 64  12 269 301 357],416,5,36880,3.841666666666667,40.0,0.0
29600,2,9600,[ 64  12 269 301 357],416,5,36885,3.841787313821477,40.0,0.0
29601,2,9601,[100  79 200 313 204],618,4,36889,3.8418037908769005,20.0,20.0
29602,2,9602,[423 357 196 276 237],62,3,36892,3.841716130375924,0.0,0.0
29603,2,9603,[ 64  12 269 301 357],416,5,36897,3.8418367346938775,40.0,0.0
29604,2,9604,[288 313 161 483 181],618,4,36901,3.841853201457574,40.0,60.0
29605,2,9605,[196 121 475 161  97],198,1,36902,3.841557359983344,0.0,0.0
29606,2,9606,[ 64 161 181  70  96],230,4,36906,3.8415738523992924,20.0,20.0
29607,2,9607,[ 64  12 269 301 357],416,5,36911,3.8416944213155704,40.0,0.0
29608,2,9608,[603  89 135 127 172],214,3,36914,3.8416068269330834,0.0,0.0
29609,2,9609,[168 508  12 258  15],62,4,36918,3.8416233090530696,20.0,0.0
29610,2,9610,[357 168 222   9 111],805,3,36921,3.8415357402975756,0.0,0.0
29611,2,9611,[ 64  12 269 301 357],416,5,36926,3.8416562630045776,40.0,0.0
29612,2,9612,[435  69  56 194 216],297,2,36928,3.841464683241444,0.0,0.0
29613,2,9613,[748 191  50 427   1],198,4,36932,3.8414811732889538,0.0,20.0
29614,2,9614,[186 181  97  25  15],618,3,36935,3.84139365574623,0.0,20.0
29615,2,9615,[ 64  12 269 301 357],416,5,36940,3.841514143094842,40.0,0.0
29616,2,9616,[286 117 588 385  79],43,5,36945,3.8416346053862953,0.0,0.0
29617,2,9617,[403 125 588 127 568],373,2,36947,3.8414431274693284,0.0,0.0
29618,2,9618,[135 238 275 210 202],618,1,36948,3.8411477284541014,0.0,0.0
29619,2,9619,[268 191 204 471  64],416,5,36953,3.8412681912681914,20.0,0.0
29620,2,9620,[258 197 748 181 318],416,5,36958,3.8413886290406403,20.0,20.0
29621,2,9621,[ 64  12 269 301 357],416,5,36963,3.841509041779256,40.0,0.0
29622,2,9622,[ 64  12 269 301 357],416,5,36968,3.8416294294918423,40.0,0.0
29623,2,9623,[117 237 288 238 294],345,3,36971,3.8415419783873648,0.0,20.0
29624,2,9624,[187 121 127  22 135],618,5,36976,3.8416623376623376,0.0,0.0
29625,2,9625,[597 313 161 204  22],618,4,36980,3.841678786619572,20.0,20.0
29626,2,9626,[423 275 195   9   1],416,5,36985,3.8417991066791317,0.0,0.0
29627,2,9627,[111  98 234 185 210],805,3,36988,3.8417116742833404,0.0,20.0
29628,2,9628,[127   4  96 197 234],416,5,36993,3.841831965936234,0.0,0.0
29629,2,9629,[ 64  12 269 301 357],416,5,36998,3.841952232606438,40.0,0.0
29630,2,9630,[121 483 168 183 258],601,4,37002,3.8419686429238915,20.0,0.0
29631,2,9631,[ 64  12 269 301 357],416,5,37007,3.8420888704318936,40.0,0.0
29632,2,9632,[ 89 385 238 161 269],373,4,37011,3.8421052631578947,0.0,0.0
29633,2,9633,[ 11 234  82  12 117],437,2,37013,3.8419140543906996,20.0,0.0
29634,2,9634,[204  12 238 655 117],416,5,37018,3.8420342501297355,20.0,0.0
29635,2,9635,[200  98  15   4 175],253,4,37022,3.8420506434205066,0.0,20.0
29636,2,9636,[ 64  12 269 301 357],416,5,37027,3.8421708000415067,40.0,0.0
29637,2,9637,[238  22 603 182 228],297,3,37030,3.8420834197966385,0.0,0.0
29638,2,9638,[ 64  12 269 301 357],416,5,37035,3.842203548085901,40.0,0.0
29639,2,9639,[238  50 143  69 508],345,5,37040,3.8423236514522823,0.0,20.0
29640,2,9640,[174 403 204 179 173],62,4,37044,3.842340006223421,0.0,0.0
29641,2,9641,[194 313   9 357   7],416,5,37049,3.8424600705247873,20.0,20.0
29642,2,9642,[ 97 275 300 245  82],128,3,37052,3.842372705589547,0.0,0.0
29643,2,9643,[235 405  71 121 423],642,2,37054,3.8421816673579428,0.0,0.0
29644,2,9644,[ 64  12 269 301 357],416,5,37059,3.8423017107309487,40.0,0.0
29645,2,9645,[ 28 144  25 742 258],588,4,37063,3.8423180592991915,0.0,0.0
29646,2,9646,[ 64  12 269 301 357],416,5,37068,3.8424380636467297,40.0,0.0
29647,2,9647,[294 508 313  97   1],654,2,37070,3.842247097844113,20.0,20.0
29648,2,9648,[ 64  12 269 301 357],416,5,37075,3.8423670846719866,40.0,0.0
29649,2,9649,[508 195 289 235 328],854,1,37076,3.8420725388601036,0.0,0.0
29650,2,9650,[127  97 111 546 187],416,4,37080,3.8420889027043827,0.0,0.0
29651,2,9651,[288 100 235 423 172],417,1,37081,3.841794446746788,0.0,20.0
29652,2,9652,[ 64  12 269 301 357],416,5,37086,3.841914430746918,40.0,0.0
29653,2,9653,[294 282 302 301 546],416,4,37090,3.8419308058835715,0.0,0.0
29654,2,9654,[100 276 288  70 568],618,2,37092,3.8417400310719834,0.0,20.0
29655,2,9655,[ 98 403 273 204  69],618,4,37096,3.8417564208782102,0.0,20.0
29656,2,9656,[172 202  88 143  71],618,4,37100,3.8417728072900488,0.0,0.0
29657,2,9657,[202  56 127 322 588],417,3,37103,3.8416856492027334,0.0,0.0
29658,2,9658,[200 210 135 181 132],405,4,37107,3.8417020395486077,0.0,20.0
29659,2,9659,[  8 546 318 183 328],416,4,37111,3.841718426501035,20.0,0.0
29660,2,9660,[385 132  64  11 195],618,4,37115,3.8417348100610704,20.0,0.0
29661,2,9661,[ 64  12 269 301 357],416,5,37120,3.841854688470296,40.0,0.0
29662,2,9662,[100 210 195 173  69],618,2,37122,3.8416640794784227,0.0,0.0
29663,2,9663,[202 143 318 195  82],618,3,37125,3.841576986754967,20.0,0.0
29664,2,9664,[568 258 222 151 427],128,2,37127,3.841386445938955,0.0,0.0
29665,2,9665,[ 64  12 269 301 357],416,5,37132,3.841506310780054,40.0,0.0
29666,2,9666,[143 172  25 180 153],373,3,37135,3.8414192614047793,0.0,0.0
29667,2,9667,[ 28 215 294   1 568],679,1,37136,3.841125362019032,0.0,0.0
29668,2,9668,[117  70 161 182 143],128,4,37140,3.841141793360223,0.0,0.0
29669,2,9669,[269 568 143 176  25],805,3,37143,3.8410548086866596,0.0,0.0
29670,2,9670,[118  69 742  15 322],128,3,37146,3.840967842001861,0.0,0.0
29671,2,9671,[568 748  70 181  69],679,4,37150,3.840984284532672,0.0,20.0
29672,2,9672,[144 185  25 183  70],297,4,37154,3.8410007236638064,0.0,0.0
29673,2,9673,[ 97 318 273 237 151],416,3,37157,3.8409137895389702,20.0,0.0
29674,2,9674,[  4  15 172  88 187],373,4,37161,3.8409302325581396,0.0,0.0
29675,2,9675,[678 215   9 568 161],345,3,37164,3.840843323687474,0.0,0.0
29676,2,9676,[597 588 216 603  98],751,4,37168,3.840859770590059,0.0,20.0
29677,2,9677,[ 64  12 269 301 357],416,5,37173,3.8409795412275263,40.0,0.0
29678,2,9678,[191  96 748 289 204],416,4,37177,3.840995970658126,0.0,0.0
29679,2,9679,[ 96 195  50  70 237],198,2,37179,3.8408057851239668,0.0,20.0
29680,2,9680,[ 64  12 269 301 357],416,5,37184,3.8409255242227043,40.0,0.0
29681,2,9681,[ 64  12 269 301 357],416,5,37189,3.8410452385870686,40.0,0.0
29682,2,9682,[275 475 168 288  50],416,4,37193,3.8410616544459364,0.0,40.0
29683,2,9683,[202  15   8 597 143],588,4,37197,3.841078066914498,0.0,0.0
29684,2,9684,[ 64  12 269 301 357],416,5,37202,3.841197728446051,40.0,0.0
29685,2,9685,[ 64  12 269 301 357],416,5,37207,3.841317365269461,40.0,0.0
29686,2,9686,[195 135 655 275 423],618,3,37210,3.8412305151233612,0.0,0.0
29687,2,9687,[118 197 195  12 257],297,1,37211,3.8409372419488026,20.0,0.0
29688,2,9688,[181 153 273 742 197],416,5,37216,3.841056868613892,0.0,20.0
29689,2,9689,[ 95 269 748 174 597],751,3,37219,3.840970072239422,0.0,0.0
29690,2,9690,[ 64  12 269 301 357],416,5,37224,3.841089670828604,40.0,0.0
29691,2,9691,[210  70 144 118 182],416,4,37228,3.8411060668592656,0.0,0.0
29692,2,9692,[ 64  12 269 301 357],416,5,37233,3.8412256267409473,40.0,0.0
29693,2,9693,[ 89 181 191 211 269],297,4,37237,3.8412420053641427,0.0,20.0
29694,2,9694,[172 216 117 286 546],416,4,37241,3.841258380608561,0.0,0.0
29695,2,9695,[ 64  12 269 301 357],416,5,37246,3.841377887788779,40.0,0.0
29696,2,9696,[ 64  12 269 301 357],416,5,37251,3.8414973703207176,40.0,0.0
29697,2,9697,[300  98 313  69  82],43,5,37256,3.8416168282120027,20.0,40.0
29698,2,9698,[258 180 275   8 289],854,4,37260,3.841633158057532,0.0,0.0
29699,2,9699,[153 269  71 204  64],43,5,37265,3.8417525773195877,20.0,0.0
29700,2,9700,[228 222 405 144  56],805,2,37267,3.841562725492217,0.0,0.0
29701,2,9701,[ 79 132 180  25 100],417,2,37269,3.8413729128014844,0.0,0.0
29702,2,9702,[273 357  98 268  11],297,5,37274,3.8414923219622796,0.0,20.0
29703,2,9703,[742  95 210  25  56],43,5,37279,3.8416117065127784,0.0,0.0
29704,2,9704,[294 180 153  88 385],805,1,37280,3.841318907779495,0.0,0.0
29705,2,9705,[268  64 161 282 216],128,3,37283,3.8412322274881516,20.0,0.0
29706,2,9706,[  8 153 546 275 204],62,4,37287,3.841248583496446,0.0,0.0
29707,2,9707,[ 50 215  56 173 200],405,4,37291,3.841264936135146,0.0,20.0
29708,2,9708,[ 64  12 269 301 357],416,5,37296,3.841384282624369,40.0,0.0
29709,2,9709,[ 64  12 269 301 357],416,5,37301,3.841503604531411,40.0,0.0
29710,2,9710,[ 64  12 269 301 357],416,5,37306,3.841622901863866,40.0,0.0
29711,2,9711,[328 202 210 143 176],416,5,37311,3.8417421746293248,0.0,0.0
29712,2,9712,[ 79 125 678 173 508],345,3,37314,3.8416555132296923,0.0,0.0
29713,2,9713,[ 64  12 269 301 357],416,5,37319,3.84177475808112,40.0,0.0
29714,2,9714,[ 64  12 269 301 357],416,5,37324,3.8418939783839425,40.0,0.0
29715,2,9715,[ 69 275  12 187   8],618,3,37327,3.841807328118567,20.0,0.0
29716,2,9716,[195 258 200   7 546],262,2,37329,3.8416177832664404,0.0,0.0
29717,2,9717,[234 546 161 121  56],416,4,37333,3.841634081086643,0.0,0.0
29718,2,9718,[125 132  89 268 483],417,5,37338,3.8417532667969954,20.0,0.0
29719,2,9719,[ 98 216 181   4 202],618,2,37340,3.8415637860082303,0.0,40.0
29720,2,9720,[475 273 144  50 172],805,3,37343,3.8414772142783664,0.0,20.0
29721,2,9721,[204  22 597 275  69],654,5,37348,3.8415963793458134,0.0,0.0
29722,2,9722,[132 496  50 318 273],618,5,37353,3.841715519901265,20.0,20.0
29723,2,9723,[204 313 151 172   4],345,5,37358,3.841834635952283,20.0,20.0
29724,2,9724,[748  22 153 300 143],654,5,37363,3.841953727506427,0.0,0.0
29725,2,9725,[143 678 195 302 588],654,5,37368,3.8420727945712523,0.0,0.0
29726,2,9726,[195 176  98 197  11],805,3,37371,3.84198622391282,0.0,20.0
29727,2,9727,[179 265 121 245  96],417,2,37373,3.841796875,0.0,0.0
29728,2,9728,[ 64  12 269 301 357],416,5,37378,3.8419159214718883,40.0,0.0
29729,2,9729,[318  64 185 655 269],416,5,37383,3.8420349434737924,40.0,0.0
29730,2,9730,[289 172 173  12 742],345,4,37387,3.842051176651937,20.0,0.0
29731,2,9731,[ 64  12 269 301 357],416,5,37392,3.842170160295931,40.0,0.0
29732,2,9732,[210 215 191   4 181],712,3,37395,3.8420836330011303,0.0,20.0
29733,2,9733,[197 182  12 172 216],416,5,37400,3.8422025888637763,20.0,0.0
29734,2,9734,[ 56  95 257  70 515],417,4,37404,3.8422187981510016,0.0,0.0
29735,2,9735,[ 64  12 269 301 357],416,5,37409,3.84233771569433,40.0,0.0
29736,2,9736,[182 197 173  98 322],128,4,37413,3.8423539077744686,0.0,20.0
29737,2,9737,[268 257 222   1 357],417,3,37416,3.842267406038201,0.0,0.0
29738,2,9738,[ 64  12 269 301 357],416,5,37421,3.8423862819591332,40.0,0.0
29739,2,9739,[300 496  69  56  98],654,5,37426,3.842505133470226,0.0,20.0
29740,2,9740,[286 197 435 127 179],373,1,37427,3.8422133251206243,0.0,0.0
29741,2,9741,[235 191 125   4 273],417,2,37429,3.8420242250051326,0.0,0.0
29742,2,9742,[ 64  12 269 301 357],416,5,37434,3.8421430770809812,40.0,0.0
29743,2,9743,[435 173  50 302  69],405,4,37438,3.842159277504105,0.0,20.0
29744,2,9744,[245 151  71 210 276],416,2,37440,3.8419702411493075,0.0,0.0
29745,2,9745,[ 25 161 197   8 196],711,5,37445,3.8420890621793555,0.0,0.0
29746,2,9746,[195   7 127  64 175],214,5,37450,3.8422078588283575,20.0,0.0
29747,2,9747,[ 64  12 269 301 357],416,5,37455,3.8423266311038162,40.0,0.0
29748,2,9748,[173 183 161   1 237],618,4,37459,3.842342804390194,0.0,0.0
29749,2,9749,[144 228 546 181 173],297,2,37461,3.8421538461538463,0.0,20.0
29750,2,9750,[ 64  12 269 301 357],416,5,37466,3.8422725874269306,40.0,0.0
29751,2,9751,[ 96 294 496 748 288],907,5,37471,3.842391304347826,0.0,20.0
29752,2,9752,[655 275  71 132 228],711,3,37474,3.8423049318158515,0.0,0.0
29753,2,9753,[ 79 258  28 125 210],345,3,37477,3.842218576994054,0.0,0.0
29754,2,9754,[234 179  64 288 176],417,4,37481,3.8422347514095336,20.0,20.0
29755,2,9755,[ 11 265  25 288  97],417,2,37483,3.8420459204592046,0.0,20.0
29756,2,9756,[185 127 153 228 216],805,2,37485,3.84185712821564,0.0,0.0
29757,2,9757,[ 64  12 269 301 357],416,5,37490,3.8419758147161303,40.0,0.0
29758,2,9758,[282  69  88 294 117],588,4,37494,3.841992007377805,0.0,0.0
29759,2,9759,[ 64  12 269 301 357],416,5,37499,3.842110655737705,40.0,0.0
29760,2,9760,[179  69  50 191  15],601,3,37502,3.8420243827476694,0.0,20.0
29761,2,9761,[588 475 423 269  79],297,3,37505,3.841938127432903,0.0,0.0
29762,2,9762,[153 655  79 258 173],805,3,37508,3.841851889787975,0.0,0.0
29763,2,9763,[234 423  82 161 294],416,5,37513,3.8419705038918477,0.0,0.0
29764,2,9764,[742 176 322 483 333],854,1,37514,3.841679467485919,20.0,0.0
29765,2,9765,[ 96 265 228 100 175],373,3,37517,3.8415932828179398,0.0,0.0
29766,2,9766,[ 64  12 269 301 357],416,5,37522,3.841711886966315,40.0,0.0
29767,2,9767,[ 64  12 269 301 357],416,5,37527,3.841830466830467,40.0,0.0
29768,2,9768,[111 268  56   1 282],588,4,37531,3.841846657795066,0.0,0.0
29769,2,9769,[100  69 301 265 176],297,3,37534,3.8417604912998975,0.0,0.0
29770,2,9770,[ 64  12 269 301 357],416,5,37539,3.841879029782008,40.0,0.0
29771,2,9771,[ 64  12 269 301 357],416,5,37544,3.8419975440032745,40.0,0.0
29772,2,9772,[235 508 423 597 118],417,2,37546,3.841809065793513,0.0,0.0
29773,2,9773,[132 427 603  98 151],128,3,37549,3.8417229384080214,0.0,20.0
29774,2,9774,[678 265 195  95 313],654,5,37554,3.841841432225064,20.0,20.0
29775,2,9775,[ 88 191 183 276 100],437,3,37557,3.841755319148936,0.0,0.0
29776,2,9776,[  8 176 182   1 300],416,5,37562,3.841873785414749,0.0,0.0
29777,2,9777,[135  12 100 176 302],62,4,37566,3.8418899570464307,20.0,0.0
29778,2,9778,[191 180 483  96  25],417,3,37569,3.841803865425913,20.0,0.0
29779,2,9779,[ 64  12 269 301 357],416,5,37574,3.841922290388548,40.0,0.0
29780,2,9780,[228 257 100 258 385],417,2,37576,3.841733974031285,0.0,0.0
29781,2,9781,[ 64  12 269 301 357],416,5,37581,3.8418523819259867,40.0,0.0
29782,2,9782,[100  95 238 237 294],654,3,37584,3.841766329346826,0.0,0.0
29783,2,9783,[175 603 179 168 153],805,5,37589,3.841884709730172,0.0,0.0
29784,2,9784,[  4 151 194 265 216],373,5,37594,3.84200306591722,0.0,0.0
29785,2,9785,[ 50 196 185 161 172],711,5,37599,3.842121397915389,0.0,20.0
29786,2,9786,[245  70  12  95 603],416,3,37602,3.842035353019311,20.0,0.0
29787,2,9787,[288  79 176 258   7],854,4,37606,3.842051491622395,0.0,20.0
29788,2,9788,[200 210 100 405  98],417,2,37608,3.8418633159669016,0.0,20.0
29789,2,9789,[174 282  82 508 276],654,2,37610,3.8416751787538304,0.0,0.0
29790,2,9790,[181  97  56  88 183],405,2,37612,3.8414870799714023,0.0,20.0
29791,2,9791,[268 323 678 655 288],416,3,37615,3.8414011437908497,0.0,20.0
29792,2,9792,[294  96  22 471 257],887,4,37619,3.841417338915552,0.0,0.0
29793,2,9793,[181 182 405 508  25],128,4,37623,3.841433530733102,0.0,20.0
29794,2,9794,[322 313 357  88 273],416,3,37626,3.8413476263399695,20.0,20.0
29795,2,9795,[ 64  12 269 301 357],416,5,37631,3.8414659044507964,40.0,0.0
29796,2,9796,[174 496 483 100 257],214,4,37635,3.8414820863529653,20.0,0.0
29797,2,9797,[ 64  12 269 301 357],416,5,37640,3.841600326597265,40.0,0.0
29798,2,9798,[ 64  12 269 301 357],416,5,37645,3.8417185427084397,40.0,0.0
29799,2,9799,[ 64  12 269 301 357],416,5,37650,3.8418367346938775,40.0,0.0
29800,2,9800,[ 64  12 269 301 357],416,5,37655,3.841954902560963,40.0,0.0
29801,2,9801,[ 12  56 181  11 210],417,3,37658,3.84186900632524,20.0,20.0
29802,2,9802,[ 64  12 269 301 357],416,5,37663,3.8419871467917983,40.0,0.0
29803,2,9803,[ 64  12 269 301 357],416,5,37668,3.8421052631578947,40.0,0.0
29804,2,9804,[ 64  12 269 301 357],416,5,37673,3.8422233554309027,40.0,0.0
29805,2,9805,[  4 176 135 271  50],854,3,37676,3.8421374668570265,0.0,20.0
29806,2,9806,[182 200 118 423 172],198,3,37679,3.842051595798919,0.0,0.0
29807,2,9807,[603 153 328 403 143],416,5,37684,3.842169657422512,0.0,0.0
29808,2,9808,[515 151 194  69 204],297,1,37685,3.8418799062085838,0.0,0.0
29809,2,9809,[  7  22 276 275 144],416,4,37689,3.8418960244648317,0.0,0.0
29810,2,9810,[ 64  12 269 301 357],416,5,37694,3.8420140658444604,40.0,0.0
29811,2,9811,[ 64  12 269 301 357],416,5,37699,3.8421320831634733,40.0,0.0
29812,2,9812,[ 64  12 269 301 357],416,5,37704,3.8422500764292264,40.0,0.0
29813,2,9813,[ 64  12 269 301 357],416,5,37709,3.842368045649073,40.0,0.0
29814,2,9814,[204 121 151 302   8],416,4,37713,3.842384105960265,0.0,0.0
29815,2,9815,[ 97 288 100  95 168],416,4,37717,3.842400162999185,0.0,20.0
29816,2,9816,[ 64  12 269 301 357],416,5,37722,3.842518080880106,40.0,0.0
29817,2,9817,[427 196 471 405  25],416,5,37727,3.842635974740273,0.0,0.0
29818,2,9818,[195 323 265 301 210],416,4,37731,3.8426520012221204,0.0,0.0
29819,2,9819,[597 568 185 475 125],416,3,37734,3.8425661914460285,0.0,0.0
29820,2,9820,[471 125 153 475 185],854,3,37737,3.84248039914469,0.0,0.0
29821,2,9821,[ 56 423 318  82  22],618,5,37742,3.8425982488291592,20.0,0.0
29822,2,9822,[ 64  12 269 301 357],416,5,37747,3.842716074518986,40.0,0.0
29823,2,9823,[678  70  28  12  22],297,4,37751,3.842732084690554,20.0,0.0
29824,2,9824,[210 282 318 117 323],345,3,37754,3.84264631043257,20.0,0.0
29825,2,9825,[183 215  15  69 204],437,2,37756,3.8424587828210868,0.0,0.0
29826,2,9826,[174 194  97 172  70],373,4,37760,3.842474814287168,0.0,0.0
29827,2,9827,[288 289 174   7 125],342,2,37762,3.8422873422873423,0.0,20.0
29828,2,9828,[ 64  12 269 301 357],416,5,37767,3.842405127683386,40.0,0.0
29829,2,9829,[ 64  12 269 301 357],416,5,37772,3.8425228891149543,40.0,0.0
29830,2,9830,[  9 179 210 286 294],416,4,37776,3.842538907537382,0.0,0.0
29831,2,9831,[181 323  70 185 228],417,1,37777,3.8422497965825873,0.0,20.0
29832,2,9832,[ 15  95 268 181   1],588,5,37782,3.84236753788264,0.0,20.0
29833,2,9833,[405 655 228  82 597],805,0,37782,3.8419768151311775,0.0,0.0
29834,2,9834,[ 64  12 269 301 357],416,5,37787,3.8420945602440266,40.0,0.0
29835,2,9835,[ 64  12 269 301 357],416,5,37792,3.8422122814152093,40.0,0.0
29836,2,9836,[ 64  12 269 301 357],416,5,37797,3.842329978652028,40.0,0.0
29837,2,9837,[508 191 180  82 195],417,4,37801,3.842346005285627,0.0,0.0
29838,2,9838,[427 215 294 168  22],922,3,37804,3.8422603923162924,0.0,0.0
29839,2,9839,[202 100 172  12 174],49,2,37806,3.8420731707317075,20.0,0.0
29840,2,9840,[ 64  12 269 301 357],416,5,37811,3.8421908342648106,40.0,0.0
29841,2,9841,[100 179 302 268 496],417,2,37813,3.8420036577931316,0.0,0.0
29842,2,9842,[  9 181 323 496 328],416,4,37817,3.8420197094381794,0.0,20.0
29843,2,9843,[ 64  12 269 301 357],416,5,37822,3.8421373425436816,40.0,0.0
29844,2,9844,[546 423 237 111  64],314,5,37827,3.8422549517521585,20.0,0.0
29845,2,9845,[ 15 237  98 268 323],416,3,37830,3.842169408897014,0.0,20.0
29846,2,9846,[265  15 286  50  98],588,4,37834,3.8421854371889914,0.0,40.0
29847,2,9847,[282 168 273 237 268],297,4,37838,3.8422014622258325,0.0,0.0
29848,2,9848,[237 269 175 200 196],297,4,37842,3.8422174840085286,0.0,0.0
29849,2,9849,[328   9  70 678 183],416,4,37846,3.842233502538071,0.0,0.0
29850,2,9850,[  1  56 235 508 191],297,2,37848,3.842046492741854,0.0,0.0
29851,2,9851,[568 588  15 202 174],373,3,37851,3.841961023142509,0.0,0.0
29852,2,9852,[288  95  88 568 183],416,3,37854,3.841875570892114,0.0,20.0
29853,2,9853,[ 64  12 269 301 357],416,5,37859,3.841993099249036,40.0,0.0
29854,2,9854,[ 22  56 125  25  64],854,2,37861,3.841806189751395,20.0,0.0
29855,2,9855,[603  69 282  89 117],297,3,37864,3.841720779220779,0.0,0.0
29856,2,9856,[ 64  12 269 301 357],416,5,37869,3.8418382875114134,40.0,0.0
29857,2,9857,[ 12 423   7 168 135],417,3,37872,3.841752891052952,20.0,0.0
29858,2,9858,[132 742 210 161  11],345,4,37876,3.8417689420833754,0.0,0.0
29859,2,9859,[ 64  12 269 301 357],416,5,37881,3.841886409736308,40.0,0.0
29860,2,9860,[655   4  79 475 333],416,4,37885,3.8419024439711995,0.0,0.0
29861,2,9861,[238 215 265 202 742],128,2,37887,3.841715676333401,0.0,0.0
29862,2,9862,[597 186 185 265 427],618,5,37892,3.8418331136571022,0.0,0.0
29863,2,9863,[168 318  97 176  56],437,2,37894,3.841646390916464,20.0,0.0
29864,2,9864,[151 286 200 168 258],711,5,37899,3.8417638114546375,0.0,0.0
29865,2,9865,[ 64  12 269 301 357],416,5,37904,3.8418812081897427,40.0,0.0
29866,2,9866,[ 56 132 333 118   9],416,4,37908,3.841897233201581,0.0,0.0
29867,2,9867,[ 64  12 269 301 357],416,5,37913,3.8420145926226184,40.0,0.0
29868,2,9868,[258 275 135 216 508],854,4,37917,3.8420306008714156,0.0,0.0
29869,2,9869,[357  69 153  71 234],230,5,37922,3.8421479229989868,0.0,0.0
29870,2,9870,[ 64  12 269 301 357],416,5,37927,3.8422652213554858,40.0,0.0
29871,2,9871,[ 64  12 269 301 357],416,5,37932,3.842382495948136,40.0,0.0
29872,2,9872,[ 64  12 269 301 357],416,5,37937,3.8424997467841586,40.0,0.0
29873,2,9873,[172 210 191   1 294],416,5,37942,3.8426169738707716,0.0,0.0
29874,2,9874,[234 173 603 269 100],805,5,37947,3.8427341772151897,0.0,0.0
29875,2,9875,[568  82 132 496 125],618,4,37951,3.842750101255569,0.0,0.0
29876,2,9876,[313 385  71 546 597],416,3,37954,3.842664776754075,20.0,20.0
29877,2,9877,[742   7  89 202 357],805,3,37957,3.8425794695282445,0.0,0.0
29878,2,9878,[268 313   1 151 181],654,3,37960,3.842494179572831,20.0,40.0
29879,2,9879,[132 273  15 121 182],417,3,37963,3.842408906882591,0.0,0.0
29880,2,9880,[ 64  12 269 301 357],416,5,37968,3.842526060115373,40.0,0.0
29881,2,9881,[313  56 496 515 282],416,5,37973,3.8426431896377253,20.0,20.0
29882,2,9882,[127 204 180 238  70],198,2,37975,3.8424567439036728,0.0,0.0
29883,2,9883,[173 144 237 125 294],505,0,37975,3.842067988668555,0.0,0.0
29884,2,9884,[ 95   1 385  89 173],417,5,37980,3.842185128983308,0.0,0.0
29885,2,9885,[ 97 403  70  25 215],711,4,37984,3.8422010924539753,0.0,0.0
29886,2,9886,[568 202  88 318 546],314,5,37989,3.8423181956103973,20.0,0.0
29887,2,9887,[210 117  97 216 111],43,5,37994,3.842435275080906,0.0,0.0
29888,2,9888,[161 276 323 186 183],198,2,37996,3.842248963494792,0.0,0.0
29889,2,9889,[ 95  69 215  71 176],618,4,38000,3.8422649140546006,0.0,0.0
29890,2,9890,[475 237 288 144 546],62,2,38002,3.8420786573652816,0.0,20.0
29891,2,9891,[515 405  70 153 183],230,4,38006,3.8420946219167003,0.0,0.0
29892,2,9892,[ 64  12 269 301 357],416,5,38011,3.8422116648135045,40.0,0.0
29893,2,9893,[302 127  71 173 132],405,4,38015,3.8422276126945625,0.0,0.0
29894,2,9894,[ 64  12 269 301 357],416,5,38020,3.842344618494189,40.0,0.0
29895,2,9895,[ 64  12 269 301 357],416,5,38025,3.842461600646726,40.0,0.0
29896,2,9896,[405   9 168 568 603],416,5,38030,3.842578559159341,0.0,0.0
29897,2,9897,[ 64  12 269 301 357],416,5,38035,3.8426954940391997,40.0,0.0
29898,2,9898,[ 64  12 269 301 357],416,5,38040,3.842812405293464,40.0,0.0
29899,2,9899,[ 96 294   7 405 202],887,5,38045,3.842929292929293,0.0,0.0
29900,2,9900,[ 82 588 483 748 204],751,4,38049,3.8429451570548427,20.0,0.0
29901,2,9901,[ 64  12 269 301 357],416,5,38054,3.843062007675217,40.0,0.0
29902,2,9902,[ 64  12 269 301 357],416,5,38059,3.8431788346965567,40.0,0.0
29903,2,9903,[200 117 328   9 588],416,5,38064,3.8432956381260097,0.0,0.0
29904,2,9904,[ 95  79 294  28  98],416,4,38068,3.843311458859162,0.0,20.0
29905,2,9905,[ 64  12 269 301 357],416,5,38073,3.843428225317989,40.0,0.0
29906,2,9906,[ 79 173 202 210 204],297,2,38075,3.843242152013728,0.0,0.0
29907,2,9907,[168 181  69 222 173],654,4,38079,3.8432579733548646,0.0,20.0
29908,2,9908,[269 258 172 173   1],43,5,38084,3.8433747098597233,0.0,0.0
29909,2,9909,[204 268 322  15  64],314,5,38089,3.843491422805247,20.0,0.0
29910,2,9910,[ 97 385 237 182 118],618,4,38093,3.8435072142064373,0.0,0.0
29911,2,9911,[286 427 288 275  50],907,5,38098,3.84362389023406,0.0,40.0
29912,2,9912,[ 64  12 269 301 357],416,5,38103,3.8437405427216786,40.0,0.0
29913,2,9913,[186 423  71 238  70],230,4,38107,3.8437563042162597,0.0,0.0
29914,2,9914,[300 187   1 183  56],505,1,38108,3.8434694906707008,0.0,0.0
29915,2,9915,[204 235 258 597 257],887,3,38111,3.8433844292053245,0.0,0.0
29916,2,9916,[ 64  12 269 301 357],416,5,38116,3.8435010587879397,40.0,0.0
29917,2,9917,[ 64  12 269 301 357],416,5,38121,3.843617664851785,40.0,0.0
29918,2,9918,[ 64  12 269 301 357],416,5,38126,3.843734247403972,40.0,0.0
29919,2,9919,[ 64  12 269 301 357],416,5,38131,3.843850806451613,40.0,0.0
29920,2,9920,[ 88 238 300 186 161],43,3,38134,3.843765749420421,0.0,0.0
29921,2,9921,[ 64  12 269 301 357],416,5,38139,3.8438822817980247,40.0,0.0
29922,2,9922,[228 179 196 180  70],128,2,38141,3.843696462763277,0.0,0.0
29923,2,9923,[121 405  97 568 168],230,4,38145,3.843712212817412,0.0,0.0
29924,2,9924,[294  28 117 405 423],62,1,38146,3.843425692695214,0.0,0.0
29925,2,9925,[ 64  12 269 301 357],416,5,38151,3.8435422123715495,40.0,0.0
29926,2,9926,[195 475 117 173 111],417,4,38155,3.843557973204392,0.0,0.0
29927,2,9927,[568 151 200   7 121],417,2,38157,3.843372280419017,0.0,0.0
29928,2,9928,[117  82 655 176 168],805,2,38159,3.843186625037768,0.0,0.0
29929,2,9929,[ 96 151 183 175 204],805,4,38163,3.843202416918429,0.0,0.0
29930,2,9930,[282 322  28 179   4],416,3,38166,3.8431175108246904,0.0,0.0
29931,2,9931,[ 64  12 269 301 357],416,5,38171,3.8432339911397504,40.0,0.0
29932,2,9932,[269 742  69 322   1],854,2,38173,3.8430484244437735,0.0,0.0
29933,2,9933,[ 64  12 269 301 357],416,5,38178,3.8431648882625327,40.0,0.0
29934,2,9934,[118  88 289 179 515],416,1,38179,3.8428787116255663,0.0,0.0
29935,2,9935,[125 187 172 173 127],416,5,38184,3.842995169082126,0.0,0.0
29936,2,9936,[ 56 222 275 475  96],62,5,38189,3.843111603099527,0.0,0.0
29937,2,9937,[ 70  69 405   1 588],314,4,38193,3.8431273898168645,0.0,0.0
29938,2,9938,[ 96 289 174 200 237],416,3,38196,3.843042559613643,0.0,0.0
29939,2,9939,[275 357  15 204 282],416,5,38201,3.843158953722334,0.0,0.0
29940,2,9940,[135 333 215 403 228],721,3,38204,3.8430741374107233,0.0,0.0
29941,2,9941,[ 64  12 269 301 357],416,5,38209,3.843190504928586,40.0,0.0
29942,2,9942,[ 64  12 269 301 357],416,5,38214,3.8433068490395255,40.0,0.0
29943,2,9943,[ 64  12 269 301 357],416,5,38219,3.8434231697506034,40.0,0.0
29944,2,9944,[ 64  12 269 301 357],416,5,38224,3.843539467068879,40.0,0.0
29945,2,9945,[508 268 546 176 269],297,4,38228,3.8435551980695757,0.0,0.0
29946,2,9946,[183  15 427 318 496],416,5,38233,3.8436714587312757,20.0,0.0
29947,2,9947,[  8 111 161  88  69],588,3,38236,3.8435866505830316,0.0,0.0
29948,2,9948,[144 161 322   4 318],416,4,38240,3.843602372097698,20.0,0.0
29949,2,9949,[423 118 318 127 288],618,3,38243,3.8435175879396986,20.0,20.0
29950,2,9950,[174 195 588 748 496],416,5,38248,3.8436338056476735,0.0,0.0
29951,2,9951,[118 288 151 182  89],417,4,38252,3.8436495176848875,0.0,20.0
29952,2,9952,[257 508 302   9 151],62,3,38255,3.8435647543454237,0.0,0.0
29953,2,9953,[ 95 546 258 742 597],654,5,38260,3.8436809322885273,0.0,0.0
29954,2,9954,[216 655 403  11 228],405,3,38263,3.843596182822702,0.0,0.0
29955,2,9955,[568 179 172 546 195],62,4,38267,3.8436118923262352,0.0,0.0
29956,2,9956,[181 191 294 174 357],630,1,38268,3.8433263031033444,0.0,20.0
29957,2,9957,[ 98 302 405  69 204],416,5,38273,3.8434424583249647,0.0,20.0
29958,2,9958,[300 168 257  82 258],416,4,38277,3.8434581785319812,0.0,0.0
29959,2,9959,[273 294 234  22 282],253,4,38281,3.843473895582329,0.0,0.0
29960,2,9960,[546   1 234 237 515],297,2,38283,3.84328882642305,0.0,0.0
29961,2,9961,[200  69 185 216 322],417,1,38284,3.843003412969283,0.0,0.0
29962,2,9962,[405  22 257 235 135],642,2,38286,3.8428184281842817,0.0,0.0
29963,2,9963,[ 64  12 269 301 357],416,5,38291,3.842934564431955,40.0,0.0
29964,2,9964,[132 191 195 182 496],214,5,38296,3.843050677370798,0.0,0.0
29965,2,9965,[ 64  12 269 301 357],416,5,38301,3.8431667670078267,40.0,0.0
29966,2,9966,[ 64  12 269 301 357],416,5,38306,3.843282833350055,40.0,0.0
29967,2,9967,[323 121 405 597 172],417,0,38306,3.8428972712680576,0.0,0.0
29968,2,9968,[ 64  12 269 301 357],416,5,38311,3.8430133413582106,40.0,0.0
29969,2,9969,[135 183 153 204  89],297,4,38315,3.8430290872617854,0.0,0.0
29970,2,9970,[508  15  96 121   9],601,2,38317,3.8428442483201284,0.0,0.0
29971,2,9971,[  7   1 271 385  69],505,2,38319,3.8426594464500603,0.0,0.0
29972,2,9972,[ 64  12 269 301 357],416,5,38324,3.8427754938333503,40.0,0.0
29973,2,9973,[ 25 271 175 143 127],43,3,38327,3.842690996591137,0.0,0.0
29974,2,9974,[ 64  12 269 301 357],416,5,38332,3.84280701754386,40.0,0.0
29975,2,9975,[143 181 117 222  98],43,5,38337,3.842923015236568,0.0,40.0
29976,2,9976,[ 64  12 269 301 357],416,5,38342,3.8430389896762556,40.0,0.0
29977,2,9977,[235 161  50 211 302],43,4,38346,3.843054720384847,0.0,20.0
29978,2,9978,[471  96  22 423 515],416,5,38351,3.8431706583826033,0.0,0.0
29979,2,9979,[ 64  12 269 301 357],416,5,38356,3.8432865731462926,40.0,0.0
29980,2,9980,[ 64  12 269 301 357],416,5,38361,3.8434024646828977,40.0,0.0
29981,2,9981,[168 357 405 132 183],417,4,38365,3.843418152674815,0.0,0.0
29982,2,9982,[ 64  12 269 301 357],416,5,38370,3.8435340078132825,40.0,0.0
29983,2,9983,[118 475 508 427 258],601,4,38374,3.8435496794871793,0.0,0.0
29984,2,9984,[276 546 405 742 237],159,3,38377,3.843465197796695,0.0,0.0
29985,2,9985,[175  11 748 228   4],805,1,38378,3.8431804526336872,0.0,0.0
29986,2,9986,[435 194 678 423 118],297,0,38378,3.842795634324622,0.0,0.0
29987,2,9987,[603 546  56  22 588],805,2,38380,3.842611133360032,0.0,0.0
29988,2,9988,[  1 210 748 197 200],297,1,38381,3.8423265592151368,0.0,0.0
29989,2,9989,[ 64  12 269 301 357],416,5,38386,3.8424424424424424,40.0,0.0
29990,2,9990,[238 235 258 173 300],416,4,38390,3.842458212391152,0.0,0.0
29991,2,9991,[ 71 111 168 191 144],618,4,38394,3.842473979183347,0.0,0.0
29992,2,9992,[ 64  12 269 301 357],416,5,38399,3.8425898128690084,40.0,0.0
29993,2,9993,[100 222 191 153 742],297,3,38402,3.842505503301981,0.0,0.0
29994,2,9994,[ 79 597 678 273 748],416,3,38405,3.842421210605303,0.0,0.0
29995,2,9995,[ 64  12 269 301 357],416,5,38410,3.8425370148059224,40.0,0.0
29996,2,9996,[748 546  70 496 301],416,4,38414,3.842552765829749,0.0,0.0
29997,2,9997,[313 204 191  70 405],642,3,38417,3.84246849369874,20.0,20.0
29998,2,9998,[ 64  12 269 301 357],416,5,38422,3.8425842584258425,40.0,0.0
29999,2,9999,[144 175  79 196 135],373,2,38424,3.8424,0.0,0.0
30000,3,0,[144 483  69 238   4],417,2,2,2.0,20.0,0.0
30001,3,1,[200  12 173 403 176],416,5,7,3.5,20.0,0.0
30002,3,2,[238 173  12 483 176],62,5,12,4.0,40.0,0.0
30003,3,3,[204 172 121 471 153],43,4,16,4.0,0.0,0.0
30004,3,4,[238 173 172  12 153],437,5,21,4.2,20.0,0.0
30005,3,5,[238 173 172  12 153],805,5,26,4.333333333333333,20.0,0.0
30006,3,6,[238 173 172  12 153],43,4,30,4.285714285714286,20.0,0.0
30007,3,7,[204 173 172  12 153],373,5,35,4.375,20.0,0.0
30008,3,8,[204 173 172  12 153],416,5,40,4.444444444444445,20.0,0.0
30009,3,9,[191 273 118  96 168],417,3,43,4.3,0.0,0.0
30010,3,10,[286 202  25 118 742],417,3,46,4.181818181818182,0.0,0.0
30011,3,11,[238 121 182  15 318],437,3,49,4.083333333333333,20.0,0.0
30012,3,12,[118 191 318 176 286],437,2,51,3.923076923076923,20.0,0.0
30013,3,13,[211 161 568  64  70],230,4,55,3.9285714285714284,20.0,0.0
30014,3,14,[ 70  64 172 204  12],345,5,60,4.0,40.0,0.0
30015,3,15,[ 70  64 172 204  12],405,4,64,4.0,40.0,0.0
30016,3,16,[202  15 403 153 211],43,5,69,4.0588235294117645,0.0,0.0
30017,3,17,[210   1  70 111  79],128,3,72,4.0,0.0,0.0
30018,3,18,[ 15  79   1  64 211],417,4,76,4.0,20.0,0.0
30019,3,19,[195 117 175  96   9],854,2,78,3.9,0.0,0.0
30020,3,20,[200 151 194 117  79],297,1,79,3.761904761904762,0.0,0.0
30021,3,21,[ 12 173 191 204  64],601,3,82,3.727272727272727,40.0,0.0
30022,3,22,[403 211 191  64 172],373,4,86,3.739130434782609,20.0,0.0
30023,3,23,[161 172 318 168 191],373,5,91,3.7916666666666665,20.0,0.0
30024,3,24,[161 172 318 168 191],198,4,95,3.8,20.0,0.0
30025,3,25,[  1 211 172 202  15],43,5,100,3.8461538461538463,0.0,0.0
30026,3,26,[  1 211 172 202  15],43,5,105,3.888888888888889,0.0,0.0
30027,3,27,[ 70 318 132 204 135],711,4,109,3.892857142857143,20.0,0.0
30028,3,28,[173   9 153 202   1],805,3,112,3.8620689655172415,0.0,0.0
30029,3,29,[173  15 135 318 168],437,4,116,3.8666666666666667,20.0,0.0
30030,3,30,[173 153 135 318 191],854,5,121,3.903225806451613,20.0,0.0
30031,3,31,[173 153 135 318 191],437,5,126,3.9375,20.0,0.0
30032,3,32,[173 153 135 318 191],642,2,128,3.878787878787879,20.0,0.0
30033,3,33,[173 175 191 172  64],214,4,132,3.8823529411764706,20.0,0.0
30034,3,34,[173 175 191  64 483],854,5,137,3.914285714285714,40.0,0.0
30035,3,35,[  8 216 182  64 183],96,5,142,3.9444444444444446,20.0,0.0
30036,3,36,[175 132 191   8  15],854,4,146,3.945945945945946,0.0,0.0
30037,3,37,[175 132 191   8  64],214,5,151,3.973684210526316,20.0,0.0
30038,3,38,[200 121 265   8 288],711,2,153,3.923076923076923,0.0,20.0
30039,3,39,[265 183 423 597  70],618,4,157,3.925,0.0,0.0
30040,3,40,[175   1 216 211 183],297,4,161,3.926829268292683,0.0,0.0
30041,3,41,[175 191 216 211 183],405,1,162,3.857142857142857,0.0,0.0
30042,3,42,[173 483 210   8 132],62,5,167,3.883720930232558,20.0,0.0
30043,3,43,[173 483 210   8 132],437,4,171,3.8863636363636362,20.0,0.0
30044,3,44,[357 655  69 183  71],62,4,175,3.888888888888889,0.0,0.0
30045,3,45,[748 135 546 172   8],805,2,177,3.847826086956522,0.0,0.0
30046,3,46,[ 56 405 118 132 174],764,4,181,3.851063829787234,0.0,0.0
30047,3,47,[ 64 132 423 483 174],679,3,184,3.8333333333333335,40.0,0.0
30048,3,48,[ 88 132  97 210 228],505,4,188,3.836734693877551,0.0,0.0
30049,3,49,[ 97  64 405  71 191],705,3,191,3.82,20.0,0.0
30050,3,50,[234 333 300 196 286],345,2,193,3.784313725490196,0.0,0.0
30051,3,51,[ 64 173 179 515 357],405,3,196,3.769230769230769,20.0,0.0
30052,3,52,[191  98 202 258 568],711,4,200,3.7735849056603774,0.0,20.0
30053,3,53,[405  64  88 196 132],128,4,204,3.7777777777777777,20.0,0.0
30054,3,54,[427 496  79 202 185],230,5,209,3.8,0.0,0.0
30055,3,55,[ 88 196  71 258 234],345,4,213,3.8035714285714284,0.0,0.0
30056,3,56,[161 323 294 475 678],805,3,216,3.789473684210526,0.0,0.0
30057,3,57,[475 496 678  88 258],416,2,218,3.7586206896551726,0.0,0.0
30058,3,58,[216  28 568  70   9],43,5,223,3.7796610169491527,0.0,0.0
30059,3,59,[ 56  64 258 323  28],43,4,227,3.783333333333333,20.0,0.0
30060,3,60,[357 496 234 427 185],601,4,231,3.7868852459016393,0.0,0.0
30061,3,61,[ 12 742 195 245  15],417,4,235,3.7903225806451615,20.0,0.0
30062,3,62,[496 258 196 405 483],601,3,238,3.7777777777777777,20.0,0.0
30063,3,63,[172  88  15 313 135],618,4,242,3.78125,20.0,20.0
30064,3,64,[257 125 211 403 182],417,4,246,3.7846153846153845,0.0,0.0
30065,3,65,[216 235 655 234 202],805,1,247,3.742424242424242,0.0,0.0
30066,3,66,[357  64 597 125 427],642,3,250,3.7313432835820897,20.0,0.0
30067,3,67,[ 56  97 185  95  69],417,3,253,3.7205882352941178,0.0,0.0
30068,3,68,[748 183  70   8 234],416,5,258,3.739130434782609,0.0,0.0
30069,3,69,[328   8 204 323 173],416,4,262,3.742857142857143,0.0,0.0
30070,3,70,[258  95 245 328  98],416,3,265,3.732394366197183,0.0,20.0
30071,3,71,[173 597 144 235 568],417,1,266,3.6944444444444446,0.0,0.0
30072,3,72,[ 64 257 237 289 100],43,5,271,3.712328767123288,20.0,0.0
30073,3,73,[313 258 100  56 328],43,5,276,3.72972972972973,20.0,20.0
30074,3,74,[313 258 100  56 328],43,5,281,3.7466666666666666,20.0,20.0
30075,3,75,[405  95 403 508  64],417,3,284,3.736842105263158,20.0,0.0
30076,3,76,[ 15 200   8 282 127],253,5,289,3.7532467532467533,0.0,0.0
30077,3,77,[195 181  56 603 234],416,5,294,3.769230769230769,0.0,20.0
30078,3,78,[ 28 313 328  98 496],43,5,299,3.7848101265822787,20.0,40.0
30079,3,79,[195 172 121 127 168],417,3,302,3.775,0.0,0.0
30080,3,80,[313 276 172  22 318],618,4,306,3.7777777777777777,40.0,20.0
30081,3,81,[ 28 282 313 328  98],416,5,311,3.792682926829268,20.0,40.0
30082,3,82,[ 28 282 313 328  98],416,5,316,3.8072289156626504,20.0,40.0
30083,3,83,[ 28 282 313 328  98],416,5,321,3.8214285714285716,20.0,40.0
30084,3,84,[ 28 282 313 328  98],416,5,326,3.835294117647059,20.0,40.0
30085,3,85,[496   7 111  25 135],417,0,326,3.7906976744186047,0.0,0.0
30086,3,86,[ 28 282 313 328  98],416,5,331,3.8045977011494254,20.0,40.0
30087,3,87,[568 405 151  15 300],416,4,335,3.8068181818181817,0.0,0.0
30088,3,88,[288  11   7 237 423],416,4,339,3.808988764044944,0.0,20.0
30089,3,89,[173 269 111 597 603],805,3,342,3.8,0.0,0.0
30090,3,90,[ 28 289 125 100 258],345,2,344,3.78021978021978,0.0,0.0
30091,3,91,[181 127 313  22 328],505,3,347,3.7717391304347827,20.0,40.0
30092,3,92,[ 98 313  11  56  64],345,5,352,3.78494623655914,40.0,40.0
30093,3,93,[ 98 313  11  56  64],43,5,357,3.797872340425532,40.0,40.0
30094,3,94,[ 98 313  11  56  64],416,5,362,3.8105263157894735,40.0,40.0
30095,3,95,[ 98 313  11  56  64],618,5,367,3.8229166666666665,40.0,40.0
30096,3,96,[181 100 173  96 228],698,2,369,3.804123711340206,0.0,20.0
30097,3,97,[258 195  64 496 423],417,4,373,3.806122448979592,20.0,0.0
30098,3,98,[ 98 328 313  64  56],43,5,378,3.8181818181818183,40.0,40.0
30099,3,99,[405 238 294 182 748],416,5,383,3.83,0.0,0.0
30100,3,100,[423 125  50 215  98],416,5,388,3.8415841584158414,0.0,40.0
30101,3,101,[174 191 187 748 357],373,4,392,3.843137254901961,0.0,0.0
30102,3,102,[210 204 216 187  88],373,4,396,3.8446601941747574,0.0,0.0
30103,3,103,[385 210  82 195 294],230,3,399,3.8365384615384617,0.0,0.0
30104,3,104,[ 11 328 313  98 282],416,5,404,3.8476190476190477,20.0,40.0
30105,3,105,[ 15 302 151 181 191],62,3,407,3.839622641509434,0.0,20.0
30106,3,106,[ 64  11 313  98 282],345,4,411,3.8411214953271027,40.0,40.0
30107,3,107,[ 64  11 313  98 215],618,5,416,3.8518518518518516,40.0,40.0
30108,3,108,[ 64  11 313  98 215],345,5,421,3.8623853211009176,40.0,40.0
30109,3,109,[ 64  11 313  98 215],618,5,426,3.8727272727272726,40.0,40.0
30110,3,110,[ 64  11 313  98 215],416,5,431,3.8828828828828827,40.0,40.0
30111,3,111,[111 748 143 176 655],416,5,436,3.892857142857143,0.0,0.0
30112,3,112,[185 135 161 176 200],405,2,438,3.8761061946902653,0.0,0.0
30113,3,113,[ 64 258  82 313 143],642,4,442,3.8771929824561404,40.0,20.0
30114,3,114,[423 172 215  56 483],62,3,445,3.869565217391304,20.0,0.0
30115,3,115,[ 11  56  64 313 143],405,5,450,3.8793103448275863,40.0,20.0
30116,3,116,[ 11  56  64 313 143],405,5,455,3.888888888888889,40.0,20.0
30117,3,117,[125 151 132 127 271],505,2,457,3.8728813559322033,0.0,0.0
30118,3,118,[ 82 173  56 328  98],49,2,459,3.857142857142857,0.0,20.0
30119,3,119,[ 98 143  64  50 269],416,5,464,3.8666666666666667,20.0,40.0
30120,3,120,[ 98 143  64  50 269],711,5,469,3.87603305785124,20.0,40.0
30121,3,121,[ 98 143  64  50 269],416,5,474,3.8852459016393444,20.0,40.0
30122,3,122,[568  71 258  70  88],642,3,477,3.8780487804878048,0.0,0.0
30123,3,123,[ 56  22  64  98 143],262,4,481,3.879032258064516,20.0,20.0
30124,3,124,[313  50 269 603 483],751,4,485,3.88,40.0,40.0
30125,3,125,[172 151 405   8 222],43,5,490,3.888888888888889,0.0,0.0
30126,3,126,[ 11  64  50 269 603],214,3,493,3.8818897637795278,20.0,20.0
30127,3,127,[ 22  11  64  98 222],854,4,497,3.8828125,20.0,20.0
30128,3,128,[204 276  69 238 185],618,2,499,3.868217054263566,0.0,0.0
30129,3,129,[ 98  64 222 603 483],854,5,504,3.876923076923077,40.0,20.0
30130,3,130,[ 98  64 222 603 483],128,4,508,3.877862595419847,40.0,20.0
30131,3,131,[183 228 185 186 357],230,3,511,3.871212121212121,0.0,0.0
30132,3,132,[597 275 151 172 289],588,3,514,3.8646616541353382,0.0,0.0
30133,3,133,[508 268 168 172  70],654,3,517,3.8582089552238807,0.0,0.0
30134,3,134,[258 173 222 175 423],854,5,522,3.8666666666666667,0.0,0.0
30135,3,135,[471 275 300 282 245],297,1,523,3.8455882352941178,0.0,0.0
30136,3,136,[271 186  98  11  56],854,4,527,3.846715328467153,0.0,20.0
30137,3,137,[ 11 603 483  56 271],854,5,532,3.8550724637681157,20.0,0.0
30138,3,138,[174 196 151 403 385],705,4,536,3.856115107913669,0.0,0.0
30139,3,139,[ 11 603 483  56 271],854,5,541,3.8642857142857143,20.0,0.0
30140,3,140,[174 195 294 318 748],654,4,545,3.8652482269503547,20.0,0.0
30141,3,141,[ 11  56 603 483 271],854,5,550,3.8732394366197185,20.0,0.0
30142,3,142,[302 568 427 215 174],405,5,555,3.8811188811188813,0.0,0.0
30143,3,143,[125  82 423  64 286],62,3,558,3.875,20.0,0.0
30144,3,144,[ 82 118 271 204 322],805,0,558,3.8482758620689657,0.0,0.0
30145,3,145,[ 89 100 200  88 273],805,3,561,3.8424657534246576,0.0,0.0
30146,3,146,[ 56  89  11 603  98],214,5,566,3.8503401360544216,0.0,20.0
30147,3,147,[ 56  89  11 603  98],751,3,569,3.8445945945945947,0.0,20.0
30148,3,148,[ 50 237 175 176 257],922,3,572,3.838926174496644,0.0,20.0
30149,3,149,[ 56 483  64  98 603],854,5,577,3.8466666666666667,40.0,20.0
30150,3,150,[168  28 748 228 132],373,3,580,3.8410596026490067,0.0,0.0
30151,3,151,[181  50  95 301  28],43,5,585,3.848684210526316,0.0,40.0
30152,3,152,[423 273 385 181 111],417,2,587,3.8366013071895426,0.0,20.0
30153,3,153,[ 64  98  56 603 483],128,4,591,3.8376623376623376,40.0,20.0
30154,3,154,[200  12 174 257 300],297,2,593,3.825806451612903,20.0,0.0
30155,3,155,[216 282 143 238 200],12,4,597,3.826923076923077,0.0,0.0
30156,3,156,[ 89 385 265 323 222],417,2,599,3.8152866242038215,0.0,0.0
30157,3,157,[ 69 333 111  25 194],416,5,604,3.8227848101265822,0.0,0.0
30158,3,158,[268   8  69 180  98],214,3,607,3.8176100628930816,0.0,20.0
30159,3,159,[195  89  96 181  15],373,5,612,3.825,0.0,20.0
30160,3,160,[313 200 748 323  88],345,3,615,3.8198757763975157,20.0,20.0
30161,3,161,[318  79 238 100  82],437,4,619,3.8209876543209877,20.0,0.0
30162,3,162,[603  89  11  98 222],297,5,624,3.8282208588957056,0.0,20.0
30163,3,163,[179 125 496  15 174],262,2,626,3.817073170731707,0.0,0.0
30164,3,164,[  4 238 200 258 185],297,3,629,3.812121212121212,0.0,0.0
30165,3,165,[300 215 127 238 318],12,5,634,3.819277108433735,20.0,0.0
30166,3,166,[210  97 117 204 403],618,3,637,3.81437125748503,0.0,0.0
30167,3,167,[202 427 176 125  98],416,5,642,3.8214285714285716,0.0,20.0
30168,3,168,[111  97 195 275   7],297,3,645,3.8165680473372783,0.0,0.0
30169,3,169,[ 79 655 423  69  15],373,4,649,3.8176470588235296,0.0,0.0
30170,3,170,[173  98 282 318 172],734,4,653,3.818713450292398,20.0,20.0
30171,3,171,[191 100 275  96 483],698,2,655,3.808139534883721,20.0,0.0
30172,3,172,[597 385 153 405 222],43,4,659,3.8092485549132946,0.0,0.0
30173,3,173,[275 196 655 174 475],437,4,663,3.810344827586207,0.0,0.0
30174,3,174,[174  64  12 186 168],417,4,667,3.8114285714285714,40.0,0.0
30175,3,175,[151 403  97 276 194],416,3,670,3.8068181818181817,0.0,0.0
30176,3,176,[143 216 196 197 655],405,3,673,3.8022598870056497,0.0,0.0
30177,3,177,[ 12 222 183 195 294],297,3,676,3.797752808988764,20.0,0.0
30178,3,178,[294 121 289 235 323],416,2,678,3.787709497206704,0.0,0.0
30179,3,179,[  7 238 265 210 228],417,1,679,3.772222222222222,0.0,0.0
30180,3,180,[186   4   7 508 196],417,2,681,3.7624309392265194,0.0,0.0
30181,3,181,[ 82 180 568 405 172],887,4,685,3.7637362637362637,0.0,0.0
30182,3,182,[588 276 748 471 323],159,3,688,3.759562841530055,0.0,0.0
30183,3,183,[568   1 121 496 132],642,4,692,3.760869565217391,0.0,0.0
30184,3,184,[  9  98 588 121 143],601,1,693,3.745945945945946,0.0,20.0
30185,3,185,[ 89 197  98 301 258],297,4,697,3.747311827956989,0.0,20.0
30186,3,186,[200  69  96 546  56],417,2,699,3.7379679144385025,0.0,0.0
30187,3,187,[174 183  56   9 257],62,4,703,3.7393617021276597,0.0,0.0
30188,3,188,[269 121 423 194  98],854,3,706,3.7354497354497354,0.0,20.0
30189,3,189,[125 228 471 127 269],721,4,710,3.736842105263158,0.0,0.0
30190,3,190,[185  70  22 483 385],618,4,714,3.738219895287958,20.0,0.0
30191,3,191,[568 228 258  71 385],922,3,717,3.734375,0.0,0.0
30192,3,192,[403 173 742 508 271],62,3,720,3.7305699481865284,0.0,0.0
30193,3,193,[ 50  11   1 318 238],854,4,724,3.731958762886598,20.0,20.0
30194,3,194,[588 742 748 173 302],297,3,727,3.7282051282051283,0.0,0.0
30195,3,195,[172 471 153 385   1],922,3,730,3.7244897959183674,0.0,0.0
30196,3,196,[  1 235  98 238  70],62,3,733,3.720812182741117,0.0,20.0
30197,3,197,[  1 471  79 238 318],43,3,736,3.717171717171717,20.0,0.0
30198,3,198,[216 144  98 237 483],588,2,738,3.708542713567839,20.0,20.0
30199,3,199,[475 234 257 423 135],297,2,740,3.7,0.0,0.0
30200,3,200,[357 168 195 191  82],373,4,744,3.701492537313433,0.0,0.0
30201,3,201,[211 179 228 235  97],417,3,747,3.698019801980198,0.0,0.0
30202,3,202,[322   9 121 603  11],854,3,750,3.6945812807881775,0.0,0.0
30203,3,203,[172 191 202 302 216],405,4,754,3.696078431372549,0.0,0.0
30204,3,204,[161 282 215  28   9],618,3,757,3.6926829268292685,0.0,0.0
30205,3,205,[143 748 258 508  25],297,4,761,3.6941747572815533,0.0,0.0
30206,3,206,[385 121 210 183 588],805,1,762,3.681159420289855,0.0,0.0
30207,3,207,[748  95 196  12  71],416,4,766,3.6826923076923075,20.0,0.0
30208,3,208,[300  22 357 172 258],416,5,771,3.688995215311005,0.0,0.0
30209,3,209,[423  25  97 238   8],416,5,776,3.6952380952380954,0.0,0.0
30210,3,210,[125 385  22 655   7],416,5,781,3.7014218009478674,0.0,0.0
30211,3,211,[ 56 588 100 182  50],297,4,785,3.702830188679245,0.0,20.0
30212,3,212,[ 82 127   4 471 216],43,4,789,3.704225352112676,0.0,0.0
30213,3,213,[173 385  96 423 294],505,3,792,3.7009345794392523,0.0,0.0
30214,3,214,[318 204 191 742 423],416,5,797,3.7069767441860466,20.0,0.0
30215,3,215,[ 64   1 125 655 357],416,5,802,3.712962962962963,20.0,0.0
30216,3,216,[289  82  22 121 234],588,4,806,3.7142857142857144,0.0,0.0
30217,3,217,[174 196 257 228   8],921,2,808,3.706422018348624,0.0,0.0
30218,3,218,[268   8 328  15  22],721,5,813,3.712328767123288,0.0,0.0
30219,3,219,[273 234 175 742  12],805,3,816,3.709090909090909,20.0,0.0
30220,3,220,[175  79 748  15 132],198,1,817,3.6968325791855206,0.0,0.0
30221,3,221,[211   7 302 300 111],297,3,820,3.6936936936936937,0.0,0.0
30222,3,222,[ 64  79 185 125 427],230,5,825,3.6995515695067263,20.0,0.0
30223,3,223,[185 176 117  79 268],854,2,827,3.6919642857142856,0.0,0.0
30224,3,224,[132 313  79 174 194],416,5,832,3.6977777777777776,20.0,20.0
30225,3,225,[161 151 678  82 268],416,3,835,3.6946902654867255,0.0,0.0
30226,3,226,[174 144  71 597  28],618,5,840,3.700440528634361,0.0,0.0
30227,3,227,[216 100 127 234 200],253,5,845,3.706140350877193,0.0,0.0
30228,3,228,[100 238 185  11 168],618,4,849,3.7074235807860263,0.0,0.0
30229,3,229,[204  28 161  88 143],405,3,852,3.7043478260869565,0.0,0.0
30230,3,230,[ 50 144 135  71 143],618,5,857,3.70995670995671,0.0,20.0
30231,3,231,[117 269 191 282 588],416,5,862,3.7155172413793105,0.0,0.0
30232,3,232,[603  64  12  95 568],405,3,865,3.7124463519313307,40.0,0.0
30233,3,233,[202  25 211 748 301],416,5,870,3.717948717948718,0.0,0.0
30234,3,234,[200 173 143 174 288],345,4,874,3.7191489361702126,0.0,20.0
30235,3,235,[187  96 258 111 181],416,5,879,3.7245762711864407,0.0,20.0
30236,3,236,[546 216 508 144 168],62,4,883,3.7257383966244726,0.0,0.0
30237,3,237,[ 98 427 496  79 273],618,5,888,3.73109243697479,0.0,20.0
30238,3,238,[302 173 268 197  70],416,5,893,3.7364016736401675,0.0,0.0
30239,3,239,[151 204 222 183 176],922,2,895,3.7291666666666665,0.0,0.0
30240,3,240,[275 181 161 313 228],711,4,899,3.7302904564315353,20.0,40.0
30241,3,241,[ 70 475 191  56 168],437,2,901,3.7231404958677685,0.0,0.0
30242,3,242,[ 15 161 286 471 678],721,4,905,3.7242798353909463,0.0,0.0
30243,3,243,[191 172 265 127 183],416,5,910,3.7295081967213113,0.0,0.0
30244,3,244,[546 333 118 515  11],416,3,913,3.726530612244898,0.0,0.0
30245,3,245,[175 200 161 271 405],805,2,915,3.7195121951219514,0.0,0.0
30246,3,246,[174  79 132 127 100],373,2,917,3.7125506072874495,0.0,0.0
30247,3,247,[125  79 423  56 172],416,5,922,3.717741935483871,0.0,0.0
30248,3,248,[323 515 742  28 265],416,4,926,3.718875502008032,0.0,0.0
30249,3,249,[183  56 427 186  89],198,5,931,3.724,0.0,0.0
30250,3,250,[403 546  98 423 187],416,4,935,3.7250996015936253,0.0,20.0
30251,3,251,[174 181 202 121 655],805,0,935,3.7103174603174605,0.0,20.0
30252,3,252,[ 28 742 237 222 118],588,2,937,3.7035573122529644,0.0,0.0
30253,3,253,[182 100 742 144 475],416,4,941,3.704724409448819,0.0,0.0
30254,3,254,[195 748 238 300  97],198,1,942,3.6941176470588237,0.0,0.0
30255,3,255,[357 496 200 210  71],416,5,947,3.69921875,0.0,0.0
30256,3,256,[182   4  28 289 483],342,3,950,3.6964980544747084,20.0,0.0
30257,3,257,[435 179 655 168 286],373,3,953,3.693798449612403,0.0,0.0
30258,3,258,[427 237 597  79 143],416,3,956,3.6911196911196913,0.0,0.0
30259,3,259,[196 176 197  15 151],198,3,959,3.6884615384615387,0.0,0.0
30260,3,260,[  8 143 197  11  98],416,5,964,3.6934865900383143,0.0,20.0
30261,3,261,[ 64 127 228 187 234],198,3,967,3.6908396946564888,20.0,0.0
30262,3,262,[268 182   8 385 475],49,1,968,3.6806083650190113,0.0,0.0
30263,3,263,[182 143  89  28 427],342,3,971,3.678030303030303,0.0,0.0
30264,3,264,[603 423 286  50 234],297,3,974,3.6754716981132076,0.0,20.0
30265,3,265,[127  50 483 228  71],601,4,978,3.6766917293233083,20.0,20.0
30266,3,266,[143 313 328  95 357],416,4,982,3.6779026217228465,20.0,20.0
30267,3,267,[168  22 423 153 210],373,4,986,3.6791044776119404,0.0,0.0
30268,3,268,[ 82 294 496 196 405],417,3,989,3.676579925650558,0.0,0.0
30269,3,269,[237 168 151 174 181],198,4,993,3.6777777777777776,0.0,20.0
30270,3,270,[300 302 125  97 475],416,4,997,3.678966789667897,0.0,0.0
30271,3,271,[678 191 245  97 182],297,1,998,3.6691176470588234,0.0,0.0
30272,3,272,[ 95  15   4 132 228],198,1,999,3.659340659340659,0.0,0.0
30273,3,273,[508  70 546 588 118],297,3,1002,3.656934306569343,0.0,0.0
30274,3,274,[357 172 182 215 286],416,5,1007,3.6618181818181816,0.0,0.0
30275,3,275,[228 100 135 174 194],373,3,1010,3.6594202898550723,0.0,0.0
30276,3,276,[173 196 216 117  25],345,4,1014,3.660649819494585,0.0,0.0
30277,3,277,[258  82 328 742 111],62,2,1016,3.6546762589928057,0.0,0.0
30278,3,278,[ 56 111  96  15   1],416,5,1021,3.6594982078853047,0.0,0.0
30279,3,279,[237 302 168  71 216],62,3,1024,3.657142857142857,0.0,0.0
30280,3,280,[313 216  79  71 173],345,4,1028,3.6583629893238436,20.0,20.0
30281,3,281,[ 89 235 194 471 210],297,2,1030,3.652482269503546,0.0,0.0
30282,3,282,[ 15 153 282 276  97],654,1,1031,3.6431095406360425,0.0,0.0
30283,3,283,[ 70 197 143 210 216],297,4,1035,3.6443661971830985,0.0,0.0
30284,3,284,[265 322 191 211 275],416,4,1039,3.645614035087719,0.0,0.0
30285,3,285,[603  70 245 176 179],416,3,1042,3.6433566433566433,0.0,0.0
30286,3,286,[202   8 186 742  56],230,4,1046,3.6445993031358883,0.0,0.0
30287,3,287,[168 143 211   4 191],373,4,1050,3.6458333333333335,0.0,0.0
30288,3,288,[183 135 196  28 161],230,3,1053,3.643598615916955,0.0,0.0
30289,3,289,[302  71 238 245 568],62,2,1055,3.6379310344827585,0.0,0.0
30290,3,290,[423 403 111  89 191],62,3,1058,3.6357388316151202,0.0,0.0
30291,3,291,[ 69 496  97 427 143],373,3,1061,3.6335616438356166,0.0,0.0
30292,3,292,[265  70 168 172 196],618,4,1065,3.63481228668942,0.0,0.0
30293,3,293,[ 71  79 294 121 117],654,3,1068,3.63265306122449,0.0,0.0
30294,3,294,[186  69 191 174 161],373,5,1073,3.6372881355932205,0.0,0.0
30295,3,295,[ 15 546  56 235 302],416,3,1076,3.635135135135135,0.0,0.0
30296,3,296,[269 289 117 275  50],416,4,1080,3.6363636363636362,0.0,20.0
30297,3,297,[175 216  95 121 117],805,1,1081,3.62751677852349,0.0,0.0
30298,3,298,[204 202 191 216 121],642,3,1084,3.6254180602006687,0.0,0.0
30299,3,299,[588 568 168  50 678],588,4,1088,3.6266666666666665,0.0,20.0
30300,3,300,[357 174 238 111  11],417,3,1091,3.6245847176079735,0.0,0.0
30301,3,301,[275 202 286 318  50],416,5,1096,3.629139072847682,20.0,20.0
30302,3,302,[174 357 546 294 235],417,2,1098,3.623762376237624,0.0,0.0
30303,3,303,[117 202 237 588  56],505,2,1100,3.6184210526315788,0.0,0.0
30304,3,304,[271 597 195 275  89],62,3,1103,3.6163934426229507,0.0,0.0
30305,3,305,[117 228 127  25 168],417,3,1106,3.6143790849673203,0.0,0.0
30306,3,306,[143  95   1 294 258],887,4,1110,3.6156351791530943,0.0,0.0
30307,3,307,[215  50 121  15 151],416,4,1114,3.616883116883117,0.0,20.0
30308,3,308,[471 125 118  25  71],887,3,1117,3.614886731391586,0.0,0.0
30309,3,309,[168 228 515 176  25],698,2,1119,3.609677419354839,0.0,0.0
30310,3,310,[288 196 302 118  97],416,4,1123,3.6109324758842445,0.0,20.0
30311,3,311,[289 282 125  71 318],345,1,1124,3.6025641025641026,20.0,0.0
30312,3,312,[191 127 132 168  22],601,5,1129,3.6070287539936103,0.0,0.0
30313,3,313,[196 202 161  11  56],43,5,1134,3.611464968152866,0.0,0.0
30314,3,314,[475 194   8 174 195],297,3,1137,3.6095238095238096,0.0,0.0
30315,3,315,[211 161 183 186  50],230,4,1141,3.6107594936708862,0.0,20.0
30316,3,316,[191 300   1  50 200],416,5,1146,3.6151419558359623,0.0,20.0
30317,3,317,[ 71  15 125 245 111],921,3,1149,3.6132075471698113,0.0,0.0
30318,3,318,[289 385 172  96 322],416,3,1152,3.6112852664576804,0.0,0.0
30319,3,319,[ 22 216   7 196 210],805,1,1153,3.603125,0.0,0.0
30320,3,320,[174 117  97 168 173],588,3,1156,3.601246105919003,0.0,0.0
30321,3,321,[258 275 176 195 111],854,2,1158,3.5962732919254656,0.0,0.0
30322,3,322,[ 70 748 187 234  96],416,5,1163,3.6006191950464395,0.0,0.0
30323,3,323,[  1 568   8 257 742],654,5,1168,3.6049382716049383,0.0,0.0
30324,3,324,[195 174 238 118  70],437,2,1170,3.6,0.0,0.0
30325,3,325,[328 286 235 183 294],62,2,1172,3.5950920245398774,0.0,0.0
30326,3,326,[176  69 273  64 195],417,3,1175,3.5932721712538225,20.0,0.0
30327,3,327,[597 748 403 143 117],642,5,1180,3.597560975609756,0.0,0.0
30328,3,328,[185  97 301 483 168],711,5,1185,3.601823708206687,20.0,0.0
30329,3,329,[ 71 322 151 180  88],128,3,1188,3.6,0.0,0.0
30330,3,330,[ 28 200 176 202 403],618,4,1192,3.6012084592145017,0.0,0.0
30331,3,331,[  7 435 144 496 172],230,3,1195,3.5993975903614457,0.0,0.0
30332,3,332,[144 125 228  89   4],62,3,1198,3.5975975975975976,0.0,0.0
30333,3,333,[357 182 423 181 132],198,4,1202,3.5988023952095807,0.0,20.0
30334,3,334,[153 235 515 143 182],297,3,1205,3.5970149253731343,0.0,0.0
30335,3,335,[175  98 385 161 655],922,1,1206,3.5892857142857144,0.0,20.0
30336,3,336,[161 403 235 172 496],417,1,1207,3.5816023738872405,0.0,0.0
30337,3,337,[204 173 318 172 168],588,5,1212,3.5857988165680474,20.0,0.0
30338,3,338,[ 98 151 180 179 302],214,5,1217,3.589970501474926,0.0,20.0
30339,3,339,[546 153 215 282  98],654,4,1221,3.5911764705882354,0.0,20.0
30340,3,340,[ 70 282 197 173 237],128,3,1224,3.589442815249267,0.0,0.0
30341,3,341,[118 151  25 168 405],416,3,1227,3.587719298245614,0.0,0.0
30342,3,342,[322 678 275 195 197],416,3,1230,3.58600583090379,0.0,0.0
30343,3,343,[ 12 132 100 471 258],588,4,1234,3.5872093023255816,20.0,0.0
30344,3,344,[294 742 216 151 286],416,4,1238,3.588405797101449,0.0,0.0
30345,3,345,[161 200 194 191 275],416,5,1243,3.592485549132948,0.0,0.0
30346,3,346,[100 258 568 216 181],416,5,1248,3.596541786743516,0.0,20.0
30347,3,347,[181 237 144 191 175],297,3,1251,3.5948275862068964,0.0,20.0
30348,3,348,[655  11 228 202  71],405,3,1254,3.5931232091690544,0.0,0.0
30349,3,349,[191 216 655 603  89],405,2,1256,3.5885714285714285,0.0,0.0
30350,3,350,[181 168 496  25   1],230,4,1260,3.58974358974359,0.0,20.0
30351,3,351,[228 237   7 294  22],297,3,1263,3.5880681818181817,0.0,0.0
30352,3,352,[294 174 197 228 215],721,4,1267,3.5892351274787537,0.0,0.0
30353,3,353,[186  25 181 655 742],588,4,1271,3.5903954802259888,0.0,20.0
30354,3,354,[ 79 197 118 176 153],854,3,1274,3.5887323943661973,0.0,0.0
30355,3,355,[597 125  28 176  70],62,2,1276,3.5842696629213484,0.0,0.0
30356,3,356,[748 318 286 403 197],721,4,1280,3.585434173669468,20.0,0.0
30357,3,357,[294 258 678 143 222],805,2,1282,3.5810055865921786,0.0,0.0
30358,3,358,[328 151 202  28  50],43,5,1287,3.584958217270195,0.0,20.0
30359,3,359,[161 597  82 195 269],416,4,1291,3.5861111111111112,0.0,0.0
30360,3,360,[  7 172 197 127 357],805,4,1295,3.587257617728532,0.0,0.0
30361,3,361,[ 22  96  97 191 183],62,4,1299,3.588397790055249,0.0,0.0
30362,3,362,[588 151 655 174 508],345,4,1303,3.5895316804407713,0.0,0.0
30363,3,363,[191  70  97 121 200],416,5,1308,3.5934065934065935,0.0,0.0
30364,3,364,[ 15 211 302 271 328],43,4,1312,3.5945205479452054,0.0,0.0
30365,3,365,[179 211 588 318 496],416,4,1316,3.5956284153005464,20.0,0.0
30366,3,366,[245 313 748 405  22],416,4,1320,3.5967302452316074,20.0,20.0
30367,3,367,[ 28 185  11 515 568],416,5,1325,3.6005434782608696,0.0,0.0
30368,3,368,[200  89 258  82 173],198,4,1329,3.6016260162601625,0.0,0.0
30369,3,369,[  4 186 300 143 403],198,2,1331,3.597297297297297,0.0,0.0
30370,3,370,[210 275   8 117 655],416,5,1336,3.601078167115903,0.0,0.0
30371,3,371,[423 238 179 181  50],49,2,1338,3.596774193548387,0.0,40.0
30372,3,372,[318 161 183 403 186],405,3,1341,3.5951742627345844,20.0,0.0
30373,3,373,[100 161 172   4 180],373,3,1344,3.593582887700535,0.0,0.0
30374,3,374,[403 655 286 496 268],416,5,1349,3.5973333333333333,0.0,0.0
30375,3,375,[435 403 318 161 143],405,3,1352,3.595744680851064,20.0,0.0
30376,3,376,[ 64 301 313  11  98],416,5,1357,3.59946949602122,40.0,40.0
30377,3,377,[ 64  96 318   4  69],854,3,1360,3.5978835978835977,40.0,0.0
30378,3,378,[ 82 273 294 385 179],416,4,1364,3.598944591029024,0.0,0.0
30379,3,379,[197  56 191  69 301],297,2,1366,3.594736842105263,0.0,0.0
30380,3,380,[210 475 483 496  69],437,2,1368,3.590551181102362,20.0,0.0
30381,3,381,[ 64 301 313  11 318],345,5,1373,3.594240837696335,60.0,20.0
30382,3,382,[ 64 301 313  11 318],345,5,1378,3.597911227154047,60.0,20.0
30383,3,383,[ 64 301 313  11 318],345,5,1383,3.6015625,60.0,20.0
30384,3,384,[ 64 301 313  11 318],345,5,1388,3.605194805194805,60.0,20.0
30385,3,385,[195 313 385 168 294],642,4,1392,3.606217616580311,20.0,20.0
30386,3,386,[ 64 301 313  11 318],43,5,1397,3.6098191214470283,60.0,20.0
30387,3,387,[ 28  25 161 496  95],230,4,1401,3.6108247422680413,0.0,0.0
30388,3,388,[215 144  15 151  95],43,5,1406,3.61439588688946,0.0,0.0
30389,3,389,[655 294 127 183 288],887,2,1408,3.6102564102564103,0.0,20.0
30390,3,390,[153  12 180 168 288],805,3,1411,3.608695652173913,20.0,20.0
30391,3,391,[121  69 597  88  12],588,4,1415,3.6096938775510203,20.0,0.0
30392,3,392,[301  64 313  11 318],345,5,1420,3.61323155216285,60.0,20.0
30393,3,393,[288 275 258 216 427],262,3,1423,3.6116751269035534,0.0,20.0
30394,3,394,[301  64 313  11 318],345,5,1428,3.6151898734177217,60.0,20.0
30395,3,395,[269  79 191 237   4],43,5,1433,3.6186868686868685,0.0,0.0
30396,3,396,[301  64 313  11 318],416,5,1438,3.6221662468513856,60.0,20.0
30397,3,397,[301  64 313  11 318],43,5,1443,3.6256281407035176,60.0,20.0
30398,3,398,[301  64 313  11 318],416,5,1448,3.6290726817042605,60.0,20.0
30399,3,399,[301  64 313  11 318],43,5,1453,3.6325,60.0,20.0
30400,3,400,[301  64 313  11 318],416,5,1458,3.6359102244389025,60.0,20.0
30401,3,401,[301  64 313  11 318],416,5,1463,3.6393034825870645,60.0,20.0
30402,3,402,[301  64 313  11 318],345,5,1468,3.642679900744417,60.0,20.0
30403,3,403,[301  64 313  11 318],345,5,1473,3.646039603960396,60.0,20.0
30404,3,404,[301  64 313  11 318],43,5,1478,3.6493827160493826,60.0,20.0
30405,3,405,[301  64 313  11 318],43,5,1483,3.6527093596059115,60.0,20.0
30406,3,406,[301  64 313  11 318],416,5,1488,3.656019656019656,60.0,20.0
30407,3,407,[301  64 313  11 318],345,5,1493,3.659313725490196,60.0,20.0
30408,3,408,[ 96 176 423 118 313],416,4,1497,3.6601466992665035,20.0,20.0
30409,3,409,[ 12 173 210   8   4],297,4,1501,3.6609756097560977,20.0,0.0
30410,3,410,[301  64 313  11 318],345,5,1506,3.664233576642336,60.0,20.0
30411,3,411,[181 179 127 273  50],417,2,1508,3.6601941747572817,0.0,40.0
30412,3,412,[302  12 269 144 423],297,3,1511,3.6585956416464893,20.0,0.0
30413,3,413,[282 173  95 211 179],416,3,1514,3.657004830917874,0.0,0.0
30414,3,414,[301  64 313  11 318],43,5,1519,3.6602409638554216,60.0,20.0
30415,3,415,[301  64 313  11 318],345,5,1524,3.6634615384615383,60.0,20.0
30416,3,416,[301  64 313  11 318],345,5,1529,3.6666666666666665,60.0,20.0
30417,3,417,[288 187 328 286  97],416,5,1534,3.6698564593301435,0.0,20.0
30418,3,418,[301  64 313  11 318],345,5,1539,3.6730310262529833,60.0,20.0
30419,3,419,[288 568 273 515 742],417,1,1540,3.6666666666666665,0.0,20.0
30420,3,420,[301  64 313  11 318],345,5,1545,3.669833729216152,60.0,20.0
30421,3,421,[301  64 313  11 318],416,5,1550,3.6729857819905214,60.0,20.0
30422,3,422,[172   4 245 282 197],345,3,1553,3.6713947990543736,0.0,0.0
30423,3,423,[357 294 258 211 435],698,2,1555,3.667452830188679,0.0,0.0
30424,3,424,[ 64 301 313  11 318],345,5,1560,3.6705882352941175,60.0,20.0
30425,3,425,[144 197 196 202 323],805,2,1562,3.6666666666666665,0.0,0.0
30426,3,426,[ 22   7 194 288 204],416,5,1567,3.669789227166276,0.0,20.0
30427,3,427,[195 215 597 117 508],62,3,1570,3.6682242990654204,0.0,0.0
30428,3,428,[ 15 151 210  64 181],62,4,1574,3.668997668997669,20.0,20.0
30429,3,429,[ 64 301 313  11 318],416,5,1579,3.672093023255814,60.0,20.0
30430,3,430,[117 183 174 496  97],416,5,1584,3.6751740139211138,0.0,0.0
30431,3,431,[301  64 313  11 318],43,5,1589,3.678240740740741,60.0,20.0
30432,3,432,[301  64 313  11 318],345,5,1594,3.6812933025404155,60.0,20.0
30433,3,433,[234  79 191 197 238],198,3,1597,3.6797235023041477,0.0,0.0
30434,3,434,[301  64 313  11 318],345,5,1602,3.682758620689655,60.0,20.0
30435,3,435,[301  64 313  11 318],416,5,1607,3.6857798165137616,60.0,20.0
30436,3,436,[301  64 313  11 318],345,5,1612,3.688787185354691,60.0,20.0
30437,3,437,[282 100 235 111 121],854,1,1613,3.682648401826484,0.0,0.0
30438,3,438,[191 118  64 234  95],417,5,1618,3.6856492027334853,20.0,0.0
30439,3,439,[301  64 313  11 318],43,5,1623,3.6886363636363635,60.0,20.0
30440,3,440,[301  64 313  11 318],416,5,1628,3.691609977324263,60.0,20.0
30441,3,441,[301  64 313  11 318],345,5,1633,3.6945701357466065,60.0,20.0
30442,3,442,[301  64 313  11 318],345,5,1638,3.6975169300225734,60.0,20.0
30443,3,443,[301  64 313  11 318],43,5,1643,3.7004504504504503,60.0,20.0
30444,3,444,[301  64 313  11 318],416,5,1648,3.703370786516854,60.0,20.0
30445,3,445,[301  64 313  11 318],345,5,1653,3.7062780269058297,60.0,20.0
30446,3,446,[301  64 313  11 318],416,5,1658,3.70917225950783,60.0,20.0
30447,3,447,[301  64 313  11 318],43,5,1663,3.7120535714285716,60.0,20.0
30448,3,448,[301  64 313  11 318],345,5,1668,3.714922048997773,60.0,20.0
30449,3,449,[302  11 385   1 597],417,3,1671,3.7133333333333334,0.0,0.0
30450,3,450,[301  64 313  11 318],43,5,1676,3.7161862527716187,60.0,20.0
30451,3,451,[ 12  98 151 118 257],416,2,1678,3.7123893805309733,20.0,20.0
30452,3,452,[ 64 301 313  11 318],416,5,1683,3.7152317880794703,60.0,20.0
30453,3,453,[ 64 301 313  11 318],43,5,1688,3.7180616740088106,60.0,20.0
30454,3,454,[186 588 276 127  97],618,4,1692,3.718681318681319,0.0,0.0
30455,3,455,[186 168  50 385 318],373,4,1696,3.719298245614035,20.0,20.0
30456,3,456,[301  64 313  11 318],345,5,1701,3.7221006564551424,60.0,20.0
30457,3,457,[276  71  15 132  70],764,4,1705,3.722707423580786,0.0,0.0
30458,3,458,[301  64 313  11 318],345,5,1710,3.7254901960784315,60.0,20.0
30459,3,459,[180 216 313 655   8],711,5,1715,3.7282608695652173,20.0,20.0
30460,3,460,[301  64 313  11 318],43,5,1720,3.7310195227765726,60.0,20.0
30461,3,461,[301  64 313  11 318],345,5,1725,3.7337662337662336,60.0,20.0
30462,3,462,[301  64 313  11 318],345,5,1730,3.736501079913607,60.0,20.0
30463,3,463,[742 215 117 357 568],416,5,1735,3.7392241379310347,0.0,0.0
30464,3,464,[301  64 313  11 318],43,5,1740,3.7419354838709675,60.0,20.0
30465,3,465,[182   4  15 258 222],198,2,1742,3.7381974248927037,0.0,0.0
30466,3,466,[ 64 301 313  11 318],416,5,1747,3.740899357601713,60.0,20.0
30467,3,467,[ 64 301 313  11 318],416,5,1752,3.7435897435897436,60.0,20.0
30468,3,468,[568 222  70 173  25],128,2,1754,3.739872068230277,0.0,0.0
30469,3,469,[ 64 301 313  11 318],345,5,1759,3.7425531914893617,60.0,20.0
30470,3,470,[ 64 301 313  11 318],345,5,1764,3.745222929936306,60.0,20.0
30471,3,471,[ 64 301 313  11 318],416,5,1769,3.7478813559322033,60.0,20.0
30472,3,472,[ 64 301 313  11 318],416,5,1774,3.7505285412262155,60.0,20.0
30473,3,473,[ 98 235 273 187 588],416,4,1778,3.7510548523206753,0.0,20.0
30474,3,474,[ 64 301 313  11 318],416,5,1783,3.7536842105263157,60.0,20.0
30475,3,475,[ 64 301 313  11 318],416,5,1788,3.7563025210084033,60.0,20.0
30476,3,476,[496 210 322  89 144],417,1,1789,3.750524109014675,0.0,0.0
30477,3,477,[ 95 546  98 405 275],43,5,1794,3.7531380753138075,0.0,20.0
30478,3,478,[302  15 185 286 496],416,5,1799,3.755741127348643,0.0,0.0
30479,3,479,[ 64 301 313  11 318],416,5,1804,3.7583333333333333,60.0,20.0
30480,3,480,[ 64 301 313  11 318],416,5,1809,3.760914760914761,60.0,20.0
30481,3,481,[202 258 405 121   7],416,5,1814,3.763485477178423,0.0,0.0
30482,3,482,[678 174 276 313  50],416,3,1817,3.761904761904762,20.0,40.0
30483,3,483,[180 228 475   7  50],805,3,1820,3.760330578512397,0.0,20.0
30484,3,484,[301 200 195   4 182],297,1,1821,3.754639175257732,0.0,0.0
30485,3,485,[117 742 121  95 127],253,5,1826,3.757201646090535,0.0,0.0
30486,3,486,[301  64 313  11 318],43,5,1831,3.759753593429158,60.0,20.0
30487,3,487,[301  64 313  11 318],43,5,1836,3.762295081967213,60.0,20.0
30488,3,488,[118 143  28 257 588],541,5,1841,3.764826175869121,0.0,0.0
30489,3,489,[301  64 313  11 318],416,5,1846,3.76734693877551,60.0,20.0
30490,3,490,[301  64 313  11 318],43,5,1851,3.769857433808554,60.0,20.0
30491,3,491,[301  64 313  11 318],43,5,1856,3.772357723577236,60.0,20.0
30492,3,492,[301  64 313  11 318],416,5,1861,3.7748478701825556,60.0,20.0
30493,3,493,[118 228 265 268 127],417,3,1864,3.7732793522267207,0.0,0.0
30494,3,494,[ 64 301 313  11 318],345,5,1869,3.775757575757576,60.0,20.0
30495,3,495,[ 64 301 313  11 318],345,5,1874,3.778225806451613,60.0,20.0
30496,3,496,[182 257 385  50 176],416,4,1878,3.778672032193159,0.0,20.0
30497,3,497,[228 191 176 301 748],297,2,1880,3.7751004016064256,0.0,0.0
30498,3,498,[ 64 301 313  11 318],43,5,1885,3.7775551102204408,60.0,20.0
30499,3,499,[ 64 301 313  11 318],416,5,1890,3.78,60.0,20.0
30500,3,500,[ 95  50 111 196 181],711,4,1894,3.780439121756487,0.0,40.0
30501,3,501,[ 64 301 313  11 318],43,5,1899,3.7828685258964145,60.0,20.0
30502,3,502,[ 64 301 313  11 318],345,5,1904,3.7852882703777335,60.0,20.0
30503,3,503,[271 322  15 182 258],907,5,1909,3.7876984126984126,0.0,0.0
30504,3,504,[  7  64  56 238  22],262,5,1914,3.79009900990099,20.0,0.0
30505,3,505,[301  64 313  11 318],345,5,1919,3.792490118577075,60.0,20.0
30506,3,506,[742 294  12  97 357],417,4,1923,3.7928994082840237,20.0,0.0
30507,3,507,[ 64 196 588 357 121],417,3,1926,3.7913385826771653,20.0,0.0
30508,3,508,[301  64 313  11 318],416,5,1931,3.793713163064833,60.0,20.0
30509,3,509,[ 64 202 282 187 151],416,4,1935,3.7941176470588234,20.0,0.0
30510,3,510,[ 28 215 200 194 302],297,2,1937,3.7906066536203524,0.0,0.0
30511,3,511,[423  22 276 245 742],416,3,1940,3.7890625,0.0,0.0
30512,3,512,[ 11  96  98 151 655],198,5,1945,3.7914230019493176,0.0,20.0
30513,3,513,[ 64 301 313  11 318],416,5,1950,3.7937743190661477,60.0,20.0
30514,3,514,[ 64 301 313  11 318],416,5,1955,3.796116504854369,60.0,20.0
30515,3,515,[333 127 475 200 269],416,4,1959,3.796511627906977,0.0,0.0
30516,3,516,[ 64 301 313  11 318],416,5,1964,3.7988394584139265,60.0,20.0
30517,3,517,[357  22 302 183 216],297,5,1969,3.801158301158301,0.0,0.0
30518,3,518,[302 143  89 200 216],405,2,1971,3.7976878612716765,0.0,0.0
30519,3,519,[ 64 301 313  11 318],43,5,1976,3.8,60.0,20.0
30520,3,520,[ 64 301 313  11 318],416,5,1981,3.802303262955854,60.0,20.0
30521,3,521,[ 64 301 313  11 318],43,5,1986,3.8045977011494254,60.0,20.0
30522,3,522,[ 64 301 313  11 318],43,5,1991,3.8068833652007648,60.0,20.0
30523,3,523,[234   8  82 183  95],253,4,1995,3.8072519083969465,0.0,0.0
30524,3,524,[568 183 471 202 234],618,3,1998,3.8057142857142856,0.0,0.0
30525,3,525,[496 748 151 118 301],437,3,2001,3.8041825095057034,0.0,0.0
30526,3,526,[ 64 313  11 318 301],43,5,2006,3.806451612903226,60.0,20.0
30527,3,527,[ 64 313  11 318 301],416,5,2011,3.808712121212121,60.0,20.0
30528,3,528,[ 64 313  11 318 301],416,5,2016,3.8109640831758034,60.0,20.0
30529,3,529,[121 127 265 135 228],198,2,2018,3.8075471698113206,0.0,0.0
30530,3,530,[181 121  15 294 288],601,1,2019,3.8022598870056497,0.0,40.0
30531,3,531,[210 197  15 100 191],345,5,2024,3.8045112781954886,0.0,0.0
30532,3,532,[ 64 313  11 318 301],416,5,2029,3.806754221388368,60.0,20.0
30533,3,533,[508  12 237 313  64],345,5,2034,3.808988764044944,60.0,20.0
30534,3,534,[ 64 313  11 318 301],416,5,2039,3.811214953271028,60.0,20.0
30535,3,535,[471 194 125 568  96],373,4,2043,3.8115671641791047,0.0,0.0
30536,3,536,[185  56 174 357  22],805,3,2046,3.810055865921788,0.0,0.0
30537,3,537,[ 64 313  11 318 301],43,5,2051,3.812267657992565,60.0,20.0
30538,3,538,[195 125  70 181 182],416,5,2056,3.8144712430426715,0.0,20.0
30539,3,539,[ 64 313  11 318 301],416,5,2061,3.816666666666667,60.0,20.0
30540,3,540,[ 64 313  11 318 301],345,5,2066,3.8188539741219962,60.0,20.0
30541,3,541,[597 568  11 173 161],314,4,2070,3.819188191881919,0.0,0.0
30542,3,542,[ 25 173 125   7 194],416,5,2075,3.8213627992633517,0.0,0.0
30543,3,543,[ 64 313  11 318 301],416,5,2080,3.823529411764706,60.0,20.0
30544,3,544,[ 64 313  11 318 301],345,5,2085,3.8256880733944953,60.0,20.0
30545,3,545,[174 288 121 275  82],734,5,2090,3.827838827838828,0.0,20.0
30546,3,546,[ 12 118 151 180 132],854,4,2094,3.8281535648994516,20.0,0.0
30547,3,547,[200 191 153 237   1],854,3,2097,3.826642335766423,0.0,0.0
30548,3,548,[ 64 313  11 318 301],43,5,2102,3.8287795992714027,60.0,20.0
30549,3,549,[357 111 238 302 483],62,3,2105,3.827272727272727,20.0,0.0
30550,3,550,[235 423 302 471 215],297,1,2106,3.8221415607985483,0.0,0.0
30551,3,551,[405 191  12   1 588],43,5,2111,3.824275362318841,20.0,0.0
30552,3,552,[  4 678 100 742   9],416,4,2115,3.824593128390597,0.0,0.0
30553,3,553,[ 64 313  11 318 301],345,5,2120,3.8267148014440435,60.0,20.0
30554,3,554,[ 64 313  11 318 301],416,5,2125,3.828828828828829,60.0,20.0
30555,3,555,[ 64 313  11 318 301],43,5,2130,3.8309352517985613,60.0,20.0
30556,3,556,[ 64 313  11 318 301],416,5,2135,3.8330341113105924,60.0,20.0
30557,3,557,[ 64 313  11 318 301],43,5,2140,3.835125448028674,60.0,20.0
30558,3,558,[ 64 313  11 318 301],416,5,2145,3.8372093023255816,60.0,20.0
30559,3,559,[286 294 245 546 100],416,3,2148,3.835714285714286,0.0,0.0
30560,3,560,[176 403 118 427  82],618,4,2152,3.836007130124777,0.0,0.0
30561,3,561,[282   9  97 185 144],416,5,2157,3.8380782918149468,0.0,0.0
30562,3,562,[ 64 313  11 318 301],43,5,2162,3.8401420959147425,60.0,20.0
30563,3,563,[ 64 313  11 318 301],43,5,2167,3.8421985815602837,60.0,20.0
30564,3,564,[211 204 269 328 271],43,4,2171,3.842477876106195,0.0,0.0
30565,3,565,[ 64 313  11 318 301],345,5,2176,3.8445229681978796,60.0,20.0
30566,3,566,[ 64 313  11 318 301],345,5,2181,3.8465608465608465,60.0,20.0
30567,3,567,[174 210 179  95 211],417,3,2184,3.8450704225352115,0.0,0.0
30568,3,568,[180 168 568  64  28],373,3,2187,3.843585237258348,20.0,0.0
30569,3,569,[ 64 313  11 318 301],416,5,2192,3.8456140350877193,60.0,20.0
30570,3,570,[210 313  82   4  12],405,5,2197,3.8476357267950965,40.0,20.0
30571,3,571,[ 64 313  11 318 301],345,5,2202,3.8496503496503496,60.0,20.0
30572,3,572,[318 265 234 237 143],618,5,2207,3.851657940663176,20.0,0.0
30573,3,573,[ 64 313  11 318 301],416,5,2212,3.8536585365853657,60.0,20.0
30574,3,574,[ 28 181 508 385  82],654,3,2215,3.8521739130434782,0.0,20.0
30575,3,575,[ 64 313  11 318 301],416,5,2220,3.8541666666666665,60.0,20.0
30576,3,576,[275 191 153  71 168],416,5,2225,3.856152512998267,0.0,0.0
30577,3,577,[ 64 313  11 318 301],345,5,2230,3.858131487889273,60.0,20.0
30578,3,578,[742 237 568 268 294],128,3,2233,3.856649395509499,0.0,0.0
30579,3,579,[ 64 313  11 318 301],43,5,2238,3.8586206896551722,60.0,20.0
30580,3,580,[ 64 313  11 318 301],345,5,2243,3.8605851979345953,60.0,20.0
30581,3,581,[ 64 313  11 318 301],345,5,2248,3.8625429553264605,60.0,20.0
30582,3,582,[ 64 313  11 318 301],43,5,2253,3.8644939965694682,60.0,20.0
30583,3,583,[435  96  97 174 176],405,1,2254,3.8595890410958904,0.0,0.0
30584,3,584,[ 64 313  11 318 301],43,5,2259,3.8615384615384616,60.0,20.0
30585,3,585,[ 64 313  11 318 301],416,5,2264,3.863481228668942,60.0,20.0
30586,3,586,[ 64 313  11 318 301],43,5,2269,3.86541737649063,60.0,20.0
30587,3,587,[ 64 313  11 318 301],345,5,2274,3.86734693877551,60.0,20.0
30588,3,588,[ 64 313  11 318 301],43,5,2279,3.869269949066214,60.0,20.0
30589,3,589,[ 95 143  82 168 423],416,4,2283,3.869491525423729,0.0,0.0
30590,3,590,[ 95 228  69 168  71],922,2,2285,3.8663282571912014,0.0,0.0
30591,3,591,[222  22 168  98 269],297,5,2290,3.8682432432432434,0.0,20.0
30592,3,592,[100  64 194  70  22],416,5,2295,3.8701517706576727,20.0,0.0
30593,3,593,[ 64 313  11 318 301],416,5,2300,3.872053872053872,60.0,20.0
30594,3,594,[423 268 483 186 135],854,3,2303,3.8705882352941177,20.0,0.0
30595,3,595,[ 64 313  11 318 301],345,5,2308,3.87248322147651,60.0,20.0
30596,3,596,[ 89   1 655 176 127],805,3,2311,3.8710217755443885,0.0,0.0
30597,3,597,[ 64 313  11 318 301],345,5,2316,3.8729096989966556,60.0,20.0
30598,3,598,[117  15 237 748  50],654,4,2320,3.8731218697829717,0.0,20.0
30599,3,599,[111 269 313  82  79],751,3,2323,3.8716666666666666,20.0,20.0
30600,3,600,[ 64  11 318 301 313],43,5,2328,3.8735440931780367,60.0,20.0
30601,3,601,[  1 215 195 427  95],198,3,2331,3.872093023255814,0.0,0.0
30602,3,602,[182 204 237 191  56],618,4,2335,3.872305140961857,0.0,0.0
30603,3,603,[748  11 257 588 144],297,2,2337,3.869205298013245,0.0,0.0
30604,3,604,[ 64  11 318 301 313],345,5,2342,3.871074380165289,60.0,20.0
30605,3,605,[ 64  11 318 301 313],345,5,2347,3.872937293729373,60.0,20.0
30606,3,606,[168  82 427 403   1],642,4,2351,3.8731466227347613,0.0,0.0
30607,3,607,[ 64  11 318 301 313],416,5,2356,3.875,60.0,20.0
30608,3,608,[191 237  98 135 194],854,3,2359,3.8735632183908044,0.0,20.0
30609,3,609,[597  56 257 179 405],416,2,2361,3.8704918032786884,0.0,0.0
30610,3,610,[ 98 427 655 423 100],618,5,2366,3.872340425531915,0.0,20.0
30611,3,611,[237 186 117 176 151],198,3,2369,3.8709150326797386,0.0,0.0
30612,3,612,[ 64  11 318 301 313],43,5,2374,3.872756933115824,60.0,20.0
30613,3,613,[ 64  11 318 301 313],416,5,2379,3.8745928338762217,60.0,20.0
30614,3,614,[186 216  56 257   1],43,4,2383,3.87479674796748,0.0,0.0
30615,3,615,[435 127  22 313 216],405,3,2386,3.8733766233766236,20.0,20.0
30616,3,616,[ 64  11 318 301 313],416,5,2391,3.875202593192869,60.0,20.0
30617,3,617,[ 64  11 318 301 313],43,5,2396,3.8770226537216828,60.0,20.0
30618,3,618,[ 64  11 318 301 313],416,5,2401,3.878836833602585,60.0,20.0
30619,3,619,[ 64  11 318 301 313],43,5,2406,3.8806451612903228,60.0,20.0
30620,3,620,[ 64  11 318 301 313],416,5,2411,3.8824476650563606,60.0,20.0
30621,3,621,[ 64  11 318 301 313],43,5,2416,3.8842443729903535,60.0,20.0
30622,3,622,[202 403 245 496 282],416,4,2420,3.884430176565008,0.0,0.0
30623,3,623,[271 172 275 173  50],907,5,2425,3.886217948717949,0.0,20.0
30624,3,624,[ 64  11 318 301 313],43,5,2430,3.888,60.0,20.0
30625,3,625,[257 196 328 172   9],416,4,2434,3.8881789137380194,0.0,0.0
30626,3,626,[ 64  11 318 301 313],345,5,2439,3.889952153110048,60.0,20.0
30627,3,627,[ 64  11 318 301 313],43,5,2444,3.8917197452229297,60.0,20.0
30628,3,628,[ 64  11 318 301 313],43,5,2449,3.8934817170111287,60.0,20.0
30629,3,629,[ 64  11 318 301 313],345,5,2454,3.895238095238095,60.0,20.0
30630,3,630,[  8  69 173 294 597],43,4,2458,3.89540412044374,0.0,0.0
30631,3,631,[181 427 215 234 245],416,4,2462,3.8955696202531644,0.0,20.0
30632,3,632,[ 64  11 318 301 313],416,5,2467,3.897314375987362,60.0,20.0
30633,3,633,[ 64  11 318 301 313],345,5,2472,3.8990536277602525,60.0,20.0
30634,3,634,[ 64  11 318 301 313],43,5,2477,3.900787401574803,60.0,20.0
30635,3,635,[ 56 427 237 385 143],642,4,2481,3.900943396226415,0.0,0.0
30636,3,636,[151   8 597  79 135],854,4,2485,3.901098901098901,0.0,0.0
30637,3,637,[174  28 204 216 202],751,5,2490,3.90282131661442,0.0,0.0
30638,3,638,[ 64  11 318 301 313],43,5,2495,3.9045383411580596,60.0,20.0
30639,3,639,[ 71 151  50  28 195],654,4,2499,3.9046875,0.0,20.0
30640,3,640,[ 64  11 318 301 313],43,5,2504,3.906396255850234,60.0,20.0
30641,3,641,[ 64  11 318 301 313],43,5,2509,3.9080996884735204,60.0,20.0
30642,3,642,[ 64  11 318 301 313],43,5,2514,3.9097978227060652,60.0,20.0
30643,3,643,[ 64  11 318 301 313],43,5,2519,3.9114906832298137,60.0,20.0
30644,3,644,[ 64  11 318 301 313],43,5,2524,3.9131782945736435,60.0,20.0
30645,3,645,[235  96 508   1 204],62,3,2527,3.911764705882353,0.0,0.0
30646,3,646,[ 64  11 318 301 313],345,5,2532,3.9134466769706338,60.0,20.0
30647,3,647,[ 64  11 318 301 313],416,5,2537,3.9151234567901234,60.0,20.0
30648,3,648,[ 64  11 318 301 313],43,5,2542,3.916795069337442,60.0,20.0
30649,3,649,[313 118  70  22 235],416,3,2545,3.9153846153846152,20.0,20.0
30650,3,650,[ 64  11 318 301 313],345,5,2550,3.9170506912442398,60.0,20.0
30651,3,651,[ 64  11 318 301 313],416,5,2555,3.918711656441718,60.0,20.0
30652,3,652,[ 64  11 318 301 313],345,5,2560,3.9203675344563553,60.0,20.0
30653,3,653,[127 294 117 238 143],416,5,2565,3.9220183486238533,0.0,0.0
30654,3,654,[  1 568 655 181 234],262,1,2566,3.9175572519083968,0.0,20.0
30655,3,655,[181 215 546  25 182],416,4,2570,3.917682926829268,0.0,20.0
30656,3,656,[ 64  11 318 301 313],43,5,2575,3.919330289193303,60.0,20.0
30657,3,657,[588  28  11 172 181],416,5,2580,3.9209726443768997,0.0,20.0
30658,3,658,[ 71  12 183 215  89],62,4,2584,3.921092564491654,20.0,0.0
30659,3,659,[ 64  11 318 301 313],43,5,2589,3.922727272727273,60.0,20.0
30660,3,660,[ 64  11 318 301 313],345,5,2594,3.924357034795764,60.0,20.0
30661,3,661,[ 64  11 318 301 313],416,5,2599,3.9259818731117826,60.0,20.0
30662,3,662,[ 64  11 318 301 313],416,5,2604,3.927601809954751,60.0,20.0
30663,3,663,[181 173 135 215 143],437,4,2608,3.927710843373494,0.0,20.0
30664,3,664,[ 64  11 318 301 313],43,5,2613,3.9293233082706767,60.0,20.0
30665,3,665,[ 64  11 318 301 313],345,5,2618,3.930930930930931,60.0,20.0
30666,3,666,[ 64  11 318 301 313],345,5,2623,3.9325337331334334,60.0,20.0
30667,3,667,[210  22 151  98 403],618,3,2626,3.931137724550898,0.0,20.0
30668,3,668,[ 64  11 318 301 313],43,5,2631,3.9327354260089686,60.0,20.0
30669,3,669,[ 64  11 318 301 313],345,5,2636,3.934328358208955,60.0,20.0
30670,3,670,[ 64  11 318 301 313],416,5,2641,3.9359165424739193,60.0,20.0
30671,3,671,[302 333 496 191   1],416,5,2646,3.9375,0.0,0.0
30672,3,672,[ 64  11 318 301 313],345,5,2651,3.9390787518573553,60.0,20.0
30673,3,673,[ 64  11 318 301 313],416,5,2656,3.940652818991098,60.0,20.0
30674,3,674,[ 64  11 318 301 313],43,5,2661,3.942222222222222,60.0,20.0
30675,3,675,[ 64  11 318 301 313],416,5,2666,3.9437869822485205,60.0,20.0
30676,3,676,[ 64  11 318 301 313],416,5,2671,3.945347119645495,60.0,20.0
30677,3,677,[187  97 328 210  69],373,3,2674,3.943952802359882,0.0,0.0
30678,3,678,[ 64  11 318 301 313],43,5,2679,3.9455081001472756,60.0,20.0
30679,3,679,[ 64  11 318 301 313],416,5,2684,3.947058823529412,60.0,20.0
30680,3,680,[237 135   9 483 132],618,4,2688,3.947136563876652,20.0,0.0
30681,3,681,[174 496 238  11   1],230,4,2692,3.9472140762463344,0.0,0.0
30682,3,682,[118 471 318 161 181],345,2,2694,3.944363103953148,20.0,20.0
30683,3,683,[ 64  11 318 301 313],345,5,2699,3.945906432748538,60.0,20.0
30684,3,684,[ 64  11 318 301 313],416,5,2704,3.9474452554744524,60.0,20.0
30685,3,685,[385  97  25  71 127],43,5,2709,3.9489795918367347,0.0,0.0
30686,3,686,[ 64  11 318 301 313],43,5,2714,3.950509461426492,60.0,20.0
30687,3,687,[357   1  15 117 173],642,4,2718,3.9505813953488373,0.0,0.0
30688,3,688,[ 64  11 318 301 313],345,5,2723,3.9521044992743106,60.0,20.0
30689,3,689,[ 69 313 174 200 333],345,4,2727,3.9521739130434783,20.0,20.0
30690,3,690,[ 64  11 318 301 313],43,5,2732,3.9536903039073805,60.0,20.0
30691,3,691,[300  95 182 216 258],416,4,2736,3.953757225433526,0.0,0.0
30692,3,692,[ 25 202 132 191 151],764,3,2739,3.9523809523809526,0.0,0.0
30693,3,693,[ 64  11 318 301 313],416,5,2744,3.9538904899135447,60.0,20.0
30694,3,694,[276  28 111 597 323],416,2,2746,3.9510791366906477,0.0,0.0
30695,3,695,[423 125  12 357 258],416,5,2751,3.9525862068965516,20.0,0.0
30696,3,696,[ 64  11 318 301 313],43,5,2756,3.9540889526542324,60.0,20.0
30697,3,697,[ 64  11 318 301 313],43,5,2761,3.9555873925501435,60.0,20.0
30698,3,698,[ 64  11 318 301 313],43,5,2766,3.9570815450643777,60.0,20.0
30699,3,699,[ 82 161 238 185 216],805,2,2768,3.954285714285714,0.0,0.0
30700,3,700,[288 655 328 121 222],62,2,2770,3.951497860199715,0.0,20.0
30701,3,701,[ 64  11 318 301 313],345,5,2775,3.952991452991453,60.0,20.0
30702,3,702,[ 64  11 318 301 313],345,5,2780,3.9544807965860596,60.0,20.0
30703,3,703,[ 64  11 318 301 313],345,5,2785,3.955965909090909,60.0,20.0
30704,3,704,[ 64  11 318 301 313],345,5,2790,3.9574468085106385,60.0,20.0
30705,3,705,[234 385 185  70  97],417,4,2794,3.9575070821529743,0.0,0.0
30706,3,706,[435  95 143  71  88],373,4,2798,3.9575671852899577,0.0,0.0
30707,3,707,[ 64  11 318 301 313],345,5,2803,3.959039548022599,60.0,20.0
30708,3,708,[742 496 268 144 597],654,4,2807,3.9590973201692523,0.0,0.0
30709,3,709,[ 64  11 318 301 313],43,5,2812,3.96056338028169,60.0,20.0
30710,3,710,[ 64  11 318 301 313],43,5,2817,3.962025316455696,60.0,20.0
30711,3,711,[ 64  11 318 301 313],345,5,2822,3.9634831460674156,60.0,20.0
30712,3,712,[288 210 174 144 322],416,4,2826,3.9635343618513326,0.0,20.0
30713,3,713,[ 64  11 318 301 313],416,5,2831,3.9649859943977592,60.0,20.0
30714,3,714,[ 64  11 318 301 313],345,5,2836,3.9664335664335666,60.0,20.0
30715,3,715,[121 515 333  64 546],416,4,2840,3.9664804469273744,20.0,0.0
30716,3,716,[405 176 403  15 195],416,5,2845,3.96792189679219,0.0,0.0
30717,3,717,[ 64  11 318 301 313],43,5,2850,3.969359331476323,60.0,20.0
30718,3,718,[ 64  11 318 301 313],416,5,2855,3.9707927677329624,60.0,20.0
30719,3,719,[ 64  11 318 301 313],416,5,2860,3.9722222222222223,60.0,20.0
30720,3,720,[ 64  11 318 301 313],43,5,2865,3.973647711511789,60.0,20.0
30721,3,721,[ 64  11 318 301 313],43,5,2870,3.9750692520775623,60.0,20.0
30722,3,722,[ 64  11 318 301 313],43,5,2875,3.9764868603042878,60.0,20.0
30723,3,723,[ 64  11 318 301 313],345,5,2880,3.977900552486188,60.0,20.0
30724,3,724,[ 64  11 318 301 313],345,5,2885,3.9793103448275864,60.0,20.0
30725,3,725,[ 64  11 318 301 313],416,5,2890,3.9807162534435263,60.0,20.0
30726,3,726,[ 64  11 318 301 313],43,5,2895,3.9821182943603852,60.0,20.0
30727,3,727,[ 64  11 318 301 313],416,5,2900,3.9835164835164836,60.0,20.0
30728,3,728,[100 333 423 588 210],588,3,2903,3.982167352537723,0.0,0.0
30729,3,729,[125 282 216 237 328],253,4,2907,3.9821917808219176,0.0,0.0
30730,3,730,[ 64  11 318 301 313],43,5,2912,3.9835841313269493,60.0,20.0
30731,3,731,[168  50 194 182 403],405,2,2914,3.980874316939891,0.0,20.0
30732,3,732,[ 64  11 318 301 313],345,5,2919,3.9822646657571625,60.0,20.0
30733,3,733,[ 98 168 475 471 127],416,4,2923,3.982288828337875,0.0,20.0
30734,3,734,[ 64  11 318 301 313],345,5,2928,3.983673469387755,60.0,20.0
30735,3,735,[ 64  11 318 301 313],416,5,2933,3.985054347826087,60.0,20.0
30736,3,736,[168  50 187 546  95],416,3,2936,3.983717774762551,0.0,20.0
30737,3,737,[ 64  11 318 301 313],345,5,2941,3.9850948509485096,60.0,20.0
30738,3,738,[ 64  11 318 301 313],43,5,2946,3.986468200270636,60.0,20.0
30739,3,739,[195 200 385 111 475],417,4,2950,3.9864864864864864,0.0,0.0
30740,3,740,[ 64  11 318 301 313],345,5,2955,3.9878542510121457,60.0,20.0
30741,3,741,[508 200 181 546 258],417,2,2957,3.9851752021563343,0.0,20.0
30742,3,742,[ 69  82 405 132 496],128,4,2961,3.9851951547779274,0.0,0.0
30743,3,743,[ 64  11 318 301 313],416,5,2966,3.986559139784946,60.0,20.0
30744,3,744,[328 282 742 294 496],128,2,2968,3.9838926174496643,0.0,0.0
30745,3,745,[ 64  11 318 301 313],345,5,2973,3.985254691689008,60.0,20.0
30746,3,746,[ 64  11 318 301 313],416,5,2978,3.9866131191432395,60.0,20.0
30747,3,747,[  4 275 427 265  88],416,4,2982,3.986631016042781,0.0,0.0
30748,3,748,[ 64  11 318 301 313],43,5,2987,3.987983978638184,60.0,20.0
30749,3,749,[ 64  11 318 301 313],345,5,2992,3.989333333333333,60.0,20.0
30750,3,750,[ 64  11 318 301 313],345,5,2997,3.9906790945406123,60.0,20.0
30751,3,751,[ 64  11 318 301 313],345,5,3002,3.992021276595745,60.0,20.0
30752,3,752,[ 64  11 318 301 313],43,5,3007,3.9933598937583,60.0,20.0
30753,3,753,[ 64  11 318 301 313],345,5,3012,3.9946949602122017,60.0,20.0
30754,3,754,[ 56 183 195 118 187],416,4,3016,3.9947019867549667,0.0,0.0
30755,3,755,[174 588 568 151 318],43,5,3021,3.996031746031746,20.0,0.0
30756,3,756,[546 423 257 597  28],416,2,3023,3.9933949801849407,0.0,0.0
30757,3,757,[ 64  11 318 301 313],416,5,3028,3.994722955145119,60.0,20.0
30758,3,758,[ 70 179 603  98   7],751,4,3032,3.994729907773386,0.0,20.0
30759,3,759,[ 64  11 318 301 313],43,5,3037,3.9960526315789475,60.0,20.0
30760,3,760,[405 204 216  96 257],62,2,3039,3.9934296977660972,0.0,0.0
30761,3,761,[300 245   8  82 181],416,4,3043,3.993438320209974,0.0,20.0
30762,3,762,[ 64  11 318 301 313],43,5,3048,3.9947575360419396,60.0,20.0
30763,3,763,[ 64  11 318 301 313],416,5,3053,3.9960732984293195,60.0,20.0
30764,3,764,[ 64  11 318 301 313],345,5,3058,3.9973856209150327,60.0,20.0
30765,3,765,[ 64  11 318 301 313],345,5,3063,3.9986945169712795,60.0,20.0
30766,3,766,[328   1 286 742 294],416,5,3068,4.0,0.0,0.0
30767,3,767,[ 64  11 318 301 313],416,5,3073,4.001302083333333,60.0,20.0
30768,3,768,[ 64  11 318 301 313],43,5,3078,4.00260078023407,60.0,20.0
30769,3,769,[172 161 275  88 111],437,2,3080,4.0,0.0,0.0
30770,3,770,[210 185 180 748 176],198,2,3082,3.9974059662775616,0.0,0.0
30771,3,771,[423 127 185 318 153],198,3,3085,3.9961139896373057,20.0,0.0
30772,3,772,[ 28 228 282 301 204],721,5,3090,3.997412677878396,0.0,0.0
30773,3,773,[ 64  11 318 301 313],43,5,3095,3.998708010335917,60.0,20.0
30774,3,774,[ 64  11 318 301 313],345,5,3100,4.0,60.0,20.0
30775,3,775,[135 405  22 180 546],62,4,3104,4.0,0.0,0.0
30776,3,776,[ 64  11 318 301 313],43,5,3109,4.001287001287001,60.0,20.0
30777,3,777,[ 64  11 318 301 313],43,5,3114,4.002570694087404,60.0,20.0
30778,3,778,[ 64  11 318 301 313],345,5,3119,4.00385109114249,60.0,20.0
30779,3,779,[ 64  11 318 301 313],43,5,3124,4.005128205128205,60.0,20.0
30780,3,780,[ 50 215 179 403 276],198,4,3128,4.0051216389244555,0.0,20.0
30781,3,781,[ 64  11 318 301 313],416,5,3133,4.006393861892583,60.0,20.0
30782,3,782,[323 268 132 385 748],345,2,3135,4.003831417624521,0.0,0.0
30783,3,783,[ 64  11 318 301 313],416,5,3140,4.005102040816326,60.0,20.0
30784,3,784,[423 258  71  97  95],711,3,3143,4.003821656050955,0.0,0.0
30785,3,785,[ 64  11 318 301 313],345,5,3148,4.005089058524173,60.0,20.0
30786,3,786,[ 64  11 318 301 313],345,5,3153,4.006353240152478,60.0,20.0
30787,3,787,[471 196 174  15 245],921,3,3156,4.00507614213198,0.0,0.0
30788,3,788,[ 64  11 318 301 313],416,5,3161,4.006337135614702,60.0,20.0
30789,3,789,[ 64  11 318 301 313],43,5,3166,4.007594936708861,60.0,20.0
30790,3,790,[385  50  56 286 258],416,5,3171,4.008849557522124,0.0,20.0
30791,3,791,[322 678  64 546  97],416,2,3173,4.0063131313131315,20.0,0.0
30792,3,792,[ 64  11 318 301 313],345,5,3178,4.0075662042875155,60.0,20.0
30793,3,793,[ 15 195  70 323  71],198,0,3178,4.002518891687657,0.0,0.0
30794,3,794,[ 64  11 318 301 313],345,5,3183,4.003773584905661,60.0,20.0
30795,3,795,[ 64  11 318 301 313],43,5,3188,4.005025125628141,60.0,20.0
30796,3,796,[ 64  11 318 301 313],43,5,3193,4.006273525721456,60.0,20.0
30797,3,797,[111  12 181 211   4],297,3,3196,4.005012531328321,20.0,20.0
30798,3,798,[ 64  11 318 301 313],43,5,3201,4.006257822277847,60.0,20.0
30799,3,799,[423 173 210 286 196],417,4,3205,4.00625,0.0,0.0
30800,3,800,[ 88 294 143 228 258],128,3,3208,4.004993757802747,0.0,0.0
30801,3,801,[215 265 151  71  15],128,3,3211,4.003740648379052,0.0,0.0
30802,3,802,[288 385 204  71 265],416,5,3216,4.004981320049813,0.0,20.0
30803,3,803,[ 96 200 172 603 288],805,4,3220,4.0049751243781095,0.0,20.0
30804,3,804,[ 64  11 318 301 313],345,5,3225,4.0062111801242235,60.0,20.0
30805,3,805,[ 64  11 318 301 313],345,5,3230,4.007444168734492,60.0,20.0
30806,3,806,[200 588 483 135  88],437,3,3233,4.006195786864932,20.0,0.0
30807,3,807,[185 172  11 121 181],417,1,3234,4.002475247524752,0.0,20.0
30808,3,808,[286 210 172   4 568],417,1,3235,3.9987639060568605,0.0,0.0
30809,3,809,[202 288 435 258  98],297,2,3237,3.9962962962962965,0.0,40.0
30810,3,810,[  8 333 151 588 597],416,3,3240,3.995067817509248,0.0,0.0
30811,3,811,[ 64  11 318 301 313],345,5,3245,3.9963054187192117,60.0,20.0
30812,3,812,[ 64  11 318 301 313],345,5,3250,3.997539975399754,60.0,20.0
30813,3,813,[ 64  11 318 301 313],43,5,3255,3.998771498771499,60.0,20.0
30814,3,814,[ 64  11 318 301 313],345,5,3260,4.0,60.0,20.0
30815,3,815,[196 294  97 179   8],62,3,3263,3.9987745098039214,0.0,0.0
30816,3,816,[603   1 403 200 405],416,5,3268,4.0,0.0,0.0
30817,3,817,[ 64  11 318 301 313],416,5,3273,4.00122249388753,60.0,20.0
30818,3,818,[ 64  11 318 301 313],416,5,3278,4.002442002442002,60.0,20.0
30819,3,819,[ 64  11 318 301 313],43,5,3283,4.003658536585366,60.0,20.0
30820,3,820,[ 64  11 318 301 313],43,5,3288,4.004872107186358,60.0,20.0
30821,3,821,[181 100 483 144  71],907,5,3293,4.0060827250608275,20.0,20.0
30822,3,822,[588 215  71 568 405],345,3,3296,4.004860267314703,0.0,0.0
30823,3,823,[ 64  11 318 301 313],43,5,3301,4.006067961165049,60.0,20.0
30824,3,824,[ 64  11 318 301 313],43,5,3306,4.007272727272727,60.0,20.0
30825,3,825,[ 64  11 318 301 313],416,5,3311,4.008474576271187,60.0,20.0
30826,3,826,[ 64  11 318 301 313],43,5,3316,4.009673518742442,60.0,20.0
30827,3,827,[ 64  11 318 301 313],43,5,3321,4.010869565217392,60.0,20.0
30828,3,828,[403 175 180 172 132],198,3,3324,4.009650180940892,0.0,0.0
30829,3,829,[276 200  11 603 153],437,4,3328,4.009638554216868,0.0,0.0
30830,3,830,[  4   9 471 496 588],416,5,3333,4.0108303249097474,0.0,0.0
30831,3,831,[ 64 318 301 313  11],345,5,3338,4.012019230769231,60.0,20.0
30832,3,832,[313 288  56 301 300],416,5,3343,4.013205282112845,20.0,40.0
30833,3,833,[ 64 318 301 313  11],345,5,3348,4.014388489208633,60.0,20.0
30834,3,834,[ 64 318 301 313  11],43,5,3353,4.015568862275449,60.0,20.0
30835,3,835,[ 64 318 301 313  11],43,5,3358,4.016746411483253,60.0,20.0
30836,3,836,[ 64 318 301 313  11],43,5,3363,4.017921146953405,60.0,20.0
30837,3,837,[ 64 318 301 313  11],416,5,3368,4.01909307875895,60.0,20.0
30838,3,838,[ 64 318 301 313  11],43,5,3373,4.020262216924911,60.0,20.0
30839,3,839,[ 64 318 301 313  11],345,5,3378,4.021428571428571,60.0,20.0
30840,3,840,[ 64 318 301 313  11],416,5,3383,4.0225921521997625,60.0,20.0
30841,3,841,[275  70 496  50 132],128,3,3386,4.021377672209026,0.0,20.0
30842,3,842,[ 64 318 301 313  11],43,5,3391,4.022538552787663,60.0,20.0
30843,3,843,[ 64 318 301 313  11],416,5,3396,4.023696682464455,60.0,20.0
30844,3,844,[111 333 121 678  71],588,3,3399,4.022485207100591,0.0,0.0
30845,3,845,[ 64 318 301 313  11],416,5,3404,4.0236406619385345,60.0,20.0
30846,3,846,[294 186 117 210 588],642,5,3409,4.024793388429752,0.0,0.0
30847,3,847,[ 64 318 301 313  11],416,5,3414,4.025943396226415,60.0,20.0
30848,3,848,[ 64 318 301 313  11],43,5,3419,4.027090694935218,60.0,20.0
30849,3,849,[301  28 678 294 568],588,4,3423,4.027058823529412,0.0,0.0
30850,3,850,[496  96 748 172 258],417,2,3425,4.024676850763807,0.0,0.0
30851,3,851,[ 64 318 301 313  11],43,5,3430,4.025821596244131,60.0,20.0
30852,3,852,[ 64 318 301 313  11],43,5,3435,4.026963657678781,60.0,20.0
30853,3,853,[ 64 318 301 313  11],43,5,3440,4.028103044496487,60.0,20.0
30854,3,854,[ 64 318 301 313  11],416,5,3445,4.029239766081871,60.0,20.0
30855,3,855,[111 121 258 210 118],654,4,3449,4.029205607476635,0.0,0.0
30856,3,856,[ 64 318 301 313  11],416,5,3454,4.030338389731622,60.0,20.0
30857,3,857,[117  15 333 111 197],416,5,3459,4.031468531468532,0.0,0.0
30858,3,858,[ 64 318 301 313  11],43,5,3464,4.032596041909197,60.0,20.0
30859,3,859,[ 64 318 301 313  11],345,5,3469,4.033720930232558,60.0,20.0
30860,3,860,[ 88 323 111 238   4],416,3,3472,4.032520325203252,0.0,0.0
30861,3,861,[ 64 318 301 313  11],345,5,3477,4.033642691415313,60.0,20.0
30862,3,862,[ 15 385   9 269 301],416,5,3482,4.034762456546929,0.0,0.0
30863,3,863,[175 168 234   4 185],805,4,3486,4.034722222222222,0.0,0.0
30864,3,864,[183 313 191 200  56],405,3,3489,4.033526011560694,20.0,20.0
30865,3,865,[ 64 318 301 313  11],416,5,3494,4.034642032332563,60.0,20.0
30866,3,866,[ 64 318 301 313  11],345,5,3499,4.035755478662053,60.0,20.0
30867,3,867,[ 64 318 301 313  11],416,5,3504,4.0368663594470044,60.0,20.0
30868,3,868,[ 64 318 301 313  11],345,5,3509,4.037974683544304,60.0,20.0
30869,3,869,[603 323 405 111 289],416,3,3512,4.036781609195402,0.0,0.0
30870,3,870,[423 180  70 179 288],437,3,3515,4.035591274397245,0.0,20.0
30871,3,871,[ 96 546 273 742  28],805,1,3516,4.032110091743119,0.0,0.0
30872,3,872,[ 12 202 228   4 197],373,3,3519,4.030927835051546,20.0,0.0
30873,3,873,[ 64 318 301 313  11],43,5,3524,4.032036613272311,60.0,20.0
30874,3,874,[508 275 216 301 143],297,5,3529,4.033142857142857,0.0,0.0
30875,3,875,[127 204 597 200   1],805,2,3531,4.030821917808219,0.0,0.0
30876,3,876,[118 333 515 328  25],416,4,3535,4.03078677309008,0.0,0.0
30877,3,877,[300 174 168 313 301],751,3,3538,4.029612756264237,20.0,20.0
30878,3,878,[ 64 318 301  11 313],43,5,3543,4.030716723549488,60.0,20.0
30879,3,879,[ 64 318 301  11 313],43,5,3548,4.031818181818182,60.0,20.0
30880,3,880,[515 273  70 168 144],417,3,3551,4.030646992054484,0.0,0.0
30881,3,881,[ 64 318 301  11 313],345,5,3556,4.031746031746032,60.0,20.0
30882,3,882,[ 64 318 301  11 313],345,5,3561,4.032842582106455,60.0,20.0
30883,3,883,[ 79 118 196  12 268],345,4,3565,4.032805429864253,20.0,0.0
30884,3,884,[  7 168 235  97   4],297,3,3568,4.031638418079096,0.0,0.0
30885,3,885,[ 64 318 301  11 313],416,5,3573,4.032731376975169,60.0,20.0
30886,3,886,[268  71 301 181 357],416,5,3578,4.0338218714768885,0.0,20.0
30887,3,887,[ 64 318 301  11 313],345,5,3583,4.03490990990991,60.0,20.0
30888,3,888,[ 64 318 301  11 313],43,5,3588,4.0359955005624295,60.0,20.0
30889,3,889,[ 25 222   8 269  22],297,5,3593,4.037078651685393,0.0,0.0
30890,3,890,[ 64 318 301  11 313],345,5,3598,4.038159371492704,60.0,20.0
30891,3,891,[ 64 318 301  11 313],345,5,3603,4.039237668161435,60.0,20.0
30892,3,892,[508 118 176  70 322],417,3,3606,4.038073908174692,0.0,0.0
30893,3,893,[ 64 318 301  11 313],416,5,3611,4.039149888143177,60.0,20.0
30894,3,894,[187  28 202 483  98],618,4,3615,4.039106145251397,20.0,20.0
30895,3,895,[ 64 318 301  11 313],345,5,3620,4.040178571428571,60.0,20.0
30896,3,896,[ 64 318 301  11 313],43,5,3625,4.041248606465998,60.0,20.0
30897,3,897,[423 238  79 181 471],43,3,3628,4.040089086859688,0.0,20.0
30898,3,898,[ 64 318 301  11 313],345,5,3633,4.041156840934372,60.0,20.0
30899,3,899,[ 88 655 405   9 182],416,4,3637,4.041111111111111,0.0,0.0
30900,3,900,[ 64 318 301  11 313],345,5,3642,4.0421753607103215,60.0,20.0
30901,3,901,[100  70 172 202 483],437,4,3646,4.042128603104213,20.0,0.0
30902,3,902,[118 202 143 117 268],297,3,3649,4.040974529346622,0.0,0.0
30903,3,903,[ 64 318 301  11 313],43,5,3654,4.042035398230088,60.0,20.0
30904,3,904,[ 64 318 301  11 313],416,5,3659,4.043093922651933,60.0,20.0
30905,3,905,[174 275 678  70 216],297,4,3663,4.043046357615894,0.0,0.0
30906,3,906,[ 64 318 301  11 313],416,5,3668,4.044101433296582,60.0,20.0
30907,3,907,[357 323 172 237 153],416,3,3671,4.04295154185022,0.0,0.0
30908,3,908,[ 64 318 301  11 313],43,5,3676,4.044004400440044,60.0,20.0
30909,3,909,[235 258  15 471 282],854,1,3677,4.0406593406593405,0.0,0.0
30910,3,910,[204 276 294  96 151],601,1,3678,4.0373216245883645,0.0,0.0
30911,3,911,[ 64 318 301  11 313],345,5,3683,4.038377192982456,60.0,20.0
30912,3,912,[  4 568  98  25 132],416,5,3688,4.039430449069004,0.0,20.0
30913,3,913,[ 64 318 301  11 313],345,5,3693,4.040481400437637,60.0,20.0
30914,3,914,[265 483 182 588   4],618,4,3697,4.0404371584699454,20.0,0.0
30915,3,915,[423 282 132   9 118],416,4,3701,4.040393013100437,0.0,0.0
30916,3,916,[ 69  56 222 228  98],601,2,3703,4.038167938931298,0.0,20.0
30917,3,917,[ 64 318 301  11 313],345,5,3708,4.03921568627451,60.0,20.0
30918,3,918,[ 64 318 301  11 313],43,5,3713,4.040261153427639,60.0,20.0
30919,3,919,[ 64 318 301  11 313],416,5,3718,4.041304347826087,60.0,20.0
30920,3,920,[ 22 118 588 176 275],764,4,3722,4.041259500542888,0.0,0.0
30921,3,921,[ 64 318 301  11 313],43,5,3727,4.042299349240781,60.0,20.0
30922,3,922,[ 64 318 301  11 313],345,5,3732,4.043336944745396,60.0,20.0
30923,3,923,[234   4  98 121  82],417,3,3735,4.042207792207792,0.0,20.0
30924,3,924,[ 64 318 301  11 313],416,5,3740,4.043243243243243,60.0,20.0
30925,3,925,[ 64 318 301  11 313],416,5,3745,4.044276457883369,60.0,20.0
30926,3,926,[603 655 153 168 568],416,5,3750,4.0453074433656955,0.0,0.0
30927,3,927,[ 64 318 301  11 313],43,5,3755,4.046336206896552,60.0,20.0
30928,3,928,[ 64 318 301  11 313],416,5,3760,4.047362755651238,60.0,20.0
30929,3,929,[235  11 237 183 210],416,3,3763,4.046236559139785,0.0,0.0
30930,3,930,[ 64 318 301  11 313],416,5,3768,4.047261009667024,60.0,20.0
30931,3,931,[ 64 318 301  11 313],345,5,3773,4.048283261802575,60.0,20.0
30932,3,932,[ 95 235 269 191 173],805,3,3776,4.047159699892819,0.0,0.0
30933,3,933,[ 64 318 301  11 313],416,5,3781,4.048179871520342,60.0,20.0
30934,3,934,[195 118 742 294  70],416,4,3785,4.048128342245989,0.0,0.0
30935,3,935,[ 64 318 301  11 313],43,5,3790,4.049145299145299,60.0,20.0
30936,3,936,[258 302 202 151 176],417,4,3794,4.049092849519744,0.0,0.0
30937,3,937,[ 64 318 301  11 313],345,5,3799,4.050106609808102,60.0,20.0
30938,3,938,[483 196 127 258 238],417,5,3804,4.05111821086262,20.0,0.0
30939,3,939,[ 64 318 301  11 313],345,5,3809,4.052127659574468,60.0,20.0
30940,3,940,[ 64 318 301  11 313],43,5,3814,4.053134962805526,60.0,20.0
30941,3,941,[210  25   1 100 655],345,3,3817,4.052016985138004,0.0,0.0
30942,3,942,[ 64 318 301  11 313],416,5,3822,4.053022269353129,60.0,20.0
30943,3,943,[588 180  64  56 100],417,3,3825,4.051906779661017,20.0,0.0
30944,3,944,[258 597 125 181 196],417,3,3828,4.050793650793651,0.0,20.0
30945,3,945,[216  79 153  97 588],253,4,3832,4.050739957716702,0.0,0.0
30946,3,946,[ 64 318 301  11 313],416,5,3837,4.0517423442449845,60.0,20.0
30947,3,947,[ 64 318 301  11 313],416,5,3842,4.052742616033755,60.0,20.0
30948,3,948,[ 64 318 301  11 313],345,5,3847,4.053740779768177,60.0,20.0
30949,3,949,[ 64 318 301  11 313],416,5,3852,4.054736842105263,60.0,20.0
30950,3,950,[ 64 318 301  11 313],43,5,3857,4.055730809674027,60.0,20.0
30951,3,951,[ 56 385  79 286 403],416,5,3862,4.05672268907563,0.0,0.0
30952,3,952,[ 64 318 301  11 313],345,5,3867,4.057712486883526,60.0,20.0
30953,3,953,[ 15  89 174  69 151],198,4,3871,4.0576519916142555,0.0,0.0
30954,3,954,[ 64 318 301  11 313],416,5,3876,4.058638743455497,60.0,20.0
30955,3,955,[ 64 318 301  11 313],345,5,3881,4.059623430962343,60.0,20.0
30956,3,956,[ 64 318 301  11 313],345,5,3886,4.0606060606060606,60.0,20.0
30957,3,957,[ 64 318 301  11 313],43,5,3891,4.061586638830898,60.0,20.0
30958,3,958,[ 64 318 301  11 313],345,5,3896,4.0625651720542235,60.0,20.0
30959,3,959,[144   9 275 118  95],43,5,3901,4.063541666666667,0.0,0.0
30960,3,960,[ 64 318 301  11 313],416,5,3906,4.064516129032258,60.0,20.0
30961,3,961,[ 15  71  89 151 210],437,2,3908,4.0623700623700625,0.0,0.0
30962,3,962,[  1 127 121 405 471],887,3,3911,4.061266874350986,0.0,0.0
30963,3,963,[172 475 235 222 508],62,5,3916,4.062240663900415,0.0,0.0
30964,3,964,[ 64 318 301  11 313],345,5,3921,4.063212435233161,60.0,20.0
30965,3,965,[475 234 204 423 176],437,3,3924,4.062111801242236,0.0,0.0
30966,3,966,[ 64 318 301  11 313],416,5,3929,4.063081695966908,60.0,20.0
30967,3,967,[ 64 318 301  11 313],416,5,3934,4.06404958677686,60.0,20.0
30968,3,968,[ 64 318 301  11 313],345,5,3939,4.065015479876161,60.0,20.0
30969,3,969,[ 12 257  69 151 357],297,2,3941,4.062886597938144,20.0,0.0
30970,3,970,[ 64 318 301  11 313],43,5,3946,4.063851699279094,60.0,20.0
30971,3,971,[215 655 100 168 179],198,4,3950,4.063786008230453,0.0,0.0
30972,3,972,[ 64 318 301  11 313],43,5,3955,4.0647482014388485,60.0,20.0
30973,3,973,[ 64 318 301  11 313],416,5,3960,4.0657084188911705,60.0,20.0
30974,3,974,[ 64 318 301  11 313],43,5,3965,4.066666666666666,60.0,20.0
30975,3,975,[ 64 318 301  11 313],345,5,3970,4.067622950819672,60.0,20.0
30976,3,976,[211 294 182 235 210],297,2,3972,4.0655066530194475,0.0,0.0
30977,3,977,[100 275  96  82 496],416,5,3977,4.066462167689162,0.0,0.0
30978,3,978,[ 64 318 301  11 313],43,5,3982,4.067415730337078,60.0,20.0
30979,3,979,[ 64 318 301  11 313],345,5,3987,4.068367346938776,60.0,20.0
30980,3,980,[ 64 318 301  11 313],43,5,3992,4.069317023445464,60.0,20.0
30981,3,981,[196  28 655 215  82],128,3,3995,4.0682281059063135,0.0,0.0
30982,3,982,[144 153  89  71  88],373,4,3999,4.068158697863683,0.0,0.0
30983,3,983,[ 64 318 301  11 313],43,5,4004,4.069105691056911,60.0,20.0
30984,3,984,[153 195  64  69 197],373,4,4008,4.069035532994924,20.0,0.0
30985,3,985,[ 64 318 301  11 313],43,5,4013,4.069979716024341,60.0,20.0
30986,3,986,[ 64 318 301  11 313],345,5,4018,4.070921985815603,60.0,20.0
30987,3,987,[ 64 318 301  11 313],345,5,4023,4.071862348178137,60.0,20.0
30988,3,988,[ 64 318 301  11 313],416,5,4028,4.072800808897877,60.0,20.0
30989,3,989,[ 64 318 301  11 313],345,5,4033,4.073737373737374,60.0,20.0
30990,3,990,[ 64 318 301  11 313],345,5,4038,4.074672048435923,60.0,20.0
30991,3,991,[ 12   9 182 181 385],618,4,4042,4.074596774193548,20.0,20.0
30992,3,992,[ 64 318 301  11 313],43,5,4047,4.075528700906345,60.0,20.0
30993,3,993,[ 64 318 301  11 313],43,5,4052,4.076458752515091,60.0,20.0
30994,3,994,[161 191 403 405 228],705,3,4055,4.075376884422111,0.0,0.0
30995,3,995,[ 64 318 301  11 313],416,5,4060,4.076305220883534,60.0,20.0
30996,3,996,[210 271 211 181  88],43,4,4064,4.076228686058174,0.0,20.0
30997,3,997,[ 64 318 301  11 313],43,5,4069,4.077154308617234,60.0,20.0
30998,3,998,[ 64 318 301  11 313],43,5,4074,4.078078078078078,60.0,20.0
30999,3,999,[ 69 228  79 132 748],373,4,4078,4.078,0.0,0.0
31000,3,1000,[ 64 318 301  11 313],43,5,4083,4.078921078921079,60.0,20.0
31001,3,1001,[ 64 318 301  11 313],43,5,4088,4.079840319361278,60.0,20.0
31002,3,1002,[211 151 174 210  25],373,5,4093,4.080757726819542,0.0,0.0
31003,3,1003,[ 64 318 301  11 313],345,5,4098,4.081673306772909,60.0,20.0
31004,3,1004,[ 69  70 568  64 300],43,5,4103,4.082587064676617,20.0,0.0
31005,3,1005,[125 271 215 216 127],62,3,4106,4.081510934393638,0.0,0.0
31006,3,1006,[ 28  11 185 172 197],618,4,4110,4.0814299900695135,0.0,0.0
31007,3,1007,[ 64 318 301  11 313],43,5,4115,4.08234126984127,60.0,20.0
31008,3,1008,[173 143 222 275 288],297,4,4119,4.082259663032706,0.0,20.0
31009,3,1009,[ 64 318 301  11 313],43,5,4124,4.083168316831683,60.0,20.0
31010,3,1010,[405  79 288   7 185],416,5,4129,4.084075173095945,0.0,20.0
31011,3,1011,[427 678  88 118 268],416,2,4131,4.08201581027668,0.0,0.0
31012,3,1012,[173 191 742 271   1],62,2,4133,4.0799605133267525,0.0,0.0
31013,3,1013,[ 64 318 301  11 313],345,5,4138,4.0808678500986195,60.0,20.0
31014,3,1014,[ 64 318 301  11 313],43,5,4143,4.081773399014779,60.0,20.0
31015,3,1015,[117  88   7 603 127],805,2,4145,4.0797244094488185,0.0,0.0
31016,3,1016,[508 258 153 144 194],297,3,4148,4.07866273352999,0.0,0.0
31017,3,1017,[269 151 200 111 100],805,4,4152,4.078585461689587,0.0,0.0
31018,3,1018,[ 64 318 301  11 313],345,5,4157,4.079489695780176,60.0,20.0
31019,3,1019,[ 64 318 301  11 313],416,5,4162,4.080392156862745,60.0,20.0
31020,3,1020,[204 357 257  82  56],601,1,4163,4.077375122428991,0.0,0.0
31021,3,1021,[ 64 318 301  11 313],416,5,4168,4.078277886497065,60.0,20.0
31022,3,1022,[ 64 318 301  11 313],345,5,4173,4.0791788856304985,60.0,20.0
31023,3,1023,[ 64 318 301  11 313],345,5,4178,4.080078125,60.0,20.0
31024,3,1024,[ 64 318 301  11 313],416,5,4183,4.080975609756098,60.0,20.0
31025,3,1025,[ 89 211 195 200  50],437,3,4186,4.079922027290448,0.0,20.0
31026,3,1026,[ 64 318 301  11 313],345,5,4191,4.080817916260954,60.0,20.0
31027,3,1027,[ 64 318 301  11 313],43,5,4196,4.081712062256809,60.0,20.0
31028,3,1028,[237 117  64 191 202],642,4,4200,4.081632653061225,20.0,0.0
31029,3,1029,[ 64 318 301  11 313],43,5,4205,4.08252427184466,60.0,20.0
31030,3,1030,[161 144  11 258  50],416,5,4210,4.083414161008729,0.0,20.0
31031,3,1031,[121  70 210 181 191],437,2,4212,4.0813953488372094,0.0,20.0
31032,3,1032,[ 64 318 301  11 313],345,5,4217,4.082284607938044,60.0,20.0
31033,3,1033,[234 318 172  25 237],345,4,4221,4.082205029013539,20.0,0.0
31034,3,1034,[  1 153 515 222  69],297,3,4224,4.081159420289855,0.0,0.0
31035,3,1035,[ 64 318 301  11 313],345,5,4229,4.082046332046332,60.0,20.0
31036,3,1036,[191 313 195 187 655],618,4,4233,4.081967213114754,20.0,20.0
31037,3,1037,[ 97 172 161 300   8],43,5,4238,4.082851637764932,0.0,0.0
31038,3,1038,[215 288 301 174 222],588,3,4241,4.0818094321462945,0.0,20.0
31039,3,1039,[161 238 202 185 200],437,4,4245,4.081730769230769,0.0,0.0
31040,3,1040,[ 64 318 301  11 313],416,5,4250,4.082612872238233,60.0,20.0
31041,3,1041,[ 64 318 301  11 313],416,5,4255,4.083493282149712,60.0,20.0
31042,3,1042,[153 234 235 183  98],297,3,4258,4.082454458293385,0.0,20.0
31043,3,1043,[216   7  96 258 222],854,3,4261,4.081417624521073,0.0,0.0
31044,3,1044,[  4 257 423  12 181],654,4,4265,4.08133971291866,20.0,20.0
31045,3,1045,[ 64 318 301  11 313],43,5,4270,4.082217973231358,60.0,20.0
31046,3,1046,[ 64 318 301  11 313],43,5,4275,4.083094555873926,60.0,20.0
31047,3,1047,[328 151 423   1 294],505,2,4277,4.081106870229007,0.0,0.0
31048,3,1048,[ 64 318 301  11 313],43,5,4282,4.081982840800762,60.0,20.0
31049,3,1049,[202 235 179 222 118],805,2,4284,4.08,0.0,0.0
31050,3,1050,[200 100 483 204 196],618,4,4288,4.079923882017127,20.0,0.0
31051,3,1051,[ 64 318 301  11 313],43,5,4293,4.080798479087452,60.0,20.0
31052,3,1052,[ 64 318 301  11 313],43,5,4298,4.081671415004748,60.0,20.0
31053,3,1053,[ 64 318 301  11 313],345,5,4303,4.082542694497154,60.0,20.0
31054,3,1054,[237 568 215  79 286],588,4,4307,4.082464454976304,0.0,0.0
31055,3,1055,[ 64 318 301  11 313],43,5,4312,4.083333333333333,60.0,20.0
31056,3,1056,[597 238 286 603 144],854,2,4314,4.081362346263009,0.0,0.0
31057,3,1057,[ 64 318 301  11 313],416,5,4319,4.082230623818526,60.0,20.0
31058,3,1058,[ 64 318 301  11 313],416,5,4324,4.0830972615675165,60.0,20.0
31059,3,1059,[ 64 318 301  11 313],43,5,4329,4.083962264150943,60.0,20.0
31060,3,1060,[ 64 318 301  11 313],345,5,4334,4.084825636192272,60.0,20.0
31061,3,1061,[ 64 318 301  11 313],345,5,4339,4.085687382297552,60.0,20.0
31062,3,1062,[ 69 135 435 172 215],405,4,4343,4.0856067732831605,0.0,0.0
31063,3,1063,[ 64 318 301  11 313],345,5,4348,4.086466165413534,60.0,20.0
31064,3,1064,[ 22 174  12 323 275],416,4,4352,4.086384976525822,20.0,0.0
31065,3,1065,[ 64 318 301  11 313],43,5,4357,4.087242026266416,60.0,20.0
31066,3,1066,[ 64 318 301  11 313],43,5,4362,4.088097469540768,60.0,20.0
31067,3,1067,[ 79 172 357 385  11],405,4,4366,4.088014981273409,0.0,0.0
31068,3,1068,[ 64 318 301  11 313],43,5,4371,4.088868101028999,60.0,20.0
31069,3,1069,[ 64 318 301  11 313],345,5,4376,4.0897196261682245,60.0,20.0
31070,3,1070,[ 64 318 301  11 313],345,5,4381,4.090569561157796,60.0,20.0
31071,3,1071,[ 64 318 301  11 313],345,5,4386,4.0914179104477615,60.0,20.0
31072,3,1072,[322 121 174 183 245],417,2,4388,4.089468779123951,0.0,0.0
31073,3,1073,[ 64 318 301  11 313],345,5,4393,4.090316573556797,60.0,20.0
31074,3,1074,[215  64 483   9 275],618,3,4396,4.089302325581396,40.0,0.0
31075,3,1075,[ 64 318 301  11 313],416,5,4401,4.090148698884758,60.0,20.0
31076,3,1076,[172 405 245 185 678],921,2,4403,4.088207985143918,0.0,0.0
31077,3,1077,[182 196 475 195 748],198,2,4405,4.086270871985158,0.0,0.0
31078,3,1078,[ 64 318 301  11 313],345,5,4410,4.087117701575533,60.0,20.0
31079,3,1079,[111 143 289  28 655],588,2,4412,4.0851851851851855,0.0,0.0
31080,3,1080,[ 64 318 301  11 313],416,5,4417,4.0860314523589265,60.0,20.0
31081,3,1081,[ 64 318 301  11 313],345,5,4422,4.086876155268023,60.0,20.0
31082,3,1082,[ 64 318 301  11 313],416,5,4427,4.087719298245614,60.0,20.0
31083,3,1083,[235   4 143 216  95],43,4,4431,4.087638376383764,0.0,0.0
31084,3,1084,[ 64 318 301  11 313],43,5,4436,4.088479262672811,60.0,20.0
31085,3,1085,[ 95 300 185  70  15],416,4,4440,4.088397790055248,0.0,0.0
31086,3,1086,[ 15 173 237 132 742],642,4,4444,4.088316467341306,0.0,0.0
31087,3,1087,[ 64 318 301  11 313],345,5,4449,4.089154411764706,60.0,20.0
31088,3,1088,[ 64 318 301  11 313],345,5,4454,4.089990817263544,60.0,20.0
31089,3,1089,[748 546 427  98 121],416,4,4458,4.089908256880734,0.0,20.0
31090,3,1090,[ 64 318 301  11 313],345,5,4463,4.090742438130156,60.0,20.0
31091,3,1091,[ 64 318 301  11 313],43,5,4468,4.091575091575091,60.0,20.0
31092,3,1092,[ 64 318 301  11 313],43,5,4473,4.092406221408966,60.0,20.0
31093,3,1093,[ 64 318 301  11 313],43,5,4478,4.093235831809872,60.0,20.0
31094,3,1094,[ 64 318 301  11 313],43,5,4483,4.094063926940639,60.0,20.0
31095,3,1095,[ 89  69 204 172  97],373,4,4487,4.093978102189781,0.0,0.0
31096,3,1096,[182 211  79 588 143],405,2,4489,4.092069279854147,0.0,0.0
31097,3,1097,[257   8 238 300 597],43,3,4492,4.091074681238616,0.0,0.0
31098,3,1098,[ 64 318 301  11 313],416,5,4497,4.091901728844404,60.0,20.0
31099,3,1099,[ 64 318 301  11 313],43,5,4502,4.092727272727273,60.0,20.0
31100,3,1100,[ 64 318 301  11 313],345,5,4507,4.093551316984559,60.0,20.0
31101,3,1101,[151 100  95  64   9],618,2,4509,4.0916515426497275,20.0,0.0
31102,3,1102,[ 64 318 301  11 313],416,5,4514,4.092475067996373,60.0,20.0
31103,3,1103,[ 64 318 301  11 313],345,5,4519,4.093297101449275,60.0,20.0
31104,3,1104,[ 64 318 301  11 313],43,5,4524,4.094117647058823,60.0,20.0
31105,3,1105,[ 82 496 603 275 483],128,5,4529,4.094936708860759,20.0,0.0
31106,3,1106,[ 64 318 301  11 313],43,5,4534,4.095754290876242,60.0,20.0
31107,3,1107,[ 64 318 301  11 313],43,5,4539,4.096570397111913,60.0,20.0
31108,3,1108,[181 403 176 603 143],416,5,4544,4.097385031559964,0.0,20.0
31109,3,1109,[174  25 127 117 179],198,3,4547,4.096396396396396,0.0,0.0
31110,3,1110,[ 28 182 132 318  97],416,5,4552,4.0972097209720975,20.0,0.0
31111,3,1111,[ 64 318 301  11 313],416,5,4557,4.098021582733813,60.0,20.0
31112,3,1112,[ 64 318 301  11 313],43,5,4562,4.098831985624439,60.0,20.0
31113,3,1113,[313 151 288 216 185],416,4,4566,4.098743267504489,20.0,40.0
31114,3,1114,[ 64 318 301  11 313],416,5,4571,4.099551569506726,60.0,20.0
31115,3,1115,[238  96 100 153 655],373,4,4575,4.099462365591398,0.0,0.0
31116,3,1116,[ 64 318 301  11 313],345,5,4580,4.100268576544315,60.0,20.0
31117,3,1117,[127 273 111 176 678],805,2,4582,4.098389982110913,0.0,0.0
31118,3,1118,[ 64 318 301  11 313],43,5,4587,4.099195710455764,60.0,20.0
31119,3,1119,[ 64 318 301  11 313],416,5,4592,4.1,60.0,20.0
31120,3,1120,[174 202 196 111 483],618,3,4595,4.099018733273863,20.0,0.0
31121,3,1121,[ 98  22  97  79 318],253,5,4600,4.09982174688057,20.0,20.0
31122,3,1122,[238 200 151  71  11],805,3,4603,4.098842386464827,0.0,0.0
31123,3,1123,[ 64 318 301 313  11],416,5,4608,4.099644128113879,60.0,20.0
31124,3,1124,[ 64 318 301 313  11],416,5,4613,4.100444444444444,60.0,20.0
31125,3,1125,[286 111 234 313 121],588,4,4617,4.100355239786857,20.0,20.0
31126,3,1126,[ 64 318 301 313  11],416,5,4622,4.101153504880213,60.0,20.0
31127,3,1127,[183 215 168  89 182],437,0,4622,4.097517730496454,0.0,0.0
31128,3,1128,[237   1 151  56 200],922,3,4625,4.096545615589017,0.0,0.0
31129,3,1129,[ 64 318 301 313  11],345,5,4630,4.097345132743363,60.0,20.0
31130,3,1130,[ 64 318 301 313  11],416,5,4635,4.098143236074271,60.0,20.0
31131,3,1131,[ 64 318 301 313  11],345,5,4640,4.098939929328622,60.0,20.0
31132,3,1132,[132  15 655 204 234],262,1,4641,4.096204766107679,0.0,0.0
31133,3,1133,[ 64 318 301 313  11],416,5,4646,4.09700176366843,60.0,20.0
31134,3,1134,[ 64 318 301 313  11],345,5,4651,4.097797356828194,60.0,20.0
31135,3,1135,[ 64 318 301 313  11],416,5,4656,4.098591549295775,60.0,20.0
31136,3,1136,[ 64 318 301 313  11],416,5,4661,4.09938434476693,60.0,20.0
31137,3,1137,[ 64 318 301 313  11],345,5,4666,4.100175746924429,60.0,20.0
31138,3,1138,[ 64 318 301 313  11],345,5,4671,4.100965759438104,60.0,20.0
31139,3,1139,[153 294 181 515 121],417,3,4674,4.1,0.0,20.0
31140,3,1140,[200 111 655 125 228],417,3,4677,4.099035933391762,0.0,0.0
31141,3,1141,[238 588  70 215  25],345,3,4680,4.0980735551663745,0.0,0.0
31142,3,1142,[ 64 318 301 313  11],43,5,4685,4.0988626421697285,60.0,20.0
31143,3,1143,[ 64 318 301 313  11],43,5,4690,4.09965034965035,60.0,20.0
31144,3,1144,[ 64 318 301 313  11],43,5,4695,4.100436681222708,60.0,20.0
31145,3,1145,[237  12   4 143 300],297,3,4698,4.099476439790576,20.0,0.0
31146,3,1146,[273 144 132 515 405],416,5,4703,4.100261551874455,0.0,0.0
31147,3,1147,[ 64 318 301 313  11],43,5,4708,4.101045296167247,60.0,20.0
31148,3,1148,[ 64 318 301 313  11],345,5,4713,4.101827676240209,60.0,20.0
31149,3,1149,[ 64 318 301 313  11],345,5,4718,4.102608695652174,60.0,20.0
31150,3,1150,[ 64 318 301 313  11],43,5,4723,4.103388357949609,60.0,20.0
31151,3,1151,[ 64 318 301 313  11],43,5,4728,4.104166666666667,60.0,20.0
31152,3,1152,[ 64 318 301 313  11],43,5,4733,4.104943625325238,60.0,20.0
31153,3,1153,[427  15 655 215 172],198,4,4737,4.104852686308492,0.0,0.0
31154,3,1154,[ 64 318 301 313  11],345,5,4742,4.105627705627706,60.0,20.0
31155,3,1155,[191 132  70 174 328],373,4,4746,4.1055363321799305,0.0,0.0
31156,3,1156,[ 64 318 301 313  11],345,5,4751,4.106309420916163,60.0,20.0
31157,3,1157,[ 64 318 301 313  11],43,5,4756,4.1070811744386875,60.0,20.0
31158,3,1158,[ 64 318 301 313  11],345,5,4761,4.1078515962036235,60.0,20.0
31159,3,1159,[ 11  79 597 357  69],854,4,4765,4.107758620689655,0.0,0.0
31160,3,1160,[ 64 318 301 313  11],416,5,4770,4.108527131782946,60.0,20.0
31161,3,1161,[ 64 318 301 313  11],345,5,4775,4.1092943201376935,60.0,20.0
31162,3,1162,[ 64 318 301 313  11],43,5,4780,4.11006018916595,60.0,20.0
31163,3,1163,[ 64 318 301 313  11],416,5,4785,4.110824742268041,60.0,20.0
31164,3,1164,[ 64 318 301 313  11],416,5,4790,4.111587982832618,60.0,20.0
31165,3,1165,[222 144 216 678 357],297,3,4793,4.110634648370498,0.0,0.0
31166,3,1166,[ 64 318 301 313  11],345,5,4798,4.111396743787489,60.0,20.0
31167,3,1167,[322 153 187 132 127],416,4,4802,4.111301369863014,0.0,0.0
31168,3,1168,[ 71   4 289 125 237],764,4,4806,4.111206159110351,0.0,0.0
31169,3,1169,[ 79 357 197 423  50],373,3,4809,4.11025641025641,0.0,20.0
31170,3,1170,[202 235 216 210  98],416,4,4813,4.110162254483347,0.0,20.0
31171,3,1171,[ 64 318 301 313  11],345,5,4818,4.110921501706485,60.0,20.0
31172,3,1172,[ 64 318 301 313  11],43,5,4823,4.111679454390452,60.0,20.0
31173,3,1173,[ 64 318 301 313  11],345,5,4828,4.112436115843271,60.0,20.0
31174,3,1174,[185 269 194 200 257],297,2,4830,4.110638297872341,0.0,0.0
31175,3,1175,[ 64 318 301 313  11],43,5,4835,4.11139455782313,60.0,20.0
31176,3,1176,[ 64 318 301 313  11],43,5,4840,4.11214953271028,60.0,20.0
31177,3,1177,[  8 546 265 215 204],297,1,4841,4.109507640067911,0.0,0.0
31178,3,1178,[ 64 318 301 313  11],43,5,4846,4.110262934690415,60.0,20.0
31179,3,1179,[  4 496 175  82 168],373,3,4849,4.109322033898305,0.0,0.0
31180,3,1180,[ 64 318 301 313  11],43,5,4854,4.110076206604572,60.0,20.0
31181,3,1181,[ 64 318 301 313  11],345,5,4859,4.11082910321489,60.0,20.0
31182,3,1182,[269  79 168 204  11],416,5,4864,4.111580726965342,0.0,0.0
31183,3,1183,[ 70 655 678   4 196],416,4,4868,4.111486486486487,0.0,0.0
31184,3,1184,[121 216 288 265   7],588,4,4872,4.111392405063291,0.0,20.0
31185,3,1185,[ 64 318 301 313  11],345,5,4877,4.112141652613828,60.0,20.0
31186,3,1186,[ 64 318 301 313  11],416,5,4882,4.1128896377422075,60.0,20.0
31187,3,1187,[ 64 318 301 313  11],416,5,4887,4.113636363636363,60.0,20.0
31188,3,1188,[273 294  71  50 183],416,5,4892,4.114381833473507,0.0,20.0
31189,3,1189,[ 64 318 301 313  11],345,5,4897,4.115126050420168,60.0,20.0
31190,3,1190,[318 118 238  64 125],416,4,4901,4.115029387069689,40.0,0.0
31191,3,1191,[269  71  79 471 318],373,4,4905,4.114932885906041,20.0,0.0
31192,3,1192,[176 118 655 238 132],416,4,4909,4.114836546521374,0.0,0.0
31193,3,1193,[168 742 275 173  79],416,5,4914,4.115577889447236,0.0,0.0
31194,3,1194,[ 64 318 301 313  11],416,5,4919,4.116317991631799,60.0,20.0
31195,3,1195,[ 64 318 301 313  11],345,5,4924,4.117056856187291,60.0,20.0
31196,3,1196,[ 64 318 301 313  11],345,5,4929,4.117794486215539,60.0,20.0
31197,3,1197,[269  28 185 475 144],416,4,4933,4.117696160267112,0.0,0.0
31198,3,1198,[202  95 100  69 215],43,5,4938,4.118432026688907,0.0,0.0
31199,3,1199,[ 64 318 301 313  11],416,5,4943,4.119166666666667,60.0,20.0
31200,3,1200,[187  50 742 288  95],416,4,4947,4.119067443796836,0.0,40.0
31201,3,1201,[117 597 288  64 588],642,4,4951,4.118968386023295,20.0,20.0
31202,3,1202,[  8 403  95 588  82],49,1,4952,4.116375727348296,0.0,0.0
31203,3,1203,[ 82 742 175 168  88],805,2,4954,4.114617940199335,0.0,0.0
31204,3,1204,[ 69  82 245  98 300],416,4,4958,4.114522821576763,0.0,20.0
31205,3,1205,[100 117 269  56 196],805,3,4961,4.1135986733001655,0.0,0.0
31206,3,1206,[ 64 318 301 313  11],43,5,4966,4.114333057166529,60.0,20.0
31207,3,1207,[ 64 318 301 313  11],345,5,4971,4.115066225165563,60.0,20.0
31208,3,1208,[ 64 318 301 313  11],43,5,4976,4.115798180314309,60.0,20.0
31209,3,1209,[ 64 318 301 313  11],43,5,4981,4.116528925619835,60.0,20.0
31210,3,1210,[ 64 318 301 313  11],43,5,4986,4.117258464079273,60.0,20.0
31211,3,1211,[257 238 196 144 313],711,3,4989,4.116336633663367,20.0,20.0
31212,3,1212,[ 64 318 301 313  11],416,5,4994,4.117065127782358,60.0,20.0
31213,3,1213,[ 64 318 301 313  11],416,5,4999,4.117792421746294,60.0,20.0
31214,3,1214,[ 64 318 301 313  11],43,5,5004,4.118518518518519,60.0,20.0
31215,3,1215,[202 210 313 238 144],416,5,5009,4.119243421052632,20.0,20.0
31216,3,1216,[ 64 318 301 313  11],43,5,5014,4.119967132292523,60.0,20.0
31217,3,1217,[187 197 588 173 161],618,3,5017,4.119047619047619,0.0,0.0
31218,3,1218,[ 64 318 301 313  11],416,5,5022,4.119770303527481,60.0,20.0
31219,3,1219,[172  70  64 191 196],711,5,5027,4.120491803278688,20.0,0.0
31220,3,1220,[265 144  64 234 603],416,5,5032,4.121212121212121,20.0,0.0
31221,3,1221,[ 64 318 301 313  11],43,5,5037,4.1219312602291325,60.0,20.0
31222,3,1222,[191 100 168 405 204],416,5,5042,4.122649223221586,0.0,0.0
31223,3,1223,[ 64 318 301 313  11],416,5,5047,4.123366013071895,60.0,20.0
31224,3,1224,[ 64 318 301 313  11],43,5,5052,4.124081632653061,60.0,20.0
31225,3,1225,[313  15 204  25 258],43,5,5057,4.124796084828711,20.0,20.0
31226,3,1226,[302 210 183 257 179],416,3,5060,4.123879380603097,0.0,0.0
31227,3,1227,[215 268 237  56 678],297,3,5063,4.122964169381108,0.0,0.0
31228,3,1228,[127  98 475  56  71],601,2,5065,4.1212367778681855,0.0,20.0
31229,3,1229,[ 64 318 301 313  11],416,5,5070,4.121951219512195,60.0,20.0
31230,3,1230,[ 64 318 301 313  11],416,5,5075,4.122664500406174,60.0,20.0
31231,3,1231,[234  50 144 176   7],297,3,5078,4.121753246753247,0.0,20.0
31232,3,1232,[ 64 318 301 313  11],43,5,5083,4.122465531224655,60.0,20.0
31233,3,1233,[ 69 216  97  15 196],12,5,5088,4.123176661264181,0.0,0.0
31234,3,1234,[ 64 318 301 313  11],416,5,5093,4.123886639676114,60.0,20.0
31235,3,1235,[204  15 269 268   8],721,5,5098,4.124595469255663,0.0,0.0
31236,3,1236,[ 64 318 301 313  11],43,5,5103,4.125303152789006,60.0,20.0
31237,3,1237,[ 64 318 301 313  11],416,5,5108,4.1260096930533114,60.0,20.0
31238,3,1238,[ 56 302 678   4  88],345,4,5112,4.12590799031477,0.0,0.0
31239,3,1239,[ 64 318 301 313  11],43,5,5117,4.126612903225807,60.0,20.0
31240,3,1240,[ 64 318 301 313  11],416,5,5122,4.127316680096696,60.0,20.0
31241,3,1241,[175  70 182 153  25],198,2,5124,4.125603864734299,0.0,0.0
31242,3,1242,[ 96 183  79  22 237],253,5,5129,4.1263073209975865,0.0,0.0
31243,3,1243,[ 64 318 301 313  11],345,5,5134,4.127009646302251,60.0,20.0
31244,3,1244,[211 289 294 127 546],43,5,5139,4.127710843373494,0.0,0.0
31245,3,1245,[ 64 318 301 313  11],43,5,5144,4.128410914927769,60.0,20.0
31246,3,1246,[ 64 318 301 313  11],345,5,5149,4.129109863672815,60.0,20.0
31247,3,1247,[257 173 117 588 302],297,4,5153,4.129006410256411,0.0,0.0
31248,3,1248,[ 64 318 301 313  11],345,5,5158,4.129703763010409,60.0,20.0
31249,3,1249,[ 50 100 222 135 111],297,4,5162,4.1296,0.0,20.0
31250,3,1250,[ 64 318 301 313  11],416,5,5167,4.130295763389289,60.0,20.0
31251,3,1251,[ 64 318 301 313  11],416,5,5172,4.1309904153354635,60.0,20.0
31252,3,1252,[111 238 245 151 289],416,2,5174,4.129289704708699,0.0,0.0
31253,3,1253,[ 11  15 302 275 186],43,4,5178,4.1291866028708135,0.0,0.0
31254,3,1254,[ 64 318 301 313  11],345,5,5183,4.1298804780876495,60.0,20.0
31255,3,1255,[ 64 318 301 313  11],416,5,5188,4.130573248407643,60.0,20.0
31256,3,1256,[ 15  82 275  50 144],416,5,5193,4.131264916467781,0.0,20.0
31257,3,1257,[ 64 318 301 313  11],43,5,5198,4.131955484896661,60.0,20.0
31258,3,1258,[ 64 318 301 313  11],43,5,5203,4.132644956314535,60.0,20.0
31259,3,1259,[ 64 318 301 313  11],43,5,5208,4.133333333333334,60.0,20.0
31260,3,1260,[111 597 328 195 161],416,4,5212,4.133227597145123,0.0,0.0
31261,3,1261,[288  12 258  96 423],62,3,5215,4.132329635499207,20.0,20.0
31262,3,1262,[ 15 483 301 180 182],437,3,5218,4.131433095803642,20.0,0.0
31263,3,1263,[ 64 318 301 313  11],416,5,5223,4.132120253164557,60.0,20.0
31264,3,1264,[ 64 318 301 313  11],43,5,5228,4.132806324110672,60.0,20.0
31265,3,1265,[ 64 318 301 313  11],43,5,5233,4.13349131121643,60.0,20.0
31266,3,1266,[ 64 318 301 313  11],43,5,5238,4.134175217048146,60.0,20.0
31267,3,1267,[168 132 276 403 475],198,4,5242,4.134069400630914,0.0,0.0
31268,3,1268,[ 64 318 301 313  11],416,5,5247,4.134751773049645,60.0,20.0
31269,3,1269,[357  64 191   8 288],214,4,5251,4.134645669291339,20.0,20.0
31270,3,1270,[ 64 318 301 313  11],416,5,5256,4.1353265145554685,60.0,20.0
31271,3,1271,[ 64 318 301 313  11],416,5,5261,4.136006289308176,60.0,20.0
31272,3,1272,[200 235 186 302 515],417,3,5264,4.1351139041633935,0.0,0.0
31273,3,1273,[ 64 318 301 313  11],43,5,5269,4.135792778649922,60.0,20.0
31274,3,1274,[ 96 202  56  82 125],505,2,5271,4.134117647058823,0.0,0.0
31275,3,1275,[ 64 318 301 313  11],416,5,5276,4.1347962382445145,60.0,20.0
31276,3,1276,[174 423 144   1 195],618,4,5280,4.13469068128426,0.0,0.0
31277,3,1277,[ 64 318 301 313  11],416,5,5285,4.135367762128325,60.0,20.0
31278,3,1278,[475 294 333 302 245],416,3,5288,4.1344800625488665,0.0,0.0
31279,3,1279,[ 64 318 301 313  11],43,5,5293,4.13515625,60.0,20.0
31280,3,1280,[405 742  50 655 603],751,2,5295,4.133489461358314,0.0,20.0
31281,3,1281,[127 328 174 405 483],854,3,5298,4.132605304212168,20.0,0.0
31282,3,1282,[ 64 318 301 313  11],416,5,5303,4.1332813717848795,60.0,20.0
31283,3,1283,[ 64 318 301 313  11],43,5,5308,4.133956386292835,60.0,20.0
31284,3,1284,[161 282 237 323 289],416,2,5310,4.132295719844358,0.0,0.0
31285,3,1285,[111  15 194 153 568],416,5,5315,4.132970451010887,0.0,0.0
31286,3,1286,[ 64 318 301 313  11],345,5,5320,4.133644133644133,60.0,20.0
31287,3,1287,[ 64 318 301 313  11],416,5,5325,4.134316770186335,60.0,20.0
31288,3,1288,[ 64 318 301 313  11],345,5,5330,4.134988363072149,60.0,20.0
31289,3,1289,[ 64 318 301 313  11],345,5,5335,4.135658914728682,60.0,20.0
31290,3,1290,[ 64 318 301 313  11],43,5,5340,4.136328427575523,60.0,20.0
31291,3,1291,[286   4 127 238 245],62,3,5343,4.135448916408668,0.0,0.0
31292,3,1292,[ 64 318 301 313  11],345,5,5348,4.136117556071152,60.0,20.0
31293,3,1293,[ 64 318 301 313  11],43,5,5353,4.136785162287481,60.0,20.0
31294,3,1294,[168 151 496 597 204],618,3,5356,4.135907335907336,0.0,0.0
31295,3,1295,[ 64 318 301 313  11],43,5,5361,4.136574074074074,60.0,20.0
31296,3,1296,[ 64 318 301 313  11],416,5,5366,4.1372397841171935,60.0,20.0
31297,3,1297,[ 64 318 301 313  11],345,5,5371,4.137904468412943,60.0,20.0
31298,3,1298,[ 64 318 301 313  11],43,5,5376,4.138568129330254,60.0,20.0
31299,3,1299,[ 96 258 655 215 403],416,5,5381,4.139230769230769,0.0,0.0
31300,3,1300,[ 64 318 301 313  11],416,5,5386,4.13989239046887,60.0,20.0
31301,3,1301,[ 15 258 186 195 265],198,2,5388,4.138248847926267,0.0,0.0
31302,3,1302,[ 64 318 301 313  11],345,5,5393,4.1389102072141215,60.0,20.0
31303,3,1303,[ 64 318 301 313  11],43,5,5398,4.139570552147239,60.0,20.0
31304,3,1304,[ 96 423 132 125 202],505,3,5401,4.1386973180076625,0.0,0.0
31305,3,1305,[ 64 318 301 313  11],43,5,5406,4.139356814701379,60.0,20.0
31306,3,1306,[ 64 318 301 313  11],416,5,5411,4.1400153022188215,60.0,20.0
31307,3,1307,[ 64 318 301 313  11],416,5,5416,4.140672782874618,60.0,20.0
31308,3,1308,[275  22  96  28 118],618,2,5418,4.13903743315508,0.0,0.0
31309,3,1309,[ 64 318 301 313  11],43,5,5423,4.139694656488549,60.0,20.0
31310,3,1310,[318 322 289 180  96],854,2,5425,4.138062547673532,20.0,0.0
31311,3,1311,[588 153 405  28 187],416,5,5430,4.138719512195122,0.0,0.0
31312,3,1312,[288 286  50 153 385],416,5,5435,4.139375476009139,0.0,40.0
31313,3,1313,[ 64 318 301 313  11],43,5,5440,4.140030441400304,60.0,20.0
31314,3,1314,[ 64 318 301 313  11],345,5,5445,4.140684410646388,60.0,20.0
31315,3,1315,[ 64 318 301 313  11],345,5,5450,4.141337386018237,60.0,20.0
31316,3,1316,[ 95 153  70 228 435],230,4,5454,4.14123006833713,0.0,0.0
31317,3,1317,[ 64 318 301 313  11],43,5,5459,4.141881638846738,60.0,20.0
31318,3,1318,[ 64 318 301 313  11],345,5,5464,4.142532221379833,60.0,20.0
31319,3,1319,[ 64 318 301 313  11],416,5,5469,4.1431818181818185,60.0,20.0
31320,3,1320,[ 64 318 301 313  11],416,5,5474,4.143830431491295,60.0,20.0
31321,3,1321,[ 64 318 301 313  11],416,5,5479,4.144478063540091,60.0,20.0
31322,3,1322,[ 56 385 211 202 191],417,5,5484,4.145124716553288,0.0,0.0
31323,3,1323,[215 211 234 183   4],297,2,5486,4.143504531722054,0.0,0.0
31324,3,1324,[176 597 385 588 322],805,1,5487,4.141132075471698,0.0,0.0
31325,3,1325,[ 64 318 301 313  11],43,5,5492,4.141779788838613,60.0,20.0
31326,3,1326,[ 98 597   8 173  70],654,5,5497,4.142426525998493,0.0,20.0
31327,3,1327,[ 64 318 301 313  11],416,5,5502,4.143072289156627,60.0,20.0
31328,3,1328,[655 191  95 302  25],416,4,5506,4.142964635063958,0.0,0.0
31329,3,1329,[ 70 200 118 288 328],416,4,5510,4.142857142857143,0.0,20.0
31330,3,1330,[222 125  89 200  64],854,4,5514,4.142749812171299,20.0,0.0
31331,3,1331,[ 64 318 301 313  11],43,5,5519,4.143393393393393,60.0,20.0
31332,3,1332,[ 64 318 301 313  11],345,5,5524,4.14403600900225,60.0,20.0
31333,3,1333,[ 64 318 301 313  11],43,5,5529,4.144677661169415,60.0,20.0
31334,3,1334,[ 64 318 301 313  11],43,5,5534,4.145318352059925,60.0,20.0
31335,3,1335,[ 64 318 301 313  11],43,5,5539,4.145958083832335,60.0,20.0
31336,3,1336,[ 56  71 588  97   8],43,5,5544,4.146596858638744,0.0,0.0
31337,3,1337,[ 64 318 301 313  11],345,5,5549,4.147234678624813,60.0,20.0
31338,3,1338,[742 111 496  56  50],416,5,5554,4.147871545929799,0.0,20.0
31339,3,1339,[ 64 318 301 313  11],345,5,5559,4.148507462686567,60.0,20.0
31340,3,1340,[288 173 265 276 471],922,2,5561,4.146905294556301,0.0,20.0
31341,3,1341,[ 64 318 301 313  11],416,5,5566,4.147540983606557,60.0,20.0
31342,3,1342,[ 64 318 301 313  11],345,5,5571,4.148175725986597,60.0,20.0
31343,3,1343,[161 405 111 471 742],416,5,5576,4.148809523809524,0.0,0.0
31344,3,1344,[151  88   8  28 275],437,3,5579,4.147955390334572,0.0,0.0
31345,3,1345,[318 678 211 196 174],416,4,5583,4.147845468053492,20.0,0.0
31346,3,1346,[ 64 318 301 313  11],43,5,5588,4.148478099480327,60.0,20.0
31347,3,1347,[211 258  88  64 496],43,5,5593,4.149109792284866,20.0,0.0
31348,3,1348,[ 64 318 301 313  11],345,5,5598,4.149740548554485,60.0,20.0
31349,3,1349,[  9 333 597   7 294],854,2,5600,4.148148148148148,0.0,0.0
31350,3,1350,[ 64 318 301 313  11],43,5,5605,4.148778682457439,60.0,20.0
31351,3,1351,[ 64 318 301 313  11],416,5,5610,4.149408284023669,60.0,20.0
31352,3,1352,[ 64 318 301 313  11],43,5,5615,4.150036954915004,60.0,20.0
31353,3,1353,[ 22 403 222 153 228],922,4,5619,4.149926144756278,0.0,0.0
31354,3,1354,[ 64 318 301 313  11],43,5,5624,4.150553505535055,60.0,20.0
31355,3,1355,[ 64 318 301 313  11],416,5,5629,4.15117994100295,60.0,20.0
31356,3,1356,[ 64 318 301 313  11],345,5,5634,4.151805453205601,60.0,20.0
31357,3,1357,[216 742 173  11 257],416,4,5638,4.151693667157585,0.0,0.0
31358,3,1358,[ 95 200 282 204 265],618,2,5640,4.150110375275938,0.0,0.0
31359,3,1359,[ 64 318 301 313  11],416,5,5645,4.150735294117647,60.0,20.0
31360,3,1360,[ 64 318 301 313  11],43,5,5650,4.151359294636297,60.0,20.0
31361,3,1361,[ 64 318 301 313  11],345,5,5655,4.151982378854625,60.0,20.0
31362,3,1362,[125 143 265 176 435],230,5,5660,4.152604548789435,0.0,0.0
31363,3,1363,[403 405  97 257   9],62,2,5662,4.151026392961877,0.0,0.0
31364,3,1364,[ 12 268 546 508 588],417,2,5664,4.14945054945055,20.0,0.0
31365,3,1365,[ 64 318 301 313  11],345,5,5669,4.150073206442167,60.0,20.0
31366,3,1366,[288  96 258 228  12],417,2,5671,4.1485003657644475,20.0,20.0
31367,3,1367,[ 64 318 301 313  11],345,5,5676,4.149122807017544,60.0,20.0
31368,3,1368,[ 64 318 301 313  11],43,5,5681,4.1497443389335285,60.0,20.0
31369,3,1369,[143 195  98 588 275],297,4,5685,4.149635036496351,0.0,20.0
31370,3,1370,[302 204 288 191 197],297,1,5686,4.147337709700948,0.0,20.0
31371,3,1371,[ 64 318 301 313  11],416,5,5691,4.1479591836734695,60.0,20.0
31372,3,1372,[151 275 742 423  95],654,5,5696,4.1485797523670795,0.0,0.0
31373,3,1373,[ 64 318 301 313  11],416,5,5701,4.1491994177583695,60.0,20.0
31374,3,1374,[210  71 179  12 186],601,3,5704,4.148363636363636,20.0,0.0
31375,3,1375,[ 64 318 301 313  11],416,5,5709,4.148982558139535,60.0,20.0
31376,3,1376,[ 64 318 301 313  11],43,5,5714,4.14960058097313,60.0,20.0
31377,3,1377,[ 64 318 301 313  11],43,5,5719,4.15021770682148,60.0,20.0
31378,3,1378,[ 22 313 568  96 204],618,3,5722,4.149383611312546,20.0,20.0
31379,3,1379,[176   1   4 294 181],297,2,5724,4.147826086956521,0.0,20.0
31380,3,1380,[ 22 265  71  82 216],416,5,5729,4.148443157132513,0.0,0.0
31381,3,1381,[ 64 318 301 313  11],416,5,5734,4.149059334298118,60.0,20.0
31382,3,1382,[ 64 318 301 313  11],345,5,5739,4.1496746203904555,60.0,20.0
31383,3,1383,[ 64 318 301 313  11],416,5,5744,4.1502890173410405,60.0,20.0
31384,3,1384,[ 64 318 301 313  11],345,5,5749,4.150902527075813,60.0,20.0
31385,3,1385,[ 64 318 301 313  11],345,5,5754,4.151515151515151,60.0,20.0
31386,3,1386,[ 71   4 294  64 127],43,5,5759,4.1521268925739,20.0,0.0
31387,3,1387,[ 64 318 301 313  11],345,5,5764,4.152737752161383,60.0,20.0
31388,3,1388,[282 196 176 471  96],416,5,5769,4.153347732181426,0.0,0.0
31389,3,1389,[ 64 318 301 313  11],43,5,5774,4.153956834532374,60.0,20.0
31390,3,1390,[ 64 318 301 313  11],416,5,5779,4.154565061107117,60.0,20.0
31391,3,1391,[ 64 318 301 313  11],416,5,5784,4.155172413793103,60.0,20.0
31392,3,1392,[ 64 318 301 313  11],416,5,5789,4.155778894472362,60.0,20.0
31393,3,1393,[ 64 318 301 313  11],43,5,5794,4.156384505021521,60.0,20.0
31394,3,1394,[ 96 161  82 185 180],805,2,5796,4.15483870967742,0.0,0.0
31395,3,1395,[222 211 215 118 238],43,4,5800,4.154727793696275,0.0,0.0
31396,3,1396,[ 64 318 301 313  11],43,5,5805,4.155332856120258,60.0,20.0
31397,3,1397,[135 210 742 257 181],417,0,5805,4.152360515021459,0.0,20.0
31398,3,1398,[403 423 385 237 238],416,4,5809,4.152251608291637,0.0,0.0
31399,3,1399,[ 64 318 301 313  11],43,5,5814,4.152857142857143,60.0,20.0
31400,3,1400,[ 64 318 301 313  11],345,5,5819,4.153461812990721,60.0,20.0
31401,3,1401,[ 64 318 301 313  11],345,5,5824,4.154065620542083,60.0,20.0
31402,3,1402,[ 64 318 301 313  11],43,5,5829,4.1546685673556665,60.0,20.0
31403,3,1403,[ 69 234  50 742 748],416,5,5834,4.155270655270655,0.0,20.0
31404,3,1404,[111 318 258  82 294],887,4,5838,4.1551601423487545,20.0,0.0
31405,3,1405,[ 64 318 301 313  11],416,5,5843,4.155761024182077,60.0,20.0
31406,3,1406,[ 64 318 301 313  11],345,5,5848,4.15636105188344,60.0,20.0
31407,3,1407,[748 132 172 508 234],345,4,5852,4.15625,0.0,0.0
31408,3,1408,[ 64 318 301 313  11],416,5,5857,4.156848828956707,60.0,20.0
31409,3,1409,[ 64 318 301 313  11],416,5,5862,4.157446808510638,60.0,20.0
31410,3,1410,[ 64 318 301 313  11],43,5,5867,4.158043940467754,60.0,20.0
31411,3,1411,[ 64 318 301 313  11],416,5,5872,4.158640226628895,60.0,20.0
31412,3,1412,[ 64 318 301 313  11],416,5,5877,4.159235668789809,60.0,20.0
31413,3,1413,[204 168   7 742 588],297,3,5880,4.158415841584159,0.0,0.0
31414,3,1414,[ 64 318 301 313  11],43,5,5885,4.159010600706714,60.0,20.0
31415,3,1415,[ 64 318 301 313  11],43,5,5890,4.159604519774011,60.0,20.0
31416,3,1416,[ 64 318 301 313  11],416,5,5895,4.160197600564573,60.0,20.0
31417,3,1417,[ 64 318 301 313  11],345,5,5900,4.160789844851904,60.0,20.0
31418,3,1418,[655 289 100 301 173],588,2,5902,4.1592670894996475,0.0,0.0
31419,3,1419,[ 64 318 301 313  11],345,5,5907,4.159859154929578,60.0,20.0
31420,3,1420,[ 98 143 151 179  69],601,1,5908,4.157635467980295,0.0,20.0
31421,3,1421,[258 271 286 423  12],297,3,5911,4.156821378340366,20.0,0.0
31422,3,1422,[ 64 318 301 313  11],345,5,5916,4.157413914265636,60.0,20.0
31423,3,1423,[ 64 318 301 313  11],43,5,5921,4.158005617977528,60.0,20.0
31424,3,1424,[496  50 121 273 405],416,5,5926,4.15859649122807,0.0,20.0
31425,3,1425,[ 64 318 301 313  11],345,5,5931,4.159186535764376,60.0,20.0
31426,3,1426,[313 185 143  82  50],921,3,5934,4.158374211632796,20.0,40.0
31427,3,1427,[ 64 318 301 313  11],43,5,5939,4.158963585434174,60.0,20.0
31428,3,1428,[ 64 318 301 313  11],416,5,5944,4.159552134359692,60.0,20.0
31429,3,1429,[ 64 318 301 313  11],345,5,5949,4.16013986013986,60.0,20.0
31430,3,1430,[181 238   9 151   7],43,4,5953,4.160027952480783,0.0,20.0
31431,3,1431,[ 64 318 301 313  11],416,5,5958,4.160614525139665,60.0,20.0
31432,3,1432,[161 181 286  79  64],43,5,5963,4.1612002791346825,20.0,20.0
31433,3,1433,[282  70 655   1  97],416,5,5968,4.161785216178521,0.0,0.0
31434,3,1434,[ 64 318 301 313  11],43,5,5973,4.1623693379790945,60.0,20.0
31435,3,1435,[ 56 237  50  22  96],230,3,5976,4.161559888579387,0.0,20.0
31436,3,1436,[ 64 318 301 313  11],416,5,5981,4.16214335421016,60.0,20.0
31437,3,1437,[ 64 318 301 313  11],416,5,5986,4.162726008344923,60.0,20.0
31438,3,1438,[151 181  95 186 496],711,4,5990,4.162612925642808,0.0,20.0
31439,3,1439,[483 333 173 204 597],588,5,5995,4.163194444444445,20.0,0.0
31440,3,1440,[211   9 151   1  11],416,4,5999,4.163081193615545,0.0,0.0
31441,3,1441,[173 161  88 385 111],588,3,6002,4.162274618585299,0.0,0.0
31442,3,1442,[  7 265  82 294  70],230,4,6006,4.162162162162162,0.0,0.0
31443,3,1443,[ 64 318 301 313  11],345,5,6011,4.162742382271468,60.0,20.0
31444,3,1444,[ 64 318 301 313  11],43,5,6016,4.163321799307958,60.0,20.0
31445,3,1445,[ 64 318 301 313  11],43,5,6021,4.16390041493776,60.0,20.0
31446,3,1446,[  7 294 508 135 237],854,3,6024,4.16309606081548,0.0,0.0
31447,3,1447,[  9 117 289  88  11],345,4,6028,4.162983425414365,0.0,0.0
31448,3,1448,[ 64 318 301 313  11],43,5,6033,4.163561076604555,60.0,20.0
31449,3,1449,[ 79 597 196 143 273],805,1,6034,4.161379310344827,0.0,0.0
31450,3,1450,[ 64 318 301 313  11],345,5,6039,4.161957270847691,60.0,20.0
31451,3,1451,[ 64 318 301 313  11],43,5,6044,4.162534435261708,60.0,20.0
31452,3,1452,[ 64 318 301 313  11],416,5,6049,4.163110805230557,60.0,20.0
31453,3,1453,[323 215 121 313 196],416,4,6053,4.162998624484182,20.0,20.0
31454,3,1454,[300 265 271 202 228],297,0,6053,4.160137457044674,0.0,0.0
31455,3,1455,[245 496  95 151 655],417,4,6057,4.160027472527473,0.0,0.0
31456,3,1456,[ 64 318 301 313  11],43,5,6062,4.1606039807824295,60.0,20.0
31457,3,1457,[748 237 117  69 182],297,2,6064,4.159122085048011,0.0,0.0
31458,3,1458,[ 64 318 301 313  11],345,5,6069,4.159698423577793,60.0,20.0
31459,3,1459,[282 194  69 216 423],416,5,6074,4.16027397260274,0.0,0.0
31460,3,1460,[ 64 318 301 313  11],416,5,6079,4.160848733744011,60.0,20.0
31461,3,1461,[191 179  97 568 273],416,4,6083,4.160738714090288,0.0,0.0
31462,3,1462,[588 125 191 135   1],618,4,6087,4.160628844839371,0.0,0.0
31463,3,1463,[117 294 435 210 228],297,2,6089,4.159153005464481,0.0,0.0
31464,3,1464,[258 161 678 215 385],345,2,6091,4.157679180887372,0.0,0.0
31465,3,1465,[ 64 318 301 313  11],43,5,6096,4.15825375170532,60.0,20.0
31466,3,1466,[ 70 471 265 132 215],618,3,6099,4.157464212678937,0.0,0.0
31467,3,1467,[ 64 318 301 313  11],345,5,6104,4.1580381471389645,60.0,20.0
31468,3,1468,[ 64 318 301 313  11],345,5,6109,4.15861130020422,60.0,20.0
31469,3,1469,[ 64 318 301 313  11],345,5,6114,4.159183673469387,60.0,20.0
31470,3,1470,[ 64 318 301 313  11],43,5,6119,4.159755268524813,60.0,20.0
31471,3,1471,[ 69  28 121 273 111],416,5,6124,4.1603260869565215,0.0,0.0
31472,3,1472,[282 269 403 302 289],345,2,6126,4.158859470468432,0.0,0.0
31473,3,1473,[235  64 210 216   8],642,3,6129,4.158073270013569,20.0,0.0
31474,3,1474,[ 25 175 174 313  98],49,2,6131,4.156610169491525,20.0,40.0
31475,3,1475,[ 64 318 301  11 313],43,5,6136,4.157181571815718,60.0,20.0
31476,3,1476,[ 64 318 301  11 313],345,5,6141,4.157752200406229,60.0,20.0
31477,3,1477,[ 64 318 301  11 313],416,5,6146,4.158322056833559,60.0,20.0
31478,3,1478,[153  22  15  79 282],416,5,6151,4.158891142663962,0.0,0.0
31479,3,1479,[597 127 202  69 313],618,4,6155,4.158783783783784,20.0,20.0
31480,3,1480,[ 64 318 301  11 313],416,5,6160,4.159351789331533,60.0,20.0
31481,3,1481,[ 64 318 301  11 313],416,5,6165,4.159919028340081,60.0,20.0
31482,3,1482,[ 64 318 301  11 313],43,5,6170,4.160485502360081,60.0,20.0
31483,3,1483,[ 12 210 180 127 173],805,2,6172,4.159029649595688,20.0,0.0
31484,3,1484,[ 64 318 301  11 313],345,5,6177,4.1595959595959595,60.0,20.0
31485,3,1485,[ 64 318 301  11 313],416,5,6182,4.160161507402423,60.0,20.0
31486,3,1486,[588 678 427 302  88],416,3,6185,4.159381304640215,0.0,0.0
31487,3,1487,[ 64 318 301  11 313],416,5,6190,4.15994623655914,60.0,20.0
31488,3,1488,[ 64 318 301  11 313],416,5,6195,4.16051040967092,60.0,20.0
31489,3,1489,[471 288   9 496 275],274,5,6200,4.1610738255033555,0.0,20.0
31490,3,1490,[568   9 328 294  71],43,5,6205,4.161636485580147,0.0,0.0
31491,3,1491,[273   7  98 588 748],297,4,6209,4.161528150134048,0.0,20.0
31492,3,1492,[ 64 318 301  11 313],345,5,6214,4.162089752176825,60.0,20.0
31493,3,1493,[204  95 427 215 132],416,4,6218,4.161981258366801,0.0,0.0
31494,3,1494,[678 515 173  50  28],416,4,6222,4.161872909698997,0.0,20.0
31495,3,1495,[197 204  70 282 237],297,2,6224,4.160427807486631,0.0,0.0
31496,3,1496,[ 82   1 222 153 333],721,4,6228,4.160320641282565,0.0,0.0
31497,3,1497,[ 64 318 301  11 313],345,5,6233,4.160881174899867,60.0,20.0
31498,3,1498,[ 64 318 301  11 313],43,5,6238,4.161440960640427,60.0,20.0
31499,3,1499,[153 228 168 210  96],417,2,6240,4.16,0.0,0.0
31500,3,1500,[ 64 318 301  11 313],43,5,6245,4.16055962691539,60.0,20.0
31501,3,1501,[ 64 318 301  11 313],43,5,6250,4.161118508655126,60.0,20.0
31502,3,1502,[ 64 318 301  11 313],345,5,6255,4.161676646706587,60.0,20.0
31503,3,1503,[ 56 100 496 168 403],43,5,6260,4.162234042553192,0.0,0.0
31504,3,1504,[ 64 318 301  11 313],43,5,6265,4.162790697674419,60.0,20.0
31505,3,1505,[238 143 100 427  22],416,5,6270,4.163346613545817,0.0,0.0
31506,3,1506,[ 64 318 301  11 313],345,5,6275,4.1639017916390175,60.0,20.0
31507,3,1507,[ 64 318 301  11 313],345,5,6280,4.164456233421751,60.0,20.0
31508,3,1508,[211 197 238  15 322],416,4,6284,4.164347249834328,0.0,0.0
31509,3,1509,[ 64 318 301  11 313],43,5,6289,4.164900662251656,60.0,20.0
31510,3,1510,[289 318 427 475 655],24,4,6293,4.164791528788881,20.0,0.0
31511,3,1511,[117 568 121 153  71],805,1,6294,4.162698412698413,0.0,0.0
31512,3,1512,[ 64 318 301  11 313],416,5,6299,4.163251817580965,60.0,20.0
31513,3,1513,[ 64 318 301  11 313],416,5,6304,4.163804491413474,60.0,20.0
31514,3,1514,[ 97 300 268 357 515],297,4,6308,4.1636963696369635,0.0,0.0
31515,3,1515,[182 228 174 294 117],62,3,6311,4.162928759894459,0.0,0.0
31516,3,1516,[ 64 318 301  11 313],416,5,6316,4.163480553724456,60.0,20.0
31517,3,1517,[ 64 318 301  11 313],416,5,6321,4.164031620553359,60.0,20.0
31518,3,1518,[185 294 172  89 357],805,4,6325,4.163923633969717,0.0,0.0
31519,3,1519,[ 64 318 301  11 313],345,5,6330,4.1644736842105265,60.0,20.0
31520,3,1520,[ 79 173 294 172  96],712,5,6335,4.165023011176857,0.0,0.0
31521,3,1521,[ 64 318 301  11 313],345,5,6340,4.16557161629435,60.0,20.0
31522,3,1522,[ 64 318 301  11 313],416,5,6345,4.166119500984898,60.0,20.0
31523,3,1523,[ 64 318 301  11 313],416,5,6350,4.166666666666667,60.0,20.0
31524,3,1524,[ 64 318 301  11 313],416,5,6355,4.167213114754098,60.0,20.0
31525,3,1525,[ 71 151 172 286  56],588,5,6360,4.16775884665793,0.0,0.0
31526,3,1526,[ 82 216 135 257 655],62,3,6363,4.166994106090374,0.0,0.0
31527,3,1527,[ 64 318 301  11 313],43,5,6368,4.167539267015707,60.0,20.0
31528,3,1528,[211  89 151 202 179],437,4,6372,4.167429692609549,0.0,0.0
31529,3,1529,[423 181  69 238 655],373,4,6376,4.167320261437909,0.0,20.0
31530,3,1530,[196 127 187 181 423],618,5,6381,4.167864141084259,0.0,20.0
31531,3,1531,[ 64 318 301  11 313],416,5,6386,4.168407310704961,60.0,20.0
31532,3,1532,[ 64 318 301  11 313],416,5,6391,4.168949771689498,60.0,20.0
31533,3,1533,[265 215 588  97 210],373,3,6394,4.168187744458931,0.0,0.0
31534,3,1534,[ 64 318 301  11 313],43,5,6399,4.168729641693811,60.0,20.0
31535,3,1535,[ 64 318 301  11 313],416,5,6404,4.169270833333333,60.0,20.0
31536,3,1536,[294 427 172 258 204],698,2,6406,4.1678594664931685,0.0,0.0
31537,3,1537,[ 64 318 301  11 313],345,5,6411,4.168400520156047,60.0,20.0
31538,3,1538,[204 333  82 202 268],416,5,6416,4.168940870695256,0.0,0.0
31539,3,1539,[435 237 100 588  25],230,4,6420,4.1688311688311686,0.0,0.0
31540,3,1540,[ 64 318 301  11 313],43,5,6425,4.169370538611291,60.0,20.0
31541,3,1541,[ 64 318 301  11 313],43,5,6430,4.169909208819715,60.0,20.0
31542,3,1542,[ 64 318 301  11 313],43,5,6435,4.170447180816591,60.0,20.0
31543,3,1543,[ 64 318 301  11 313],345,5,6440,4.170984455958549,60.0,20.0
31544,3,1544,[ 64 318 301  11 313],43,5,6445,4.171521035598706,60.0,20.0
31545,3,1545,[ 56 161   4 235 135],417,1,6446,4.169469598965071,0.0,0.0
31546,3,1546,[ 64 318 301  11 313],43,5,6451,4.1700064641241115,60.0,20.0
31547,3,1547,[ 64 318 301  11 313],345,5,6456,4.170542635658915,60.0,20.0
31548,3,1548,[191 216 183 135 200],405,2,6458,4.169141381536475,0.0,0.0
31549,3,1549,[ 64 318 301  11 313],416,5,6463,4.169677419354839,60.0,20.0
31550,3,1550,[ 64 318 301  11 313],345,5,6468,4.170212765957447,60.0,20.0
31551,3,1551,[ 11 235 194  82 269],416,4,6472,4.170103092783505,0.0,0.0
31552,3,1552,[ 79 182 568 276  69],230,3,6475,4.169349645846748,0.0,0.0
31553,3,1553,[ 50  97 328   7 258],62,3,6478,4.168597168597168,0.0,20.0
31554,3,1554,[ 64 318 301  11 313],416,5,6483,4.169131832797428,60.0,20.0
31555,3,1555,[ 64 318 301  11 313],43,5,6488,4.169665809768637,60.0,20.0
31556,3,1556,[238 172  64 286 300],416,5,6493,4.170199100834939,20.0,0.0
31557,3,1557,[ 64 318 301  11 313],416,5,6498,4.170731707317073,60.0,20.0
31558,3,1558,[ 64 318 301  11 313],345,5,6503,4.171263630532392,60.0,20.0
31559,3,1559,[237 181 282 216 153],721,4,6507,4.171153846153846,0.0,20.0
31560,3,1560,[ 64 318 301  11 313],43,5,6512,4.171684817424728,60.0,20.0
31561,3,1561,[ 64 318 301  11 313],43,5,6517,4.172215108834827,60.0,20.0
31562,3,1562,[179 258 328 235 546],49,1,6518,4.170185540626999,0.0,0.0
31563,3,1563,[ 64 318 301  11 313],416,5,6523,4.170716112531969,60.0,20.0
31564,3,1564,[ 64 318 301  11 313],43,5,6528,4.171246006389777,60.0,20.0
31565,3,1565,[ 64 318 301  11 313],43,5,6533,4.1717752234993615,60.0,20.0
31566,3,1566,[ 64 318 301  11 313],416,5,6538,4.17230376515635,60.0,20.0
31567,3,1567,[ 64 318 301  11 313],416,5,6543,4.172831632653061,60.0,20.0
31568,3,1568,[ 11 471 176 144 318],416,5,6548,4.173358827278522,20.0,0.0
31569,3,1569,[ 64 318 301  11 313],43,5,6553,4.173885350318471,60.0,20.0
31570,3,1570,[ 9 28 98 12 71],43,5,6558,4.174411203055379,20.0,20.0
31571,3,1571,[496  22 568  70 405],262,3,6561,4.173664122137405,0.0,0.0
31572,3,1572,[  1 568 405  97 125],417,3,6564,4.172917991099809,0.0,0.0
31573,3,1573,[435 202 245 234 200],297,0,6564,4.170266836086404,0.0,0.0
31574,3,1574,[ 64 318 301  11 313],345,5,6569,4.170793650793651,60.0,20.0
31575,3,1575,[ 64 318 301  11 313],345,5,6574,4.1713197969543145,60.0,20.0
31576,3,1576,[ 82 204 153   4  56],416,5,6579,4.1718452758402025,0.0,0.0
31577,3,1577,[234 111 132  71 143],437,3,6582,4.171102661596958,0.0,0.0
31578,3,1578,[ 64 318 301  11 313],416,5,6587,4.1716276124129195,60.0,20.0
31579,3,1579,[ 64 318 301  11 313],43,5,6592,4.172151898734177,60.0,20.0
31580,3,1580,[ 64 318 301  11 313],416,5,6597,4.172675521821632,60.0,20.0
31581,3,1581,[ 64 318 301  11 313],43,5,6602,4.173198482932996,60.0,20.0
31582,3,1582,[ 64 318 301  11 313],43,5,6607,4.173720783322805,60.0,20.0
31583,3,1583,[195 151  28 172 210],805,2,6609,4.172348484848484,0.0,0.0
31584,3,1584,[ 64 318 301  11 313],43,5,6614,4.172870662460568,60.0,20.0
31585,3,1585,[ 64 318 301  11 313],345,5,6619,4.173392181588903,60.0,20.0
31586,3,1586,[742   4 302  97 322],417,1,6620,4.171392564587271,0.0,0.0
31587,3,1587,[179 180 385  82 269],373,1,6621,4.169395465994962,0.0,0.0
31588,3,1588,[568 195 302 172 238],214,4,6625,4.169288860918817,0.0,0.0
31589,3,1589,[ 98 475 216 588 172],416,4,6629,4.169182389937107,0.0,20.0
31590,3,1590,[132 125 228 546 328],62,3,6632,4.168447517284727,0.0,0.0
31591,3,1591,[ 64 318 301  11 313],345,5,6637,4.168969849246231,60.0,20.0
31592,3,1592,[ 64 318 301  11 313],416,5,6642,4.169491525423729,60.0,20.0
31593,3,1593,[ 64 318 301  11 313],43,5,6647,4.170012547051443,60.0,20.0
31594,3,1594,[ 64 318 301  11 313],345,5,6652,4.170532915360502,60.0,20.0
31595,3,1595,[ 64 318 301  11 313],345,5,6657,4.171052631578948,60.0,20.0
31596,3,1596,[ 64 318 301  11 313],416,5,6662,4.171571696931747,60.0,20.0
31597,3,1597,[176 483   7 258 748],417,4,6666,4.171464330413016,20.0,0.0
31598,3,1598,[ 64 318 301  11 313],345,5,6671,4.17198248905566,60.0,20.0
31599,3,1599,[ 64 318 301  11 313],345,5,6676,4.1725,60.0,20.0
31600,3,1600,[742 313 118 597  69],588,3,6679,4.1717676452217365,20.0,20.0
31601,3,1601,[ 64 318 301  11 313],43,5,6684,4.1722846441947565,60.0,20.0
31602,3,1602,[ 64 318 301  11 313],43,5,6689,4.172800998128509,60.0,20.0
31603,3,1603,[ 70  11 202 588 323],751,3,6692,4.172069825436409,0.0,0.0
31604,3,1604,[121 471 385  12 117],43,4,6696,4.17196261682243,20.0,0.0
31605,3,1605,[515 185 357 471  71],416,5,6701,4.172478206724782,0.0,0.0
31606,3,1606,[ 64 318 301 313  11],43,5,6706,4.172993154947107,60.0,20.0
31607,3,1607,[405 132 174   8 546],416,4,6710,4.172885572139304,0.0,0.0
31608,3,1608,[ 64 318 301 313  11],43,5,6715,4.173399627097576,60.0,20.0
31609,3,1609,[ 64 318 301 313  11],416,5,6720,4.173913043478261,60.0,20.0
31610,3,1610,[405 568 597 265 300],705,5,6725,4.174425822470515,0.0,0.0
31611,3,1611,[ 64 318 301 313  11],43,5,6730,4.174937965260546,60.0,20.0
31612,3,1612,[181 191 257 597 151],62,3,6733,4.1742095474271546,0.0,20.0
31613,3,1613,[ 64 318 301 313  11],43,5,6738,4.174721189591078,60.0,20.0
31614,3,1614,[ 12 603 181 202  56],405,4,6742,4.174613003095975,20.0,20.0
31615,3,1615,[ 64 318 301 313  11],345,5,6747,4.175123762376238,60.0,20.0
31616,3,1616,[ 64 318 301 313  11],43,5,6752,4.175633889919604,60.0,20.0
31617,3,1617,[ 64 318 301 313  11],416,5,6757,4.1761433868974045,60.0,20.0
31618,3,1618,[ 64 318 301 313  11],345,5,6762,4.176652254478073,60.0,20.0
31619,3,1619,[ 89  79 132 318 197],711,5,6767,4.17716049382716,20.0,0.0
31620,3,1620,[121 183 200 423 597],618,5,6772,4.177668106107341,0.0,0.0
31621,3,1621,[ 64 318 301 313  11],416,5,6777,4.178175092478422,60.0,20.0
31622,3,1622,[ 64 318 301 313  11],43,5,6782,4.178681454097351,60.0,20.0
31623,3,1623,[ 64 318 301 313  11],43,5,6787,4.179187192118227,60.0,20.0
31624,3,1624,[323 588 282 143  11],764,4,6791,4.179076923076923,0.0,0.0
31625,3,1625,[ 64 318 301 313  11],43,5,6796,4.179581795817958,60.0,20.0
31626,3,1626,[238 180 405 173 258],198,3,6799,4.178856791641057,0.0,0.0
31627,3,1627,[ 64 318 301 313  11],43,5,6804,4.179361179361179,60.0,20.0
31628,3,1628,[ 64 318 301 313  11],43,5,6809,4.179864947820749,60.0,20.0
31629,3,1629,[471 210 258  89 151],922,3,6812,4.179141104294478,0.0,0.0
31630,3,1630,[ 64 318 301 313  11],43,5,6817,4.179644389944819,60.0,20.0
31631,3,1631,[588 678 655  11 318],345,3,6820,4.178921568627451,20.0,0.0
31632,3,1632,[179 216  95  97  71],437,3,6823,4.178199632578077,0.0,0.0
31633,3,1633,[ 64 318 301 313  11],416,5,6828,4.178702570379437,60.0,20.0
31634,3,1634,[ 64 318 301 313  11],345,5,6833,4.179204892966361,60.0,20.0
31635,3,1635,[ 64 318 301 313  11],416,5,6838,4.179706601466993,60.0,20.0
31636,3,1636,[ 64 318 301 313  11],416,5,6843,4.180207697006719,60.0,20.0
31637,3,1637,[ 64 318 301 313  11],43,5,6848,4.180708180708181,60.0,20.0
31638,3,1638,[ 64 318 301 313  11],416,5,6853,4.181208053691275,60.0,20.0
31639,3,1639,[ 64 318 301 313  11],43,5,6858,4.181707317073171,60.0,20.0
31640,3,1640,[ 64 318 301 313  11],416,5,6863,4.182205971968312,60.0,20.0
31641,3,1641,[ 28 475 302 276 427],416,3,6866,4.181485992691839,0.0,0.0
31642,3,1642,[ 64 318 301 313  11],416,5,6871,4.181984175289105,60.0,20.0
31643,3,1643,[423 475 269 385  56],805,3,6874,4.181265206812652,0.0,0.0
31644,3,1644,[ 64 318 301 313  11],43,5,6879,4.18176291793313,60.0,20.0
31645,3,1645,[186 238 597 276 403],43,2,6881,4.180437424058323,0.0,0.0
31646,3,1646,[161 125 143 202 180],373,2,6883,4.179113539769277,0.0,0.0
31647,3,1647,[ 28  79 385 100 238],805,3,6886,4.178398058252427,0.0,0.0
31648,3,1648,[ 64 318 301 313  11],345,5,6891,4.178896300788357,60.0,20.0
31649,3,1649,[ 64 318 301 313  11],345,5,6896,4.17939393939394,60.0,20.0
31650,3,1650,[ 98 318   7 742 117],854,3,6899,4.178679588128407,20.0,20.0
31651,3,1651,[ 64 318 301 313  11],43,5,6904,4.1791767554479415,60.0,20.0
31652,3,1652,[ 64 318 301 313  11],416,5,6909,4.1796733212341195,60.0,20.0
31653,3,1653,[ 64 318 301 313  11],345,5,6914,4.180169286577993,60.0,20.0
31654,3,1654,[ 64 318 301 313  11],416,5,6919,4.180664652567976,60.0,20.0
31655,3,1655,[ 82 181 568 143 357],373,3,6922,4.179951690821256,0.0,20.0
31656,3,1656,[301  50 195 328 742],416,5,6927,4.180446590223295,0.0,20.0
31657,3,1657,[181 288 111 100 237],618,3,6930,4.179734620024125,0.0,40.0
31658,3,1658,[ 56 655  88 215 181],618,5,6935,4.180229053646775,0.0,20.0
31659,3,1659,[202  12 186 117 268],588,4,6939,4.180120481927711,20.0,0.0
31660,3,1660,[265 427 182 173 322],416,4,6943,4.180012040939193,0.0,0.0
31661,3,1661,[173 183 202 385 194],698,3,6946,4.179302045728038,0.0,0.0
31662,3,1662,[ 64 318 301 313  11],416,5,6951,4.179795550210463,60.0,20.0
31663,3,1663,[302 179 568 405 268],416,4,6955,4.1796875,0.0,0.0
31664,3,1664,[ 64 318 301 313  11],416,5,6960,4.18018018018018,60.0,20.0
31665,3,1665,[237  56  95 121 186],437,3,6963,4.179471788715486,0.0,0.0
31666,3,1666,[ 64 318 301 313  11],43,5,6968,4.17996400719856,60.0,20.0
31667,3,1667,[185   1  71  25 275],907,5,6973,4.180455635491607,0.0,0.0
31668,3,1668,[ 64 318 301 313  11],345,5,6978,4.180946674655482,60.0,20.0
31669,3,1669,[ 64 318 301 313  11],43,5,6983,4.181437125748503,60.0,20.0
31670,3,1670,[215 127 135  70   7],198,4,6987,4.1813285457809695,0.0,0.0
31671,3,1671,[ 64 318 301 313  11],416,5,6992,4.181818181818182,60.0,20.0
31672,3,1672,[ 64 318 301 313  11],43,5,6997,4.182307232516438,60.0,20.0
31673,3,1673,[288 111 405 423 546],805,0,6997,4.179808841099164,0.0,20.0
31674,3,1674,[276 318 196  56 597],654,4,7001,4.179701492537314,20.0,0.0
31675,3,1675,[ 64 318 301 313  11],416,5,7006,4.18019093078759,60.0,20.0
31676,3,1676,[174  50 151 269   8],805,3,7009,4.17948717948718,0.0,20.0
31677,3,1677,[385 403  15 185 173],198,2,7011,4.17818831942789,0.0,0.0
31678,3,1678,[275 151 144 172 257],416,3,7014,4.17748659916617,0.0,0.0
31679,3,1679,[  8 423 117 200 132],437,4,7018,4.177380952380952,0.0,0.0
31680,3,1680,[ 64 318 301 313  11],43,5,7023,4.177870315288518,60.0,20.0
31681,3,1681,[181 182 597 215 127],416,4,7027,4.177764565992866,0.0,20.0
31682,3,1682,[427  98 357 302 125],416,5,7032,4.17825311942959,0.0,20.0
31683,3,1683,[ 96  71 245 187  82],416,4,7036,4.178147268408551,0.0,0.0
31684,3,1684,[197 175 168  88 235],805,3,7039,4.1774480712166175,0.0,0.0
31685,3,1685,[ 64 318 301 313  11],43,5,7044,4.177935943060498,60.0,20.0
31686,3,1686,[427 185 186 405 515],230,5,7049,4.178423236514523,0.0,0.0
31687,3,1687,[742  82 151 265 121],654,5,7054,4.178909952606635,0.0,0.0
31688,3,1688,[ 89  70 191 197 216],711,5,7059,4.179396092362345,0.0,0.0
31689,3,1689,[ 64 318 301 313  11],43,5,7064,4.179881656804734,60.0,20.0
31690,3,1690,[ 64 318 301 313  11],416,5,7069,4.1803666469544645,60.0,20.0
31691,3,1691,[ 79  64  22 282 144],618,4,7073,4.180260047281324,20.0,0.0
31692,3,1692,[ 64 318 301 313  11],416,5,7078,4.180744240992321,60.0,20.0
31693,3,1693,[ 96 127   4  25 357],198,3,7081,4.180047225501771,0.0,0.0
31694,3,1694,[471 318  56 234 211],416,5,7086,4.180530973451328,20.0,0.0
31695,3,1695,[168 174 322 185 143],805,2,7088,4.179245283018868,0.0,0.0
31696,3,1696,[ 64 318 301 313  11],43,5,7093,4.179728933411903,60.0,20.0
31697,3,1697,[ 98  11 435  79  50],437,3,7096,4.179034157832745,0.0,40.0
31698,3,1698,[228 143   8 179 302],405,3,7099,4.178340200117717,0.0,0.0
31699,3,1699,[ 64 318 301 313  11],43,5,7104,4.178823529411765,60.0,20.0
31700,3,1700,[200 168 276 234 235],416,3,7107,4.178130511463845,0.0,0.0
31701,3,1701,[222 257 294 191 195],601,2,7109,4.176850763807286,0.0,0.0
31702,3,1702,[ 64 318 301 313  11],416,5,7114,4.177334116265414,60.0,20.0
31703,3,1703,[ 88 121  56  15 181],345,4,7118,4.177230046948357,0.0,20.0
31704,3,1704,[ 64 318 301 313  11],416,5,7123,4.1777126099706745,60.0,20.0
31705,3,1705,[ 64 318 301 313  11],345,5,7128,4.178194607268464,60.0,20.0
31706,3,1706,[ 64 318 301 313  11],345,5,7133,4.1786760398359695,60.0,20.0
31707,3,1707,[ 64 318 301 313  11],416,5,7138,4.179156908665106,60.0,20.0
31708,3,1708,[ 22 289 471 273 197],416,4,7142,4.1790520772381505,0.0,0.0
31709,3,1709,[ 15 515 161 288 118],416,4,7146,4.178947368421053,0.0,20.0
31710,3,1710,[ 64 318 301 313  11],416,5,7151,4.179427235534775,60.0,20.0
31711,3,1711,[ 64 318 301 313  11],43,5,7156,4.179906542056075,60.0,20.0
31712,3,1712,[176 678 210 195 135],297,3,7159,4.179217746643316,0.0,0.0
31713,3,1713,[ 64 318 301 313  11],345,5,7164,4.179696616102683,60.0,20.0
31714,3,1714,[ 64 318 301 313  11],43,5,7169,4.180174927113702,60.0,20.0
31715,3,1715,[ 64 318 301 313  11],416,5,7174,4.18065268065268,60.0,20.0
31716,3,1716,[ 98 185  79 153 179],417,3,7177,4.179965055329062,0.0,20.0
31717,3,1717,[204 117 215 191 269],297,2,7179,4.178696158323632,0.0,0.0
31718,3,1718,[ 11 294 515  56 603],297,4,7183,4.178592204770215,0.0,0.0
31719,3,1719,[ 64 318 301 313  11],416,5,7188,4.17906976744186,60.0,20.0
31720,3,1720,[ 64 318 301 313  11],43,5,7193,4.179546775130738,60.0,20.0
31721,3,1721,[ 64 318 301 313  11],416,5,7198,4.180023228803717,60.0,20.0
31722,3,1722,[ 64 318 301 313  11],43,5,7203,4.180499129425421,60.0,20.0
31723,3,1723,[194 423 515 161 173],405,2,7205,4.1792343387471,0.0,0.0
31724,3,1724,[ 64 318 301 313  11],43,5,7210,4.179710144927537,60.0,20.0
31725,3,1725,[143 471 328 302 235],416,4,7214,4.179606025492468,0.0,0.0
31726,3,1726,[ 98  11 181  15 168],198,4,7218,4.1795020266357845,0.0,40.0
31727,3,1727,[161 135 196 197  22],805,2,7220,4.1782407407407405,0.0,0.0
31728,3,1728,[ 64 318 301 313  11],43,5,7225,4.178716020821284,60.0,20.0
31729,3,1729,[ 64 318 301 313  11],345,5,7230,4.179190751445087,60.0,20.0
31730,3,1730,[ 64 318 301 313  11],416,5,7235,4.179664933564414,60.0,20.0
31731,3,1731,[ 64 318 301 313  11],43,5,7240,4.180138568129331,60.0,20.0
31732,3,1732,[ 64 318 301 313  11],345,5,7245,4.180611656087709,60.0,20.0
31733,3,1733,[ 79   8 111 200 235],854,3,7248,4.179930795847751,0.0,0.0
31734,3,1734,[ 64 318 301 313  11],43,5,7253,4.180403458213257,60.0,20.0
31735,3,1735,[ 64 318 301 313  11],43,5,7258,4.1808755760368665,60.0,20.0
31736,3,1736,[238  89 603   1 174],751,2,7260,4.179620034542315,0.0,0.0
31737,3,1737,[125   1 328 111 151],314,5,7265,4.180092059838895,0.0,0.0
31738,3,1738,[ 64 318 301 313  11],345,5,7270,4.18056354226567,60.0,20.0
31739,3,1739,[ 64 318 301 313  11],43,5,7275,4.181034482758621,60.0,20.0
31740,3,1740,[ 64 318 301 313  11],416,5,7280,4.18150488225158,60.0,20.0
31741,3,1741,[ 22  89 183 173 195],62,5,7285,4.1819747416762345,0.0,0.0
31742,3,1742,[265 117 313  95 202],618,3,7288,4.181296615031555,20.0,20.0
31743,3,1743,[ 64 318 301 313  11],43,5,7293,4.1817660550458715,60.0,20.0
31744,3,1744,[ 22 496 179 215 151],373,4,7297,4.1816618911174785,0.0,0.0
31745,3,1745,[323   9 174 257 423],43,4,7301,4.1815578465063,0.0,0.0
31746,3,1746,[ 25 385 265 238 173],373,4,7305,4.181453921007441,0.0,0.0
31747,3,1747,[357 151  70 603 180],373,4,7309,4.181350114416476,0.0,0.0
31748,3,1748,[  9 238 286 322 300],416,4,7313,4.181246426529445,0.0,0.0
31749,3,1749,[ 64 318 301 313  11],416,5,7318,4.1817142857142855,60.0,20.0
31750,3,1750,[ 64 318 301 313  11],416,5,7323,4.182181610508281,60.0,20.0
31751,3,1751,[144 211 173  50 181],43,5,7328,4.1826484018264845,0.0,40.0
31752,3,1752,[ 64 318 301 313  11],345,5,7333,4.18311466058186,60.0,20.0
31753,3,1753,[196 257 118 568 143],416,3,7336,4.1824401368301025,0.0,0.0
31754,3,1754,[234  50 195   1 313],642,3,7339,4.181766381766382,20.0,40.0
31755,3,1755,[ 64 318 301 313  11],345,5,7344,4.182232346241458,60.0,20.0
31756,3,1756,[245 173 323 234 183],416,3,7347,4.181559476380193,0.0,0.0
31757,3,1757,[323 237  79 191 475],416,2,7349,4.180318543799772,0.0,0.0
31758,3,1758,[ 64 318 301 313  11],416,5,7354,4.180784536668562,60.0,20.0
31759,3,1759,[ 64 318 301 313  11],345,5,7359,4.18125,60.0,20.0
31760,3,1760,[ 64 318 301 313  11],43,5,7364,4.1817149346961955,60.0,20.0
31761,3,1761,[475 121 202  11 100],805,2,7366,4.180476730987515,0.0,0.0
31762,3,1762,[271  89 269 282 603],854,4,7370,4.180374361883154,0.0,0.0
31763,3,1763,[ 64 318 301 313  11],43,5,7375,4.180839002267573,60.0,20.0
31764,3,1764,[ 96   7  28   8 603],416,5,7380,4.181303116147308,0.0,0.0
31765,3,1765,[ 88   1  71 403 210],642,5,7385,4.181766704416761,0.0,0.0
31766,3,1766,[234  22  15 423 195],416,5,7390,4.182229767968308,0.0,0.0
31767,3,1767,[195 318 187 508 174],214,5,7395,4.1826923076923075,20.0,0.0
31768,3,1768,[ 64 318 301 313  11],43,5,7400,4.183154324477106,60.0,20.0
31769,3,1769,[357 173  70 176 318],198,4,7404,4.183050847457627,20.0,0.0
31770,3,1770,[135 238 216  56 597],618,3,7407,4.182382834556748,0.0,0.0
31771,3,1771,[ 64 318 301 313  11],345,5,7412,4.182844243792325,60.0,20.0
31772,3,1772,[ 64 318 301 313  11],43,5,7417,4.183305132543711,60.0,20.0
31773,3,1773,[ 70 100 125 191 204],618,2,7419,4.182074408117249,0.0,0.0
31774,3,1774,[302  71 275 597 215],43,4,7423,4.1819718309859155,0.0,0.0
31775,3,1775,[ 64 318 301 313  11],416,5,7428,4.1824324324324325,60.0,20.0
31776,3,1776,[ 64 318 301 313  11],43,5,7433,4.182892515475521,60.0,20.0
31777,3,1777,[ 64 318 301 313  11],345,5,7438,4.183352080989876,60.0,20.0
31778,3,1778,[ 64 318 301 313  11],43,5,7443,4.1838111298482294,60.0,20.0
31779,3,1779,[ 64 318 301 313  11],416,5,7448,4.1842696629213485,60.0,20.0
31780,3,1780,[ 64 318 301 313  11],345,5,7453,4.184727681078046,60.0,20.0
31781,3,1781,[ 64 318 301 313  11],345,5,7458,4.185185185185185,60.0,20.0
31782,3,1782,[135 211  96 174 423],875,5,7463,4.185642176107684,0.0,0.0
31783,3,1783,[ 64 318 301 313  11],345,5,7468,4.186098654708521,60.0,20.0
31784,3,1784,[ 64 318 301 313  11],43,5,7473,4.18655462184874,60.0,20.0
31785,3,1785,[117 313  96 258 301],907,5,7478,4.187010078387458,20.0,20.0
31786,3,1786,[ 64 318 301 313  11],416,5,7483,4.1874650251818695,60.0,20.0
31787,3,1787,[ 64 318 301 313  11],43,5,7488,4.1879194630872485,60.0,20.0
31788,3,1788,[176 271 294 174 228],922,3,7491,4.187255449972051,0.0,0.0
31789,3,1789,[ 64 318 301 313  11],43,5,7496,4.187709497206704,60.0,20.0
31790,3,1790,[ 64 318 301 313  11],43,5,7501,4.188163037409269,60.0,20.0
31791,3,1791,[ 64 318 301 313  11],345,5,7506,4.188616071428571,60.0,20.0
31792,3,1792,[ 64 318 301 313  11],345,5,7511,4.189068600111545,60.0,20.0
31793,3,1793,[183 588 176 289 174],416,4,7515,4.188963210702341,0.0,0.0
31794,3,1794,[ 64 318 301 313  11],345,5,7520,4.18941504178273,60.0,20.0
31795,3,1795,[ 64 318 301 313  11],345,5,7525,4.189866369710468,60.0,20.0
31796,3,1796,[ 64 318 301 313  11],345,5,7530,4.190317195325543,60.0,20.0
31797,3,1797,[118 742 385  98 181],751,3,7533,4.189655172413793,0.0,40.0
31798,3,1798,[ 64 318 301 313  11],345,5,7538,4.190105614230128,60.0,20.0
31799,3,1799,[151 176 300  96 496],416,4,7542,4.19,0.0,0.0
31800,3,1800,[ 28  50  82 568 182],62,3,7545,4.189339255968906,0.0,20.0
31801,3,1801,[245 204 202 265 127],416,4,7549,4.189234184239734,0.0,0.0
31802,3,1802,[546   9 258 222  98],43,5,7554,4.189683860232945,0.0,20.0
31803,3,1803,[546 269  95 282 153],654,4,7558,4.189578713968958,0.0,0.0
31804,3,1804,[288 125 210 385 191],642,4,7562,4.189473684210526,0.0,20.0
31805,3,1805,[191 288 273 271 275],62,3,7565,4.188815060908084,0.0,20.0
31806,3,1806,[ 64 318 301 313  11],416,5,7570,4.189263973436636,60.0,20.0
31807,3,1807,[117 405  98 182 748],198,2,7572,4.188053097345133,0.0,20.0
31808,3,1808,[ 64 318 301 313  11],345,5,7577,4.188501934770591,60.0,20.0
31809,3,1809,[  7 175 127 286  97],43,4,7581,4.188397790055249,0.0,0.0
31810,3,1810,[195  70 597 216 173],416,4,7585,4.188293760353396,0.0,0.0
31811,3,1811,[ 64 318 301 313  11],43,5,7590,4.188741721854305,60.0,20.0
31812,3,1812,[ 64 318 301 313  11],345,5,7595,4.1891891891891895,60.0,20.0
31813,3,1813,[269  64 173 202 294],416,5,7600,4.189636163175304,20.0,0.0
31814,3,1814,[183 132  95 118 125],417,5,7605,4.190082644628099,0.0,0.0
31815,3,1815,[ 64 318 301 313  11],416,5,7610,4.190528634361233,60.0,20.0
31816,3,1816,[ 64 318 301 313  11],416,5,7615,4.190974133186571,60.0,20.0
31817,3,1817,[ 64 318 301 313  11],43,5,7620,4.191419141914191,60.0,20.0
31818,3,1818,[ 64 318 301 313  11],416,5,7625,4.191863661352391,60.0,20.0
31819,3,1819,[ 69 181 282 597 475],588,3,7628,4.191208791208791,0.0,20.0
31820,3,1820,[ 64 318 301 313  11],345,5,7633,4.191652937946183,60.0,20.0
31821,3,1821,[ 98   1 282  11  12],297,3,7636,4.190998902305159,20.0,20.0
31822,3,1822,[ 64 318 301 313  11],345,5,7641,4.191442676906199,60.0,20.0
31823,3,1823,[ 64 318 301 313  11],345,5,7646,4.191885964912281,60.0,20.0
31824,3,1824,[ 64 318 301 313  11],416,5,7651,4.192328767123287,60.0,20.0
31825,3,1825,[ 64 318 301 313  11],416,5,7656,4.192771084337349,60.0,20.0
31826,3,1826,[333 191   8 269 294],721,2,7658,4.1915708812260535,0.0,0.0
31827,3,1827,[276 228 323 176 191],198,2,7660,4.190371991247265,0.0,0.0
31828,3,1828,[ 95 125 228  50 132],505,2,7662,4.189174412247129,0.0,20.0
31829,3,1829,[ 64 318 301 313  11],43,5,7667,4.189617486338798,60.0,20.0
31830,3,1830,[ 64 318 301 313  11],43,5,7672,4.19006007646095,60.0,20.0
31831,3,1831,[174 216 238 427 172],198,5,7677,4.190502183406114,0.0,0.0
31832,3,1832,[385  95 186  15 182],198,2,7679,4.189307146753955,0.0,0.0
31833,3,1833,[  1 111  25   4 423],805,2,7681,4.188113413304253,0.0,0.0
31834,3,1834,[151  64 197 269 174],416,4,7685,4.1880108991825615,20.0,0.0
31835,3,1835,[181 289 322 475  12],416,2,7687,4.18681917211329,20.0,20.0
31836,3,1836,[179 100 357 118 588],417,3,7690,4.186173108328797,0.0,0.0
31837,3,1837,[ 64 318 301 313  11],345,5,7695,4.186615886833515,60.0,20.0
31838,3,1838,[ 25 313 174 237  96],618,3,7698,4.185970636215335,20.0,20.0
31839,3,1839,[238 234 161 195 228],198,1,7699,4.184239130434783,0.0,0.0
31840,3,1840,[216 196  70 302  56],297,5,7704,4.184682237914177,0.0,0.0
31841,3,1841,[ 64 318 301 313  11],416,5,7709,4.185124864277959,60.0,20.0
31842,3,1842,[195  95 275   9  79],416,4,7713,4.185024416711883,0.0,0.0
31843,3,1843,[200 191 204 216  15],416,5,7718,4.185466377440347,0.0,0.0
31844,3,1844,[ 64 318 301 313  11],345,5,7723,4.185907859078591,60.0,20.0
31845,3,1845,[179  12  89 151 228],805,4,7727,4.185807150595883,20.0,0.0
31846,3,1846,[742 179 174 282 210],416,4,7731,4.18570655116405,0.0,0.0
31847,3,1847,[  4  69 748 100   9],345,4,7735,4.1856060606060606,0.0,0.0
31848,3,1848,[  1 197  50 196 475],297,3,7738,4.184964845862629,0.0,20.0
31849,3,1849,[ 64 318 301 313  11],416,5,7743,4.1854054054054055,60.0,20.0
31850,3,1850,[ 64 318 301 313  11],416,5,7748,4.1858454889249055,60.0,20.0
31851,3,1851,[ 64 318 301 313  11],43,5,7753,4.186285097192225,60.0,20.0
31852,3,1852,[ 64 318 301 313  11],345,5,7758,4.186724230976794,60.0,20.0
31853,3,1853,[ 28 197  79 173 235],297,2,7760,4.18554476806904,0.0,0.0
31854,3,1854,[515 194 265 313  82],416,5,7765,4.185983827493262,20.0,20.0
31855,3,1855,[ 64 318 301 313  11],345,5,7770,4.186422413793103,60.0,20.0
31856,3,1856,[ 64 318 301 313  11],345,5,7775,4.186860527732903,60.0,20.0
31857,3,1857,[ 64 318 301 313  11],416,5,7780,4.1872981700753495,60.0,20.0
31858,3,1858,[ 64 318 301 313  11],345,5,7785,4.1877353415814955,60.0,20.0
31859,3,1859,[ 64 318 301 313  11],416,5,7790,4.188172043010753,60.0,20.0
31860,3,1860,[ 64 318 301 313  11],416,5,7795,4.188608275120902,60.0,20.0
31861,3,1861,[546 151 302 265 197],297,1,7796,4.186895810955962,0.0,0.0
31862,3,1862,[ 64 318 301 313  11],416,5,7801,4.187332259796028,60.0,20.0
31863,3,1863,[ 64 318 301 313  11],345,5,7806,4.187768240343348,60.0,20.0
31864,3,1864,[ 64 318 301 313  11],43,5,7811,4.188203753351207,60.0,20.0
31865,3,1865,[ 64 318 301 313  11],43,5,7816,4.188638799571275,60.0,20.0
31866,3,1866,[597 405 132 271 168],854,4,7820,4.188537761114087,0.0,0.0
31867,3,1867,[ 64 318 301 313  11],416,5,7825,4.1889721627409,60.0,20.0
31868,3,1868,[ 64 318 301 313  11],416,5,7830,4.189406099518459,60.0,20.0
31869,3,1869,[196 182 194 127  22],416,5,7835,4.189839572192513,0.0,0.0
31870,3,1870,[ 64 318 301 313  11],43,5,7840,4.190272581507215,60.0,20.0
31871,3,1871,[ 25 238 483 168 210],618,2,7842,4.189102564102564,20.0,0.0
31872,3,1872,[ 64 318 301 313  11],345,5,7847,4.189535504538174,60.0,20.0
31873,3,1873,[597 191 235 405 508],62,3,7850,4.188900747065102,0.0,0.0
31874,3,1874,[318  82  25 143 182],416,5,7855,4.189333333333333,20.0,0.0
31875,3,1875,[ 64 318 301 313  11],345,5,7860,4.189765458422174,60.0,20.0
31876,3,1876,[ 64 318 301 313  11],43,5,7865,4.190197123068726,60.0,20.0
31877,3,1877,[216 427 174  98 423],416,5,7870,4.19062832800852,0.0,20.0
31878,3,1878,[ 28 289 328 161 204],416,4,7874,4.190526875997871,0.0,0.0
31879,3,1879,[258 161  95 257 228],711,3,7877,4.189893617021276,0.0,0.0
31880,3,1880,[174  97 357  56 135],417,3,7880,4.189261031366295,0.0,0.0
31881,3,1881,[ 64 318 301 313  11],345,5,7885,4.189691817215728,60.0,20.0
31882,3,1882,[ 64 318 301 313  11],345,5,7890,4.19012214551248,60.0,20.0
31883,3,1883,[ 64 318 301 313  11],416,5,7895,4.190552016985138,60.0,20.0
31884,3,1884,[ 64 318 301 313  11],345,5,7900,4.190981432360743,60.0,20.0
31885,3,1885,[748 235 273   4  12],417,2,7902,4.1898197242842,20.0,0.0
31886,3,1886,[195  22  64  89 197],405,4,7906,4.189719130895601,20.0,0.0
31887,3,1887,[ 64 318 301 313  11],345,5,7911,4.190148305084746,60.0,20.0
31888,3,1888,[ 64 318 301 313  11],345,5,7916,4.19057702488089,60.0,20.0
31889,3,1889,[ 64 318 301 313  11],43,5,7921,4.191005291005291,60.0,20.0
31890,3,1890,[603 258 742 173 300],128,3,7924,4.190375462718139,0.0,0.0
31891,3,1891,[ 64 318 301 313  11],345,5,7929,4.190803382663848,60.0,20.0
31892,3,1892,[268 471 588 265  97],588,4,7933,4.190702588483888,0.0,0.0
31893,3,1893,[ 69 300 515 678  22],297,2,7935,4.189545934530095,0.0,0.0
31894,3,1894,[ 64 318 301 313  11],43,5,7940,4.189973614775726,60.0,20.0
31895,3,1895,[ 64 318 301 313  11],416,5,7945,4.190400843881856,60.0,20.0
31896,3,1896,[ 28 483 258 234 318],588,5,7950,4.19082762256194,40.0,0.0
31897,3,1897,[168 174 286 471 125],588,3,7953,4.190200210748156,0.0,0.0
31898,3,1898,[ 64 318 301 313  11],345,5,7958,4.190626645602949,60.0,20.0
31899,3,1899,[  7 151  64 179 183],198,5,7963,4.191052631578947,20.0,0.0
31900,3,1900,[588 301 235 282 403],345,1,7964,4.189374013677012,0.0,0.0
31901,3,1901,[117 237   9 273  56],62,4,7968,4.1892744479495265,0.0,0.0
31902,3,1902,[ 88 197 234  89 187],405,3,7971,4.188649500788229,0.0,0.0
31903,3,1903,[ 64 318 301 313  11],43,5,7976,4.189075630252101,60.0,20.0
31904,3,1904,[ 64 318 301 313  11],416,5,7981,4.189501312335958,60.0,20.0
31905,3,1905,[ 64 318 301 313  11],43,5,7986,4.1899265477439664,60.0,20.0
31906,3,1906,[ 64 318 301 313  11],43,5,7991,4.190351337178815,60.0,20.0
31907,3,1907,[ 64 318 301 313  11],43,5,7996,4.190775681341719,60.0,20.0
31908,3,1908,[ 64 318 301 313  11],416,5,8001,4.191199580932425,60.0,20.0
31909,3,1909,[ 64 318 301 313  11],416,5,8006,4.191623036649215,60.0,20.0
31910,3,1910,[ 64 318 301 313  11],43,5,8011,4.192046049188907,60.0,20.0
31911,3,1911,[ 98 191 216 405 655],416,5,8016,4.192468619246862,0.0,20.0
31912,3,1912,[385 200 234 211  15],416,5,8021,4.192890747516989,0.0,0.0
31913,3,1913,[ 88  89 269 588 271],805,2,8023,4.191745036572623,0.0,0.0
31914,3,1914,[ 64 318 301 313  11],345,5,8028,4.1921671018276765,60.0,20.0
31915,3,1915,[235 118 318 168 228],887,4,8032,4.192066805845512,20.0,0.0
31916,3,1916,[405 228  25 168 603],128,3,8035,4.191444966092853,0.0,0.0
31917,3,1917,[ 64 318 301 313  11],345,5,8040,4.191866527632951,60.0,20.0
31918,3,1918,[ 64 318 301 313  11],416,5,8045,4.192287649817613,60.0,20.0
31919,3,1919,[ 64 318 301 313  11],345,5,8050,4.192708333333333,60.0,20.0
31920,3,1920,[ 64 318 301 313  11],416,5,8055,4.193128578865174,60.0,20.0
31921,3,1921,[117  71 151 121 202],128,3,8058,4.192507804370448,0.0,0.0
31922,3,1922,[ 64 318 301 313  11],416,5,8063,4.1929277171086845,60.0,20.0
31923,3,1923,[ 64 318 301 313  11],416,5,8068,4.1933471933471935,60.0,20.0
31924,3,1924,[ 64 318 301 313  11],416,5,8073,4.193766233766234,60.0,20.0
31925,3,1925,[ 64 318 301 313  11],43,5,8078,4.194184839044652,60.0,20.0
31926,3,1926,[ 64 318 301 313  11],345,5,8083,4.194603009859886,60.0,20.0
31927,3,1927,[215 748 300 195 202],416,5,8088,4.195020746887967,0.0,0.0
31928,3,1928,[ 25  70 195 294   1],417,4,8092,4.194919647485744,0.0,0.0
31929,3,1929,[ 64 318 301 313  11],345,5,8097,4.1953367875647665,60.0,20.0
31930,3,1930,[ 64 318 301 313  11],345,5,8102,4.195753495598136,60.0,20.0
31931,3,1931,[ 64 318 301 313  11],416,5,8107,4.196169772256729,60.0,20.0
31932,3,1932,[ 64 318 301 313  11],345,5,8112,4.196585618210036,60.0,20.0
31933,3,1933,[ 64 318 301 313  11],345,5,8117,4.197001034126163,60.0,20.0
31934,3,1934,[ 64 318 301 313  11],43,5,8122,4.1974160206718345,60.0,20.0
31935,3,1935,[ 64 318 301 313  11],43,5,8127,4.197830578512397,60.0,20.0
31936,3,1936,[ 64 318 301 313  11],345,5,8132,4.198244708311822,60.0,20.0
31937,3,1937,[ 64 318 301 313  11],43,5,8137,4.1986584107327145,60.0,20.0
31938,3,1938,[ 64 318 301 313  11],345,5,8142,4.199071686436308,60.0,20.0
31939,3,1939,[ 64 286 323  50 172],417,2,8144,4.197938144329897,20.0,20.0
31940,3,1940,[ 64 318 301 313  11],43,5,8149,4.198351365275631,60.0,20.0
31941,3,1941,[ 64 318 301 313  11],43,5,8154,4.198764160659114,60.0,20.0
31942,3,1942,[ 64 318 301 313  11],345,5,8159,4.199176531137416,60.0,20.0
31943,3,1943,[ 64 318 301 313  11],43,5,8164,4.199588477366255,60.0,20.0
31944,3,1944,[ 64 318 301 313  11],345,5,8169,4.2,60.0,20.0
31945,3,1945,[ 64 318 301 313  11],416,5,8174,4.200411099691675,60.0,20.0
31946,3,1946,[269 318 200 294 273],416,5,8179,4.200821777092964,20.0,0.0
31947,3,1947,[  4  64 127 475  79],854,4,8183,4.200718685831622,20.0,0.0
31948,3,1948,[ 64 318 301 313  11],43,5,8188,4.20112878399179,60.0,20.0
31949,3,1949,[ 64 318 301 313  11],416,5,8193,4.201538461538462,60.0,20.0
31950,3,1950,[ 64 318 301 313  11],43,5,8198,4.201947719118401,60.0,20.0
31951,3,1951,[ 64 318 301 313  11],416,5,8203,4.202356557377049,60.0,20.0
31952,3,1952,[153 568  88 405 323],751,2,8205,4.201228878648234,0.0,0.0
31953,3,1953,[172 237 197   8  11],416,4,8209,4.201125895598771,0.0,0.0
31954,3,1954,[403 180  70 173  79],405,3,8212,4.200511508951407,0.0,0.0
31955,3,1955,[121 180 742 238 237],128,4,8216,4.2004089979550105,0.0,0.0
31956,3,1956,[ 64 318 301 313  11],345,5,8221,4.200817577925396,60.0,20.0
31957,3,1957,[ 64 318 301 313  11],416,5,8226,4.201225740551584,60.0,20.0
31958,3,1958,[ 64 318 301 313  11],43,5,8231,4.20163348647269,60.0,20.0
31959,3,1959,[496  98  50 216 546],416,4,8235,4.201530612244898,0.0,40.0
31960,3,1960,[ 64 318 301 313  11],345,5,8240,4.201937786843447,60.0,20.0
31961,3,1961,[ 64 318 301 313  11],345,5,8245,4.202344546381243,60.0,20.0
31962,3,1962,[ 64 318 301 313  11],416,5,8250,4.202750891492613,60.0,20.0
31963,3,1963,[ 64 318 301 313  11],43,5,8255,4.20315682281059,60.0,20.0
31964,3,1964,[ 97   1 121  50 176],416,5,8260,4.203562340966921,0.0,20.0
31965,3,1965,[144   8 258  11 546],416,4,8264,4.203458799593083,0.0,0.0
31966,3,1966,[ 64 111 302 742 403],43,5,8269,4.203863751906456,20.0,0.0
31967,3,1967,[117 182  28 172 202],437,2,8271,4.202743902439025,0.0,0.0
31968,3,1968,[ 64 318 301 313  11],416,5,8276,4.203148806500762,60.0,20.0
31969,3,1969,[ 64 318 301 313  11],43,5,8281,4.203553299492386,60.0,20.0
31970,3,1970,[ 64 318 301 313  11],345,5,8286,4.203957382039574,60.0,20.0
31971,3,1971,[ 71 238  70 216 597],62,3,8289,4.203346855983773,0.0,0.0
31972,3,1972,[ 64 318 301 313  11],416,5,8294,4.203750633552965,60.0,20.0
31973,3,1973,[ 64 318 301 313  11],345,5,8299,4.204154002026343,60.0,20.0
31974,3,1974,[ 11 302  56 179 132],214,5,8304,4.2045569620253165,0.0,0.0
31975,3,1975,[ 64 318 301 313  11],345,5,8309,4.20495951417004,60.0,20.0
31976,3,1976,[ 64 318 301 313  11],345,5,8314,4.205361659079413,60.0,20.0
31977,3,1977,[  4 143 151 471 294],297,1,8315,4.203741152679474,0.0,0.0
31978,3,1978,[ 64 318 301 313  11],345,5,8320,4.2041435068216275,60.0,20.0
31979,3,1979,[ 64 318 301 313  11],416,5,8325,4.204545454545454,60.0,20.0
31980,3,1980,[ 64 318 301 313  11],416,5,8330,4.204946996466431,60.0,20.0
31981,3,1981,[ 64 318 301 313  11],43,5,8335,4.205348133198789,60.0,20.0
31982,3,1982,[ 64 318 301 313  11],416,5,8340,4.205748865355522,60.0,20.0
31983,3,1983,[168 282 182   4 322],416,4,8344,4.205645161290323,0.0,0.0
31984,3,1984,[ 64 318 301 313  11],416,5,8349,4.206045340050378,60.0,20.0
31985,3,1985,[265 176 117 238 496],437,2,8351,4.204934541792547,0.0,0.0
31986,3,1986,[ 64 318 301 313  11],345,5,8356,4.205334675390035,60.0,20.0
31987,3,1987,[ 64 318 301 313  11],43,5,8361,4.205734406438632,60.0,20.0
31988,3,1988,[234   7  96  22 405],262,3,8364,4.205128205128205,0.0,0.0
31989,3,1989,[237 144 127 597  69],854,2,8366,4.204020100502513,0.0,0.0
31990,3,1990,[143 294 228 183  28],805,1,8367,4.202410848819689,0.0,0.0
31991,3,1991,[215 228  28 742 151],128,1,8368,4.2008032128514055,0.0,0.0
31992,3,1992,[ 64 318 301 313  11],416,5,8373,4.20120421475163,60.0,20.0
31993,3,1993,[181 655 175 211 568],373,4,8377,4.201103309929789,0.0,20.0
31994,3,1994,[ 64 318 301 313  11],416,5,8382,4.201503759398496,60.0,20.0
31995,3,1995,[ 97   1 182 172 357],416,5,8387,4.20190380761523,0.0,0.0
31996,3,1996,[475  50 275  12 288],437,3,8390,4.201301952929394,20.0,40.0
31997,3,1997,[144 282 294  11 385],416,5,8395,4.201701701701702,0.0,0.0
31998,3,1998,[  8 222 748  71 127],805,1,8396,4.2001000500250125,0.0,0.0
31999,3,1999,[302 742 117 286 194],297,3,8399,4.1995,0.0,0.0
32000,3,2000,[  1 403 238 235 195],416,4,8403,4.199400299850075,0.0,0.0
32001,3,2001,[ 64 318 301 313  11],345,5,8408,4.1998001998002,60.0,20.0
32002,3,2002,[ 64 318 301 313  11],345,5,8413,4.200199700449326,60.0,20.0
32003,3,2003,[ 64 318 301 313  11],345,5,8418,4.200598802395209,60.0,20.0
32004,3,2004,[ 97  79 427 357 132],230,5,8423,4.200997506234414,0.0,0.0
32005,3,2005,[200 288 475  50  69],854,5,8428,4.201395812562313,0.0,40.0
32006,3,2006,[ 64 318 301 313  11],416,5,8433,4.201793721973094,60.0,20.0
32007,3,2007,[ 64 318 301 313  11],345,5,8438,4.202191235059761,60.0,20.0
32008,3,2008,[ 64 318 301 313  11],416,5,8443,4.2025883524141365,60.0,20.0
32009,3,2009,[  4 183 234 403 427],198,3,8446,4.2019900497512435,0.0,0.0
32010,3,2010,[245 151  71 257 132],642,3,8449,4.201392342118349,0.0,0.0
32011,3,2011,[ 22 185 143 117  70],416,5,8454,4.201789264413519,0.0,0.0
32012,3,2012,[ 25 237 182   7 202],297,3,8457,4.2011922503725785,0.0,0.0
32013,3,2013,[ 64 318 301 313  11],416,5,8462,4.201588877855015,60.0,20.0
32014,3,2014,[ 15 185 182  50 111],437,3,8465,4.200992555831266,0.0,20.0
32015,3,2015,[ 64 318 301 313  11],416,5,8470,4.201388888888889,60.0,20.0
32016,3,2016,[ 22 151 195 179  70],373,4,8474,4.201289043133366,0.0,0.0
32017,3,2017,[222 269 322  69 197],854,4,8478,4.201189296333003,0.0,0.0
32018,3,2018,[ 64 318 301 313  11],345,5,8483,4.20158494304111,60.0,20.0
32019,3,2019,[568 405 176 385 471],416,5,8488,4.201980198019802,0.0,0.0
32020,3,2020,[ 64 318 301 313  11],43,5,8493,4.202375061850569,60.0,20.0
32021,3,2021,[ 64 318 301 313  11],43,5,8498,4.202769535113749,60.0,20.0
32022,3,2022,[ 98 603 161 210 215],751,4,8502,4.202669303015324,0.0,20.0
32023,3,2023,[ 95 195 475 655 168],805,2,8504,4.201581027667984,0.0,0.0
32024,3,2024,[273 568 191 228  89],417,2,8506,4.200493827160494,0.0,0.0
32025,3,2025,[ 64 318 301 313  11],416,5,8511,4.200888450148075,60.0,20.0
32026,3,2026,[258 135 117 288 191],805,2,8513,4.199802664035521,0.0,20.0
32027,3,2027,[ 64 318 301 313  11],43,5,8518,4.200197238658777,60.0,20.0
32028,3,2028,[313  50 237 121 234],416,4,8522,4.200098570724495,20.0,40.0
32029,3,2029,[496 238  25  79   4],43,4,8526,4.2,0.0,0.0
32030,3,2030,[471 328  82 238 144],416,5,8531,4.200393894633185,0.0,0.0
32031,3,2031,[286  64  95 678 195],416,3,8534,4.199803149606299,20.0,0.0
32032,3,2032,[ 64 318 301 313  11],416,5,8539,4.200196753566158,60.0,20.0
32033,3,2033,[ 64 318 301 313  11],416,5,8544,4.200589970501475,60.0,20.0
32034,3,2034,[ 64 318 301 313  11],416,5,8549,4.200982800982801,60.0,20.0
32035,3,2035,[ 64 318 301 313  11],416,5,8554,4.201375245579568,60.0,20.0
32036,3,2036,[ 64 318 301 313  11],416,5,8559,4.2017673048600885,60.0,20.0
32037,3,2037,[ 64 318 301 313  11],416,5,8564,4.202158979391561,60.0,20.0
32038,3,2038,[ 64 318 301 313  11],345,5,8569,4.202550269740069,60.0,20.0
32039,3,2039,[385 300 294 235 268],49,0,8569,4.200490196078431,0.0,0.0
32040,3,2040,[ 64 318 301 313  11],416,5,8574,4.200881920627143,60.0,20.0
32041,3,2041,[ 64 318 301 313  11],43,5,8579,4.201273261508325,60.0,20.0
32042,3,2042,[ 50 357 228 144   4],62,3,8582,4.2006852667645616,0.0,20.0
32043,3,2043,[ 64 318 301 313  11],416,5,8587,4.201076320939334,60.0,20.0
32044,3,2044,[257 176 568  71  15],62,2,8589,4.2,0.0,0.0
32045,3,2045,[100 121 655 318 286],416,5,8594,4.20039100684262,20.0,0.0
32046,3,2046,[ 25 238 655  70 289],416,4,8598,4.200293111871031,0.0,0.0
32047,3,2047,[ 64 318 301 313  11],43,5,8603,4.20068359375,60.0,20.0
32048,3,2048,[ 64 318 301 313  11],345,5,8608,4.201073694485115,60.0,20.0
32049,3,2049,[427  64  71 323 328],416,4,8612,4.200975609756098,20.0,0.0
32050,3,2050,[ 64 318 301 313  11],43,5,8617,4.201365187713311,60.0,20.0
32051,3,2051,[ 64 318 301 313  11],416,5,8622,4.201754385964913,60.0,20.0
32052,3,2052,[ 64 318 301 313  11],43,5,8627,4.202143205065758,60.0,20.0
32053,3,2053,[ 64 318 301 313  11],416,5,8632,4.2025316455696204,60.0,20.0
32054,3,2054,[180 182 300 151  50],128,4,8636,4.202433090024331,0.0,20.0
32055,3,2055,[ 82 191 197 403 161],805,3,8639,4.201848249027237,0.0,0.0
32056,3,2056,[ 64 318 301 313  11],345,5,8644,4.20223626640739,60.0,20.0
32057,3,2057,[118 237 183 300 268],416,3,8647,4.201652089407191,0.0,0.0
32058,3,2058,[ 64 318 301 313  11],345,5,8652,4.2020398251578435,60.0,20.0
32059,3,2059,[234 144 603 215 111],437,2,8654,4.2009708737864075,0.0,0.0
32060,3,2060,[216 153 427 174 742],642,2,8656,4.199902959728287,0.0,0.0
32061,3,2061,[ 64 318 301 313  11],416,5,8661,4.200290979631426,60.0,20.0
32062,3,2062,[403 182 237 568 222],198,2,8663,4.199224430441105,0.0,0.0
32063,3,2063,[ 64 318 301 313  11],416,5,8668,4.199612403100775,60.0,20.0
32064,3,2064,[ 64 318 301 313  11],43,5,8673,4.2,60.0,20.0
32065,3,2065,[ 69 202 228 238 144],711,2,8675,4.198935140367861,0.0,0.0
32066,3,2066,[121  79   8 423 588],588,4,8679,4.198838896952105,0.0,0.0
32067,3,2067,[ 64 318 301 313  11],345,5,8684,4.199226305609284,60.0,20.0
32068,3,2068,[153 322  11 222 323],417,2,8686,4.198163363943935,0.0,0.0
32069,3,2069,[ 98 135  12 515 234],417,4,8690,4.1980676328502415,20.0,20.0
32070,3,2070,[ 64 318 301 313  11],416,5,8695,4.19845485272815,60.0,20.0
32071,3,2071,[ 64 318 301 313  11],345,5,8700,4.198841698841699,60.0,20.0
32072,3,2072,[ 64 318 301 313  11],345,5,8705,4.199228171731789,60.0,20.0
32073,3,2073,[508 286 181 228 275],62,3,8708,4.198649951783993,0.0,20.0
32074,3,2074,[ 64 318 301 313  11],416,5,8713,4.199036144578313,60.0,20.0
32075,3,2075,[172 187 111 471  70],618,2,8715,4.1979768786127165,0.0,0.0
32076,3,2076,[173 197 603 161 202],437,4,8719,4.197881559942225,0.0,0.0
32077,3,2077,[ 64 318 301 313  11],416,5,8724,4.198267564966314,60.0,20.0
32078,3,2078,[ 28 273 655 546 405],805,0,8724,4.196248196248196,0.0,0.0
32079,3,2079,[ 64 318 301 313  11],345,5,8729,4.196634615384616,60.0,20.0
32080,3,2080,[ 69  97 403  79 117],588,2,8731,4.195579048534358,0.0,0.0
32081,3,2081,[313 215  82 385  28],654,5,8736,4.195965417867435,20.0,20.0
32082,3,2082,[318 182  64 323 597],416,3,8739,4.1953912626020164,40.0,0.0
32083,3,2083,[475 655  89  56 172],198,5,8744,4.1957773512476,0.0,0.0
32084,3,2084,[ 64 318 301 313  11],43,5,8749,4.196163069544364,60.0,20.0
32085,3,2085,[216   4   1 289 257],854,0,8749,4.194151486097795,0.0,0.0
32086,3,2086,[ 64 318 301 313  11],43,5,8754,4.194537613799713,60.0,20.0
32087,3,2087,[ 64 318 301 313  11],43,5,8759,4.194923371647509,60.0,20.0
32088,3,2088,[ 64 318 301 313  11],43,5,8764,4.195308760172331,60.0,20.0
32089,3,2089,[ 64 318 301 313  11],416,5,8769,4.195693779904306,60.0,20.0
32090,3,2090,[144  98   8 294 174],588,2,8771,4.1946437111429935,0.0,20.0
32091,3,2091,[405 132 323 483 153],417,3,8774,4.194072657743786,20.0,0.0
32092,3,2092,[174 301 168 265 403],416,5,8779,4.194457716196847,0.0,0.0
32093,3,2093,[ 64 318 301 313  11],43,5,8784,4.19484240687679,60.0,20.0
32094,3,2094,[655 275 195 235 597],416,3,8787,4.194272076372315,0.0,0.0
32095,3,2095,[187 403 127 202 357],405,5,8792,4.194656488549619,0.0,0.0
32096,3,2096,[161  71 117 328   1],416,5,8797,4.195040534096328,0.0,0.0
32097,3,2097,[ 69 748  12  11   7],417,3,8800,4.194470924690181,20.0,0.0
32098,3,2098,[ 64 318 301 313  11],416,5,8805,4.194854692710814,60.0,20.0
32099,3,2099,[ 64 318 301 313  11],43,5,8810,4.195238095238095,60.0,20.0
32100,3,2100,[301  50 655 748 245],345,3,8813,4.19466920514041,0.0,20.0
32101,3,2101,[ 64 318 301 313  11],345,5,8818,4.195052331113225,60.0,20.0
32102,3,2102,[174   9 286 182 179],342,4,8822,4.194959581550166,0.0,0.0
32103,3,2103,[ 64 318 301 313  11],43,5,8827,4.195342205323194,60.0,20.0
32104,3,2104,[276 168  11 132 496],230,5,8832,4.195724465558195,0.0,0.0
32105,3,2105,[182 423 328 173 385],505,3,8835,4.195156695156695,0.0,0.0
32106,3,2106,[ 64 318 301 313  11],416,5,8840,4.195538680588514,60.0,20.0
32107,3,2107,[173 234   1 100 222],253,5,8845,4.195920303605313,0.0,0.0
32108,3,2108,[ 64 318 301 313  11],416,5,8850,4.196301564722617,60.0,20.0
32109,3,2109,[ 64 318 301 313  11],43,5,8855,4.196682464454977,60.0,20.0
32110,3,2110,[ 64 318 301 313  11],43,5,8860,4.197063003315964,60.0,20.0
32111,3,2111,[ 64 318 301 313  11],345,5,8865,4.197443181818182,60.0,20.0
32112,3,2112,[ 64 318 301 313  11],345,5,8870,4.197823000473261,60.0,20.0
32113,3,2113,[ 64 318 301 313  11],43,5,8875,4.1982024597918635,60.0,20.0
32114,3,2114,[655 268 588 515 273],416,5,8880,4.198581560283688,0.0,0.0
32115,3,2115,[ 64 318 301 313  11],43,5,8885,4.198960302457467,60.0,20.0
32116,3,2116,[ 64 318 301 313  11],345,5,8890,4.199338686820973,60.0,20.0
32117,3,2117,[ 64 318 301 313  11],345,5,8895,4.19971671388102,60.0,20.0
32118,3,2118,[215 301 211 196  50],43,5,8900,4.200094384143464,0.0,20.0
32119,3,2119,[427 235 603 405 127],416,4,8904,4.2,0.0,0.0
32120,3,2120,[ 89 117 144 121 294],62,3,8907,4.199434229137199,0.0,0.0
32121,3,2121,[245 204 197  95 191],416,3,8910,4.198868991517436,0.0,0.0
32122,3,2122,[ 64 318 301 313  11],416,5,8915,4.199246349505417,60.0,20.0
32123,3,2123,[ 64 318 301 313  11],345,5,8920,4.199623352165725,60.0,20.0
32124,3,2124,[ 64 318 301 313  11],43,5,8925,4.2,60.0,20.0
32125,3,2125,[181  95 144 405  12],654,4,8929,4.199905926622765,20.0,20.0
32126,3,2126,[ 64 318 301 313  11],43,5,8934,4.200282087447109,60.0,20.0
32127,3,2127,[ 64 318 301 313  11],43,5,8939,4.2006578947368425,60.0,20.0
32128,3,2128,[ 64 318 301 313  11],416,5,8944,4.201033348990136,60.0,20.0
32129,3,2129,[288 183 200 204 174],416,5,8949,4.201408450704226,0.0,20.0
32130,3,2130,[ 64 318 301 313  11],43,5,8954,4.20178320037541,60.0,20.0
32131,3,2131,[161 228 234  25 273],805,2,8956,4.200750469043152,0.0,0.0
32132,3,2132,[ 64 318 301 313  11],416,5,8961,4.20112517580872,60.0,20.0
32133,3,2133,[ 64 318 301 313  11],345,5,8966,4.201499531396439,60.0,20.0
32134,3,2134,[ 64 318 301 313  11],416,5,8971,4.2018735362997655,60.0,20.0
32135,3,2135,[ 64 318 301 313  11],345,5,8976,4.202247191011236,60.0,20.0
32136,3,2136,[ 64 318 301 313  11],43,5,8981,4.202620496022462,60.0,20.0
32137,3,2137,[ 70 237  11 234 161],437,2,8983,4.201590271281572,0.0,0.0
32138,3,2138,[ 98 194 423   4 143],416,5,8988,4.201963534361852,0.0,20.0
32139,3,2139,[ 64 318 301 313  11],345,5,8993,4.202336448598131,60.0,20.0
32140,3,2140,[ 64 318 301 313  11],345,5,8998,4.202709014479216,60.0,20.0
32141,3,2141,[ 12   4  79 179 588],417,2,9000,4.201680672268908,20.0,0.0
32142,3,2142,[222   1  69  71  89],764,5,9005,4.20205319645357,0.0,0.0
32143,3,2143,[ 64 318 301 313  11],43,5,9010,4.202425373134329,60.0,20.0
32144,3,2144,[ 64 318 301 313  11],43,5,9015,4.2027972027972025,60.0,20.0
32145,3,2145,[144  12 172  98 385],805,3,9018,4.2022367194780985,20.0,20.0
32146,3,2146,[ 64 318 301 313  11],43,5,9023,4.2026082906381,60.0,20.0
32147,3,2147,[ 64 318 301 313  11],416,5,9028,4.202979515828678,60.0,20.0
32148,3,2148,[ 64 318 301 313  11],345,5,9033,4.203350395532806,60.0,20.0
32149,3,2149,[ 64 318 301 313  11],416,5,9038,4.203720930232558,60.0,20.0
32150,3,2150,[215  56 216 151 195],654,5,9043,4.204091120409112,0.0,0.0
32151,3,2151,[195 742  70 405 238],654,5,9048,4.204460966542751,0.0,0.0
32152,3,2152,[161 588 176 313 282],618,4,9052,4.204366000928936,20.0,20.0
32153,3,2153,[ 64 318 301 313  11],416,5,9057,4.204735376044568,60.0,20.0
32154,3,2154,[ 64   7 118 546 471],630,4,9061,4.204640371229698,20.0,0.0
32155,3,2155,[ 64 318 301 313  11],416,5,9066,4.205009276437848,60.0,20.0
32156,3,2156,[222 181 258 235 185],297,4,9070,4.204914232730644,0.0,20.0
32157,3,2157,[ 64 318 301 313  11],43,5,9075,4.205282669138091,60.0,20.0
32158,3,2158,[ 64 318 301 313  11],43,5,9080,4.205650764242705,60.0,20.0
32159,3,2159,[ 64 318 301 313  11],345,5,9085,4.206018518518518,60.0,20.0
32160,3,2160,[ 95 151 144  56 228],417,3,9088,4.205460434983804,0.0,0.0
32161,3,2161,[ 64 318 301 313  11],43,5,9093,4.2058279370952825,60.0,20.0
32162,3,2162,[ 64 318 301 313  11],345,5,9098,4.2061950993989825,60.0,20.0
32163,3,2163,[183  12 191 282  82],416,5,9103,4.206561922365989,20.0,0.0
32164,3,2164,[ 64 318 301 313  11],416,5,9108,4.2069284064665124,60.0,20.0
32165,3,2165,[ 64 318 301 313  11],43,5,9113,4.207294552169898,60.0,20.0
32166,3,2166,[200 117  89   8 328],253,5,9118,4.207660359944624,0.0,0.0
32167,3,2167,[195 235 228 118 185],805,1,9119,4.206180811808118,0.0,0.0
32168,3,2168,[328 234 161 323 588],416,4,9123,4.206085753803596,0.0,0.0
32169,3,2169,[403  98 748 175 655],805,3,9126,4.2055299539170505,0.0,20.0
32170,3,2170,[ 64 318 301 313  11],416,5,9131,4.205895900506679,60.0,20.0
32171,3,2171,[ 64 318 301 313  11],416,5,9136,4.206261510128914,60.0,20.0
32172,3,2172,[ 64 318 301 313  11],416,5,9141,4.206626783248964,60.0,20.0
32173,3,2173,[ 64 318 301 313  11],416,5,9146,4.206991720331187,60.0,20.0
32174,3,2174,[ 64 318 301 313  11],43,5,9151,4.207356321839081,60.0,20.0
32175,3,2175,[ 64 318 301 313  11],345,5,9156,4.207720588235294,60.0,20.0
32176,3,2176,[ 64 318 301 313  11],43,5,9161,4.208084519981626,60.0,20.0
32177,3,2177,[603 655  71 182 211],437,3,9164,4.2075298438934805,0.0,0.0
32178,3,2178,[ 64 318 301 313  11],345,5,9169,4.207893529141808,60.0,20.0
32179,3,2179,[176   4  98 215   8],405,4,9173,4.207798165137615,0.0,20.0
32180,3,2180,[ 11 475 135 179 435],437,2,9175,4.206785878037597,0.0,0.0
32181,3,2181,[ 64 318 301 313  11],416,5,9180,4.207149404216315,60.0,20.0
32182,3,2182,[ 64 318 301 313  11],43,5,9185,4.207512597343106,60.0,20.0
32183,3,2183,[183  11 168 282 210],416,5,9190,4.207875457875458,0.0,0.0
32184,3,2184,[151  97 174  56 265],198,3,9193,4.207322654462242,0.0,0.0
32185,3,2185,[ 64 318 301 313  11],416,5,9198,4.207685269899359,60.0,20.0
32186,3,2186,[289 185 182 195 176],416,4,9202,4.207590306355739,0.0,0.0
32187,3,2187,[ 28   7 222  70 100],62,3,9205,4.207038391224863,0.0,0.0
32188,3,2188,[ 79 655   1 748 183],805,3,9208,4.206486980356327,0.0,0.0
32189,3,2189,[ 64 318 301 313  11],43,5,9213,4.206849315068493,60.0,20.0
32190,3,2190,[385 257 121 216 275],43,5,9218,4.207211319032405,0.0,0.0
32191,3,2191,[ 64 318 301 313  11],416,5,9223,4.2075729927007295,60.0,20.0
32192,3,2192,[ 64 318 301 313  11],43,5,9228,4.207934336525308,60.0,20.0
32193,3,2193,[ 64 318 301 313  11],416,5,9233,4.2082953509571555,60.0,20.0
32194,3,2194,[ 64 318 301 313  11],345,5,9238,4.208656036446469,60.0,20.0
32195,3,2195,[ 64 318 301 313  11],345,5,9243,4.209016393442623,60.0,20.0
32196,3,2196,[ 64 318 301 313  11],416,5,9248,4.209376422394174,60.0,20.0
32197,3,2197,[ 64 318 301 313  11],345,5,9253,4.209736123748862,60.0,20.0
32198,3,2198,[471 173 196 748 135],297,3,9256,4.2091859936334695,0.0,0.0
32199,3,2199,[ 64 318 301 313  11],43,5,9261,4.209545454545455,60.0,20.0
32200,3,2200,[237 196 568 172 168],43,5,9266,4.209904588823262,0.0,0.0
32201,3,2201,[ 15  28 275 313 100],43,5,9271,4.210263396911898,20.0,20.0
32202,3,2202,[ 64 318 301 313  11],416,5,9276,4.2106218792555605,60.0,20.0
32203,3,2203,[588 153 597  64 168],43,4,9280,4.2105263157894735,20.0,0.0
32204,3,2204,[603 655 228 111 322],805,1,9281,4.20907029478458,0.0,0.0
32205,3,2205,[185 269 234 200  82],262,0,9281,4.207162284678151,0.0,0.0
32206,3,2206,[111 234 168   1  95],618,3,9284,4.206615314907114,0.0,0.0
32207,3,2207,[ 64 318 301 313  11],43,5,9289,4.206974637681159,60.0,20.0
32208,3,2208,[ 64 318 301 313  11],416,5,9294,4.207333635129018,60.0,20.0
32209,3,2209,[ 64 318 301 313  11],43,5,9299,4.207692307692308,60.0,20.0
32210,3,2210,[ 64 318 301 313  11],416,5,9304,4.20805065581185,60.0,20.0
32211,3,2211,[ 64 318 301 313  11],43,5,9309,4.208408679927667,60.0,20.0
32212,3,2212,[ 64 318 301 313  11],43,5,9314,4.208766380478988,60.0,20.0
32213,3,2213,[153 328 568 597 385],416,4,9318,4.208672086720867,0.0,0.0
32214,3,2214,[ 64 318 301 313  11],345,5,9323,4.2090293453724605,60.0,20.0
32215,3,2215,[ 64 318 301 313  11],43,5,9328,4.209386281588448,60.0,20.0
32216,3,2216,[ 64 318 301 313  11],345,5,9333,4.209742895805142,60.0,20.0
32217,3,2217,[568 117  79 172  71],198,1,9334,4.208295761947701,0.0,0.0
32218,3,2218,[  7  25 191 186 475],417,3,9337,4.2077512392969805,0.0,0.0
32219,3,2219,[ 64 318 301 313  11],416,5,9342,4.208108108108108,60.0,20.0
32220,3,2220,[ 64 318 301 313  11],43,5,9347,4.208464655560558,60.0,20.0
32221,3,2221,[ 64 318 301 313  11],345,5,9352,4.208820882088209,60.0,20.0
32222,3,2222,[318 100  22  69 302],654,4,9356,4.208726945569051,20.0,0.0
32223,3,2223,[ 64 318 301 313  11],416,5,9361,4.2090827338129495,60.0,20.0
32224,3,2224,[678  89 168 269  25],805,5,9366,4.209438202247191,0.0,0.0
32225,3,2225,[ 64 318 301 313  11],345,5,9371,4.209793351302785,60.0,20.0
32226,3,2226,[ 79 471 168 282 313],618,3,9374,4.209250112258644,20.0,20.0
32227,3,2227,[ 64  25 258 294 172],345,3,9377,4.20870736086176,20.0,0.0
32228,3,2228,[ 64 318 301 313  11],416,5,9382,4.209062359802602,60.0,20.0
32229,3,2229,[ 64 318 301 313  11],43,5,9387,4.209417040358744,60.0,20.0
32230,3,2230,[204 175 200 153 588],922,2,9389,4.208426714477812,0.0,0.0
32231,3,2231,[174  28 173 322 125],416,4,9393,4.208333333333333,0.0,0.0
32232,3,2232,[ 64 318 301 313  11],345,5,9398,4.208687863860278,60.0,20.0
32233,3,2233,[546 301 385 191 403],416,4,9402,4.208594449418084,0.0,0.0
32234,3,2234,[196 742 588 210 275],297,4,9406,4.208501118568233,0.0,0.0
32235,3,2235,[204  50 216 100 121],62,4,9410,4.208407871198569,0.0,20.0
32236,3,2236,[ 64 318 301 313  11],416,5,9415,4.208761734465803,60.0,20.0
32237,3,2237,[ 64 318 301 313  11],345,5,9420,4.20911528150134,60.0,20.0
32238,3,2238,[174 175 161  70 276],198,1,9421,4.207682000893256,0.0,0.0
32239,3,2239,[ 64 318 301 313  11],43,5,9426,4.208035714285714,60.0,20.0
32240,3,2240,[ 64 318 301 313  11],345,5,9431,4.2083891120035695,60.0,20.0
32241,3,2241,[496 143 111 187 173],618,3,9434,4.2078501338090994,0.0,0.0
32242,3,2242,[ 64 318 301 313  11],416,5,9439,4.20820329915292,60.0,20.0
32243,3,2243,[100 257 195 174 117],416,4,9443,4.208110516934046,0.0,0.0
32244,3,2244,[ 64 318 301 313  11],345,5,9448,4.208463251670379,60.0,20.0
32245,3,2245,[ 64 318 301 313  11],345,5,9453,4.208815672306322,60.0,20.0
32246,3,2246,[ 64 318 301 313  11],345,5,9458,4.209167779261238,60.0,20.0
32247,3,2247,[ 64 318 301 313  11],43,5,9463,4.209519572953736,60.0,20.0
32248,3,2248,[ 56 121 153 302 508],417,2,9465,4.2085371276122725,0.0,0.0
32249,3,2249,[22 98 64  8 96],62,5,9470,4.208888888888889,20.0,20.0
32250,3,2250,[ 64 318 301 313  11],43,5,9475,4.209240337627721,60.0,20.0
32251,3,2251,[ 64 318 301 313  11],345,5,9480,4.209591474245116,60.0,20.0
32252,3,2252,[313  11 179 258 100],416,4,9484,4.209498446515757,20.0,20.0
32253,3,2253,[ 64 318 301 313  11],416,5,9489,4.209849157054126,60.0,20.0
32254,3,2254,[118 211 222  96 234],417,3,9492,4.209312638580931,0.0,0.0
32255,3,2255,[ 64 318 301 313  11],345,5,9497,4.209663120567376,60.0,20.0
32256,3,2256,[ 25 196  82 172 597],416,4,9501,4.2095702259636685,0.0,0.0
32257,3,2257,[216 546 328 286   1],416,4,9505,4.20947741364039,0.0,0.0
32258,3,2258,[276 275  88 655 238],618,2,9507,4.208499335989376,0.0,0.0
32259,3,2259,[ 88 323 125 200 127],416,3,9510,4.207964601769912,0.0,0.0
32260,3,2260,[125 127 151 294  15],417,5,9515,4.208314904909332,0.0,0.0
32261,3,2261,[301  79 143 174 423],437,4,9519,4.208222811671088,0.0,0.0
32262,3,2262,[ 64 318 301 313  11],345,5,9524,4.208572691117985,60.0,20.0
32263,3,2263,[ 64 318 301 313  11],416,5,9529,4.208922261484099,60.0,20.0
32264,3,2264,[ 64 318 301 313  11],345,5,9534,4.209271523178808,60.0,20.0
32265,3,2265,[ 64 318 301 313  11],345,5,9539,4.209620476610768,60.0,20.0
32266,3,2266,[ 64 318 301 313  11],43,5,9544,4.209969122187913,60.0,20.0
32267,3,2267,[ 64 318 301 313  11],43,5,9549,4.2103174603174605,60.0,20.0
32268,3,2268,[405  12 195 153  70],417,4,9553,4.210224768620538,20.0,0.0
32269,3,2269,[ 64 318 301 313  11],345,5,9558,4.21057268722467,60.0,20.0
32270,3,2270,[100 215 496   8  56],588,3,9561,4.2100396301188905,0.0,0.0
32271,3,2271,[ 88 276 237 196 655],342,2,9563,4.209066901408451,0.0,0.0
32272,3,2272,[ 70 265 288 153 111],437,1,9564,4.207655081390233,0.0,20.0
32273,3,2273,[111 215 655 748 269],345,4,9568,4.207563764291996,0.0,0.0
32274,3,2274,[ 64 318 301 313  11],345,5,9573,4.207912087912088,60.0,20.0
32275,3,2275,[268 265  97 143 172],654,3,9576,4.207381370826011,0.0,0.0
32276,3,2276,[ 64 318 301 313  11],345,5,9581,4.207729468599034,60.0,20.0
32277,3,2277,[405 121 288 234 143],262,0,9581,4.205882352941177,0.0,20.0
32278,3,2278,[  7 144 151 235 176],805,3,9584,4.205353225098728,0.0,0.0
32279,3,2279,[ 64 318 301 313  11],416,5,9589,4.205701754385965,60.0,20.0
32280,3,2280,[ 64 318 301 313  11],43,5,9594,4.20604997807979,60.0,20.0
32281,3,2281,[ 64 318 301 313  11],43,5,9599,4.2063978965819455,60.0,20.0
32282,3,2282,[161 265 151 173 483],417,3,9602,4.20586946999562,20.0,0.0
32283,3,2283,[ 64 318 301 313  11],345,5,9607,4.2062171628721545,60.0,20.0
32284,3,2284,[ 64 318 301 313  11],43,5,9612,4.2065645514223196,60.0,20.0
32285,3,2285,[ 64 318 301 313  11],345,5,9617,4.206911636045494,60.0,20.0
32286,3,2286,[ 64 318 301 313  11],416,5,9622,4.207258417140358,60.0,20.0
32287,3,2287,[ 64 318 301 313  11],345,5,9627,4.207604895104895,60.0,20.0
32288,3,2288,[200 322 179 204 172],416,3,9630,4.207077326343382,0.0,0.0
32289,3,2289,[ 71   8 175  69 235],43,3,9633,4.206550218340611,0.0,0.0
32290,3,2290,[258  12 191  79 405],43,5,9638,4.206896551724138,20.0,0.0
32291,3,2291,[ 64 318 301 313  11],416,5,9643,4.207242582897033,60.0,20.0
32292,3,2292,[ 64 318 301 313  11],345,5,9648,4.207588312254688,60.0,20.0
32293,3,2293,[161   1 357  82  98],230,5,9653,4.207933740191804,0.0,20.0
32294,3,2294,[ 64 318 301 313  11],345,5,9658,4.208278867102396,60.0,20.0
32295,3,2295,[  9 161 179 127   8],416,4,9662,4.208188153310105,0.0,0.0
32296,3,2296,[ 70 322 143 245 194],416,3,9665,4.207662168045276,0.0,0.0
32297,3,2297,[210 175 186  69 475],198,4,9669,4.20757180156658,0.0,0.0
32298,3,2298,[195  12   1  88 405],805,2,9671,4.206611570247934,20.0,0.0
32299,3,2299,[ 12 508 435   8  97],297,4,9675,4.206521739130435,20.0,0.0
32300,3,2300,[ 64 318 301 313  11],345,5,9680,4.206866579747936,60.0,20.0
32301,3,2301,[117 301 172 176 153],437,2,9682,4.205907906168549,0.0,0.0
32302,3,2302,[ 64 318 313 301  11],345,5,9687,4.206252713851498,60.0,20.0
32303,3,2303,[265 182 121   7 200],198,3,9690,4.205729166666667,0.0,0.0
32304,3,2304,[ 64 318 313 301  11],345,5,9695,4.206073752711497,60.0,20.0
32305,3,2305,[ 64 318 313 301  11],345,5,9700,4.206418039895924,60.0,20.0
32306,3,2306,[508 265  12  71  82],654,3,9703,4.205895101863892,20.0,0.0
32307,3,2307,[ 64 318 313 301  11],416,5,9708,4.206239168110918,60.0,20.0
32308,3,2308,[ 64 318 313 301  11],345,5,9713,4.206582936336076,60.0,20.0
32309,3,2309,[ 64 318 313 301  11],345,5,9718,4.2069264069264065,60.0,20.0
32310,3,2310,[ 64 318 313 301  11],43,5,9723,4.2072695802682825,60.0,20.0
32311,3,2311,[357 322  79 183 265],416,4,9727,4.2071799307958475,0.0,0.0
32312,3,2312,[  1 182 151 200 191],297,0,9727,4.205361003026373,0.0,0.0
32313,3,2313,[ 64 318 313 301  11],43,5,9732,4.205704407951599,60.0,20.0
32314,3,2314,[117 403 258 328  96],49,0,9732,4.2038876889848815,0.0,0.0
32315,3,2315,[118  88 245 181 288],345,2,9734,4.202936096718481,0.0,40.0
32316,3,2316,[ 64 318 313 301  11],43,5,9739,4.203280103582219,60.0,20.0
32317,3,2317,[ 56 286 118  70  82],416,4,9743,4.203192407247627,0.0,0.0
32318,3,2318,[118  79 117 678  50],588,3,9746,4.202673566192324,0.0,20.0
32319,3,2319,[ 64 318 313 301  11],345,5,9751,4.20301724137931,60.0,20.0
32320,3,2320,[403   8   1 568 588],642,5,9756,4.203360620422232,0.0,0.0
32321,3,2321,[182  71 333 143 471],416,5,9761,4.203703703703703,0.0,0.0
32322,3,2322,[ 64 318 313 301  11],416,5,9766,4.204046491605682,60.0,20.0
32323,3,2323,[132  15  95 475   4],417,4,9770,4.203958691910499,0.0,0.0
32324,3,2324,[ 71  98 204  50 127],601,2,9772,4.203010752688172,0.0,40.0
32325,3,2325,[269 496 288 181 185],262,1,9773,4.201633705932932,0.0,40.0
32326,3,2326,[ 64 318 313 301  11],345,5,9778,4.2019767941555655,60.0,20.0
32327,3,2327,[ 64 318 313 301  11],416,5,9783,4.202319587628866,60.0,20.0
32328,3,2328,[ 64 318 313 301  11],416,5,9788,4.202662086732503,60.0,20.0
32329,3,2329,[ 64 318 313 301  11],416,5,9793,4.2030042918454935,60.0,20.0
32330,3,2330,[168  64 204 323 185],416,4,9797,4.202917202917203,20.0,0.0
32331,3,2331,[ 28  15 161 181 174],618,4,9801,4.202830188679245,0.0,20.0
32332,3,2332,[191 117   8  96 202],642,4,9805,4.202743249035577,0.0,0.0
32333,3,2333,[ 64 318 313 301  11],416,5,9810,4.203084832904884,60.0,20.0
32334,3,2334,[ 64 318 313 301  11],43,5,9815,4.203426124197002,60.0,20.0
32335,3,2335,[273   4 742 183 234],297,2,9817,4.202482876712328,0.0,0.0
32336,3,2336,[ 64 318 313 301  11],416,5,9822,4.202824133504493,60.0,20.0
32337,3,2337,[258  15 245 300 276],416,3,9825,4.202309666381523,0.0,0.0
32338,3,2338,[161 215 301 318 168],588,5,9830,4.2026507054296705,20.0,0.0
32339,3,2339,[ 64 318 313 301  11],43,5,9835,4.202991452991453,60.0,20.0
32340,3,2340,[ 95 121 228   7 568],417,1,9836,4.201623237932507,0.0,0.0
32341,3,2341,[ 64 318 313 301  11],345,5,9841,4.20196413321947,60.0,20.0
32342,3,2342,[183 172 173 597 118],417,3,9844,4.201451131028596,0.0,0.0
32343,3,2343,[323 127 151  12 234],416,3,9847,4.200938566552901,20.0,0.0
32344,3,2344,[ 64 318 313 301  11],43,5,9852,4.201279317697228,60.0,20.0
32345,3,2345,[ 64 318 313 301  11],43,5,9857,4.201619778346121,60.0,20.0
32346,3,2346,[183  12 302 423  96],875,5,9862,4.201959948870899,20.0,0.0
32347,3,2347,[597 100 323 173 483],751,3,9865,4.20144804088586,20.0,0.0
32348,3,2348,[588 748 435 183 132],437,2,9867,4.2005108556832695,0.0,0.0
32349,3,2349,[  4 257 289 328 175],43,4,9871,4.2004255319148935,0.0,0.0
32350,3,2350,[ 64 318 313 301  11],43,5,9876,4.200765631646108,60.0,20.0
32351,3,2351,[ 64 318 313 301  11],345,5,9881,4.20110544217687,60.0,20.0
32352,3,2352,[222   8 121 483 182],62,5,9886,4.201444963875903,20.0,0.0
32353,3,2353,[ 64 318 313 301  11],345,5,9891,4.2017841971113,60.0,20.0
32354,3,2354,[117  71   7  95 273],618,4,9895,4.201698513800425,0.0,0.0
32355,3,2355,[211 385 435  28 187],373,2,9897,4.200764006791172,0.0,0.0
32356,3,2356,[181  79 118  50  95],618,3,9900,4.2002545608824775,0.0,40.0
32357,3,2357,[204 588 216 234 568],345,4,9904,4.200169635284139,0.0,0.0
32358,3,2358,[294 204 175 161 185],49,2,9906,4.1992369648156,0.0,0.0
32359,3,2359,[161 111 153 238  15],43,4,9910,4.1991525423728815,0.0,0.0
32360,3,2360,[ 64 318 313 301  11],416,5,9915,4.199491740787802,60.0,20.0
32361,3,2361,[ 64 318 313 301  11],416,5,9920,4.199830651989839,60.0,20.0
32362,3,2362,[ 64 318 313 301  11],416,5,9925,4.200169276343631,60.0,20.0
32363,3,2363,[ 64 318 313 301  11],416,5,9930,4.200507614213198,60.0,20.0
32364,3,2364,[173 179  89 181 174],214,4,9934,4.200422832980973,0.0,20.0
32365,3,2365,[ 64 318 313 301  11],345,5,9939,4.200760777683855,60.0,20.0
32366,3,2366,[302 197 176  96 143],405,3,9942,4.200253485424588,0.0,0.0
32367,3,2367,[385 143 175  97 197],198,1,9943,4.198902027027027,0.0,0.0
32368,3,2368,[ 64 318 313 301  11],345,5,9948,4.199240185732377,60.0,20.0
32369,3,2369,[228  12 202  70  95],417,4,9952,4.19915611814346,20.0,0.0
32370,3,2370,[ 64 318 313 301  11],43,5,9957,4.199493884436946,60.0,20.0
32371,3,2371,[100  64  96 117 210],417,2,9959,4.198566610455312,20.0,0.0
32372,3,2372,[ 64 318 313 301  11],43,5,9964,4.198904340497261,60.0,20.0
32373,3,2373,[ 64 318 313 301  11],416,5,9969,4.199241786015164,60.0,20.0
32374,3,2374,[ 88 100 313 322 496],907,5,9974,4.199578947368421,20.0,20.0
32375,3,2375,[181 385 211 427  89],373,4,9978,4.19949494949495,0.0,20.0
32376,3,2376,[ 64 318 313 301  11],345,5,9983,4.19983172065629,60.0,20.0
32377,3,2377,[ 22 322 333 100 172],416,4,9987,4.199747687132044,0.0,0.0
32378,3,2378,[ 64 318 313 301  11],345,5,9992,4.200084068936528,60.0,20.0
32379,3,2379,[ 64 318 313 301  11],416,5,9997,4.200420168067227,60.0,20.0
32380,3,2380,[ 64 318 313 301  11],43,5,10002,4.200755984880303,60.0,20.0
32381,3,2381,[ 64 318 313 301  11],345,5,10007,4.201091519731318,60.0,20.0
32382,3,2382,[ 64 318 313 301  11],416,5,10012,4.201426772975242,60.0,20.0
32383,3,2383,[ 64 318 313 301  11],416,5,10017,4.201761744966443,60.0,20.0
32384,3,2384,[ 64 318 313 301  11],43,5,10022,4.2020964360587,60.0,20.0
32385,3,2385,[ 64 318 313 301  11],416,5,10027,4.202430846605197,60.0,20.0
32386,3,2386,[ 64 318 313 301  11],43,5,10032,4.202764976958525,60.0,20.0
32387,3,2387,[ 64 318 313 301  11],43,5,10037,4.203098827470686,60.0,20.0
32388,3,2388,[ 64 318 313 301  11],43,5,10042,4.203432398493093,60.0,20.0
32389,3,2389,[ 64 318 313 301  11],345,5,10047,4.203765690376569,60.0,20.0
32390,3,2390,[211 125 403 172  98],417,4,10051,4.203680468423254,0.0,20.0
32391,3,2391,[ 64 318 313 301  11],416,5,10056,4.2040133779264215,60.0,20.0
32392,3,2392,[ 28 215  56 153 211],437,3,10059,4.203510238194735,0.0,0.0
32393,3,2393,[302 194  50 357  11],297,4,10063,4.203425229741019,0.0,20.0
32394,3,2394,[200  89 132 144  79],437,3,10066,4.2029227557411275,0.0,0.0
32395,3,2395,[471  97 313  50 265],505,4,10070,4.202838063439065,20.0,40.0
32396,3,2396,[ 64 318 313 301  11],416,5,10075,4.203170629954109,60.0,20.0
32397,3,2397,[322 294   4  25 118],805,1,10076,4.201834862385321,0.0,0.0
32398,3,2398,[ 64 318 313 301  11],416,5,10081,4.202167569820759,60.0,20.0
32399,3,2399,[496 168 151 385 118],43,5,10086,4.2025,0.0,0.0
32400,3,2400,[ 64 318 313 301  11],43,5,10091,4.202832153269471,60.0,20.0
32401,3,2401,[ 64 318 313 301  11],345,5,10096,4.203164029975021,60.0,20.0
32402,3,2402,[ 64 318 313 301  11],345,5,10101,4.203495630461923,60.0,20.0
32403,3,2403,[ 50 301 603 172  89],437,3,10104,4.202995008319467,0.0,20.0
32404,3,2404,[ 64 318 313 301  11],43,5,10109,4.203326403326403,60.0,20.0
32405,3,2405,[603  88 238 423  95],437,4,10113,4.203241895261845,0.0,0.0
32406,3,2406,[161  70 117  25 265],373,5,10118,4.203572912339011,0.0,0.0
32407,3,2407,[ 15 273   9 385 265],618,3,10121,4.203073089700997,0.0,0.0
32408,3,2408,[176 403 257 276 194],416,3,10124,4.2025736820257364,0.0,0.0
32409,3,2409,[ 64 318 313 301  11],43,5,10129,4.202904564315353,60.0,20.0
32410,3,2410,[ 64 318 313 301  11],43,5,10134,4.203235172127748,60.0,20.0
32411,3,2411,[ 64 318 313 301  11],416,5,10139,4.2035655058043115,60.0,20.0
32412,3,2412,[173 210  98  56  50],618,3,10142,4.203066721922918,0.0,40.0
32413,3,2413,[ 64 318 313 301  11],416,5,10147,4.203396851698426,60.0,20.0
32414,3,2414,[ 64 318 313 301  11],416,5,10152,4.203726708074534,60.0,20.0
32415,3,2415,[742  88  79 323 748],805,2,10154,4.202814569536423,0.0,0.0
32416,3,2416,[187 215 200 100  11],198,4,10158,4.202730657840298,0.0,0.0
32417,3,2417,[ 64 318 313 301  11],43,5,10163,4.2030603804797355,60.0,20.0
32418,3,2418,[ 64 318 313 301  11],345,5,10168,4.203389830508475,60.0,20.0
32419,3,2419,[ 64 318 313 301  11],416,5,10173,4.203719008264462,60.0,20.0
32420,3,2420,[385 328 211 318 300],416,5,10178,4.204047914085089,20.0,0.0
32421,3,2421,[ 64 318 313 301  11],43,5,10183,4.204376548307184,60.0,20.0
32422,3,2422,[ 64 318 313 301  11],416,5,10188,4.204704911267024,60.0,20.0
32423,3,2423,[ 64 318 313 301  11],345,5,10193,4.20503300330033,60.0,20.0
32424,3,2424,[ 56 204  50 172 403],49,1,10194,4.203711340206185,0.0,20.0
32425,3,2425,[322 182  79  88 153],416,3,10197,4.2032151690024735,0.0,0.0
32426,3,2426,[ 64 318 313 301  11],345,5,10202,4.203543469303667,60.0,20.0
32427,3,2427,[ 64 318 313 301  11],345,5,10207,4.203871499176277,60.0,20.0
32428,3,2428,[ 64 318 313 301  11],416,5,10212,4.2041992589543025,60.0,20.0
32429,3,2429,[655   8  64  56 200],253,4,10216,4.204115226337448,20.0,0.0
32430,3,2430,[427 181 655 323 210],416,4,10220,4.204031262854793,0.0,20.0
32431,3,2431,[ 64 318 313 301  11],43,5,10225,4.204358552631579,60.0,20.0
32432,3,2432,[179  56  12 515 161],417,4,10229,4.204274558158652,20.0,0.0
32433,3,2433,[ 64 318 313 301  11],43,5,10234,4.204601479046836,60.0,20.0
32434,3,2434,[ 64 318 313 301  11],43,5,10239,4.204928131416838,60.0,20.0
32435,3,2435,[ 64 318 313 301  11],345,5,10244,4.205254515599343,60.0,20.0
32436,3,2436,[ 64 318 313 301  11],416,5,10249,4.205580631924497,60.0,20.0
32437,3,2437,[ 64 318 313 301  11],345,5,10254,4.205906480721903,60.0,20.0
32438,3,2438,[ 64 318 313 301  11],345,5,10259,4.206232062320623,60.0,20.0
32439,3,2439,[ 64 318 313 301  11],345,5,10264,4.20655737704918,60.0,20.0
32440,3,2440,[153 294 237 515 282],416,4,10268,4.206472757066776,0.0,0.0
32441,3,2441,[ 64 318 313 301  11],345,5,10273,4.2067977067977065,60.0,20.0
32442,3,2442,[ 64 318 313 301  11],416,5,10278,4.207122390503479,60.0,20.0
32443,3,2443,[179 121 132 257  12],214,4,10282,4.207037643207856,20.0,0.0
32444,3,2444,[ 95   7 313 269 318],416,4,10286,4.206952965235174,40.0,20.0
32445,3,2445,[ 64 318 313 301  11],43,5,10291,4.207277187244481,60.0,20.0
32446,3,2446,[ 25 100 423 301 385],416,5,10296,4.207601144258275,0.0,0.0
32447,3,2447,[153 655   1 143 176],805,3,10299,4.207107843137255,0.0,0.0
32448,3,2448,[ 64 318 313 301  11],345,5,10304,4.207431604736628,60.0,20.0
32449,3,2449,[ 64 318 313 301  11],416,5,10309,4.207755102040816,60.0,20.0
32450,3,2450,[ 64 318 313 301  11],43,5,10314,4.208078335373317,60.0,20.0
32451,3,2451,[427 132 168 265 143],373,3,10317,4.2075856443719415,0.0,0.0
32452,3,2452,[ 50  12 215  28 235],345,3,10320,4.2070933550754175,20.0,20.0
32453,3,2453,[ 64 318 313 301  11],43,5,10325,4.207416462917686,60.0,20.0
32454,3,2454,[ 64 318 313 301  11],345,5,10330,4.2077393075356415,60.0,20.0
32455,3,2455,[ 64 318 313 301  11],345,5,10335,4.208061889250814,60.0,20.0
32456,3,2456,[ 64 318 313 301  11],345,5,10340,4.208384208384208,60.0,20.0
32457,3,2457,[265 191 286 568 187],416,5,10345,4.208706265256306,0.0,0.0
32458,3,2458,[ 64 318 313 301  11],43,5,10350,4.209028060187068,60.0,20.0
32459,3,2459,[301 568  70 196 200],711,4,10354,4.208943089430894,0.0,0.0
32460,3,2460,[ 64 318 313 301  11],345,5,10359,4.209264526615197,60.0,20.0
32461,3,2461,[161 257 151  50 288],922,3,10362,4.208773354995938,0.0,40.0
32462,3,2462,[483   9 181 195 471],618,2,10364,4.207876573284612,20.0,20.0
32463,3,2463,[ 64 318 313 301  11],416,5,10369,4.2081980519480515,60.0,20.0
32464,3,2464,[588   9 258 125  96],601,2,10371,4.207302231237323,0.0,0.0
32465,3,2465,[ 64 318 313 301  11],416,5,10376,4.207623682076237,60.0,20.0
32466,3,2466,[ 64 318 313 301  11],345,5,10381,4.2079448723145525,60.0,20.0
32467,3,2467,[ 64 318 313 301  11],416,5,10386,4.208265802269044,60.0,20.0
32468,3,2468,[ 79 546 655  97 286],417,3,10389,4.207776427703524,0.0,0.0
32469,3,2469,[ 96 405 118 403 385],805,2,10391,4.206882591093118,0.0,0.0
32470,3,2470,[568 237 215 161 216],588,4,10395,4.206798866855524,0.0,0.0
32471,3,2471,[ 64 318 313 301  11],416,5,10400,4.207119741100324,60.0,20.0
32472,3,2472,[ 64 318 313 301  11],345,5,10405,4.207440355843105,60.0,20.0
32473,3,2473,[ 64 318 313 301  11],416,5,10410,4.207760711398545,60.0,20.0
32474,3,2474,[ 64 318 313 301  11],345,5,10415,4.208080808080808,60.0,20.0
32475,3,2475,[ 64 318 313 301  11],43,5,10420,4.208400646203554,60.0,20.0
32476,3,2476,[ 64 318 313 301  11],43,5,10425,4.208720226079936,60.0,20.0
32477,3,2477,[ 64 318 313 301  11],43,5,10430,4.209039548022599,60.0,20.0
32478,3,2478,[ 64 318 313 301  11],416,5,10435,4.209358612343687,60.0,20.0
32479,3,2479,[ 64 318 313 301  11],416,5,10440,4.209677419354839,60.0,20.0
32480,3,2480,[588 748 268  69 151],297,2,10442,4.208786779524385,0.0,0.0
32481,3,2481,[ 64 318 313 301  11],416,5,10447,4.209105560032232,60.0,20.0
32482,3,2482,[ 64 318 313 301  11],416,5,10452,4.209424083769633,60.0,20.0
32483,3,2483,[ 70  50 181 196 313],751,4,10456,4.209339774557166,20.0,60.0
32484,3,2484,[268 185 496 286   4],416,5,10461,4.209657947686117,0.0,0.0
32485,3,2485,[180  64  98 403 546],62,5,10466,4.209975864843122,20.0,20.0
32486,3,2486,[ 64 318 313 301  11],43,5,10471,4.210293526336952,60.0,20.0
32487,3,2487,[269 475  97 655   1],416,4,10475,4.210209003215434,0.0,0.0
32488,3,2488,[302 301 215 294 471],416,5,10480,4.2105263157894735,0.0,0.0
32489,3,2489,[172 496 597 173 423],618,4,10484,4.210441767068273,0.0,0.0
32490,3,2490,[ 15  69 282 313 210],654,3,10487,4.2099558410277,20.0,20.0
32491,3,2491,[ 64 318 313 301  11],416,5,10492,4.210272873194222,60.0,20.0
32492,3,2492,[357  69 175 318  56],198,4,10496,4.210188527878058,20.0,0.0
32493,3,2493,[ 64 318 313 301  11],345,5,10501,4.210505212510024,60.0,20.0
32494,3,2494,[ 11 515  25 196  98],417,4,10505,4.210420841683367,0.0,20.0
32495,3,2495,[ 11  98 191 742 271],505,4,10509,4.210336538461538,0.0,20.0
32496,3,2496,[ 64 318 313 301  11],416,5,10514,4.210652783340008,60.0,20.0
32497,3,2497,[ 64 318 313 301  11],345,5,10519,4.210968775020016,60.0,20.0
32498,3,2498,[ 64 318 313 301  11],43,5,10524,4.211284513805523,60.0,20.0
32499,3,2499,[ 64 318 313 301  11],43,5,10529,4.2116,60.0,20.0
32500,3,2500,[ 64 318 313 301  11],416,5,10534,4.211915233906438,60.0,20.0
32501,3,2501,[ 64 318 313 301  11],345,5,10539,4.212230215827338,60.0,20.0
32502,3,2502,[ 64 318 313 301  11],416,5,10544,4.212544946064722,60.0,20.0
32503,3,2503,[238 182 176 125 403],62,5,10549,4.212859424920127,0.0,0.0
32504,3,2504,[ 64 318 313 301  11],43,5,10554,4.213173652694611,60.0,20.0
32505,3,2505,[202 153 210 508 216],297,4,10558,4.2130885873902635,0.0,0.0
32506,3,2506,[ 50 655  79 215 118],128,3,10561,4.212604706820901,0.0,20.0
32507,3,2507,[ 88 173 125 588 168],373,4,10565,4.2125199362041466,0.0,0.0
32508,3,2508,[ 64 318 313 301  11],345,5,10570,4.2128337983260264,60.0,20.0
32509,3,2509,[ 64 318 313 301  11],416,5,10575,4.213147410358566,60.0,20.0
32510,3,2510,[ 12 294  96 475 288],854,3,10578,4.212664277180406,20.0,20.0
32511,3,2511,[ 64 318 313 301  11],416,5,10583,4.212977707006369,60.0,20.0
32512,3,2512,[ 64 318 313 301  11],416,5,10588,4.213290887385595,60.0,20.0
32513,3,2513,[282 181 194 216 176],297,3,10591,4.212808273667462,0.0,20.0
32514,3,2514,[185 427 153  70 181],416,5,10596,4.213121272365806,0.0,20.0
32515,3,2515,[  1 588 118 597  96],416,3,10599,4.212639109697934,0.0,0.0
32516,3,2516,[ 64 318 313 301  11],43,5,10604,4.2129519268971,60.0,20.0
32517,3,2517,[265 286  95 173 282],705,3,10607,4.212470214455918,0.0,0.0
32518,3,2518,[ 64 318 313 301  11],416,5,10612,4.212782850337436,60.0,20.0
32519,3,2519,[496 322 508  98 179],128,3,10615,4.212301587301587,0.0,20.0
32520,3,2520,[ 64 318 313 301  11],43,5,10620,4.212614042046807,60.0,20.0
32521,3,2521,[ 64 318 313 301  11],416,5,10625,4.212926249008723,60.0,20.0
32522,3,2522,[ 64 318 313 301  11],345,5,10630,4.2132382084819655,60.0,20.0
32523,3,2523,[ 64 318 313 301  11],43,5,10635,4.2135499207606975,60.0,20.0
32524,3,2524,[ 56 475 234  50 222],805,5,10640,4.213861386138614,0.0,20.0
32525,3,2525,[ 64 318 313 301  11],43,5,10645,4.2141726049089465,60.0,20.0
32526,3,2526,[183 515 185 161 301],416,5,10650,4.214483577364464,0.0,0.0
32527,3,2527,[385 568  82 180 176],405,2,10652,4.2136075949367084,0.0,0.0
32528,3,2528,[ 64 318 313 301  11],345,5,10657,4.213918544879399,60.0,20.0
32529,3,2529,[179 357 174  96 197],405,3,10660,4.213438735177865,0.0,0.0
32530,3,2530,[475 403  95 118  89],198,3,10663,4.212959304622679,0.0,0.0
32531,3,2531,[ 64 318 313 301  11],416,5,10668,4.213270142180095,60.0,20.0
32532,3,2532,[ 64 318 313 301  11],416,5,10673,4.213580734307146,60.0,20.0
32533,3,2533,[237 121  50 257 117],416,3,10676,4.21310181531176,0.0,20.0
32534,3,2534,[183 176 117 275 121],416,5,10681,4.2134122287968445,0.0,0.0
32535,3,2535,[ 69 302 168 318 588],43,5,10686,4.2137223974763405,20.0,0.0
32536,3,2536,[202 405   1  89 655],417,4,10690,4.213638155301537,0.0,0.0
32537,3,2537,[ 64 318 313 301  11],345,5,10695,4.213947990543735,60.0,20.0
32538,3,2538,[ 64 318 313 301  11],416,5,10700,4.2142575817250885,60.0,20.0
32539,3,2539,[275  22 568 174 588],654,5,10705,4.214566929133858,0.0,0.0
32540,3,2540,[568 132 268 471 196],128,3,10708,4.214088941361669,0.0,0.0
32541,3,2541,[ 64 318 313 301  11],416,5,10713,4.214398111723053,60.0,20.0
32542,3,2542,[ 64 318 313 301  11],416,5,10718,4.214707038930397,60.0,20.0
32543,3,2543,[ 64 318 313 301  11],345,5,10723,4.21501572327044,60.0,20.0
32544,3,2544,[ 64 318 313 301  11],416,5,10728,4.21532416502947,60.0,20.0
32545,3,2545,[588 273   8 603 211],416,5,10733,4.215632364493323,0.0,0.0
32546,3,2546,[  7 174 200 235 118],854,2,10735,4.214762465645858,0.0,0.0
32547,3,2547,[ 69 288  25  96 168],887,4,10739,4.214678178963894,0.0,20.0
32548,3,2548,[ 64 318 313 301  11],345,5,10744,4.214986269125147,60.0,20.0
32549,3,2549,[ 64 318 313 301  11],416,5,10749,4.215294117647058,60.0,20.0
32550,3,2550,[ 64 318 313 301  11],416,5,10754,4.215601724813799,60.0,20.0
32551,3,2551,[ 64 318 313 301  11],43,5,10759,4.215909090909091,60.0,20.0
32552,3,2552,[ 64 318 313 301  11],416,5,10764,4.216216216216216,60.0,20.0
32553,3,2553,[ 64 318 313 301  11],416,5,10769,4.216523101018011,60.0,20.0
32554,3,2554,[ 64 318 313 301  11],416,5,10774,4.216829745596869,60.0,20.0
32555,3,2555,[228 135  12 515 742],417,2,10776,4.215962441314554,20.0,0.0
32556,3,2556,[ 64 318 313 301  11],43,5,10781,4.216269065310911,60.0,20.0
32557,3,2557,[286 423  56 405  25],43,5,10786,4.2165754495699765,0.0,0.0
32558,3,2558,[  7  12  69  22 195],214,3,10789,4.216100039077765,20.0,0.0
32559,3,2559,[ 56 234 153 172 269],262,1,10790,4.21484375,0.0,0.0
32560,3,2560,[ 64 318 313 301  11],43,5,10795,4.215150331901601,60.0,20.0
32561,3,2561,[151 191 235 153 144],854,3,10798,4.214676034348165,0.0,0.0
32562,3,2562,[132 182  15 276 191],128,4,10802,4.214592274678112,0.0,0.0
32563,3,2563,[ 64 318 313 301  11],416,5,10807,4.214898595943838,60.0,20.0
32564,3,2564,[ 64 318 313 301  11],416,5,10812,4.215204678362573,60.0,20.0
32565,3,2565,[ 64 318 313 301  11],345,5,10817,4.215510522213562,60.0,20.0
32566,3,2566,[ 64 318 313 301  11],43,5,10822,4.215816127775613,60.0,20.0
32567,3,2567,[ 64 318 313 301  11],43,5,10827,4.216121495327103,60.0,20.0
32568,3,2568,[ 64 318 313 301  11],43,5,10832,4.216426625145971,60.0,20.0
32569,3,2569,[ 64 318 313 301  11],345,5,10837,4.216731517509728,60.0,20.0
32570,3,2570,[195 179  98  79 546],417,3,10840,4.2162582652664335,0.0,20.0
32571,3,2571,[ 64 318 313 301  11],345,5,10845,4.216562986003111,60.0,20.0
32572,3,2572,[475  95 143  28   7],297,4,10849,4.216478818499806,0.0,0.0
32573,3,2573,[ 64 318 313 301  11],43,5,10854,4.216783216783217,60.0,20.0
32574,3,2574,[173 135  12 275 234],297,4,10858,4.216699029126214,20.0,0.0
32575,3,2575,[ 64 318 313 301  11],345,5,10863,4.217003105590062,60.0,20.0
32576,3,2576,[ 64 318 313 301  11],416,5,10868,4.217306946061312,60.0,20.0
32577,3,2577,[ 64 318 313 301  11],43,5,10873,4.217610550814585,60.0,20.0
32578,3,2578,[496 742 234 182 302],417,2,10875,4.21675067855758,0.0,0.0
32579,3,2579,[153  97 483 125 185],417,4,10879,4.216666666666667,20.0,0.0
32580,3,2580,[ 64 318 313 301  11],416,5,10884,4.216970166602092,60.0,20.0
32581,3,2581,[191 238 202 258 173],345,4,10888,4.216886134779241,0.0,0.0
32582,3,2582,[ 64 318 313 301  11],43,5,10893,4.21718931475029,60.0,20.0
32583,3,2583,[ 64 318 313 301  11],43,5,10898,4.21749226006192,60.0,20.0
32584,3,2584,[ 64 318 313 301  11],43,5,10903,4.217794970986461,60.0,20.0
32585,3,2585,[597 197 161   9 313],618,3,10906,4.2173240525908735,20.0,20.0
32586,3,2586,[ 64 318 313 301  11],43,5,10911,4.2176265945110165,60.0,20.0
32587,3,2587,[257 182  95 515 211],417,4,10915,4.217542503863988,0.0,0.0
32588,3,2588,[ 64 318 313 301  11],416,5,10920,4.21784472769409,60.0,20.0
32589,3,2589,[ 64 318 313 301  11],43,5,10925,4.218146718146718,60.0,20.0
32590,3,2590,[ 64 318 313 301  11],345,5,10930,4.218448475492088,60.0,20.0
32591,3,2591,[ 64 318 313 301  11],416,5,10935,4.21875,60.0,20.0
32592,3,2592,[ 64 318 313 301  11],43,5,10940,4.219051291939838,60.0,20.0
32593,3,2593,[ 64 318 313 301  11],345,5,10945,4.219352351580571,60.0,20.0
32594,3,2594,[ 64 318 313 301  11],416,5,10950,4.219653179190751,60.0,20.0
32595,3,2595,[127 135 182 288 118],417,3,10953,4.219183359013868,0.0,20.0
32596,3,2596,[ 64 318 313 301  11],345,5,10958,4.219484020023104,60.0,20.0
32597,3,2597,[ 28  88  11 423 234],405,4,10962,4.219399538106235,0.0,0.0
32598,3,2598,[ 50 121 258 289 748],345,2,10964,4.218545594459408,0.0,20.0
32599,3,2599,[ 64 318 313 301  11],345,5,10969,4.218846153846154,60.0,20.0
32600,3,2600,[ 64 318 313 301  11],345,5,10974,4.219146482122261,60.0,20.0
32601,3,2601,[ 64 318 313 301  11],43,5,10979,4.219446579554189,60.0,20.0
32602,3,2602,[ 64 318 313 301  11],43,5,10984,4.21974644640799,60.0,20.0
32603,3,2603,[ 64 318 313 301  11],345,5,10989,4.220046082949309,60.0,20.0
32604,3,2604,[ 64 318 313 301  11],43,5,10994,4.220345489443378,60.0,20.0
32605,3,2605,[ 64 318 313 301  11],345,5,10999,4.220644666155027,60.0,20.0
32606,3,2606,[ 25 742 161  64 118],128,3,11002,4.220176448024549,20.0,0.0
32607,3,2607,[237  97 265 111 191],416,4,11006,4.220092024539877,0.0,0.0
32608,3,2608,[ 64 318 313 301  11],416,5,11011,4.220390954388654,60.0,20.0
32609,3,2609,[ 64 318 313 301  11],43,5,11016,4.220689655172414,60.0,20.0
32610,3,2610,[508   9 271 294 405],708,2,11018,4.2198391420911525,0.0,0.0
32611,3,2611,[ 64 318 313 301  11],416,5,11023,4.2201378254211335,60.0,20.0
32612,3,2612,[ 64 318 313 301  11],345,5,11028,4.220436280137773,60.0,20.0
32613,3,2613,[197 273 294 181 234],297,2,11030,4.2195868400918135,0.0,20.0
32614,3,2614,[ 70 405   1 302 183],62,1,11031,4.218355640535373,0.0,0.0
32615,3,2615,[385  96  22 215 181],618,4,11035,4.2182721712538225,0.0,20.0
32616,3,2616,[286 357 132 117   4],62,4,11039,4.218188765762323,0.0,0.0
32617,3,2617,[ 64 318 313 301  11],416,5,11044,4.218487394957983,60.0,20.0
32618,3,2618,[ 64 318 313 301  11],416,5,11049,4.218785796105384,60.0,20.0
32619,3,2619,[ 64 318 313 301  11],43,5,11054,4.219083969465649,60.0,20.0
32620,3,2620,[ 64 318 313 301  11],416,5,11059,4.219381915299504,60.0,20.0
32621,3,2621,[151   1 168  79  64],854,4,11063,4.219298245614035,20.0,0.0
32622,3,2622,[234   1  25 118 655],345,2,11065,4.2184521540221125,0.0,0.0
32623,3,2623,[742   4 210 183 168],416,5,11070,4.21875,0.0,0.0
32624,3,2624,[ 64 318 313 301  11],345,5,11075,4.219047619047619,60.0,20.0
32625,3,2625,[ 64 318 313 301  11],43,5,11080,4.2193450114242195,60.0,20.0
32626,3,2626,[742 197 127  11 121],416,5,11085,4.219642177388656,0.0,0.0
32627,3,2627,[ 64 318 313 301  11],43,5,11090,4.219939117199391,60.0,20.0
32628,3,2628,[ 64 318 313 301  11],345,5,11095,4.2202358311144925,60.0,20.0
32629,3,2629,[ 64 318 313 301  11],416,5,11100,4.220532319391635,60.0,20.0
32630,3,2630,[ 71 176 132 385 313],505,5,11105,4.220828582288103,20.0,20.0
32631,3,2631,[ 64 318 313 301  11],43,5,11110,4.22112462006079,60.0,20.0
32632,3,2632,[ 64 318 313 301  11],43,5,11115,4.221420432966198,60.0,20.0
32633,3,2633,[ 64 318 313 301  11],43,5,11120,4.22171602126044,60.0,20.0
32634,3,2634,[ 64 318 313 301  11],345,5,11125,4.222011385199241,60.0,20.0
32635,3,2635,[ 64 318 313 301  11],345,5,11130,4.222306525037936,60.0,20.0
32636,3,2636,[ 64 318 313 301  11],416,5,11135,4.222601441031475,60.0,20.0
32637,3,2637,[269 194  69 300  25],416,5,11140,4.22289613343442,0.0,0.0
32638,3,2638,[191  95  69  71 568],262,3,11143,4.222432739674119,0.0,0.0
32639,3,2639,[ 64 318 313 301  11],43,5,11148,4.222727272727273,60.0,20.0
32640,3,2640,[ 64 318 313 301  11],43,5,11153,4.223021582733813,60.0,20.0
32641,3,2641,[742  98  25  11  50],43,5,11158,4.22331566994701,0.0,40.0
32642,3,2642,[ 64 318 313 301  11],345,5,11163,4.22360953461975,60.0,20.0
32643,3,2643,[288  11 568  98 168],405,4,11167,4.223524962178518,0.0,40.0
32644,3,2644,[ 64 318 313 301  11],43,5,11172,4.223818525519849,60.0,20.0
32645,3,2645,[286 475 196  88 294],342,2,11174,4.222978080120937,0.0,0.0
32646,3,2646,[ 82 313  64 496  15],642,5,11179,4.223271628258406,40.0,20.0
32647,3,2647,[ 64 318 313 301  11],416,5,11184,4.22356495468278,60.0,20.0
32648,3,2648,[ 64 318 313 301  11],345,5,11189,4.223858059645149,60.0,20.0
32649,3,2649,[597 276 215  97 174],43,4,11193,4.22377358490566,0.0,0.0
32650,3,2650,[ 64 318 313 301  11],416,5,11198,4.224066390041494,60.0,20.0
32651,3,2651,[282 245 427  97  96],907,5,11203,4.2243589743589745,0.0,0.0
32652,3,2652,[ 64 318 313 301  11],43,5,11208,4.224651338107803,60.0,20.0
32653,3,2653,[333  12 117 471 132],345,3,11211,4.224189902034665,20.0,0.0
32654,3,2654,[ 50 151 196 294  11],416,4,11215,4.224105461393597,0.0,20.0
32655,3,2655,[588 118 196  56 180],805,1,11216,4.22289156626506,0.0,0.0
32656,3,2656,[182   7  71 423 294],505,2,11218,4.222054949190817,0.0,0.0
32657,3,2657,[ 56  64 222 151 257],601,2,11220,4.221218961625282,20.0,0.0
32658,3,2658,[ 64 318 313 301  11],43,5,11225,4.221511846558856,60.0,20.0
32659,3,2659,[ 64 318 313 301  11],43,5,11230,4.2218045112781954,60.0,20.0
32660,3,2660,[ 69 323 597 322 294],630,3,11233,4.221345358887636,0.0,0.0
32661,3,2661,[ 64 318 313 301  11],416,5,11238,4.221637866265965,60.0,20.0
32662,3,2662,[ 64 318 313 301  11],43,5,11243,4.221930153961697,60.0,20.0
32663,3,2663,[ 64 318 313 301  11],345,5,11248,4.222222222222222,60.0,20.0
32664,3,2664,[210 423 271 182 174],505,4,11252,4.2221388367729835,0.0,0.0
32665,3,2665,[ 64 318 313 301  11],43,5,11257,4.222430607651913,60.0,20.0
32666,3,2666,[313 288 202 121  15],416,5,11262,4.222722159730034,20.0,40.0
32667,3,2667,[ 64 318 313 301  11],43,5,11267,4.223013493253373,60.0,20.0
32668,3,2668,[268 508  28  50 483],128,4,11271,4.222929936305732,20.0,20.0
32669,3,2669,[ 64 318 313 301  11],345,5,11276,4.223220973782771,60.0,20.0
32670,3,2670,[313 210 496  95  79],43,5,11281,4.223511793335829,20.0,20.0
32671,3,2671,[ 64 318 313 301  11],43,5,11286,4.223802395209581,60.0,20.0
32672,3,2672,[ 64 318 313 301  11],345,5,11291,4.224092779648335,60.0,20.0
32673,3,2673,[ 64 318 313 301  11],43,5,11296,4.224382946896036,60.0,20.0
32674,3,2674,[265 183 182   7  82],417,3,11299,4.223925233644859,0.0,0.0
32675,3,2675,[ 64 318 313 301  11],345,5,11304,4.2242152466367715,60.0,20.0
32676,3,2676,[ 64 318 313 301  11],416,5,11309,4.224505042958536,60.0,20.0
32677,3,2677,[125 211 172 294 237],416,4,11313,4.224421209858103,0.0,0.0
32678,3,2678,[238 328 183 742 427],416,5,11318,4.224710712952594,0.0,0.0
32679,3,2679,[ 64 318 313 301  11],43,5,11323,4.225,60.0,20.0
32680,3,2680,[ 28  64 183 173 258],875,5,11328,4.225289071242074,20.0,0.0
32681,3,2681,[  1 258 405   8 313],907,4,11332,4.225205070842655,20.0,20.0
32682,3,2682,[ 64 318 313 301  11],345,5,11337,4.225493850167723,60.0,20.0
32683,3,2683,[ 64 318 313 301  11],416,5,11342,4.225782414307004,60.0,20.0
32684,3,2684,[ 64 318 313 301  11],345,5,11347,4.226070763500931,60.0,20.0
32685,3,2685,[127 597 742 273 238],416,4,11351,4.225986597170514,0.0,0.0
32686,3,2686,[ 64 318 313 301  11],416,5,11356,4.226274655749907,60.0,20.0
32687,3,2687,[423 144 302 216  25],417,1,11357,4.225074404761905,0.0,0.0
32688,3,2688,[ 50 202 181  88  79],751,5,11362,4.225362588322796,0.0,40.0
32689,3,2689,[ 64 318 313 301  11],345,5,11367,4.225650557620818,60.0,20.0
32690,3,2690,[  4  82  64 546 125],62,5,11372,4.225938312894835,20.0,0.0
32691,3,2691,[ 64 318 313 301  11],345,5,11377,4.226225854383358,60.0,20.0
32692,3,2692,[211 301 496 117  69],437,2,11379,4.2253991830672115,0.0,0.0
32693,3,2693,[ 64 318 313 301  11],43,5,11384,4.225686711210097,60.0,20.0
32694,3,2694,[ 64 318 313 301  11],416,5,11389,4.225974025974026,60.0,20.0
32695,3,2695,[ 64 318 313 301  11],345,5,11394,4.226261127596439,60.0,20.0
32696,3,2696,[ 71 174 179 182 275],62,5,11399,4.226548016314424,0.0,0.0
32697,3,2697,[161 257 403   8  50],416,4,11403,4.22646404744255,0.0,20.0
32698,3,2698,[ 64 318 313 301  11],345,5,11408,4.226750648388292,60.0,20.0
32699,3,2699,[132 197  88  95 588],711,5,11413,4.227037037037037,0.0,0.0
32700,3,2700,[ 64 318 313 301  11],43,5,11418,4.227323213624583,60.0,20.0
32701,3,2701,[603 289 546 286 257],416,2,11420,4.226498889711325,0.0,0.0
32702,3,2702,[127 655 588 174  28],618,5,11425,4.226785053644099,0.0,0.0
32703,3,2703,[200  25 588 181  50],297,4,11429,4.226701183431953,0.0,40.0
32704,3,2704,[ 82 144 143 328 268],416,5,11434,4.226987060998152,0.0,0.0
32705,3,2705,[318 127  64 191 151],62,5,11439,4.2272727272727275,40.0,0.0
32706,3,2706,[471 179 403  56 197],721,4,11443,4.227188769855929,0.0,0.0
32707,3,2707,[ 64 318 313 301  11],345,5,11448,4.227474150664698,60.0,20.0
32708,3,2708,[ 64 318 313 301  11],416,5,11453,4.227759320782576,60.0,20.0
32709,3,2709,[143   1 121   9  69],416,5,11458,4.228044280442805,0.0,0.0
32710,3,2710,[ 64 318 313 301  11],345,5,11463,4.228329029878274,60.0,20.0
32711,3,2711,[ 64 318 313 301  11],416,5,11468,4.228613569321534,60.0,20.0
32712,3,2712,[ 64 318 313 301  11],43,5,11473,4.228897899004791,60.0,20.0
32713,3,2713,[  1 427 423  25 269],416,5,11478,4.229182019159912,0.0,0.0
32714,3,2714,[ 64 318 313 301  11],416,5,11483,4.229465930018416,60.0,20.0
32715,3,2715,[ 64 318 313 301  11],416,5,11488,4.2297496318114876,60.0,20.0
32716,3,2716,[143 238  56 357  50],601,2,11490,4.228928965771071,0.0,20.0
32717,3,2717,[ 64 318 313 301  11],345,5,11495,4.229212656364974,60.0,20.0
32718,3,2718,[ 64 318 313 301  11],416,5,11500,4.229496138286135,60.0,20.0
32719,3,2719,[ 64 318 313 301  11],416,5,11505,4.229779411764706,60.0,20.0
32720,3,2720,[ 64 318 313 301  11],345,5,11510,4.230062477030503,60.0,20.0
32721,3,2721,[ 64 318 313 301  11],345,5,11515,4.2303453343130055,60.0,20.0
32722,3,2722,[ 64 318 313 301  11],416,5,11520,4.230627983841352,60.0,20.0
32723,3,2723,[ 64 318 313 301  11],416,5,11525,4.230910425844346,60.0,20.0
32724,3,2724,[179  15  50 655  95],262,2,11527,4.230091743119266,0.0,20.0
32725,3,2725,[215 238 427 258 748],198,4,11531,4.230007336757153,0.0,0.0
32726,3,2726,[204 191 286  15 168],373,4,11535,4.22992299229923,0.0,0.0
32727,3,2727,[216  50 222  82 328],721,5,11540,4.230205278592376,0.0,20.0
32728,3,2728,[ 64 318 313 301  11],43,5,11545,4.230487358006596,60.0,20.0
32729,3,2729,[ 64 318 313 301  11],43,5,11550,4.230769230769231,60.0,20.0
32730,3,2730,[ 64 318 313 301  11],416,5,11555,4.231050897107287,60.0,20.0
32731,3,2731,[ 64 318 313 301  11],416,5,11560,4.231332357247438,60.0,20.0
32732,3,2732,[168  95 186 127 181],618,4,11564,4.231247713135748,0.0,20.0
32733,3,2733,[ 64 318 313 301  11],345,5,11569,4.231528895391368,60.0,20.0
32734,3,2734,[ 64 318 313 301  11],416,5,11574,4.231809872029251,60.0,20.0
32735,3,2735,[ 25  64 215  98 282],416,5,11579,4.232090643274854,20.0,20.0
32736,3,2736,[ 64 318 313 301  11],43,5,11584,4.232371209353307,60.0,20.0
32737,3,2737,[318 181 405 183 195],887,4,11588,4.232286340394449,20.0,20.0
32738,3,2738,[ 64 318 313 301  11],345,5,11593,4.232566630156992,60.0,20.0
32739,3,2739,[ 64 318 313 301  11],345,5,11598,4.232846715328467,60.0,20.0
32740,3,2740,[403 183  50 197 191],405,4,11602,4.232761765778913,0.0,20.0
32741,3,2741,[210  82 322 423 180],417,3,11605,4.232312180889862,0.0,0.0
32742,3,2742,[ 64 318 313 301  11],43,5,11610,4.2325920524972656,60.0,20.0
32743,3,2743,[144 196 301   7 265],297,3,11613,4.232142857142857,0.0,0.0
32744,3,2744,[ 64 318 313 301  11],43,5,11618,4.232422586520947,60.0,20.0
32745,3,2745,[ 64 318 313 301  11],43,5,11623,4.232702112163146,60.0,20.0
32746,3,2746,[ 64 318 313 301  11],43,5,11628,4.232981434291955,60.0,20.0
32747,3,2747,[588 132 111 196 245],417,3,11631,4.2325327510917035,0.0,0.0
32748,3,2748,[ 64 318 313 301  11],416,5,11636,4.232811931611495,60.0,20.0
32749,3,2749,[161 173  50 168  56],43,5,11641,4.233090909090909,0.0,20.0
32750,3,2750,[ 64 318 313 301  11],416,5,11646,4.233369683751363,60.0,20.0
32751,3,2751,[172  71  28 197 174],805,2,11648,4.232558139534884,0.0,0.0
32752,3,2752,[ 64 318 313 301  11],345,5,11653,4.2328369051943335,60.0,20.0
32753,3,2753,[ 64 318 313 301  11],416,5,11658,4.233115468409586,60.0,20.0
32754,3,2754,[ 64 318 313 301  11],416,5,11663,4.233393829401089,60.0,20.0
32755,3,2755,[127 286 153 132 143],373,1,11664,4.2322206095791,0.0,0.0
32756,3,2756,[ 64 318 313 301  11],416,5,11669,4.232499093217265,60.0,20.0
32757,3,2757,[ 64 318 313 301  11],43,5,11674,4.232777374909355,60.0,20.0
32758,3,2758,[ 64 318 313 301  11],345,5,11679,4.233055454874955,60.0,20.0
32759,3,2759,[ 64 318 313 301  11],416,5,11684,4.233333333333333,60.0,20.0
32760,3,2760,[427 245 172 181 471],128,3,11687,4.232886635277073,0.0,20.0
32761,3,2761,[153 238 174 121 210],62,5,11692,4.233164373642288,0.0,0.0
32762,3,2762,[269 182 286 200 265],416,5,11697,4.233441910966341,0.0,0.0
32763,3,2763,[ 64 318 313 301  11],43,5,11702,4.233719247467438,60.0,20.0
32764,3,2764,[546 111 127 568  50],416,4,11706,4.233634719710669,0.0,20.0
32765,3,2765,[385 515 294 180  98],417,5,11711,4.2339117859725235,0.0,20.0
32766,3,2766,[ 64 318 313 301  11],416,5,11716,4.234188651969642,60.0,20.0
32767,3,2767,[186 597 323 294  56],417,3,11719,4.233742774566474,0.0,0.0
32768,3,2768,[ 64 318 313 301  11],43,5,11724,4.234019501625135,60.0,20.0
32769,3,2769,[132 182 403 187 127],198,5,11729,4.234296028880866,0.0,0.0
32770,3,2770,[ 64 318 313 301  11],416,5,11734,4.2345723565499815,60.0,20.0
32771,3,2771,[ 64 318 313 301  11],43,5,11739,4.234848484848484,60.0,20.0
32772,3,2772,[ 64 318 313 301  11],416,5,11744,4.235124413992066,60.0,20.0
32773,3,2773,[127 118  25 181   7],417,2,11746,4.234318673395818,0.0,20.0
32774,3,2774,[ 64 318 313 301  11],416,5,11751,4.234594594594594,60.0,20.0
32775,3,2775,[268  25 748 475 508],297,4,11755,4.234510086455331,0.0,0.0
32776,3,2776,[ 64 318 313 301  11],345,5,11760,4.234785740007202,60.0,20.0
32777,3,2777,[ 64 318 313 301  11],345,5,11765,4.235061195104391,60.0,20.0
32778,3,2778,[302 125 135 151 269],854,3,11768,4.234616768621806,0.0,0.0
32779,3,2779,[ 64 318 313 301  11],43,5,11773,4.234892086330936,60.0,20.0
32780,3,2780,[ 70 427  64 265  82],373,4,11777,4.234807623157137,20.0,0.0
32781,3,2781,[195 135  64 483 423],854,4,11781,4.234723220704529,40.0,0.0
32782,3,2782,[ 64 318 313 301  11],345,5,11786,4.23499820337765,60.0,20.0
32783,3,2783,[475   8  15 127  71],601,2,11788,4.234195402298851,0.0,0.0
32784,3,2784,[ 88 403   8 235 237],642,4,11792,4.23411131059246,0.0,0.0
32785,3,2785,[ 64 318 313 301  11],43,5,11797,4.234386216798277,60.0,20.0
32786,3,2786,[ 64 318 313 301  11],43,5,11802,4.234660925726588,60.0,20.0
32787,3,2787,[ 64 318 313 301  11],43,5,11807,4.23493543758967,60.0,20.0
32788,3,2788,[ 28  15 132 405 546],62,2,11809,4.234134098243098,0.0,0.0
32789,3,2789,[ 64 318 313 301  11],345,5,11814,4.234408602150538,60.0,20.0
32790,3,2790,[ 64 318 313 301  11],43,5,11819,4.234682909351487,60.0,20.0
32791,3,2791,[ 15 318 196  95 276],437,5,11824,4.234957020057307,20.0,0.0
32792,3,2792,[ 64 318 313 301  11],345,5,11829,4.235230934479055,60.0,20.0
32793,3,2793,[ 64 318 313 301  11],43,5,11834,4.235504652827488,60.0,20.0
32794,3,2794,[132  96 117  71 204],618,3,11837,4.235062611806798,0.0,0.0
32795,3,2795,[ 56 174 191  12 294],342,3,11840,4.234620886981402,20.0,0.0
32796,3,2796,[268 161 174 222 132],588,3,11843,4.234179478012156,0.0,0.0
32797,3,2797,[144 143 269 161  64],43,5,11848,4.23445318084346,20.0,0.0
32798,3,2798,[100 748 302 151 423],297,2,11850,4.233654876741693,0.0,0.0
32799,3,2799,[ 64 318 313 301  11],416,5,11855,4.233928571428572,60.0,20.0
32800,3,2800,[  1 423  50  28 202],642,3,11858,4.233488039985719,0.0,20.0
32801,3,2801,[ 64 318 313 301  11],345,5,11863,4.233761598857958,60.0,20.0
32802,3,2802,[ 64 318 313 301  11],416,5,11868,4.234034962540136,60.0,20.0
32803,3,2803,[ 64 318 313 301  11],43,5,11873,4.234308131241084,60.0,20.0
32804,3,2804,[ 64 318 313 301  11],345,5,11878,4.23458110516934,60.0,20.0
32805,3,2805,[ 70 196 181 216 183],62,4,11882,4.234497505345688,0.0,20.0
32806,3,2806,[ 64 318 313 301  11],416,5,11887,4.234770217313859,60.0,20.0
32807,3,2807,[ 64 318 313 301  11],345,5,11892,4.235042735042735,60.0,20.0
32808,3,2808,[ 11 385  64 403  71],618,5,11897,4.235315058739765,20.0,0.0
32809,3,2809,[318 118 288 117 161],588,4,11901,4.2352313167259785,20.0,20.0
32810,3,2810,[ 64 318 313 301  11],416,5,11906,4.23550337958022,60.0,20.0
32811,3,2811,[ 64 318 313 301  11],43,5,11911,4.235775248933144,60.0,20.0
32812,3,2812,[ 64 318 313 301  11],345,5,11916,4.236046924991113,60.0,20.0
32813,3,2813,[ 64 318 313 301  11],416,5,11921,4.236318407960199,60.0,20.0
32814,3,2814,[ 12  28  97 132 127],373,1,11922,4.235168738898756,20.0,0.0
32815,3,2815,[ 64 318 313 301  11],345,5,11927,4.235440340909091,60.0,20.0
32816,3,2816,[357 194 301 405 127],416,5,11932,4.235711750088747,0.0,0.0
32817,3,2817,[ 64 318 313 301  11],416,5,11937,4.235982966643009,60.0,20.0
32818,3,2818,[ 64 318 313 301  11],416,5,11942,4.236253990776871,60.0,20.0
32819,3,2819,[427  69  71 172   8],601,2,11944,4.235460992907801,0.0,0.0
32820,3,2820,[ 64 318 313 301  11],416,5,11949,4.235732009925559,60.0,20.0
32821,3,2821,[ 64 318 313 301  11],43,5,11954,4.236002834868887,60.0,20.0
32822,3,2822,[ 64 318 313 301  11],43,5,11959,4.236273467941905,60.0,20.0
32823,3,2823,[ 64 318 313 301  11],416,5,11964,4.236543909348442,60.0,20.0
32824,3,2824,[ 64 318 313 301  11],345,5,11969,4.236814159292035,60.0,20.0
32825,3,2825,[ 64 318 313 301  11],43,5,11974,4.237084217975938,60.0,20.0
32826,3,2826,[ 64 318 313 301  11],345,5,11979,4.237354085603113,60.0,20.0
32827,3,2827,[288 174 496  56 183],875,5,11984,4.237623762376238,0.0,20.0
32828,3,2828,[195 182 288  79   1],297,0,11984,4.236125839519265,0.0,20.0
32829,3,2829,[276 185 191  56 238],214,4,11988,4.236042402826855,0.0,0.0
32830,3,2830,[111  96 234 323 597],805,3,11991,4.235605793006005,0.0,0.0
32831,3,2831,[265 588 197 181 204],437,3,11994,4.235169491525424,0.0,20.0
32832,3,2832,[302   1 385 183  69],417,3,11997,4.234733498058596,0.0,0.0
32833,3,2833,[275  97 475 655 144],62,2,11999,4.23394495412844,0.0,0.0
32834,3,2834,[ 64 318 313 301  11],345,5,12004,4.234215167548501,60.0,20.0
32835,3,2835,[ 64 318 313 301  11],416,5,12009,4.234485190409027,60.0,20.0
32836,3,2836,[ 25 597 234  11 405],805,2,12011,4.233697567853366,0.0,0.0
32837,3,2837,[ 50 215  25 475  89],198,4,12015,4.233615221987315,0.0,20.0
32838,3,2838,[ 64 318 313 301  11],43,5,12020,4.233885170834801,60.0,20.0
32839,3,2839,[ 64 318 313 301  11],416,5,12025,4.234154929577465,60.0,20.0
32840,3,2840,[143 118 173  71 200],416,4,12029,4.23407250967969,0.0,0.0
32841,3,2841,[216   1 508 238  69],297,3,12032,4.233638282899367,0.0,0.0
32842,3,2842,[204 475 288 172 132],601,3,12035,4.23320436158987,0.0,20.0
32843,3,2843,[151 117 475 215 143],437,2,12037,4.232419127988749,0.0,0.0
32844,3,2844,[238 180 216   1  64],198,4,12041,4.232337434094903,20.0,0.0
32845,3,2845,[ 64 318 313 301  11],345,5,12046,4.232607167955025,60.0,20.0
32846,3,2846,[168 423  15 196 144],416,5,12051,4.232876712328767,0.0,0.0
32847,3,2847,[ 64 318 313 301  11],416,5,12056,4.23314606741573,60.0,20.0
32848,3,2848,[ 64 318 313 301  11],43,5,12061,4.233415233415234,60.0,20.0
32849,3,2849,[ 64 318 313 301  11],43,5,12066,4.233684210526316,60.0,20.0
32850,3,2850,[302 174 597 238 237],751,2,12068,4.232900736583655,0.0,0.0
32851,3,2851,[ 64 318 313 301  11],416,5,12073,4.233169705469845,60.0,20.0
32852,3,2852,[ 64 318 313 301  11],345,5,12078,4.233438485804417,60.0,20.0
32853,3,2853,[237 385 185 200 216],618,4,12082,4.233356692361598,0.0,0.0
32854,3,2854,[ 64 318 313 301  11],345,5,12087,4.233625218914185,60.0,20.0
32855,3,2855,[ 64 318 313 301  11],345,5,12092,4.233893557422969,60.0,20.0
32856,3,2856,[204 144 179 121   9],62,3,12095,4.233461673083654,0.0,0.0
32857,3,2857,[143 173   7 168 483],751,4,12099,4.2333799860041985,20.0,0.0
32858,3,2858,[ 64 318 313 301  11],43,5,12104,4.233648128716334,60.0,20.0
32859,3,2859,[ 64 318 313 301  11],416,5,12109,4.233916083916084,60.0,20.0
32860,3,2860,[301 288  12 588  56],345,3,12112,4.2334847955260395,20.0,20.0
32861,3,2861,[ 64 318 313 301  11],416,5,12117,4.233752620545073,60.0,20.0
32862,3,2862,[ 64 318 313 301  11],43,5,12122,4.234020258470136,60.0,20.0
32863,3,2863,[222  12 161 568  22],588,4,12126,4.233938547486034,20.0,0.0
32864,3,2864,[286 210 191 151  70],43,5,12131,4.234205933682373,0.0,0.0
32865,3,2865,[ 71 282 100 289 191],764,4,12135,4.234124214933706,0.0,0.0
32866,3,2866,[  4 238   7 237 181],416,4,12139,4.23404255319149,0.0,20.0
32867,3,2867,[ 64 318 313 301  11],345,5,12144,4.2343096234309625,60.0,20.0
32868,3,2868,[357 151  28 475 118],297,3,12147,4.233879400487975,0.0,0.0
32869,3,2869,[ 64 318 313 301  11],43,5,12152,4.234146341463415,60.0,20.0
32870,3,2870,[ 64 318 313 301  11],345,5,12157,4.234413096482062,60.0,20.0
32871,3,2871,[ 64 318 313 301  11],416,5,12162,4.234679665738161,60.0,20.0
32872,3,2872,[143 237 323 168   9],416,3,12165,4.2342499129829445,0.0,0.0
32873,3,2873,[ 64 318 313 301  11],43,5,12170,4.234516353514266,60.0,20.0
32874,3,2874,[234 132 181 245 300],345,3,12173,4.234086956521739,0.0,20.0
32875,3,2875,[ 64 318 313 301  11],43,5,12178,4.2343532684283725,60.0,20.0
32876,3,2876,[ 64 318 313 301  11],416,5,12183,4.234619395203337,60.0,20.0
32877,3,2877,[194 216 121 204 282],416,5,12188,4.234885337039611,0.0,0.0
32878,3,2878,[161  96 179 202 403],373,2,12190,4.234109065647794,0.0,0.0
32879,3,2879,[318 258 403 475 151],198,5,12195,4.234375,20.0,0.0
32880,3,2880,[ 82 237  64   4  70],416,4,12199,4.234293648038875,20.0,0.0
32881,3,2881,[ 69 127 273   7 194],854,4,12203,4.234212352532963,0.0,0.0
32882,3,2882,[ 64 318 313 301  11],43,5,12208,4.234477974332293,60.0,20.0
32883,3,2883,[204  95 385  70 211],43,5,12213,4.2347434119278775,0.0,0.0
32884,3,2884,[ 64 318 313 301  11],345,5,12218,4.235008665511265,60.0,20.0
32885,3,2885,[ 64 318 313 301  11],416,5,12223,4.2352737352737355,60.0,20.0
32886,3,2886,[ 64 318 313 301  11],43,5,12228,4.235538621406304,60.0,20.0
32887,3,2887,[ 64 318 313 301  11],416,5,12233,4.235803324099723,60.0,20.0
32888,3,2888,[181 216 258 173 153],721,4,12237,4.235721703011422,0.0,20.0
32889,3,2889,[ 64 318 313 301  11],416,5,12242,4.23598615916955,60.0,20.0
32890,3,2890,[ 64 318 313 301  11],43,5,12247,4.23625043237634,60.0,20.0
32891,3,2891,[ 64 318 313 301  11],43,5,12252,4.236514522821577,60.0,20.0
32892,3,2892,[ 64 318 313 301  11],345,5,12257,4.23677843069478,60.0,20.0
32893,3,2893,[471 405  22 144 423],416,5,12262,4.237042156185211,0.0,0.0
32894,3,2894,[151 153  64 204 271],43,4,12266,4.236960276338515,20.0,0.0
32895,3,2895,[ 64 318 313 301  11],345,5,12271,4.2372237569060776,60.0,20.0
32896,3,2896,[185 174 258 288 268],875,5,12276,4.237487055574732,0.0,20.0
32897,3,2897,[288 301   4 588 678],297,2,12278,4.236714975845411,0.0,20.0
32898,3,2898,[143 100 322 318 271],907,5,12283,4.236978268368403,20.0,0.0
32899,3,2899,[ 64 318 313 301  11],345,5,12288,4.237241379310345,60.0,20.0
32900,3,2900,[ 64 318 313 301  11],43,5,12293,4.237504308859014,60.0,20.0
32901,3,2901,[118  79  11 111 471],345,3,12296,4.237077877325982,0.0,0.0
32902,3,2902,[ 64 318 313 301  11],43,5,12301,4.237340682053048,60.0,20.0
32903,3,2903,[  1 302 135 111 182],417,2,12303,4.2365702479338845,0.0,0.0
32904,3,2904,[496  50 172 132 204],262,1,12304,4.235456110154906,0.0,20.0
32905,3,2905,[ 64 318 313 301  11],43,5,12309,4.235719201651755,60.0,20.0
32906,3,2906,[ 64 318 313 301  11],345,5,12314,4.235982112143103,60.0,20.0
32907,3,2907,[ 64 318 313 301  11],416,5,12319,4.236244841815681,60.0,20.0
32908,3,2908,[ 70 318 204  89 435],405,2,12321,4.2354761086283945,20.0,0.0
32909,3,2909,[ 64 318 313 301  11],416,5,12326,4.23573883161512,60.0,20.0
32910,3,2910,[183 313 173 275 197],618,2,12328,4.2349708004122295,20.0,20.0
32911,3,2911,[143 286 313 568  56],416,5,12333,4.235233516483516,20.0,20.0
32912,3,2912,[275 496 603 435 204],373,5,12338,4.235496052179883,0.0,0.0
32913,3,2913,[ 64 318 313 301  11],345,5,12343,4.235758407687028,60.0,20.0
32914,3,2914,[ 64 318 313 301  11],43,5,12348,4.2360205831903945,60.0,20.0
32915,3,2915,[ 64 318 313 301  11],416,5,12353,4.236282578875172,60.0,20.0
32916,3,2916,[258 405 471   9  88],43,4,12357,4.236201576962633,0.0,0.0
32917,3,2917,[186 318 597 196 187],618,5,12362,4.236463331048664,20.0,0.0
32918,3,2918,[ 64 318 313 301  11],345,5,12367,4.236724905789654,60.0,20.0
32919,3,2919,[ 28 202 210 597 200],618,3,12370,4.236301369863014,0.0,0.0
32920,3,2920,[ 64 318 313 301  11],43,5,12375,4.236562820951729,60.0,20.0
32921,3,2921,[ 64 318 313 301  11],345,5,12380,4.236824093086927,60.0,20.0
32922,3,2922,[ 64 318 313 301  11],416,5,12385,4.237085186452275,60.0,20.0
32923,3,2923,[ 64 318 313 301  11],345,5,12390,4.23734610123119,60.0,20.0
32924,3,2924,[ 64 318 313 301  11],416,5,12395,4.237606837606838,60.0,20.0
32925,3,2925,[ 64 318 313 301  11],43,5,12400,4.237867395762133,60.0,20.0
32926,3,2926,[ 64 318 313 301  11],43,5,12405,4.23812777587974,60.0,20.0
32927,3,2927,[ 64 318 313 301  11],416,5,12410,4.238387978142076,60.0,20.0
32928,3,2928,[ 64 318 313 301  11],345,5,12415,4.238648002731308,60.0,20.0
32929,3,2929,[ 64 318 313 301  11],416,5,12420,4.238907849829351,60.0,20.0
32930,3,2930,[ 64 318 313 301  11],345,5,12425,4.239167519617878,60.0,20.0
32931,3,2931,[ 64 318 313 301  11],416,5,12430,4.239427012278308,60.0,20.0
32932,3,2932,[ 64 318 313 301  11],43,5,12435,4.2396863279918175,60.0,20.0
32933,3,2933,[ 64 318 313 301  11],416,5,12440,4.239945466939332,60.0,20.0
32934,3,2934,[ 64 318 313 301  11],416,5,12445,4.240204429301533,60.0,20.0
32935,3,2935,[ 64   7 187 286 546],416,4,12449,4.2401226158038146,20.0,0.0
32936,3,2936,[151 202 471  95  88],505,3,12452,4.239700374531835,0.0,0.0
32937,3,2937,[ 64 318 313 301  11],345,5,12457,4.23995915588836,60.0,20.0
32938,3,2938,[ 64 318 313 301  11],43,5,12462,4.240217761143246,60.0,20.0
32939,3,2939,[ 64 318 313 301  11],416,5,12467,4.2404761904761905,60.0,20.0
32940,3,2940,[210   8 323 202 127],416,4,12471,4.24039442366542,0.0,0.0
32941,3,2941,[ 50 268 282  71 117],128,3,12474,4.239972807613868,0.0,20.0
32942,3,2942,[275 427 161 125 144],416,5,12479,4.240231056744818,0.0,0.0
32943,3,2943,[ 64 318 313 301  11],43,5,12484,4.240489130434782,60.0,20.0
32944,3,2944,[ 98 195 423  69 187],405,5,12489,4.2407470288624785,0.0,20.0
32945,3,2945,[ 95  11 125 475  69],416,3,12492,4.240325865580448,0.0,0.0
32946,3,2946,[ 64 318 313 301  11],416,5,12497,4.240583644384119,60.0,20.0
32947,3,2947,[ 64 318 313 301  11],416,5,12502,4.240841248303935,60.0,20.0
32948,3,2948,[143  22 168  98 196],405,3,12505,4.240420481519159,0.0,20.0
32949,3,2949,[ 64 318 313 301  11],416,5,12510,4.240677966101695,60.0,20.0
32950,3,2950,[ 64 318 313 301  11],345,5,12515,4.2409352761775665,60.0,20.0
32951,3,2951,[118 258 282  28 313],588,4,12519,4.240853658536586,20.0,20.0
32952,3,2952,[ 64 318 313 301  11],345,5,12524,4.241110734845919,60.0,20.0
32953,3,2953,[ 64 318 313 301  11],345,5,12529,4.241367637102234,60.0,20.0
32954,3,2954,[ 79 405  71 245   9],416,4,12533,4.241285956006768,0.0,0.0
32955,3,2955,[ 64 318 313 301  11],416,5,12538,4.2415426251691475,60.0,20.0
32956,3,2956,[ 96 132 111 286  22],62,3,12541,4.241122759553601,0.0,0.0
32957,3,2957,[288 161 318 210  79],618,3,12544,4.240703177822853,20.0,20.0
32958,3,2958,[483 100  98 234 215],437,4,12548,4.240621831699898,20.0,20.0
32959,3,2959,[ 79 182 194 111 172],416,5,12553,4.240878378378379,0.0,0.0
32960,3,2960,[161 191 276  12 546],43,5,12558,4.24113475177305,20.0,0.0
32961,3,2961,[323 496 588 268 237],416,3,12561,4.240715732613099,0.0,0.0
32962,3,2962,[ 69  96 132  15 174],12,5,12566,4.240971987850152,0.0,0.0
32963,3,2963,[ 64 318 313 301  11],43,5,12571,4.241228070175438,60.0,20.0
32964,3,2964,[ 64 318 313 301  11],345,5,12576,4.241483979763912,60.0,20.0
32965,3,2965,[ 64 318 313 301  11],416,5,12581,4.24173971679029,60.0,20.0
32966,3,2966,[ 64 318 313 301  11],345,5,12586,4.241995281429053,60.0,20.0
32967,3,2967,[ 64 318 313 301  11],43,5,12591,4.242250673854447,60.0,20.0
32968,3,2968,[ 12 515  82  79 161],405,3,12594,4.241832266756484,20.0,0.0
32969,3,2969,[191 385  50 173 313],405,4,12598,4.241750841750842,20.0,40.0
32970,3,2970,[ 64 318 313 301  11],43,5,12603,4.242006058566139,60.0,20.0
32971,3,2971,[ 64 318 313 301  11],43,5,12608,4.242261103633917,60.0,20.0
32972,3,2972,[357 257  95 179 318],416,2,12610,4.24150689539186,20.0,0.0
32973,3,2973,[222 153 318 176 173],854,4,12614,4.24142568930733,20.0,0.0
32974,3,2974,[  1  15 196 748   4],345,3,12617,4.241008403361344,0.0,0.0
32975,3,2975,[187 237 385 181 197],618,4,12621,4.240927419354839,0.0,20.0
32976,3,2976,[ 64 318 313 301  11],345,5,12626,4.241182398387639,60.0,20.0
32977,3,2977,[ 64 318 313 301  11],416,5,12631,4.241437206178643,60.0,20.0
32978,3,2978,[ 79 183 197  98 153],297,3,12634,4.241020476670023,0.0,20.0
32979,3,2979,[172 300 385 197 132],416,5,12639,4.2412751677852345,0.0,0.0
32980,3,2980,[ 64 318 313 301  11],345,5,12644,4.241529688024153,60.0,20.0
32981,3,2981,[ 71 655  89  28  15],437,2,12646,4.240778001341382,0.0,0.0
32982,3,2982,[ 69  22 301   7 127],416,5,12651,4.241032517599732,0.0,0.0
32983,3,2983,[ 64 318 313 301  11],43,5,12656,4.241286863270777,60.0,20.0
32984,3,2984,[180  71  64 385 275],373,3,12659,4.240871021775544,20.0,0.0
32985,3,2985,[ 64 318 313 301  11],43,5,12664,4.241125251172137,60.0,20.0
32986,3,2986,[ 98 183 196 204  89],805,3,12667,4.2407097422162705,0.0,20.0
32987,3,2987,[475 196 191 100 168],62,5,12672,4.240963855421687,0.0,0.0
32988,3,2988,[301 475 200 197 216],416,4,12676,4.240883238541318,0.0,0.0
32989,3,2989,[ 12 118 172 100 234],417,3,12679,4.240468227424749,20.0,0.0
32990,3,2990,[385 111 210 245 127],417,3,12682,4.240053493814778,0.0,0.0
32991,3,2991,[161 183  70 483 275],437,2,12684,4.239304812834225,20.0,0.0
32992,3,2992,[ 64 318 313 301  11],43,5,12689,4.239558970932175,60.0,20.0
32993,3,2993,[186 135  25  50 222],354,2,12691,4.238810955243821,0.0,20.0
32994,3,2994,[ 64 318 313 301  11],416,5,12696,4.239065108514191,60.0,20.0
32995,3,2995,[ 64 318 313 301  11],416,5,12701,4.23931909212283,60.0,20.0
32996,3,2996,[151  25 271 174 200],805,3,12704,4.238905572238906,0.0,0.0
32997,3,2997,[151 111   7   9  28],314,5,12709,4.239159439626418,0.0,0.0
32998,3,2998,[ 64 318 313 301  11],345,5,12714,4.239413137712571,60.0,20.0
32999,3,2999,[197 323 151  11 172],345,4,12718,4.239333333333334,0.0,0.0
33000,3,3000,[322  69  98 405 515],417,2,12720,4.238587137620793,0.0,20.0
33001,3,3001,[ 64 318 313 301  11],43,5,12725,4.238840772818121,60.0,20.0
33002,3,3002,[ 64 318 313 301  11],416,5,12730,4.239094239094239,60.0,20.0
33003,3,3003,[153 143  50 183 237],416,4,12734,4.23901464713715,0.0,20.0
33004,3,3004,[ 64 318 313 301  11],416,5,12739,4.239267886855242,60.0,20.0
33005,3,3005,[ 64 318 313 301  11],345,5,12744,4.2395209580838324,60.0,20.0
33006,3,3006,[ 64 318 313 301  11],345,5,12749,4.239773860991021,60.0,20.0
33007,3,3007,[ 64 318 313 301  11],345,5,12754,4.2400265957446805,60.0,20.0
33008,3,3008,[ 64 318 313 301  11],43,5,12759,4.240279162512462,60.0,20.0
33009,3,3009,[ 64 318 313 301  11],43,5,12764,4.240531561461794,60.0,20.0
33010,3,3010,[ 64 318 313 301  11],43,5,12769,4.24078379275988,60.0,20.0
33011,3,3011,[ 64 318 313 301  11],416,5,12774,4.241035856573705,60.0,20.0
33012,3,3012,[ 64 318 313 301  11],43,5,12779,4.24128775307003,60.0,20.0
33013,3,3013,[216 588 275 238   8],711,5,12784,4.241539482415395,0.0,0.0
33014,3,3014,[ 64 318 313 301  11],345,5,12789,4.24179104477612,60.0,20.0
33015,3,3015,[ 15 121 289 403  82],416,4,12793,4.241710875331565,0.0,0.0
33016,3,3016,[ 64 318 313 301  11],416,5,12798,4.241962214119987,60.0,20.0
33017,3,3017,[191 135 185 179   7],805,5,12803,4.242213386348575,0.0,0.0
33018,3,3018,[153 282 427 268 471],416,5,12808,4.242464392182842,0.0,0.0
33019,3,3019,[ 64 318 313 301  11],345,5,12813,4.24271523178808,60.0,20.0
33020,3,3020,[405 216 294 257 174],642,3,12816,4.242303872889772,0.0,0.0
33021,3,3021,[ 64 318 313 301  11],345,5,12821,4.242554599602912,60.0,20.0
33022,3,3022,[ 64 318 313 301  11],43,5,12826,4.242805160436652,60.0,20.0
33023,3,3023,[143 191 427 322 357],416,4,12830,4.242724867724868,0.0,0.0
33024,3,3024,[ 64 318 313 301  11],43,5,12835,4.24297520661157,60.0,20.0
33025,3,3025,[238 237 174   4 161],43,4,12839,4.242894910773298,0.0,0.0
33026,3,3026,[ 64 318 313 301  11],416,5,12844,4.243145028080608,60.0,20.0
33027,3,3027,[ 64 318 313 301  11],345,5,12849,4.243394980184941,60.0,20.0
33028,3,3028,[216 161 271 258 235],805,0,12849,4.2419940574447015,0.0,0.0
33029,3,3029,[191 100 475  11 111],297,3,12852,4.241584158415842,0.0,0.0
33030,3,3030,[117 508 288  22 143],297,4,12856,4.241504453975586,0.0,20.0
33031,3,3031,[ 64 318 313 301  11],416,5,12861,4.241754617414248,60.0,20.0
33032,3,3032,[ 70 597 742 125 216],314,3,12864,4.241345202769535,0.0,0.0
33033,3,3033,[ 98  50 204 508 181],128,5,12869,4.241595253790376,0.0,60.0
33034,3,3034,[ 64 318 313 301  11],43,5,12874,4.241845140032949,60.0,20.0
33035,3,3035,[186 180 211 216  12],405,2,12876,4.241106719367589,20.0,0.0
33036,3,3036,[ 64 318 313 301  11],416,5,12881,4.2413566019097795,60.0,20.0
33037,3,3037,[181 275 257 546  97],654,3,12884,4.2409479921000655,0.0,20.0
33038,3,3038,[216 210 125  89  82],373,4,12888,4.240868706811451,0.0,0.0
33039,3,3039,[ 64 318 313 301  11],43,5,12893,4.241118421052631,60.0,20.0
33040,3,3040,[ 64 318 313 301  11],43,5,12898,4.241367971062151,60.0,20.0
33041,3,3041,[257 403 496 191 118],417,3,12901,4.240959894806049,0.0,0.0
33042,3,3042,[237 357 328 385 300],416,4,12905,4.24088070982583,0.0,0.0
33043,3,3043,[175 216  95 235 300],43,3,12908,4.240473061760841,0.0,0.0
33044,3,3044,[ 79 748 127 144 276],416,4,12912,4.240394088669951,0.0,0.0
33045,3,3045,[ 64 318 313 301  11],345,5,12917,4.240643466841759,60.0,20.0
33046,3,3046,[ 64 318 313 301  11],345,5,12922,4.240892681325894,60.0,20.0
33047,3,3047,[182 185 546  95  12],416,3,12925,4.240485564304462,20.0,0.0
33048,3,3048,[191 121 117 172 568],805,2,12927,4.239750737946868,0.0,0.0
33049,3,3049,[181 568 333 132 234],416,5,12932,4.24,0.0,20.0
33050,3,3050,[ 64 318 313 301  11],416,5,12937,4.240249098656179,60.0,20.0
33051,3,3051,[357 117  15 403 216],198,3,12940,4.239842726081259,0.0,0.0
33052,3,3052,[  8 235 286  69 275],297,3,12943,4.23943661971831,0.0,0.0
33053,3,3053,[ 64 318 313 301  11],43,5,12948,4.239685658153242,60.0,20.0
33054,3,3054,[ 64 318 313 301  11],43,5,12953,4.239934533551555,60.0,20.0
33055,3,3055,[ 64 318 313 301  11],43,5,12958,4.240183246073299,60.0,20.0
33056,3,3056,[ 64 318 313 301  11],416,5,12963,4.240431795878312,60.0,20.0
33057,3,3057,[ 64 318 313 301  11],345,5,12968,4.240680183126226,60.0,20.0
33058,3,3058,[ 28  95 182 183 191],618,4,12972,4.2406015037593985,0.0,0.0
33059,3,3059,[ 64 318 313 301  11],345,5,12977,4.240849673202614,60.0,20.0
33060,3,3060,[ 64 318 313 301  11],416,5,12982,4.24109768049657,60.0,20.0
33061,3,3061,[176 202 132   1 245],416,4,12986,4.24101894186806,0.0,0.0
33062,3,3062,[ 64 318 313 301  11],345,5,12991,4.241266731962129,60.0,20.0
33063,3,3063,[ 64 318 313 301  11],43,5,12996,4.241514360313316,60.0,20.0
33064,3,3064,[ 12 301  56   4 194],416,5,13001,4.241761827079935,20.0,0.0
33065,3,3065,[ 64 318 313 301  11],416,5,13006,4.242009132420091,60.0,20.0
33066,3,3066,[ 64 318 313 301  11],43,5,13011,4.242256276491686,60.0,20.0
33067,3,3067,[546 282 195 269 216],654,4,13015,4.2421773142112125,0.0,0.0
33068,3,3068,[ 64 318 313 301  11],416,5,13020,4.242424242424242,60.0,20.0
33069,3,3069,[ 64 318 313 301  11],43,5,13025,4.242671009771987,60.0,20.0
33070,3,3070,[ 64 318 313 301  11],345,5,13030,4.242917616411592,60.0,20.0
33071,3,3071,[ 64 318 313 301  11],345,5,13035,4.2431640625,60.0,20.0
33072,3,3072,[ 28 748  64 282  71],345,1,13036,4.242108688577937,20.0,0.0
33073,3,3073,[258   4 515 603 211],297,4,13040,4.24202992843201,0.0,0.0
33074,3,3074,[210 228 168 185   4],417,1,13041,4.240975609756098,0.0,0.0
33075,3,3075,[603 191 235 200  69],416,4,13045,4.2408972691807545,0.0,0.0
33076,3,3076,[ 64 318 313 301  11],416,5,13050,4.241143971400715,60.0,20.0
33077,3,3077,[204 405 202 181 282],128,3,13053,4.2407407407407405,0.0,20.0
33078,3,3078,[ 64 318 313 301  11],345,5,13058,4.240987333549854,60.0,20.0
33079,3,3079,[ 64 318 313 301  11],43,5,13063,4.2412337662337665,60.0,20.0
33080,3,3080,[ 64 318 313 301  11],43,5,13068,4.241480038948393,60.0,20.0
33081,3,3081,[135 302  22  88 179],405,3,13071,4.241077222582739,0.0,0.0
33082,3,3082,[ 64 318 313 301  11],416,5,13076,4.241323386312033,60.0,20.0
33083,3,3083,[ 69 210 200  11 237],198,4,13080,4.2412451361867705,0.0,0.0
33084,3,3084,[195 176 187 127 185],405,4,13084,4.241166936790924,0.0,0.0
33085,3,3085,[496  22 302 127 132],214,4,13088,4.241088788075178,0.0,0.0
33086,3,3086,[ 64 318 313 301  11],43,5,13093,4.241334629089731,60.0,20.0
33087,3,3087,[ 64 318 313 301  11],345,5,13098,4.241580310880829,60.0,20.0
33088,3,3088,[ 64 318 313 301  11],345,5,13103,4.241825833603108,60.0,20.0
33089,3,3089,[268 235  50 238 176],416,4,13107,4.241747572815534,0.0,20.0
33090,3,3090,[ 64 318 313 301  11],416,5,13112,4.241992882562277,60.0,20.0
33091,3,3091,[ 12 318 603 301  97],437,3,13115,4.241591203104787,40.0,0.0
33092,3,3092,[318 471 265 173 678],588,4,13119,4.241513094083414,20.0,0.0
33093,3,3093,[ 64 318 313 301  11],43,5,13124,4.241758241758242,60.0,20.0
33094,3,3094,[ 64 318 313 301  11],43,5,13129,4.242003231017771,60.0,20.0
33095,3,3095,[186 185  79 210 172],437,3,13132,4.241602067183463,0.0,0.0
33096,3,3096,[ 64 318 313 301  11],43,5,13137,4.241846948659994,60.0,20.0
33097,3,3097,[ 64 318 313 301  11],345,5,13142,4.242091672046482,60.0,20.0
33098,3,3098,[ 64 318 313 301  11],416,5,13147,4.242336237495967,60.0,20.0
33099,3,3099,[288 405 118 204 235],62,1,13148,4.241290322580645,0.0,20.0
33100,3,3100,[ 64 318 313 301  11],345,5,13153,4.241534988713318,60.0,20.0
33101,3,3101,[ 64 318 313 301  11],345,5,13158,4.241779497098646,60.0,20.0
33102,3,3102,[ 64 318 313 301  11],416,5,13163,4.24202384788914,60.0,20.0
33103,3,3103,[168 258   1 202 289],588,3,13166,4.241623711340206,0.0,0.0
33104,3,3104,[ 64 318 313 301  11],345,5,13171,4.2418679549114335,60.0,20.0
33105,3,3105,[ 64 318 313 301  11],345,5,13176,4.24211204121056,60.0,20.0
33106,3,3106,[ 64 318 313 301  11],345,5,13181,4.242355970389443,60.0,20.0
33107,3,3107,[ 64 318 313 301  11],43,5,13186,4.242599742599743,60.0,20.0
33108,3,3108,[111 275 179 322 216],128,2,13188,4.241878417497587,0.0,0.0
33109,3,3109,[ 71 195 475  15 258],62,4,13192,4.241800643086817,0.0,0.0
33110,3,3110,[ 64 318 313 301  11],345,5,13197,4.242044358727098,60.0,20.0
33111,3,3111,[ 11  56 176 245 197],416,4,13201,4.241966580976864,0.0,0.0
33112,3,3112,[ 64 318 313 301  11],345,5,13206,4.2422100867330546,60.0,20.0
33113,3,3113,[ 64 318 313 301  11],345,5,13211,4.2424534360950545,60.0,20.0
33114,3,3114,[ 64 318 313 301  11],43,5,13216,4.242696629213484,60.0,20.0
33115,3,3115,[ 64 318 313 301  11],345,5,13221,4.242939666238768,60.0,20.0
33116,3,3116,[ 64 318 313 301  11],43,5,13226,4.243182547321142,60.0,20.0
33117,3,3117,[ 64 318 313 301  11],416,5,13231,4.243425272610648,60.0,20.0
33118,3,3118,[ 64 318 313 301  11],43,5,13236,4.243667842257134,60.0,20.0
33119,3,3119,[235 211 357 210 196],417,3,13239,4.243269230769231,0.0,0.0
33120,3,3120,[151  69 215 174  97],654,4,13243,4.243191284844601,0.0,0.0
33121,3,3121,[ 64 318 313 301  11],345,5,13248,4.243433696348495,60.0,20.0
33122,3,3122,[ 64 318 313 301  11],416,5,13253,4.24367595260967,60.0,20.0
33123,3,3123,[185 742 286 294 118],223,1,13254,4.242637644046095,0.0,0.0
33124,3,3124,[  9   8 172 127 132],618,3,13257,4.24224,0.0,0.0
33125,3,3125,[ 64 318 313 301  11],416,5,13262,4.242482405630199,60.0,20.0
33126,3,3126,[179 168 181 423 273],62,4,13266,4.242404860889031,0.0,20.0
33127,3,3127,[ 64 318 313 301  11],416,5,13271,4.242647058823529,60.0,20.0
33128,3,3128,[ 64 318 313 301  11],345,5,13276,4.242889101949505,60.0,20.0
33129,3,3129,[ 64 318 313 301  11],416,5,13281,4.243130990415335,60.0,20.0
33130,3,3130,[483 202 275  95 197],711,5,13286,4.243372724369211,20.0,0.0
33131,3,3131,[ 64 318 313 301  11],416,5,13291,4.243614303959132,60.0,20.0
33132,3,3132,[ 64 318 313 301  11],43,5,13296,4.243855729332908,60.0,20.0
33133,3,3133,[ 64 318 313 301  11],345,5,13301,4.244097000638162,60.0,20.0
33134,3,3134,[215 143 183 195 117],198,2,13303,4.2433811802232855,0.0,0.0
33135,3,3135,[ 64 318 313 301  11],416,5,13308,4.2436224489795915,60.0,20.0
33136,3,3136,[117 238 195 176 323],417,4,13312,4.2435447880140265,0.0,0.0
33137,3,3137,[ 64 318 313 301  11],345,5,13317,4.24378585086042,60.0,20.0
33138,3,3138,[ 64 318 313 301  11],416,5,13322,4.244026760114687,60.0,20.0
33139,3,3139,[200 191 286  56  64],417,5,13327,4.244267515923567,20.0,0.0
33140,3,3140,[ 64 318 313 301  11],345,5,13332,4.24450811843362,60.0,20.0
33141,3,3141,[ 64 318 313 301  11],345,5,13337,4.244748567791215,60.0,20.0
33142,3,3142,[ 15  70 216 127 286],417,4,13341,4.2446706967865095,0.0,0.0
33143,3,3143,[ 64 318 313 301  11],345,5,13346,4.244910941475827,60.0,20.0
33144,3,3144,[118  82 161 588  79],588,4,13350,4.24483306836248,0.0,0.0
33145,3,3145,[185 161  70 191 286],437,2,13352,4.24411951684679,0.0,0.0
33146,3,3146,[135  96 132  95 228],405,2,13354,4.243406418811567,0.0,0.0
33147,3,3147,[200 655   9  69 282],618,3,13357,4.243011435832274,0.0,0.0
33148,3,3148,[ 64 318 313 301  11],416,5,13362,4.2432518259765,60.0,20.0
33149,3,3149,[286 215 100 173  88],345,4,13366,4.243174603174603,0.0,0.0
33150,3,3150,[ 64 318 313 301  11],345,5,13371,4.243414788955887,60.0,20.0
33151,3,3151,[ 64 318 313 301  11],416,5,13376,4.243654822335025,60.0,20.0
33152,3,3152,[ 64 318 313 301  11],43,5,13381,4.243894703457025,60.0,20.0
33153,3,3153,[ 64 318 313 301  11],345,5,13386,4.2441344324667085,60.0,20.0
33154,3,3154,[ 64 318 313 301  11],43,5,13391,4.244374009508716,60.0,20.0
33155,3,3155,[ 64 318 313 301  11],416,5,13396,4.244613434727503,60.0,20.0
33156,3,3156,[423 216 471  11  15],854,2,13398,4.2439024390243905,0.0,0.0
33157,3,3157,[ 64 318 313 301  11],416,5,13403,4.244141861937935,60.0,20.0
33158,3,3158,[ 64 318 313 301  11],416,5,13408,4.244381133270022,60.0,20.0
33159,3,3159,[ 64 318 313 301  11],43,5,13413,4.244620253164557,60.0,20.0
33160,3,3160,[ 64 318 313 301  11],345,5,13418,4.244859221765264,60.0,20.0
33161,3,3161,[ 96  50 100 475 238],417,2,13420,4.244149272612271,0.0,20.0
33162,3,3162,[ 64 318 313 301  11],43,5,13425,4.2443882390135945,60.0,20.0
33163,3,3163,[ 64 318 313 301  11],43,5,13430,4.244627054361568,60.0,20.0
33164,3,3164,[ 64 318 313 301  11],345,5,13435,4.244865718799368,60.0,20.0
33165,3,3165,[172 323 508 121 181],345,3,13438,4.244472520530638,0.0,20.0
33166,3,3166,[ 64 318 313 301  11],345,5,13443,4.2447110830438906,60.0,20.0
33167,3,3167,[176 235 273 195   8],805,1,13444,4.2436868686868685,0.0,0.0
33168,3,3168,[ 79 423 179  28 357],416,4,13448,4.243609971599874,0.0,0.0
33169,3,3169,[ 64 318 313 301  11],416,5,13453,4.24384858044164,60.0,20.0
33170,3,3170,[176  25 275  95 125],416,4,13457,4.2437716808577735,0.0,0.0
33171,3,3171,[ 64 318 313 301  11],416,5,13462,4.2440100882723835,60.0,20.0
33172,3,3172,[ 64 318 313 301  11],43,5,13467,4.244248345414435,60.0,20.0
33173,3,3173,[ 64 318 313 301  11],43,5,13472,4.244486452425961,60.0,20.0
33174,3,3174,[ 98  69 288 300 144],654,4,13476,4.244409448818898,0.0,40.0
33175,3,3175,[ 64 318 313 301  11],345,5,13481,4.244647355163728,60.0,20.0
33176,3,3176,[515 234  69 269 275],297,3,13484,4.244255587031791,0.0,0.0
33177,3,3177,[ 64 318 313 301  11],416,5,13489,4.244493392070485,60.0,20.0
33178,3,3178,[ 64 318 313 301  11],345,5,13494,4.244731047499213,60.0,20.0
33179,3,3179,[ 64 318 313 301  11],43,5,13499,4.2449685534591195,60.0,20.0
33180,3,3180,[323 121 245 597 151],416,1,13500,4.243948443885571,0.0,0.0
33181,3,3181,[322 245 144 216 742],416,3,13503,4.243557510999372,0.0,0.0
33182,3,3182,[121 318 423 471 210],43,4,13507,4.243480992774113,20.0,0.0
33183,3,3183,[ 64 318 313 301  11],416,5,13512,4.243718592964824,60.0,20.0
33184,3,3184,[ 64 318 313 301  11],416,5,13517,4.243956043956044,60.0,20.0
33185,3,3185,[183  89 191   1 228],297,2,13519,4.2432517263025735,0.0,0.0
33186,3,3186,[678 234 238  25 496],416,4,13523,4.243175400062755,0.0,0.0
33187,3,3187,[275 294   4 176 168],297,3,13526,4.242785445420326,0.0,0.0
33188,3,3188,[ 64 318 313 301  11],416,5,13531,4.243022891188461,60.0,20.0
33189,3,3189,[496 234 176 183  64],618,5,13536,4.243260188087774,20.0,0.0
33190,3,3190,[ 64 318 313 301  11],416,5,13541,4.243497336258226,60.0,20.0
33191,3,3191,[ 64 318 313 301  11],345,5,13546,4.243734335839599,60.0,20.0
33192,3,3192,[ 64 318 313 301  11],43,5,13551,4.2439711869715,60.0,20.0
33193,3,3193,[385  97 318   4 161],198,1,13552,4.242955541640576,20.0,0.0
33194,3,3194,[ 64 318 313 301  11],43,5,13557,4.243192488262911,60.0,20.0
33195,3,3195,[ 64 318 313 301  11],416,5,13562,4.243429286608261,60.0,20.0
33196,3,3196,[ 64 318 313 301  11],43,5,13567,4.2436659368157645,60.0,20.0
33197,3,3197,[ 64 318 313 301  11],43,5,13572,4.2439024390243905,60.0,20.0
33198,3,3198,[168 144 603  95  79],297,2,13574,4.243201000312598,0.0,0.0
33199,3,3199,[ 64 318 313 301  11],416,5,13579,4.2434375,60.0,20.0
33200,3,3200,[ 64 318 313 301  11],345,5,13584,4.243673851921274,60.0,20.0
33201,3,3201,[ 64 318 313 301  11],416,5,13589,4.243910056214865,60.0,20.0
33202,3,3202,[ 64 318 313 301  11],345,5,13594,4.2441461130190445,60.0,20.0
33203,3,3203,[ 64 318 313 301  11],416,5,13599,4.24438202247191,60.0,20.0
33204,3,3204,[268 245 202  69 183],417,4,13603,4.24430577223089,0.0,0.0
33205,3,3205,[ 64 318 313 301  11],43,5,13608,4.244541484716157,60.0,20.0
33206,3,3206,[ 88 269 111 127 323],416,3,13611,4.244153414405987,0.0,0.0
33207,3,3207,[286 313  96 273 125],416,5,13616,4.2443890274314215,20.0,20.0
33208,3,3208,[ 97 211  28  98 222],43,5,13621,4.244624493611717,0.0,20.0
33209,3,3209,[ 64 318 313 301  11],416,5,13626,4.244859813084112,60.0,20.0
33210,3,3210,[ 64 318 313 301  11],345,5,13631,4.245094985985674,60.0,20.0
33211,3,3211,[ 64 318 313 301  11],345,5,13636,4.2453300124533,60.0,20.0
33212,3,3212,[135 405 143  82 179],805,2,13638,4.244631185807656,0.0,0.0
33213,3,3213,[ 64 318 313 301  11],43,5,13643,4.244866210329807,60.0,20.0
33214,3,3214,[ 64 318 313 301  11],416,5,13648,4.245101088646967,60.0,20.0
33215,3,3215,[ 64 318 313 301  11],345,5,13653,4.245335820895522,60.0,20.0
33216,3,3216,[118 173 186 275 258],43,4,13657,4.245259558594964,0.0,0.0
33217,3,3217,[ 64 318 313 301  11],345,5,13662,4.2454940957116225,60.0,20.0
33218,3,3218,[ 64 318 313 301  11],416,5,13667,4.245728487107797,60.0,20.0
33219,3,3219,[176 245 302 269   1],297,3,13670,4.245341614906832,0.0,0.0
33220,3,3220,[ 64 318 313 301  11],416,5,13675,4.245575908103073,60.0,20.0
33221,3,3221,[173 276 181 216 180],128,5,13680,4.245810055865922,0.0,20.0
33222,3,3222,[ 64 318 313 301  11],416,5,13685,4.246044058330748,60.0,20.0
33223,3,3223,[245 294  97 111 197],128,2,13687,4.245347394540943,0.0,0.0
33224,3,3224,[ 64 318 313 301  11],345,5,13692,4.245581395348837,60.0,20.0
33225,3,3225,[ 64 318 313 301  11],345,5,13697,4.2458152510849345,60.0,20.0
33226,3,3226,[ 64 318 313 301  11],345,5,13702,4.246048961884103,60.0,20.0
33227,3,3227,[ 64 318 313 301  11],345,5,13707,4.246282527881041,60.0,20.0
33228,3,3228,[ 64 318 313 301  11],43,5,13712,4.2465159492102815,60.0,20.0
33229,3,3229,[234 111  12 173 655],588,3,13715,4.246130030959752,20.0,0.0
33230,3,3230,[ 64 318 313 301  11],43,5,13720,4.2463633549984525,60.0,20.0
33231,3,3231,[ 64 318 313 301  11],345,5,13725,4.246596534653466,60.0,20.0
33232,3,3232,[  9 235 471 183  98],887,0,13725,4.245283018867925,0.0,20.0
33233,3,3233,[  7 357 180 144   9],62,4,13729,4.245207173778603,0.0,0.0
33234,3,3234,[161 216 186  64 318],711,4,13733,4.245131375579598,40.0,0.0
33235,3,3235,[ 64 318 313 301  11],416,5,13738,4.2453646477132265,60.0,20.0
33236,3,3236,[ 89 282 742 195  98],297,2,13740,4.244670991658944,0.0,20.0
33237,3,3237,[289 121 100 125 294],416,4,13744,4.244595429277331,0.0,0.0
33238,3,3238,[ 64 318 313 301  11],416,5,13749,4.244828650818154,60.0,20.0
33239,3,3239,[ 64 318 313 301  11],43,5,13754,4.245061728395061,60.0,20.0
33240,3,3240,[ 64 318 313 301  11],345,5,13759,4.245294662141315,60.0,20.0
33241,3,3241,[ 64 318 313 301  11],345,5,13764,4.245527452190006,60.0,20.0
33242,3,3242,[125  28 234 153 210],262,0,13764,4.244218316373728,0.0,0.0
33243,3,3243,[ 64 318 313 301  11],345,5,13769,4.244451294697904,60.0,20.0
33244,3,3244,[ 64 318 313 301  11],43,5,13774,4.244684129429892,60.0,20.0
33245,3,3245,[202 258 405 151 172],43,5,13779,4.244916820702403,0.0,0.0
33246,3,3246,[118 496 183 257 191],417,3,13782,4.244533415460425,0.0,0.0
33247,3,3247,[151 471  88 323 294],345,2,13784,4.24384236453202,0.0,0.0
33248,3,3248,[ 64 318 313 301  11],345,5,13789,4.244075100030779,60.0,20.0
33249,3,3249,[ 64 318 313 301  11],416,5,13794,4.244307692307692,60.0,20.0
33250,3,3250,[568  69 483   8 655],618,4,13798,4.244232543832667,20.0,0.0
33251,3,3251,[ 64 318 313 301  11],43,5,13803,4.2444649446494465,60.0,20.0
33252,3,3252,[ 97 168 748 211 117],373,4,13807,4.244389794036274,0.0,0.0
33253,3,3253,[ 50 271 100 313 202],907,5,13812,4.244622003687769,20.0,40.0
33254,3,3254,[ 64 318 313 301  11],345,5,13817,4.244854070660522,60.0,20.0
33255,3,3255,[197 405   4 151 294],345,4,13821,4.2447788697788695,0.0,0.0
33256,3,3256,[ 64 318 313 301  11],43,5,13826,4.245010746085355,60.0,20.0
33257,3,3257,[ 64 318 313 301  11],43,5,13831,4.24524248004911,60.0,20.0
33258,3,3258,[  7 173 568 195 235],417,2,13833,4.244553544031912,0.0,0.0
33259,3,3259,[ 64 318 313 301  11],416,5,13838,4.244785276073619,60.0,20.0
33260,3,3260,[127 176 427  69 273],416,5,13843,4.245016865992027,0.0,0.0
33261,3,3261,[ 79 257   8 222  50],654,5,13848,4.245248313917842,0.0,20.0
33262,3,3262,[216  25 471 111  79],345,3,13851,4.244866687097763,0.0,0.0
33263,3,3263,[132 234  97 282 195],618,3,13854,4.244485294117647,0.0,0.0
33264,3,3264,[ 64 318 313 301  11],416,5,13859,4.2447166921898924,60.0,20.0
33265,3,3265,[ 64 318 313 301  11],345,5,13864,4.244947948560931,60.0,20.0
33266,3,3266,[ 64 318 313 301  11],43,5,13869,4.245179063360881,60.0,20.0
33267,3,3267,[215 210 121  12 300],654,5,13874,4.245410036719706,20.0,0.0
33268,3,3268,[ 64 318 313 301  11],345,5,13879,4.245640868767207,60.0,20.0
33269,3,3269,[ 64 318 313 301  11],416,5,13884,4.245871559633027,60.0,20.0
33270,3,3270,[238 174 186 275 118],43,3,13887,4.245490675634363,0.0,0.0
33271,3,3271,[ 22 195  64 127 588],601,3,13890,4.245110024449878,20.0,0.0
33272,3,3272,[ 64 318 313 301  11],416,5,13895,4.245340666055607,60.0,20.0
33273,3,3273,[ 64 318 313 301  11],43,5,13900,4.245571166768479,60.0,20.0
33274,3,3274,[ 64 318 313 301  11],416,5,13905,4.245801526717557,60.0,20.0
33275,3,3275,[200 204 181 742  95],805,1,13906,4.244810744810745,0.0,20.0
33276,3,3276,[ 11 655 546 202 151],314,5,13911,4.245041196216051,0.0,0.0
33277,3,3277,[ 64 318 313 301  11],345,5,13916,4.245271507016473,60.0,20.0
33278,3,3278,[100  70 427  22  98],416,5,13921,4.245501677340653,0.0,20.0
33279,3,3279,[ 64 210 117 202   1],230,5,13926,4.2457317073170735,20.0,0.0
33280,3,3280,[ 64 318 313 301  11],43,5,13931,4.2459615970740625,60.0,20.0
33281,3,3281,[ 64 318 313 301  11],43,5,13936,4.246191346739793,60.0,20.0
33282,3,3282,[ 64 318 313 301  11],345,5,13941,4.246420956442279,60.0,20.0
33283,3,3283,[357 568 210 132  56],230,3,13944,4.246041412911084,0.0,0.0
33284,3,3284,[ 64 318 313 301  11],345,5,13949,4.246270928462709,60.0,20.0
33285,3,3285,[ 64 318 313 301  11],43,5,13954,4.246500304321363,60.0,20.0
33286,3,3286,[  8  25 132 742 144],854,2,13956,4.245816854274414,0.0,0.0
33287,3,3287,[ 64 318 313 301  11],43,5,13961,4.246046228710462,60.0,20.0
33288,3,3288,[ 64 318 313 301  11],43,5,13966,4.246275463666768,60.0,20.0
33289,3,3289,[ 64 318 313 301  11],416,5,13971,4.246504559270517,60.0,20.0
33290,3,3290,[228  71  97  25 265],230,3,13974,4.2461257976299,0.0,0.0
33291,3,3291,[ 64 318 313 301  11],345,5,13979,4.246354799513973,60.0,20.0
33292,3,3292,[ 79  71 132 655 286],24,4,13983,4.246279987853022,0.0,0.0
33293,3,3293,[ 71  69 176 151 282],618,3,13986,4.245901639344262,0.0,0.0
33294,3,3294,[ 64 318 313 301  11],345,5,13991,4.246130500758725,60.0,20.0
33295,3,3295,[275 222  71 597  56],654,4,13995,4.246055825242719,0.0,0.0
33296,3,3296,[ 64 318 313 301  11],416,5,14000,4.246284501061571,60.0,20.0
33297,3,3297,[ 64 318 313 301  11],416,5,14005,4.246513038204973,60.0,20.0
33298,3,3298,[  7 127 191 289 211],43,5,14010,4.24674143679903,0.0,0.0
33299,3,3299,[742 111 118 195  15],159,3,14013,4.246363636363636,0.0,0.0
33300,3,3300,[111 269 313 135 215],711,3,14016,4.2459860648288394,20.0,20.0
33301,3,3301,[ 64 318 313 301  11],416,5,14021,4.246214415505754,60.0,20.0
33302,3,3302,[ 89 257 173 603 515],297,4,14025,4.24613987284287,0.0,0.0
33303,3,3303,[ 64 318 313 301  11],43,5,14030,4.24636803874092,60.0,20.0
33304,3,3304,[ 64 318 313 301  11],43,5,14035,4.246596066565809,60.0,20.0
33305,3,3305,[211   7 302 403  22],416,5,14040,4.246823956442832,0.0,0.0
33306,3,3306,[197 678 135  28  25],297,3,14043,4.246446930752948,0.0,0.0
33307,3,3307,[210 288 257 302 546],62,2,14045,4.245767835550182,0.0,20.0
33308,3,3308,[ 64 318 313 301  11],43,5,14050,4.245995769114536,60.0,20.0
33309,3,3309,[ 64 318 313 301  11],345,5,14055,4.246223564954683,60.0,20.0
33310,3,3310,[ 64 318 313 301  11],43,5,14060,4.246451223195409,60.0,20.0
33311,3,3311,[125 588 245 289 211],416,3,14063,4.246074879227053,0.0,0.0
33312,3,3312,[195  70  71 403 204],642,3,14066,4.245698762450951,0.0,0.0
33313,3,3313,[ 64 318 313 301  11],345,5,14071,4.245926372963186,60.0,20.0
33314,3,3314,[ 64 318 313 301  11],43,5,14076,4.246153846153846,60.0,20.0
33315,3,3315,[234 117 269   4 405],416,5,14081,4.246381182147165,0.0,0.0
33316,3,3316,[ 64 318 313 301  11],416,5,14086,4.2466083810672295,60.0,20.0
33317,3,3317,[ 64 318 313 301  11],43,5,14091,4.246835443037975,60.0,20.0
33318,3,3318,[ 64 318 313 301  11],43,5,14096,4.247062368183188,60.0,20.0
33319,3,3319,[ 64 318 313 301  11],43,5,14101,4.247289156626506,60.0,20.0
33320,3,3320,[ 64 318 313 301  11],345,5,14106,4.247515808491419,60.0,20.0
33321,3,3321,[204 546 423   1 275],654,5,14111,4.247742323901265,0.0,0.0
33322,3,3322,[ 64 318 313 301  11],416,5,14116,4.247968702979236,60.0,20.0
33323,3,3323,[ 64 318 313 301  11],416,5,14121,4.248194945848375,60.0,20.0
33324,3,3324,[588   8  64 234 153],253,4,14125,4.2481203007518795,20.0,0.0
33325,3,3325,[ 64 318 313 301  11],345,5,14130,4.248346361996392,60.0,20.0
33326,3,3326,[257 117 118 237 273],297,3,14133,4.247971145175834,0.0,0.0
33327,3,3327,[ 64 318 313 301  11],416,5,14138,4.248197115384615,60.0,20.0
33328,3,3328,[235 423 176 405 385],805,1,14139,4.247221387804146,0.0,0.0
33329,3,3329,[ 64 318 313 301  11],43,5,14144,4.247447447447447,60.0,20.0
33330,3,3330,[ 64 318 313 301  11],345,5,14149,4.247673371359952,60.0,20.0
33331,3,3331,[ 98 268 182  64  56],214,4,14153,4.247599039615847,20.0,20.0
33332,3,3332,[ 64 318 313 301  11],43,5,14158,4.247824782478248,60.0,20.0
33333,3,3333,[ 64 318 313 301  11],345,5,14163,4.248050389922016,60.0,20.0
33334,3,3334,[ 98 185 403 269  64],711,5,14168,4.248275862068965,20.0,20.0
33335,3,3335,[ 64 318 313 301  11],416,5,14173,4.248501199040767,60.0,20.0
33336,3,3336,[ 64 318 313 301  11],43,5,14178,4.248726400958946,60.0,20.0
33337,3,3337,[ 64 318 313 301  11],43,5,14183,4.248951467944877,60.0,20.0
33338,3,3338,[ 64 318 313 301  11],345,5,14188,4.249176400119796,60.0,20.0
33339,3,3339,[ 64 318 313 301  11],416,5,14193,4.24940119760479,60.0,20.0
33340,3,3340,[ 64 318 313 301  11],416,5,14198,4.249625860520802,60.0,20.0
33341,3,3341,[ 64 318 313 301  11],416,5,14203,4.249850388988629,60.0,20.0
33342,3,3342,[ 64 318 313 301  11],416,5,14208,4.250074783128926,60.0,20.0
33343,3,3343,[ 64 318 313 301  11],43,5,14213,4.250299043062201,60.0,20.0
33344,3,3344,[186   7 161 185 597],417,1,14214,4.24932735426009,0.0,0.0
33345,3,3345,[265 144 323 748 161],416,4,14218,4.249252839210998,0.0,0.0
33346,3,3346,[ 64 318 313 301  11],416,5,14223,4.249477143710786,60.0,20.0
33347,3,3347,[ 64 318 313 301  11],416,5,14228,4.249701314217443,60.0,20.0
33348,3,3348,[289 153 151 191 403],416,3,14231,4.2493281576590025,0.0,0.0
33349,3,3349,[385 471 238 423 483],618,3,14234,4.248955223880597,20.0,0.0
33350,3,3350,[ 64 318 313 301  11],345,5,14239,4.249179349447926,60.0,20.0
33351,3,3351,[ 64 318 313 301  11],416,5,14244,4.249403341288783,60.0,20.0
33352,3,3352,[ 64 318 313 301  11],416,5,14249,4.249627199522815,60.0,20.0
33353,3,3353,[215 286 186 275 597],43,3,14252,4.249254621347645,0.0,0.0
33354,3,3354,[ 64 318 313 301  11],416,5,14257,4.249478390461997,60.0,20.0
33355,3,3355,[ 64 318 313 301  11],416,5,14262,4.2497020262216925,60.0,20.0
33356,3,3356,[175 403  69 196 742],43,4,14266,4.249627643729521,0.0,0.0
33357,3,3357,[289 328  96  12 257],416,3,14269,4.249255509231686,20.0,0.0
33358,3,3358,[153 588 202 174 742],642,3,14272,4.248883596308425,0.0,0.0
33359,3,3359,[151 196   1 276 186],43,4,14276,4.248809523809523,0.0,0.0
33360,3,3360,[ 64 318 313 301  11],43,5,14281,4.249033025885153,60.0,20.0
33361,3,3361,[181  12   8 405 194],416,5,14286,4.249256395002974,20.0,20.0
33362,3,3362,[742 357 405 300  95],416,4,14290,4.249182277728218,0.0,0.0
33363,3,3363,[ 64 318 313 301  11],43,5,14295,4.249405469678954,60.0,20.0
33364,3,3364,[234  15  22  25 265],588,5,14300,4.24962852897474,0.0,0.0
33365,3,3365,[181 215 269 403 588],711,4,14304,4.249554367201426,0.0,20.0
33366,3,3366,[ 64 318 313 301  11],416,5,14309,4.2497772497772495,60.0,20.0
33367,3,3367,[ 64 318 313 301  11],43,5,14314,4.25,60.0,20.0
33368,3,3368,[ 69 191 435 187  50],505,0,14314,4.248738498070644,0.0,20.0
33369,3,3369,[ 64 318 313 301  11],345,5,14319,4.248961424332344,60.0,20.0
33370,3,3370,[ 64 318 313 301  11],345,5,14324,4.2491842183328385,60.0,20.0
33371,3,3371,[ 64 318 313 301  11],416,5,14329,4.249406880189798,60.0,20.0
33372,3,3372,[118  95 153  28  88],43,5,14334,4.249629410020753,0.0,0.0
33373,3,3373,[ 64 318 313 301  11],416,5,14339,4.249851807943094,60.0,20.0
33374,3,3374,[ 64 318 313 301  11],43,5,14344,4.250074074074074,60.0,20.0
33375,3,3375,[ 64 318 313 301  11],416,5,14349,4.250296208530806,60.0,20.0
33376,3,3376,[ 64 318 313 301  11],416,5,14354,4.250518211430264,60.0,20.0
33377,3,3377,[121  88 655 268 181],128,3,14357,4.250148016577857,0.0,20.0
33378,3,3378,[202 245 496 302 191],417,3,14360,4.249778040840486,0.0,0.0
33379,3,3379,[ 64 318 313 301  11],345,5,14365,4.25,60.0,20.0
33380,3,3380,[135 568 475 216  96],198,4,14369,4.249926057379474,0.0,0.0
33381,3,3381,[ 89 405 195 318 202],642,0,14369,4.248669426374926,20.0,0.0
33382,3,3382,[ 64 318 313 301  11],416,5,14374,4.248891516405557,60.0,20.0
33383,3,3383,[ 64 318 313 301  11],416,5,14379,4.249113475177305,60.0,20.0
33384,3,3384,[ 64 318 313 301  11],416,5,14384,4.249335302806499,60.0,20.0
33385,3,3385,[ 64 318 313 301  11],345,5,14389,4.249556999409332,60.0,20.0
33386,3,3386,[245 132 268 118 174],416,3,14392,4.249188072040154,0.0,0.0
33387,3,3387,[ 64 318 313 301  11],43,5,14397,4.2494096812278634,60.0,20.0
33388,3,3388,[ 64 318 313 301  11],416,5,14402,4.24963115963411,60.0,20.0
33389,3,3389,[318  12  69  71 405],416,5,14407,4.249852507374631,40.0,0.0
33390,3,3390,[ 64 318 313 301  11],416,5,14412,4.250073724565025,60.0,20.0
33391,3,3391,[ 64 318 313 301  11],345,5,14417,4.250294811320755,60.0,20.0
33392,3,3392,[ 64 318 313 301  11],345,5,14422,4.250515767757147,60.0,20.0
33393,3,3393,[ 64 318 313 301  11],416,5,14427,4.250736593989393,60.0,20.0
33394,3,3394,[117 333 195 286 300],416,5,14432,4.250957290132548,0.0,0.0
33395,3,3395,[ 64 318 313 301  11],416,5,14437,4.251177856301531,60.0,20.0
33396,3,3396,[748 125 515  96 191],416,5,14442,4.251398292611127,0.0,0.0
33397,3,3397,[ 64 318 313 301  11],416,5,14447,4.251618599175986,60.0,20.0
33398,3,3398,[222  97 202 168  25],43,5,14452,4.25183877611062,0.0,0.0
33399,3,3399,[ 64 318 313 301  11],43,5,14457,4.252058823529412,60.0,20.0
33400,3,3400,[ 64 318 313 301  11],416,5,14462,4.252278741546604,60.0,20.0
33401,3,3401,[ 64 318 313 301  11],345,5,14467,4.252498530276308,60.0,20.0
33402,3,3402,[313  12   8  82 202],405,5,14472,4.252718189832501,40.0,20.0
33403,3,3403,[286 245 301 127 435],721,4,14476,4.2526439482961225,0.0,0.0
33404,3,3404,[ 64 318 313 301  11],416,5,14481,4.252863436123348,60.0,20.0
33405,3,3405,[ 64 318 313 301  11],416,5,14486,4.253082795067528,60.0,20.0
33406,3,3406,[ 64 318 313 301  11],416,5,14491,4.2533020252421485,60.0,20.0
33407,3,3407,[ 64 318 313 301  11],345,5,14496,4.253521126760563,60.0,20.0
33408,3,3408,[ 95 161  88 742 216],314,4,14500,4.253446758580229,0.0,0.0
33409,3,3409,[ 64 318 313 301  11],43,5,14505,4.25366568914956,60.0,20.0
33410,3,3410,[125  15 588 678   9],416,4,14509,4.253591322192905,0.0,0.0
33411,3,3411,[180 121 179 117 161],198,1,14510,4.25263774912075,0.0,0.0
33412,3,3412,[195 197   4   1 228],297,0,14510,4.251391737474362,0.0,0.0
33413,3,3413,[ 64 318 313 301  11],416,5,14515,4.251611013473931,60.0,20.0
33414,3,3414,[ 64 318 313 301  11],416,5,14520,4.251830161054173,60.0,20.0
33415,3,3415,[ 64 318 313 301  11],345,5,14525,4.252049180327869,60.0,20.0
33416,3,3416,[276  25 496 265 187],618,3,14528,4.2516827626573015,0.0,0.0
33417,3,3417,[197 121 135 302  15],854,2,14530,4.2510239906378,0.0,0.0
33418,3,3418,[ 28 144 215 403 275],373,2,14532,4.250365603977771,0.0,0.0
33419,3,3419,[ 64 318 313 301  11],345,5,14537,4.250584795321638,60.0,20.0
33420,3,3420,[ 96 288  11  56 151],417,3,14540,4.2502192341420635,0.0,20.0
33421,3,3421,[ 64 318 313 301  11],43,5,14545,4.250438340151958,60.0,20.0
33422,3,3422,[200   8  50 508   9],854,5,14550,4.250657318141981,0.0,20.0
33423,3,3423,[ 64 318 313 301  11],345,5,14555,4.250876168224299,60.0,20.0
33424,3,3424,[ 64 318 313 301  11],43,5,14560,4.251094890510949,60.0,20.0
33425,3,3425,[ 64 318 313 301  11],43,5,14565,4.251313485113835,60.0,20.0
33426,3,3426,[ 64 318 313 301  11],43,5,14570,4.251531952144733,60.0,20.0
33427,3,3427,[ 64 318 313 301  11],43,5,14575,4.251750291715286,60.0,20.0
33428,3,3428,[168  95 174 202  98],588,2,14577,4.2510936132983375,0.0,20.0
33429,3,3429,[ 12  15 176  50 132],416,5,14582,4.2513119533527695,20.0,20.0
33430,3,3430,[ 64 318 313 301  11],43,5,14587,4.251530166132323,60.0,20.0
33431,3,3431,[ 64 318 313 301  11],345,5,14592,4.251748251748252,60.0,20.0
33432,3,3432,[ 64 318 313 301  11],416,5,14597,4.25196621031168,60.0,20.0
33433,3,3433,[ 64 318 313 301  11],43,5,14602,4.252184041933605,60.0,20.0
33434,3,3434,[161 423 322 603 118],416,3,14605,4.251819505094614,0.0,0.0
33435,3,3435,[153  50  69  71 275],262,3,14608,4.251455180442375,0.0,20.0
33436,3,3436,[ 64 318 313 301  11],345,5,14613,4.251672970613908,60.0,20.0
33437,3,3437,[ 64 318 313 301  11],43,5,14618,4.251890634089587,60.0,20.0
33438,3,3438,[117 234 357  28   4],805,2,14620,4.251235824367549,0.0,0.0
33439,3,3439,[181 172 111  70 196],62,3,14623,4.250872093023256,0.0,20.0
33440,3,3440,[  4 237  64  69 289],43,5,14628,4.251089799476897,20.0,0.0
33441,3,3441,[ 64 318 313 301  11],43,5,14633,4.251307379430564,60.0,20.0
33442,3,3442,[ 64 318 313 301  11],345,5,14638,4.251524832994481,60.0,20.0
33443,3,3443,[322  12 144 168 176],417,3,14641,4.251161440185831,20.0,0.0
33444,3,3444,[ 64 318 313 301  11],416,5,14646,4.251378809869376,60.0,20.0
33445,3,3445,[286 168 197 423 176],297,3,14649,4.251015670342426,0.0,0.0
33446,3,3446,[313  12 276 144 181],618,4,14653,4.250942848854076,40.0,40.0
33447,3,3447,[588  56 143 125  96],642,5,14658,4.2511600928074245,0.0,0.0
33448,3,3448,[ 64 318 313 301  11],416,5,14663,4.251377210785735,60.0,20.0
33449,3,3449,[294 234  98  95 228],297,1,14664,4.2504347826086954,0.0,20.0
33450,3,3450,[202 127 588  89  22],253,5,14669,4.2506519849319035,0.0,0.0
33451,3,3451,[ 64 318 313 301  11],43,5,14674,4.250869061413673,60.0,20.0
33452,3,3452,[405 179 180 151 222],62,4,14678,4.25079640891978,0.0,0.0
33453,3,3453,[357 288 286 318 265],416,5,14683,4.251013317892299,20.0,20.0
33454,3,3454,[ 88 132 238  70 144],373,3,14686,4.250651230101303,0.0,0.0
33455,3,3455,[257 588  25   1 117],751,4,14690,4.250578703703703,0.0,0.0
33456,3,3456,[ 64 318 313 301  11],416,5,14695,4.250795487416835,60.0,20.0
33457,3,3457,[202 282 195 153 301],416,5,14700,4.251012145748988,0.0,0.0
33458,3,3458,[228  89   1  12 210],62,3,14703,4.250650477016479,20.0,0.0
33459,3,3459,[ 64 318 313 301  11],345,5,14708,4.250867052023121,60.0,20.0
33460,3,3460,[ 64 318 313 301  11],43,5,14713,4.25108350187807,60.0,20.0
33461,3,3461,[  8 222   9 288 302],62,3,14716,4.250722125938764,0.0,20.0
33462,3,3462,[ 64 318 313 301  11],43,5,14721,4.250938492636442,60.0,20.0
33463,3,3463,[161 403  28 111 143],43,5,14726,4.251154734411085,0.0,0.0
33464,3,3464,[100 275 194 515  97],416,5,14731,4.251370851370852,0.0,0.0
33465,3,3465,[ 64 318 313 301  11],43,5,14736,4.251586843623774,60.0,20.0
33466,3,3466,[121 237  96 180   9],62,4,14740,4.25151427747332,0.0,0.0
33467,3,3467,[ 64 318 313 301  11],416,5,14745,4.251730103806229,60.0,20.0
33468,3,3468,[238  50 196 257 118],654,4,14749,4.251657538195445,0.0,20.0
33469,3,3469,[322  71 161 301 237],416,3,14752,4.2512968299711815,0.0,0.0
33470,3,3470,[ 64 318 313 301  11],43,5,14757,4.251512532411409,60.0,20.0
33471,3,3471,[ 64 318 313 301  11],43,5,14762,4.251728110599078,60.0,20.0
33472,3,3472,[ 64 318 313 301  11],43,5,14767,4.25194356464152,60.0,20.0
33473,3,3473,[288 210 151 275   7],416,4,14771,4.251871042026482,0.0,20.0
33474,3,3474,[ 64 318 313 301  11],345,5,14776,4.252086330935252,60.0,20.0
33475,3,3475,[423 135  79 153 185],297,3,14779,4.251726121979287,0.0,0.0
33476,3,3476,[ 64 318 313 301  11],43,5,14784,4.251941328731665,60.0,20.0
33477,3,3477,[275  69 603 151  89],297,3,14787,4.251581368602645,0.0,0.0
33478,3,3478,[ 64 318 313 301  11],43,5,14792,4.251796493245186,60.0,20.0
33479,3,3479,[ 95  64 144 204 143],618,3,14795,4.251436781609195,20.0,0.0
33480,3,3480,[ 64 318 313 301  11],416,5,14800,4.251651824188452,60.0,20.0
33481,3,3481,[ 64 318 313 301  11],345,5,14805,4.251866743251005,60.0,20.0
33482,3,3482,[ 89 475 403 204 176],198,4,14809,4.251794430089004,0.0,0.0
33483,3,3483,[175 302 286  97 234],297,4,14813,4.251722158438576,0.0,0.0
33484,3,3484,[286  69 179 216 275],373,3,14816,4.251362984218077,0.0,0.0
33485,3,3485,[ 64 318 313 301  11],345,5,14821,4.251577739529547,60.0,20.0
33486,3,3486,[ 64 318 313 301  11],345,5,14826,4.2517923716661885,60.0,20.0
33487,3,3487,[ 64 318 313 301  11],345,5,14831,4.252006880733945,60.0,20.0
33488,3,3488,[  7 423   4 385   1],805,2,14833,4.251361421610777,0.0,0.0
33489,3,3489,[121 289  50 323 175],43,3,14836,4.251002865329513,0.0,20.0
33490,3,3490,[ 50  15 286 215 318],588,5,14841,4.2512174162131195,20.0,20.0
33491,3,3491,[ 64 318 313 301  11],416,5,14846,4.251431844215349,60.0,20.0
33492,3,3492,[ 64 318 313 301  11],43,5,14851,4.251646149441741,60.0,20.0
33493,3,3493,[ 22 603 546 196 204],297,3,14854,4.251287922152261,0.0,0.0
33494,3,3494,[ 64 318 313 301  11],416,5,14859,4.251502145922747,60.0,20.0
33495,3,3495,[  1 196 268  88 237],128,4,14863,4.2514302059496565,0.0,0.0
33496,3,3496,[210 222 153 172 216],417,1,14864,4.250500428939091,0.0,0.0
33497,3,3497,[ 64 318 313 301  11],345,5,14869,4.25071469411092,60.0,20.0
33498,3,3498,[ 25 423  71 196 228],805,1,14870,4.249785653043727,0.0,0.0
33499,3,3499,[ 64 318 313 301  11],416,5,14875,4.25,60.0,20.0
33500,3,3500,[ 64 318 313 301  11],416,5,14880,4.250214224507284,60.0,20.0
33501,3,3501,[ 64 318 313 301  11],43,5,14885,4.250428326670474,60.0,20.0
33502,3,3502,[238 121  28 742   1],62,2,14887,4.2497858978018845,0.0,0.0
33503,3,3503,[ 64 318 313 301  11],345,5,14892,4.25,60.0,20.0
33504,3,3504,[588 111 235  22 269],297,3,14895,4.249643366619115,0.0,0.0
33505,3,3505,[ 64 318 313 301  11],43,5,14900,4.249857387335996,60.0,20.0
33506,3,3506,[301 216 186  70 204],43,4,14904,4.249786142001711,0.0,0.0
33507,3,3507,[216 182  69 405 678],416,4,14908,4.249714937286203,0.0,0.0
33508,3,3508,[265 483 197 143 100],618,4,14912,4.2496437731547445,20.0,0.0
33509,3,3509,[ 64 318 313 301  11],416,5,14917,4.24985754985755,60.0,20.0
33510,3,3510,[ 64 318 313 301  11],416,5,14922,4.250071204784962,60.0,20.0
33511,3,3511,[  8 132 143 173 588],588,5,14927,4.250284738041002,0.0,0.0
33512,3,3512,[ 64 318 313 301  11],43,5,14932,4.250498149729576,60.0,20.0
33513,3,3513,[ 64 318 313 301  11],416,5,14937,4.250711439954467,60.0,20.0
33514,3,3514,[ 25 471  95  79  12],416,4,14941,4.250640113798008,20.0,0.0
33515,3,3515,[  8 185 175 508  88],354,2,14943,4.25,0.0,0.0
33516,3,3516,[ 64 318 313 301  11],416,5,14948,4.250213249928916,60.0,20.0
33517,3,3517,[ 64 318 313 301  11],345,5,14953,4.250426378624218,60.0,20.0
33518,3,3518,[100 144 257 151 180],417,2,14955,4.249786871270247,0.0,0.0
33519,3,3519,[111 245  50 196 288],721,3,14958,4.249431818181818,0.0,40.0
33520,3,3520,[ 64 318 313 301  11],43,5,14963,4.24964498721954,60.0,20.0
33521,3,3521,[ 64 318 313 301  11],416,5,14968,4.249858035207269,60.0,20.0
33522,3,3522,[546  97 265  98 742],416,4,14972,4.249787113255748,0.0,20.0
33523,3,3523,[ 64 318 313 301  11],345,5,14977,4.25,60.0,20.0
33524,3,3524,[ 64 318 313 301  11],43,5,14982,4.250212765957447,60.0,20.0
33525,3,3525,[ 64 318 313 301  11],345,5,14987,4.250425411230856,60.0,20.0
33526,3,3526,[ 64 318 313 301  11],43,5,14992,4.250637935922881,60.0,20.0
33527,3,3527,[  7 234 475 117 238],416,4,14996,4.250566893424036,0.0,0.0
33528,3,3528,[ 64 318 313 301  11],345,5,15001,4.250779257580051,60.0,20.0
33529,3,3529,[ 64 318 313 301  11],345,5,15006,4.250991501416431,60.0,20.0
33530,3,3530,[322 357  96 181 111],630,2,15008,4.250354007363353,0.0,20.0
33531,3,3531,[742 175 125 200  82],253,2,15010,4.249716874292186,0.0,0.0
33532,3,3532,[357 288 172  70 194],416,5,15015,4.2499292386074154,0.0,20.0
33533,3,3533,[ 64 318 313 301  11],43,5,15020,4.250141482739106,60.0,20.0
33534,3,3534,[ 64 318 313 301  11],345,5,15025,4.2503536067892504,60.0,20.0
33535,3,3535,[273 118  56 475  89],297,4,15029,4.2502828054298645,0.0,0.0
33536,3,3536,[268 603 135 176 200],297,4,15033,4.250212044105174,0.0,0.0
33537,3,3537,[ 89 127 568 333 273],253,3,15036,4.249858677218768,0.0,0.0
33538,3,3538,[ 64 318 313 301  11],43,5,15041,4.250070641424131,60.0,20.0
33539,3,3539,[385 210 423 196 181],198,2,15043,4.2494350282485875,0.0,20.0
33540,3,3540,[234 211  22 508 175],297,4,15047,4.249364586275064,0.0,0.0
33541,3,3541,[ 64 318 313 301  11],345,5,15052,4.249576510446076,60.0,20.0
33542,3,3542,[ 64 318 313 301  11],43,5,15057,4.249788314987299,60.0,20.0
33543,3,3543,[ 64 318 313 301  11],43,5,15062,4.25,60.0,20.0
33544,3,3544,[191  69 313 118 238],345,4,15066,4.249929478138223,20.0,20.0
33545,3,3545,[111 174 117 210  28],437,1,15067,4.249012972363226,0.0,0.0
33546,3,3546,[ 64 318 313 301  11],345,5,15072,4.249224696926981,60.0,20.0
33547,3,3547,[ 82  25  79 161 228],230,3,15075,4.248872604284104,0.0,0.0
33548,3,3548,[289 235 168  71   9],887,3,15078,4.2485207100591715,0.0,0.0
33549,3,3549,[111 301 427 268 597],416,4,15082,4.248450704225352,0.0,0.0
33550,3,3550,[ 64 318 313 301  11],416,5,15087,4.248662348634188,60.0,20.0
33551,3,3551,[197 405 300 185   7],416,5,15092,4.248873873873874,0.0,0.0
33552,3,3552,[186 318 655 180 197],373,3,15095,4.24852237545736,20.0,0.0
33553,3,3553,[132 258 181 568 403],588,4,15099,4.248452447945977,0.0,20.0
33554,3,3554,[127   9 111   7 172],887,3,15102,4.248101265822785,0.0,0.0
33555,3,3555,[269 143   9 588 568],43,5,15107,4.2483127109111365,0.0,0.0
33556,3,3556,[ 64 318 313 301  11],345,5,15112,4.248524037109924,60.0,20.0
33557,3,3557,[ 64 318 313 301  11],416,5,15117,4.248735244519393,60.0,20.0
33558,3,3558,[ 64 318 313 301  11],345,5,15122,4.248946333239674,60.0,20.0
33559,3,3559,[405 200 179 215 195],198,3,15125,4.248595505617978,0.0,0.0
33560,3,3560,[ 64 318 313 301  11],43,5,15130,4.24880651502387,60.0,20.0
33561,3,3561,[ 64 318 313 301  11],43,5,15135,4.2490174059517125,60.0,20.0
33562,3,3562,[ 64 318 313 301  11],416,5,15140,4.249228178501263,60.0,20.0
33563,3,3563,[ 96  12  71 204 196],416,5,15145,4.249438832772166,20.0,0.0
33564,3,3564,[168  25 238 288 144],805,3,15148,4.249088359046283,0.0,20.0
33565,3,3565,[ 64 318 313 301  11],345,5,15153,4.249298934380258,60.0,20.0
33566,3,3566,[ 64 318 313 301  11],345,5,15158,4.249509391645641,60.0,20.0
33567,3,3567,[301 195  50 475 588],297,4,15162,4.249439461883408,0.0,20.0
33568,3,3568,[ 64 318 313 301  11],43,5,15167,4.24964976183805,60.0,20.0
33569,3,3569,[ 64 318 313 301  11],345,5,15172,4.249859943977591,60.0,20.0
33570,3,3570,[ 64 318 313 301  11],345,5,15177,4.250070008401008,60.0,20.0
33571,3,3571,[ 64 318 313 301  11],345,5,15182,4.250279955207167,60.0,20.0
33572,3,3572,[235 176 269 185  22],854,2,15184,4.2496501539322695,0.0,0.0
33573,3,3573,[ 64 318 313 301  11],345,5,15189,4.249860100727476,60.0,20.0
33574,3,3574,[ 97  50  56 197 187],416,5,15194,4.25006993006993,0.0,20.0
33575,3,3575,[ 64 318 313 301  11],345,5,15199,4.250279642058166,60.0,20.0
33576,3,3576,[ 64 318 313 301  11],416,5,15204,4.250489236790607,60.0,20.0
33577,3,3577,[328 153 742 235 210],62,3,15207,4.250139742873113,0.0,0.0
33578,3,3578,[ 64 318 313 301  11],416,5,15212,4.250349259569712,60.0,20.0
33579,3,3579,[ 64 318 313 301  11],43,5,15217,4.2505586592178775,60.0,20.0
33580,3,3580,[ 64 318 313 301  11],345,5,15222,4.250767941915666,60.0,20.0
33581,3,3581,[ 64 318 313 301  11],345,5,15227,4.250977107761027,60.0,20.0
33582,3,3582,[268 151 508 496 276],128,3,15230,4.2506279653921295,0.0,0.0
33583,3,3583,[ 64 318 313 301  11],43,5,15235,4.250837053571429,60.0,20.0
33584,3,3584,[ 64 318 313 301  11],416,5,15240,4.2510460251046025,60.0,20.0
33585,3,3585,[ 64 210  22 222 475],62,5,15245,4.251254880089236,20.0,0.0
33586,3,3586,[ 64 318 313 301  11],345,5,15250,4.251463618622805,60.0,20.0
33587,3,3587,[ 64 318 313 301  11],43,5,15255,4.251672240802676,60.0,20.0
33588,3,3588,[288 313 161 228  69],711,2,15257,4.251044859292282,20.0,40.0
33589,3,3589,[183 195 273  70 204],618,2,15259,4.25041782729805,0.0,0.0
33590,3,3590,[204 294 195 215 187],416,5,15264,4.25062656641604,0.0,0.0
33591,3,3591,[403  82 588 211 182],405,2,15266,4.25,0.0,0.0
33592,3,3592,[132 318 180 195   7],887,5,15271,4.25020873921514,20.0,0.0
33593,3,3593,[588  79 202  97 496],43,5,15276,4.250417362270451,0.0,0.0
33594,3,3594,[ 95 423 313  82 276],654,4,15280,4.250347705146036,20.0,20.0
33595,3,3595,[204  96 168  11  98],198,4,15284,4.25027808676307,0.0,20.0
33596,3,3596,[ 64 174 200 161 144],417,2,15286,4.249652488184598,20.0,0.0
33597,3,3597,[143  97 187 228 269],373,2,15288,4.249027237354086,0.0,0.0
33598,3,3598,[  1 300  64  12 742],345,3,15291,4.248680188941373,40.0,0.0
33599,3,3599,[ 64 318 313 301  11],43,5,15296,4.248888888888889,60.0,20.0
33600,3,3600,[ 64  82 427 204 603],416,5,15301,4.249097472924188,20.0,0.0
33601,3,3601,[ 64 318 313 301  11],345,5,15306,4.249305941143809,60.0,20.0
33602,3,3602,[ 64 318 313 301  11],345,5,15311,4.249514293644185,60.0,20.0
33603,3,3603,[ 64 318 313 301  11],416,5,15316,4.249722530521643,60.0,20.0
33604,3,3604,[ 64 318 313 301  11],345,5,15321,4.2499306518724,60.0,20.0
33605,3,3605,[ 64 318 313 301  11],345,5,15326,4.250138657792568,60.0,20.0
33606,3,3606,[403 423 135 294  12],805,3,15329,4.249792070973108,20.0,0.0
33607,3,3607,[322  28 496 222  79],128,3,15332,4.249445676274944,0.0,0.0
33608,3,3608,[405  71  70 216 318],642,1,15333,4.248545303408147,20.0,0.0
33609,3,3609,[ 64 318 313 301  11],416,5,15338,4.2487534626038785,60.0,20.0
33610,3,3610,[ 64 318 313 301  11],43,5,15343,4.248961506507893,60.0,20.0
33611,3,3611,[ 82  12 435 288 603],437,2,15345,4.248338870431894,20.0,20.0
33612,3,3612,[100 265  28  70   8],416,5,15350,4.248546913921949,0.0,0.0
33613,3,3613,[ 64 318 313 301  11],416,5,15355,4.2487548422800225,60.0,20.0
33614,3,3614,[ 64 318 313 301  11],345,5,15360,4.24896265560166,60.0,20.0
33615,3,3615,[302  50 151 185 301],297,4,15364,4.248893805309734,0.0,20.0
33616,3,3616,[471 275  88 742  82],43,4,15368,4.248824993088195,0.0,0.0
33617,3,3617,[ 64 318 313 301  11],43,5,15373,4.249032614704256,60.0,20.0
33618,3,3618,[ 64 318 313 301  11],416,5,15378,4.249240121580547,60.0,20.0
33619,3,3619,[268   4 173  96 176],416,5,15383,4.249447513812155,0.0,0.0
33620,3,3620,[191 210   1  95 405],416,4,15387,4.249378624689312,0.0,0.0
33621,3,3621,[ 64 318 313 301  11],43,5,15392,4.249585864163445,60.0,20.0
33622,3,3622,[ 64 318 313 301  11],43,5,15397,4.2497929892354405,60.0,20.0
33623,3,3623,[423 216 603  88   4],405,2,15399,4.249172185430464,0.0,0.0
33624,3,3624,[318 183  56 237 597],62,3,15402,4.248827586206897,20.0,0.0
33625,3,3625,[ 64 318 313 301  11],416,5,15407,4.249034749034749,60.0,20.0
33626,3,3626,[268   1  82 222  15],417,4,15411,4.248966087675765,0.0,0.0
33627,3,3627,[ 64 318 313 301  11],416,5,15416,4.249173098125689,60.0,20.0
33628,3,3628,[ 64 318 313 301  11],43,5,15421,4.24937999448884,60.0,20.0
33629,3,3629,[ 64 318 313 301  11],43,5,15426,4.249586776859504,60.0,20.0
33630,3,3630,[ 64 318 313 301  11],416,5,15431,4.249793445331864,60.0,20.0
33631,3,3631,[ 64 318 313 301  11],345,5,15436,4.25,60.0,20.0
33632,3,3632,[265  82 597  22 742],416,4,15440,4.249931186347371,0.0,0.0
33633,3,3633,[ 69  22 275 117 238],416,5,15445,4.250137589433131,0.0,0.0
33634,3,3634,[ 64 318 313 301  11],43,5,15450,4.250343878954608,60.0,20.0
33635,3,3635,[ 64 318 313 301  11],43,5,15455,4.2505500550055,60.0,20.0
33636,3,3636,[276  50 286 182 275],416,4,15459,4.250481165795986,0.0,20.0
33637,3,3637,[323 423 588 237 210],43,4,15463,4.250412314458494,0.0,0.0
33638,3,3638,[ 64 318 313 301  11],416,5,15468,4.250618301731245,60.0,20.0
33639,3,3639,[ 64 318 313 301  11],416,5,15473,4.250824175824176,60.0,20.0
33640,3,3640,[ 64 318 313 301  11],345,5,15478,4.251029936830541,60.0,20.0
33641,3,3641,[181   9 496  56 174],601,4,15482,4.250961010433827,0.0,20.0
33642,3,3642,[ 64 318 313 301  11],416,5,15487,4.251166620916827,60.0,20.0
33643,3,3643,[ 64 318 313 301  11],43,5,15492,4.251372118551043,60.0,20.0
33644,3,3644,[ 64 318 313 301  11],345,5,15497,4.251577503429355,60.0,20.0
33645,3,3645,[ 64 318 313 301  11],345,5,15502,4.251782775644542,60.0,20.0
33646,3,3646,[100 276  97  22 328],62,3,15505,4.251439539347409,0.0,0.0
33647,3,3647,[ 95 153  69 273 515],417,3,15508,4.25109649122807,0.0,0.0
33648,3,3648,[ 64 318 313 301  11],43,5,15513,4.251301726500411,60.0,20.0
33649,3,3649,[483 127 195 197 172],618,3,15516,4.250958904109589,20.0,0.0
33650,3,3650,[ 64 318 313 301  11],43,5,15521,4.251164064639824,60.0,20.0
33651,3,3651,[ 64 318 313 301  11],345,5,15526,4.251369112814896,60.0,20.0
33652,3,3652,[ 64 318 313 301  11],416,5,15531,4.251574048727074,60.0,20.0
33653,3,3653,[ 64 318 313 301  11],345,5,15536,4.2517788724685275,60.0,20.0
33654,3,3654,[ 64 318 313 301  11],43,5,15541,4.251983584131327,60.0,20.0
33655,3,3655,[ 64 318 313 301  11],345,5,15546,4.25218818380744,60.0,20.0
33656,3,3656,[ 64 318 313 301  11],43,5,15551,4.252392671588734,60.0,20.0
33657,3,3657,[ 64 318 313 301  11],345,5,15556,4.252597047566977,60.0,20.0
33658,3,3658,[ 64 318 313 301  11],345,5,15561,4.252801311833834,60.0,20.0
33659,3,3659,[ 64 318 313 301  11],345,5,15566,4.253005464480874,60.0,20.0
33660,3,3660,[161  82 143 286  22],711,4,15570,4.252936356186834,0.0,0.0
33661,3,3661,[ 64 318 313 301  11],345,5,15575,4.253140360458766,60.0,20.0
33662,3,3662,[288 181  56  79 294],654,2,15577,4.252525252525253,0.0,40.0
33663,3,3663,[204   4 471 405 276],43,4,15581,4.252456331877729,0.0,0.0
33664,3,3664,[ 64 318 313 301  11],416,5,15586,4.252660300136426,60.0,20.0
33665,3,3665,[ 64 318 313 301  11],43,5,15591,4.252864157119476,60.0,20.0
33666,3,3666,[ 64 318 313 301  11],43,5,15596,4.253067902917916,60.0,20.0
33667,3,3667,[196  82 268 100  22],654,3,15599,4.252726281352236,0.0,0.0
33668,3,3668,[ 64 318 313 301  11],345,5,15604,4.252929953665849,60.0,20.0
33669,3,3669,[ 64 318 313 301  11],345,5,15609,4.253133514986376,60.0,20.0
33670,3,3670,[357  28 175  89 483],698,2,15611,4.252519749387088,20.0,0.0
33671,3,3671,[168  71 204 118 655],416,4,15615,4.252450980392157,0.0,0.0
33672,3,3672,[ 64 318 313 301  11],43,5,15620,4.252654505853526,60.0,20.0
33673,3,3673,[238 257 144 194 385],416,4,15624,4.252585737615678,0.0,0.0
33674,3,3674,[ 50 185 678 238 181],416,4,15628,4.252517006802721,0.0,40.0
33675,3,3675,[ 64 318 313 301  11],416,5,15633,4.25272034820457,60.0,20.0
33676,3,3676,[ 69 265 143 515 181],405,3,15636,4.252379657329344,0.0,20.0
33677,3,3677,[117  88 174 269 322],805,1,15637,4.251495377922784,0.0,0.0
33678,3,3678,[ 64 318 313 301  11],43,5,15642,4.2516988312041315,60.0,20.0
33679,3,3679,[423  12   9  22 173],618,3,15645,4.251358695652174,20.0,0.0
33680,3,3680,[ 64 318 313 301  11],345,5,15650,4.251562075522956,60.0,20.0
33681,3,3681,[ 64 318 313 301  11],345,5,15655,4.251765344921238,60.0,20.0
33682,3,3682,[191 210 127 195 125],416,5,15660,4.251968503937008,0.0,0.0
33683,3,3683,[ 64 318 313 301  11],416,5,15665,4.252171552660152,60.0,20.0
33684,3,3684,[ 64 318 313 301  11],43,5,15670,4.252374491180461,60.0,20.0
33685,3,3685,[403  79 427 385 655],705,3,15673,4.252034725990233,0.0,0.0
33686,3,3686,[ 64 318 313 301  11],345,5,15678,4.252237591537836,60.0,20.0
33687,3,3687,[ 64 318 313 301  11],345,5,15683,4.252440347071584,60.0,20.0
33688,3,3688,[ 64 318 313 301  11],416,5,15688,4.2526429926809435,60.0,20.0
33689,3,3689,[ 64 318 313 301  11],345,5,15693,4.252845528455285,60.0,20.0
33690,3,3690,[475 222  82 257 216],711,2,15695,4.252235166621512,0.0,0.0
33691,3,3691,[328 100 286 273 282],854,2,15697,4.251625135427952,0.0,0.0
33692,3,3692,[269 288 357  25   7],297,4,15701,4.2515569997292175,0.0,20.0
33693,3,3693,[ 64 318 313 301  11],345,5,15706,4.251759610178668,60.0,20.0
33694,3,3694,[ 64 318 313 301  11],345,5,15711,4.251962110960758,60.0,20.0
33695,3,3695,[ 64 318 313 301  11],43,5,15716,4.2521645021645025,60.0,20.0
33696,3,3696,[ 64 318 313 301  11],43,5,15721,4.252366783878821,60.0,20.0
33697,3,3697,[ 64 318 313 301  11],345,5,15726,4.252568956192537,60.0,20.0
33698,3,3698,[597 100 182  12 268],416,4,15730,4.25250067585834,20.0,0.0
33699,3,3699,[ 64 318 313 301  11],43,5,15735,4.2527027027027025,60.0,20.0
33700,3,3700,[ 64 318 313 301  11],345,5,15740,4.252904620372872,60.0,20.0
33701,3,3701,[313 286  69 333 257],416,4,15744,4.252836304700162,20.0,20.0
33702,3,3702,[ 64 318 313 301  11],345,5,15749,4.253038077234675,60.0,20.0
33703,3,3703,[191 313 237  71 202],618,4,15753,4.252969762419006,20.0,20.0
33704,3,3704,[ 64 318 313 301  11],43,5,15758,4.253171390013495,60.0,20.0
33705,3,3705,[181 323 174   1  11],630,3,15761,4.252833243389099,0.0,20.0
33706,3,3706,[ 22   9 183 405 181],416,5,15766,4.253034799028864,0.0,20.0
33707,3,3707,[144 655 546  71 118],416,3,15769,4.252696871628911,0.0,0.0
33708,3,3708,[ 64 318 313 301  11],416,5,15774,4.252898355351847,60.0,20.0
33709,3,3709,[403 176 186 273  50],417,3,15777,4.252560646900269,0.0,20.0
33710,3,3710,[ 64 318 313 301  11],345,5,15782,4.252762058744274,60.0,20.0
33711,3,3711,[ 64 318 313 301  11],345,5,15787,4.252963362068965,60.0,20.0
33712,3,3712,[483 117 508 125   7],417,3,15790,4.252625908968489,20.0,0.0
33713,3,3713,[ 64 318 313 301  11],43,5,15795,4.252827140549273,60.0,20.0
33714,3,3714,[191 215 195  12 182],416,5,15800,4.253028263795424,20.0,0.0
33715,3,3715,[ 64 318 313 301  11],416,5,15805,4.253229278794403,60.0,20.0
33716,3,3716,[ 64 318 313 301  11],43,5,15810,4.253430185633576,60.0,20.0
33717,3,3717,[ 97 111 475 471 118],907,4,15814,4.253362022592792,0.0,0.0
33718,3,3718,[ 64 318 313 301  11],345,5,15819,4.253562785695079,60.0,20.0
33719,3,3719,[ 64 318 313 301  11],416,5,15824,4.253763440860215,60.0,20.0
33720,3,3720,[182 180 168 475 153],62,5,15829,4.253963988175221,0.0,0.0
33721,3,3721,[ 64 318 313 301  11],43,5,15834,4.254164427727028,60.0,20.0
33722,3,3722,[ 64 318 313 301  11],416,5,15839,4.254364759602471,60.0,20.0
33723,3,3723,[385 286 174  15  56],416,5,15844,4.254564983888292,0.0,0.0
33724,3,3724,[ 64 318 313 301  11],345,5,15849,4.254765100671141,60.0,20.0
33725,3,3725,[ 64 318 313 301  11],43,5,15854,4.254965110037574,60.0,20.0
33726,3,3726,[748 238 483 117 423],417,5,15859,4.2551650120740545,20.0,0.0
33727,3,3727,[ 64 318 313 301  11],43,5,15864,4.255364806866953,60.0,20.0
33728,3,3728,[ 64 318 313 301  11],43,5,15869,4.255564494502548,60.0,20.0
33729,3,3729,[ 64 318 313 301  11],416,5,15874,4.255764075067024,60.0,20.0
33730,3,3730,[ 64 318 313 301  11],43,5,15879,4.255963548646475,60.0,20.0
33731,3,3731,[ 64 318 313 301  11],416,5,15884,4.256162915326902,60.0,20.0
33732,3,3732,[ 64 318 313 301  11],416,5,15889,4.256362175194214,60.0,20.0
33733,3,3733,[ 64 318 313 301  11],416,5,15894,4.256561328334226,60.0,20.0
33734,3,3734,[ 79 168 180  11 118],437,2,15896,4.255957161981258,0.0,0.0
33735,3,3735,[588  71 181 318 471],705,4,15900,4.255888650963597,20.0,20.0
33736,3,3736,[ 64 318 313 301  11],416,5,15905,4.256087770939256,60.0,20.0
33737,3,3737,[546 265  25 151 568],416,3,15908,4.255751738897806,0.0,0.0
33738,3,3738,[403 143   4 237 235],43,4,15912,4.255683337790853,0.0,0.0
33739,3,3739,[175 258   9 588 181],698,1,15913,4.254812834224599,0.0,20.0
33740,3,3740,[323 111 215 357 172],416,4,15917,4.2547447206629245,0.0,0.0
33741,3,3741,[597 286 471  22 176],854,0,15917,4.253607696419027,0.0,0.0
33742,3,3742,[237 269 257  95 273],416,2,15919,4.253005610472883,0.0,0.0
33743,3,3743,[200 301 257 237 185],297,3,15922,4.25267094017094,0.0,0.0
33744,3,3744,[ 50 181 196  98 121],43,5,15927,4.252870493991989,0.0,60.0
33745,3,3745,[ 64 318 313 301  11],345,5,15932,4.253069941270689,60.0,20.0
33746,3,3746,[ 64 318 313 301  11],43,5,15937,4.25326928209234,60.0,20.0
33747,3,3747,[ 64 318 313 301  11],43,5,15942,4.2534685165421555,60.0,20.0
33748,3,3748,[ 64 318 313 301  11],416,5,15947,4.253667644705255,60.0,20.0
33749,3,3749,[ 64 318 313 301  11],416,5,15952,4.253866666666666,60.0,20.0
33750,3,3750,[181 132  97 202  96],416,5,15957,4.2540655825113305,0.0,20.0
33751,3,3751,[282 183 258 117 174],416,5,15962,4.254264392324094,0.0,0.0
33752,3,3752,[234 385 273 127 508],417,3,15965,4.253930189181988,0.0,0.0
33753,3,3753,[ 64 318 313 301  11],416,5,15970,4.254128929142248,60.0,20.0
33754,3,3754,[204 742 275 202 403],43,5,15975,4.254327563249001,0.0,0.0
33755,3,3755,[ 64 318 313 301  11],43,5,15980,4.254526091586794,60.0,20.0
33756,3,3756,[ 64 318 313 301  11],416,5,15985,4.254724514240086,60.0,20.0
33757,3,3757,[ 64 318 313 301  11],345,5,15990,4.254922831293241,60.0,20.0
33758,3,3758,[168 323 289 174 176],416,3,15993,4.2545889864325614,0.0,0.0
33759,3,3759,[ 64 318 313 301  11],345,5,15998,4.254787234042553,60.0,20.0
33760,3,3760,[ 64 318 313 301  11],345,5,16003,4.254985376229726,60.0,20.0
33761,3,3761,[ 64 318 313 301  11],416,5,16008,4.25518341307815,60.0,20.0
33762,3,3762,[ 64 318 313 301  11],345,5,16013,4.255381344671805,60.0,20.0
33763,3,3763,[ 64 318 313 301  11],43,5,16018,4.25557917109458,60.0,20.0
33764,3,3764,[ 64 318 313 301  11],43,5,16023,4.255776892430279,60.0,20.0
33765,3,3765,[302   7   4 118 151],297,2,16025,4.255177907594264,0.0,0.0
33766,3,3766,[195  15 405  98  64],416,5,16030,4.2553756304751795,20.0,20.0
33767,3,3767,[748 385  82 568 210],373,3,16033,4.255042462845011,0.0,0.0
33768,3,3768,[204 289 144  69  12],588,2,16035,4.254444149641815,20.0,0.0
33769,3,3769,[ 64 318 313 301  11],43,5,16040,4.254641909814324,60.0,20.0
33770,3,3770,[ 64 318 313 301  11],416,5,16045,4.254839565102095,60.0,20.0
33771,3,3771,[ 64 318 313 301  11],43,5,16050,4.255037115588547,60.0,20.0
33772,3,3772,[ 64 318 313 301  11],416,5,16055,4.25523456135701,60.0,20.0
33773,3,3773,[276 186 275 173 403],618,2,16057,4.254636989931107,0.0,0.0
33774,3,3774,[427 210  56 294 405],601,2,16059,4.2540397350993375,0.0,0.0
33775,3,3775,[ 64 318 313 301  11],43,5,16064,4.254237288135593,60.0,20.0
33776,3,3776,[216 222 196 257 286],62,3,16067,4.253905215779719,0.0,0.0
33777,3,3777,[234 568 238 748 313],345,4,16071,4.2538380095288515,20.0,20.0
33778,3,3778,[475 228 111 127 273],417,2,16073,4.25324159830643,0.0,0.0
33779,3,3779,[ 64 318 313 301  11],345,5,16078,4.253439153439153,60.0,20.0
33780,3,3780,[ 64 318 313 301  11],43,5,16083,4.253636604072996,60.0,20.0
33781,3,3781,[175 196 357 475  11],805,3,16086,4.253305129561078,0.0,0.0
33782,3,3782,[ 64 318 313 301  11],43,5,16091,4.25350251123447,60.0,20.0
33783,3,3783,[ 64 318 313 301  11],416,5,16096,4.25369978858351,60.0,20.0
33784,3,3784,[ 64 318 313 301  11],43,5,16101,4.253896961690885,60.0,20.0
33785,3,3785,[ 64 318 313 301  11],345,5,16106,4.254094030639197,60.0,20.0
33786,3,3786,[588 121   1 496 176],230,5,16111,4.254290995510958,0.0,0.0
33787,3,3787,[100 125  56 405  98],854,4,16115,4.254223864836325,0.0,20.0
33788,3,3788,[ 64 318 313 301  11],43,5,16120,4.254420691475323,60.0,20.0
33789,3,3789,[ 64 318 313 301  11],345,5,16125,4.254617414248021,60.0,20.0
33790,3,3790,[ 64 318 313 301  11],43,5,16130,4.254814033236613,60.0,20.0
33791,3,3791,[ 64 318 313 301  11],345,5,16135,4.255010548523207,60.0,20.0
33792,3,3792,[ 64 318 313 301  11],345,5,16140,4.255206960189823,60.0,20.0
33793,3,3793,[ 64 318 313 301  11],43,5,16145,4.255403268318397,60.0,20.0
33794,3,3794,[ 64 318 313 301  11],416,5,16150,4.255599472990777,60.0,20.0
33795,3,3795,[ 15 210 200 405  64],198,3,16153,4.255268703898841,20.0,0.0
33796,3,3796,[210 215 168  97 328],62,2,16155,4.25467474321833,0.0,0.0
33797,3,3797,[ 64 318 313 301  11],345,5,16160,4.254870984728805,60.0,20.0
33798,3,3798,[ 64 318 313 301  11],43,5,16165,4.255067122927086,60.0,20.0
33799,3,3799,[ 64 318 313 301  11],416,5,16170,4.255263157894737,60.0,20.0
33800,3,3800,[423 181  11 273 100],297,4,16174,4.255196001052354,0.0,20.0
33801,3,3801,[ 64 318 313 301  11],416,5,16179,4.255391899000526,60.0,20.0
33802,3,3802,[ 69 151 237 333 118],416,2,16181,4.254798843018669,0.0,0.0
33803,3,3803,[ 56 323 328 294 153],416,4,16185,4.254731861198739,0.0,0.0
33804,3,3804,[ 70 204 238  97  15],437,3,16188,4.254402102496715,0.0,0.0
33805,3,3805,[ 64 318 313 301  11],345,5,16193,4.254598003152917,60.0,20.0
33806,3,3806,[196 132 191  79 300],416,5,16198,4.254793800893092,0.0,0.0
33807,3,3807,[294 211 180 196 125],417,5,16203,4.254989495798319,0.0,0.0
33808,3,3808,[ 64 318 313 301  11],416,5,16208,4.255185087949593,60.0,20.0
33809,3,3809,[238 153 268 235   1],297,3,16211,4.254855643044619,0.0,0.0
33810,3,3810,[ 64 318 313 301  11],416,5,16216,4.255051167672527,60.0,20.0
33811,3,3811,[ 64 318 313 301  11],416,5,16221,4.255246589716684,60.0,20.0
33812,3,3812,[ 64 318 313 301  11],43,5,16226,4.255441909257803,60.0,20.0
33813,3,3813,[197 132 237 475 655],416,3,16229,4.255112742527531,0.0,0.0
33814,3,3814,[172 288 282 385 234],416,5,16234,4.255307994757536,0.0,20.0
33815,3,3815,[ 64 318 313 301  11],43,5,16239,4.255503144654088,60.0,20.0
33816,3,3816,[ 64 318 313 301  11],43,5,16244,4.255698192297616,60.0,20.0
33817,3,3817,[143 237 301 132 258],416,4,16248,4.255631220534311,0.0,0.0
33818,3,3818,[302 546 588 268 515],297,4,16252,4.255564283843938,0.0,0.0
33819,3,3819,[ 64 318 313 301  11],345,5,16257,4.255759162303665,60.0,20.0
33820,3,3820,[275   9 176 181 172],618,3,16260,4.25543051557184,0.0,20.0
33821,3,3821,[211 161 238 202 125],373,4,16264,4.255363683935112,0.0,0.0
33822,3,3822,[ 64 318 313 301  11],43,5,16269,4.255558461940884,60.0,20.0
33823,3,3823,[ 64 318 313 301  11],43,5,16274,4.255753138075314,60.0,20.0
33824,3,3824,[301  95  28 222 175],297,4,16278,4.255686274509804,0.0,0.0
33825,3,3825,[257  11  28 237 271],297,3,16281,4.255358076319917,0.0,0.0
33826,3,3826,[ 64 318 313 301  11],43,5,16286,4.255552652207996,60.0,20.0
33827,3,3827,[427 118  28 603  70],416,4,16290,4.255485893416928,0.0,0.0
33828,3,3828,[175 174  79 117 276],214,4,16294,4.255419169495952,0.0,0.0
33829,3,3829,[ 64 318 313 301  11],416,5,16299,4.255613577023499,60.0,20.0
33830,3,3830,[143 403 597 271 161],43,3,16302,4.255285826155051,0.0,0.0
33831,3,3831,[ 64 318 313 301  11],416,5,16307,4.255480167014614,60.0,20.0
33832,3,3832,[ 64 318 313 301  11],416,5,16312,4.255674406470128,60.0,20.0
33833,3,3833,[ 64 318 313 301  11],416,5,16317,4.255868544600939,60.0,20.0
33834,3,3834,[ 50  96  22 597  25],630,2,16319,4.2552803129074315,0.0,20.0
33835,3,3835,[168 173 742 196  28],805,2,16321,4.254692387904067,0.0,0.0
33836,3,3836,[ 64 318 313 301  11],416,5,16326,4.254886630179828,60.0,20.0
33837,3,3837,[265  98  56 211   7],297,4,16330,4.254820218863991,0.0,20.0
33838,3,3838,[ 64 318 313 301  11],416,5,16335,4.255014326647564,60.0,20.0
33839,3,3839,[288 471 286 301 403],588,4,16339,4.254947916666667,0.0,20.0
33840,3,3840,[ 64 318 313 301  11],345,5,16344,4.255141890132778,60.0,20.0
33841,3,3841,[ 64 318 313 301  11],416,5,16349,4.255335762623633,60.0,20.0
33842,3,3842,[ 64 318 313 301  11],345,5,16354,4.255529534218059,60.0,20.0
33843,3,3843,[ 64 318 313 301  11],345,5,16359,4.255723204994797,60.0,20.0
33844,3,3844,[ 64 318 313 301  11],416,5,16364,4.255916775032509,60.0,20.0
33845,3,3845,[ 64 318 313 301  11],416,5,16369,4.2561102444097765,60.0,20.0
33846,3,3846,[ 64 318 313 301  11],345,5,16374,4.256303613205095,60.0,20.0
33847,3,3847,[318 100   8   9 405],854,5,16379,4.256496881496881,20.0,0.0
33848,3,3848,[655 196  79 197 471],618,3,16382,4.256170433878929,0.0,0.0
33849,3,3849,[ 64 318 313 301  11],43,5,16387,4.256363636363637,60.0,20.0
33850,3,3850,[ 64 318 313 301  11],416,5,16392,4.256556738509478,60.0,20.0
33851,3,3851,[  8 282   9  25 173],416,5,16397,4.2567497403946,0.0,0.0
33852,3,3852,[ 64 318 313 301  11],345,5,16402,4.2569426420970675,60.0,20.0
33853,3,3853,[100  64   1 286 257],416,4,16406,4.256875973015049,20.0,0.0
33854,3,3854,[173 257  15  11 174],416,4,16410,4.256809338521401,0.0,0.0
33855,3,3855,[ 64 318 313 301  11],416,5,16415,4.257002074688796,60.0,20.0
33856,3,3856,[ 64 318 313 301  11],416,5,16420,4.257194710915219,60.0,20.0
33857,3,3857,[ 89 385 135 191  64],373,3,16423,4.256868843960602,20.0,0.0
33858,3,3858,[121 179  70 222 172],128,1,16424,4.256024876911117,0.0,0.0
33859,3,3859,[257 111 289 508 258],854,2,16426,4.255440414507772,0.0,0.0
33860,3,3860,[276 301 748 234 268],416,4,16430,4.255374255374256,0.0,0.0
33861,3,3861,[ 64 318 313 301  11],43,5,16435,4.255567063697566,60.0,20.0
33862,3,3862,[269 132   8 275 182],214,3,16438,4.255242039865389,0.0,0.0
33863,3,3863,[180 228 172   4   7],62,4,16442,4.255175983436853,0.0,0.0
33864,3,3864,[181 132 423 117  25],618,4,16446,4.255109961190168,0.0,20.0
33865,3,3865,[288 508 258  56 195],62,4,16450,4.25504397309881,0.0,20.0
33866,3,3866,[ 12 235 403 475  88],416,2,16452,4.254460822342901,20.0,0.0
33867,3,3867,[161 742  98 471 265],416,5,16457,4.2546535677352635,0.0,20.0
33868,3,3868,[228 200 234 258  22],297,2,16459,4.254070819333161,0.0,0.0
33869,3,3869,[  4  79 245 235 132],417,2,16461,4.253488372093023,0.0,0.0
33870,3,3870,[127 200 176 204 196],805,2,16463,4.252906225781452,0.0,0.0
33871,3,3871,[179  98 603 269 257],214,3,16466,4.252582644628099,0.0,20.0
33872,3,3872,[ 64 318 313 301  11],43,5,16471,4.2527756261296155,60.0,20.0
33873,3,3873,[196 185 197 132  56],437,5,16476,4.252968508002065,0.0,0.0
33874,3,3874,[515 196 275  95 234],416,4,16480,4.252903225806452,0.0,0.0
33875,3,3875,[475   1 588 568   8],588,4,16484,4.252837977296181,0.0,0.0
33876,3,3876,[ 64 318 313 301  11],43,5,16489,4.25303069383544,60.0,20.0
33877,3,3877,[ 64 318 313 301  11],345,5,16494,4.253223310985044,60.0,20.0
33878,3,3878,[ 64 318 313 301  11],43,5,16499,4.253415828821861,60.0,20.0
33879,3,3879,[288 197 111 234 181],805,2,16501,4.252835051546392,0.0,40.0
33880,3,3880,[ 64 318 313 301  11],345,5,16506,4.253027570213862,60.0,20.0
33881,3,3881,[174  69 568 276 185],416,4,16510,4.25296239052035,0.0,0.0
33882,3,3882,[ 64 318 313 301  11],43,5,16515,4.253154777234097,60.0,20.0
33883,3,3883,[222  11 405   1 276],764,4,16519,4.253089598352214,0.0,0.0
33884,3,3884,[ 56 257 125 118   8],62,3,16522,4.2527670527670525,0.0,0.0
33885,3,3885,[144 210  11  12 678],654,5,16527,4.25295934122491,20.0,0.0
33886,3,3886,[ 64 318 313 301  11],43,5,16532,4.253151530743504,60.0,20.0
33887,3,3887,[475 196 234 143 200],198,2,16534,4.252572016460905,0.0,0.0
33888,3,3888,[ 64 318 313 301  11],416,5,16539,4.25276420673695,60.0,20.0
33889,3,3889,[ 98 121 168 276  56],62,5,16544,4.252956298200514,0.0,20.0
33890,3,3890,[ 15 748 118  69 182],198,2,16546,4.252377280904652,0.0,0.0
33891,3,3891,[ 64 318 313 301  11],345,5,16551,4.25256937307297,60.0,20.0
33892,3,3892,[ 64 318 313 301  11],416,5,16556,4.252761366555355,60.0,20.0
33893,3,3893,[ 64 318 313 301  11],416,5,16561,4.252953261427837,60.0,20.0
33894,3,3894,[ 64 318 313 301  11],43,5,16566,4.253145057766367,60.0,20.0
33895,3,3895,[322 269  50 168 183],805,4,16570,4.253080082135524,0.0,20.0
33896,3,3896,[ 64 318  98 357 125],416,5,16575,4.253271747498076,40.0,20.0
33897,3,3897,[ 64 318 313 301  11],43,5,16580,4.253463314520267,60.0,20.0
33898,3,3898,[211 427  88 186 302],405,3,16583,4.253141831238779,0.0,0.0
33899,3,3899,[258 100   7 135 294],62,4,16587,4.253076923076923,0.0,0.0
33900,3,3900,[196 174 111 515 195],297,3,16590,4.252755703665727,0.0,0.0
33901,3,3901,[144 111  25  12 153],854,2,16592,4.252178370066632,20.0,0.0
33902,3,3902,[ 64 318 313 301  11],43,5,16597,4.2523699718165515,60.0,20.0
33903,3,3903,[88 25  4  7  8],618,2,16599,4.251793032786885,0.0,0.0
33904,3,3904,[200 183 289 182 144],416,4,16603,4.251728553137004,0.0,0.0
33905,3,3905,[ 71 211 100  28 117],43,5,16608,4.2519201228878645,0.0,0.0
33906,3,3906,[ 70  50 216 318 265],416,5,16613,4.252111594573842,20.0,20.0
33907,3,3907,[ 64 318 313 301  11],416,5,16618,4.252302968270215,60.0,20.0
33908,3,3908,[ 64 318 313 301  11],416,5,16623,4.252494244052187,60.0,20.0
33909,3,3909,[ 64 318 313 301  11],416,5,16628,4.252685421994885,60.0,20.0
33910,3,3910,[471 742 210 200 357],297,2,16630,4.252109434927129,0.0,0.0
33911,3,3911,[237 210   4 173 257],43,5,16635,4.252300613496932,0.0,0.0
33912,3,3912,[  1  95 175 180 172],805,3,16638,4.251980577561973,0.0,0.0
33913,3,3913,[ 64 318 313 301  11],345,5,16643,4.2521716913643335,60.0,20.0
33914,3,3914,[127  22 568 210 234],253,5,16648,4.252362707535121,0.0,0.0
33915,3,3915,[ 64 318 313 301  11],43,5,16653,4.2525536261491315,60.0,20.0
33916,3,3916,[ 64 318 313 301  11],416,5,16658,4.252744447281082,60.0,20.0
33917,3,3917,[ 64 318 313 301  11],345,5,16663,4.252935171005615,60.0,20.0
33918,3,3918,[ 64 318 313 301  11],416,5,16668,4.253125797397296,60.0,20.0
33919,3,3919,[ 64 318 313 301  11],345,5,16673,4.253316326530612,60.0,20.0
33920,3,3920,[ 64 318 313 301  11],416,5,16678,4.25350675847998,60.0,20.0
33921,3,3921,[ 64 318 313 301  11],43,5,16683,4.253697093319735,60.0,20.0
33922,3,3922,[ 64 318 313 301  11],43,5,16688,4.253887331124139,60.0,20.0
33923,3,3923,[ 64 318 313 301  11],345,5,16693,4.25407747196738,60.0,20.0
33924,3,3924,[ 79 210  22  28 117],416,5,16698,4.254267515923567,0.0,0.0
33925,3,3925,[ 69 742 276 405 268],416,4,16702,4.254202750891492,0.0,0.0
33926,3,3926,[ 64 318 313 301  11],345,5,16707,4.254392666157372,60.0,20.0
33927,3,3927,[168 196 258 423 175],805,2,16709,4.253818737270875,0.0,0.0
33928,3,3928,[257 151  50 258 323],416,2,16711,4.253245100534487,0.0,20.0
33929,3,3929,[597 161 172 603 268],416,4,16715,4.253180661577608,0.0,0.0
33930,3,3930,[ 64 318 313 301  11],345,5,16720,4.253370643602137,60.0,20.0
33931,3,3931,[ 64 318 313 301  11],345,5,16725,4.253560528992879,60.0,20.0
33932,3,3932,[182 161 323  98  64],198,3,16728,4.253241800152555,20.0,20.0
33933,3,3933,[ 64 318 313 301  11],43,5,16733,4.253431621759024,60.0,20.0
33934,3,3934,[118 111   7 202 210],417,2,16735,4.252858958068615,0.0,0.0
33935,3,3935,[405 588 742 271 222],805,1,16736,4.252032520325203,0.0,0.0
33936,3,3936,[ 64 318 313 301  11],43,5,16741,4.252222504445009,60.0,20.0
33937,3,3937,[ 64 318 313 301  11],345,5,16746,4.252412392077196,60.0,20.0
33938,3,3938,[100  69  70  15   1],262,2,16748,4.251840568672252,0.0,0.0
33939,3,3939,[ 95 475  11 238  25],49,2,16750,4.251269035532995,0.0,0.0
33940,3,3940,[ 64 318 313 301  11],416,5,16755,4.251459020553159,60.0,20.0
33941,3,3941,[655 568 204 215 333],345,4,16759,4.251395230847286,0.0,0.0
33942,3,3942,[ 69 204  22 385 333],416,5,16764,4.25158508749683,0.0,0.0
33943,3,3943,[ 64 318 313 301  11],43,5,16769,4.251774847870182,60.0,20.0
33944,3,3944,[ 64 318 313 301  11],416,5,16774,4.251964512040558,60.0,20.0
33945,3,3945,[ 15  69 471 153   1],721,5,16779,4.252154080081095,0.0,0.0
33946,3,3946,[ 64 318 313 301  11],43,5,16784,4.252343552064859,60.0,20.0
33947,3,3947,[ 64 318 313 301  11],43,5,16789,4.252532928064843,60.0,20.0
33948,3,3948,[ 64 318 313 301  11],345,5,16794,4.252722208153963,60.0,20.0
33949,3,3949,[ 64 318 313 301  11],43,5,16799,4.252911392405063,60.0,20.0
33950,3,3950,[238 204 111   4 168],43,4,16803,4.252847380410023,0.0,0.0
33951,3,3951,[546 187 385  69  82],416,4,16807,4.252783400809717,0.0,0.0
33952,3,3952,[ 64 318 313 301  11],345,5,16812,4.252972426005566,60.0,20.0
33953,3,3953,[161 186   7 515 196],417,3,16815,4.2526555386949925,0.0,0.0
33954,3,3954,[ 64 318 313 301  11],416,5,16820,4.252844500632111,60.0,20.0
33955,3,3955,[ 64 318 313 301  11],345,5,16825,4.253033367037411,60.0,20.0
33956,3,3956,[ 64 318 313 301  11],43,5,16830,4.253222137983321,60.0,20.0
33957,3,3957,[ 64 318 313 301  11],43,5,16835,4.253410813542193,60.0,20.0
33958,3,3958,[ 64 318 313 301  11],416,5,16840,4.25359939378631,60.0,20.0
33959,3,3959,[ 64 318 313 301  11],43,5,16845,4.253787878787879,60.0,20.0
33960,3,3960,[655 423 202 180 475],711,4,16849,4.253723807119414,0.0,0.0
33961,3,3961,[ 64 318 313 301  11],416,5,16854,4.253912165572943,60.0,20.0
33962,3,3962,[ 64 318 313 301  11],416,5,16859,4.254100428967954,60.0,20.0
33963,3,3963,[357 265 234  22  56],416,5,16864,4.254288597376387,0.0,0.0
33964,3,3964,[ 12  82  71 300 132],416,5,16869,4.254476670870114,20.0,0.0
33965,3,3965,[294 288 216 121 118],416,4,16873,4.254412506303581,0.0,20.0
33966,3,3966,[ 64 318 313 301  11],345,5,16878,4.254600453743383,60.0,20.0
33967,3,3967,[ 64 318 313 301  11],416,5,16883,4.254788306451613,60.0,20.0
33968,3,3968,[ 64 318 313 301  11],416,5,16888,4.254976064499874,60.0,20.0
33969,3,3969,[ 64 318 313 301  11],345,5,16893,4.255163727959697,60.0,20.0
33970,3,3970,[ 64 318 313 301  11],416,5,16898,4.2553512969025435,60.0,20.0
33971,3,3971,[ 64 318 313 301  11],43,5,16903,4.255538771399799,60.0,20.0
33972,3,3972,[ 64 318 313 301  11],416,5,16908,4.2557261515227784,60.0,20.0
33973,3,3973,[323 125 118  69 210],417,2,16910,4.255158530447911,0.0,0.0
33974,3,3974,[ 64 318 313 301  11],345,5,16915,4.255345911949686,60.0,20.0
33975,3,3975,[ 12 275 174 121 423],654,5,16920,4.255533199195171,20.0,0.0
33976,3,3976,[200  25 182 197 403],618,3,16923,4.255217500628614,0.0,0.0
33977,3,3977,[ 64 318 313 301  11],345,5,16928,4.255404725992961,60.0,20.0
33978,3,3978,[258 265 245 271  56],505,3,16931,4.2550892183965825,0.0,0.0
33979,3,3979,[ 64 318 313 301  11],345,5,16936,4.255276381909548,60.0,20.0
33980,3,3980,[ 64 318 313 301  11],416,5,16941,4.255463451394122,60.0,20.0
33981,3,3981,[ 64 318 313 301  11],345,5,16946,4.255650426921145,60.0,20.0
33982,3,3982,[ 64 318 313 301  11],345,5,16951,4.255837308561386,60.0,20.0
33983,3,3983,[  4 328 333 161  70],416,5,16956,4.256024096385542,0.0,0.0
33984,3,3984,[ 64 318 313 301  11],416,5,16961,4.256210790464241,60.0,20.0
33985,3,3985,[ 64 318 313 301  11],345,5,16966,4.256397390868038,60.0,20.0
33986,3,3986,[186  70   1 168 405],642,3,16969,4.256082267368949,0.0,0.0
33987,3,3987,[ 64 318 313 301  11],345,5,16974,4.256268806419258,60.0,20.0
33988,3,3988,[405 300 182 196 276],198,1,16975,4.2554524943594885,0.0,0.0
33989,3,3989,[174 222 275 655 318],62,4,16979,4.255388471177945,20.0,0.0
33990,3,3990,[ 64 318 313 301  11],345,5,16984,4.255575043848659,60.0,20.0
33991,3,3991,[ 64 318 313 301  11],43,5,16989,4.255761523046092,60.0,20.0
33992,3,3992,[182 234  95 200 135],297,1,16990,4.254946155772602,0.0,0.0
33993,3,3993,[385 427 318 172 423],642,2,16992,4.254381572358538,20.0,0.0
33994,3,3994,[127 215  12 265 515],416,5,16997,4.254568210262828,20.0,0.0
33995,3,3995,[ 64 318 313 301  11],345,5,17002,4.254754754754755,60.0,20.0
33996,3,3996,[ 64 318 313 301  11],43,5,17007,4.254941205904428,60.0,20.0
33997,3,3997,[ 64 318 313 301  11],345,5,17012,4.255127563781891,60.0,20.0
33998,3,3998,[196  12 228 182  71],62,4,17016,4.255063765941485,20.0,0.0
33999,3,3999,[238 333 235 403 234],345,2,17018,4.2545,0.0,0.0
34000,3,4000,[ 64 318 313 301  11],43,5,17023,4.254686328417896,60.0,20.0
34001,3,4001,[288 301 483 245  25],907,5,17028,4.254872563718141,20.0,20.0
34002,3,4002,[  1 174 423 235  69],297,1,17029,4.254059455408444,0.0,0.0
34003,3,4003,[405 161  82 151 168],416,4,17033,4.253996003996004,0.0,0.0
34004,3,4004,[282 125  28  50 288],345,1,17034,4.253183520599251,0.0,40.0
34005,3,4005,[168 161 200 423  79],618,5,17039,4.253369945082376,0.0,0.0
34006,3,4006,[ 64 318 313 301  11],345,5,17044,4.253556276516097,60.0,20.0
34007,3,4007,[ 64 318 313 301  11],345,5,17049,4.25374251497006,60.0,20.0
34008,3,4008,[216 151 313 238 508],345,5,17054,4.253928660513844,20.0,20.0
34009,3,4009,[ 56 275  28  69 111],62,3,17057,4.253615960099751,0.0,0.0
34010,3,4010,[ 64 318 313 301  11],345,5,17062,4.25380204437796,60.0,20.0
34011,3,4011,[ 64 318 313 301  11],416,5,17067,4.253988035892323,60.0,20.0
34012,3,4012,[ 64 318 313 301  11],345,5,17072,4.254173934712186,60.0,20.0
34013,3,4013,[  4   9  88 268 597],416,3,17075,4.253861484803189,0.0,0.0
34014,3,4014,[ 64 318 313 301  11],416,5,17080,4.254047322540473,60.0,20.0
34015,3,4015,[117 176 111 173 742],805,2,17082,4.253486055776892,0.0,0.0
34016,3,4016,[118   7  88 195 323],416,2,17084,4.252925068459049,0.0,0.0
34017,3,4017,[ 64 318 313 301  11],416,5,17089,4.25311100049776,60.0,20.0
34018,3,4018,[ 11 185 655 313  95],618,4,17093,4.253048021895994,20.0,20.0
34019,3,4019,[ 64 318 313 301  11],416,5,17098,4.253233830845772,60.0,20.0
34020,3,4020,[127 216 423  70 211],416,5,17103,4.253419547376274,0.0,0.0
34021,3,4021,[202  71  50 471 245],921,3,17106,4.253107906514172,0.0,20.0
34022,3,4022,[172 186 211  97 161],437,2,17108,4.252547849863286,0.0,0.0
34023,3,4023,[  8 200 161 143 151],711,5,17113,4.2527335984095425,0.0,0.0
34024,3,4024,[ 64 318 313 301  11],416,5,17118,4.252919254658385,60.0,20.0
34025,3,4025,[ 64 318 313 301  11],345,5,17123,4.253104818678589,60.0,20.0
34026,3,4026,[ 64 318 313 301  11],345,5,17128,4.253290290538863,60.0,20.0
34027,3,4027,[588 475 742 357 143],805,2,17130,4.252730883813307,0.0,0.0
34028,3,4028,[ 88 269 176 191 597],805,3,17133,4.2524199553239015,0.0,0.0
34029,3,4029,[ 64 318 313 301  11],345,5,17138,4.252605459057072,60.0,20.0
34030,3,4030,[ 64 318 313 301  11],345,5,17143,4.252790870751674,60.0,20.0
34031,3,4031,[ 64 318 313 301  11],43,5,17148,4.252976190476191,60.0,20.0
34032,3,4032,[176 597 210 135 403],62,4,17152,4.2529134639226385,0.0,0.0
34033,3,4033,[ 98 265 202 245 161],417,3,17155,4.252602875557759,0.0,20.0
34034,3,4034,[ 64 318 313 301  11],43,5,17160,4.25278810408922,60.0,20.0
34035,3,4035,[ 64 318 313 301  11],416,5,17165,4.252973240832508,60.0,20.0
34036,3,4036,[ 64 318 313 301  11],416,5,17170,4.253158285855833,60.0,20.0
34037,3,4037,[ 64 318 313 301  11],416,5,17175,4.25334323922734,60.0,20.0
34038,3,4038,[ 64 318 313 301  11],345,5,17180,4.253528101015103,60.0,20.0
34039,3,4039,[ 64 318 313 301  11],43,5,17185,4.253712871287129,60.0,20.0
34040,3,4040,[ 64 318 313 301  11],345,5,17190,4.2538975501113585,60.0,20.0
34041,3,4041,[ 64 318 313 301  11],345,5,17195,4.254082137555666,60.0,20.0
34042,3,4042,[144 403 121  97  82],416,5,17200,4.254266633687855,0.0,0.0
34043,3,4043,[ 64 318 313 301  11],43,5,17205,4.2544510385756675,60.0,20.0
34044,3,4044,[ 64 318 313 301  11],416,5,17210,4.2546353522867735,60.0,20.0
34045,3,4045,[ 64 318 313 301  11],43,5,17215,4.254819574888779,60.0,20.0
34046,3,4046,[ 64 318 313 301  11],416,5,17220,4.255003706449221,60.0,20.0
34047,3,4047,[ 64 318 313 301  11],416,5,17225,4.255187747035573,60.0,20.0
34048,3,4048,[196 238 328 216 117],373,5,17230,4.255371696715239,0.0,0.0
34049,3,4049,[117 257 237 276 318],314,4,17234,4.255308641975309,20.0,0.0
34050,3,4050,[ 64 318 313 301  11],416,5,17239,4.255492470994816,60.0,20.0
34051,3,4051,[ 64 318 313 301  11],416,5,17244,4.255676209279368,60.0,20.0
34052,3,4052,[ 64 318 313 301  11],416,5,17249,4.255859856896127,60.0,20.0
34053,3,4053,[ 64 318 313 301  11],416,5,17254,4.256043413912185,60.0,20.0
34054,3,4054,[ 64 318 313 301  11],43,5,17259,4.256226880394575,60.0,20.0
34055,3,4055,[ 64 318 313 301  11],345,5,17264,4.256410256410256,60.0,20.0
34056,3,4056,[215 174 182 143 176],618,5,17269,4.256593542026128,0.0,0.0
34057,3,4057,[ 56 483 127 100 222],854,5,17274,4.2567767373090195,20.0,0.0
34058,3,4058,[515 323   7 245 202],417,3,17277,4.256467110125647,0.0,0.0
34059,3,4059,[ 64 318 313 301  11],43,5,17282,4.256650246305418,60.0,20.0
34060,3,4060,[ 56 405  12 143  70],345,5,17287,4.256833292292539,20.0,0.0
34061,3,4061,[ 64 318 313 301  11],43,5,17292,4.257016248153619,60.0,20.0
34062,3,4062,[ 64 318 313 301  11],345,5,17297,4.257199113955205,60.0,20.0
34063,3,4063,[204 194 300 423  79],297,0,17297,4.25615157480315,0.0,0.0
34064,3,4064,[ 71  89 588   7 216],764,5,17302,4.256334563345633,0.0,0.0
34065,3,4065,[ 64 318 313 301  11],345,5,17307,4.256517461878997,60.0,20.0
34066,3,4066,[ 64 318 313 301  11],43,5,17312,4.256700270469634,60.0,20.0
34067,3,4067,[357 182  97  89 186],417,5,17317,4.256882989183874,0.0,0.0
34068,3,4068,[135  79   1  70  28],297,3,17320,4.256574096829688,0.0,0.0
34069,3,4069,[ 64 318 313 301  11],43,5,17325,4.256756756756757,60.0,20.0
34070,3,4070,[328 187 471   1 125],505,2,17327,4.256202407270941,0.0,0.0
34071,3,4071,[191  22 313 228 435],405,3,17330,4.255893909626719,20.0,20.0
34072,3,4072,[ 64 318 313 301  11],416,5,17335,4.256076602013258,60.0,20.0
34073,3,4073,[ 98 286 197 211 237],437,4,17339,4.256013745704467,0.0,20.0
34074,3,4074,[ 64 318 313 301  11],345,5,17344,4.256196319018405,60.0,20.0
34075,3,4075,[  7  96 423 132 288],62,3,17347,4.255888125613346,0.0,20.0
34076,3,4076,[742  28   4 269 216],654,5,17352,4.256070640176601,0.0,0.0
34077,3,4077,[ 64 318 313 301  11],43,5,17357,4.256253065228053,60.0,20.0
34078,3,4078,[ 64 318 313 301  11],345,5,17362,4.256435400833538,60.0,20.0
34079,3,4079,[ 11   4 228 302  12],405,4,17366,4.256372549019608,20.0,0.0
34080,3,4080,[271 597 237 196   8],43,3,17369,4.256064690026954,0.0,0.0
34081,3,4081,[257 318 269 100 655],416,4,17373,4.256001959823616,20.0,0.0
34082,3,4082,[ 64 318 313 301  11],345,5,17378,4.25618417830027,60.0,20.0
34083,3,4083,[ 64 318 313 301  11],345,5,17383,4.256366307541626,60.0,20.0
34084,3,4084,[ 64 318 313 301  11],345,5,17388,4.256548347613219,60.0,20.0
34085,3,4085,[ 64 318 313 301  11],43,5,17393,4.256730298580519,60.0,20.0
34086,3,4086,[ 64 318 313 301  11],416,5,17398,4.25691216050893,60.0,20.0
34087,3,4087,[ 64 318 313 301  11],416,5,17403,4.257093933463796,60.0,20.0
34088,3,4088,[258 111 323 173 174],416,4,17407,4.257031058938616,0.0,0.0
34089,3,4089,[ 64 318 313 301  11],345,5,17412,4.25721271393643,60.0,20.0
34090,3,4090,[568 237 385  88 328],43,5,17417,4.257394280127108,0.0,0.0
34091,3,4091,[ 64 318 313 301  11],43,5,17422,4.257575757575758,60.0,20.0
34092,3,4092,[ 56 215 269  50  11],297,4,17426,4.2575128267774245,0.0,20.0
34093,3,4093,[ 64 318 313 301  11],345,5,17431,4.2576941866145575,60.0,20.0
34094,3,4094,[ 64 318 313 301  11],345,5,17436,4.257875457875458,60.0,20.0
34095,3,4095,[ 64 318 313 301  11],416,5,17441,4.258056640625,60.0,20.0
34096,3,4096,[603  22 180 258 211],875,4,17445,4.2579936538930925,0.0,0.0
34097,3,4097,[ 64 318 313 301  11],43,5,17450,4.2581747193753055,60.0,20.0
34098,3,4098,[323 301  11 748 742],751,1,17451,4.257379848743596,0.0,0.0
34099,3,4099,[172 111 655 174 211],437,4,17455,4.257317073170731,0.0,0.0
34100,3,4100,[ 64 318 313 301  11],416,5,17460,4.257498171177762,60.0,20.0
34101,3,4101,[125  82 322 748 655],721,2,17462,4.25694783032667,0.0,0.0
34102,3,4102,[471 174 143 245  22],297,3,17465,4.256641481842554,0.0,0.0
34103,3,4103,[603 271 144 228 210],805,1,17466,4.255847953216374,0.0,0.0
34104,3,4104,[265 216 176 210 132],416,5,17471,4.256029232643118,0.0,0.0
34105,3,4105,[ 64 318 313 301  11],345,5,17476,4.256210423770092,60.0,20.0
34106,3,4106,[ 64 318 313 301  11],43,5,17481,4.256391526661797,60.0,20.0
34107,3,4107,[168 288 742 423 483],854,4,17485,4.256329113924051,20.0,20.0
34108,3,4108,[185  56 238  97  98],405,4,17489,4.256266731564858,0.0,20.0
34109,3,4109,[ 64 318 313 301  11],43,5,17494,4.256447688564477,60.0,20.0
34110,3,4110,[ 64 318 313 301  11],345,5,17499,4.256628557528582,60.0,20.0
34111,3,4111,[ 64 318 313 301  11],345,5,17504,4.256809338521401,60.0,20.0
34112,3,4112,[ 64 318 313 301  11],345,5,17509,4.256990031607099,60.0,20.0
34113,3,4113,[ 64 318 313 301  11],43,5,17514,4.257170636849781,60.0,20.0
34114,3,4114,[ 64 318 313 301  11],43,5,17519,4.257351154313487,60.0,20.0
34115,3,4115,[151 117 302 269 475],657,4,17523,4.25728862973761,0.0,0.0
34116,3,4116,[357 197 121 204 748],805,2,17525,4.256740344911343,0.0,0.0
34117,3,4117,[182 568 357  56 210],417,3,17528,4.25643516270034,0.0,0.0
34118,3,4118,[ 64 318 313 301  11],416,5,17533,4.256615683418305,60.0,20.0
34119,3,4119,[183 153 273 597 322],416,3,17536,4.2563106796116505,0.0,0.0
34120,3,4120,[197 222  71 118 181],805,2,17538,4.2557631642805145,0.0,20.0
34121,3,4121,[ 64 318 313 301  11],416,5,17543,4.255943716642407,60.0,20.0
34122,3,4122,[ 64 318 313 301  11],43,5,17548,4.256124181421296,60.0,20.0
34123,3,4123,[ 64 318 313 301  11],43,5,17553,4.256304558680893,60.0,20.0
34124,3,4124,[ 97 655 276  98 181],62,3,17556,4.256,0.0,40.0
34125,3,4125,[ 12 168   7 180 405],62,4,17560,4.255937954435288,20.0,0.0
34126,3,4126,[245  15 172 191  56],345,4,17564,4.255875938938696,0.0,0.0
34127,3,4127,[ 64 318 313 301  11],416,5,17569,4.256056201550388,60.0,20.0
34128,3,4128,[ 64 318 313 301  11],43,5,17574,4.256236376846694,60.0,20.0
34129,3,4129,[471 289  70   1 176],416,4,17578,4.256174334140436,0.0,0.0
34130,3,4130,[ 64 318 313 301  11],43,5,17583,4.256354393609295,60.0,20.0
34131,3,4131,[ 64 318 313 301  11],345,5,17588,4.256534365924492,60.0,20.0
34132,3,4132,[121 143 588 153  64],601,2,17590,4.255988386160174,20.0,0.0
34133,3,4133,[ 64 318 313 301  11],43,5,17595,4.256168359941944,60.0,20.0
34134,3,4134,[ 64 318 313 301  11],345,5,17600,4.256348246674728,60.0,20.0
34135,3,4135,[ 64 318 313 301  11],416,5,17605,4.256528046421663,60.0,20.0
34136,3,4136,[132 185 204  50  82],618,4,17609,4.256466038191927,0.0,20.0
34137,3,4137,[196   9 288  69 168],416,5,17614,4.256645722571291,0.0,20.0
34138,3,4138,[ 64 318 313 301  11],43,5,17619,4.2568253201256345,60.0,20.0
34139,3,4139,[ 64 318 313 301  11],416,5,17624,4.257004830917874,60.0,20.0
34140,3,4140,[ 64 318 313 301  11],43,5,17629,4.257184255010867,60.0,20.0
34141,3,4141,[ 64 318 313 301  11],43,5,17634,4.257363592467407,60.0,20.0
34142,3,4142,[237 546 258 748 174],416,3,17637,4.2570601013758145,0.0,0.0
34143,3,4143,[ 64 318 313 301  11],416,5,17642,4.257239382239383,60.0,20.0
34144,3,4144,[ 22 678 300 222 179],721,4,17646,4.257177322074789,0.0,0.0
34145,3,4145,[ 64 318 313 301  11],416,5,17651,4.2573564881813795,60.0,20.0
34146,3,4146,[483 265 191 258 195],417,4,17655,4.257294429708223,20.0,0.0
34147,3,4147,[568 323  25 151  82],805,3,17658,4.256991321118611,0.0,0.0
34148,3,4148,[ 64 318 313 301  11],416,5,17663,4.257170402506628,60.0,20.0
34149,3,4149,[ 64 318 313 301  11],416,5,17668,4.257349397590361,60.0,20.0
34150,3,4150,[ 64 318 313 301  11],43,5,17673,4.257528306432185,60.0,20.0
34151,3,4151,[ 64 318 313 301  11],43,5,17678,4.257707129094412,60.0,20.0
34152,3,4152,[ 64 318 313 301  11],416,5,17683,4.257885865639297,60.0,20.0
34153,3,4153,[ 64 318 313 301  11],416,5,17688,4.258064516129032,60.0,20.0
34154,3,4154,[117   8  28 121  50],43,5,17693,4.2582430806257525,0.0,20.0
34155,3,4155,[ 64 318 313 301  11],43,5,17698,4.258421559191531,60.0,20.0
34156,3,4156,[ 64 318 313 301  11],43,5,17703,4.258599951888381,60.0,20.0
34157,3,4157,[ 64 318 313 301  11],416,5,17708,4.258778258778259,60.0,20.0
34158,3,4158,[ 64 318 313 301  11],416,5,17713,4.258956479923058,60.0,20.0
34159,3,4159,[117 197  79 257  50],751,4,17717,4.258894230769231,0.0,20.0
34160,3,4160,[ 64 318 313 301  11],416,5,17722,4.259072338380197,60.0,20.0
34161,3,4161,[ 64 318 313 301  11],43,5,17727,4.2592503604036525,60.0,20.0
34162,3,4162,[ 64 318 313 301  11],43,5,17732,4.259428296901273,60.0,20.0
34163,3,4163,[ 64 318 313 301  11],345,5,17737,4.2596061479346785,60.0,20.0
34164,3,4164,[ 88 118 496 222 268],128,3,17740,4.259303721488595,0.0,0.0
34165,3,4165,[181  22 258  71 173],62,5,17745,4.259481517042727,0.0,20.0
34166,3,4166,[ 64 318 313 301  11],43,5,17750,4.259659227261819,60.0,20.0
34167,3,4167,[ 64 318 313 301  11],345,5,17755,4.259836852207294,60.0,20.0
34168,3,4168,[ 64 318 313 301  11],43,5,17760,4.260014391940513,60.0,20.0
34169,3,4169,[ 64 318 313 301  11],43,5,17765,4.2601918465227815,60.0,20.0
34170,3,4170,[151 357 286 655 289],416,3,17768,4.259889714696715,0.0,0.0
34171,3,4171,[ 64 318 313 301  11],416,5,17773,4.260067114093959,60.0,20.0
34172,3,4172,[ 70 286 191 275 186],711,4,17777,4.2600047927150735,0.0,0.0
34173,3,4173,[ 64  25 222 196   9],43,5,17782,4.26018207954001,20.0,0.0
34174,3,4174,[ 64 318 313 301  11],416,5,17787,4.260359281437125,60.0,20.0
34175,3,4175,[132 202 748 322 333],416,4,17791,4.2602969348659006,0.0,0.0
34176,3,4176,[ 64 318 313 301  11],345,5,17796,4.26047402441944,60.0,20.0
34177,3,4177,[ 71 172  15 196 228],921,4,17800,4.260411680229775,0.0,0.0
34178,3,4178,[ 64 318 313 301  11],345,5,17805,4.2605886575735825,60.0,20.0
34179,3,4179,[ 64 318 313 301  11],416,5,17810,4.260765550239235,60.0,20.0
34180,3,4180,[182 187 172 196 216],416,5,17815,4.260942358287491,0.0,0.0
34181,3,4181,[ 64 318 313 301  11],345,5,17820,4.261119081779053,60.0,20.0
34182,3,4182,[288  79 508 748 282],297,1,17821,4.260339469280421,0.0,20.0
34183,3,4183,[ 64 318 313 301  11],416,5,17826,4.260516252390057,60.0,20.0
34184,3,4184,[121 300   8 275  95],43,5,17831,4.260692951015532,0.0,0.0
34185,3,4185,[ 71 100 318 173   7],416,5,17836,4.260869565217392,20.0,0.0
34186,3,4186,[121 196 546 153 300],416,4,17840,4.260807260568426,0.0,0.0
34187,3,4187,[ 64 318 313 301  11],43,5,17845,4.26098376313276,60.0,20.0
34188,3,4188,[ 64 318 313 301  11],345,5,17850,4.261160181427548,60.0,20.0
34189,3,4189,[ 64 318 313 301  11],345,5,17855,4.261336515513126,60.0,20.0
34190,3,4190,[ 64 318 313 301  11],345,5,17860,4.2615127654497735,60.0,20.0
34191,3,4191,[ 64 318 313 301  11],416,5,17865,4.2616889312977095,60.0,20.0
34192,3,4192,[ 64 318 313 301  11],43,5,17870,4.2618650131171,60.0,20.0
34193,3,4193,[655 258 748 121 125],345,2,17872,4.261325703385789,0.0,0.0
34194,3,4194,[118 183 742 597 195],416,3,17875,4.261025029797378,0.0,0.0
34195,3,4195,[ 28 121 678 265 183],416,4,17879,4.260962821734986,0.0,0.0
34196,3,4196,[ 64 318 313 301  11],416,5,17884,4.261138908744341,60.0,20.0
34197,3,4197,[ 64 318 313 301  11],43,5,17889,4.261314911862792,60.0,20.0
34198,3,4198,[258 161 172 271 127],922,2,17891,4.260776375327459,0.0,0.0
34199,3,4199,[258 216 245  71  79],345,3,17894,4.26047619047619,0.0,0.0
34200,3,4200,[ 64 318 313 301  11],345,5,17899,4.260652225660557,60.0,20.0
34201,3,4201,[ 64 318 313 301  11],416,5,17904,4.260828177058544,60.0,20.0
34202,3,4202,[238 174 289 318 132],854,3,17907,4.260528194147038,20.0,0.0
34203,3,4203,[238 200 318 179  98],416,4,17911,4.2604662226451,20.0,20.0
34204,3,4204,[238 258  70  15 245],128,2,17913,4.259928656361474,0.0,0.0
34205,3,4205,[ 64 318 313 301  11],416,5,17918,4.260104612458393,60.0,20.0
34206,3,4206,[175  64 265 210 174],405,3,17921,4.259805086760162,20.0,0.0
34207,3,4207,[328  69 196 655 742],62,2,17923,4.259268060836502,0.0,0.0
34208,3,4208,[ 64 318 313 301  11],416,5,17928,4.25944404846757,60.0,20.0
34209,3,4209,[195 174 176 187 357],198,4,17932,4.25938242280285,0.0,0.0
34210,3,4210,[ 64 318 313 301  11],416,5,17937,4.259558299691284,60.0,20.0
34211,3,4211,[ 64 318 313 301  11],416,5,17942,4.259734093067427,60.0,20.0
34212,3,4212,[ 64 318 313 301  11],345,5,17947,4.259909802990743,60.0,20.0
34213,3,4213,[ 64 318 313 301  11],43,5,17952,4.260085429520646,60.0,20.0
34214,3,4214,[181 269 423  56 286],875,4,17956,4.260023724792408,0.0,20.0
34215,3,4215,[ 12 282 678 200 183],416,4,17960,4.259962049335863,20.0,0.0
34216,3,4216,[273 588 151 302 265],297,3,17963,4.2596632677258714,0.0,0.0
34217,3,4217,[ 64 318 313 301  11],416,5,17968,4.2598387861545755,60.0,20.0
34218,3,4218,[ 64 318 313 301  11],416,5,17973,4.260014221379474,60.0,20.0
34219,3,4219,[ 64 318 313 301  11],345,5,17978,4.260189573459716,60.0,20.0
34220,3,4220,[313 144 245 168 385],416,4,17982,4.2601279317697225,20.0,20.0
34221,3,4221,[173 289 323 237 151],416,1,17983,4.259355755566083,0.0,0.0
34222,3,4222,[117  69 100 173 210],588,3,17986,4.259057542031731,0.0,0.0
34223,3,4223,[ 64 318 313 301  11],345,5,17991,4.259232954545454,60.0,20.0
34224,3,4224,[245 288 179 173 357],62,3,17994,4.258934911242603,0.0,20.0
34225,3,4225,[ 82 194 435 175 289],721,4,17998,4.258873639375296,0.0,0.0
34226,3,4226,[ 64 318 313 301  11],345,5,18003,4.259048970901349,60.0,20.0
34227,3,4227,[385 215 168 144  50],43,5,18008,4.25922421948912,0.0,20.0
34228,3,4228,[ 64 318 313 301  11],43,5,18013,4.2593993851974465,60.0,20.0
34229,3,4229,[ 64 318 313 301  11],43,5,18018,4.259574468085106,60.0,20.0
34230,3,4230,[195 265 179 588 475],417,3,18021,4.259276766721815,0.0,0.0
34231,3,4231,[300 268 471 100   1],345,2,18023,4.258742911153119,0.0,0.0
34232,3,4232,[173  96 427  12  69],601,2,18025,4.258209307819514,20.0,0.0
34233,3,4233,[ 64 318 313 301  11],416,5,18030,4.258384506376949,60.0,20.0
34234,3,4234,[237 288   8 678 168],654,4,18034,4.258323494687131,0.0,20.0
34235,3,4235,[ 64 318 313 301  11],416,5,18039,4.258498583569405,60.0,20.0
34236,3,4236,[222  95 143 111  89],805,2,18041,4.257965541656833,0.0,0.0
34237,3,4237,[ 64 318 313 301  11],43,5,18046,4.258140632373761,60.0,20.0
34238,3,4238,[ 64 318 313 301  11],43,5,18051,4.2583156404812454,60.0,20.0
34239,3,4239,[97  1 82 95 22],416,4,18055,4.258254716981132,0.0,0.0
34240,3,4240,[ 64 318 313 301  11],416,5,18060,4.258429615656684,60.0,20.0
34241,3,4241,[ 64 318 313 301  11],345,5,18065,4.258604431871759,60.0,20.0
34242,3,4242,[185  98 496  89  79],417,2,18067,4.258072118783879,0.0,20.0
34243,3,4243,[ 64 318 313 301  11],416,5,18072,4.258246936852027,60.0,20.0
34244,3,4244,[ 64 318 313 301  11],345,5,18077,4.258421672555948,60.0,20.0
34245,3,4245,[ 64 318 313 301  11],416,5,18082,4.258596325953839,60.0,20.0
34246,3,4246,[ 64 318 313 301  11],416,5,18087,4.258770897103838,60.0,20.0
34247,3,4247,[ 64 318 313 301  11],345,5,18092,4.25894538606403,60.0,20.0
34248,3,4248,[ 64 318 313 301  11],43,5,18097,4.259119792892445,60.0,20.0
34249,3,4249,[ 64 318 313 301  11],43,5,18102,4.259294117647059,60.0,20.0
34250,3,4250,[301 234 471 508 288],297,2,18104,4.258762644083745,0.0,20.0
34251,3,4251,[ 64 318 313 301  11],416,5,18109,4.258936970837253,60.0,20.0
34252,3,4252,[200   9 118   4 357],805,2,18111,4.258405831177992,0.0,0.0
34253,3,4253,[ 64 318 313 301  11],345,5,18116,4.258580159849553,60.0,20.0
34254,3,4254,[ 64 318 313 301  11],43,5,18121,4.258754406580493,60.0,20.0
34255,3,4255,[  7 186   8 111 183],618,3,18124,4.258458646616542,0.0,0.0
34256,3,4256,[ 64 318 313 301  11],345,5,18129,4.258632840028189,60.0,20.0
34257,3,4257,[385 187 328 269 235],416,4,18133,4.2585720995772665,0.0,0.0
34258,3,4258,[ 50  70 132  11 237],230,5,18138,4.258746184550364,0.0,20.0
34259,3,4259,[121 151 265 568 172],417,1,18139,4.257981220657277,0.0,0.0
34260,3,4260,[ 64 318 313 301  11],43,5,18144,4.258155362590941,60.0,20.0
34261,3,4261,[ 64 318 313 301  11],345,5,18149,4.258329422806194,60.0,20.0
34262,3,4262,[179  56 357 118  71],62,4,18153,4.258268824771288,0.0,0.0
34263,3,4263,[ 64 318 313 301  11],43,5,18158,4.25844277673546,60.0,20.0
34264,3,4264,[ 97 313 655 515 435],405,2,18160,4.257913247362251,20.0,20.0
34265,3,4265,[258  50   4 268 204],49,0,18160,4.256915142991092,0.0,20.0
34266,3,4266,[ 64 318 313 301  11],345,5,18165,4.257089289899227,60.0,20.0
34267,3,4267,[ 64 318 313 301  11],43,5,18170,4.257263355201499,60.0,20.0
34268,3,4268,[121 237 125   1 597],618,4,18174,4.25720309205903,0.0,0.0
34269,3,4269,[127 655 597 357 269],805,2,18176,4.256674473067916,0.0,0.0
34270,3,4270,[ 64 318 313 301  11],345,5,18181,4.256848513228752,60.0,20.0
34271,3,4271,[269 496 275 111 238],711,4,18185,4.256788389513108,0.0,0.0
34272,3,4272,[276 258 313   7 174],416,4,18189,4.256728293938685,20.0,20.0
34273,3,4273,[275 173 742   1 268],416,5,18194,4.256902199344876,0.0,0.0
34274,3,4274,[ 64 318 313 301  11],43,5,18199,4.257076023391813,60.0,20.0
34275,3,4275,[257 211 143 269 168],416,4,18203,4.257015902712816,0.0,0.0
34276,3,4276,[ 64 318 313 301  11],345,5,18208,4.257189618891746,60.0,20.0
34277,3,4277,[ 64 318 313 301  11],345,5,18213,4.257363253856942,60.0,20.0
34278,3,4278,[ 64 318 313 301  11],416,5,18218,4.257536807665343,60.0,20.0
34279,3,4279,[ 64 318 313 301  11],43,5,18223,4.257710280373832,60.0,20.0
34280,3,4280,[ 64 318 313 301  11],43,5,18228,4.2578836720392435,60.0,20.0
34281,3,4281,[ 64 318 313 301  11],416,5,18233,4.258056982718356,60.0,20.0
34282,3,4282,[ 64 318 313 301  11],43,5,18238,4.258230212467896,60.0,20.0
34283,3,4283,[ 64 318 313 301  11],345,5,18243,4.258403361344538,60.0,20.0
34284,3,4284,[111 196 216 174 191],416,5,18248,4.258576429404901,0.0,0.0
34285,3,4285,[ 64 318 313 301  11],416,5,18253,4.258749416705553,60.0,20.0
34286,3,4286,[ 64 318 313 301  11],416,5,18258,4.258922323303009,60.0,20.0
34287,3,4287,[237 144 125 385  56],505,1,18259,4.258162313432836,0.0,0.0
34288,3,4288,[ 64 318 313 301  11],345,5,18264,4.258335276288179,60.0,20.0
34289,3,4289,[ 64 318 313 301  11],43,5,18269,4.258508158508159,60.0,20.0
34290,3,4290,[168 357  89 175 179],214,4,18273,4.258447914239105,0.0,0.0
34291,3,4291,[ 64 318 313 301  11],43,5,18278,4.258620689655173,60.0,20.0
34292,3,4292,[ 64 318 313 301  11],43,5,18283,4.2587933845795485,60.0,20.0
34293,3,4293,[168 183 179  50 132],405,2,18285,4.2582673497904056,0.0,20.0
34294,3,4294,[ 64 318 313 301  11],43,5,18290,4.258440046565775,60.0,20.0
34295,3,4295,[174 195 238  98 191],805,3,18293,4.258147113594041,0.0,20.0
34296,3,4296,[ 64 318 313 301  11],416,5,18298,4.2583197579706775,60.0,20.0
34297,3,4297,[ 64 318 313 301  11],345,5,18303,4.2584923220102375,60.0,20.0
34298,3,4298,[202  88 179 180  70],405,1,18304,4.257734356827169,0.0,0.0
34299,3,4299,[ 56 742 496  79 153],253,3,18307,4.257441860465116,0.0,0.0
34300,3,4300,[ 64 318 313 301  11],43,5,18312,4.257614508253894,60.0,20.0
34301,3,4301,[ 64 318 313 301  11],416,5,18317,4.257787075778707,60.0,20.0
34302,3,4302,[655   1 483 191  56],618,5,18322,4.257959563095515,20.0,0.0
34303,3,4303,[ 64 318 313 301  11],345,5,18327,4.258131970260223,60.0,20.0
34304,3,4304,[ 95 483 385  79  56],618,4,18331,4.258072009291522,20.0,0.0
34305,3,4305,[ 64 318 313 301  11],43,5,18336,4.258244310264747,60.0,20.0
34306,3,4306,[234 179  71  69  89],198,3,18339,4.257952170884606,0.0,0.0
34307,3,4307,[ 64 318 313 301  11],43,5,18344,4.258124419684308,60.0,20.0
34308,3,4308,[121 127  69   8 172],601,2,18346,4.25760037131585,0.0,0.0
34309,3,4309,[ 89 237 234  12 475],297,4,18350,4.25754060324826,20.0,0.0
34310,3,4310,[  9 427  98 269 275],416,5,18355,4.257712827650197,0.0,20.0
34311,3,4311,[ 98  64 195  89  25],854,3,18358,4.257421150278293,20.0,20.0
34312,3,4312,[ 64 318 313 301  11],43,5,18363,4.257593322513332,60.0,20.0
34313,3,4313,[183 271 117 237 191],297,3,18366,4.257301808066759,0.0,0.0
34314,3,4314,[258 423   1   8 172],62,3,18369,4.257010428736964,0.0,0.0
34315,3,4315,[ 11  95 200 168 121],198,3,18372,4.256719184430028,0.0,0.0
34316,3,4316,[118 185 294 357  71],416,4,18376,4.25665971739634,0.0,0.0
34317,3,4317,[ 64 318 313 301  11],43,5,18381,4.25683186660491,60.0,20.0
34318,3,4318,[ 64 318 313 301  11],345,5,18386,4.257003936096319,60.0,20.0
34319,3,4319,[ 64 318 313 301  11],345,5,18391,4.257175925925926,60.0,20.0
34320,3,4320,[ 64 318 313 301  11],43,5,18396,4.25734783614904,60.0,20.0
34321,3,4321,[ 64 318 313 301  11],43,5,18401,4.257519666820916,60.0,20.0
34322,3,4322,[ 64 151  82 132 234],198,3,18404,4.257228776312746,20.0,0.0
34323,3,4323,[742 196  50 153  11],43,5,18409,4.257400555041628,0.0,20.0
34324,3,4324,[ 64 318 313 301  11],43,5,18414,4.25757225433526,60.0,20.0
34325,3,4325,[ 64 318 313 301  11],43,5,18419,4.257743874248729,60.0,20.0
34326,3,4326,[ 64 318 313 301  11],416,5,18424,4.257915414837069,60.0,20.0
34327,3,4327,[597  98 127  28  50],62,3,18427,4.257624768946395,0.0,40.0
34328,3,4328,[588  50 118 161  71],437,1,18428,4.256872256872257,0.0,20.0
34329,3,4329,[ 64 318 313 301  11],43,5,18433,4.257043879907621,60.0,20.0
34330,3,4330,[117  50  79 515 182],230,4,18437,4.256984530131609,0.0,20.0
34331,3,4331,[ 64 318 313 301  11],43,5,18442,4.257156048014774,60.0,20.0
34332,3,4332,[ 64 318 313 301  11],43,5,18447,4.257327486729748,60.0,20.0
34333,3,4333,[ 64 318 313 301  11],416,5,18452,4.257498846331334,60.0,20.0
34334,3,4334,[185 238 257  56 288],854,4,18456,4.257439446366782,0.0,20.0
34335,3,4335,[ 64 318 313 301  11],416,5,18461,4.257610701107011,60.0,20.0
34336,3,4336,[385 179 515 655 268],417,5,18466,4.257781876873414,0.0,0.0
34337,3,4337,[ 64 318 313 301  11],416,5,18471,4.2579529737206085,60.0,20.0
34338,3,4338,[222 318 385 121   7],198,2,18473,4.257432588153953,20.0,0.0
34339,3,4339,[ 64 318 313 301  11],416,5,18478,4.257603686635945,60.0,20.0
34340,3,4340,[ 64 318 313 301  11],43,5,18483,4.257774706288873,60.0,20.0
34341,3,4341,[ 71  28 151 174 288],805,1,18484,4.257024412713036,0.0,20.0
34342,3,4342,[423   1 144 222   7],297,2,18486,4.256504720239466,0.0,0.0
34343,3,4343,[ 64 318 313 301  11],416,5,18491,4.2566758747697975,60.0,20.0
34344,3,4344,[ 64 318 313 301  11],43,5,18496,4.256846950517836,60.0,20.0
34345,3,4345,[ 64 318 313 301  11],345,5,18501,4.257017947537966,60.0,20.0
34346,3,4346,[ 97 288 282 153  71],416,5,18506,4.257188865884518,0.0,20.0
34347,3,4347,[  1 597  69 273 125],630,3,18509,4.256899724011039,0.0,0.0
34348,3,4348,[ 64 318 313 301  11],43,5,18514,4.2570705909404465,60.0,20.0
34349,3,4349,[275  98 282 483 655],618,3,18517,4.256781609195403,20.0,20.0
34350,3,4350,[ 64 318 313 301  11],345,5,18522,4.256952424729947,60.0,20.0
34351,3,4351,[ 64 318 313 301  11],416,5,18527,4.257123161764706,60.0,20.0
34352,3,4352,[ 15 328  82 197 275],416,5,18532,4.257293820353779,0.0,0.0
34353,3,4353,[222 210 174   8 121],43,5,18537,4.257464400551218,0.0,0.0
34354,3,4354,[ 64 318 313 301  11],345,5,18542,4.257634902411022,60.0,20.0
34355,3,4355,[603 151  82 282  11],416,4,18546,4.257575757575758,0.0,0.0
34356,3,4356,[ 64 318 313 301  11],416,5,18551,4.25774615561166,60.0,20.0
34357,3,4357,[  8 300 328  22 127],721,5,18556,4.257916475447453,0.0,0.0
34358,3,4358,[ 64 318 313 301  11],416,5,18561,4.258086717136958,60.0,20.0
34359,3,4359,[200 288  28  64 172],405,4,18565,4.25802752293578,20.0,20.0
34360,3,4360,[ 82 655 228 318 588],405,3,18568,4.2577390506764505,20.0,0.0
34361,3,4361,[200 282 194 153 268],416,5,18573,4.2579092159559835,0.0,0.0
34362,3,4362,[237 183 161 151  95],618,3,18576,4.257620903048362,0.0,0.0
34363,3,4363,[ 64 318 313 301  11],43,5,18581,4.257791017415215,60.0,20.0
34364,3,4364,[ 64 318 313 301  11],416,5,18586,4.2579610538373425,60.0,20.0
34365,3,4365,[ 64 318 313 301  11],43,5,18591,4.258131012368301,60.0,20.0
34366,3,4366,[ 64 318 313 301  11],416,5,18596,4.258300893061598,60.0,20.0
34367,3,4367,[144 185  89 322  50],805,3,18599,4.25801282051282,0.0,20.0
34368,3,4368,[ 64 318 313 301  11],43,5,18604,4.258182650492103,60.0,20.0
34369,3,4369,[ 64 318 313 301  11],43,5,18609,4.258352402745995,60.0,20.0
34370,3,4370,[271 258 161  88 153],805,1,18610,4.257606954930222,0.0,0.0
34371,3,4371,[ 22 423 282 603 271],297,2,18612,4.2570905763952425,0.0,0.0
34372,3,4372,[185  15 258 153 125],417,4,18616,4.257031785959295,0.0,0.0
34373,3,4373,[ 88   9  89 258  28],805,1,18617,4.25628715134888,0.0,0.0
34374,3,4374,[ 64 318 313 301  11],416,5,18622,4.256457142857143,60.0,20.0
34375,3,4375,[ 64 318 313 301  11],416,5,18627,4.256627056672761,60.0,20.0
34376,3,4376,[ 64 318 313 301  11],43,5,18632,4.256796892848984,60.0,20.0
34377,3,4377,[313  50 265 269 496],711,4,18636,4.256738236637734,20.0,40.0
34378,3,4378,[ 64 318 313 301  11],345,5,18641,4.256907969856131,60.0,20.0
34379,3,4379,[ 64 318 313 301  11],345,5,18646,4.257077625570776,60.0,20.0
34380,3,4380,[ 64 318 313 301  11],345,5,18651,4.257247203834741,60.0,20.0
34381,3,4381,[ 64 318 313 301  11],416,5,18656,4.25741670470105,60.0,20.0
34382,3,4382,[ 11 403  12 282 144],618,4,18660,4.257357973990418,20.0,0.0
34383,3,4383,[ 64 318 313 301  11],43,5,18665,4.257527372262774,60.0,20.0
34384,3,4384,[182 515 294 168 216],297,3,18668,4.257240592930445,0.0,0.0
34385,3,4385,[ 64 318 313 301  11],43,5,18673,4.257409940720474,60.0,20.0
34386,3,4386,[471 211 172 161 269],373,4,18677,4.257351265101436,0.0,0.0
34387,3,4387,[ 64 318 313 301  11],43,5,18682,4.257520510483136,60.0,20.0
34388,3,4388,[ 64 318 313 301  11],416,5,18687,4.25768967874231,60.0,20.0
34389,3,4389,[258 301   4   8 168],49,1,18688,4.256947608200456,0.0,0.0
34390,3,4390,[ 64 318 313 301  11],416,5,18693,4.2571168298792985,60.0,20.0
34391,3,4391,[ 64 318 313 301  11],43,5,18698,4.257285974499089,60.0,20.0
34392,3,4392,[195 276  82 268 121],416,4,18702,4.257227407238789,0.0,0.0
34393,3,4393,[ 64 318 313 301  11],345,5,18707,4.257396449704142,60.0,20.0
34394,3,4394,[238 257 174  98  71],416,4,18711,4.257337883959044,0.0,20.0
34395,3,4395,[294 235 357 597  50],854,2,18713,4.2568243858052774,0.0,20.0
34396,3,4396,[168 265  28 496 403],618,5,18718,4.256993404594041,0.0,0.0
34397,3,4397,[ 64 318 313 301  11],345,5,18723,4.257162346521146,60.0,20.0
34398,3,4398,[275 161 143  88  79],437,3,18726,4.256876562855195,0.0,0.0
34399,3,4399,[ 64 318 313 301  11],43,5,18731,4.257045454545454,60.0,20.0
34400,3,4400,[ 64 318 313 301  11],43,5,18736,4.257214269484209,60.0,20.0
34401,3,4401,[ 64 318 313 301  11],43,5,18741,4.257383007723762,60.0,20.0
34402,3,4402,[ 64 318 313 301  11],43,5,18746,4.257551669316375,60.0,20.0
34403,3,4403,[ 64 318 313 301  11],345,5,18751,4.257720254314259,60.0,20.0
34404,3,4404,[ 64 318 313 301  11],345,5,18756,4.25788876276958,60.0,20.0
34405,3,4405,[ 56 475  95 273  25],805,3,18759,4.2576032682705405,0.0,0.0
34406,3,4406,[ 15   1 144 135 168],417,3,18762,4.257317903335602,0.0,0.0
34407,3,4407,[ 64 318 313 301  11],416,5,18767,4.257486388384755,60.0,20.0
34408,3,4408,[202  98 191 496 238],437,5,18772,4.257654797006124,0.0,20.0
34409,3,4409,[ 64 318 313 301  11],345,5,18777,4.257823129251701,60.0,20.0
34410,3,4410,[ 64 318 313 301  11],43,5,18782,4.25799138517343,60.0,20.0
34411,3,4411,[180 118  96 135 127],854,3,18785,4.257706255666364,0.0,0.0
34412,3,4412,[ 64 318 313 301  11],416,5,18790,4.257874461817358,60.0,20.0
34413,3,4413,[118 143 222  95 183],198,1,18791,4.257136384231989,0.0,0.0
34414,3,4414,[ 64 318 313 301  11],345,5,18796,4.257304643261608,60.0,20.0
34415,3,4415,[ 64 318 313 301  11],345,5,18801,4.257472826086956,60.0,20.0
34416,3,4416,[200 183 603 597   1],805,4,18805,4.257414534752094,0.0,0.0
34417,3,4417,[ 64 318 313 301  11],345,5,18810,4.257582616568583,60.0,20.0
34418,3,4418,[197 176  88 127  28],405,3,18813,4.2572980312287845,0.0,0.0
34419,3,4419,[ 64 318 313 301  11],345,5,18818,4.257466063348416,60.0,20.0
34420,3,4420,[ 64 318 313 301  11],345,5,18823,4.257634019452612,60.0,20.0
34421,3,4421,[323  12 202 127 475],416,3,18826,4.257349615558571,20.0,0.0
34422,3,4422,[ 64 318 313 301  11],43,5,18831,4.2575175220438615,60.0,20.0
34423,3,4423,[257 204  56 179 286],416,3,18834,4.257233273056058,0.0,0.0
34424,3,4424,[ 22  11 180  98   7],214,4,18838,4.2571751412429375,0.0,20.0
34425,3,4425,[ 64 318 313 301  11],416,5,18843,4.257342973339358,60.0,20.0
34426,3,4426,[ 64 318 313 301  11],345,5,18848,4.257510729613734,60.0,20.0
34427,3,4427,[ 64 318 313 301  11],345,5,18853,4.2576784101174345,60.0,20.0
34428,3,4428,[118 238 172 195 300],654,4,18857,4.257620230300294,0.0,0.0
34429,3,4429,[161 211 289 174 333],416,4,18861,4.257562076749435,0.0,0.0
34430,3,4430,[ 64 318 313 301  11],43,5,18866,4.257729632137215,60.0,20.0
34431,3,4431,[ 64 318 313 301  11],416,5,18871,4.2578971119133575,60.0,20.0
34432,3,4432,[ 64 318 313 301  11],345,5,18876,4.258064516129032,60.0,20.0
34433,3,4433,[471 288 597 111 423],588,3,18879,4.2577807848443845,0.0,20.0
34434,3,4434,[ 64 318 313 301  11],345,5,18884,4.257948139797069,60.0,20.0
34435,3,4435,[ 64 318 313 301  11],43,5,18889,4.258115419296663,60.0,20.0
34436,3,4436,[132  98 228 385  50],405,3,18892,4.257831868379536,0.0,40.0
34437,3,4437,[ 64 318 313 301  11],416,5,18897,4.257999098693105,60.0,20.0
34438,3,4438,[496 302 117 357  25],416,5,18902,4.258166253660734,0.0,0.0
34439,3,4439,[ 64 318 313 301  11],416,5,18907,4.258333333333334,60.0,20.0
34440,3,4440,[ 64 318 313 301  11],416,5,18912,4.258500337761765,60.0,20.0
34441,3,4441,[ 64 318 313 301  11],416,5,18917,4.258667266996849,60.0,20.0
34442,3,4442,[ 64 318 313 301  11],43,5,18922,4.258834121089354,60.0,20.0
34443,3,4443,[ 64 318 313 301  11],416,5,18927,4.259000900090009,60.0,20.0
34444,3,4444,[ 64 318 313 301  11],43,5,18932,4.259167604049494,60.0,20.0
34445,3,4445,[237   7 176 187  98],416,4,18936,4.2591093117408905,0.0,20.0
34446,3,4446,[ 97  70  12 588 125],373,3,18939,4.258826174949404,20.0,0.0
34447,3,4447,[ 64 318 313 301  11],345,5,18944,4.258992805755396,60.0,20.0
34448,3,4448,[300 204  97 289 143],416,4,18948,4.258934592043156,0.0,0.0
34449,3,4449,[197 185  12 100  97],416,5,18953,4.259101123595506,20.0,0.0
34450,3,4450,[ 64 318 313 301  11],43,5,18958,4.25926758031903,60.0,20.0
34451,3,4451,[273   7  82 153 125],416,5,18963,4.259433962264151,0.0,0.0
34452,3,4452,[ 64 318 313 301  11],345,5,18968,4.259600269481249,60.0,20.0
34453,3,4453,[211 276 300 144 275],43,5,18973,4.259766502020655,0.0,0.0
34454,3,4454,[204 100  15 194 111],416,5,18978,4.25993265993266,0.0,0.0
34455,3,4455,[357  97 181 118 423],62,2,18980,4.259425493716337,0.0,20.0
34456,3,4456,[ 64 318 313 301  11],43,5,18985,4.2595916535786404,60.0,20.0
34457,3,4457,[ 64 318 313 301  11],43,5,18990,4.259757738896366,60.0,20.0
34458,3,4458,[172 181  79 118 215],437,3,18993,4.259475218658892,0.0,20.0
34459,3,4459,[181  50 194 187 273],416,5,18998,4.2596412556053815,0.0,40.0
34460,3,4460,[ 64 318 313 301  11],43,5,19003,4.259807218112531,60.0,20.0
34461,3,4461,[ 64 318 313 301  11],43,5,19008,4.25997310623039,60.0,20.0
34462,3,4462,[ 64 318 313 301  11],416,5,19013,4.260138920008963,60.0,20.0
34463,3,4463,[ 64 318 313 301  11],345,5,19018,4.260304659498208,60.0,20.0
34464,3,4464,[179 173  11 405 427],416,4,19022,4.260246360582307,0.0,0.0
34465,3,4465,[ 64 318 313 301  11],345,5,19027,4.2604120017913125,60.0,20.0
34466,3,4466,[ 64 318 313 301  11],416,5,19032,4.260577568838146,60.0,20.0
34467,3,4467,[ 64 318 313 301  11],345,5,19037,4.260743061772605,60.0,20.0
34468,3,4468,[ 64 318 313 301  11],345,5,19042,4.2609084806444395,60.0,20.0
34469,3,4469,[ 64 318 313 301  11],416,5,19047,4.261073825503356,60.0,20.0
34470,3,4470,[ 22  98 202 273 144],416,5,19052,4.261239096399016,0.0,20.0
34471,3,4471,[ 64 318 313 301  11],416,5,19057,4.261404293381037,60.0,20.0
34472,3,4472,[ 64 318 313 301  11],345,5,19062,4.261569416498994,60.0,20.0
34473,3,4473,[180  50 200 121  11],198,3,19065,4.261287438533751,0.0,20.0
34474,3,4474,[ 64 318 313 301  11],345,5,19070,4.26145251396648,60.0,20.0
34475,3,4475,[ 64 318 313 301  11],416,5,19075,4.261617515638964,60.0,20.0
34476,3,4476,[111 496  56 202  15],416,5,19080,4.261782443600626,0.0,0.0
34477,3,4477,[ 64 318 313 301  11],43,5,19085,4.261947297900849,60.0,20.0
34478,3,4478,[118 174   4 175 313],43,4,19089,4.261888814467515,20.0,20.0
34479,3,4479,[313 234 127 195  82],38,3,19092,4.261607142857143,20.0,20.0
34480,3,4480,[ 64 318 313 301  11],43,5,19097,4.261771925909395,60.0,20.0
34481,3,4481,[471 173 132  56  71],416,5,19102,4.261936635430612,0.0,0.0
34482,3,4482,[ 64 318 313 301  11],416,5,19107,4.262101271469998,60.0,20.0
34483,3,4483,[ 64 318 313 301  11],416,5,19112,4.262265834076717,60.0,20.0
34484,3,4484,[197   8 588 423 179],405,3,19115,4.261984392419175,0.0,0.0
34485,3,4485,[ 64 318 313 301  11],43,5,19120,4.262148907712884,60.0,20.0
34486,3,4486,[ 64 318 313 301  11],345,5,19125,4.262313349676845,60.0,20.0
34487,3,4487,[318 546 127  50 258],62,5,19130,4.2624777183600715,20.0,20.0
34488,3,4488,[ 64 318 313 301  11],345,5,19135,4.262642013811539,60.0,20.0
34489,3,4489,[ 64 318 313 301  11],43,5,19140,4.262806236080178,60.0,20.0
34490,3,4490,[127 323 313 678 181],416,3,19143,4.2625250501002006,20.0,40.0
34491,3,4491,[151 121 174  98 385],49,2,19145,4.262021371326803,0.0,20.0
34492,3,4492,[ 25 180  28  82 228],887,4,19149,4.261963053638994,0.0,0.0
34493,3,4493,[168 175 234 173 176],297,4,19153,4.261904761904762,0.0,0.0
34494,3,4494,[202 301 265 135 546],297,2,19155,4.261401557285873,0.0,0.0
34495,3,4495,[ 64 318 313 301  11],416,5,19160,4.261565836298932,60.0,20.0
34496,3,4496,[179 286 127 323 515],416,3,19163,4.261285301311986,0.0,0.0
34497,3,4497,[ 64 318 313 301  11],43,5,19168,4.261449533125834,60.0,20.0
34498,3,4498,[ 64 318 313 301  11],345,5,19173,4.26161369193154,60.0,20.0
34499,3,4499,[191 655 127 210 202],618,3,19176,4.261333333333333,0.0,0.0
34500,3,4500,[121  64  22 483 258],711,4,19180,4.2612752721617415,40.0,0.0
34501,3,4501,[ 64 318 313 301  11],416,5,19185,4.261439360284318,60.0,20.0
34502,3,4502,[174 333 118  15  64],345,3,19188,4.261159227181879,20.0,0.0
34503,3,4503,[172  98 200 183 294],805,4,19192,4.261101243339254,0.0,20.0
34504,3,4504,[257 187 568 183 357],416,4,19196,4.261043285238624,0.0,0.0
34505,3,4505,[ 64 318 313 301  11],345,5,19201,4.261207279183311,60.0,20.0
34506,3,4506,[568 238  95 175 385],43,3,19204,4.260927446194808,0.0,0.0
34507,3,4507,[ 70 357 196 111 318],416,5,19209,4.261091393078971,20.0,0.0
34508,3,4508,[655 275 216  28  88],437,3,19212,4.260811709913506,0.0,0.0
34509,3,4509,[ 64 318 313 301  11],416,5,19217,4.260975609756097,60.0,20.0
34510,3,4510,[ 64 318 313 301  11],43,5,19222,4.261139436931944,60.0,20.0
34511,3,4511,[ 64 318 313 301  11],345,5,19227,4.261303191489362,60.0,20.0
34512,3,4512,[ 64 318 313 301  11],345,5,19232,4.261466873476623,60.0,20.0
34513,3,4513,[289 508 238 204 258],345,4,19236,4.26140894993354,0.0,0.0
34514,3,4514,[ 64 318 313 301  11],416,5,19241,4.2615725359911405,60.0,20.0
34515,3,4515,[ 64 318 313 301  11],416,5,19246,4.261736049601417,60.0,20.0
34516,3,4516,[ 25   8 271 144 238],43,3,19249,4.261456719061324,0.0,0.0
34517,3,4517,[275 237 268 196 215],654,4,19253,4.261398849048251,0.0,0.0
34518,3,4518,[ 64 318 313 301  11],416,5,19258,4.261562292542598,60.0,20.0
34519,3,4519,[ 64 318 313 301  11],345,5,19263,4.261725663716814,60.0,20.0
34520,3,4520,[ 64 318 313 301  11],416,5,19268,4.261888962618889,60.0,20.0
34521,3,4521,[ 64 318 313 301  11],43,5,19273,4.262052189296772,60.0,20.0
34522,3,4522,[265   4 268  70 405],417,2,19275,4.261552067212027,0.0,0.0
34523,3,4523,[268  98 603 187 117],416,5,19280,4.261715296198055,0.0,20.0
34524,3,4524,[ 97 161 151 121 282],128,2,19282,4.261215469613259,0.0,0.0
34525,3,4525,[ 28 496   1 235 195],887,4,19286,4.261157755192222,0.0,0.0
34526,3,4526,[568  82 151   1 475],198,3,19289,4.260879169427877,0.0,0.0
34527,3,4527,[215 603  95 268 471],297,2,19291,4.2603798586572434,0.0,0.0
34528,3,4528,[300  98 568 211  71],416,5,19296,4.260543166261868,0.0,20.0
34529,3,4529,[121  11 268 211  95],416,4,19300,4.260485651214128,0.0,0.0
34530,3,4530,[ 64 318 313 301  11],345,5,19305,4.260648863385566,60.0,20.0
34531,3,4531,[ 64 318 313 301  11],345,5,19310,4.26081200353045,60.0,20.0
34532,3,4532,[ 64 318 313 301  11],345,5,19315,4.260975071696448,60.0,20.0
34533,3,4533,[ 64 318 313 301  11],43,5,19320,4.261138067931187,60.0,20.0
34534,3,4534,[423 176  97 357 483],62,3,19323,4.260859977949283,20.0,0.0
34535,3,4535,[ 64 318 313 301  11],345,5,19328,4.261022927689594,60.0,20.0
34536,3,4536,[ 64 318 313 301  11],416,5,19333,4.261185805598413,60.0,20.0
34537,3,4537,[ 64 318 313 301  11],416,5,19338,4.261348611723226,60.0,20.0
34538,3,4538,[ 64 318 313 301  11],43,5,19343,4.261511346111479,60.0,20.0
34539,3,4539,[ 79 174 204 385 182],416,5,19348,4.261674008810573,0.0,0.0
34540,3,4540,[ 64 318 313 301  11],43,5,19353,4.261836599867871,60.0,20.0
34541,3,4541,[ 64 318 313 301  11],43,5,19358,4.261999119330691,60.0,20.0
34542,3,4542,[ 15 742  25 405 127],854,2,19360,4.261501210653753,0.0,0.0
34543,3,4543,[ 64 318 313 301  11],416,5,19365,4.261663732394366,60.0,20.0
34544,3,4544,[197 435 257   7  88],354,3,19368,4.261386138613862,0.0,0.0
34545,3,4545,[ 64 318 313 301  11],416,5,19373,4.2615486141663,60.0,20.0
34546,3,4546,[ 64 318 313 301  11],43,5,19378,4.261711018253794,60.0,20.0
34547,3,4547,[ 64 318 313 301  11],416,5,19383,4.261873350923483,60.0,20.0
34548,3,4548,[ 64 318 313 301  11],345,5,19388,4.2620356122224665,60.0,20.0
34549,3,4549,[173  98 235 191  50],297,3,19391,4.261758241758241,0.0,40.0
34550,3,4550,[423 195 172  97 168],373,3,19394,4.26148099318831,0.0,0.0
34551,3,4551,[ 64 318 313 301  11],416,5,19399,4.26164323374341,60.0,20.0
34552,3,4552,[ 64 318 313 301  11],43,5,19404,4.261805403030968,60.0,20.0
34553,3,4553,[202 215 471 185  97],921,2,19406,4.261308739569609,0.0,0.0
34554,3,4554,[515 168 186  70 265],417,4,19410,4.261251372118551,0.0,0.0
34555,3,4555,[117 300  79 282  11],416,5,19415,4.261413520632133,0.0,0.0
34556,3,4556,[ 64 318 313 301  11],345,5,19420,4.261575597981128,60.0,20.0
34557,3,4557,[196 748 234   7 245],416,4,19424,4.261518209741115,0.0,0.0
34558,3,4558,[180 200 185 153 301],437,4,19428,4.261460846676902,0.0,0.0
34559,3,4559,[ 64 318 313 301  11],416,5,19433,4.2616228070175435,60.0,20.0
34560,3,4560,[588  56  95 257 496],314,4,19437,4.261565446174084,0.0,0.0
34561,3,4561,[118 328 181 268 423],416,4,19441,4.261508110477861,0.0,20.0
34562,3,4562,[ 64 318 313 301  11],345,5,19446,4.261669953977647,60.0,20.0
34563,3,4563,[ 64 318 313 301  11],43,5,19451,4.261831726555653,60.0,20.0
34564,3,4564,[ 64 318 313 301  11],416,5,19456,4.261993428258489,60.0,20.0
34565,3,4565,[ 64 318 313 301  11],416,5,19461,4.26215505913272,60.0,20.0
34566,3,4566,[ 69 742  70 323  25],417,1,19462,4.261440770746661,0.0,0.0
34567,3,4567,[257 222 168 135 143],698,1,19463,4.260726795096322,0.0,0.0
34568,3,4568,[  1 127 191 276 202],618,3,19466,4.260450864521777,0.0,0.0
34569,3,4569,[357 318 210 176 258],416,5,19471,4.260612691466084,20.0,0.0
34570,3,4570,[ 64 318 313 301  11],345,5,19476,4.260774447604463,60.0,20.0
34571,3,4571,[ 64 318 313 301  11],345,5,19481,4.260936132983377,60.0,20.0
34572,3,4572,[ 64 318 313 301  11],345,5,19486,4.261097747649246,60.0,20.0
34573,3,4573,[ 64 318 313 301  11],43,5,19491,4.2612592916484475,60.0,20.0
34574,3,4574,[ 64 318 313 301  11],416,5,19496,4.261420765027323,60.0,20.0
34575,3,4575,[ 64 318 313 301  11],416,5,19501,4.2615821678321675,60.0,20.0
34576,3,4576,[ 64 318 313 301  11],43,5,19506,4.261743500109242,60.0,20.0
34577,3,4577,[ 64 318 313 301  11],43,5,19511,4.261904761904762,60.0,20.0
34578,3,4578,[153 276 323 174 300],416,3,19514,4.26162917667613,0.0,0.0
34579,3,4579,[ 64 318 313 301  11],43,5,19519,4.261790393013101,60.0,20.0
34580,3,4580,[ 15 191   8 427 403],642,4,19523,4.261733246016154,0.0,0.0
34581,3,4581,[195 568  25 117 228],230,1,19524,4.261021388040157,0.0,0.0
34582,3,4582,[ 64 318 313 301  11],416,5,19529,4.261182631464107,60.0,20.0
34583,3,4583,[655  79 403  15 235],416,4,19533,4.261125654450262,0.0,0.0
34584,3,4584,[ 64 318 313 301  11],416,5,19538,4.261286804798255,60.0,20.0
34585,3,4585,[ 97 117 258 257 496],416,4,19542,4.261229829917139,0.0,0.0
34586,3,4586,[ 64 318 313 301  11],43,5,19547,4.261390887290168,60.0,20.0
34587,3,4587,[ 64 318 313 301  11],43,5,19552,4.2615518744551,60.0,20.0
34588,3,4588,[ 64 318 313 301  11],416,5,19557,4.261712791457834,60.0,20.0
34589,3,4589,[603 276 161  96 405],416,4,19561,4.261655773420479,0.0,0.0
34590,3,4590,[ 64 318 313 301  11],345,5,19566,4.261816597691134,60.0,20.0
34591,3,4591,[168  98  15 185 182],417,4,19570,4.261759581881533,0.0,20.0
34592,3,4592,[328 168  69 151 172],43,5,19575,4.261920313520575,0.0,0.0
34593,3,4593,[  8 202 204 168 423],405,4,19579,4.261863299956465,0.0,0.0
34594,3,4594,[ 64 318 313 301  11],43,5,19584,4.2620239390642,60.0,20.0
34595,3,4595,[ 64 318 313 301  11],43,5,19589,4.262184508268059,60.0,20.0
34596,3,4596,[ 64 318 313 301  11],416,5,19594,4.262345007613661,60.0,20.0
34597,3,4597,[475 194 258 204 182],416,4,19598,4.262287951283167,0.0,0.0
34598,3,4598,[ 64 318 313 301  11],416,5,19603,4.262448358338769,60.0,20.0
34599,3,4599,[ 64 318 313 301  11],345,5,19608,4.262608695652174,60.0,20.0
34600,3,4600,[161 153 275  82 588],43,5,19613,4.262768963268854,0.0,0.0
34601,3,4601,[118   1 196  11 210],345,3,19616,4.2624945675793136,0.0,0.0
34602,3,4602,[197 471 127 603   7],854,4,19620,4.262437540734304,0.0,0.0
34603,3,4603,[111 483 202  98  56],417,4,19624,4.262380538662033,20.0,20.0
34604,3,4604,[ 64 318 313 301  11],416,5,19629,4.262540716612378,60.0,20.0
34605,3,4605,[ 64 318 313 301  11],345,5,19634,4.262700825010856,60.0,20.0
34606,3,4606,[ 64 318 313 301  11],345,5,19639,4.262860863902756,60.0,20.0
34607,3,4607,[568 151 258 471 111],345,4,19643,4.262803819444445,0.0,0.0
34608,3,4608,[ 64 318 313 301  11],345,5,19648,4.262963766543719,60.0,20.0
34609,3,4609,[ 64 318 313 301  11],416,5,19653,4.2631236442516265,60.0,20.0
34610,3,4610,[ 64 318 313 301  11],416,5,19658,4.263283452613316,60.0,20.0
34611,3,4611,[ 96 195   1  89 173],705,2,19660,4.262792714657415,0.0,0.0
34612,3,4612,[328  25 143 183 216],416,5,19665,4.262952525471493,0.0,0.0
34613,3,4613,[ 64 318 313 301  11],345,5,19670,4.263112267013438,60.0,20.0
34614,3,4614,[ 64 318 313 301  11],43,5,19675,4.263271939328277,60.0,20.0
34615,3,4615,[471 111  64 257 168],43,4,19679,4.263214904679376,20.0,0.0
34616,3,4616,[ 64 318 313 301  11],345,5,19684,4.2633744855967075,60.0,20.0
34617,3,4617,[742 475 173  50 172],588,4,19688,4.263317453443049,0.0,20.0
34618,3,4618,[ 64 318 313 301  11],43,5,19693,4.263476943061269,60.0,20.0
34619,3,4619,[ 64 318 313 301  11],345,5,19698,4.263636363636364,60.0,20.0
34620,3,4620,[ 64 318 313 301  11],345,5,19703,4.263795715213157,60.0,20.0
34621,3,4621,[ 64 318 313 301  11],345,5,19708,4.263954997836435,60.0,20.0
34622,3,4622,[222 423 300 286 196],721,5,19713,4.264114211550941,0.0,0.0
34623,3,4623,[ 64 318 313 301  11],43,5,19718,4.264273356401384,60.0,20.0
34624,3,4624,[180 173 597 174 117],854,2,19720,4.263783783783784,0.0,0.0
34625,3,4625,[ 64 318 313 301  11],416,5,19725,4.263942931258106,60.0,20.0
34626,3,4626,[ 64 318 313 301  11],43,5,19730,4.264102009941647,60.0,20.0
34627,3,4627,[ 82 211 301 143 655],416,5,19735,4.264261019878997,0.0,0.0
34628,3,4628,[176   7  70   1 271],62,2,19737,4.263771872974725,0.0,0.0
34629,3,4629,[  7 475 268  79 568],214,4,19741,4.263714902807775,0.0,0.0
34630,3,4630,[ 64 318 313 301  11],43,5,19746,4.263873893327575,60.0,20.0
34631,3,4631,[ 64 318 313 301  11],416,5,19751,4.264032815198618,60.0,20.0
34632,3,4632,[ 64 318 313 301  11],345,5,19756,4.264191668465357,60.0,20.0
34633,3,4633,[183 234 268 121 475],416,4,19760,4.264134656883901,0.0,0.0
34634,3,4634,[174 135  97 268 151],496,2,19762,4.2636461704422866,0.0,0.0
34635,3,4635,[ 64 318 313 301  11],43,5,19767,4.263805004314064,60.0,20.0
34636,3,4636,[ 64 318 313 301  11],43,5,19772,4.263963769678671,60.0,20.0
34637,3,4637,[ 64 318 313 301  11],416,5,19777,4.264122466580423,60.0,20.0
34638,3,4638,[191 597  69 258 153],62,4,19781,4.264065531364518,0.0,0.0
34639,3,4639,[ 64 318 313 301  11],416,5,19786,4.264224137931034,60.0,20.0
34640,3,4640,[ 64 318 313 301  11],345,5,19791,4.264382676147382,60.0,20.0
34641,3,4641,[276 176 318  95  79],618,3,19794,4.264110297285653,20.0,0.0
34642,3,4642,[ 64 318 313 301  11],416,5,19799,4.264268791729485,60.0,20.0
34643,3,4643,[  7 237 151 196 603],416,3,19802,4.263996554694229,0.0,0.0
34644,3,4644,[ 64 318 313 301  11],416,5,19807,4.264155005382131,60.0,20.0
34645,3,4645,[ 64 318 313 301  11],345,5,19812,4.2643133878605255,60.0,20.0
34646,3,4646,[ 64 318 313 301  11],345,5,19817,4.264471702173445,60.0,20.0
34647,3,4647,[289 318 195   4 173],416,4,19821,4.264414802065405,20.0,0.0
34648,3,4648,[357  70  97 276 405],230,5,19826,4.2645730264573025,0.0,0.0
34649,3,4649,[ 64 318 313 301  11],416,5,19831,4.264731182795699,60.0,20.0
34650,3,4650,[435  22 471  25 118],297,2,19833,4.2642442485486995,0.0,0.0
34651,3,4651,[ 89 228 118 117  15],417,4,19837,4.264187446259673,0.0,0.0
34652,3,4652,[216 288 385 546 257],416,3,19840,4.263915753277455,0.0,20.0
34653,3,4653,[151  25 288 168 111],711,3,19843,4.263644177051998,0.0,20.0
34654,3,4654,[ 64 318 313 301  11],345,5,19848,4.263802363050483,60.0,20.0
34655,3,4655,[742   1  50 132 195],642,3,19851,4.263530927835052,0.0,20.0
34656,3,4656,[179 118 234 117 127],417,5,19856,4.263689070216878,0.0,0.0
34657,3,4657,[202  28  56 323 168],751,4,19860,4.263632460283383,0.0,0.0
34658,3,4658,[ 64 318 313 301  11],416,5,19865,4.2637905129856195,60.0,20.0
34659,3,4659,[174 234 168 748 423],416,5,19870,4.263948497854077,0.0,0.0
34660,3,4660,[117 271 191   7 173],805,3,19873,4.263677322462991,0.0,0.0
34661,3,4661,[174  96 153 471 333],854,1,19874,4.262977262977263,0.0,0.0
34662,3,4662,[ 64 318 313 301  11],345,5,19879,4.26313532060905,60.0,20.0
34663,3,4663,[ 64 318 313 301  11],345,5,19884,4.263293310463122,60.0,20.0
34664,3,4664,[186 191  98 286 111],417,4,19888,4.263236870310825,0.0,20.0
34665,3,4665,[ 64 318 313 301  11],345,5,19893,4.263394770681526,60.0,20.0
34666,3,4666,[ 64 318 313 301  11],416,5,19898,4.263552603385472,60.0,20.0
34667,3,4667,[ 64 318 313 301  11],416,5,19903,4.263710368466152,60.0,20.0
34668,3,4668,[183  79 257 235 427],416,3,19906,4.26343970871707,0.0,0.0
34669,3,4669,[ 64 318 313 301  11],43,5,19911,4.263597430406852,60.0,20.0
34670,3,4670,[ 64 318 313 301  11],43,5,19916,4.263755084564333,60.0,20.0
34671,3,4671,[ 64 318 313 301  11],345,5,19921,4.263912671232877,60.0,20.0
34672,3,4672,[475 197  56 216 222],297,4,19925,4.263856195163706,0.0,0.0
34673,3,4673,[ 64 318 313 301  11],416,5,19930,4.264013692768507,60.0,20.0
34674,3,4674,[ 64 318 313 301  11],345,5,19935,4.264171122994653,60.0,20.0
34675,3,4675,[ 64 318 313 301  11],43,5,19940,4.264328485885372,60.0,20.0
34676,3,4676,[471 132 151 176 185],854,3,19943,4.2640581569382086,0.0,0.0
34677,3,4677,[ 64 318 313 301  11],416,5,19948,4.2642154766994445,60.0,20.0
34678,3,4678,[182  70 276 161 238],230,3,19951,4.263945287454584,0.0,0.0
34679,3,4679,[ 64 318 313 301  11],416,5,19956,4.264102564102564,60.0,20.0
34680,3,4680,[ 64 318 313 301  11],416,5,19961,4.264259773552659,60.0,20.0
34681,3,4681,[ 64 318 313 301  11],43,5,19966,4.264416915847928,60.0,20.0
34682,3,4682,[234 286 191 135  71],437,3,19969,4.264146914371129,0.0,0.0
34683,3,4683,[294  96 237 172  71],262,2,19971,4.263663535439795,0.0,0.0
34684,3,4684,[ 64 318 313 301  11],345,5,19976,4.263820704375667,60.0,20.0
34685,3,4685,[ 64 318 313 301  11],43,5,19981,4.263977806231328,60.0,20.0
34686,3,4686,[  1 301 322 268 286],324,5,19986,4.264134841049712,0.0,0.0
34687,3,4687,[ 64 318 313 301  11],416,5,19991,4.26429180887372,60.0,20.0
34688,3,4688,[ 64 318 313 301  11],43,5,19996,4.2644487097462145,60.0,20.0
34689,3,4689,[568 748 269  22 121],805,1,19997,4.263752665245202,0.0,0.0
34690,3,4690,[ 64 318 313 301  11],345,5,20002,4.263909614154764,60.0,20.0
34691,3,4691,[ 64 318 313 301  11],345,5,20007,4.264066496163683,60.0,20.0
34692,3,4692,[276 216 215 238 300],128,4,20011,4.264010227999147,0.0,0.0
34693,3,4693,[423 568  56 200 174],417,3,20014,4.263740945888368,0.0,0.0
34694,3,4694,[  7  88 151 276 313],354,1,20015,4.263045793397231,20.0,20.0
34695,3,4695,[  8 313 286 151 655],711,5,20020,4.26320272572402,20.0,20.0
34696,3,4696,[ 64 318 313 301  11],345,5,20025,4.263359591228443,60.0,20.0
34697,3,4697,[ 64 318 313 301  11],416,5,20030,4.263516389953171,60.0,20.0
34698,3,4698,[ 64 318 313 301  11],416,5,20035,4.263673121940839,60.0,20.0
34699,3,4699,[ 71 174 143 172 748],345,3,20038,4.263404255319149,0.0,0.0
34700,3,4700,[185 196 238  15 286],437,4,20042,4.263348223782174,0.0,0.0
34701,3,4701,[197 186  97  56 204],405,4,20046,4.2632922160782645,0.0,0.0
34702,3,4702,[742 117 323 273  56],764,2,20048,4.262810971720179,0.0,0.0
34703,3,4703,[ 64 318 313 301  11],416,5,20053,4.26296768707483,60.0,20.0
34704,3,4704,[ 64 318 313 301  11],345,5,20058,4.263124335812965,60.0,20.0
34705,3,4705,[ 64 318 313 301  11],43,5,20063,4.263280917977051,60.0,20.0
34706,3,4706,[  8  56 132 151 568],588,5,20068,4.263437433609518,0.0,0.0
34707,3,4707,[ 64 318 313 301  11],345,5,20073,4.263593882752761,60.0,20.0
34708,3,4708,[ 64 318 313 301  11],345,5,20078,4.26375026544914,60.0,20.0
34709,3,4709,[ 64 318 313 301  11],43,5,20083,4.263906581740977,60.0,20.0
34710,3,4710,[ 64 318 313 301  11],43,5,20088,4.264062831670558,60.0,20.0
34711,3,4711,[ 64 318 313 301  11],416,5,20093,4.264219015280136,60.0,20.0
34712,3,4712,[181 100 423 655 127],416,5,20098,4.264375132611924,0.0,20.0
34713,3,4713,[ 64 318 313 301  11],43,5,20103,4.264531183708104,60.0,20.0
34714,3,4714,[ 64 318 313 301  11],416,5,20108,4.264687168610816,60.0,20.0
34715,3,4715,[ 64 318 313 301  11],416,5,20113,4.264843087362172,60.0,20.0
34716,3,4716,[ 64 318 313 301  11],345,5,20118,4.26499894000424,60.0,20.0
34717,3,4717,[ 64 318 313 301  11],43,5,20123,4.265154726579059,60.0,20.0
34718,3,4718,[ 64 318 313 301  11],345,5,20128,4.265310447128629,60.0,20.0
34719,3,4719,[228 125 742  71 117],62,3,20131,4.265042372881356,0.0,0.0
34720,3,4720,[181 471 313  69 179],416,4,20135,4.264986231730566,20.0,40.0
34721,3,4721,[204 196 195 210 161],230,4,20139,4.2649301143583225,0.0,0.0
34722,3,4722,[204  95  96  22 496],373,5,20144,4.265085750582257,0.0,0.0
34723,3,4723,[301 318  69   1 143],43,5,20149,4.2652413209144795,20.0,0.0
34724,3,4724,[191 176 100 204 234],297,2,20151,4.2647619047619045,0.0,0.0
34725,3,4725,[100 385  25  95 655],373,3,20154,4.264494286923402,0.0,0.0
34726,3,4726,[ 64 318 313 301  11],345,5,20159,4.264649883647134,60.0,20.0
34727,3,4727,[238 258  28 597  15],43,3,20162,4.264382402707276,0.0,0.0
34728,3,4728,[678 273  82  96 222],805,3,20165,4.2641150348910974,0.0,0.0
34729,3,4729,[ 64 318 313 301  11],43,5,20170,4.264270613107822,60.0,20.0
34730,3,4730,[210 748 655  69 385],373,4,20174,4.264214753751849,0.0,0.0
34731,3,4731,[265 275 215 273 333],416,5,20179,4.264370245139476,0.0,0.0
34732,3,4732,[286 271 181 111 179],62,2,20181,4.2638918233678424,0.0,20.0
34733,3,4733,[ 64 318 313 301  11],416,5,20186,4.264047317279257,60.0,20.0
34734,3,4734,[ 82 237   1 191  50],198,3,20189,4.2637803590285115,0.0,20.0
34735,3,4735,[515 258 132 168 179],416,4,20193,4.263724662162162,0.0,0.0
34736,3,4736,[ 64 318 313 301  11],416,5,20198,4.263880092885793,60.0,20.0
34737,3,4737,[ 64 318 313 301  11],416,5,20203,4.264035457999156,60.0,20.0
34738,3,4738,[268 215  22 742 204],416,5,20208,4.264190757543785,0.0,0.0
34739,3,4739,[  4 197 200 405 118],805,2,20210,4.263713080168777,0.0,0.0
34740,3,4740,[ 64 318 313 301  11],345,5,20215,4.263868382197849,60.0,20.0
34741,3,4741,[ 64 318 313 301  11],43,5,20220,4.2640236187262754,60.0,20.0
34742,3,4742,[ 64 318 313 301  11],416,5,20225,4.264178789795488,60.0,20.0
34743,3,4743,[ 64 318 313 301  11],416,5,20230,4.26433389544688,60.0,20.0
34744,3,4744,[175 235 197 678  25],297,2,20232,4.2638566912539515,0.0,0.0
34745,3,4745,[ 22  28 288 322 222],721,4,20236,4.2638010956595025,0.0,20.0
34746,3,4746,[ 64 318 313 301  11],43,5,20241,4.263956182852327,60.0,20.0
34747,3,4747,[ 64 318 313 301  11],416,5,20246,4.264111204717776,60.0,20.0
34748,3,4748,[ 64 318 313 301  11],345,5,20251,4.264266161297115,60.0,20.0
34749,3,4749,[125 135 100 228   8],62,4,20255,4.2642105263157895,0.0,0.0
34750,3,4750,[195 228 423 568  98],805,1,20256,4.263523468743422,0.0,20.0
34751,3,4751,[238 323   4 175   1],805,4,20260,4.263468013468014,0.0,0.0
34752,3,4752,[ 98 237   4 151 405],854,3,20263,4.263202188091731,0.0,20.0
34753,3,4753,[234  95  12 111 423],437,4,20267,4.2631468237273875,20.0,0.0
34754,3,4754,[ 64 318 313 301  11],345,5,20272,4.263301787592009,60.0,20.0
34755,3,4755,[678 234 301 405 302],345,4,20276,4.263246425567704,0.0,0.0
34756,3,4756,[ 64 318 313 301  11],345,5,20281,4.263401303342443,60.0,20.0
34757,3,4757,[ 64 318 313 301  11],345,5,20286,4.263556116015132,60.0,20.0
34758,3,4758,[191 135 168 235 403],642,3,20289,4.263290607270435,0.0,0.0
34759,3,4759,[597 179  96 210 268],417,2,20291,4.262815126050421,0.0,0.0
34760,3,4760,[603  70  97 471 748],373,3,20294,4.262549884478051,0.0,0.0
34761,3,4761,[ 64 318 313 301  11],43,5,20299,4.262704745905082,60.0,20.0
34762,3,4762,[ 64 318 313 301  11],43,5,20304,4.26285954230527,60.0,20.0
34763,3,4763,[ 64 318 313 301  11],416,5,20309,4.2630142737195635,60.0,20.0
34764,3,4764,[ 97 132 196 403 179],62,4,20313,4.26295907660021,0.0,0.0
34765,3,4765,[ 97 403 216  69 210],416,5,20318,4.263113722198909,0.0,0.0
34766,3,4766,[ 64 318 313 301  11],416,5,20323,4.26326830291588,60.0,20.0
34767,3,4767,[111  22 185   1 288],416,5,20328,4.2634228187919465,0.0,20.0
34768,3,4768,[ 64 318 313 301  11],345,5,20333,4.263577269867897,60.0,20.0
34769,3,4769,[ 64 318 313 301  11],416,5,20338,4.263731656184486,60.0,20.0
34770,3,4770,[237   1 546 286 151],62,2,20340,4.263257178788514,0.0,0.0
34771,3,4771,[357 197 200 265 216],297,2,20342,4.262782900251467,0.0,0.0
34772,3,4772,[ 64 318 313 301  11],345,5,20347,4.262937355960612,60.0,20.0
34773,3,4773,[ 64 318 313 301  11],345,5,20352,4.263091746962715,60.0,20.0
34774,3,4774,[ 64 318 313 301  11],345,5,20357,4.263246073298429,60.0,20.0
34775,3,4775,[ 64 318 313 301  11],416,5,20362,4.263400335008376,60.0,20.0
34776,3,4776,[ 89 216  64 183  79],198,4,20366,4.263345195729538,20.0,0.0
34777,3,4777,[121 172 196 179 174],437,4,20370,4.263290079531185,0.0,0.0
34778,3,4778,[ 64 318 313 301  11],345,5,20375,4.263444235195648,60.0,20.0
34779,3,4779,[127   9 748 174  12],805,1,20376,4.262761506276151,20.0,0.0
34780,3,4780,[ 64 318 313 301  11],43,5,20381,4.262915708010876,60.0,20.0
34781,3,4781,[235 435 475 151 210],297,2,20383,4.262442492680886,0.0,0.0
34782,3,4782,[ 50  25 172  82 655],751,4,20387,4.262387622830859,0.0,20.0
34783,3,4783,[118  69 282 216 269],345,3,20390,4.262123745819398,0.0,0.0
34784,3,4784,[ 64 318 313 301  11],345,5,20395,4.262277951933124,60.0,20.0
34785,3,4785,[196 153 204 385 300],198,1,20396,4.2615963226076055,0.0,0.0
34786,3,4786,[ 64 318 313 301  11],416,5,20401,4.26175057447253,60.0,20.0
34787,3,4787,[ 64 318 313 301  11],345,5,20406,4.261904761904762,60.0,20.0
34788,3,4788,[496 215 275 111  11],654,5,20411,4.262058884944665,0.0,0.0
34789,3,4789,[237 286  97 471 200],297,3,20414,4.261795407098121,0.0,0.0
34790,3,4790,[ 64 318 313 301  11],43,5,20419,4.261949488624504,60.0,20.0
34791,3,4791,[196  15 269 175 100],43,4,20423,4.261894824707847,0.0,0.0
34792,3,4792,[117 202  98  82 210],505,4,20427,4.261840183601085,0.0,20.0
34793,3,4793,[100 245 257 597 183],62,2,20429,4.26136837713809,0.0,0.0
34794,3,4794,[ 64 318 313 301  11],416,5,20434,4.261522419186653,60.0,20.0
34795,3,4795,[182 385 181 302 168],417,3,20437,4.2612593828190155,0.0,20.0
34796,3,4796,[ 64 318 313 301  11],43,5,20442,4.261413383364603,60.0,20.0
34797,3,4797,[127 210 151 271 185],805,2,20444,4.26094205919133,0.0,0.0
34798,3,4798,[269 322 282 257 515],416,3,20447,4.260679308189206,0.0,0.0
34799,3,4799,[ 64 318 313 301  11],43,5,20452,4.260833333333333,60.0,20.0
34800,3,4800,[ 64 318 313 301  11],43,5,20457,4.260987294313685,60.0,20.0
34801,3,4801,[ 64 318 313 301  11],43,5,20462,4.261141191170346,60.0,20.0
34802,3,4802,[ 64 318 313 301  11],43,5,20467,4.261295023943369,60.0,20.0
34803,3,4803,[ 64 318 313 301  11],345,5,20472,4.261448792672772,60.0,20.0
34804,3,4804,[ 64 318 313 301  11],416,5,20477,4.261602497398544,60.0,20.0
34805,3,4805,[ 64 318 313 301  11],345,5,20482,4.261756138160632,60.0,20.0
34806,3,4806,[ 64 318 313 301  11],416,5,20487,4.26190971499896,60.0,20.0
34807,3,4807,[385  50 187 678 237],416,3,20490,4.261647254575707,0.0,20.0
34808,3,4808,[ 64 318 313 301  11],43,5,20495,4.261800790185069,60.0,20.0
34809,3,4809,[202 127 323 597 475],417,3,20498,4.2615384615384615,0.0,0.0
34810,3,4810,[ 64 318 313 301  11],345,5,20503,4.261691955934317,60.0,20.0
34811,3,4811,[265  28 100 151 204],297,2,20505,4.261221945137157,0.0,0.0
34812,3,4812,[ 64 318 313 301  11],416,5,20510,4.26137544151257,60.0,20.0
34813,3,4813,[127 117 265  71 191],373,4,20514,4.261321146655588,0.0,0.0
34814,3,4814,[ 64 318 313 301  11],43,5,20519,4.2614745586708205,60.0,20.0
34815,3,4815,[  4 143 144  71 275],373,3,20522,4.261212624584718,0.0,0.0
34816,3,4816,[210 403   8 318   1],588,4,20526,4.2611583973427445,20.0,0.0
34817,3,4817,[210 132 318 603 153],416,5,20531,4.261311747613117,20.0,0.0
34818,3,4818,[ 64 318 313 301  11],345,5,20536,4.261465034239468,60.0,20.0
34819,3,4819,[ 64 318 313 301  11],43,5,20541,4.261618257261411,60.0,20.0
34820,3,4820,[176 222 748 678 172],805,4,20545,4.261563990873263,0.0,0.0
34821,3,4821,[204 275 186 185 215],618,3,20548,4.261302364164247,0.0,0.0
34822,3,4822,[ 12 269 216 237 202],416,4,20552,4.261248185776488,20.0,0.0
34823,3,4823,[748 268   8 121  98],416,5,20557,4.2614013266998345,0.0,20.0
34824,3,4824,[496  25  95 603 568],416,4,20561,4.261347150259067,0.0,0.0
34825,3,4825,[ 64 318 313 301  11],345,5,20566,4.261500207210941,60.0,20.0
34826,3,4826,[ 64 318 313 301  11],416,5,20571,4.261653200745805,60.0,20.0
34827,3,4827,[588 125 294 234 135],601,1,20572,4.260977630488815,0.0,0.0
34828,3,4828,[ 64 318 313 301  11],43,5,20577,4.261130668875544,60.0,20.0
34829,3,4829,[ 56 238 161  64 237],416,4,20581,4.261076604554866,20.0,0.0
34830,3,4830,[ 64 318 313 301  11],416,5,20586,4.261229559097496,60.0,20.0
34831,3,4831,[ 64 318 313 301  11],345,5,20591,4.2613824503311255,60.0,20.0
34832,3,4832,[ 64 318 313 301  11],416,5,20596,4.261535278295055,60.0,20.0
34833,3,4833,[ 64 318 313 301  11],416,5,20601,4.261688043028548,60.0,20.0
34834,3,4834,[100  28 143 181 210],373,2,20603,4.261220268872803,0.0,20.0
34835,3,4835,[655  97 172 235 153],62,3,20606,4.26095947063689,0.0,0.0
34836,3,4836,[ 64 318 313 301  11],345,5,20611,4.261112259665081,60.0,20.0
34837,3,4837,[ 64 318 313 301  11],345,5,20616,4.261264985531211,60.0,20.0
34838,3,4838,[117 125 195 216 385],230,3,20619,4.261004339739616,0.0,0.0
34839,3,4839,[132  56 100 234 173],588,4,20623,4.26095041322314,0.0,0.0
34840,3,4840,[271  69 471 125 200],854,3,20626,4.2606899400950216,0.0,0.0
34841,3,4841,[ 22 748 268 258   1],721,3,20629,4.260429574555968,0.0,0.0
34842,3,4842,[ 64 318 313 301  11],345,5,20634,4.2605822837084455,60.0,20.0
34843,3,4843,[185 257 546 161 655],416,3,20637,4.260322047894302,0.0,0.0
34844,3,4844,[204  89 181 655 215],198,4,20641,4.260268317853457,0.0,20.0
34845,3,4845,[ 64 318 313 301  11],416,5,20646,4.260420965744944,60.0,20.0
34846,3,4846,[ 64 318 313 301  11],43,5,20651,4.2605735506498865,60.0,20.0
34847,3,4847,[222 100  22 294 237],764,4,20655,4.260519801980198,0.0,0.0
34848,3,4848,[174 172 471 215 588],373,3,20658,4.2602598473912145,0.0,0.0
34849,3,4849,[ 98  70 328 423 237],62,1,20659,4.2595876288659795,0.0,20.0
34850,3,4850,[ 64 318 313 301  11],416,5,20664,4.259740259740259,60.0,20.0
34851,3,4851,[ 64 318 313 301  11],416,5,20669,4.259892827699917,60.0,20.0
34852,3,4852,[135  70  98 546 172],62,4,20673,4.259839274675459,0.0,20.0
34853,3,4853,[ 64 318 313 301  11],43,5,20678,4.259991759373713,60.0,20.0
34854,3,4854,[174  15 328 191 172],43,5,20683,4.260144181256437,0.0,0.0
34855,3,4855,[ 64 318 313 301  11],345,5,20688,4.260296540362439,60.0,20.0
34856,3,4856,[597 202 176 234 405],416,4,20692,4.260242948322009,0.0,0.0
34857,3,4857,[ 64 318 313 301  11],43,5,20697,4.26039522437217,60.0,20.0
34858,3,4858,[ 64 318 313 301  11],43,5,20702,4.260547437744392,60.0,20.0
34859,3,4859,[ 64 318 313 301  11],43,5,20707,4.260699588477366,60.0,20.0
34860,3,4860,[ 64 318 313 301  11],43,5,20712,4.260851676609751,60.0,20.0
34861,3,4861,[210 200  12 176  71],416,5,20717,4.261003702180172,20.0,0.0
34862,3,4862,[ 64 318 313 301  11],345,5,20722,4.261155665227226,60.0,20.0
34863,3,4863,[ 64 318 313 301  11],43,5,20727,4.2613075657894735,60.0,20.0
34864,3,4864,[ 64 318 313 301  11],416,5,20732,4.261459403905447,60.0,20.0
34865,3,4865,[215 125 568 238  70],62,2,20734,4.260994656802302,0.0,0.0
34866,3,4866,[ 64 318 313 301  11],43,5,20739,4.261146496815287,60.0,20.0
34867,3,4867,[ 64 318 313 301  11],43,5,20744,4.261298274445357,60.0,20.0
34868,3,4868,[403 423 121  11 173],49,0,20744,4.260423084822346,0.0,0.0
34869,3,4869,[ 70 172 173 268 179],417,4,20748,4.260369609856263,0.0,0.0
34870,3,4870,[ 64 318 313 301  11],43,5,20753,4.260521453500308,60.0,20.0
34871,3,4871,[ 64 318 313 301  11],345,5,20758,4.260673234811166,60.0,20.0
34872,3,4872,[ 64 318 313 301  11],345,5,20763,4.260824953827211,60.0,20.0
34873,3,4873,[ 64 318 313 301  11],416,5,20768,4.260976610586787,60.0,20.0
34874,3,4874,[176 268 210 318 191],416,5,20773,4.261128205128205,20.0,0.0
34875,3,4875,[235 100 302 318 183],62,4,20777,4.261074651353568,20.0,0.0
34876,3,4876,[ 64 318 313 301  11],43,5,20782,4.26122616362518,60.0,20.0
34877,3,4877,[588 678 268 174 423],416,4,20786,4.261172611726117,0.0,0.0
34878,3,4878,[ 64 318 313 301  11],345,5,20791,4.2613240418118465,60.0,20.0
34879,3,4879,[ 64 318 313 301  11],345,5,20796,4.261475409836065,60.0,20.0
34880,3,4880,[  8 202   1 200  25],887,3,20799,4.261216963736939,0.0,0.0
34881,3,4881,[204 273 748  64 211],416,5,20804,4.261368291683736,20.0,0.0
34882,3,4882,[144 168  11  95 143],805,1,20805,4.260700389105058,0.0,0.0
34883,3,4883,[195  96 132  98 121],887,4,20809,4.260647010647011,0.0,20.0
34884,3,4884,[ 64 318 313 301  11],345,5,20814,4.2607983623336745,60.0,20.0
34885,3,4885,[ 64 318 313 301  11],345,5,20819,4.26094965206713,60.0,20.0
34886,3,4886,[ 64 318 313 301  11],345,5,20824,4.261100879885411,60.0,20.0
34887,3,4887,[135 210 294 302 288],417,1,20825,4.260433715220949,0.0,20.0
34888,3,4888,[ 64 318 313 301  11],345,5,20830,4.260584986704847,60.0,20.0
34889,3,4889,[ 64 318 313 301  11],345,5,20835,4.2607361963190185,60.0,20.0
34890,3,4890,[ 64 318 313 301  11],43,5,20840,4.260887344101411,60.0,20.0
34891,3,4891,[ 79 182 181 173 125],907,5,20845,4.261038430089942,0.0,20.0
34892,3,4892,[ 64 318 313 301  11],345,5,20850,4.261189454322501,60.0,20.0
34893,3,4893,[ 64 318 313 301  11],416,5,20855,4.261340416836943,60.0,20.0
34894,3,4894,[ 64 318 313 301  11],43,5,20860,4.261491317671093,60.0,20.0
34895,3,4895,[ 64 318 313 301  11],416,5,20865,4.261642156862745,60.0,20.0
34896,3,4896,[151  12 181 655 323],805,3,20868,4.261384521135389,20.0,20.0
34897,3,4897,[ 64 318 313 301  11],416,5,20873,4.261535320538996,60.0,20.0
34898,3,4898,[237 568 323 127  98],198,2,20875,4.261073688507858,0.0,20.0
34899,3,4899,[294  82 286 100 200],416,5,20880,4.261224489795918,0.0,0.0
34900,3,4900,[22 69 88 56  7],618,5,20885,4.261375229544991,0.0,0.0
34901,3,4901,[196 603   4 597 180],805,1,20886,4.260709914320685,0.0,0.0
34902,3,4902,[301 235 294 423 215],43,4,20890,4.260656740770957,0.0,0.0
34903,3,4903,[  1 405 181 100 168],417,2,20892,4.260195758564437,0.0,20.0
34904,3,4904,[174  56 127 300 237],505,2,20894,4.25973496432212,0.0,0.0
34905,3,4905,[ 69 288 194 175 322],721,4,20898,4.259682022013861,0.0,20.0
34906,3,4906,[ 64 318 313 301  11],416,5,20903,4.259832891787243,60.0,20.0
34907,3,4907,[258 271 603 301 508],297,4,20907,4.259779951100245,0.0,0.0
34908,3,4908,[302 328  82 111  28],43,5,20912,4.259930739458138,0.0,0.0
34909,3,4909,[ 64 318 313 301  11],345,5,20917,4.260081466395112,60.0,20.0
34910,3,4910,[ 64 318 313 301  11],345,5,20922,4.260232131948687,60.0,20.0
34911,3,4911,[  8 161 176 117  70],230,5,20927,4.260382736156352,0.0,0.0
34912,3,4912,[ 64 318 313 301  11],416,5,20932,4.260533279055567,60.0,20.0
34913,3,4913,[ 50 172 117 210 245],417,2,20934,4.26007326007326,0.0,20.0
34914,3,4914,[132 238 153 318 385],373,3,20937,4.259816887080366,20.0,0.0
34915,3,4915,[ 64 318 313 301  11],416,5,20942,4.259967453213995,60.0,20.0
34916,3,4916,[168 748 300  71 313],654,4,20946,4.259914582062233,20.0,20.0
34917,3,4917,[268  22 191  28  11],496,4,20950,4.259861732411549,0.0,0.0
34918,3,4918,[ 64 318 313 301  11],43,5,20955,4.260012197601139,60.0,20.0
34919,3,4919,[179 185 403 151 423],805,4,20959,4.259959349593496,0.0,0.0
34920,3,4920,[ 64 318 313 301  11],43,5,20964,4.260109733793945,60.0,20.0
34921,3,4921,[197 100 204 282 237],297,2,20966,4.259650548557497,0.0,0.0
34922,3,4922,[ 96 238 182  64 202],618,2,20968,4.259191549867967,20.0,0.0
34923,3,4923,[ 64 318 313 301  11],416,5,20973,4.259341998375304,60.0,20.0
34924,3,4924,[ 64 318 313 301  11],43,5,20978,4.259492385786802,60.0,20.0
34925,3,4925,[ 64 318 313 301  11],345,5,20983,4.259642712139667,60.0,20.0
34926,3,4926,[ 64 318 313 301  11],416,5,20988,4.259792977471077,60.0,20.0
34927,3,4927,[ 64 318 313 301  11],345,5,20993,4.259943181818182,60.0,20.0
34928,3,4928,[508 496 405 237 144],654,4,20997,4.259890444309191,0.0,0.0
34929,3,4929,[ 64 318 313 301  11],416,5,21002,4.260040567951318,60.0,20.0
34930,3,4930,[ 64 318 313 301  11],345,5,21007,4.260190630703711,60.0,20.0
34931,3,4931,[ 64 318 313 301  11],416,5,21012,4.260340632603406,60.0,20.0
34932,3,4932,[181 301 182  28 288],416,5,21017,4.260490573687411,0.0,40.0
34933,3,4933,[265 168 111 302  79],417,1,21018,4.259829752736117,0.0,0.0
34934,3,4934,[ 98 403 288 515 273],416,5,21023,4.259979736575481,0.0,40.0
34935,3,4935,[ 64 318 313 301  11],43,5,21028,4.260129659643436,60.0,20.0
34936,3,4936,[ 64 318 313 301  11],43,5,21033,4.260279521976909,60.0,20.0
34937,3,4937,[289 118   9 318  22],416,3,21036,4.260024301336574,20.0,0.0
34938,3,4938,[238 423  89 258 385],417,5,21041,4.260174124316663,0.0,0.0
34939,3,4939,[222 215 168 271 117],43,4,21045,4.260121457489879,0.0,0.0
34940,3,4940,[ 79  69 333 117 174],588,3,21048,4.25986642380085,0.0,0.0
34941,3,4941,[ 64 318 313 301  11],416,5,21053,4.260016187778228,60.0,20.0
34942,3,4942,[475 597 153 603 423],805,3,21056,4.2597612785757635,0.0,0.0
34943,3,4943,[286 181 100 151  28],588,4,21060,4.259708737864078,0.0,20.0
34944,3,4944,[117 222 172  70 508],62,4,21064,4.2596562184024265,0.0,0.0
34945,3,4945,[ 64 318 313 301  11],345,5,21069,4.259805903760615,60.0,20.0
34946,3,4946,[202 173 655 427 215],128,2,21071,4.259349100464928,0.0,0.0
34947,3,4947,[258 143  71  97 222],654,3,21074,4.25909458367017,0.0,0.0
34948,3,4948,[ 64 318 313 301  11],345,5,21079,4.259244291776116,60.0,20.0
34949,3,4949,[ 64 318 313 301  11],416,5,21084,4.25939393939394,60.0,20.0
34950,3,4950,[ 64 318 313 301  11],43,5,21089,4.259543526560291,60.0,20.0
34951,3,4951,[ 64 318 313 301  11],43,5,21094,4.259693053311794,60.0,20.0
34952,3,4952,[ 64 318 313 301  11],345,5,21099,4.25984251968504,60.0,20.0
34953,3,4953,[ 64 318 313 301  11],345,5,21104,4.259991925716593,60.0,20.0
34954,3,4954,[151 172 202 603  15],437,5,21109,4.260141271442987,0.0,0.0
34955,3,4955,[ 64 318 313 301  11],416,5,21114,4.260290556900727,60.0,20.0
34956,3,4956,[161 117 286   8   7],588,4,21118,4.260238047205972,0.0,0.0
34957,3,4957,[ 50 435  79  88 180],354,2,21120,4.259782170229931,0.0,20.0
34958,3,4958,[ 64 318 313 301  11],345,5,21125,4.259931437789877,60.0,20.0
34959,3,4959,[ 64 318 313 301  11],345,5,21130,4.26008064516129,60.0,20.0
34960,3,4960,[ 12 168  64 282  82],416,5,21135,4.260229792380568,40.0,0.0
34961,3,4961,[471 210 168 196   7],43,4,21139,4.260177347843611,0.0,0.0
34962,3,4962,[ 64 318 313 301  11],43,5,21144,4.260326415474512,60.0,20.0
34963,3,4963,[ 64 318 313 301  11],345,5,21149,4.26047542304593,60.0,20.0
34964,3,4964,[ 96 258 172  97 276],416,4,21153,4.260422960725076,0.0,0.0
34965,3,4965,[ 64 318 313 301  11],416,5,21158,4.26057188884414,60.0,20.0
34966,3,4966,[  8 172 268 302  22],654,4,21162,4.260519428226294,0.0,0.0
34967,3,4967,[197 313 423 100 288],416,5,21167,4.260668276972625,20.0,40.0
34968,3,4968,[ 64 318 313 301  11],43,5,21172,4.26081706580801,60.0,20.0
34969,3,4969,[200 423 496  69 132],416,5,21177,4.2609657947686115,0.0,0.0
34970,3,4970,[ 64 318 313 301  11],345,5,21182,4.261114463890565,60.0,20.0
34971,3,4971,[153 172 228 258 127],417,3,21185,4.260860820595334,0.0,0.0
34972,3,4972,[603 471 257 322 268],854,1,21186,4.260205107580937,0.0,0.0
34973,3,4973,[301 385  50 294 172],49,0,21186,4.25934861278649,0.0,20.0
34974,3,4974,[200 194   1 357 475],297,2,21188,4.258894472361809,0.0,0.0
34975,3,4975,[ 69 100  12 125 385],416,5,21193,4.259043408360129,20.0,0.0
34976,3,4976,[ 64 318 313 301  11],416,5,21198,4.25919228450874,60.0,20.0
34977,3,4977,[ 64 318 313 301  11],43,5,21203,4.259341100843712,60.0,20.0
34978,3,4978,[237 204 275 385 471],588,2,21205,4.258887326772444,0.0,0.0
34979,3,4979,[ 64 318 313 301  11],345,5,21210,4.259036144578313,60.0,20.0
34980,3,4980,[ 64 318 313 301  11],43,5,21215,4.259184902629994,60.0,20.0
34981,3,4981,[ 64 318 313 301  11],345,5,21220,4.259333600963468,60.0,20.0
34982,3,4982,[318  88  69 289 235],43,4,21224,4.259281557294802,20.0,0.0
34983,3,4983,[  4 151 161 210 200],618,2,21226,4.258828250401284,0.0,0.0
34984,3,4984,[ 64 318 313 301  11],43,5,21231,4.258976930792377,60.0,20.0
34985,3,4985,[ 64 318 313 301  11],43,5,21236,4.259125551544324,60.0,20.0
34986,3,4986,[288 181 301 471 196],721,4,21240,4.2590735913374775,0.0,40.0
34987,3,4987,[ 64 318 313 301  11],345,5,21245,4.259222133119486,60.0,20.0
34988,3,4988,[ 64 318 313 301  11],43,5,21250,4.259370615353778,60.0,20.0
34989,3,4989,[ 64 318 313 301  11],345,5,21255,4.259519038076152,60.0,20.0
34990,3,4990,[ 88 235 603 568 302],416,3,21258,4.2592666800240435,0.0,0.0
34991,3,4991,[258 151 245 322 275],907,5,21263,4.259415064102564,0.0,0.0
34992,3,4992,[ 64 318 313 301  11],43,5,21268,4.259563388744242,60.0,20.0
34993,3,4993,[471 173 127 678 588],416,4,21272,4.259511413696436,0.0,0.0
34994,3,4994,[ 64 318 313 301  11],345,5,21277,4.259659659659659,60.0,20.0
34995,3,4995,[ 64 318 313 301  11],43,5,21282,4.259807846277021,60.0,20.0
34996,3,4996,[ 64 318 313 301  11],43,5,21287,4.259955973584151,60.0,20.0
34997,3,4997,[ 64 318 313 301  11],43,5,21292,4.260104041616646,60.0,20.0
34998,3,4998,[210 238 655 144 195],373,4,21296,4.26005201040208,0.0,0.0
34999,3,4999,[471 182  25 258 197],128,3,21299,4.2598,0.0,0.0
35000,3,5000,[301 603 568 191 182],416,5,21304,4.25994801039792,0.0,0.0
35001,3,5001,[ 11 300   7  70 183],416,5,21309,4.260095961615354,0.0,0.0
35002,3,5002,[176  11 144 135 435],297,3,21312,4.259844093543873,0.0,0.0
35003,3,5003,[ 64 318 313 301  11],345,5,21317,4.259992006394884,60.0,20.0
35004,3,5004,[ 64 318 313 301  11],416,5,21322,4.26013986013986,60.0,20.0
35005,3,5005,[515 276 288 385 427],416,4,21326,4.260087894526568,0.0,20.0
35006,3,5006,[ 64 318 313 301  11],345,5,21331,4.260235670061913,60.0,20.0
35007,3,5007,[ 64 318 313 301  11],43,5,21336,4.26038338658147,60.0,20.0
35008,3,5008,[ 64 318 313 301  11],43,5,21341,4.260531044120583,60.0,20.0
35009,3,5009,[515 127 403 121 597],417,3,21344,4.260279441117764,0.0,0.0
35010,3,5010,[ 64 318 313 301  11],416,5,21349,4.260427060466973,60.0,20.0
35011,3,5011,[135 216  95 483  79],711,5,21354,4.260574620909816,20.0,0.0
35012,3,5012,[215  79  15  28 182],618,4,21358,4.260522641133054,0.0,0.0
35013,3,5013,[ 12  79  95   7 181],43,5,21363,4.260670123653769,20.0,20.0
35014,3,5014,[ 64 318 313 301  11],345,5,21368,4.260817547357926,60.0,20.0
35015,3,5015,[313 238 286 172 197],416,5,21373,4.260964912280702,20.0,20.0
35016,3,5016,[302 328 118   4 186],43,4,21377,4.260912896153079,0.0,0.0
35017,3,5017,[ 64 318 313 301  11],345,5,21382,4.261060183339976,60.0,20.0
35018,3,5018,[ 64 318 313 301  11],43,5,21387,4.261207411835027,60.0,20.0
35019,3,5019,[  8  82 179 323  96],416,3,21390,4.260956175298805,0.0,0.0
35020,3,5020,[ 64 318 313 301  11],43,5,21395,4.261103365863374,60.0,20.0
35021,3,5021,[117 742 210 258 173],805,1,21396,4.260454002389486,0.0,0.0
35022,3,5022,[143  28  89 168 181],642,4,21400,4.260402150109496,0.0,20.0
35023,3,5023,[ 64 318 313 301  11],345,5,21405,4.260549363057325,60.0,20.0
35024,3,5024,[ 64 318 313 301  11],345,5,21410,4.260696517412935,60.0,20.0
35025,3,5025,[ 64 318 313 301  11],416,5,21415,4.260843613211302,60.0,20.0
35026,3,5026,[ 64 318 313 301  11],345,5,21420,4.2609906504873685,60.0,20.0
35027,3,5027,[ 64 318 313 301  11],345,5,21425,4.261137629276054,60.0,20.0
35028,3,5028,[ 64 318 313 301  11],416,5,21430,4.261284549612249,60.0,20.0
35029,3,5029,[275 182 153 742 288],297,2,21432,4.260834990059642,0.0,20.0
35030,3,5030,[ 64 318 313 301  11],43,5,21437,4.260981912144703,60.0,20.0
35031,3,5031,[ 64 318 313 301  11],43,5,21442,4.261128775834658,60.0,20.0
35032,3,5032,[ 50 143  71 151 211],43,5,21447,4.261275581164315,0.0,20.0
35033,3,5033,[118 202 748  97 435],297,1,21448,4.260627731426301,0.0,0.0
35034,3,5034,[ 64 318 313 301  11],43,5,21453,4.26077457795432,60.0,20.0
35035,3,5035,[211 196 200   8 132],405,2,21455,4.26032565528197,0.0,0.0
35036,3,5036,[ 64 318 313 301  11],416,5,21460,4.26047250347429,60.0,20.0
35037,3,5037,[423 125 271 245  71],505,4,21464,4.260420801905518,0.0,0.0
35038,3,5038,[ 64 318 313 301  11],416,5,21469,4.260567572931137,60.0,20.0
35039,3,5039,[ 64 318 313 301  11],43,5,21474,4.260714285714286,60.0,20.0
35040,3,5040,[ 64 318 313 301  11],345,5,21479,4.260860940289625,60.0,20.0
35041,3,5041,[ 64 318 313 301  11],43,5,21484,4.261007536691789,60.0,20.0
35042,3,5042,[ 64 318 313 301  11],345,5,21489,4.261154074955384,60.0,20.0
35043,3,5043,[ 64 318 313 301  11],416,5,21494,4.261300555114988,60.0,20.0
35044,3,5044,[ 64 318 313 301  11],43,5,21499,4.2614469772051535,60.0,20.0
35045,3,5045,[ 64 318 313 301  11],345,5,21504,4.261593341260404,60.0,20.0
35046,3,5046,[588 182 135 403  88],405,2,21506,4.261145234792946,0.0,0.0
35047,3,5047,[ 64 318 313 301  11],416,5,21511,4.261291600633914,60.0,20.0
35048,3,5048,[ 64 318 313 301  11],43,5,21516,4.261437908496732,60.0,20.0
35049,3,5049,[ 64 318 313 301  11],345,5,21521,4.261584158415841,60.0,20.0
35050,3,5050,[174 216 328 276   7],62,4,21525,4.261532369827757,0.0,0.0
35051,3,5051,[ 64 318 313 301  11],416,5,21530,4.261678543151227,60.0,20.0
35052,3,5052,[ 64 318 313 301  11],416,5,21535,4.261824658618642,60.0,20.0
35053,3,5053,[100 289 215 273 302],416,4,21539,4.261772853185596,0.0,0.0
35054,3,5054,[ 64 318 313 301  11],416,5,21544,4.261918892185954,60.0,20.0
35055,3,5055,[282   8 289 237 132],588,3,21547,4.2616693037974684,0.0,0.0
35056,3,5056,[ 64 318 313 301  11],43,5,21552,4.261815305517105,60.0,20.0
35057,3,5057,[ 64 318 313 301  11],416,5,21557,4.261961249505734,60.0,20.0
35058,3,5058,[483  95 132 237 144],342,5,21562,4.262107135797589,20.0,0.0
35059,3,5059,[ 64 318 313 301  11],43,5,21567,4.262252964426877,60.0,20.0
35060,3,5060,[ 64 318 313 301  11],416,5,21572,4.262398735427781,60.0,20.0
35061,3,5061,[ 79 435  25 483  89],354,3,21575,4.262149348083762,20.0,0.0
35062,3,5062,[ 64 318 313 301  11],43,5,21580,4.262295081967213,60.0,20.0
35063,3,5063,[ 64 318 313 301  11],416,5,21585,4.262440758293839,60.0,20.0
35064,3,5064,[ 64 318 313 301  11],345,5,21590,4.26258637709773,60.0,20.0
35065,3,5065,[568 301 678 211 269],416,4,21594,4.2625345440189495,0.0,0.0
35066,3,5066,[153 302 144  98  79],43,5,21599,4.262680086836393,0.0,20.0
35067,3,5067,[ 64 318 313 301  11],345,5,21604,4.262825572217837,60.0,20.0
35068,3,5068,[ 64 318 313 301  11],43,5,21609,4.262971000197277,60.0,20.0
35069,3,5069,[ 64 318 313 301  11],416,5,21614,4.263116370808678,60.0,20.0
35070,3,5070,[ 64 318 313 301  11],416,5,21619,4.263261684085979,60.0,20.0
35071,3,5071,[ 64 318 313 301  11],416,5,21624,4.263406940063091,60.0,20.0
35072,3,5072,[ 64 318 313 301  11],345,5,21629,4.263552138773901,60.0,20.0
35073,3,5073,[423 111 173 143 117],223,4,21633,4.263500197083169,0.0,0.0
35074,3,5074,[ 64 318 313 301  11],43,5,21638,4.263645320197044,60.0,20.0
35075,3,5075,[ 82 187 186  95 385],198,2,21640,4.263199369582348,0.0,0.0
35076,3,5076,[216 197 508 181 202],128,4,21644,4.263147528067757,0.0,20.0
35077,3,5077,[258 471 175   9 117],43,3,21647,4.262898779046869,0.0,0.0
35078,3,5078,[294  69 475  70  96],62,3,21650,4.262650127977948,0.0,0.0
35079,3,5079,[ 64 318 313 301  11],345,5,21655,4.262795275590551,60.0,20.0
35080,3,5080,[181 143  71   4 678],805,1,21656,4.2621531194646725,0.0,20.0
35081,3,5081,[ 71  98 127 204  95],405,3,21659,4.261904761904762,0.0,20.0
35082,3,5082,[ 64 318 313 301  11],43,5,21664,4.262049970489868,60.0,20.0
35083,3,5083,[ 64 318 313 301  11],345,5,21669,4.262195121951219,60.0,20.0
35084,3,5084,[ 64 318 313 301  11],43,5,21674,4.262340216322517,60.0,20.0
35085,3,5085,[ 64 318 313 301  11],345,5,21679,4.262485253637436,60.0,20.0
35086,3,5086,[ 64 318 313 301  11],416,5,21684,4.262630233929625,60.0,20.0
35087,3,5087,[423  12 268 186 204],588,4,21688,4.262578616352202,20.0,0.0
35088,3,5088,[ 64 318 313 301  11],345,5,21693,4.2627235213204955,60.0,20.0
35089,3,5089,[603 597 423 197 132],854,4,21697,4.262671905697446,0.0,0.0
35090,3,5090,[588  50 678  82  28],654,5,21702,4.262816735415439,0.0,20.0
35091,3,5091,[ 15 286 748 313  56],416,5,21707,4.262961508248233,20.0,20.0
35092,3,5092,[ 64 318 313 301  11],345,5,21712,4.263106224229334,60.0,20.0
35093,3,5093,[ 64 318 313 301  11],416,5,21717,4.263250883392226,60.0,20.0
35094,3,5094,[ 64 318 313 301  11],43,5,21722,4.2633954857703635,60.0,20.0
35095,3,5095,[151 238  89 127 153],417,5,21727,4.2635400313971745,0.0,0.0
35096,3,5096,[181 195 423  69 132],230,4,21731,4.263488326466549,0.0,20.0
35097,3,5097,[ 64 318 313 301  11],43,5,21736,4.2636327971753625,60.0,20.0
35098,3,5098,[ 64 318 313 301  11],416,5,21741,4.263777211217886,60.0,20.0
35099,3,5099,[ 64 318 313 301  11],43,5,21746,4.263921568627451,60.0,20.0
35100,3,5100,[ 64 318 313 301  11],345,5,21751,4.264065869437365,60.0,20.0
35101,3,5101,[ 64 318 313 301  11],43,5,21756,4.264210113680909,60.0,20.0
35102,3,5102,[174  82 508 228 151],128,2,21758,4.26376641191456,0.0,0.0
35103,3,5103,[ 64 318 313 301  11],43,5,21763,4.26391065830721,60.0,20.0
35104,3,5104,[ 64 318 313 301  11],416,5,21768,4.264054848188051,60.0,20.0
35105,3,5105,[ 64 318 313 301  11],416,5,21773,4.264198981590286,60.0,20.0
35106,3,5106,[195 215  70 173 234],437,2,21775,4.263755629528099,0.0,0.0
35107,3,5107,[ 64 318 313 301  11],43,5,21780,4.2638997650743935,60.0,20.0
35108,3,5108,[ 64 318 313 301  11],43,5,21785,4.264043844196516,60.0,20.0
35109,3,5109,[204 322 173 222 151],128,2,21787,4.263600782778865,0.0,0.0
35110,3,5110,[174 168 173   8 427],405,4,21791,4.26354920759147,0.0,0.0
35111,3,5111,[ 64 318 313 301  11],345,5,21796,4.263693270735525,60.0,20.0
35112,3,5112,[ 64 318 313 301  11],416,5,21801,4.263837277527871,60.0,20.0
35113,3,5113,[385 100  95 742 121],416,4,21805,4.263785686351193,0.0,0.0
35114,3,5114,[ 64 318 313 301  11],416,5,21810,4.263929618768328,60.0,20.0
35115,3,5115,[100  11   8 111 258],297,4,21814,4.263878029710711,0.0,0.0
35116,3,5116,[  9 289 121 508 258],854,3,21817,4.263631033808872,0.0,0.0
35117,3,5117,[294 182 196 603 172],214,3,21820,4.263384134427511,0.0,0.0
35118,3,5118,[ 98 588 222 204 168],711,3,21823,4.263137331510061,0.0,20.0
35119,3,5119,[ 64 318 313 301  11],43,5,21828,4.26328125,60.0,20.0
35120,3,5120,[ 64 318 313 301  11],43,5,21833,4.263425112282757,60.0,20.0
35121,3,5121,[ 64 318 313 301  11],43,5,21838,4.263568918391253,60.0,20.0
35122,3,5122,[288 228 172 127 427],405,4,21842,4.263517470232285,0.0,20.0
35123,3,5123,[ 64 318 313 301  11],416,5,21847,4.2636612021857925,60.0,20.0
35124,3,5124,[ 64 318 313 301  11],345,5,21852,4.263804878048781,60.0,20.0
35125,3,5125,[405 258 202  95   9],43,5,21857,4.263948497854077,0.0,0.0
35126,3,5126,[121 403 568 385 328],416,5,21862,4.264092061634484,0.0,0.0
35127,3,5127,[ 98 176 237  97 405],198,2,21864,4.263650546021841,0.0,20.0
35128,3,5128,[ 64 318 313 301  11],416,5,21869,4.263794111912653,60.0,20.0
35129,3,5129,[ 64 318 313 301  11],43,5,21874,4.263937621832358,60.0,20.0
35130,3,5130,[ 25   8  98 179 181],805,3,21877,4.263691288247905,0.0,40.0
35131,3,5131,[187  95 127 748 204],416,4,21881,4.263639906469213,0.0,0.0
35132,3,5132,[173 258 603 742 168],128,3,21884,4.263393726865381,0.0,0.0
35133,3,5133,[197 175 655 153 111],342,4,21888,4.26334242306194,0.0,0.0
35134,3,5134,[ 64 318 313 301  11],416,5,21893,4.263485881207401,60.0,20.0
35135,3,5135,[ 64 318 313 301  11],43,5,21898,4.263629283489097,60.0,20.0
35136,3,5136,[ 64 318 313 301  11],416,5,21903,4.263772629939654,60.0,20.0
35137,3,5137,[ 64 318 313 301  11],345,5,21908,4.26391592059167,60.0,20.0
35138,3,5138,[ 64 318 313 301  11],345,5,21913,4.264059155477719,60.0,20.0
35139,3,5139,[173 238 546 323 258],805,3,21916,4.263813229571984,0.0,0.0
35140,3,5140,[ 64 318 313 301  11],416,5,21921,4.263956428710368,60.0,20.0
35141,3,5141,[191 322 423 475 153],854,4,21925,4.26390509529366,0.0,0.0
35142,3,5142,[ 64 318 313 301  11],416,5,21930,4.264048220882753,60.0,20.0
35143,3,5143,[483   4 127 748  64],417,4,21934,4.263996889580094,40.0,0.0
35144,3,5144,[ 64 318 313 301  11],43,5,21939,4.264139941690962,60.0,20.0
35145,3,5145,[172 174 176 118 196],62,4,21943,4.264088612514574,0.0,0.0
35146,3,5146,[172 100 191 237 235],62,4,21947,4.264037303283466,0.0,0.0
35147,3,5147,[268  28 173 258 265],128,3,21950,4.2637917637917635,0.0,0.0
35148,3,5148,[ 97  79 357 237 183],416,4,21954,4.2637405321421635,0.0,0.0
35149,3,5149,[ 82 195  96 385  22],262,2,21956,4.263300970873787,0.0,0.0
35150,3,5150,[ 64 318 313 301  11],416,5,21961,4.26344399145797,60.0,20.0
35151,3,5151,[ 12 197 204  70  28],416,5,21966,4.263586956521739,20.0,0.0
35152,3,5152,[ 64 318 313 301  11],43,5,21971,4.263729866097419,60.0,20.0
35153,3,5153,[180 143 100 515 286],354,3,21974,4.263484672099341,0.0,0.0
35154,3,5154,[ 79 568 276 318 222],198,1,21975,4.262851600387973,20.0,0.0
35155,3,5155,[ 64 318 313 301  11],43,5,21980,4.26299456943367,60.0,20.0
35156,3,5156,[204  64  71 234 238],405,4,21984,4.262943571844096,20.0,0.0
35157,3,5157,[508 322 588 742 186],128,3,21987,4.262698720434277,0.0,0.0
35158,3,5158,[603 216 210 118 238],805,2,21989,4.26226012793177,0.0,0.0
35159,3,5159,[ 64 318 313 301  11],345,5,21994,4.2624031007751935,60.0,20.0
35160,3,5160,[ 64 318 313 301  11],43,5,21999,4.262546018213524,60.0,20.0
35161,3,5161,[ 64 318 313 301  11],416,5,22004,4.2626888802789615,60.0,20.0
35162,3,5162,[ 64 318 313 301  11],43,5,22009,4.26283168700368,60.0,20.0
35163,3,5163,[168 273 172  25 475],416,4,22013,4.2627807900852055,0.0,0.0
35164,3,5164,[ 64 318 313 301  11],345,5,22018,4.262923523717328,60.0,20.0
35165,3,5165,[135 265 195 216 475],437,2,22020,4.262485481997677,0.0,0.0
35166,3,5166,[ 64 318 313 301  11],43,5,22025,4.262628217534353,60.0,20.0
35167,3,5167,[ 64 318 313 301  11],416,5,22030,4.262770897832818,60.0,20.0
35168,3,5168,[289 257 185  70 357],416,3,22033,4.26252660088992,0.0,0.0
35169,3,5169,[234  12  70 183 202],405,3,22036,4.262282398452611,20.0,0.0
35170,3,5170,[168 588 603 265 195],437,1,22037,4.261651518081609,0.0,0.0
35171,3,5171,[ 64 318 313 301  11],416,5,22042,4.2617942768754835,60.0,20.0
35172,3,5172,[ 64 318 313 301  11],416,5,22047,4.2619369804755465,60.0,20.0
35173,3,5173,[ 64 318 313 301  11],345,5,22052,4.2620796289138,60.0,20.0
35174,3,5174,[322 568  12 127  56],416,4,22056,4.262028985507246,20.0,0.0
35175,3,5175,[ 64 318 313 301  11],345,5,22061,4.262171561051004,60.0,20.0
35176,3,5176,[ 98 268 179 168   7],49,4,22065,4.262120919451419,0.0,20.0
35177,3,5177,[ 15 294 118 276 288],601,1,22066,4.261490923136346,0.0,20.0
35178,3,5178,[ 64 318 313 301  11],345,5,22071,4.261633519984553,60.0,20.0
35179,3,5179,[173   9 181 191  50],43,5,22076,4.261776061776062,0.0,40.0
35180,3,5180,[132  15 125 191 603],416,5,22081,4.261918548542752,0.0,0.0
35181,3,5181,[ 64 318 313 301  11],345,5,22086,4.26206098031648,60.0,20.0
35182,3,5182,[282 323 125 603  15],416,4,22090,4.262010418676442,0.0,0.0
35183,3,5183,[  8  56  11 323 403],416,4,22094,4.26195987654321,0.0,0.0
35184,3,5184,[ 64 318 313 301  11],345,5,22099,4.262102217936355,60.0,20.0
35185,3,5185,[ 98 194  28 265 204],297,2,22101,4.261666023910529,0.0,20.0
35186,3,5186,[ 28 143  95 117 568],588,5,22106,4.2618083670715246,0.0,0.0
35187,3,5187,[144 515 100 322 385],416,4,22110,4.261757902852737,0.0,0.0
35188,3,5188,[ 64 318 313 301  11],345,5,22115,4.2619001734438235,60.0,20.0
35189,3,5189,[ 64 318 313 301  11],43,5,22120,4.262042389210019,60.0,20.0
35190,3,5190,[ 64 318 313 301  11],416,5,22125,4.262184550183009,60.0,20.0
35191,3,5191,[ 64 318 313 301  11],345,5,22130,4.262326656394453,60.0,20.0
35192,3,5192,[ 64 318 313 301  11],345,5,22135,4.262468707875987,60.0,20.0
35193,3,5193,[ 64 318 313 301  11],416,5,22140,4.262610704659222,60.0,20.0
35194,3,5194,[ 64 318 313 301  11],43,5,22145,4.262752646775746,60.0,20.0
35195,3,5195,[265 333 328  79  96],416,5,22150,4.2628945342571205,0.0,0.0
35196,3,5196,[ 64 318 313 301  11],345,5,22155,4.263036367134886,60.0,20.0
35197,3,5197,[742 273 100 118 258],630,3,22158,4.262793382070027,0.0,0.0
35198,3,5198,[ 56 235 179 475  97],417,4,22162,4.262742835160608,0.0,0.0
35199,3,5199,[ 64 318 313 301  11],43,5,22167,4.262884615384616,60.0,20.0
35200,3,5200,[ 64 318 313 301  11],43,5,22172,4.263026341088252,60.0,20.0
35201,3,5201,[ 64 318 313 301  11],345,5,22177,4.263168012302961,60.0,20.0
35202,3,5202,[ 64 318 313 301  11],43,5,22182,4.263309629060157,60.0,20.0
35203,3,5203,[ 88 300 588 385 237],416,3,22185,4.263066871637202,0.0,0.0
35204,3,5204,[ 64 318 313 301  11],43,5,22190,4.263208453410183,60.0,20.0
35205,3,5205,[603  79 289 288 268],854,3,22193,4.2629658086822895,0.0,20.0
35206,3,5206,[ 64 318 313 301  11],43,5,22198,4.263107355483004,60.0,20.0
35207,3,5207,[ 64 318 313 301  11],345,5,22203,4.263248847926267,60.0,20.0
35208,3,5208,[568 195 268 210 265],416,5,22208,4.2633902860433865,0.0,0.0
35209,3,5209,[ 64 318 313 301  11],345,5,22213,4.263531669865643,60.0,20.0
35210,3,5210,[ 64 318 313 301  11],43,5,22218,4.263672999424295,60.0,20.0
35211,3,5211,[403  82  95 318  50],711,4,22222,4.263622409823484,20.0,20.0
35212,3,5212,[ 64 318 313 301  11],416,5,22227,4.263763667753692,60.0,20.0
35213,3,5213,[ 64 318 313 301  11],416,5,22232,4.2639048714998085,60.0,20.0
35214,3,5214,[300 127 143  15  82],43,5,22237,4.264046021093001,0.0,0.0
35215,3,5215,[  1  71 238 174   7],198,4,22241,4.263995398773006,0.0,0.0
35216,3,5216,[ 64 318 313 301  11],416,5,22246,4.264136476902435,60.0,20.0
35217,3,5217,[ 64 318 313 301  11],345,5,22251,4.2642775009582214,60.0,20.0
35218,3,5218,[ 64 318 313 301  11],43,5,22256,4.26441847097145,60.0,20.0
35219,3,5219,[ 64 318 313 301  11],416,5,22261,4.26455938697318,60.0,20.0
35220,3,5220,[ 64 318 313 301  11],43,5,22266,4.264700248994446,60.0,20.0
35221,3,5221,[175 121 168 151 187],198,3,22269,4.264458062045193,0.0,0.0
35222,3,5222,[ 64 318 313 301  11],416,5,22274,4.264598889527091,60.0,20.0
35223,3,5223,[ 64 318 313 301  11],345,5,22279,4.264739663093415,60.0,20.0
35224,3,5224,[ 64 318 313 301  11],416,5,22284,4.26488038277512,60.0,20.0
35225,3,5225,[423 211 210   1 245],416,4,22288,4.264829697665519,0.0,0.0
35226,3,5226,[427 603 143 222  89],698,3,22291,4.26458771762005,0.0,0.0
35227,3,5227,[ 64 318 313 301  11],345,5,22296,4.264728385615914,60.0,20.0
35228,3,5228,[ 50  82 269 286  98],711,4,22300,4.264677758653662,0.0,40.0
35229,3,5229,[ 71 174  96 318   1],705,5,22305,4.264818355640536,20.0,0.0
35230,3,5230,[ 64 318 313 301  11],416,5,22310,4.264958898872108,60.0,20.0
35231,3,5231,[655 748 318 427 403],198,4,22314,4.264908256880734,20.0,0.0
35232,3,5232,[161 655 385 568 175],373,3,22317,4.264666539270017,0.0,0.0
35233,3,5233,[ 64 318 313 301  11],345,5,22322,4.264807030951471,60.0,20.0
35234,3,5234,[ 82  98  70 496  15],437,3,22325,4.264565425023878,0.0,20.0
35235,3,5235,[ 64 318 313 301  11],416,5,22330,4.264705882352941,60.0,20.0
35236,3,5236,[ 64 318 313 301  11],416,5,22335,4.264846286041627,60.0,20.0
35237,3,5237,[ 64 318 313 301  11],43,5,22340,4.264986636120657,60.0,20.0
35238,3,5238,[ 64 318 313 301  11],43,5,22345,4.2651269326207295,60.0,20.0
35239,3,5239,[294 323  56 125 286],417,4,22349,4.265076335877863,0.0,0.0
35240,3,5240,[ 64 318 313 301  11],345,5,22354,4.265216561724862,60.0,20.0
35241,3,5241,[ 64 318 313 301  11],43,5,22359,4.2653567340709655,60.0,20.0
35242,3,5242,[121  11 475 258 288],805,1,22360,4.264733930955559,0.0,20.0
35243,3,5243,[385   9  98 183 143],887,2,22362,4.2643020594965675,0.0,20.0
35244,3,5244,[194  22  79 288 603],416,5,22367,4.264442326024786,0.0,20.0
35245,3,5245,[405 117 111 179 181],417,2,22369,4.264010674799848,0.0,20.0
35246,3,5246,[ 64 318 313 301  11],345,5,22374,4.264150943396227,60.0,20.0
35247,3,5247,[423  71 275 196  25],128,4,22378,4.264100609756097,0.0,0.0
35248,3,5248,[273   7 258  56 597],416,4,22382,4.264050295294342,0.0,0.0
35249,3,5249,[ 64 318 313 301  11],416,5,22387,4.2641904761904765,60.0,20.0
35250,3,5250,[ 64 318 313 301  11],416,5,22392,4.2643306036945345,60.0,20.0
35251,3,5251,[ 64 318 313 301  11],345,5,22397,4.264470677837014,60.0,20.0
35252,3,5252,[197 111 121 196 403],711,3,22400,4.264229963830192,0.0,0.0
35253,3,5253,[ 64 318 313 301  11],416,5,22405,4.264370003806624,60.0,20.0
35254,3,5254,[ 50 323 161 183 216],198,3,22408,4.2641294005708845,0.0,20.0
35255,3,5255,[ 64 318 313 301  11],416,5,22413,4.264269406392694,60.0,20.0
35256,3,5256,[ 64 318 313 301  11],416,5,22418,4.264409358949972,60.0,20.0
35257,3,5257,[ 64 318 313 301  11],345,5,22423,4.2645492582731075,60.0,20.0
35258,3,5258,[ 64 318 313 301  11],43,5,22428,4.26468910439247,60.0,20.0
35259,3,5259,[  1 245 323  11 276],416,2,22430,4.26425855513308,0.0,0.0
35260,3,5260,[ 64 318 313 301  11],43,5,22435,4.264398403345371,60.0,20.0
35261,3,5261,[ 64 318 313 301  11],416,5,22440,4.264538198403649,60.0,20.0
35262,3,5262,[195 173 286 235 423],62,3,22443,4.264297928937868,0.0,0.0
35263,3,5263,[ 64 318 313 301  11],416,5,22448,4.264437689969605,60.0,20.0
35264,3,5264,[ 64 318 313 301  11],416,5,22453,4.264577397910731,60.0,20.0
35265,3,5265,[173 471 222 185  98],297,4,22457,4.264527155336118,0.0,20.0
35266,3,5266,[ 28 546 196 183 269],805,2,22459,4.264097209037403,0.0,0.0
35267,3,5267,[ 64 318 313 301  11],416,5,22464,4.264236902050114,60.0,20.0
35268,3,5268,[ 64 318 313 301  11],345,5,22469,4.264376542038337,60.0,20.0
35269,3,5269,[435 322 216  28  70],721,4,22473,4.264326375711575,0.0,0.0
35270,3,5270,[ 88 265 235 288 323],416,2,22475,4.263896793777272,0.0,20.0
35271,3,5271,[ 64 318 313 301  11],416,5,22480,4.264036418816389,60.0,20.0
35272,3,5272,[328 237 144 245 568],416,3,22483,4.263796700170681,0.0,0.0
35273,3,5273,[ 64 318 313 301  11],43,5,22488,4.263936291240046,60.0,20.0
35274,3,5274,[ 64 318 313 301  11],43,5,22493,4.264075829383886,60.0,20.0
35275,3,5275,[191 215 125  98 153],416,5,22498,4.264215314632297,0.0,20.0
35276,3,5276,[ 64 318 313 301  11],416,5,22503,4.26435474701535,60.0,20.0
35277,3,5277,[ 98 151 117  50  28],437,3,22506,4.264115195149678,0.0,40.0
35278,3,5278,[ 64 318 313 301  11],345,5,22511,4.264254593673044,60.0,20.0
35279,3,5279,[ 64 318 313 301  11],43,5,22516,4.26439393939394,60.0,20.0
35280,3,5280,[  8 300 282 187 257],416,4,22520,4.264343874266237,0.0,0.0
35281,3,5281,[ 64 318 313 301  11],43,5,22525,4.264483150321848,60.0,20.0
35282,3,5282,[ 64 318 313 301  11],345,5,22530,4.264622373651335,60.0,20.0
35283,3,5283,[ 64 318 313 301  11],345,5,22535,4.2647615442846325,60.0,20.0
35284,3,5284,[ 64 318 313 301  11],43,5,22540,4.264900662251655,60.0,20.0
35285,3,5285,[655 286  50 294 483],417,4,22544,4.264850548618994,20.0,20.0
35286,3,5286,[174 228 357 176 216],417,2,22546,4.264422167580859,0.0,0.0
35287,3,5287,[ 64 318 313 301  11],43,5,22551,4.264561270801815,60.0,20.0
35288,3,5288,[ 64 318 313 301  11],43,5,22556,4.264700321421818,60.0,20.0
35289,3,5289,[475   7 174 742 288],805,2,22558,4.264272211720227,0.0,20.0
35290,3,5290,[ 64 318 313 301  11],43,5,22563,4.264411264411264,60.0,20.0
35291,3,5291,[143 173  15  28 318],642,4,22567,4.264361300075586,20.0,0.0
35292,3,5292,[ 64 318 313 301  11],43,5,22572,4.2645002833931605,60.0,20.0
35293,3,5293,[ 64 318 313 301  11],345,5,22577,4.26463921420476,60.0,20.0
35294,3,5294,[191 471  82 265 173],618,3,22580,4.264400377714825,0.0,0.0
35295,3,5295,[ 64 318 313 301  11],43,5,22585,4.264539274924472,60.0,20.0
35296,3,5296,[ 64 318 313 301  11],416,5,22590,4.264678119690391,60.0,20.0
35297,3,5297,[ 64 237 655   9 301],345,5,22595,4.2648169120422805,20.0,0.0
35298,3,5298,[ 64 318 313 301  11],345,5,22600,4.264955652009813,60.0,20.0
35299,3,5299,[ 50 333  98 258   9],416,5,22605,4.2650943396226415,0.0,40.0
35300,3,5300,[ 64 318 313 301  11],416,5,22610,4.265232974910394,60.0,20.0
35301,3,5301,[546 238 496 175 323],43,2,22612,4.264805733685402,0.0,0.0
35302,3,5302,[ 64 318 313 301  11],43,5,22617,4.264944371110692,60.0,20.0
35303,3,5303,[ 79 357  64   1 181],416,5,22622,4.265082956259427,20.0,20.0
35304,3,5304,[ 64 318 313 301  11],43,5,22627,4.265221489161169,60.0,20.0
35305,3,5305,[ 64 318 313 301  11],416,5,22632,4.265359969845458,60.0,20.0
35306,3,5306,[ 64 318 313 301  11],416,5,22637,4.265498398341813,60.0,20.0
35307,3,5307,[ 64 318 313 301  11],416,5,22642,4.265636774679729,60.0,20.0
35308,3,5308,[ 64 318 313 301  11],43,5,22647,4.26577509888868,60.0,20.0
35309,3,5309,[385 144  64 127 191],416,5,22652,4.265913370998117,20.0,0.0
35310,3,5310,[288   4 385 191 127],405,4,22656,4.265863302579552,0.0,20.0
35311,3,5311,[ 64 318 313 301  11],416,5,22661,4.266001506024097,60.0,20.0
35312,3,5312,[  9 655 471 742 173],416,5,22666,4.266139657444005,0.0,0.0
35313,3,5313,[ 64 318 313 301  11],345,5,22671,4.266277756868649,60.0,20.0
35314,3,5314,[200 117 748 183 655],416,5,22676,4.266415804327376,0.0,0.0
35315,3,5315,[ 64 318 313 301  11],345,5,22681,4.266553799849511,60.0,20.0
35316,3,5316,[ 12 258 275  79 132],854,5,22686,4.266691743464359,20.0,0.0
35317,3,5317,[423  56 300 185 288],875,4,22690,4.2666415945844305,0.0,20.0
35318,3,5318,[ 64 318 313 301  11],345,5,22695,4.266779469825155,60.0,20.0
35319,3,5319,[ 64 318 313 301  11],345,5,22700,4.2669172932330826,60.0,20.0
35320,3,5320,[135 144 153 121 182],417,2,22702,4.266491261041158,0.0,0.0
35321,3,5321,[172 742 216 237  79],128,3,22705,4.266253288237505,0.0,0.0
35322,3,5322,[ 64 318 313 301  11],345,5,22710,4.266391132819838,60.0,20.0
35323,3,5323,[183 655 179 238  11],805,3,22713,4.266153268219384,0.0,0.0
35324,3,5324,[ 64 318 313 301  11],416,5,22718,4.2662910798122065,60.0,20.0
35325,3,5325,[ 64 318 313 301  11],416,5,22723,4.266428839654525,60.0,20.0
35326,3,5326,[ 69 301 302 111  56],345,5,22728,4.266566547775484,0.0,0.0
35327,3,5327,[286  25 323 322 546],223,2,22730,4.266141141141141,0.0,0.0
35328,3,5328,[597  96 748 183  88],805,2,22732,4.265715894164008,0.0,0.0
35329,3,5329,[ 64 318 313 301  11],345,5,22737,4.265853658536585,60.0,20.0
35330,3,5330,[ 64 318 313 301  11],345,5,22742,4.265991371224911,60.0,20.0
35331,3,5331,[ 64 318 313 301  11],43,5,22747,4.266129032258065,60.0,20.0
35332,3,5332,[423 211 286 427 237],416,4,22751,4.266079129945622,0.0,0.0
35333,3,5333,[210 597 121 191 161],705,4,22755,4.266029246344207,0.0,0.0
35334,3,5334,[ 64 318 313 301  11],43,5,22760,4.266166822867854,60.0,20.0
35335,3,5335,[195 597  64 216   8],854,2,22762,4.265742128935532,20.0,0.0
35336,3,5336,[ 64 318 313 301  11],416,5,22767,4.265879707700956,60.0,20.0
35337,3,5337,[ 64 318 313 301  11],416,5,22772,4.266017234919445,60.0,20.0
35338,3,5338,[ 64 318 313 301  11],43,5,22777,4.266154710619967,60.0,20.0
35339,3,5339,[ 64 318 313 301  11],345,5,22782,4.266292134831461,60.0,20.0
35340,3,5340,[238 496 185 135 222],354,1,22783,4.265680584160269,0.0,0.0
35341,3,5341,[ 64 318 313 301  11],43,5,22788,4.265818045675777,60.0,20.0
35342,3,5342,[ 95 121   8 118 216],618,1,22789,4.265206812652068,0.0,0.0
35343,3,5343,[ 64 318 313 301  11],43,5,22794,4.265344311377246,60.0,20.0
35344,3,5344,[ 64 318 313 301  11],345,5,22799,4.265481758652947,60.0,20.0
35345,3,5345,[235 196 175 323 275],43,2,22801,4.265057987280209,0.0,0.0
35346,3,5346,[ 64 318 313 301  11],43,5,22806,4.265195436693473,60.0,20.0
35347,3,5347,[328  22  96 597   8],62,3,22809,4.264958863126402,0.0,0.0
35348,3,5348,[ 64 318 313 301  11],345,5,22814,4.265096279678445,60.0,20.0
35349,3,5349,[328 121 195 202 496],416,5,22819,4.265233644859813,0.0,0.0
35350,3,5350,[ 64 318 313 301  11],416,5,22824,4.265370958699308,60.0,20.0
35351,3,5351,[483 238 185 172 168],711,5,22829,4.26550822122571,20.0,0.0
35352,3,5352,[185  22 294   1 546],223,4,22833,4.265458621333831,0.0,0.0
35353,3,5353,[ 64 318 313 301  11],416,5,22838,4.265595816212178,60.0,20.0
35354,3,5354,[173 168 228 258 357],417,4,22842,4.265546218487395,0.0,0.0
35355,3,5355,[ 64 318 313 301  11],43,5,22847,4.265683345780433,60.0,20.0
35356,3,5356,[ 64 318 313 301  11],416,5,22852,4.265820421877916,60.0,20.0
35357,3,5357,[ 64 318 313 301  11],416,5,22857,4.26595744680851,60.0,20.0
35358,3,5358,[ 64 318 313 301  11],416,5,22862,4.266094420600858,60.0,20.0
35359,3,5359,[ 64 318 313 301  11],43,5,22867,4.266231343283582,60.0,20.0
35360,3,5360,[161 168  79  82 286],43,5,22872,4.266368214885283,0.0,0.0
35361,3,5361,[ 28 144 678  11 268],297,3,22875,4.266132040283476,0.0,0.0
35362,3,5362,[ 64 318 313 301  11],43,5,22880,4.266268879358568,60.0,20.0
35363,3,5363,[ 64 318 313 301  11],416,5,22885,4.2664056674123785,60.0,20.0
35364,3,5364,[742 328 405 276 678],708,1,22886,4.265796831314073,0.0,0.0
35365,3,5365,[ 64 318 313 301  11],416,5,22891,4.265933656354827,60.0,20.0
35366,3,5366,[ 64 318 313 301  11],416,5,22896,4.266070430408049,60.0,20.0
35367,3,5367,[ 64 318 313 301  11],416,5,22901,4.2662071535022354,60.0,20.0
35368,3,5368,[ 64 318 313 301  11],416,5,22906,4.266343825665859,60.0,20.0
35369,3,5369,[  7 151 286 289 173],416,3,22909,4.266108007448789,0.0,0.0
35370,3,5370,[ 64 318 313 301  11],43,5,22914,4.266244647179296,60.0,20.0
35371,3,5371,[ 64 318 313 301  11],43,5,22919,4.266381236038719,60.0,20.0
35372,3,5372,[ 64 318 313 301  11],43,5,22924,4.266517774055463,60.0,20.0
35373,3,5373,[742 127  97   8 748],416,5,22929,4.266654261257909,0.0,0.0
35374,3,5374,[ 11 173   9 268 161],345,4,22933,4.26660465116279,0.0,0.0
35375,3,5375,[194 238 496  96 153],416,5,22938,4.266741071428571,0.0,0.0
35376,3,5376,[ 64 318 313 301  11],345,5,22943,4.266877440952204,60.0,20.0
35377,3,5377,[742  98  56 173 132],128,2,22945,4.266455931573075,0.0,20.0
35378,3,5378,[ 64 318 313 301  11],416,5,22950,4.26659230340212,60.0,20.0
35379,3,5379,[ 64 318 313 301  11],345,5,22955,4.266728624535316,60.0,20.0
35380,3,5380,[ 64 318 313 301  11],345,5,22960,4.266864895000929,60.0,20.0
35381,3,5381,[ 64 318 313 301  11],416,5,22965,4.267001114827202,60.0,20.0
35382,3,5382,[168 100 597 125 175],854,3,22968,4.266765744008917,0.0,0.0
35383,3,5383,[ 64 318 313 301  11],345,5,22973,4.266901931649332,60.0,20.0
35384,3,5384,[257 117 423 222 180],417,3,22976,4.266666666666667,0.0,0.0
35385,3,5385,[471   1 301 237 318],43,4,22980,4.266617155588563,20.0,0.0
35386,3,5386,[ 50 238  96 111 655],751,2,22982,4.266196398737702,0.0,20.0
35387,3,5387,[257 748 197 302 294],416,4,22986,4.266146993318485,0.0,0.0
35388,3,5388,[176 118 215  56  28],437,1,22987,4.26554091668213,0.0,0.0
35389,3,5389,[ 64 318 313 301  11],416,5,22992,4.2656771799628945,60.0,20.0
35390,3,5390,[568 183 151 153 748],416,4,22996,4.2656278983491,0.0,0.0
35391,3,5391,[ 96  79 742 191  11],854,3,22999,4.265393175074184,0.0,0.0
35392,3,5392,[ 64 318 313 301  11],345,5,23004,4.265529389949935,60.0,20.0
35393,3,5393,[ 64 318 313 301  11],345,5,23009,4.2656655543196145,60.0,20.0
35394,3,5394,[ 64 318 313 301  11],345,5,23014,4.2658016682113065,60.0,20.0
35395,3,5395,[301 143 182 275  70],297,4,23018,4.265752409191994,0.0,0.0
35396,3,5396,[ 64 318 313 301  11],345,5,23023,4.265888456549935,60.0,20.0
35397,3,5397,[ 64 318 313 301  11],345,5,23028,4.266024453501297,60.0,20.0
35398,3,5398,[ 64 318 313 301  11],416,5,23033,4.266160400074088,60.0,20.0
35399,3,5399,[ 64 318 313 301  11],43,5,23038,4.2662962962962965,60.0,20.0
35400,3,5400,[ 64 318 313 301  11],43,5,23043,4.26643214219589,60.0,20.0
35401,3,5401,[ 64 318 313 301  11],416,5,23048,4.266567937800814,60.0,20.0
35402,3,5402,[ 64 318 313 301  11],345,5,23053,4.266703683138997,60.0,20.0
35403,3,5403,[294 357 597 176   7],62,3,23056,4.266469282013324,0.0,0.0
35404,3,5404,[182  79 181  96 172],907,5,23061,4.266604995374653,0.0,20.0
35405,3,5405,[ 64 318 313 301  11],43,5,23066,4.266740658527562,60.0,20.0
35406,3,5406,[ 64 318 313 301  11],43,5,23071,4.266876271499908,60.0,20.0
35407,3,5407,[ 64 318 313 301  11],416,5,23076,4.2670118343195265,60.0,20.0
35408,3,5408,[475   8 333  56   9],854,4,23080,4.266962469957479,0.0,0.0
35409,3,5409,[ 64 318 313 301  11],345,5,23085,4.267097966728281,60.0,20.0
35410,3,5410,[ 64 318 313 301  11],345,5,23090,4.267233413417113,60.0,20.0
35411,3,5411,[ 95 228 175 127 117],373,3,23093,4.2669992609017,0.0,0.0
35412,3,5412,[ 71 143 215 200 100],416,5,23098,4.267134675780528,0.0,0.0
35413,3,5413,[ 64 318 313 301  11],43,5,23103,4.26727004063539,60.0,20.0
35414,3,5414,[ 64 318 313 301  11],416,5,23108,4.267405355493998,60.0,20.0
35415,3,5415,[ 64 318 313 301  11],43,5,23113,4.267540620384048,60.0,20.0
35416,3,5416,[ 64 318 313 301  11],345,5,23118,4.26767583533321,60.0,20.0
35417,3,5417,[228 197 271 111 235],805,1,23119,4.267072720561092,0.0,0.0
35418,3,5418,[ 64 318 313 301  11],345,5,23124,4.267207971950544,60.0,20.0
35419,3,5419,[ 64 318 313 301  11],345,5,23129,4.267343173431734,60.0,20.0
35420,3,5420,[ 64 318 313 301  11],345,5,23134,4.267478325032282,60.0,20.0
35421,3,5421,[ 64 318 313 301  11],43,5,23139,4.2676134267797865,60.0,20.0
35422,3,5422,[ 64 318 313 301  11],43,5,23144,4.267748478701826,60.0,20.0
35423,3,5423,[357 238 385  56 182],416,5,23149,4.267883480825959,0.0,0.0
35424,3,5424,[ 64 318 313 301  11],345,5,23154,4.268018433179724,60.0,20.0
35425,3,5425,[ 64 318 313 301  11],345,5,23159,4.268153335790638,60.0,20.0
35426,3,5426,[ 64 318 313 301  11],416,5,23164,4.268288188686198,60.0,20.0
35427,3,5427,[ 64 318 313 301  11],416,5,23169,4.268422991893884,60.0,20.0
35428,3,5428,[508 132 180 302 174],854,3,23172,4.268189353472095,0.0,0.0
35429,3,5429,[200 234   4 288 427],618,3,23175,4.267955801104972,0.0,20.0
35430,3,5430,[ 64 318 313 301  11],43,5,23180,4.268090591051371,60.0,20.0
35431,3,5431,[313 144  22 234  70],416,5,23185,4.268225331369662,20.0,20.0
35432,3,5432,[ 64 318 313 301  11],416,5,23190,4.268360022087244,60.0,20.0
35433,3,5433,[ 64 318 313 301  11],43,5,23195,4.268494663231506,60.0,20.0
35434,3,5434,[ 69 210 187 427 117],198,4,23199,4.268445262189513,0.0,0.0
35435,3,5435,[ 64 318 313 301  11],43,5,23204,4.268579838116262,60.0,20.0
35436,3,5436,[121 161 546  82   8],43,5,23209,4.268714364539268,0.0,0.0
35437,3,5437,[ 64 318 313 301  11],416,5,23214,4.26884884148584,60.0,20.0
35438,3,5438,[ 64 318 313 301  11],43,5,23219,4.268983268983269,60.0,20.0
35439,3,5439,[471 603   7 286 475],854,3,23222,4.26875,0.0,0.0
35440,3,5440,[ 64 318 313 301  11],345,5,23227,4.268884396250689,60.0,20.0
35441,3,5441,[183 313  71 144 588],416,5,23232,4.269018743109151,20.0,20.0
35442,3,5442,[118 546 282 289  56],416,2,23234,4.2686018739665625,0.0,0.0
35443,3,5443,[ 64 318 313 301  11],345,5,23239,4.268736223365173,60.0,20.0
35444,3,5444,[ 64 318 313 301  11],43,5,23244,4.268870523415978,60.0,20.0
35445,3,5445,[ 64 318 313 301  11],43,5,23249,4.269004774146162,60.0,20.0
35446,3,5446,[ 64 318 313 301  11],345,5,23254,4.26913897558289,60.0,20.0
35447,3,5447,[ 98 181 475 302 191],417,3,23257,4.268906020558003,0.0,40.0
35448,3,5448,[ 64 318 313 301  11],43,5,23262,4.269040190860708,60.0,20.0
35449,3,5449,[ 64 318 313 301  11],43,5,23267,4.269174311926606,60.0,20.0
35450,3,5450,[196  50 182 127 195],417,4,23271,4.269124931205283,0.0,20.0
35451,3,5451,[ 64 318 313 301  11],416,5,23276,4.269258987527513,60.0,20.0
35452,3,5452,[ 64 318 313 301  11],345,5,23281,4.2693929946818265,60.0,20.0
35453,3,5453,[568 183  97 300 328],416,5,23286,4.269526952695269,0.0,0.0
35454,3,5454,[ 64 318 313 301  11],345,5,23291,4.2696608615948675,60.0,20.0
35455,3,5455,[ 96 483  98  64  82],253,4,23295,4.2696114369501466,40.0,20.0
35456,3,5456,[ 64 318 313 301  11],416,5,23300,4.269745281290086,60.0,20.0
35457,3,5457,[ 22 216 678 258 742],588,4,23304,4.269695859289117,0.0,0.0
35458,3,5458,[471 286 153  22 216],297,4,23308,4.269646455394761,0.0,0.0
35459,3,5459,[ 64 318 313 301  11],43,5,23313,4.26978021978022,60.0,20.0
35460,3,5460,[ 64 318 313 301  11],43,5,23318,4.2699139351767075,60.0,20.0
35461,3,5461,[496 195  82 100 121],437,2,23320,4.269498352251922,0.0,0.0
35462,3,5462,[275 144 328   7 475],416,4,23324,4.269449020684606,0.0,0.0
35463,3,5463,[210  70 237 183  50],416,4,23328,4.269399707174231,0.0,20.0
35464,3,5464,[ 64 318 313 301  11],43,5,23333,4.269533394327539,60.0,20.0
35465,3,5465,[ 64 318 313 301  11],345,5,23338,4.269667032564947,60.0,20.0
35466,3,5466,[597 333 323 234 117],416,3,23341,4.269434790561551,0.0,0.0
35467,3,5467,[ 64 318 313 301  11],43,5,23346,4.269568397951719,60.0,20.0
35468,3,5468,[ 64 318 313 301  11],345,5,23351,4.269701956481989,60.0,20.0
35469,3,5469,[ 98 174  70 100 237],654,4,23355,4.269652650822669,0.0,20.0
35470,3,5470,[385 508 234 125 100],417,3,23358,4.269420581246573,0.0,0.0
35471,3,5471,[ 64 318 313 301  11],43,5,23363,4.269554093567251,60.0,20.0
35472,3,5472,[ 64 318 313 301  11],43,5,23368,4.269687557098483,60.0,20.0
35473,3,5473,[ 71  25 197 508 748],345,2,23370,4.269272926561929,0.0,0.0
35474,3,5474,[ 64 318 313 301  11],416,5,23375,4.269406392694064,60.0,20.0
35475,3,5475,[ 64 318 313 301  11],416,5,23380,4.26953981008035,60.0,20.0
35476,3,5476,[174 191 294  97 405],62,2,23382,4.26912543363155,0.0,0.0
35477,3,5477,[ 64 318 313 301  11],345,5,23387,4.269258853596203,60.0,20.0
35478,3,5478,[ 64 318 313 301  11],43,5,23392,4.269392224858551,60.0,20.0
35479,3,5479,[ 64 318 313 301  11],416,5,23397,4.269525547445255,60.0,20.0
35480,3,5480,[172 118 748  79 475],805,3,23400,4.269293924466338,0.0,0.0
35481,3,5481,[ 64 318 313 301  11],345,5,23405,4.2694272163444,60.0,20.0
35482,3,5482,[216 423 204  71  98],405,3,23408,4.269195695786978,0.0,20.0
35483,3,5483,[ 64 318 313 301  11],416,5,23413,4.269328956965718,60.0,20.0
35484,3,5484,[ 64 318 313 301  11],416,5,23418,4.269462169553328,60.0,20.0
35485,3,5485,[273 132  96 172 222],62,5,23423,4.269595333576376,0.0,0.0
35486,3,5486,[ 64 318 313 301  11],43,5,23428,4.269728449061418,60.0,20.0
35487,3,5487,[ 64 318 313 301  11],43,5,23433,4.269861516034985,60.0,20.0
35488,3,5488,[ 64 318 313 301  11],345,5,23438,4.269994534523593,60.0,20.0
35489,3,5489,[ 64 318 313 301  11],416,5,23443,4.270127504553734,60.0,20.0
35490,3,5490,[ 69 301 168 427 196],711,4,23447,4.270078309961756,0.0,0.0
35491,3,5491,[748 322 568  25 117],417,2,23449,4.269664967225054,0.0,0.0
35492,3,5492,[ 64 318 313 301  11],345,5,23454,4.269797924631349,60.0,20.0
35493,3,5493,[ 64 318 313 301  11],43,5,23459,4.269930833636694,60.0,20.0
35494,3,5494,[183 161 238  97 127],618,4,23463,4.269881710646042,0.0,0.0
35495,3,5495,[ 64 318 313 301  11],345,5,23468,4.270014556040757,60.0,20.0
35496,3,5496,[ 64 318 313 301  11],43,5,23473,4.270147353101692,60.0,20.0
35497,3,5497,[ 64 318 313 301  11],43,5,23478,4.27028010185522,60.0,20.0
35498,3,5498,[286  12  15 125 121],345,2,23480,4.269867248590653,20.0,0.0
35499,3,5499,[265  25 322 204 197],128,3,23483,4.269636363636364,0.0,0.0
35500,3,5500,[ 64 318 313 301  11],345,5,23488,4.26976913288493,60.0,20.0
35501,3,5501,[ 64 318 313 301  11],416,5,23493,4.269901853871319,60.0,20.0
35502,3,5502,[125 181 185   8 515],230,5,23498,4.270034526621843,0.0,20.0
35503,3,5503,[ 64 318 313 301  11],43,5,23503,4.2701671511627906,60.0,20.0
35504,3,5504,[172   7  56 655  98],62,4,23507,4.270118074477748,0.0,20.0
35505,3,5505,[ 97 655 357 202 237],416,4,23511,4.270069015619324,0.0,0.0
35506,3,5506,[322  79 197 268  64],854,3,23514,4.26983838750681,20.0,0.0
35507,3,5507,[187 385  50 216 237],416,4,23518,4.269789397240378,0.0,20.0
35508,3,5508,[125 196 515 357  95],230,5,23523,4.269921945906698,0.0,0.0
35509,3,5509,[ 64 318 313 301  11],416,5,23528,4.27005444646098,60.0,20.0
35510,3,5510,[200 100 204 546   1],262,0,23528,4.269279622573036,0.0,0.0
35511,3,5511,[ 64 318 313 301  11],416,5,23533,4.269412191582003,60.0,20.0
35512,3,5512,[173   4 405 228 168],62,3,23536,4.269181933611464,0.0,0.0
35513,3,5513,[ 64 318 313 301  11],416,5,23541,4.269314472252448,60.0,20.0
35514,3,5514,[216 200 228 234 204],198,2,23543,4.268902991840435,0.0,0.0
35515,3,5515,[210 168 195 678 176],805,3,23546,4.268672951414068,0.0,0.0
35516,3,5516,[ 64 318 313 301  11],345,5,23551,4.268805510241073,60.0,20.0
35517,3,5517,[117  70  79 238 318],618,3,23554,4.2685755708590065,20.0,0.0
35518,3,5518,[288 117 195 181   7],297,3,23557,4.268345714803407,0.0,40.0
35519,3,5519,[ 64 318 313 301  11],43,5,23562,4.268478260869565,60.0,20.0
35520,3,5520,[ 64 318 313 301  11],416,5,23567,4.268610758920485,60.0,20.0
35521,3,5521,[ 64 318 313 301  11],345,5,23572,4.268743208982253,60.0,20.0
35522,3,5522,[ 64 318 313 301  11],345,5,23577,4.268875611080935,60.0,20.0
35523,3,5523,[257 125   9 471 258],416,4,23581,4.2688269370021725,0.0,0.0
35524,3,5524,[405  28 597  50 265],705,5,23586,4.2689592760181,0.0,20.0
35525,3,5525,[111 185 143 268 301],416,5,23591,4.26909156713717,0.0,0.0
35526,3,5526,[191 483 475 294 405],854,4,23595,4.269042880405284,20.0,0.0
35527,3,5527,[ 64 318 313 301  11],345,5,23600,4.2691751085383505,60.0,20.0
35528,3,5528,[ 64 318 313 301  11],345,5,23605,4.2693072888406585,60.0,20.0
35529,3,5529,[ 64 318 313 301  11],416,5,23610,4.269439421338156,60.0,20.0
35530,3,5530,[323 153  28 235 121],43,3,23613,4.269209907792443,0.0,0.0
35531,3,5531,[ 64 318 313 301  11],43,5,23618,4.269342010122921,60.0,20.0
35532,3,5532,[405 210 196 100 318],654,4,23622,4.269293330923549,20.0,0.0
35533,3,5533,[ 64 318 313 301  11],345,5,23627,4.269425370437297,60.0,20.0
35534,3,5534,[678 228  22 357 286],721,4,23631,4.2693766937669375,0.0,0.0
35535,3,5535,[515 132 357 187 655],405,4,23635,4.269328034682081,0.0,0.0
35536,3,5536,[423   9 118  88 322],416,2,23637,4.268918186743724,0.0,0.0
35537,3,5537,[ 64 318 313 301  11],43,5,23642,4.269050198627664,60.0,20.0
35538,3,5538,[ 64 318 313 301  11],43,5,23647,4.269182162845279,60.0,20.0
35539,3,5539,[ 50 603 180 172 423],373,3,23650,4.268953068592058,0.0,20.0
35540,3,5540,[423  12 475 508 546],49,2,23652,4.26854358419058,20.0,0.0
35541,3,5541,[328  11 100  82  50],416,5,23657,4.268675568386864,0.0,20.0
35542,3,5542,[435 237 172 748 258],721,2,23659,4.268266281796861,0.0,0.0
35543,3,5543,[ 64 318 313 301  11],345,5,23664,4.268398268398268,60.0,20.0
35544,3,5544,[ 64 318 313 301  11],345,5,23669,4.268530207394049,60.0,20.0
35545,3,5545,[ 64 318 313 301  11],43,5,23674,4.268662098809953,60.0,20.0
35546,3,5546,[ 64 318 313 301  11],345,5,23679,4.2687939426717145,60.0,20.0
35547,3,5547,[238 111 143 210 161],345,4,23683,4.268745493871665,0.0,0.0
35548,3,5548,[ 64 318 313 301  11],43,5,23688,4.268877275184718,60.0,20.0
35549,3,5549,[ 64 318 313 301  11],416,5,23693,4.269009009009009,60.0,20.0
35550,3,5550,[ 64 318 313 301  11],345,5,23698,4.269140695370203,60.0,20.0
35551,3,5551,[ 64 318 313 301  11],345,5,23703,4.269272334293948,60.0,20.0
35552,3,5552,[ 64 318 313 301  11],43,5,23708,4.269403925805871,60.0,20.0
35553,3,5553,[ 64 318 313 301  11],416,5,23713,4.269535469931581,60.0,20.0
35554,3,5554,[ 64 318 313 301  11],416,5,23718,4.269666966696669,60.0,20.0
35555,3,5555,[ 64 318 313 301  11],416,5,23723,4.26979841612671,60.0,20.0
35556,3,5556,[ 64 318 313 301  11],345,5,23728,4.269929818247256,60.0,20.0
35557,3,5557,[ 98 405 197 100 216],805,3,23731,4.269701331414177,0.0,20.0
35558,3,5558,[168  56   7 294 302],417,3,23734,4.269472926785393,0.0,0.0
35559,3,5559,[ 64 318 313 301  11],416,5,23739,4.269604316546762,60.0,20.0
35560,3,5560,[ 64 318 313 301  11],416,5,23744,4.269735659054127,60.0,20.0
35561,3,5561,[ 64 318 313 301  11],43,5,23749,4.269866954332974,60.0,20.0
35562,3,5562,[ 64 318 313 301  11],416,5,23754,4.269998202408773,60.0,20.0
35563,3,5563,[  1 200 328 235  98],49,1,23755,4.26941049604601,0.0,20.0
35564,3,5564,[ 64 318 313 301  11],416,5,23760,4.269541778975741,60.0,20.0
35565,3,5565,[ 64 318 313 301  11],416,5,23765,4.269673014732303,60.0,20.0
35566,3,5566,[168  22 588 185 357],230,5,23770,4.269804203341117,0.0,0.0
35567,3,5567,[275  64 216 568 313],618,3,23773,4.269576149425287,40.0,20.0
35568,3,5568,[ 64 318 313 301  11],43,5,23778,4.269707308313881,60.0,20.0
35569,3,5569,[ 64 318 313 301  11],43,5,23783,4.26983842010772,60.0,20.0
35570,3,5570,[471 234 127 302 475],416,4,23787,4.269789983844911,0.0,0.0
35571,3,5571,[228 183 678 603  25],805,4,23791,4.2697415649676955,0.0,0.0
35572,3,5572,[ 64 318 313 301  11],345,5,23796,4.269872600035887,60.0,20.0
35573,3,5573,[ 64 318 313 301  11],43,5,23801,4.270003588087549,60.0,20.0
35574,3,5574,[ 64 318 313 301  11],43,5,23806,4.270134529147982,60.0,20.0
35575,3,5575,[ 64 318 313 301  11],345,5,23811,4.270265423242468,60.0,20.0
35576,3,5576,[568 215 161 132 269],345,4,23815,4.270216962524655,0.0,0.0
35577,3,5577,[282  12 176 742  64],416,5,23820,4.270347794908569,40.0,0.0
35578,3,5578,[ 64 318 313 301  11],345,5,23825,4.270478580390751,60.0,20.0
35579,3,5579,[204 153 238   7 515],297,4,23829,4.270430107526882,0.0,0.0
35580,3,5580,[ 64 318 313 301  11],345,5,23834,4.270560831392223,60.0,20.0
35581,3,5581,[ 64 318 313 301  11],416,5,23839,4.2706915084199215,60.0,20.0
35582,3,5582,[289 286 313  12  95],588,4,23843,4.270643023464087,40.0,20.0
35583,3,5583,[ 50 215 289 265 748],416,4,23847,4.270594555873926,0.0,20.0
35584,3,5584,[ 64 318 313 301  11],345,5,23852,4.270725156669651,60.0,20.0
35585,3,5585,[ 64 318 313 301  11],416,5,23857,4.270855710705335,60.0,20.0
35586,3,5586,[ 64 318 313 301  11],416,5,23862,4.270986218006086,60.0,20.0
35587,3,5587,[ 98  12 294 202 181],588,3,23865,4.270758768790265,20.0,40.0
35588,3,5588,[ 64 318 313 301  11],43,5,23870,4.270889246734657,60.0,20.0
35589,3,5589,[588  28 216 117  71],345,2,23872,4.270483005366726,0.0,0.0
35590,3,5590,[ 25 174 597   1  64],43,4,23876,4.270434627079235,20.0,0.0
35591,3,5591,[182  15 265 200 173],437,3,23879,4.270207439198855,0.0,0.0
35592,3,5592,[ 64 318 313 301  11],345,5,23884,4.270337922403003,60.0,20.0
35593,3,5593,[ 64 318 313 301  11],416,5,23889,4.270468358956024,60.0,20.0
35594,3,5594,[ 64 318 313 301  11],43,5,23894,4.270598748882931,60.0,20.0
35595,3,5595,[ 28 318 294 483  97],62,2,23896,4.270192994996426,40.0,0.0
35596,3,5596,[ 64 318 313 301  11],416,5,23901,4.270323387529033,60.0,20.0
35597,3,5597,[ 64 318 313 301  11],345,5,23906,4.270453733476241,60.0,20.0
35598,3,5598,[ 64 318 313 301  11],345,5,23911,4.270584032863011,60.0,20.0
35599,3,5599,[ 64 318 313 301  11],416,5,23916,4.270714285714286,60.0,20.0
35600,3,5600,[ 64 318 313 301  11],416,5,23921,4.27084449205499,60.0,20.0
35601,3,5601,[286 655 322 405 211],416,4,23925,4.270796144234202,0.0,0.0
35602,3,5602,[153  15 235 269 196],416,4,23929,4.270747813671248,0.0,0.0
35603,3,5603,[ 64 318 313 301  11],416,5,23934,4.270877944325481,60.0,20.0
35604,3,5604,[ 64 318 313 301  11],345,5,23939,4.271008028545941,60.0,20.0
35605,3,5605,[ 64 318 313 301  11],43,5,23944,4.271138066357474,60.0,20.0
35606,3,5606,[ 64 318 313 301  11],416,5,23949,4.271268057784912,60.0,20.0
35607,3,5607,[ 64 318 313 301  11],416,5,23954,4.271398002853067,60.0,20.0
35608,3,5608,[ 64 318 313 301  11],43,5,23959,4.271527901586736,60.0,20.0
35609,3,5609,[ 64 318 313 301  11],43,5,23964,4.271657754010695,60.0,20.0
35610,3,5610,[172  69 211  97 318],373,4,23968,4.271609338798788,20.0,0.0
35611,3,5611,[ 64 318 313 301  11],416,5,23973,4.271739130434782,60.0,20.0
35612,3,5612,[151 132 294 202 328],314,5,23978,4.27186887582398,0.0,0.0
35613,3,5613,[ 64 318 313 301  11],345,5,23983,4.271998574991094,60.0,20.0
35614,3,5614,[ 64 318 313 301  11],43,5,23988,4.2721282279608195,60.0,20.0
35615,3,5615,[403 286 210 268 323],417,3,23991,4.2719017094017095,0.0,0.0
35616,3,5616,[ 64 318 313 301  11],416,5,23996,4.272031333452021,60.0,20.0
35617,3,5617,[ 64 318 313 301  11],416,5,24001,4.272160911356354,60.0,20.0
35618,3,5618,[271 172 294 228 258],805,1,24002,4.271578572699768,0.0,0.0
35619,3,5619,[ 64 318 313 301  11],43,5,24007,4.271708185053381,60.0,20.0
35620,3,5620,[ 64 318 313 301  11],345,5,24012,4.271837751289806,60.0,20.0
35621,3,5621,[ 64 318 313 301  11],345,5,24017,4.271967271433653,60.0,20.0
35622,3,5622,[ 64 318 313 301  11],416,5,24022,4.272096745509515,60.0,20.0
35623,3,5623,[ 64 318 313 301  11],416,5,24027,4.272226173541963,60.0,20.0
35624,3,5624,[127  28   8 258 118],43,5,24032,4.2723555555555555,0.0,0.0
35625,3,5625,[ 64 318 313 301  11],345,5,24037,4.272484891574831,60.0,20.0
35626,3,5626,[200 186 748 151 245],417,5,24042,4.272614181624311,0.0,0.0
35627,3,5627,[288  15 216  28 202],416,5,24047,4.272743425728501,0.0,20.0
35628,3,5628,[195 328 405 301 588],416,5,24052,4.272872623911885,0.0,0.0
35629,3,5629,[ 64 318 313 301  11],43,5,24057,4.273001776198934,60.0,20.0
35630,3,5630,[ 15   7 186 273 181],417,2,24059,4.272598117563488,0.0,20.0
35631,3,5631,[ 96 294 183 286  97],62,2,24061,4.2721946022727275,0.0,0.0
35632,3,5632,[ 98 173 161 111 483],437,3,24064,4.2719687555476655,20.0,20.0
35633,3,5633,[ 64 318 313 301  11],43,5,24069,4.27209797657082,60.0,20.0
35634,3,5634,[195 238  96 235  12],417,3,24072,4.27187222715173,20.0,0.0
35635,3,5635,[127 275 117 172 265],416,5,24077,4.272001419446416,0.0,0.0
35636,3,5636,[ 64 318 313 301  11],345,5,24082,4.27213056590385,60.0,20.0
35637,3,5637,[ 28 186 568  82 204],128,5,24087,4.272259666548422,0.0,0.0
35638,3,5638,[ 64 318 313 301  11],345,5,24092,4.272388721404504,60.0,20.0
35639,3,5639,[ 64 318 313 301  11],416,5,24097,4.272517730496454,60.0,20.0
35640,3,5640,[ 64 318 313 301  11],345,5,24102,4.272646693848609,60.0,20.0
35641,3,5641,[ 64 318 313 301  11],416,5,24107,4.272775611485289,60.0,20.0
35642,3,5642,[ 64 318 313 301  11],345,5,24112,4.272904483430799,60.0,20.0
35643,3,5643,[ 64 318 313 301  11],416,5,24117,4.273033309709426,60.0,20.0
35644,3,5644,[ 64 318 313 301  11],416,5,24122,4.273162090345439,60.0,20.0
35645,3,5645,[127   1 135 269  69],854,4,24126,4.273113708820404,0.0,0.0
35646,3,5646,[117  15 328 235 181],43,4,24130,4.273065344430671,0.0,20.0
35647,3,5647,[ 64 318 313 301  11],43,5,24135,4.273194050991502,60.0,20.0
35648,3,5648,[ 64 318 313 301  11],345,5,24140,4.273322711984422,60.0,20.0
35649,3,5649,[ 64 318 313 301  11],43,5,24145,4.273451327433628,60.0,20.0
35650,3,5650,[ 64 318 313 301  11],345,5,24150,4.273579897363298,60.0,20.0
35651,3,5651,[ 64 318 313 301  11],416,5,24155,4.273708421797593,60.0,20.0
35652,3,5652,[ 64 318 313 301  11],416,5,24160,4.273836900760658,60.0,20.0
35653,3,5653,[ 64 318 313 301  11],345,5,24165,4.273965334276618,60.0,20.0
35654,3,5654,[ 64 318 313 301  11],43,5,24170,4.274093722369584,60.0,20.0
35655,3,5655,[127 191 168 111 187],416,5,24175,4.2742220650636495,0.0,0.0
35656,3,5656,[ 64 318 313 301  11],345,5,24180,4.274350362382888,60.0,20.0
35657,3,5657,[ 64 318 313 301  11],43,5,24185,4.274478614351361,60.0,20.0
35658,3,5658,[ 11 197 222 302  96],854,3,24188,4.2742534016610705,0.0,0.0
35659,3,5659,[ 64 318 313 301  11],416,5,24193,4.274381625441696,60.0,20.0
35660,3,5660,[ 64 318 313 301  11],416,5,24198,4.2745098039215685,60.0,20.0
35661,3,5661,[ 79 568 318 132  70],373,4,24202,4.274461321087955,20.0,0.0
35662,3,5662,[238 118  97 181 182],198,3,24205,4.274236270527989,0.0,20.0
35663,3,5663,[176 294 132  79 151],417,4,24209,4.274187853107344,0.0,0.0
35664,3,5664,[151  70  50 121  11],49,1,24210,4.27360988526037,0.0,20.0
35665,3,5665,[ 64 318 313 301  11],345,5,24215,4.273738086833745,60.0,20.0
35666,3,5666,[ 64 318 313 301  11],43,5,24220,4.273866243162167,60.0,20.0
35667,3,5667,[ 64 318 313 301  11],345,5,24225,4.2739943542695835,60.0,20.0
35668,3,5668,[ 64 318 313 301  11],416,5,24230,4.274122420179926,60.0,20.0
35669,3,5669,[204 216   4 597 568],62,2,24232,4.273721340388007,0.0,0.0
35670,3,5670,[ 64 318 313 301  11],345,5,24237,4.27384940927526,60.0,20.0
35671,3,5671,[ 64 318 313 301  11],345,5,24242,4.273977433004231,60.0,20.0
35672,3,5672,[ 64 318 313 301  11],416,5,24247,4.274105411598802,60.0,20.0
35673,3,5673,[ 64 318 313 301  11],345,5,24252,4.274233345082834,60.0,20.0
35674,3,5674,[ 64 318 313 301  11],416,5,24257,4.274361233480176,60.0,20.0
35675,3,5675,[ 64 318 313 301  11],345,5,24262,4.274489076814659,60.0,20.0
35676,3,5676,[ 64 318 313 301  11],43,5,24267,4.274616875110094,60.0,20.0
35677,3,5677,[ 64 318 313 301  11],345,5,24272,4.274744628390279,60.0,20.0
35678,3,5678,[ 64 318 313 301  11],43,5,24277,4.2748723366789925,60.0,20.0
35679,3,5679,[ 64 318 313 301  11],43,5,24282,4.275,60.0,20.0
35680,3,5680,[ 25 234  70 191 125],345,3,24285,4.274775567681746,0.0,0.0
35681,3,5681,[197  25 258 132 121],854,3,24288,4.27455121436114,0.0,0.0
35682,3,5682,[286 245 496 183 294],417,4,24292,4.274502903396094,0.0,0.0
35683,3,5683,[ 64 318 313 301  11],43,5,24297,4.274630541871921,60.0,20.0
35684,3,5684,[268 234 125  95 174],620,3,24300,4.274406332453826,0.0,0.0
35685,3,5685,[168 275   9 603 333],854,4,24304,4.2743580724586705,0.0,0.0
35686,3,5686,[435  70 357 215 181],373,5,24309,4.274485669069809,0.0,20.0
35687,3,5687,[191 135 265 301 288],297,2,24311,4.274085794655415,0.0,20.0
35688,3,5688,[216 238 125 257 111],416,4,24315,4.274037616452803,0.0,0.0
35689,3,5689,[ 64 318 313 301  11],345,5,24320,4.274165202108963,60.0,20.0
35690,3,5690,[ 64 318 313 301  11],416,5,24325,4.274292742927429,60.0,20.0
35691,3,5691,[ 71 176 289 237 174],416,3,24328,4.2740688685874915,0.0,0.0
35692,3,5692,[ 64 318 313 301  11],345,5,24333,4.2741963815211665,60.0,20.0
35693,3,5693,[181 151 153 100 742],297,3,24336,4.273972602739726,0.0,20.0
35694,3,5694,[ 64 318 313 301  11],345,5,24341,4.274100087796312,60.0,20.0
35695,3,5695,[ 64 318 313 301  11],43,5,24346,4.274227528089888,60.0,20.0
35696,3,5696,[ 64 318 313 301  11],43,5,24351,4.274354923644023,60.0,20.0
35697,3,5697,[ 64 318 313 301  11],416,5,24356,4.274482274482274,60.0,20.0
35698,3,5698,[ 64 318 313 301  11],345,5,24361,4.27460958062818,60.0,20.0
35699,3,5699,[ 64 318 313 301  11],416,5,24366,4.274736842105263,60.0,20.0
35700,3,5700,[ 50 111 183 288 222],62,3,24369,4.2745132432906505,0.0,40.0
35701,3,5701,[ 64 318 313 301  11],43,5,24374,4.2746404770256055,60.0,20.0
35702,3,5702,[ 64 318 313 301  11],416,5,24379,4.274767666140628,60.0,20.0
35703,3,5703,[118  98 222  89 175],198,2,24381,4.274368863955119,0.0,20.0
35704,3,5704,[ 96  69  79 174 117],230,4,24385,4.2743207712532865,0.0,0.0
35705,3,5705,[  1 385 603 748 546],805,2,24387,4.273922187171398,0.0,0.0
35706,3,5706,[ 64 318 313 301  11],43,5,24392,4.274049413001577,60.0,20.0
35707,3,5707,[258 125 168 237 265],588,3,24395,4.273826208829712,0.0,0.0
35708,3,5708,[ 64 318 313 301  11],345,5,24400,4.273953406901383,60.0,20.0
35709,3,5709,[ 64 318 313 301  11],43,5,24405,4.274080560420315,60.0,20.0
35710,3,5710,[ 64 318 313 301  11],345,5,24410,4.27420766940991,60.0,20.0
35711,3,5711,[ 64 318 313 301  11],345,5,24415,4.274334733893557,60.0,20.0
35712,3,5712,[ 64 318 313 301  11],43,5,24420,4.274461753894626,60.0,20.0
35713,3,5713,[ 64 318 313 301  11],43,5,24425,4.274588729436472,60.0,20.0
35714,3,5714,[ 64 318 313 301  11],345,5,24430,4.274715660542432,60.0,20.0
35715,3,5715,[ 64 318 313 301  11],416,5,24435,4.27484254723583,60.0,20.0
35716,3,5716,[200 322 515 183 294],416,4,24439,4.274794472625503,0.0,0.0
35717,3,5717,[ 64 318 313 301  11],43,5,24444,4.27492130115425,60.0,20.0
35718,3,5718,[ 64 318 313 301  11],43,5,24449,4.275048085329603,60.0,20.0
35719,3,5719,[ 64 318 313 301  11],345,5,24454,4.275174825174825,60.0,20.0
35720,3,5720,[ 64 318 313 301  11],416,5,24459,4.275301520713162,60.0,20.0
35721,3,5721,[ 64 318 313 301  11],416,5,24464,4.275428171967843,60.0,20.0
35722,3,5722,[  9 289 597  50 471],324,5,24469,4.275554778962083,0.0,20.0
35723,3,5723,[216 172  82  71  15],618,3,24472,4.2753319357092945,0.0,0.0
35724,3,5724,[ 64 318 313 301  11],43,5,24477,4.275458515283843,60.0,20.0
35725,3,5725,[313 288 173 151 210],588,5,24482,4.275585050646176,20.0,40.0
35726,3,5726,[ 89 228 173 471  22],297,3,24485,4.27536231884058,0.0,0.0
35727,3,5727,[ 64 318 313 301  11],345,5,24490,4.275488826815643,60.0,20.0
35728,3,5728,[ 64 318 313 301  11],416,5,24495,4.275615290626637,60.0,20.0
35729,3,5729,[ 64 318 313 301  11],43,5,24500,4.275741710296684,60.0,20.0
35730,3,5730,[ 64 318 313 301  11],43,5,24505,4.2758680858488916,60.0,20.0
35731,3,5731,[195 318 471 265 742],416,5,24510,4.27599441730635,20.0,0.0
35732,3,5732,[ 64 318 313 301  11],43,5,24515,4.276120704692134,60.0,20.0
35733,3,5733,[ 64 318 313 301  11],345,5,24520,4.276246948029299,60.0,20.0
35734,3,5734,[175 423 238 258 168],805,3,24523,4.276024411508282,0.0,0.0
35735,3,5735,[ 64 318 313 301  11],416,5,24528,4.2761506276150625,60.0,20.0
35736,3,5736,[118 288 258 237 405],223,1,24529,4.275579571204462,0.0,20.0
35737,3,5737,[ 64 318 313 301  11],345,5,24534,4.275705820843499,60.0,20.0
35738,3,5738,[210  12 111 216 237],588,3,24537,4.275483533716676,20.0,0.0
35739,3,5739,[ 64 318 313 301  11],345,5,24542,4.275609756097561,60.0,20.0
35740,3,5740,[588 174 302   7 235],416,4,24546,4.275561748824247,0.0,0.0
35741,3,5741,[ 64 318 313 301  11],345,5,24551,4.275687913618948,60.0,20.0
35742,3,5742,[237 276 678  50 127],708,2,24553,4.275291659411457,0.0,20.0
35743,3,5743,[ 64 318 313 301  11],43,5,24558,4.2754178272980505,60.0,20.0
35744,3,5744,[ 64 318 313 301  11],416,5,24563,4.275543951261967,60.0,20.0
35745,3,5745,[257 322 111 294  11],854,1,24564,4.274973894883397,0.0,0.0
35746,3,5746,[117 111  71  11 200],764,5,24569,4.275100052201148,0.0,0.0
35747,3,5747,[ 64 318 313 301  11],345,5,24574,4.275226165622826,60.0,20.0
35748,3,5748,[ 71 237 435  98 176],437,2,24576,4.274830405287876,0.0,20.0
35749,3,5749,[ 64 318 313 301  11],43,5,24581,4.2749565217391305,60.0,20.0
35750,3,5750,[211 228 328 173  22],373,5,24586,4.275082594331421,0.0,0.0
35751,3,5751,[ 64 318 313 301  11],416,5,24591,4.275208623087622,60.0,20.0
35752,3,5752,[ 64 318 313 301  11],345,5,24596,4.275334608030593,60.0,20.0
35753,3,5753,[228 143 405  95 234],230,4,24600,4.2752867570385815,0.0,0.0
35754,3,5754,[286  88  89  82  70],437,0,24600,4.274543874891399,0.0,0.0
35755,3,5755,[403  28 269 597 117],805,2,24602,4.27414871438499,0.0,0.0
35756,3,5756,[ 64 318 313 301  11],416,5,24607,4.274274795900642,60.0,20.0
35757,3,5757,[ 64 318 313 301  11],345,5,24612,4.274400833622786,60.0,20.0
35758,3,5758,[ 64 318 313 301  11],43,5,24617,4.274526827574232,60.0,20.0
35759,3,5759,[222 181  11 357 322],630,2,24619,4.274131944444444,0.0,20.0
35760,3,5760,[ 64 318 313 301  11],416,5,24624,4.274257941329631,60.0,20.0
35761,3,5761,[ 97 183 323 234 238],416,4,24628,4.274210343630684,0.0,0.0
35762,3,5762,[ 64 318 313 301  11],345,5,24633,4.274336283185841,60.0,20.0
35763,3,5763,[ 64 318 313 301  11],43,5,24638,4.274462179042332,60.0,20.0
35764,3,5764,[ 64 318 313 301  11],345,5,24643,4.274588031222897,60.0,20.0
35765,3,5765,[302 181 313 300 111],751,2,24645,4.274193548387097,20.0,40.0
35766,3,5766,[269 118 186 313 117],43,4,24649,4.274146003121207,20.0,20.0
35767,3,5767,[204 172 186  25 385],43,4,24653,4.2740984743411925,0.0,0.0
35768,3,5768,[ 64 318 313 301  11],345,5,24658,4.274224302305425,60.0,20.0
35769,3,5769,[ 64 318 313 301  11],416,5,24663,4.2743500866551125,60.0,20.0
35770,3,5770,[ 64 318 313 301  11],345,5,24668,4.274475827412926,60.0,20.0
35771,3,5771,[ 64 318 313 301  11],345,5,24673,4.2746015246015245,60.0,20.0
35772,3,5772,[ 89 222 546 302  12],297,4,24677,4.274553958080721,20.0,0.0
35773,3,5773,[235 174 265  25 117],416,4,24681,4.274506408036023,0.0,0.0
35774,3,5774,[ 64 318 313 301  11],345,5,24686,4.274632034632035,60.0,20.0
35775,3,5775,[475 301  15  96 125],416,4,24690,4.274584487534626,0.0,0.0
35776,3,5776,[ 64 318 313 301  11],345,5,24695,4.274710057123074,60.0,20.0
35777,3,5777,[496 144 423  15  25],314,3,24698,4.274489442713742,0.0,0.0
35778,3,5778,[ 64 318 313 301  11],416,5,24703,4.274614985291573,60.0,20.0
35779,3,5779,[118 196 228 385 125],417,4,24707,4.2745674740484425,0.0,0.0
35780,3,5780,[197 175 222 405 403],805,4,24711,4.274519979242346,0.0,0.0
35781,3,5781,[ 64 318 313 301  11],43,5,24716,4.274645451400899,60.0,20.0
35782,3,5782,[ 64 318 313 301  11],416,5,24721,4.274770880166003,60.0,20.0
35783,3,5783,[655 515 118 302 282],416,4,24725,4.27472337482711,0.0,0.0
35784,3,5784,[ 64 318 313 301  11],345,5,24730,4.274848746758859,60.0,20.0
35785,3,5785,[ 64 318 313 301  11],416,5,24735,4.2749740753543035,60.0,20.0
35786,3,5786,[ 64 318 313 301  11],345,5,24740,4.275099360635908,60.0,20.0
35787,3,5787,[ 64 318 313 301  11],345,5,24745,4.275224602626123,60.0,20.0
35788,3,5788,[ 64 318 313 301  11],416,5,24750,4.275349801347383,60.0,20.0
35789,3,5789,[ 64 318 313 301  11],43,5,24755,4.275474956822107,60.0,20.0
35790,3,5790,[ 64 318 313 301  11],345,5,24760,4.275600069072699,60.0,20.0
35791,3,5791,[ 11 174 215 111  88],345,5,24765,4.275725138121547,0.0,0.0
35792,3,5792,[ 64 318 313 301  11],345,5,24770,4.275850163991024,60.0,20.0
35793,3,5793,[ 64 318 313 301  11],416,5,24775,4.2759751467034866,60.0,20.0
35794,3,5794,[ 64 318 313 301  11],345,5,24780,4.276100086281277,60.0,20.0
35795,3,5795,[ 64 318 313 301  11],345,5,24785,4.276224982746722,60.0,20.0
35796,3,5796,[597 180  95 268 748],417,4,24789,4.2761773331033295,0.0,0.0
35797,3,5797,[ 64 318 313 301  11],345,5,24794,4.27630217316316,60.0,20.0
35798,3,5798,[ 64 318 313 301  11],416,5,24799,4.27642697016727,60.0,20.0
35799,3,5799,[ 64 318 313 301  11],43,5,24804,4.276551724137931,60.0,20.0
35800,3,5800,[ 64 318 313 301  11],43,5,24809,4.276676435097397,60.0,20.0
35801,3,5801,[475   9 183  64 588],601,4,24813,4.276628748707342,20.0,0.0
35802,3,5802,[ 64 318 313 301  11],43,5,24818,4.2767534034120285,60.0,20.0
35803,3,5803,[174 143 228 318 238],12,5,24823,4.276878015161957,20.0,0.0
35804,3,5804,[300 202 496 127 195],416,5,24828,4.277002583979328,0.0,0.0
35805,3,5805,[191   9 172 168  82],43,5,24833,4.277127109886324,0.0,0.0
35806,3,5806,[200 496 215 742 172],416,5,24838,4.277251592905115,0.0,0.0
35807,3,5807,[228 196 182 174 180],417,3,24841,4.277031680440771,0.0,0.0
35808,3,5808,[ 64 318 313 301  11],416,5,24846,4.277156137028748,60.0,20.0
35809,3,5809,[ 56 168 202 655 294],253,3,24849,4.276936316695353,0.0,0.0
35810,3,5810,[  7 161  88 153  96],416,4,24853,4.276888659438995,0.0,0.0
35811,3,5811,[  1 168 118  22 174],588,3,24856,4.276668960770819,0.0,0.0
35812,3,5812,[234 385   7 286 197],416,5,24861,4.276793394116635,0.0,0.0
35813,3,5813,[ 64 318 313 301  11],416,5,24866,4.276917784657723,60.0,20.0
35814,3,5814,[ 64 318 313 301  11],43,5,24871,4.277042132416165,60.0,20.0
35815,3,5815,[ 64 318 313 301  11],345,5,24876,4.277166437414031,60.0,20.0
35816,3,5816,[ 22   1 427 172  98],618,5,24881,4.2772906996733715,0.0,20.0
35817,3,5817,[ 64 318 313 301  11],345,5,24886,4.277414919216225,60.0,20.0
35818,3,5818,[257 215 196  71 174],921,4,24890,4.277367245231139,0.0,0.0
35819,3,5819,[ 64 318 313 301  11],416,5,24895,4.277491408934708,60.0,20.0
35820,3,5820,[ 64 318 313 301  11],345,5,24900,4.277615529977667,60.0,20.0
35821,3,5821,[132 546 238 235 185],416,3,24903,4.277396083819993,0.0,0.0
35822,3,5822,[ 64 318 313 301  11],345,5,24908,4.277520178602095,60.0,20.0
35823,3,5823,[ 64 318 313 301  11],345,5,24913,4.277644230769231,60.0,20.0
35824,3,5824,[173   1 111 211  25],417,3,24916,4.277424892703863,0.0,0.0
35825,3,5825,[ 64 318 313 301  11],416,5,24921,4.277548918640576,60.0,20.0
35826,3,5826,[ 64 318 313 301  11],416,5,24926,4.277672902007894,60.0,20.0
35827,3,5827,[ 64 318 313 301  11],416,5,24931,4.277796842827728,60.0,20.0
35828,3,5828,[222 204 118 258  12],297,3,24934,4.2775776290959,20.0,0.0
35829,3,5829,[ 64 318 313 301  11],345,5,24939,4.27770154373928,60.0,20.0
35830,3,5830,[168  79 265  82 172],416,5,24944,4.277825415880638,0.0,0.0
35831,3,5831,[ 64 318 313 301  11],345,5,24949,4.277949245541838,60.0,20.0
35832,3,5832,[322 475 179 185 294],805,3,24952,4.277730156008915,0.0,0.0
35833,3,5833,[275 161  12  70  88],416,4,24956,4.2776825505656495,20.0,0.0
35834,3,5834,[111 234 186  12 144],588,3,24959,4.277463581833762,20.0,0.0
35835,3,5835,[273  15 238 222 568],62,3,24962,4.277244688142563,0.0,0.0
35836,3,5836,[ 64 318 313 301  11],345,5,24967,4.277368511221518,60.0,20.0
35837,3,5837,[ 64 318 313 301  11],43,5,24972,4.277492291880781,60.0,20.0
35838,3,5838,[ 28 257  25 318 204],43,5,24977,4.2776160301421475,20.0,0.0
35839,3,5839,[ 64 275 228 318 186],373,5,24982,4.277739726027397,40.0,0.0
35840,3,5840,[  8 357 174 302 187],875,4,24986,4.27769217599726,0.0,0.0
35841,3,5841,[ 64 318 313 301  11],416,5,24991,4.277815816501199,60.0,20.0
35842,3,5842,[  4   8 273 357 294],805,1,24992,4.277254834845114,0.0,0.0
35843,3,5843,[191 403  82  50   9],62,5,24997,4.277378507871321,0.0,20.0
35844,3,5844,[132 111 597 195 273],417,2,24999,4.276988879384089,0.0,0.0
35845,3,5845,[282  64 200 215   4],345,4,25003,4.276941498460486,20.0,0.0
35846,3,5846,[183 135  11 276  71],230,3,25006,4.276723105866256,0.0,0.0
35847,3,5847,[ 64 318 313 301  11],416,5,25011,4.276846785225718,60.0,20.0
35848,3,5848,[423 313   9 151 195],618,2,25013,4.276457514104975,20.0,20.0
35849,3,5849,[ 64 318 313 301  11],416,5,25018,4.276581196581197,60.0,20.0
35850,3,5850,[742 515 161 200   9],416,5,25023,4.276704836780038,0.0,0.0
35851,3,5851,[568 742  50 168  79],230,4,25027,4.276657552973343,0.0,20.0
35852,3,5852,[ 64 318 313 301  11],416,5,25032,4.276781137878011,60.0,20.0
35853,3,5853,[ 64 318 313 301  11],416,5,25037,4.276904680560301,60.0,20.0
35854,3,5854,[ 64 318 313 301  11],345,5,25042,4.277028181041844,60.0,20.0
35855,3,5855,[ 64 318 313 301  11],416,5,25047,4.277151639344262,60.0,20.0
35856,3,5856,[ 64 318 313 301  11],345,5,25052,4.2772750554891585,60.0,20.0
35857,3,5857,[ 64 318 313 301  11],43,5,25057,4.277398429498122,60.0,20.0
35858,3,5858,[197  79 202 286 135],437,4,25061,4.277351083802697,0.0,0.0
35859,3,5859,[ 64 318 313 301  11],43,5,25066,4.277474402730375,60.0,20.0
35860,3,5860,[286  11 196 210 546],416,4,25070,4.2774270602286295,0.0,0.0
35861,3,5861,[ 64 318 313 301  11],416,5,25075,4.27755032412146,60.0,20.0
35862,3,5862,[ 97 185   7  28 288],618,4,25079,4.277502984820058,0.0,20.0
35863,3,5863,[ 64 318 313 301  11],43,5,25084,4.27762619372442,60.0,20.0
35864,3,5864,[ 64 318 313 301  11],345,5,25089,4.277749360613811,60.0,20.0
35865,3,5865,[ 64 318 313 301  11],416,5,25094,4.277872485509717,60.0,20.0
35866,3,5866,[ 64 318 313 301  11],345,5,25099,4.277995568433612,60.0,20.0
35867,3,5867,[ 64 318 313 301  11],345,5,25104,4.2781186094069525,60.0,20.0
35868,3,5868,[597 237 144 191  96],62,2,25106,4.277730448117226,0.0,0.0
35869,3,5869,[ 64 318 313 301  11],416,5,25111,4.277853492333901,60.0,20.0
35870,3,5870,[176 302 132 405  50],854,3,25114,4.27763583716573,0.0,20.0
35871,3,5871,[ 56 153 483 475 237],437,4,25118,4.27758855585831,20.0,0.0
35872,3,5872,[ 64 318 313 301  11],43,5,25123,4.277711561382598,60.0,20.0
35873,3,5873,[ 64 318 313 301  11],416,5,25128,4.277834525025536,60.0,20.0
35874,3,5874,[ 64 318 313 301  11],43,5,25133,4.277957446808511,60.0,20.0
35875,3,5875,[ 64 318 313 301  11],43,5,25138,4.278080326752893,60.0,20.0
35876,3,5876,[179 275 245 191   7],62,4,25142,4.2780330100391355,0.0,0.0
35877,3,5877,[286 385 300 132 288],345,1,25143,4.277475331745491,0.0,20.0
35878,3,5878,[ 64 318 313 301  11],345,5,25148,4.277598230991665,60.0,20.0
35879,3,5879,[ 64 318 313 301  11],345,5,25153,4.277721088435374,60.0,20.0
35880,3,5880,[196  69  97   1 215],705,2,25155,4.277333786770957,0.0,0.0
35881,3,5881,[ 64 318 313 301  11],416,5,25160,4.277456647398844,60.0,20.0
35882,3,5882,[ 64 318 313 301  11],345,5,25165,4.277579466258712,60.0,20.0
35883,3,5883,[288 423  50 100 172],417,1,25166,4.2770224337185585,0.0,40.0
35884,3,5884,[ 64 318 313 301  11],43,5,25171,4.27714528462192,60.0,20.0
35885,3,5885,[ 98 100 173 195  96],198,3,25174,4.27692830445124,0.0,20.0
35886,3,5886,[ 64 318 313 301  11],43,5,25179,4.27705112960761,60.0,20.0
35887,3,5887,[748 216 100 238 357],297,4,25183,4.277004076086956,0.0,0.0
35888,3,5888,[ 64 318 313 301  11],345,5,25188,4.27712684666327,60.0,20.0
35889,3,5889,[ 12 286 196 172 597],417,3,25191,4.276910016977928,20.0,0.0
35890,3,5890,[ 64 318 313 301  11],345,5,25196,4.277032761840095,60.0,20.0
35891,3,5891,[161 588 328 475  11],49,2,25198,4.276646300067888,0.0,0.0
35892,3,5892,[ 64 318 313 301  11],416,5,25203,4.276769048023079,60.0,20.0
35893,3,5893,[ 64 318 313 301  11],416,5,25208,4.276891754326433,60.0,20.0
35894,3,5894,[ 95 127 185 191 515],417,4,25212,4.2768447837150125,0.0,0.0
35895,3,5895,[ 64 318 313 301  11],416,5,25217,4.276967435549525,60.0,20.0
35896,3,5896,[100 271  50  22 125],62,4,25221,4.276920468034594,0.0,20.0
35897,3,5897,[ 64 318 313 301  11],416,5,25226,4.2770430654459135,60.0,20.0
35898,3,5898,[ 64 318 313 301  11],416,5,25231,4.277165621291744,60.0,20.0
35899,3,5899,[118 216 271 182 405],62,2,25233,4.276779661016949,0.0,0.0
35900,3,5900,[ 64 318 313 301  11],416,5,25238,4.276902219962718,60.0,20.0
35901,3,5901,[ 64 318 313 301  11],43,5,25243,4.27702473737716,60.0,20.0
35902,3,5902,[ 64 318 313 301  11],345,5,25248,4.277147213281382,60.0,20.0
35903,3,5903,[ 64 318 313 301  11],416,5,25253,4.277269647696477,60.0,20.0
35904,3,5904,[ 64 318 313 301  11],416,5,25258,4.277392040643522,60.0,20.0
35905,3,5905,[ 64 318 313 301  11],43,5,25263,4.2775143921435825,60.0,20.0
35906,3,5906,[ 64 318 313 301  11],416,5,25268,4.277636702217708,60.0,20.0
35907,3,5907,[168 597 181 289 588],588,4,25272,4.277589708869329,0.0,20.0
35908,3,5908,[125  96 235 257  64],854,1,25273,4.2770350313081735,20.0,0.0
35909,3,5909,[ 64 318 313 301  11],43,5,25278,4.2771573604060915,60.0,20.0
35910,3,5910,[ 64 318 313 301  11],345,5,25283,4.277279648113686,60.0,20.0
35911,3,5911,[ 70 216 182 215 258],198,4,25287,4.277232746955345,0.0,0.0
35912,3,5912,[ 64 318 313 301  11],416,5,25292,4.277354980551328,60.0,20.0
35913,3,5913,[ 50 143  98 475 100],49,3,25295,4.277138992221847,0.0,40.0
35914,3,5914,[289 234 568 265 121],416,4,25299,4.2770921386306,0.0,0.0
35915,3,5915,[ 64 318 313 301  11],416,5,25304,4.277214334009466,60.0,20.0
35916,3,5916,[ 64 318 313 301  11],345,5,25309,4.2773364880851785,60.0,20.0
35917,3,5917,[ 64 318 313 301  11],345,5,25314,4.277458600878675,60.0,20.0
35918,3,5918,[ 82 435 475 183 135],437,1,25315,4.276904882581517,0.0,0.0
35919,3,5919,[ 64 318 313 301  11],416,5,25320,4.277027027027027,60.0,20.0
35920,3,5920,[173 423   4 111   7],417,2,25322,4.276642459044081,0.0,0.0
35921,3,5921,[268   1 174 172 182],416,5,25327,4.276764606551841,0.0,0.0
35922,3,5922,[588 313  89 515 427],405,2,25329,4.276380212730036,20.0,20.0
35923,3,5923,[323 245 603 215 196],921,3,25332,4.276164753544902,0.0,0.0
35924,3,5924,[ 64 318 313 301  11],43,5,25337,4.276286919831223,60.0,20.0
35925,3,5925,[ 64 318 313 301  11],43,5,25342,4.276409044886939,60.0,20.0
35926,3,5926,[ 64 318 313 301  11],43,5,25347,4.276531128732917,60.0,20.0
35927,3,5927,[ 64 318 313 301  11],345,5,25352,4.276653171390014,60.0,20.0
35928,3,5928,[ 64 318 313 301  11],416,5,25357,4.276775172879069,60.0,20.0
35929,3,5929,[ 64 318 313 301  11],416,5,25362,4.276897133220911,60.0,20.0
35930,3,5930,[ 64 318 313 301  11],345,5,25367,4.277019052436351,60.0,20.0
35931,3,5931,[161  95 302 183 111],417,2,25369,4.276635198921106,0.0,0.0
35932,3,5932,[121 151 405 496  82],601,1,25370,4.276082926007079,0.0,0.0
35933,3,5933,[ 64 318 313 301  11],43,5,25375,4.276204920795416,60.0,20.0
35934,3,5934,[ 64 318 313 301  11],416,5,25380,4.276326874473463,60.0,20.0
35935,3,5935,[ 64 318 313 301  11],345,5,25385,4.2764487870619945,60.0,20.0
35936,3,5936,[ 64 318 313 301  11],43,5,25390,4.276570658581775,60.0,20.0
35937,3,5937,[ 64 318 313 301  11],416,5,25395,4.276692489053554,60.0,20.0
35938,3,5938,[ 97 423   4 313 200],405,3,25398,4.27647752146826,20.0,20.0
35939,3,5939,[ 64 318 313 301  11],416,5,25403,4.276599326599326,60.0,20.0
35940,3,5940,[ 64 318 313 301  11],345,5,25408,4.276721090725467,60.0,20.0
35941,3,5941,[ 11  95 496 111 143],314,5,25413,4.276842813867384,0.0,0.0
35942,3,5942,[100 273 268 195 144],297,3,25416,4.276627965673902,0.0,0.0
35943,3,5943,[496 111 405 196 269],416,5,25421,4.276749663526245,0.0,0.0
35944,3,5944,[ 64 318 313 301  11],416,5,25426,4.276871320437342,60.0,20.0
35945,3,5945,[245  56 471  79 235],416,3,25429,4.2766565758493105,0.0,0.0
35946,3,5946,[ 64 318 313 301  11],416,5,25434,4.2767782074995795,60.0,20.0
35947,3,5947,[ 64 318 313 301  11],43,5,25439,4.276899798251513,60.0,20.0
35948,3,5948,[ 64 318 313 301  11],416,5,25444,4.277021348125736,60.0,20.0
35949,3,5949,[ 64 318 313 301  11],345,5,25449,4.277142857142858,60.0,20.0
35950,3,5950,[475 168 185 286 211],297,5,25454,4.2772643253234754,0.0,0.0
35951,3,5951,[ 64 318 313 301  11],416,5,25459,4.277385752688172,60.0,20.0
35952,3,5952,[  8  28 655 118 186],618,3,25462,4.277171174197884,0.0,0.0
35953,3,5953,[ 64 318 313 301  11],43,5,25467,4.277292576419214,60.0,20.0
35954,3,5954,[269 238 176 216 328],416,5,25472,4.277413937867339,0.0,0.0
35955,3,5955,[ 79 127 273  98 216],417,2,25474,4.277031564808596,0.0,20.0
35956,3,5956,[ 64 318 313 301  11],345,5,25479,4.277152929326842,60.0,20.0
35957,3,5957,[ 64 318 313 301  11],43,5,25484,4.277274253105069,60.0,20.0
35958,3,5958,[ 22  69  95  97 183],505,3,25487,4.277059909380768,0.0,0.0
35959,3,5959,[ 64 318 313 301  11],43,5,25492,4.277181208053691,60.0,20.0
35960,3,5960,[100 313  56 742 174],751,3,25495,4.276966951853716,20.0,20.0
35961,3,5961,[238 204 655  79  70],373,5,25500,4.2770882254277085,0.0,0.0
35962,3,5962,[ 64 318 313 301  11],416,5,25505,4.277209458326346,60.0,20.0
35963,3,5963,[294 258 588   1 655],588,4,25509,4.277162977867203,0.0,0.0
35964,3,5964,[ 64 318 313 301  11],43,5,25514,4.2772841575859175,60.0,20.0
35965,3,5965,[258  12 186 185 742],854,3,25517,4.277070063694268,20.0,0.0
35966,3,5966,[ 64 318 313 301  11],416,5,25522,4.277191218367689,60.0,20.0
35967,3,5967,[ 64 318 313 301  11],43,5,25527,4.277312332439679,60.0,20.0
35968,3,5968,[ 64 318 313 301  11],345,5,25532,4.277433405930641,60.0,20.0
35969,3,5969,[ 64 318 313 301  11],416,5,25537,4.277554438860972,60.0,20.0
35970,3,5970,[603 175  22 268 195],854,2,25539,4.2771730028470945,0.0,0.0
35971,3,5971,[403 748 121 423   4],198,1,25540,4.27662424648359,0.0,0.0
35972,3,5972,[ 64 318 313 301  11],345,5,25545,4.27674535409342,60.0,20.0
35973,3,5973,[ 64 318 313 301  11],345,5,25550,4.276866421158353,60.0,20.0
35974,3,5974,[288 181 100 238 183],805,3,25553,4.276652719665272,0.0,40.0
35975,3,5975,[ 64 318 313 301  11],416,5,25558,4.276773761713521,60.0,20.0
35976,3,5976,[ 64 318 313 301  11],43,5,25563,4.27689476325916,60.0,20.0
35977,3,5977,[ 64 318 313 301  11],345,5,25568,4.277015724322516,60.0,20.0
35978,3,5978,[172 176  82 200 273],618,5,25573,4.2771366449239006,0.0,0.0
35979,3,5979,[385 588   8 423 195],654,5,25578,4.277257525083612,0.0,0.0
35980,3,5980,[ 64 318 313 301  11],416,5,25583,4.277378364821936,60.0,20.0
35981,3,5981,[ 64 318 313 301  11],416,5,25588,4.277499164159144,60.0,20.0
35982,3,5982,[172 238 603 228 202],373,4,25592,4.277452782884841,0.0,0.0
35983,3,5983,[ 89 172 186 144  50],437,2,25594,4.277072192513369,0.0,20.0
35984,3,5984,[ 64 318 313 301  11],416,5,25599,4.277192982456141,60.0,20.0
35985,3,5985,[ 64 318 313 301  11],345,5,25604,4.27731373204143,60.0,20.0
35986,3,5986,[ 64 318 313 301  11],345,5,25609,4.2774344412894605,60.0,20.0
35987,3,5987,[588 181 144 235 323],416,3,25612,4.277221108884436,0.0,20.0
35988,3,5988,[ 64 318 313 301  11],416,5,25617,4.277341793287694,60.0,20.0
35989,3,5989,[ 64 318 313 301  11],345,5,25622,4.277462437395659,60.0,20.0
35990,3,5990,[313 385 238  89 323],751,1,25623,4.276915373059589,20.0,20.0
35991,3,5991,[144 245 282 127 300],416,4,25627,4.276869158878505,0.0,0.0
35992,3,5992,[ 64 318 313 301  11],416,5,25632,4.276989821458368,60.0,20.0
35993,3,5993,[427 238 215 405 294],128,4,25636,4.276943610276944,0.0,0.0
35994,3,5994,[121 183  97 195 196],618,4,25640,4.276897414512093,0.0,0.0
35995,3,5995,[ 69 228  12 195 216],62,4,25644,4.276851234156104,20.0,0.0
35996,3,5996,[603 125 568  25  96],416,5,25649,4.276971819242955,0.0,0.0
35997,3,5997,[269 603  15 265  12],373,5,25654,4.277092364121374,20.0,0.0
35998,3,5998,[302  12 204 234  88],405,4,25658,4.277046174362393,20.0,0.0
35999,3,5999,[216   8 302 197  70],416,5,25663,4.277166666666667,0.0,0.0
36000,3,6000,[ 64 318 313 301  11],416,5,25668,4.277287118813531,60.0,20.0
36001,3,6001,[ 64 318 313 301  11],345,5,25673,4.277407530823059,60.0,20.0
36002,3,6002,[ 64 318 313 301  11],43,5,25678,4.277527902715309,60.0,20.0
36003,3,6003,[ 64 318 313 301  11],416,5,25683,4.277648234510327,60.0,20.0
36004,3,6004,[748 191 742 172 196],345,4,25687,4.277601998334721,0.0,0.0
36005,3,6005,[ 64 318 313 301  11],416,5,25692,4.277722277722278,60.0,20.0
36006,3,6006,[ 64 318 313 301  11],345,5,25697,4.277842517063426,60.0,20.0
36007,3,6007,[ 64 318 313 301  11],345,5,25702,4.277962716378163,60.0,20.0
36008,3,6008,[121 176  79 175 238],854,3,25705,4.277750041604261,0.0,0.0
36009,3,6009,[132 125 405 153 174],642,2,25707,4.2773710482529115,0.0,0.0
36010,3,6010,[ 64 318 313 301  11],345,5,25712,4.27749126601231,60.0,20.0
36011,3,6011,[ 64 318 313 301  11],43,5,25717,4.277611443779109,60.0,20.0
36012,3,6012,[ 64 318 313 301  11],43,5,25722,4.277731581573258,60.0,20.0
36013,3,6013,[  9 117 276 288  64],416,4,25726,4.2776854007316265,20.0,20.0
36014,3,6014,[ 64 318 313 301  11],416,5,25731,4.277805486284289,60.0,20.0
36015,3,6015,[ 64 318 313 301  11],345,5,25736,4.277925531914893,60.0,20.0
36016,3,6016,[333 173 289  15 323],721,2,25738,4.277546950307462,0.0,0.0
36017,3,6017,[ 64 318 313 301  11],43,5,25743,4.277666999002991,60.0,20.0
36018,3,6018,[ 64 318 313 301  11],345,5,25748,4.277787007808606,60.0,20.0
36019,3,6019,[ 64 318 313 301  11],416,5,25753,4.277906976744186,60.0,20.0
36020,3,6020,[ 64 318 313 301  11],416,5,25758,4.278026905829597,60.0,20.0
36021,3,6021,[ 64 318 313 301  11],43,5,25763,4.278146795084689,60.0,20.0
36022,3,6022,[403 173 228 117  96],805,3,25766,4.2779345840943055,0.0,0.0
36023,3,6023,[597   7 151   4 143],618,3,25769,4.277722443559097,0.0,0.0
36024,3,6024,[ 64 318 313 301  11],345,5,25774,4.277842323651452,60.0,20.0
36025,3,6025,[ 64 318 313 301  11],416,5,25779,4.27796216395619,60.0,20.0
36026,3,6026,[ 64 318 313 301  11],43,5,25784,4.278081964493114,60.0,20.0
36027,3,6027,[ 64 318 313 301  11],43,5,25789,4.278201725282017,60.0,20.0
36028,3,6028,[191 238 302 222 144],297,3,25792,4.277989716370874,0.0,0.0
36029,3,6029,[ 64 318 313 301  11],345,5,25797,4.278109452736318,60.0,20.0
36030,3,6030,[ 64 318 313 301  11],345,5,25802,4.278229149394794,60.0,20.0
36031,3,6031,[ 64 318 313 301  11],416,5,25807,4.278348806366048,60.0,20.0
36032,3,6032,[143 216  25 245 121],345,2,25809,4.277971158627548,0.0,0.0
36033,3,6033,[ 64 318 313 301  11],43,5,25814,4.278090818694067,60.0,20.0
36034,3,6034,[183 385 403 210  95],416,4,25818,4.27804473902237,0.0,0.0
36035,3,6035,[ 64 318 313 301  11],416,5,25823,4.2781643472498345,60.0,20.0
36036,3,6036,[179 132  98 294 235],417,4,25827,4.278118270664237,0.0,20.0
36037,3,6037,[ 64 318 313 301  11],43,5,25832,4.278237827095064,60.0,20.0
36038,3,6038,[269 179 275 237 117],416,3,25835,4.278026163272065,0.0,0.0
36039,3,6039,[ 64 318 313 301  11],416,5,25840,4.2781456953642385,60.0,20.0
36040,3,6040,[ 64 318 313 301  11],345,5,25845,4.278265187882801,60.0,20.0
36041,3,6041,[153 427 313 187  11],416,5,25850,4.278384640847402,20.0,20.0
36042,3,6042,[ 64 318 313 301  11],416,5,25855,4.278504054277676,60.0,20.0
36043,3,6043,[357  71 294  69 496],601,2,25857,4.278127068166777,0.0,0.0
36044,3,6044,[ 64 318 313 301  11],43,5,25862,4.278246484698098,60.0,20.0
36045,3,6045,[196 546 273 135 100],297,4,25866,4.27820046311611,0.0,0.0
36046,3,6046,[ 69 100 172  97 185],416,5,25871,4.278319828013891,0.0,0.0
36047,3,6047,[ 64 318 313 301  11],345,5,25876,4.2784391534391535,60.0,20.0
36048,3,6048,[ 64 318 313 301  11],416,5,25881,4.278558439411473,60.0,20.0
36049,3,6049,[143 202 174 121 125],416,5,25886,4.278677685950413,0.0,0.0
36050,3,6050,[ 64 318 313 301  11],416,5,25891,4.2787968930755245,60.0,20.0
36051,3,6051,[ 64 318 313 301  11],43,5,25896,4.278916060806345,60.0,20.0
36052,3,6052,[ 64 318 313 301  11],416,5,25901,4.279035189162399,60.0,20.0
36053,3,6053,[ 64 318 313 301  11],345,5,25906,4.2791542781631975,60.0,20.0
36054,3,6054,[ 64 318 313 301  11],43,5,25911,4.279273327828241,60.0,20.0
36055,3,6055,[245 328  50 427 265],416,4,25915,4.279227212681638,0.0,20.0
36056,3,6056,[ 64 318 313 301  11],345,5,25920,4.279346210995542,60.0,20.0
36057,3,6057,[ 64 318 313 301  11],345,5,25925,4.27946517002311,60.0,20.0
36058,3,6058,[ 64 318 313 301  11],43,5,25930,4.279584089783793,60.0,20.0
36059,3,6059,[385 173  12 294 210],417,4,25934,4.27953795379538,20.0,0.0
36060,3,6060,[ 64 318 313 301  11],416,5,25939,4.27965682230655,60.0,20.0
36061,3,6061,[ 64 318 313 301  11],345,5,25944,4.279775651600132,60.0,20.0
36062,3,6062,[ 64 318 313 301  11],345,5,25949,4.2798944416955305,60.0,20.0
36063,3,6063,[ 64 318 313 301  11],43,5,25954,4.280013192612137,60.0,20.0
36064,3,6064,[269 286 153 204 127],721,5,25959,4.280131904369332,0.0,0.0
36065,3,6065,[ 64 496 276 294 423],416,4,25963,4.280085723705902,20.0,0.0
36066,3,6066,[ 64 318 313 301  11],345,5,25968,4.280204384374485,60.0,20.0
36067,3,6067,[197 655 175 508  28],342,3,25971,4.279993408042189,0.0,0.0
36068,3,6068,[ 70 318 471 385 405],43,4,25975,4.279947273026858,20.0,0.0
36069,3,6069,[ 64 318 313 301  11],43,5,25980,4.28006589785832,60.0,20.0
36070,3,6070,[515 742  95 143 294],416,4,25984,4.2800197661011365,0.0,0.0
36071,3,6071,[ 64 318 313 301  11],416,5,25989,4.280138339920948,60.0,20.0
36072,3,6072,[ 64 318 313 301  11],345,5,25994,4.280256874691257,60.0,20.0
36073,3,6073,[ 64 318 313 301  11],416,5,25999,4.280375370431346,60.0,20.0
36074,3,6074,[ 64 318 313 301  11],416,5,26004,4.280493827160494,60.0,20.0
36075,3,6075,[ 89 568   4 100 475],417,2,26006,4.2801184990125085,0.0,0.0
36076,3,6076,[100 742 237 265 275],297,3,26009,4.2799078492677305,0.0,0.0
36077,3,6077,[211  96 180 202 187],405,2,26011,4.2795327410332344,0.0,0.0
36078,3,6078,[237 294 300 471 357],416,4,26015,4.279486757690409,0.0,0.0
36079,3,6079,[ 64 318 313 301  11],43,5,26020,4.279605263157895,60.0,20.0
36080,3,6080,[ 69 318 405 288  22],601,2,26022,4.2792303897385295,20.0,20.0
36081,3,6081,[ 64 318 313 301  11],416,5,26027,4.279348898388688,60.0,20.0
36082,3,6082,[ 64 318 313 301  11],43,5,26032,4.279467368074963,60.0,20.0
36083,3,6083,[ 64 318 313 301  11],43,5,26037,4.279585798816568,60.0,20.0
36084,3,6084,[ 64 318 313 301  11],345,5,26042,4.279704190632703,60.0,20.0
36085,3,6085,[ 64 318 313 301  11],43,5,26047,4.279822543542557,60.0,20.0
36086,3,6086,[ 64 318 313 301  11],345,5,26052,4.279940857565303,60.0,20.0
36087,3,6087,[ 64 318 313 301  11],416,5,26057,4.280059132720105,60.0,20.0
36088,3,6088,[ 64 318 313 301  11],43,5,26062,4.280177369026113,60.0,20.0
36089,3,6089,[ 64 318 313 301  11],345,5,26067,4.280295566502463,60.0,20.0
36090,3,6090,[ 64 318 313 301  11],345,5,26072,4.280413725168281,60.0,20.0
36091,3,6091,[294 245  28 603   4],297,2,26074,4.280039395929087,0.0,0.0
36092,3,6092,[ 64 318 313 301  11],345,5,26079,4.280157557853275,60.0,20.0
36093,3,6093,[ 64 318 313 301  11],416,5,26084,4.280275680997702,60.0,20.0
36094,3,6094,[ 64 318 313 301  11],345,5,26089,4.2803937653814605,60.0,20.0
36095,3,6095,[173 216 168 161 405],128,5,26094,4.280511811023622,0.0,0.0
36096,3,6096,[ 64 318 313 301  11],416,5,26099,4.280629817943251,60.0,20.0
36097,3,6097,[ 64 318 313 301  11],416,5,26104,4.280747786159396,60.0,20.0
36098,3,6098,[ 64 318 313 301  11],43,5,26109,4.280865715691097,60.0,20.0
36099,3,6099,[ 64 318 313 301  11],416,5,26114,4.280983606557377,60.0,20.0
36100,3,6100,[ 64 318 313 301  11],43,5,26119,4.28110145877725,60.0,20.0
36101,3,6101,[ 64 318 313 301  11],345,5,26124,4.2812192723697144,60.0,20.0
36102,3,6102,[ 64 318 313 301  11],345,5,26129,4.281337047353761,60.0,20.0
36103,3,6103,[ 64 318 313 301  11],345,5,26134,4.281454783748361,60.0,20.0
36104,3,6104,[  7  71 286  79 385],588,3,26137,4.281244881244882,0.0,0.0
36105,3,6105,[ 64 318 313 301  11],416,5,26142,4.28136259416967,60.0,20.0
36106,3,6106,[508  12 216 168 121],854,3,26145,4.281152775503521,20.0,0.0
36107,3,6107,[273  15 144 195 423],854,2,26147,4.280779305828422,0.0,0.0
36108,3,6108,[ 64 318 313 301  11],43,5,26152,4.280897037158291,60.0,20.0
36109,3,6109,[ 64 318 313 301  11],43,5,26157,4.2810147299509005,60.0,20.0
36110,3,6110,[ 64 318 313 301  11],345,5,26162,4.281132384225168,60.0,20.0
36111,3,6111,[748 483 185  50 423],437,5,26167,4.28125,20.0,20.0
36112,3,6112,[ 64 318 313 301  11],43,5,26172,4.281367577294291,60.0,20.0
36113,3,6113,[ 82 288 423 173 179],721,4,26176,4.281321557082107,0.0,20.0
36114,3,6114,[ 64 318 313 301  11],43,5,26181,4.281439084219134,60.0,20.0
36115,3,6115,[ 64 275 202 385 144],43,5,26186,4.2815565729234795,20.0,0.0
36116,3,6116,[ 64 318 313 301  11],416,5,26191,4.281674023213994,60.0,20.0
36117,3,6117,[ 64 318 313 301  11],43,5,26196,4.281791435109513,60.0,20.0
36118,3,6118,[405 179 597 211 300],416,3,26199,4.281581957836248,0.0,0.0
36119,3,6119,[ 64 318 313 301  11],43,5,26204,4.281699346405229,60.0,20.0
36120,3,6120,[ 64 318 313 301  11],416,5,26209,4.2818166966182,60.0,20.0
36121,3,6121,[132  25 215 135 288],618,3,26212,4.281607317869977,0.0,20.0
36122,3,6122,[174 117  50 196  69],373,5,26217,4.28172464478197,0.0,20.0
36123,3,6123,[ 64 318 313 301  11],43,5,26222,4.281841933376878,60.0,20.0
36124,3,6124,[322 118 173  89 125],854,2,26224,4.281469387755102,0.0,0.0
36125,3,6125,[ 64 318 313 301  11],43,5,26229,4.281586679725759,60.0,20.0
36126,3,6126,[  9 121 143 268 405],416,5,26234,4.281703933409499,0.0,0.0
36127,3,6127,[ 64 318 313 301  11],416,5,26239,4.281821148825065,60.0,20.0
36128,3,6128,[ 64 318 313 301  11],345,5,26244,4.28193832599119,60.0,20.0
36129,3,6129,[ 64 318 313 301  11],345,5,26249,4.28205546492659,60.0,20.0
36130,3,6130,[ 64 318 313 301  11],416,5,26254,4.282172565649976,60.0,20.0
36131,3,6131,[ 70 435  79  22  50],297,3,26257,4.281963470319635,0.0,20.0
36132,3,6132,[ 64 318 313 301  11],43,5,26262,4.282080547855862,60.0,20.0
36133,3,6133,[ 64 318 313 301  11],345,5,26267,4.28219758721878,60.0,20.0
36134,3,6134,[132 748  12 161 294],417,4,26271,4.282151589242054,20.0,0.0
36135,3,6135,[ 64 318 313 301  11],345,5,26276,4.282268578878749,60.0,20.0
36136,3,6136,[ 64 318 313 301  11],345,5,26281,4.282385530389441,60.0,20.0
36137,3,6137,[ 64 318 313 301  11],43,5,26286,4.282502443792766,60.0,20.0
36138,3,6138,[ 64 318 313 301  11],43,5,26291,4.282619319107346,60.0,20.0
36139,3,6139,[ 64 318 313 301  11],43,5,26296,4.282736156351792,60.0,20.0
36140,3,6140,[ 64 318 313 301  11],43,5,26301,4.2828529555446995,60.0,20.0
36141,3,6141,[161 357 191 742 588],805,2,26303,4.2824812764571805,0.0,0.0
36142,3,6142,[125  64 143 183  71],416,5,26308,4.28259807911444,20.0,0.0
36143,3,6143,[ 25 273  11 286 174],764,3,26311,4.282389322916667,0.0,0.0
36144,3,6144,[ 28 385 568 275  82],705,5,26316,4.282506102522376,0.0,0.0
36145,3,6145,[ 64 318 313 301  11],345,5,26321,4.282622844126261,60.0,20.0
36146,3,6146,[173 111 100 143 172],618,3,26324,4.282414185781682,0.0,0.0
36147,3,6147,[258  82 181 742 328],43,5,26329,4.282530904359141,0.0,20.0
36148,3,6148,[ 64 318 313 301  11],43,5,26334,4.282647584973167,60.0,20.0
36149,3,6149,[132 588 168 200 475],417,4,26338,4.28260162601626,0.0,0.0
36150,3,6150,[173 265 568 288 269],654,4,26342,4.2825556820029265,0.0,20.0
36151,3,6151,[ 64 318 313 301  11],345,5,26347,4.282672301690507,60.0,20.0
36152,3,6152,[100  25 121 181 173],43,5,26352,4.282788883471477,0.0,20.0
36153,3,6153,[ 64 318 313 301  11],416,5,26357,4.282905427364316,60.0,20.0
36154,3,6154,[ 64 318 313 301  11],43,5,26362,4.28302193338749,60.0,20.0
36155,3,6155,[183 176 172 333   9],416,5,26367,4.283138401559454,0.0,0.0
36156,3,6156,[195 322  96 118 496],416,3,26370,4.282929998375832,0.0,0.0
36157,3,6157,[ 11  15   8 143 282],314,5,26375,4.2830464436505356,0.0,0.0
36158,3,6158,[ 64 318 313 301  11],416,5,26380,4.283162851112194,60.0,20.0
36159,3,6159,[ 64 318 313 301  11],416,5,26385,4.283279220779221,60.0,20.0
36160,3,6160,[ 64 318 313 301  11],345,5,26390,4.283395552670021,60.0,20.0
36161,3,6161,[ 64 318 313 301  11],345,5,26395,4.283511846802986,60.0,20.0
36162,3,6162,[210 222 111 117 300],654,5,26400,4.283628103196495,0.0,0.0
36163,3,6163,[258 257  22 222 151],854,3,26403,4.283419857235561,0.0,0.0
36164,3,6164,[ 64 318 313 301  11],345,5,26408,4.283536090835361,60.0,20.0
36165,3,6165,[191   1 258 655 322],416,4,26412,4.283490107038599,0.0,0.0
36166,3,6166,[ 64 318 313 301  11],345,5,26417,4.283606291551808,60.0,20.0
36167,3,6167,[ 69  28 121 328 100],43,5,26422,4.283722438391699,0.0,0.0
36168,3,6168,[ 64 318 313 301  11],345,5,26427,4.283838547576592,60.0,20.0
36169,3,6169,[ 64 318 313 301  11],416,5,26432,4.283954619124797,60.0,20.0
36170,3,6170,[ 64 318 313 301  11],345,5,26437,4.28407065305461,60.0,20.0
36171,3,6171,[328 100 187 333 282],416,5,26442,4.284186649384316,0.0,0.0
36172,3,6172,[ 64 318 313 301  11],43,5,26447,4.284302608132188,60.0,20.0
36173,3,6173,[ 64 318 313 301  11],43,5,26452,4.284418529316489,60.0,20.0
36174,3,6174,[282 568 257 269 597],416,3,26455,4.28421052631579,0.0,0.0
36175,3,6175,[ 98 183 111 121  88],805,2,26457,4.2838406735751295,0.0,20.0
36176,3,6176,[121  71 235 258 588],887,3,26460,4.283632831471588,0.0,0.0
36177,3,6177,[ 64 318 313 301  11],43,5,26465,4.2837487860148915,60.0,20.0
36178,3,6178,[ 64 318 313 301  11],416,5,26470,4.28386470302638,60.0,20.0
36179,3,6179,[ 64 318 313 301  11],416,5,26475,4.283980582524272,60.0,20.0
36180,3,6180,[ 64 318 313 301  11],43,5,26480,4.284096424526775,60.0,20.0
36181,3,6181,[ 64 318 313 301  11],43,5,26485,4.284212229052087,60.0,20.0
36182,3,6182,[ 64 318 313 301  11],416,5,26490,4.284327996118389,60.0,20.0
36183,3,6183,[ 64 318 313 301  11],43,5,26495,4.284443725743855,60.0,20.0
36184,3,6184,[ 64 318 313 301  11],345,5,26500,4.284559417946645,60.0,20.0
36185,3,6185,[176   9 187 100 132],698,2,26502,4.284190106692532,0.0,0.0
36186,3,6186,[216 234 288 111 603],416,5,26507,4.28430580248909,0.0,20.0
36187,3,6187,[471 195 385 183 173],922,1,26508,4.283775048480931,0.0,0.0
36188,3,6188,[ 64 318 313 301  11],345,5,26513,4.283890773953789,60.0,20.0
36189,3,6189,[ 64 318 313 301  11],345,5,26518,4.284006462035541,60.0,20.0
36190,3,6190,[ 64 318 313 301  11],416,5,26523,4.284122112744306,60.0,20.0
36191,3,6191,[ 64 318 313 301  11],345,5,26528,4.284237726098191,60.0,20.0
36192,3,6192,[ 64 318 313 301  11],416,5,26533,4.284353302115291,60.0,20.0
36193,3,6193,[ 64 318 313 301  11],416,5,26538,4.284468840813691,60.0,20.0
36194,3,6194,[678 403 323   9 302],345,2,26540,4.2841000807102505,0.0,0.0
36195,3,6195,[ 64 318 313 301  11],345,5,26545,4.284215622982569,60.0,20.0
36196,3,6196,[ 64 318 313 301  11],345,5,26550,4.284331127965144,60.0,20.0
36197,3,6197,[ 64 318 313 301  11],416,5,26555,4.284446595676025,60.0,20.0
36198,3,6198,[ 64 318 313 301  11],43,5,26560,4.284562026133247,60.0,20.0
36199,3,6199,[ 64 318 313 301  11],416,5,26565,4.284677419354839,60.0,20.0
36200,3,6200,[132 742  12 172 301],345,5,26570,4.284792775358813,20.0,0.0
36201,3,6201,[ 64 318 313 301  11],416,5,26575,4.284908094163173,60.0,20.0
36202,3,6202,[318  95 117  97 435],373,4,26579,4.284862163469289,20.0,0.0
36203,3,6203,[  8 423  70 127 181],405,4,26583,4.284816247582205,0.0,20.0
36204,3,6204,[ 64 318 313 301  11],416,5,26588,4.284931506849315,60.0,20.0
36205,3,6205,[ 64 318 313 301  11],416,5,26593,4.285046728971962,60.0,20.0
36206,3,6206,[153 234 182 195 179],416,4,26597,4.28500080554213,0.0,0.0
36207,3,6207,[ 64 318 313 301  11],416,5,26602,4.285115979381444,60.0,20.0
36208,3,6208,[ 64 318 313 301  11],43,5,26607,4.285231116121759,60.0,20.0
36209,3,6209,[ 64 318 313 301  11],43,5,26612,4.285346215780998,60.0,20.0
36210,3,6210,[ 82 678 302 318 294],721,2,26614,4.284978264369666,20.0,0.0
36211,3,6211,[286 175 385 435 269],373,2,26616,4.284610431423052,0.0,0.0
36212,3,6212,[185 748  89 423 258],198,2,26618,4.284242716883953,0.0,0.0
36213,3,6213,[ 64 318 313 301  11],416,5,26623,4.284357901512713,60.0,20.0
36214,3,6214,[ 64 318 313 301  11],416,5,26628,4.284473049074819,60.0,20.0
36215,3,6215,[173  69 237  70 258],198,3,26631,4.284266409266409,0.0,0.0
36216,3,6216,[748 153 245 483 496],417,4,26635,4.284220685217951,20.0,0.0
36217,3,6217,[ 64 318 313 301  11],43,5,26640,4.284335799292377,60.0,20.0
36218,3,6218,[ 28 222 603 135 181],698,2,26642,4.283968483679048,0.0,20.0
36219,3,6219,[  8 271 118 257 127],62,2,26644,4.283601286173633,0.0,0.0
36220,3,6220,[ 64 318 313 301  11],416,5,26649,4.283716444301559,60.0,20.0
36221,3,6221,[ 98 161 603 216 111],437,3,26652,4.28351012536162,0.0,20.0
36222,3,6222,[ 64 318 313 301  11],345,5,26657,4.283625261128074,60.0,20.0
36223,3,6223,[197  64 173 508  11],854,5,26662,4.283740359897172,20.0,0.0
36224,3,6224,[ 64 318 313 301  11],43,5,26667,4.283855421686747,60.0,20.0
36225,3,6225,[ 64 318 313 301  11],345,5,26672,4.2839704465146164,60.0,20.0
36226,3,6226,[ 64 318 313 301  11],345,5,26677,4.284085434398587,60.0,20.0
36227,3,6227,[ 64 318 313 301  11],43,5,26682,4.2842003853564545,60.0,20.0
36228,3,6228,[215 271 168 182   8],297,2,26684,4.283833681168727,0.0,0.0
36229,3,6229,[333 181 588 176 174],416,5,26689,4.283948635634029,0.0,20.0
36230,3,6230,[ 64 318 313 301  11],416,5,26694,4.284063553201733,60.0,20.0
36231,3,6231,[172  25  88  50  82],128,3,26697,4.283857509627728,0.0,20.0
36232,3,6232,[ 64 318 313 301  11],345,5,26702,4.283972404941441,60.0,20.0
36233,3,6233,[183 211  11  50 210],297,5,26707,4.284087263394289,0.0,20.0
36234,3,6234,[ 64 318 313 301  11],416,5,26712,4.28420208500401,60.0,20.0
36235,3,6235,[257   7  89 125   1],417,3,26715,4.283996151379089,0.0,0.0
36236,3,6236,[318 269 603  70 111],416,5,26720,4.284110950777618,20.0,0.0
36237,3,6237,[195 185 204  98   4],297,2,26722,4.283744789996794,0.0,20.0
36238,3,6238,[403 286 271 222 216],62,3,26725,4.2835390286904955,0.0,0.0
36239,3,6239,[ 64 318 313 301  11],416,5,26730,4.283653846153846,60.0,20.0
36240,3,6240,[ 64 318 313 301  11],43,5,26735,4.283768626822624,60.0,20.0
36241,3,6241,[288 216  79 173 475],588,4,26739,4.2837231656520345,0.0,20.0
36242,3,6242,[ 64 318 313 301  11],345,5,26744,4.28383789844626,60.0,20.0
36243,3,6243,[496 301 603  71 273],416,5,26749,4.283952594490711,0.0,0.0
36244,3,6244,[ 96 200 508 357  70],417,3,26752,4.283746997598079,0.0,0.0
36245,3,6245,[174 204 313 100   4],416,5,26757,4.283861671469741,20.0,20.0
36246,3,6246,[ 64 318 313 301  11],43,5,26762,4.283976308628142,60.0,20.0
36247,3,6247,[ 64 318 313 301  11],345,5,26767,4.284090909090909,60.0,20.0
36248,3,6248,[ 64 318 313 301  11],416,5,26772,4.2842054728756604,60.0,20.0
36249,3,6249,[ 64 318 313 301  11],416,5,26777,4.28432,60.0,20.0
36250,3,6250,[143  70 322 268 568],128,2,26779,4.2839545672692365,0.0,0.0
36251,3,6251,[ 64 318 313 301  11],416,5,26784,4.2840690978886755,60.0,20.0
36252,3,6252,[ 64 318 313 301  11],345,5,26789,4.2841835918759,60.0,20.0
36253,3,6253,[215  97 385  25 300],654,3,26792,4.283978253917493,0.0,0.0
36254,3,6254,[172 176   8  98  88],405,3,26795,4.2837729816147085,0.0,20.0
36255,3,6255,[ 64 318 313 301  11],416,5,26800,4.283887468030691,60.0,20.0
36256,3,6256,[ 64 318 313 301  11],345,5,26805,4.284001917852006,60.0,20.0
36257,3,6257,[ 64 318 313 301  11],416,5,26810,4.284116331096197,60.0,20.0
36258,3,6258,[ 64 318 313 301  11],345,5,26815,4.284230707780796,60.0,20.0
36259,3,6259,[ 71 195 276 181  95],437,3,26818,4.284025559105431,0.0,20.0
36260,3,6260,[258  97 302  98 172],417,3,26821,4.283820475962306,0.0,20.0
36261,3,6261,[ 64 318 313 301  11],43,5,26826,4.283934845097413,60.0,20.0
36262,3,6262,[ 64 318 313 301  11],416,5,26831,4.284049177710362,60.0,20.0
36263,3,6263,[ 69 182 168 202 210],405,3,26834,4.283844189016603,0.0,0.0
36264,3,6264,[ 64 318 313 301  11],345,5,26839,4.283958499600958,60.0,20.0
36265,3,6265,[ 15  97 143 588 269],654,3,26842,4.283753590807533,0.0,0.0
36266,3,6266,[655  22   7  98 172],62,4,26846,4.283708313387586,0.0,20.0
36267,3,6267,[ 64 318 313 301  11],345,5,26851,4.283822590938098,60.0,20.0
36268,3,6268,[ 64 318 313 301  11],416,5,26856,4.283936832030627,60.0,20.0
36269,3,6269,[ 64 318 313 301  11],416,5,26861,4.284051036682616,60.0,20.0
36270,3,6270,[318 195 597 258 235],416,3,26864,4.283846276510923,20.0,0.0
36271,3,6271,[ 79   1 183 357 403],805,5,26869,4.283960459183674,0.0,0.0
36272,3,6272,[ 64 318 313 301  11],345,5,26874,4.284074605451937,60.0,20.0
36273,3,6273,[ 64 318 313 301  11],416,5,26879,4.284188715333121,60.0,20.0
36274,3,6274,[ 64 318 313 301  11],345,5,26884,4.284302788844622,60.0,20.0
36275,3,6275,[ 64 318 313 301  11],345,5,26889,4.284416826003824,60.0,20.0
36276,3,6276,[ 64 318 313 301  11],43,5,26894,4.284530826828102,60.0,20.0
36277,3,6277,[ 64 318 313 301  11],43,5,26899,4.28464479133482,60.0,20.0
36278,3,6278,[196  56 151 210 403],62,5,26904,4.284758719541328,0.0,0.0
36279,3,6279,[197 403 475  11  96],198,5,26909,4.2848726114649685,0.0,0.0
36280,3,6280,[ 64 318 313 301  11],43,5,26914,4.28498646712307,60.0,20.0
36281,3,6281,[ 64 318 313 301  11],43,5,26919,4.285100286532951,60.0,20.0
36282,3,6282,[ 64 318 313 301  11],43,5,26924,4.285214069711921,60.0,20.0
36283,3,6283,[ 64 318 313 301  11],416,5,26929,4.285327816677276,60.0,20.0
36284,3,6284,[328 496 235 125   9],416,4,26933,4.285282418456643,0.0,0.0
36285,3,6285,[ 22  71 258 151 257],642,3,26936,4.285077951002227,0.0,0.0
36286,3,6286,[ 64 318 313 301  11],416,5,26941,4.285191665341181,60.0,20.0
36287,3,6287,[318 125 202 200 197],416,5,26946,4.2853053435114505,20.0,0.0
36288,3,6288,[ 64 318 313 301  11],43,5,26951,4.285418985530291,60.0,20.0
36289,3,6289,[ 64 318 313 301  11],416,5,26956,4.2855325914149445,60.0,20.0
36290,3,6290,[185 655 265 186 176],198,3,26959,4.285328246701638,0.0,0.0
36291,3,6291,[ 64 318 313 301  11],416,5,26964,4.285441830896376,60.0,20.0
36292,3,6292,[ 64 318 313 301  11],43,5,26969,4.285555378992531,60.0,20.0
36293,3,6293,[ 64 318 313 301  11],416,5,26974,4.285668891007308,60.0,20.0
36294,3,6294,[ 64 318 313 301  11],416,5,26979,4.285782366957903,60.0,20.0
36295,3,6295,[403 210 471 265  71],416,5,26984,4.285895806861499,0.0,0.0
36296,3,6296,[ 98 294 313 238 405],345,4,26988,4.285850404954741,20.0,40.0
36297,3,6297,[ 64 318 313 301  11],345,5,26993,4.285963798031121,60.0,20.0
36298,3,6298,[172 195 180  64 210],417,3,26996,4.285759644387998,20.0,0.0
36299,3,6299,[655 132 186 111  70],417,4,27000,4.285714285714286,0.0,0.0
36300,3,6300,[ 12 289   7 191 258],854,4,27004,4.285668941437867,20.0,0.0
36301,3,6301,[302 173 742 301 202],416,5,27009,4.2857822913360835,0.0,0.0
36302,3,6302,[ 64 318 313 301  11],43,5,27014,4.285895605267333,60.0,20.0
36303,3,6303,[ 15 117 318   4  79],416,5,27019,4.286008883248731,20.0,0.0
36304,3,6304,[ 69 275 180  50 268],128,4,27023,4.285963521015067,0.0,20.0
36305,3,6305,[202 179 568 423 144],416,4,27027,4.285918173168411,0.0,0.0
36306,3,6306,[ 64 318 313 301  11],416,5,27032,4.2860313936895515,60.0,20.0
36307,3,6307,[ 64 318 313 301  11],43,5,27037,4.286144578313253,60.0,20.0
36308,3,6308,[ 69 204 181 191 276],618,3,27040,4.285940719606911,0.0,20.0
36309,3,6309,[ 98 333 183 302 191],416,5,27045,4.286053882725832,0.0,20.0
36310,3,6310,[ 64 318 313 301  11],416,5,27050,4.28616700998257,60.0,20.0
36311,3,6311,[ 64 318 313 301  11],416,5,27055,4.28628010139417,60.0,20.0
36312,3,6312,[ 64 318 313 301  11],416,5,27060,4.286393156977665,60.0,20.0
36313,3,6313,[ 64 318 313 301  11],416,5,27065,4.28650617675008,60.0,20.0
36314,3,6314,[508 185 111 202  25],417,1,27066,4.285985748218527,0.0,0.0
36315,3,6315,[111  69 289   4 257],43,5,27071,4.286098796706776,0.0,0.0
36316,3,6316,[215   7 135 483  28],62,3,27074,4.2858952034193445,20.0,0.0
36317,3,6317,[194 172 153 333 238],416,5,27079,4.2860082304526745,0.0,0.0
36318,3,6318,[ 64 318 313 301  11],43,5,27084,4.286121221712296,60.0,20.0
36319,3,6319,[ 64 318 313 301  11],43,5,27089,4.2862341772151895,60.0,20.0
36320,3,6320,[475 183 234 323 143],198,2,27091,4.285872488530296,0.0,0.0
36321,3,6321,[118 132 216  64 237],345,4,27095,4.285827269851313,20.0,0.0
36322,3,6322,[100  89  50   9 288],805,3,27098,4.285623912699668,0.0,40.0
36323,3,6323,[ 64 318 313 301  11],345,5,27103,4.28573687539532,60.0,20.0
36324,3,6324,[ 64 318 313 301  11],416,5,27108,4.2858498023715415,60.0,20.0
36325,3,6325,[ 64 318 313 301  11],345,5,27113,4.285962693645273,60.0,20.0
36326,3,6326,[ 64 318 313 301  11],345,5,27118,4.286075549233444,60.0,20.0
36327,3,6327,[ 64 318 313 301  11],416,5,27123,4.2861883691529705,60.0,20.0
36328,3,6328,[ 64 318 313 301  11],416,5,27128,4.286301153420761,60.0,20.0
36329,3,6329,[ 64 318 313 301  11],416,5,27133,4.286413902053712,60.0,20.0
36330,3,6330,[ 64 318 313 301  11],416,5,27138,4.286526615068709,60.0,20.0
36331,3,6331,[ 64 318 313 301  11],43,5,27143,4.2866392924826275,60.0,20.0
36332,3,6332,[ 82 403 257  25 180],711,3,27146,4.286436128217274,0.0,0.0
36333,3,6333,[ 64 318 313 301  11],416,5,27151,4.286548784338491,60.0,20.0
36334,3,6334,[ 64 318 313 301  11],345,5,27156,4.286661404893449,60.0,20.0
36335,3,6335,[ 64 318 313 301  11],345,5,27161,4.28677398989899,60.0,20.0
36336,3,6336,[265  11 275   7 289],416,4,27165,4.28672873599495,0.0,0.0
36337,3,6337,[ 64 318 313 301  11],416,5,27170,4.286841274850111,60.0,20.0
36338,3,6338,[496  97 181   1 118],43,5,27175,4.286953778198454,0.0,20.0
36339,3,6339,[276 742  95 282  50],416,3,27178,4.286750788643533,0.0,20.0
36340,3,6340,[ 64 318 313 301  11],416,5,27183,4.28686327077748,60.0,20.0
36341,3,6341,[405 588 121  97 168],417,2,27185,4.286502680542416,0.0,0.0
36342,3,6342,[ 64 318 313 301  11],416,5,27190,4.286615166325083,60.0,20.0
36343,3,6343,[ 15 234 173 151 100],417,4,27194,4.28656998738966,0.0,0.0
36344,3,6344,[313   4  50 144  12],416,5,27199,4.286682427107959,40.0,40.0
36345,3,6345,[ 25 228 423 265 269],297,2,27201,4.286322092656792,0.0,0.0
36346,3,6346,[ 64 318 313 301  11],416,5,27206,4.28643453600126,60.0,20.0
36347,3,6347,[ 97  12 143 195 187],618,4,27210,4.286389413988658,20.0,0.0
36348,3,6348,[ 64 318 313 301  11],345,5,27215,4.2865018113088675,60.0,20.0
36349,3,6349,[ 64 318 313 301  11],416,5,27220,4.2866141732283465,60.0,20.0
36350,3,6350,[117  71 127  50 210],198,3,27223,4.286411588726184,0.0,20.0
36351,3,6351,[ 64 318 313 301  11],416,5,27228,4.2865239294710324,60.0,20.0
36352,3,6352,[ 64 318 313 301  11],43,5,27233,4.286636234849677,60.0,20.0
36353,3,6353,[ 64 318 313 301  11],345,5,27238,4.286748504878816,60.0,20.0
36354,3,6354,[ 82  70 202 234 294],417,5,27243,4.286860739575138,0.0,0.0
36355,3,6355,[276 405 168 268  28],128,4,27247,4.286815607300189,0.0,0.0
36356,3,6356,[ 64 318 313 301  11],345,5,27252,4.28692779613025,60.0,20.0
36357,3,6357,[ 64 318 313 301  11],416,5,27257,4.287039949669707,60.0,20.0
36358,3,6358,[ 64 318 313 301  11],416,5,27262,4.28715206793521,60.0,20.0
36359,3,6359,[ 64 318 313 301  11],345,5,27267,4.287264150943396,60.0,20.0
36360,3,6360,[202 294 174 655 289],345,2,27269,4.2869045747523975,0.0,0.0
36361,3,6361,[ 64 318 313 301  11],416,5,27274,4.2870166614272245,60.0,20.0
36362,3,6362,[ 64 318 313 301  11],43,5,27279,4.287128712871287,60.0,20.0
36363,3,6363,[179 286   9 403 216],62,4,27283,4.28708359522313,0.0,0.0
36364,3,6364,[ 64 318 313 301  11],416,5,27288,4.287195600942655,60.0,20.0
36365,3,6365,[ 64 318 313 301  11],416,5,27293,4.287307571473453,60.0,20.0
36366,3,6366,[ 64 318 313 301  11],416,5,27298,4.287419506832103,60.0,20.0
36367,3,6367,[ 64 318 313 301  11],416,5,27303,4.287531407035176,60.0,20.0
36368,3,6368,[ 64 318 313 301  11],43,5,27308,4.28764327209923,60.0,20.0
36369,3,6369,[ 64 318 313 301  11],43,5,27313,4.2877551020408164,60.0,20.0
36370,3,6370,[195 294  71  12 125],601,0,27313,4.287082090723591,20.0,0.0
36371,3,6371,[ 64 318 313 301  11],416,5,27318,4.287193973634651,60.0,20.0
36372,3,6372,[ 64 318 313 301  11],43,5,27323,4.287305821434176,60.0,20.0
36373,3,6373,[143 471  79 111 286],345,3,27326,4.28710385942893,0.0,0.0
36374,3,6374,[ 28 180 197 216  71],405,2,27328,4.286745098039216,0.0,0.0
36375,3,6375,[ 64 318 313 301  11],416,5,27333,4.286856963613551,60.0,20.0
36376,3,6376,[357 173 318 181 172],198,5,27338,4.28696879410381,20.0,20.0
36377,3,6377,[ 64 318 313 301  11],345,5,27343,4.287080589526497,60.0,20.0
36378,3,6378,[403 508 151  11 121],417,3,27346,4.286878821131839,0.0,0.0
36379,3,6379,[ 64 318 313 301  11],345,5,27351,4.286990595611285,60.0,20.0
36380,3,6380,[183 268   7 117  96],416,5,27356,4.2871023350572015,0.0,0.0
36381,3,6381,[ 22 182 515 237  70],416,4,27360,4.287057348793482,0.0,0.0
36382,3,6382,[258 597 196 117  98],805,1,27361,4.286542378192073,0.0,20.0
36383,3,6383,[ 64 318 313 301  11],416,5,27366,4.286654135338346,60.0,20.0
36384,3,6384,[258 237  88 483 588],128,4,27370,4.286609240407205,20.0,0.0
36385,3,6385,[ 95 202 180  56  98],417,5,27375,4.286720952082681,0.0,20.0
36386,3,6386,[ 64 318 313 301  11],43,5,27380,4.286832628777204,60.0,20.0
36387,3,6387,[ 64 318 313 301  11],43,5,27385,4.286944270507201,60.0,20.0
36388,3,6388,[ 64 318 313 301  11],416,5,27390,4.287055877289091,60.0,20.0
36389,3,6389,[ 64 318 313 301  11],416,5,27395,4.28716744913928,60.0,20.0
36390,3,6390,[471 195 258 300 275],297,2,27397,4.286809575966203,0.0,0.0
36391,3,6391,[ 64 318 313 301  11],345,5,27402,4.286921151439299,60.0,20.0
36392,3,6392,[ 64 318 313 301  11],345,5,27407,4.287032692006883,60.0,20.0
36393,3,6393,[276 471 603 202 568],416,4,27411,4.286987801063497,0.0,0.0
36394,3,6394,[  7 174  70 328 237],43,5,27416,4.287099296325254,0.0,0.0
36395,3,6395,[235 175 195 183  15],922,1,27417,4.286585365853658,0.0,0.0
36396,3,6396,[ 64 318 313 301  11],345,5,27422,4.286696889166797,60.0,20.0
36397,3,6397,[ 88 546 172 151 173],43,5,27427,4.286808377618006,0.0,0.0
36398,3,6398,[ 64 318 313 301  11],43,5,27432,4.286919831223629,60.0,20.0
36399,3,6399,[475 204 143 111  56],297,3,27435,4.28671875,0.0,0.0
36400,3,6400,[ 64 318 313 301  11],43,5,27440,4.28683018278394,60.0,20.0
36401,3,6401,[168 475  79 186  12],588,4,27444,4.286785379568885,20.0,0.0
36402,3,6402,[ 64 318 313 301  11],345,5,27449,4.286896767140403,60.0,20.0
36403,3,6403,[ 64 318 313 301  11],345,5,27454,4.287008119925047,60.0,20.0
36404,3,6404,[ 64 318 313 301  11],345,5,27459,4.28711943793911,60.0,20.0
36405,3,6405,[183   4  69 423 322],417,2,27461,4.286762410240399,0.0,0.0
36406,3,6406,[211 185 132 111 301],416,5,27466,4.286873731855783,0.0,0.0
36407,3,6407,[273 385   8 144 151],805,1,27467,4.2863607990012484,0.0,0.0
36408,3,6408,[ 64 318 313 301  11],43,5,27472,4.286472148541114,60.0,20.0
36409,3,6409,[333  25 597 202 403],416,4,27476,4.286427457098284,0.0,0.0
36410,3,6410,[ 64 318 313 301  11],43,5,27481,4.286538761503666,60.0,20.0
36411,3,6411,[ 64 318 313 301  11],43,5,27486,4.286650031191516,60.0,20.0
36412,3,6412,[ 64 318 313 301  11],345,5,27491,4.286761266178075,60.0,20.0
36413,3,6413,[173 117 318  79 288],907,5,27496,4.286872466479576,20.0,20.0
36414,3,6414,[ 64 318 313 301  11],416,5,27501,4.2869836321122365,60.0,20.0
36415,3,6415,[ 88 427 515 175 187],405,2,27503,4.286627182044888,0.0,0.0
36416,3,6416,[ 64 318 313 301  11],345,5,27508,4.28673835125448,60.0,20.0
36417,3,6417,[ 64 318 313 301  11],345,5,27513,4.286849485821128,60.0,20.0
36418,3,6418,[216  95 200 175  97],253,4,27517,4.28680479825518,0.0,0.0
36419,3,6419,[ 64 318 313 301  11],345,5,27522,4.286915887850467,60.0,20.0
36420,3,6420,[  7 174   8 288 216],854,3,27525,4.28671546488086,0.0,20.0
36421,3,6421,[ 64 318 313 301  11],43,5,27530,4.286826533790096,60.0,20.0
36422,3,6422,[ 64 318 313 301  11],416,5,27535,4.286937568114588,60.0,20.0
36423,3,6423,[ 64 318 313 301  11],43,5,27540,4.287048567870485,60.0,20.0
36424,3,6424,[ 64 151 235 234 357],417,4,27544,4.287003891050584,20.0,0.0
36425,3,6425,[ 64 318 313 301  11],416,5,27549,4.287114845938375,60.0,20.0
36426,3,6426,[111 168 117 237 268],854,1,27550,4.286603391940252,0.0,0.0
36427,3,6427,[ 64 318 313 301  11],416,5,27555,4.286714374611076,60.0,20.0
36428,3,6428,[ 64 318 313 301  11],416,5,27560,4.28682532275626,60.0,20.0
36429,3,6429,[ 64 318 313 301  11],43,5,27565,4.286936236391913,60.0,20.0
36430,3,6430,[ 64 318 313 301  11],416,5,27570,4.287047115534132,60.0,20.0
36431,3,6431,[  7 215 238 328 111],43,4,27574,4.287002487562189,0.0,0.0
36432,3,6432,[ 64 318 313 301  11],43,5,27579,4.287113321933779,60.0,20.0
36433,3,6433,[182 313 197 173 216],405,3,27582,4.2869132732359345,20.0,20.0
36434,3,6434,[ 64 318 313 301  11],43,5,27587,4.287024087024087,60.0,20.0
36435,3,6435,[ 64 318 313 301  11],43,5,27592,4.287134866376632,60.0,20.0
36436,3,6436,[ 64 318 313 301  11],345,5,27597,4.287245611309617,60.0,20.0
36437,3,6437,[125  56 508  71  15],314,3,27600,4.287045666356011,0.0,0.0
36438,3,6438,[328 121 196 302  71],416,5,27605,4.287156390743904,0.0,0.0
36439,3,6439,[197 323 282 423 333],416,4,27609,4.2871118012422365,0.0,0.0
36440,3,6440,[ 64 318 313 301  11],345,5,27614,4.287222480981214,60.0,20.0
36441,3,6441,[ 82 175  89 161 288],405,2,27616,4.286867432474387,0.0,20.0
36442,3,6442,[ 64 318 313 301  11],416,5,27621,4.2869781157845726,60.0,20.0
36443,3,6443,[ 64 318 313 301  11],416,5,27626,4.287088764742396,60.0,20.0
36444,3,6444,[182 235  95 475 151],417,4,27630,4.287044220325834,0.0,0.0
36445,3,6445,[ 64 318 313 301  11],43,5,27635,4.287154824697486,60.0,20.0
36446,3,6446,[ 64 318 313 301  11],43,5,27640,4.287265394757251,60.0,20.0
36447,3,6447,[ 64 318 313 301  11],43,5,27645,4.287375930521092,60.0,20.0
36448,3,6448,[ 64 318 313 301  11],416,5,27650,4.287486432004962,60.0,20.0
36449,3,6449,[210 288 111 200 179],437,2,27652,4.287131782945736,0.0,20.0
36450,3,6450,[ 64 318 313 301  11],345,5,27657,4.287242288017362,60.0,20.0
36451,3,6451,[ 64 318 313 301  11],416,5,27662,4.28735275883447,60.0,20.0
36452,3,6452,[ 95 597 121  79 168],588,5,27667,4.287463195412986,0.0,0.0
36453,3,6453,[ 64 318 313 301  11],345,5,27672,4.287573597768826,60.0,20.0
36454,3,6454,[ 64 318 313 301  11],345,5,27677,4.287683965917893,60.0,20.0
36455,3,6455,[ 64 318 313 301  11],345,5,27682,4.287794299876084,60.0,20.0
36456,3,6456,[748 204 202  56  97],297,2,27684,4.2874399876103455,0.0,0.0
36457,3,6457,[183 294 176 194 200],297,2,27686,4.287085785072778,0.0,0.0
36458,3,6458,[ 64 318 313 301  11],345,5,27691,4.287196160396346,60.0,20.0
36459,3,6459,[ 64 318 313 301  11],345,5,27696,4.287306501547987,60.0,20.0
36460,3,6460,[ 64 318 313 301  11],345,5,27701,4.287416808543569,60.0,20.0
36461,3,6461,[216 111 117 185 100],416,5,27706,4.287527081398948,0.0,0.0
36462,3,6462,[172 405  25  28 181],345,3,27709,4.287327866315953,0.0,20.0
36463,3,6463,[135 508 483 435 175],354,3,27712,4.287128712871287,20.0,0.0
36464,3,6464,[275 265 742  15 180],128,4,27716,4.287084300077339,0.0,0.0
36465,3,6465,[187 288 294 318 181],416,5,27721,4.287194556139808,20.0,40.0
36466,3,6466,[318  15   1  22   4],253,5,27726,4.287304778104222,20.0,0.0
36467,3,6467,[  7  96 288 269 289],854,3,27729,4.287105751391466,0.0,20.0
36468,3,6468,[294 172 257  50  97],417,2,27731,4.2867522028134175,0.0,20.0
36469,3,6469,[ 64 318 313 301  11],43,5,27736,4.286862442040185,60.0,20.0
36470,3,6470,[222 323 294  95   4],805,2,27738,4.286509040333797,0.0,0.0
36471,3,6471,[546 483  97 211 100],417,3,27741,4.286310259579728,20.0,0.0
36472,3,6472,[153 357 143  79 196],416,5,27746,4.286420515989495,0.0,0.0
36473,3,6473,[ 64 318 313 301  11],416,5,27751,4.286530738337968,60.0,20.0
36474,3,6474,[678 588 194 273 237],416,3,27754,4.2863320463320465,0.0,0.0
36475,3,6475,[ 64 318 313 301  11],416,5,27759,4.28644224830142,60.0,20.0
36476,3,6476,[ 64 318 313 301  11],43,5,27764,4.286552416242087,60.0,20.0
36477,3,6477,[ 64 318 313 301  11],43,5,27769,4.2866625501698055,60.0,20.0
36478,3,6478,[ 64 318 313 301  11],345,5,27774,4.286772650100324,60.0,20.0
36479,3,6479,[ 64 318 313 301  11],345,5,27779,4.286882716049383,60.0,20.0
36480,3,6480,[127 210 323 423 742],805,1,27780,4.286375559327264,0.0,0.0
36481,3,6481,[ 64 318 313 301  11],345,5,27785,4.286485652576365,60.0,20.0
36482,3,6482,[ 64 318 313 301  11],345,5,27790,4.286595711861793,60.0,20.0
36483,3,6483,[ 95 257  82 286 405],43,5,27795,4.286705737199259,0.0,0.0
36484,3,6484,[121 118 496 238 237],128,5,27800,4.286815728604472,0.0,0.0
36485,3,6485,[ 25 271  12 153 318],43,4,27804,4.28677150786309,40.0,0.0
36486,3,6486,[ 64 318 313 301  11],416,5,27809,4.286881455218128,60.0,20.0
36487,3,6487,[143  79   4 100 273],805,2,27811,4.286528976572133,0.0,0.0
36488,3,6488,[ 64 318 313 301  11],345,5,27816,4.286638927415626,60.0,20.0
36489,3,6489,[ 64 318 313 301  11],43,5,27821,4.286748844375963,60.0,20.0
36490,3,6490,[ 64 318 313 301  11],345,5,27826,4.286858727468803,60.0,20.0
36491,3,6491,[ 64 318 313 301  11],43,5,27831,4.286968576709796,60.0,20.0
36492,3,6492,[568  50  22 216 195],654,5,27836,4.2870783921145845,0.0,20.0
36493,3,6493,[ 64 318 313 301  11],416,5,27841,4.287188173698799,60.0,20.0
36494,3,6494,[121 257 275 333 286],416,4,27845,4.287143956889915,0.0,0.0
36495,3,6495,[ 64 318 313 301  11],416,5,27850,4.287253694581281,60.0,20.0
36496,3,6496,[ 64 318 313 301  11],416,5,27855,4.287363398491611,60.0,20.0
36497,3,6497,[ 64 318 313 301  11],43,5,27860,4.287473068636504,60.0,20.0
36498,3,6498,[ 64 318 313 301  11],416,5,27865,4.287582705031543,60.0,20.0
36499,3,6499,[ 64 318 313 301  11],43,5,27870,4.287692307692308,60.0,20.0
36500,3,6500,[ 64 318 313 301  11],345,5,27875,4.287801876634364,60.0,20.0
36501,3,6501,[ 64 318 313 301  11],43,5,27880,4.28791141187327,60.0,20.0
36502,3,6502,[ 64 318 313 301  11],345,5,27885,4.288020913424574,60.0,20.0
36503,3,6503,[ 64 318 313 301  11],345,5,27890,4.288130381303813,60.0,20.0
36504,3,6504,[ 64 318 313 301  11],416,5,27895,4.288239815526518,60.0,20.0
36505,3,6505,[423 235   1 111 742],297,0,27895,4.287580694743314,0.0,0.0
36506,3,6506,[ 64 318 313 301  11],345,5,27900,4.287690179806362,60.0,20.0
36507,3,6507,[ 64 318 313 301  11],416,5,27905,4.28779963122311,60.0,20.0
36508,3,6508,[132 153 265  82 276],437,3,27908,4.287601782147795,0.0,0.0
36509,3,6509,[ 64 318 313 301  11],43,5,27913,4.287711213517665,60.0,20.0
36510,3,6510,[427   8 127 196 228],601,3,27916,4.287513438795884,0.0,0.0
36511,3,6511,[ 97 276 117  82 100],43,5,27921,4.28762285012285,0.0,0.0
36512,3,6512,[176 185 288  11 127],417,3,27924,4.287425149700598,0.0,20.0
36513,3,6513,[ 64 318 313 301  11],416,5,27929,4.28753454098864,60.0,20.0
36514,3,6514,[172 275 211 204 235],43,4,27933,4.287490406753645,0.0,0.0
36515,3,6515,[ 64 318 313 301  11],345,5,27938,4.287599754450583,60.0,20.0
36516,3,6516,[ 69 235 172 268 322],417,1,27939,4.287095289243517,0.0,0.0
36517,3,6517,[ 64 318 313 301  11],416,5,27944,4.287204664007365,60.0,20.0
36518,3,6518,[ 64 318 313 301  11],43,5,27949,4.287314005215523,60.0,20.0
36519,3,6519,[ 64 318 313 301  11],416,5,27954,4.287423312883435,60.0,20.0
36520,3,6520,[ 64 318 313 301  11],43,5,27959,4.287532587026529,60.0,20.0
36521,3,6521,[121 176   8  50 196],805,2,27961,4.287181846059491,0.0,20.0
36522,3,6522,[ 50 435  69 174 176],230,5,27966,4.287291123716082,0.0,20.0
36523,3,6523,[ 64 318 313 301  11],416,5,27971,4.287400367872471,60.0,20.0
36524,3,6524,[ 64 318 313 301  11],43,5,27976,4.287509578544062,60.0,20.0
36525,3,6525,[211 496 153 117  64],43,5,27981,4.287618755746246,20.0,0.0
36526,3,6526,[ 64 318 313 301  11],416,5,27986,4.287727899494408,60.0,20.0
36527,3,6527,[ 64 318 313 301  11],416,5,27991,4.287837009803922,60.0,20.0
36528,3,6528,[ 64 318 313 301  11],416,5,27996,4.287946086690152,60.0,20.0
36529,3,6529,[322  15  28 204  56],314,4,28000,4.287901990811639,0.0,0.0
36530,3,6530,[ 64 318 313 301  11],345,5,28005,4.28801102434543,60.0,20.0
36531,3,6531,[ 64 318 313 301  11],43,5,28010,4.288120024494795,60.0,20.0
36532,3,6532,[195 180 275 288  28],437,2,28012,4.287769784172662,0.0,20.0
36533,3,6533,[197 202 144 172 265],416,5,28017,4.287878787878788,0.0,0.0
36534,3,6534,[ 64 318 313 301  11],416,5,28022,4.287987758224943,60.0,20.0
36535,3,6535,[ 64 318 313 301  11],416,5,28027,4.2880966952264385,60.0,20.0
36536,3,6536,[ 64 318 313 301  11],345,5,28032,4.288205598898577,60.0,20.0
36537,3,6537,[ 64 318 313 301  11],345,5,28037,4.288314469256654,60.0,20.0
36538,3,6538,[187 144 118 125 471],618,2,28039,4.287964520568894,0.0,0.0
36539,3,6539,[ 64 318 313 301  11],43,5,28044,4.288073394495413,60.0,20.0
36540,3,6540,[ 64 318 313 301  11],345,5,28049,4.2881822351322425,60.0,20.0
36541,3,6541,[ 64 318 313 301  11],345,5,28054,4.28829104249465,60.0,20.0
36542,3,6542,[ 11   8  64 172 127],416,5,28059,4.288399816597891,20.0,0.0
36543,3,6543,[ 64 318 313 301  11],345,5,28064,4.288508557457213,60.0,20.0
36544,3,6544,[300 173 385 403 268],345,2,28066,4.288158899923606,0.0,0.0
36545,3,6545,[ 64 318 313 301  11],43,5,28071,4.2882676443629695,60.0,20.0
36546,3,6546,[ 64 318 313 301  11],43,5,28076,4.2883763555827095,60.0,20.0
36547,3,6547,[ 64 318 313 301  11],416,5,28081,4.288485033598045,60.0,20.0
36548,3,6548,[ 64 318 313 301  11],345,5,28086,4.288593678424187,60.0,20.0
36549,3,6549,[  9 471 323 185 182],416,4,28090,4.28854961832061,0.0,0.0
36550,3,6550,[179 257 483 118  95],751,4,28094,4.2885055716684475,20.0,0.0
36551,3,6551,[ 64 318 313 301  11],345,5,28099,4.288614163614164,60.0,20.0
36552,3,6552,[ 64 318 313 301  11],416,5,28104,4.288722722417213,60.0,20.0
36553,3,6553,[ 69 268 515  70 183],417,4,28108,4.2886786695148,0.0,0.0
36554,3,6554,[546 127 288 302 475],62,3,28111,4.288482074752098,0.0,20.0
36555,3,6555,[ 71 183 181  69 405],230,4,28115,4.288438071995119,0.0,20.0
36556,3,6556,[ 64 318 313 301  11],416,5,28120,4.288546591429007,60.0,20.0
36557,3,6557,[ 64 318 313 301  11],43,5,28125,4.288655077767612,60.0,20.0
36558,3,6558,[ 64 318 313 301  11],345,5,28130,4.288763531026071,60.0,20.0
36559,3,6559,[ 25 216 475 182 300],297,3,28133,4.288567073170731,0.0,0.0
36560,3,6560,[ 64 318 313 301  11],416,5,28138,4.288675506782503,60.0,20.0
36561,3,6561,[ 12  97 181 196 588],297,5,28143,4.288783907345321,20.0,20.0
36562,3,6562,[ 64 318 313 301  11],416,5,28148,4.2888922748742955,60.0,20.0
36563,3,6563,[748 273 323 117 588],416,4,28152,4.288848263254113,0.0,0.0
36564,3,6564,[228 597  25 135  56],805,3,28155,4.288651942117289,0.0,0.0
36565,3,6565,[ 64 318 313 301  11],416,5,28160,4.288760280231496,60.0,20.0
36566,3,6566,[215 588  89  79 191],437,2,28162,4.288411755748439,0.0,0.0
36567,3,6567,[ 64 318 313 301  11],345,5,28167,4.288520097442143,60.0,20.0
36568,3,6568,[ 64 318 313 301  11],416,5,28172,4.2886284061500985,60.0,20.0
36569,3,6569,[357 179 323 222 748],721,3,28175,4.288432267884323,0.0,0.0
36570,3,6570,[ 64 318 313 301  11],43,5,28180,4.288540556992848,60.0,20.0
36571,3,6571,[245 143 471 385 300],416,4,28184,4.288496652465003,0.0,0.0
36572,3,6572,[ 70 197  28 176 300],297,3,28187,4.288300623763883,0.0,0.0
36573,3,6573,[ 64 318 313 301  11],345,5,28192,4.288408883480377,60.0,20.0
36574,3,6574,[238 186 405 153  96],417,3,28195,4.288212927756654,0.0,0.0
36575,3,6575,[  7  98 323  89 182],417,3,28198,4.2880170316301705,0.0,20.0
36576,3,6576,[125 655 215 153 235],416,4,28202,4.287973240079063,0.0,0.0
36577,3,6577,[ 98 258 204  22  28],262,3,28205,4.287777439951353,0.0,20.0
36578,3,6578,[ 64 318 313 301  11],416,5,28210,4.287885696914425,60.0,20.0
36579,3,6579,[ 64 318 313 301  11],345,5,28215,4.287993920972644,60.0,20.0
36580,3,6580,[ 64 318 313 301  11],416,5,28220,4.288102112141012,60.0,20.0
36581,3,6581,[127  50 185 117  98],198,3,28223,4.287906411425099,0.0,40.0
36582,3,6582,[172 111 328 153 196],62,3,28226,4.287710770165578,0.0,0.0
36583,3,6583,[ 64 318 313 301  11],43,5,28231,4.287818955042527,60.0,20.0
36584,3,6584,[ 64 318 313 301  11],345,5,28236,4.2879271070615035,60.0,20.0
36585,3,6585,[ 64 318 313 301  11],416,5,28241,4.288035226237473,60.0,20.0
36586,3,6586,[ 50  28 265 211 588],297,4,28245,4.287991498405951,0.0,20.0
36587,3,6587,[ 64 318 313 301  11],43,5,28250,4.2880995749848205,60.0,20.0
36588,3,6588,[ 64 318 313 301  11],43,5,28255,4.288207618758537,60.0,20.0
36589,3,6589,[ 64 318 313 301  11],416,5,28260,4.2883156297420335,60.0,20.0
36590,3,6590,[ 64 318 313 301  11],43,5,28265,4.288423607950235,60.0,20.0
36591,3,6591,[ 64 318 313 301  11],43,5,28270,4.288531553398058,60.0,20.0
36592,3,6592,[435  56 237 515 183],230,3,28273,4.288336114060367,0.0,0.0
36593,3,6593,[ 64 318 313 301  11],345,5,28278,4.288444040036397,60.0,20.0
36594,3,6594,[ 64 318 313 301  11],416,5,28283,4.28855193328279,60.0,20.0
36595,3,6595,[111 210 483 153 597],62,3,28286,4.2883565797453,20.0,0.0
36596,3,6596,[132 210  25 161 265],588,5,28291,4.288464453539488,0.0,0.0
36597,3,6597,[ 64 318 313 301  11],43,5,28296,4.288572294634738,60.0,20.0
36598,3,6598,[100  25 186  98 275],43,4,28300,4.288528564934081,0.0,20.0
36599,3,6599,[ 64 318 313 301  11],345,5,28305,4.288636363636364,60.0,20.0
36600,3,6600,[ 64 318 313 301  11],43,5,28310,4.288744129677322,60.0,20.0
36601,3,6601,[181 100 268 118 222],32,2,28312,4.288397455316571,0.0,20.0
36602,3,6602,[ 64 318 313 301  11],43,5,28317,4.288505224897774,60.0,20.0
36603,3,6603,[ 64 318 313 301  11],416,5,28322,4.2886129618413085,60.0,20.0
36604,3,6604,[ 82  15  28 197 111],437,2,28324,4.288266464799395,0.0,0.0
36605,3,6605,[ 64 318 313 301  11],416,5,28329,4.288374205267938,60.0,20.0
36606,3,6606,[196   4 204 183  79],805,2,28331,4.288027849250795,0.0,0.0
36607,3,6607,[186  98 200 286   1],854,2,28333,4.287681598062954,0.0,20.0
36608,3,6608,[ 64 318 313 301  11],43,5,28338,4.287789378120745,60.0,20.0
36609,3,6609,[  7 100 200 568 496],618,5,28343,4.287897125567322,0.0,0.0
36610,3,6610,[ 64 318 313 301  11],416,5,28348,4.288004840417486,60.0,20.0
36611,3,6611,[289 111 588  88 194],416,3,28351,4.287810042347248,0.0,0.0
36612,3,6612,[508 194 135 748 301],297,3,28354,4.287615303190685,0.0,0.0
36613,3,6613,[ 28  88 588  98 202],43,5,28359,4.287723011793166,0.0,20.0
36614,3,6614,[301 475 269 435 135],297,4,28363,4.287679516250945,0.0,0.0
36615,3,6615,[ 64 318 313 301  11],43,5,28368,4.287787182587667,60.0,20.0
36616,3,6616,[300 181 742 546   4],43,5,28373,4.287894816382046,0.0,20.0
36617,3,6617,[ 64 318 313 301  11],345,5,28378,4.288002417648837,60.0,20.0
36618,3,6618,[ 64 318 313 301  11],345,5,28383,4.28810998640278,60.0,20.0
36619,3,6619,[ 28 100  79 546 202],805,2,28385,4.287764350453172,0.0,0.0
36620,3,6620,[173 475 161 211 215],437,2,28387,4.28741881890953,0.0,0.0
36621,3,6621,[323  25 357 568 168],198,2,28389,4.2870733917245545,0.0,0.0
36622,3,6622,[ 88 161  71 288 176],416,4,28393,4.287030046806583,0.0,20.0
36623,3,6623,[ 82 132 174 135 588],618,5,28398,4.28713768115942,0.0,0.0
36624,3,6624,[173 294 289 286 191],721,2,28400,4.286792452830189,0.0,0.0
36625,3,6625,[318 173 210 235 237],43,4,28404,4.286749169936614,20.0,0.0
36626,3,6626,[471 385 181  25 144],618,3,28407,4.2865550022634675,0.0,20.0
36627,3,6627,[ 64 318 313 301  11],345,5,28412,4.286662643331321,60.0,20.0
36628,3,6628,[191 168 144   8 273],416,5,28417,4.286770251923367,0.0,0.0
36629,3,6629,[ 64 318 313 301  11],416,5,28422,4.2868778280542985,60.0,20.0
36630,3,6630,[ 64 318 313 301  11],416,5,28427,4.286985371738803,60.0,20.0
36631,3,6631,[ 64 318 313 301  11],416,5,28432,4.287092882991556,60.0,20.0
36632,3,6632,[ 96 132   1 121   7],416,5,28437,4.287200361827227,0.0,0.0
36633,3,6633,[ 64 318 313 301  11],345,5,28442,4.2873078082604765,60.0,20.0
36634,3,6634,[197 323  50  12  70],345,4,28446,4.287264506405426,20.0,20.0
36635,3,6635,[ 64 318 313 301  11],43,5,28451,4.287371910789632,60.0,20.0
36636,3,6636,[ 64 318 313 301  11],416,5,28456,4.287479282808498,60.0,20.0
36637,3,6637,[ 82 508 483 181 151],417,3,28459,4.287285326905694,20.0,20.0
36638,3,6638,[204  64  96 182 515],416,5,28464,4.2873926796204245,20.0,0.0
36639,3,6639,[ 64 318 313 301  11],43,5,28469,4.2875,60.0,20.0
36640,3,6640,[ 64 318 313 301  11],43,5,28474,4.287607288059028,60.0,20.0
36641,3,6641,[181  97 143 483 118],128,4,28478,4.287563986750978,20.0,20.0
36642,3,6642,[ 64 318 313 301  11],416,5,28483,4.287671232876712,60.0,20.0
36643,3,6643,[197 172 288 195  50],416,5,28488,4.2877784467188444,0.0,40.0
36644,3,6644,[ 64 318 313 301  11],345,5,28493,4.287885628291948,60.0,20.0
36645,3,6645,[ 64 318 313 301  11],345,5,28498,4.287992777610593,60.0,20.0
36646,3,6646,[ 64 318 313 301  11],43,5,28503,4.288099894689333,60.0,20.0
36647,3,6647,[ 64 318 313 301  11],43,5,28508,4.28820697954272,60.0,20.0
36648,3,6648,[357  15 117 222 111],630,3,28511,4.288013235072944,0.0,0.0
36649,3,6649,[ 64 318 313 301  11],345,5,28516,4.2881203007518796,60.0,20.0
36650,3,6650,[181 121 100 496  97],618,5,28521,4.2882273342354535,0.0,20.0
36651,3,6651,[ 64 318 313 301  11],345,5,28526,4.288334335538184,60.0,20.0
36652,3,6652,[597 265  28 275 258],588,4,28530,4.288290996542913,0.0,0.0
36653,3,6653,[ 64 318 313 301  11],43,5,28535,4.288397956116621,60.0,20.0
36654,3,6654,[125  89 357 191   7],62,5,28540,4.288504883546206,0.0,0.0
36655,3,6655,[742 204 273 300  50],416,5,28545,4.288611778846154,0.0,20.0
36656,3,6656,[ 64 318 313 301  11],345,5,28550,4.288718642030945,60.0,20.0
36657,3,6657,[ 15 318 200  50   9],274,5,28555,4.2888254731150495,20.0,20.0
36658,3,6658,[ 64 318 313 301  11],43,5,28560,4.2889322721129295,60.0,20.0
36659,3,6659,[ 64 318 313 301  11],43,5,28565,4.289039039039039,60.0,20.0
36660,3,6660,[ 64 318 313 301  11],416,5,28570,4.289145773907822,60.0,20.0
36661,3,6661,[238 271 182 173 194],297,2,28572,4.288802161513059,0.0,0.0
36662,3,6662,[ 64 318 313 301  11],345,5,28577,4.288908899894942,60.0,20.0
36663,3,6663,[ 64 318 313 301  11],345,5,28582,4.289015606242497,60.0,20.0
36664,3,6664,[ 64 318 313 301  11],345,5,28587,4.289122280570142,60.0,20.0
36665,3,6665,[179 118  79  70 403],416,3,28590,4.288928892889289,0.0,0.0
36666,3,6666,[ 64 318 313 301  11],345,5,28595,4.289035548222589,60.0,20.0
36667,3,6667,[ 64 318 313 301  11],345,5,28600,4.289142171565687,60.0,20.0
36668,3,6668,[ 64 318 313 301  11],416,5,28605,4.289248762932973,60.0,20.0
36669,3,6669,[322  50 127  11  96],416,4,28609,4.289205397301349,0.0,20.0
36670,3,6670,[ 64 318 313 301  11],345,5,28614,4.289311947234298,60.0,20.0
36671,3,6671,[ 64 318 313 301  11],416,5,28619,4.289418465227818,60.0,20.0
36672,3,6672,[ 64 318 313 301  11],345,5,28624,4.2895249512962685,60.0,20.0
36673,3,6673,[180 265  25 168 235],417,2,28626,4.289181899910099,0.0,0.0
36674,3,6674,[271  69 300  22 385],505,4,28630,4.289138576779027,0.0,0.0
36675,3,6675,[258 210 174 286 121],588,4,28634,4.289095266626723,0.0,0.0
36676,3,6676,[215 132 173 275 742],588,4,28638,4.289051969447357,0.0,0.0
36677,3,6677,[ 64 405 215 655 175],198,3,28641,4.288858939802336,20.0,0.0
36678,3,6678,[ 64 318 313 301  11],345,5,28646,4.28896541398413,60.0,20.0
36679,3,6679,[302 515  56 132 195],417,4,28650,4.288922155688622,0.0,0.0
36680,3,6680,[357 196 195 234  96],198,2,28652,4.288579553958988,0.0,0.0
36681,3,6681,[748 100  95 286 215],416,4,28656,4.288536366357378,0.0,0.0
36682,3,6682,[ 64 318 313 301  11],43,5,28661,4.288642825078558,60.0,20.0
36683,3,6683,[194 301 257 471 313],416,4,28665,4.2885996409335725,20.0,20.0
36684,3,6684,[ 64 318 313 301  11],43,5,28670,4.288706058339566,60.0,20.0
36685,3,6685,[ 15 195 475 215 294],62,2,28672,4.288363745139097,0.0,0.0
36686,3,6686,[121 186  95 313 153],43,4,28676,4.288320622102587,20.0,20.0
36687,3,6687,[597 245 182 748 151],417,4,28680,4.288277511961723,0.0,0.0
36688,3,6688,[ 64 318 313 301  11],416,5,28685,4.288383913888474,60.0,20.0
36689,3,6689,[ 64 318 313 301  11],345,5,28690,4.288490284005979,60.0,20.0
36690,3,6690,[286 204 475  82 196],416,4,28694,4.288447167837393,0.0,0.0
36691,3,6691,[  7 215 301 179 202],416,4,28698,4.288404064554692,0.0,0.0
36692,3,6692,[  1   7 269 135 257],297,3,28701,4.288211564320933,0.0,0.0
36693,3,6693,[ 64 318 313 301  11],416,5,28706,4.288317896623842,60.0,20.0
36694,3,6694,[385 357  96 568  89],642,3,28709,4.288125466766243,0.0,0.0
36695,3,6695,[179 100 118 196   9],62,4,28713,4.288082437275985,0.0,0.0
36696,3,6696,[ 64 318 313 301  11],416,5,28718,4.288188741227415,60.0,20.0
36697,3,6697,[258 288 238 204 269],416,5,28723,4.288295013436847,0.0,20.0
36698,3,6698,[161   9 197 235  56],416,4,28727,4.288251977907151,0.0,0.0
36699,3,6699,[ 64 318 313 301  11],345,5,28732,4.2883582089552235,60.0,20.0
36700,3,6700,[ 64 318 313 301  11],345,5,28737,4.288464408297269,60.0,20.0
36701,3,6701,[ 64 318 313 301  11],345,5,28742,4.288570575947478,60.0,20.0
36702,3,6702,[265 301  69 179 125],416,4,28746,4.288527524988811,0.0,0.0
36703,3,6703,[ 64 318 313 301  11],345,5,28751,4.288633651551312,60.0,20.0
36704,3,6704,[143 161   9 294 597],314,5,28756,4.288739746457868,0.0,0.0
36705,3,6705,[423 194 546  70 185],416,4,28760,4.288696689531762,0.0,0.0
36706,3,6706,[ 64 318 313 301  11],345,5,28765,4.288802743402416,60.0,20.0
36707,3,6707,[176  98 143 173 271],805,3,28768,4.2886106141920095,0.0,20.0
36708,3,6708,[215 196 204  97 100],416,5,28773,4.288716649277091,0.0,0.0
36709,3,6709,[ 64 318 313 301  11],416,5,28778,4.288822652757079,60.0,20.0
36710,3,6710,[403 144 222 143 181],43,5,28783,4.288928624646103,0.0,20.0
36711,3,6711,[ 64 318 313 301  11],345,5,28788,4.289034564958284,60.0,20.0
36712,3,6712,[ 64 318 313 301  11],416,5,28793,4.289140473707731,60.0,20.0
36713,3,6713,[ 64 318 313 301  11],345,5,28798,4.28924635090855,60.0,20.0
36714,3,6714,[111 357 742  64 100],630,3,28801,4.289054355919583,20.0,0.0
36715,3,6715,[222  96  98  88  12],805,4,28805,4.289011316259678,20.0,20.0
36716,3,6716,[588 235  98 655  79],805,2,28807,4.288670537442311,0.0,20.0
36717,3,6717,[ 64 318 313 301  11],43,5,28812,4.288776421554034,60.0,20.0
36718,3,6718,[ 64 318 313 301  11],43,5,28817,4.288882274147939,60.0,20.0
36719,3,6719,[181   4  64 228 288],417,1,28818,4.288392857142857,20.0,40.0
36720,3,6720,[ 64 318 313 301  11],43,5,28823,4.288498735307246,60.0,20.0
36721,3,6721,[ 64 318 313 301  11],416,5,28828,4.288604581969652,60.0,20.0
36722,3,6722,[ 64 318 313 301  11],43,5,28833,4.288710397144132,60.0,20.0
36723,3,6723,[ 64 318 313 301  11],43,5,28838,4.288816180844735,60.0,20.0
36724,3,6724,[ 64 318 313 301  11],416,5,28843,4.2889219330855015,60.0,20.0
36725,3,6725,[302 187 216 204 427],416,5,28848,4.2890276538804635,0.0,0.0
36726,3,6726,[ 64 318 313 301  11],43,5,28853,4.289133343243645,60.0,20.0
36727,3,6727,[294 588 301  98   1],345,2,28855,4.288793103448276,0.0,20.0
36728,3,6728,[ 79 117  50 265  25],654,4,28859,4.2887501857631145,0.0,20.0
36729,3,6729,[  9  25  69 603 127],854,4,28863,4.288707280832095,0.0,0.0
36730,3,6730,[ 64 318 313 301  11],345,5,28868,4.288812954984401,60.0,20.0
36731,3,6731,[ 64 318 313 301  11],416,5,28873,4.288918597742128,60.0,20.0
36732,3,6732,[ 64 318 313 301  11],43,5,28878,4.289024209119264,60.0,20.0
36733,3,6733,[185  28 403 237   4],416,4,28882,4.288981288981289,0.0,0.0
36734,3,6734,[ 88 204 144 143  89],805,1,28883,4.288492947290274,0.0,0.0
36735,3,6735,[ 64 318 313 301  11],416,5,28888,4.288598574821853,60.0,20.0
36736,3,6736,[ 64 318 313 301  11],43,5,28893,4.2887041709959925,60.0,20.0
36737,3,6737,[ 64 318 313 301  11],43,5,28898,4.288809735826654,60.0,20.0
36738,3,6738,[100 187 678 273  69],416,4,28902,4.288766879358955,0.0,0.0
36739,3,6739,[ 64 318 313 301  11],345,5,28907,4.2888724035608305,60.0,20.0
36740,3,6740,[ 64 318 313 301  11],416,5,28912,4.288977896454532,60.0,20.0
36741,3,6741,[127 197  95 234 121],198,2,28914,4.288638386235538,0.0,0.0
36742,3,6742,[257 118 174  71 121],541,4,28918,4.288595580602106,0.0,0.0
36743,3,6743,[ 64 318 313 301  11],345,5,28923,4.2887010676156585,60.0,20.0
36744,3,6744,[ 64 318 313 301  11],416,5,28928,4.2888065233506305,60.0,20.0
36745,3,6745,[181   1 204  97  98],43,5,28933,4.288911947820931,0.0,40.0
36746,3,6746,[289   9  28 191 216],43,5,28938,4.289017341040463,0.0,0.0
36747,3,6747,[  8   1   9 403 238],805,3,28941,4.288826318909306,0.0,0.0
36748,3,6748,[ 64 318 313 301  11],416,5,28946,4.288931693584234,60.0,20.0
36749,3,6749,[ 64 318 313 301  11],416,5,28951,4.289037037037037,60.0,20.0
36750,3,6750,[257 172 197 588 238],416,4,28955,4.288994223078062,0.0,0.0
36751,3,6751,[ 64 318 313 301  11],43,5,28960,4.289099526066351,60.0,20.0
36752,3,6752,[215 117 678 515 275],416,4,28964,4.289056715533837,0.0,0.0
36753,3,6753,[ 95 127 597  64  28],416,3,28967,4.288865857269766,20.0,0.0
36754,3,6754,[ 64 318 313 301  11],345,5,28972,4.288971132494448,60.0,20.0
36755,3,6755,[143  95 678  89   9],805,2,28974,4.288632326820604,0.0,0.0
36756,3,6756,[ 64 318 313 301  11],345,5,28979,4.288737605446204,60.0,20.0
36757,3,6757,[ 64 318 313 301  11],43,5,28984,4.288842852915064,60.0,20.0
36758,3,6758,[ 70 143 100 173 603],297,5,28989,4.288948069241012,0.0,0.0
36759,3,6759,[ 64 318 313 301  11],416,5,28994,4.28905325443787,60.0,20.0
36760,3,6760,[483  22 238 294 175],214,3,28997,4.288862594290785,20.0,0.0
36761,3,6761,[121  69 322 127 268],854,2,28999,4.288524105294291,0.0,0.0
36762,3,6762,[182 245  22 603 161],416,4,29003,4.288481443146533,0.0,0.0
36763,3,6763,[222 135 176 238 182],198,4,29007,4.288438793613246,0.0,0.0
36764,3,6764,[ 64 318 313 301  11],416,5,29012,4.288543976348854,60.0,20.0
36765,3,6765,[ 64 318 313 301  11],416,5,29017,4.2886491279929055,60.0,20.0
36766,3,6766,[127  69 216  89  50],405,3,29020,4.288458696615931,0.0,20.0
36767,3,6767,[245 323 294 195  82],416,3,29023,4.288268321513002,0.0,0.0
36768,3,6768,[508 238 257 385 216],417,2,29025,4.287930270350126,0.0,0.0
36769,3,6769,[ 64 318 313 301  11],345,5,29030,4.288035450516987,60.0,20.0
36770,3,6770,[ 64 318 313 301  11],345,5,29035,4.28814059961601,60.0,20.0
36771,3,6771,[234 235 294 322 286],416,3,29038,4.287950383933845,0.0,0.0
36772,3,6772,[385 117  25 257 118],751,4,29042,4.287907869481766,0.0,0.0
36773,3,6773,[ 64 318 313 301  11],43,5,29047,4.288012990847357,60.0,20.0
36774,3,6774,[ 64 318 313 301  11],416,5,29052,4.288118081180812,60.0,20.0
36775,3,6775,[302 181   9 289 405],345,4,29056,4.288075560802834,0.0,20.0
36776,3,6776,[ 64 318 313 301  11],416,5,29061,4.288180610889774,60.0,20.0
36777,3,6777,[ 64 318 313 301  11],43,5,29066,4.288285629979345,60.0,20.0
36778,3,6778,[173 427 172  15  79],198,3,29069,4.288095589319958,0.0,0.0
36779,3,6779,[294  88 173 597 121],642,5,29074,4.288200589970502,0.0,0.0
36780,3,6780,[ 64 318 313 301  11],416,5,29079,4.288305559651969,60.0,20.0
36781,3,6781,[ 64 318 313 301  11],43,5,29084,4.2884104983780595,60.0,20.0
36782,3,6782,[ 64 318 313 301  11],43,5,29089,4.288515406162465,60.0,20.0
36783,3,6783,[173 328 228 423  50],62,2,29091,4.2881780660377355,0.0,20.0
36784,3,6784,[ 64 318 313 301  11],345,5,29096,4.2882829771554904,60.0,20.0
36785,3,6785,[ 64 318 313 301  11],43,5,29101,4.288387857353374,60.0,20.0
36786,3,6786,[475 300  71 121 180],198,1,29102,4.287903344629439,0.0,0.0
36787,3,6787,[ 64 318 313 301  11],345,5,29107,4.288008249852681,60.0,20.0
36788,3,6788,[ 64 318 313 301  11],345,5,29112,4.288113124171454,60.0,20.0
36789,3,6789,[ 64 318 313 301  11],345,5,29117,4.288217967599411,60.0,20.0
36790,3,6790,[288 222 151  15  71],921,3,29120,4.288028272713886,0.0,20.0
36791,3,6791,[ 64 318 313 301  11],43,5,29125,4.288133097762073,60.0,20.0
36792,3,6792,[ 64 318 313 301  11],43,5,29130,4.288237891947593,60.0,20.0
36793,3,6793,[ 64 318 313 301  11],416,5,29135,4.288342655284074,60.0,20.0
36794,3,6794,[ 97 588 385  22 168],654,4,29139,4.288300220750552,0.0,0.0
36795,3,6795,[748   1  70 301 143],751,3,29142,4.288110653325486,0.0,0.0
36796,3,6796,[ 64 318 313 301  11],416,5,29147,4.288215389142269,60.0,20.0
36797,3,6797,[196  96 748 273 245],416,4,29151,4.288172992056487,0.0,0.0
36798,3,6798,[204 496  96  64 471],416,5,29156,4.288277687895278,20.0,0.0
36799,3,6799,[ 64 318 313 301  11],43,5,29161,4.288382352941176,60.0,20.0
36800,3,6800,[181 216  96 210 117],230,4,29165,4.288339950007352,0.0,20.0
36801,3,6801,[173 181 121  69   7],43,5,29170,4.288444575124963,0.0,20.0
36802,3,6802,[204  50 196 202 427],373,4,29174,4.288402175510804,0.0,20.0
36803,3,6803,[597 323  28 211 127],416,3,29177,4.288212815990594,0.0,0.0
36804,3,6804,[ 64 318 313 301  11],43,5,29182,4.288317413666422,60.0,20.0
36805,3,6805,[ 25  95  56 423 135],417,3,29185,4.2881281222450776,0.0,0.0
36806,3,6806,[ 64 318 313 301  11],345,5,29190,4.288232701630674,60.0,20.0
36807,3,6807,[144  64 475 655  12],417,4,29194,4.2881903642773205,40.0,0.0
36808,3,6808,[200 385 289 597 153],416,3,29197,4.288001174915553,0.0,0.0
36809,3,6809,[ 64 318 313 301  11],345,5,29202,4.288105726872247,60.0,20.0
36810,3,6810,[ 64 318 313 301  11],345,5,29207,4.288210248128028,60.0,20.0
36811,3,6811,[144 294 151 302 168],62,2,29209,4.287874339401057,0.0,0.0
36812,3,6812,[ 64 318 313 301  11],43,5,29214,4.2879788639365914,60.0,20.0
36813,3,6813,[ 64 318 313 301  11],416,5,29219,4.28808335779278,60.0,20.0
36814,3,6814,[ 64 318 313 301  11],416,5,29224,4.288187820983126,60.0,20.0
36815,3,6815,[186 194 603 568 161],405,2,29226,4.287852112676056,0.0,0.0
36816,3,6816,[ 64 318 313 301  11],43,5,29231,4.287956579140384,60.0,20.0
36817,3,6817,[588 435  98 183  11],405,2,29233,4.287621003226753,0.0,20.0
36818,3,6818,[ 64 318 313 301  11],345,5,29238,4.287725472943247,60.0,20.0
36819,3,6819,[174 238 234  22 318],405,5,29243,4.287829912023461,20.0,0.0
36820,3,6820,[ 64 318 313 301  11],416,5,29248,4.2879343204808675,60.0,20.0
36821,3,6821,[ 64 318 313 301  11],416,5,29253,4.288038698328935,60.0,20.0
36822,3,6822,[ 64 318 313 301  11],416,5,29258,4.288143045581123,60.0,20.0
36823,3,6823,[173 143 275 318 202],764,4,29262,4.28810082063306,20.0,0.0
36824,3,6824,[127 144 202 546 174],805,0,29262,4.287472527472527,0.0,0.0
36825,3,6825,[ 64 318 313 301  11],345,5,29267,4.287576911807793,60.0,20.0
36826,3,6826,[ 64 318 313 301  11],416,5,29272,4.287681265563205,60.0,20.0
36827,3,6827,[ 64 318 313 301  11],43,5,29277,4.287785588752197,60.0,20.0
36828,3,6828,[ 25 423 174  11 603],854,3,29280,4.287597012739786,0.0,0.0
36829,3,6829,[168   7 302 546 257],297,3,29283,4.287408491947291,0.0,0.0
36830,3,6830,[ 64 318 313 301  11],416,5,29288,4.28751280925194,60.0,20.0
36831,3,6831,[172 168 182  50 265],618,5,29293,4.287617096018735,0.0,20.0
36832,3,6832,[ 64 318 313 301  11],43,5,29298,4.2877213522610855,60.0,20.0
36833,3,6833,[135  89 118  12 185],417,3,29301,4.287532923617208,20.0,0.0
36834,3,6834,[ 64 318 313 301  11],345,5,29306,4.287637161667885,60.0,20.0
36835,3,6835,[ 64 318 313 301  11],43,5,29311,4.287741369221767,60.0,20.0
36836,3,6836,[183 144 151  82 276],437,2,29313,4.287406757349715,0.0,0.0
36837,3,6837,[222 196 210  56 328],62,4,29317,4.287364726528224,0.0,0.0
36838,3,6838,[ 12 117  15 183 748],437,3,29320,4.287176487790613,20.0,0.0
36839,3,6839,[ 64 318 313 301  11],416,5,29325,4.287280701754386,60.0,20.0
36840,3,6840,[ 64 318 313 301  11],43,5,29330,4.287384885250694,60.0,20.0
36841,3,6841,[ 64 318 313 301  11],345,5,29335,4.287489038292897,60.0,20.0
36842,3,6842,[  9 180 135 204 125],62,4,29339,4.287447026158118,0.0,0.0
36843,3,6843,[132 143 318 100  28],679,3,29342,4.287258912916423,20.0,0.0
36844,3,6844,[ 64 318 313 301  11],345,5,29347,4.28736303871439,60.0,20.0
36845,3,6845,[ 64 318 313 301  11],43,5,29352,4.287467134092901,60.0,20.0
36846,3,6846,[ 64 318 313 301  11],43,5,29357,4.287571199065284,60.0,20.0
36847,3,6847,[ 64 318 313 301  11],345,5,29362,4.28767523364486,60.0,20.0
36848,3,6848,[ 88 313 173 483 182],907,5,29367,4.287779237844941,40.0,20.0
36849,3,6849,[  4 100 173 182 423],49,1,29368,4.287299270072992,0.0,0.0
36850,3,6850,[216 258 496  97 215],416,5,29373,4.287403298788498,0.0,0.0
36851,3,6851,[ 64 318 313 301  11],345,5,29378,4.287507297139522,60.0,20.0
36852,3,6852,[ 64 318 313 301  11],345,5,29383,4.287611265139355,60.0,20.0
36853,3,6853,[ 64 318 313 301  11],43,5,29388,4.287715202801284,60.0,20.0
36854,3,6854,[ 64 318 313 301  11],345,5,29393,4.287819110138585,60.0,20.0
36855,3,6855,[275 173 294 405 403],62,3,29396,4.287631271878646,0.0,0.0
36856,3,6856,[186 174 185   8  98],230,5,29401,4.2877351611491905,0.0,20.0
36857,3,6857,[181 125 322 357  50],721,4,29405,4.28769320501604,0.0,40.0
36858,3,6858,[ 64 318 313 301  11],416,5,29410,4.2877970549642805,60.0,20.0
36859,3,6859,[496   7 748 151 405],416,4,29414,4.2877551020408164,0.0,0.0
36860,3,6860,[ 64 318 313 301  11],416,5,29419,4.287858912694943,60.0,20.0
36861,3,6861,[ 64 318 313 301  11],43,5,29424,4.287962693092393,60.0,20.0
36862,3,6862,[ 64 318 313 301  11],43,5,29429,4.288066443246394,60.0,20.0
36863,3,6863,[ 64 318 313 301  11],416,5,29434,4.288170163170163,60.0,20.0
36864,3,6864,[ 64 318 313 301  11],43,5,29439,4.2882738528769115,60.0,20.0
36865,3,6865,[ 64 318 313 301  11],416,5,29444,4.288377512379843,60.0,20.0
36866,3,6866,[546 111  28 423 289],223,3,29447,4.288189893694481,0.0,0.0
36867,3,6867,[ 64 318 313 301  11],345,5,29452,4.288293535235876,60.0,20.0
36868,3,6868,[ 64 318 313 301  11],43,5,29457,4.28839714660067,60.0,20.0
36869,3,6869,[ 64 318 313 301  11],416,5,29462,4.288500727802038,60.0,20.0
36870,3,6870,[ 64 318 313 301  11],43,5,29467,4.288604278853151,60.0,20.0
36871,3,6871,[ 64 318 313 301  11],416,5,29472,4.288707799767171,60.0,20.0
36872,3,6872,[ 64 318 313 301  11],43,5,29477,4.288811290557253,60.0,20.0
36873,3,6873,[ 64 318 313 301  11],416,5,29482,4.288914751236543,60.0,20.0
36874,3,6874,[257 237 228  15 185],921,1,29483,4.288436363636364,0.0,0.0
36875,3,6875,[ 64 318 313 301  11],345,5,29488,4.288539848749273,60.0,20.0
36876,3,6876,[127 313  89 174  56],405,4,29492,4.288497891522466,20.0,20.0
36877,3,6877,[ 64 318 313 301  11],43,5,29497,4.288601337598139,60.0,20.0
36878,3,6878,[168 655 508  25   1],128,3,29500,4.288414013664777,0.0,0.0
36879,3,6879,[568 125  11  88 117],505,4,29504,4.288372093023256,0.0,0.0
36880,3,6880,[ 64 318 313 301  11],345,5,29509,4.288475512280192,60.0,20.0
36881,3,6881,[ 64 318 313 301  11],345,5,29514,4.288578901482127,60.0,20.0
36882,3,6882,[ 64 318 313 301  11],416,5,29519,4.288682260642162,60.0,20.0
36883,3,6883,[496 655 288 125  69],588,1,29520,4.288204532248693,0.0,20.0
36884,3,6884,[ 64 318 313 301  11],43,5,29525,4.288307915758896,60.0,20.0
36885,3,6885,[143  96  25  11  28],618,3,29528,4.288120824862039,0.0,0.0
36886,3,6886,[ 64 318 313 301  11],345,5,29533,4.288224190503848,60.0,20.0
36887,3,6887,[151  11 265 143 187],618,4,29537,4.288182346109175,0.0,0.0
36888,3,6888,[ 82  64 508 265 182],128,5,29542,4.288285672811729,20.0,0.0
36889,3,6889,[ 64 318 313 301  11],416,5,29547,4.288388969521045,60.0,20.0
36890,3,6890,[ 64 318 313 301  11],416,5,29552,4.288492236250182,60.0,20.0
36891,3,6891,[ 64 318 313 301  11],416,5,29557,4.2885954730121885,60.0,20.0
36892,3,6892,[301 121 546 508 588],49,1,29558,4.288118380966198,0.0,0.0
36893,3,6893,[ 50 174 187 153 275],698,2,29560,4.287786480997969,0.0,20.0
36894,3,6894,[ 64 318 313 301  11],43,5,29565,4.28788977519942,60.0,20.0
36895,3,6895,[ 64 318 313 301  11],416,5,29570,4.287993039443156,60.0,20.0
36896,3,6896,[ 64 318 313 301  11],43,5,29575,4.288096273742207,60.0,20.0
36897,3,6897,[ 64 318 313 301  11],43,5,29580,4.288199478109597,60.0,20.0
36898,3,6898,[ 64 318 313 301  11],416,5,29585,4.288302652558341,60.0,20.0
36899,3,6899,[ 64 318 313 301  11],43,5,29590,4.288405797101449,60.0,20.0
36900,3,6900,[  8  89 300  50  71],705,3,29593,4.288219098681351,0.0,20.0
36901,3,6901,[ 64 318 313 301  11],345,5,29598,4.288322225441901,60.0,20.0
36902,3,6902,[ 64 318 313 301  11],43,5,29603,4.2884253223236275,60.0,20.0
36903,3,6903,[742   1 405  64 181],62,2,29605,4.288093858632677,20.0,20.0
36904,3,6904,[ 64 318 313 301  11],345,5,29610,4.288196958725561,60.0,20.0
36905,3,6905,[ 64 318 313 301  11],345,5,29615,4.288300028960324,60.0,20.0
36906,3,6906,[ 64 318 313 301  11],345,5,29620,4.288403069349934,60.0,20.0
36907,3,6907,[ 64 318 313 301  11],345,5,29625,4.2885060799073536,60.0,20.0
36908,3,6908,[228 151 385 318 179],373,3,29628,4.2883195831524095,20.0,0.0
36909,3,6909,[  8  95 175 210  64],43,4,29632,4.2882778581765555,20.0,0.0
36910,3,6910,[ 64 318 313 301  11],416,5,29637,4.288380842135726,60.0,20.0
36911,3,6911,[ 98  22 176 179 405],805,3,29640,4.288194444444445,0.0,20.0
36912,3,6912,[ 95 496 176 427  12],618,4,29644,4.288152755677709,20.0,0.0
36913,3,6913,[ 64 318 313 301  11],43,5,29649,4.288255713045993,60.0,20.0
36914,3,6914,[ 64 318 313 301  11],345,5,29654,4.288358640636298,60.0,20.0
36915,3,6915,[ 64 318 313 301  11],416,5,29659,4.288461538461538,60.0,20.0
36916,3,6916,[ 64 318 313 301  11],43,5,29664,4.288564406534625,60.0,20.0
36917,3,6917,[ 64 318 313 301  11],416,5,29669,4.288667244868459,60.0,20.0
36918,3,6918,[273 265 151  82 143],618,4,29673,4.288625523919642,0.0,0.0
36919,3,6919,[ 22 265 175 125  12],373,4,29677,4.288583815028901,20.0,0.0
36920,3,6920,[ 64 318 313 301  11],345,5,29682,4.288686605981795,60.0,20.0
36921,3,6921,[ 64 318 313 301  11],345,5,29687,4.288789367234903,60.0,20.0
36922,3,6922,[ 64 318 313 301  11],416,5,29692,4.288892098801098,60.0,20.0
36923,3,6923,[  7 483 135 276   4],618,3,29695,4.288705950317736,20.0,0.0
36924,3,6924,[245 204 282 333 294],721,2,29697,4.288375451263538,0.0,0.0
36925,3,6925,[ 64 318 313 301  11],43,5,29702,4.288478198094138,60.0,20.0
36926,3,6926,[ 64 318 313 301  11],43,5,29707,4.288580915259131,60.0,20.0
36927,3,6927,[ 64 318 313 301  11],43,5,29712,4.288683602771362,60.0,20.0
36928,3,6928,[228 195 179  96  95],405,1,29713,4.288208976764324,0.0,0.0
36929,3,6929,[403   8 202 132 238],405,5,29718,4.288311688311689,0.0,0.0
36930,3,6930,[ 64 318 313 301  11],43,5,29723,4.288414370220748,60.0,20.0
36931,3,6931,[ 64 318 313 301  11],345,5,29728,4.288517022504328,60.0,20.0
36932,3,6932,[ 64 318 313 301  11],43,5,29733,4.288619645175249,60.0,20.0
36933,3,6933,[ 98  69 211 168 215],43,5,29738,4.288722238246322,0.0,20.0
36934,3,6934,[ 64 318 313 301  11],345,5,29743,4.288824801730353,60.0,20.0
36935,3,6935,[ 64 318 313 301  11],345,5,29748,4.288927335640138,60.0,20.0
36936,3,6936,[ 64 318 313 301  11],43,5,29753,4.289029839988467,60.0,20.0
36937,3,6937,[ 64 318 313 301  11],345,5,29758,4.289132314788123,60.0,20.0
36938,3,6938,[ 64 318 313 301  11],345,5,29763,4.2892347600518805,60.0,20.0
36939,3,6939,[197 300 302 423 678],416,4,29767,4.289193083573487,0.0,0.0
36940,3,6940,[185 153 211 176   4],416,5,29772,4.28929549056332,0.0,0.0
36941,3,6941,[194  15 197 288 132],342,3,29775,4.289109766637856,0.0,20.0
36942,3,6942,[ 64 318 313 301  11],43,5,29780,4.289212156128475,60.0,20.0
36943,3,6943,[302 179 125   9  56],62,4,29784,4.289170506912442,0.0,0.0
36944,3,6944,[ 64 318 313 301  11],345,5,29789,4.289272858171346,60.0,20.0
36945,3,6945,[  1  79  28  50 125],588,4,29793,4.289231212208465,0.0,20.0
36946,3,6946,[515 546 211 265  11],416,4,29797,4.289189578235209,0.0,0.0
36947,3,6947,[204 195  25 111 508],654,3,29800,4.289004029936672,0.0,0.0
36948,3,6948,[ 64 318 313 301  11],345,5,29805,4.289106346236869,60.0,20.0
36949,3,6949,[ 28 118  71 228 132],62,2,29807,4.288776978417266,0.0,0.0
36950,3,6950,[ 25 294 196  70 322],416,4,29811,4.2887354337505394,0.0,0.0
36951,3,6951,[ 64 318 313 301  11],416,5,29816,4.288837744533947,60.0,20.0
36952,3,6952,[222 121 151 588 195],805,2,29818,4.288508557457213,0.0,0.0
36953,3,6953,[ 89  11 423 357  22],805,2,29820,4.288179465056083,0.0,0.0
36954,3,6954,[  4 496 405 385   1],417,2,29822,4.2878504672897195,0.0,0.0
36955,3,6955,[ 64 318 313 301  11],43,5,29827,4.287952846463485,60.0,20.0
36956,3,6956,[ 64 318 313 301  11],345,5,29832,4.288055196205261,60.0,20.0
36957,3,6957,[ 64 318 313 301  11],43,5,29837,4.288157516527738,60.0,20.0
36958,3,6958,[ 64 318 313 301  11],43,5,29842,4.288259807443598,60.0,20.0
36959,3,6959,[ 70 100 588 197 132],373,1,29843,4.287787356321839,0.0,0.0
36960,3,6960,[ 64 318 313 301  11],416,5,29848,4.287889671024278,60.0,20.0
36961,3,6961,[204  25 300 483 181],698,1,29849,4.287417408790577,20.0,20.0
36962,3,6962,[ 64 318 313 301  11],345,5,29854,4.287519747235387,60.0,20.0
36963,3,6963,[ 64 318 313 301  11],345,5,29859,4.2876220562894884,60.0,20.0
36964,3,6964,[ 96  22 173 427 423],373,4,29863,4.287580760947595,0.0,0.0
36965,3,6965,[ 64 318 313 301  11],416,5,29868,4.287683031869078,60.0,20.0
36966,3,6966,[ 64 318 313 301  11],345,5,29873,4.2877852734318935,60.0,20.0
36967,3,6967,[ 64 318 313 301  11],416,5,29878,4.28788748564868,60.0,20.0
36968,3,6968,[132 185   4 153 204],198,2,29880,4.287559190701679,0.0,0.0
36969,3,6969,[ 64 318 313 301  11],345,5,29885,4.287661406025825,60.0,20.0
36970,3,6970,[ 64 318 313 301  11],43,5,29890,4.2877635920241,60.0,20.0
36971,3,6971,[ 64 318 313 301  11],43,5,29895,4.287865748709122,60.0,20.0
36972,3,6972,[ 64 318 313 301  11],43,5,29900,4.287967876093504,60.0,20.0
36973,3,6973,[ 64 318 313 301  11],416,5,29905,4.288069974189848,60.0,20.0
36974,3,6974,[427 174 269 111 294],416,5,29910,4.288172043010753,0.0,0.0
36975,3,6975,[ 64 318 313 301  11],345,5,29915,4.288274082568807,60.0,20.0
36976,3,6976,[ 64 318 313 301  11],345,5,29920,4.288376092876595,60.0,20.0
36977,3,6977,[ 95 222 678 288 475],805,3,29923,4.288191458870736,0.0,20.0
36978,3,6978,[ 97 144 742 282 216],654,3,29926,4.288006877776185,0.0,0.0
36979,3,6979,[161   4 282  50 182],416,5,29931,4.28810888252149,0.0,20.0
36980,3,6980,[ 64 318 313 301  11],416,5,29936,4.28821085804326,60.0,20.0
36981,3,6981,[ 64 318 313 301  11],416,5,29941,4.288312804354053,60.0,20.0
36982,3,6982,[597 385  22   4 313],654,5,29946,4.2884147214664186,20.0,20.0
36983,3,6983,[403  97 179 153  70],417,5,29951,4.288516609392898,0.0,0.0
36984,3,6984,[ 64 318 313 301  11],345,5,29956,4.288618468146027,60.0,20.0
36985,3,6985,[ 64 318 313 301  11],345,5,29961,4.288720297738334,60.0,20.0
36986,3,6986,[ 64 318 313 301  11],416,5,29966,4.288822098182338,60.0,20.0
36987,3,6987,[ 64 318 313 301  11],416,5,29971,4.288923869490556,60.0,20.0
36988,3,6988,[111 237 143 333 245],345,3,29974,4.288739447703534,0.0,0.0
36989,3,6989,[ 64 318 313 301  11],416,5,29979,4.288841201716738,60.0,20.0
36990,3,6990,[ 64 318 313 301  11],43,5,29984,4.28894292661994,60.0,20.0
36991,3,6991,[ 64 318 313 301  11],416,5,29989,4.289044622425629,60.0,20.0
36992,3,6992,[ 64 318 313 301  11],43,5,29994,4.289146289146289,60.0,20.0
36993,3,6993,[ 64 318 313 301  11],416,5,29999,4.2892479267943955,60.0,20.0
36994,3,6994,[ 64 318 313 301  11],416,5,30004,4.289349535382416,60.0,20.0
36995,3,6995,[ 64 318 313 301  11],43,5,30009,4.289451114922813,60.0,20.0
36996,3,6996,[ 64 318 313 301  11],43,5,30014,4.28955266542804,60.0,20.0
36997,3,6997,[179  70  56 546 302],416,3,30017,4.289368390968848,0.0,0.0
36998,3,6998,[568   7 127 185  89],214,5,30022,4.289469924274896,0.0,0.0
36999,3,6999,[100 318 597 405 357],62,3,30025,4.289285714285715,20.0,0.0
37000,3,7000,[235 153 202  98 117],417,4,30029,4.289244393658048,0.0,20.0
37001,3,7001,[168 200 194 568 515],405,1,30030,4.288774635818338,0.0,0.0
37002,3,7002,[ 64 318 313 301  11],43,5,30035,4.288876195916036,60.0,20.0
37003,3,7003,[ 50 186 172  64  98],601,4,30039,4.288834951456311,20.0,40.0
37004,3,7004,[ 64 318 313 301  11],345,5,30044,4.288936473947181,60.0,20.0
37005,3,7005,[ 64 318 313 301  11],345,5,30049,4.289037967456466,60.0,20.0
37006,3,7006,[111 215  69  50 265],416,5,30054,4.289139431996575,0.0,20.0
37007,3,7007,[ 64 318 313 301  11],43,5,30059,4.289240867579909,60.0,20.0
37008,3,7008,[ 11 238 603 168 215],751,3,30062,4.28905692680839,0.0,0.0
37009,3,7009,[403  56  12 196 161],345,3,30065,4.288873038516405,20.0,0.0
37010,3,7010,[ 64 318 313 301  11],345,5,30070,4.2889744686920555,60.0,20.0
37011,3,7011,[ 64 318 313 301  11],345,5,30075,4.289075869937251,60.0,20.0
37012,3,7012,[ 64 318 313 301  11],43,5,30080,4.289177242264366,60.0,20.0
37013,3,7013,[143 427 357 210  79],405,5,30085,4.289278585685771,0.0,0.0
37014,3,7014,[234  88 258 257  97],416,3,30088,4.289094796863863,0.0,0.0
37015,3,7015,[ 64 318 313 301  11],43,5,30093,4.289196123147092,60.0,20.0
37016,3,7016,[ 64 318 313 301  11],43,5,30098,4.289297420550093,60.0,20.0
37017,3,7017,[423 100 191  50 195],618,4,30102,4.289256198347108,0.0,20.0
37018,3,7018,[ 64 318 313 301  11],43,5,30107,4.289357458327397,60.0,20.0
37019,3,7019,[ 64 318 313 301  11],416,5,30112,4.289458689458689,60.0,20.0
37020,3,7020,[175 603   9  25 568],805,3,30115,4.289275032046717,0.0,0.0
37021,3,7021,[202  12 151 168 265],618,3,30118,4.289091426943891,20.0,0.0
37022,3,7022,[  7 515  97 385 588],230,3,30121,4.288907874127865,0.0,0.0
37023,3,7023,[ 64 318 313 301  11],43,5,30126,4.289009111617312,60.0,20.0
37024,3,7024,[111  95 183 471 187],618,2,30128,4.288683274021352,0.0,0.0
37025,3,7025,[ 64 318 313 301  11],43,5,30133,4.2887845146598345,60.0,20.0
37026,3,7026,[496 143 568  12 318],654,5,30138,4.288885726483564,40.0,0.0
37027,3,7027,[ 64 318 313 301  11],416,5,30143,4.288986909504838,60.0,20.0
37028,3,7028,[161 100  70 546   1],43,5,30148,4.289088063735951,0.0,0.0
37029,3,7029,[ 64 318 313 301  11],345,5,30153,4.289189189189189,60.0,20.0
37030,3,7030,[ 64 318 313 301  11],43,5,30158,4.289290285876831,60.0,20.0
37031,3,7031,[ 64 318 313 301  11],416,5,30163,4.289391353811149,60.0,20.0
37032,3,7032,[ 64 318 313 301  11],345,5,30168,4.289492393004408,60.0,20.0
37033,3,7033,[ 64 318 313 301  11],43,5,30173,4.289593403468865,60.0,20.0
37034,3,7034,[496 191 742 118 546],43,5,30178,4.289694385216773,0.0,0.0
37035,3,7035,[ 64 318 313 301  11],416,5,30183,4.289795338260375,60.0,20.0
37036,3,7036,[ 64 318 313 301  11],416,5,30188,4.289896262611909,60.0,20.0
37037,3,7037,[ 64 318 313 301  11],345,5,30193,4.289997158283604,60.0,20.0
37038,3,7038,[187  88  69 197  22],405,4,30197,4.28995595965336,0.0,0.0
37039,3,7039,[ 64 318 313 301  11],43,5,30202,4.290056818181818,60.0,20.0
37040,3,7040,[ 64 318 313 301  11],345,5,30207,4.290157648061355,60.0,20.0
37041,3,7041,[216 258 300 195 132],198,3,30210,4.289974439079807,0.0,0.0
37042,3,7042,[ 64 318 313 301  11],43,5,30215,4.290075252023286,60.0,20.0
37043,3,7043,[742  88 268 471  96],416,4,30219,4.290034071550256,0.0,0.0
37044,3,7044,[ 64 318 313 301  11],345,5,30224,4.290134847409511,60.0,20.0
37045,3,7045,[ 64 318 313 301  11],345,5,30229,4.290235594663639,60.0,20.0
37046,3,7046,[185 181 238  64 121],214,4,30233,4.290194408968356,20.0,20.0
37047,3,7047,[121 237 174 508 265],654,4,30237,4.290153234960273,0.0,0.0
37048,3,7048,[191 294 257 237 328],416,3,30240,4.289970208540218,0.0,0.0
37049,3,7049,[423 132 588 144  71],437,2,30242,4.289645390070922,0.0,0.0
37050,3,7050,[ 64 318 313 301  11],345,5,30247,4.289746135299957,60.0,20.0
37051,3,7051,[ 64 318 313 301  11],43,5,30252,4.2898468519568915,60.0,20.0
37052,3,7052,[174 228 423 268 100],417,2,30254,4.289522189139373,0.0,0.0
37053,3,7053,[ 64 318 313 301  11],43,5,30259,4.289622908987808,60.0,20.0
37054,3,7054,[216 603 118 153 204],805,2,30261,4.28929836995039,0.0,0.0
37055,3,7055,[ 64 318 313 301  11],43,5,30266,4.2893990929705215,60.0,20.0
37056,3,7056,[ 64 318 313 301  11],416,5,30271,4.28949978744509,60.0,20.0
37057,3,7057,[ 64 318 313 301  11],345,5,30276,4.289600453386228,60.0,20.0
37058,3,7058,[  4 125 204  95 496],416,4,30280,4.289559427680975,0.0,0.0
37059,3,7059,[181 328   1  50 257],550,4,30284,4.289518413597734,0.0,40.0
37060,3,7060,[173 196 257 210   4],417,2,30286,4.289194165132417,0.0,0.0
37061,3,7061,[ 28  56  88 144  71],618,5,30291,4.2892948173322,0.0,0.0
37062,3,7062,[597 179 322  22  79],805,2,30293,4.288970692340365,0.0,0.0
37063,3,7063,[117 294  12  50 273],297,4,30297,4.288929784824462,20.0,20.0
37064,3,7064,[ 64 318 313 301  11],345,5,30302,4.289030431705591,60.0,20.0
37065,3,7065,[182 655 258 222 427],128,2,30304,4.288706481743561,0.0,0.0
37066,3,7066,[ 64 143 597 216  12],314,4,30308,4.288665628979765,40.0,0.0
37067,3,7067,[ 64 318 313 301  11],416,5,30313,4.288766270514997,60.0,20.0
37068,3,7068,[181 546 323 333 191],416,3,30316,4.288583958127034,0.0,20.0
37069,3,7069,[ 64 318 313 301  11],43,5,30321,4.288684582743989,60.0,20.0
37070,3,7070,[117 210 300 471 385],416,5,30326,4.288785178899731,0.0,0.0
37071,3,7071,[234 215 678 235 204],297,0,30326,4.288178733031674,0.0,0.0
37072,3,7072,[ 64 318 313 301  11],345,5,30331,4.2882793722607095,60.0,20.0
37073,3,7073,[ 64 318 313 301  11],416,5,30336,4.288379983036472,60.0,20.0
37074,3,7074,[ 97 286  25 515 238],416,5,30341,4.2884805653710245,0.0,0.0
37075,3,7075,[ 64 318 313 301  11],416,5,30346,4.288581119276428,60.0,20.0
37076,3,7076,[153 183 172 173 238],417,4,30350,4.288540341952805,0.0,0.0
37077,3,7077,[ 64 318 313 301  11],416,5,30355,4.288640858999718,60.0,20.0
37078,3,7078,[ 64 318 313 301  11],43,5,30360,4.2887413476479725,60.0,20.0
37079,3,7079,[ 64 318 313 301  11],345,5,30365,4.288841807909605,60.0,20.0
37080,3,7080,[ 64 318 313 301  11],416,5,30370,4.288942239796639,60.0,20.0
37081,3,7081,[273 174  56 603  25],297,5,30375,4.289042643321095,0.0,0.0
37082,3,7082,[172 597 245 234 151],642,3,30378,4.288860652265989,0.0,0.0
37083,3,7083,[471 276 111 118  50],274,5,30383,4.288961038961039,0.0,20.0
37084,3,7084,[197 143 176 195 151],416,4,30387,4.288920254057869,0.0,0.0
37085,3,7085,[ 25 385 301  79 323],43,4,30391,4.288879480666102,0.0,0.0
37086,3,7086,[179 210 127 185 195],198,3,30394,4.288697615352053,0.0,0.0
37087,3,7087,[204 100 127 269  28],373,2,30396,4.288374717832957,0.0,0.0
37088,3,7088,[ 98  50 204 173 742],416,5,30401,4.288475102271124,0.0,40.0
37089,3,7089,[ 64 318 313 301  11],345,5,30406,4.288575458392102,60.0,20.0
37090,3,7090,[ 64 318 313 301  11],43,5,30411,4.288675786207869,60.0,20.0
37091,3,7091,[ 64 318 313 301  11],345,5,30416,4.2887760857304,60.0,20.0
37092,3,7092,[302  56  79 508 100],417,1,30417,4.288312420696461,0.0,0.0
37093,3,7093,[ 64 318 313 301  11],43,5,30422,4.288412743163237,60.0,20.0
37094,3,7094,[197  69 176 211 187],405,3,30425,4.288231148696265,0.0,0.0
37095,3,7095,[ 69 265 183 228 202],417,2,30427,4.287908680947012,0.0,0.0
37096,3,7096,[ 64 318 313 301  11],345,5,30432,4.288009017894885,60.0,20.0
37097,3,7097,[ 64 318 313 301  11],43,5,30437,4.288109326570865,60.0,20.0
37098,3,7098,[ 64 318 313 301  11],345,5,30442,4.288209606986899,60.0,20.0
37099,3,7099,[125  69  64  95 275],262,3,30445,4.288028169014084,20.0,0.0
37100,3,7100,[ 64 318 313 301  11],345,5,30450,4.2881284326151246,60.0,20.0
37101,3,7101,[405 508 742 546 117],62,3,30453,4.2879470571669955,0.0,0.0
37102,3,7102,[238  88 742 323 237],43,3,30456,4.287765732788962,0.0,0.0
37103,3,7103,[125 127 234 161 742],416,5,30461,4.287865990990991,0.0,0.0
37104,3,7104,[323 289  70  79  12],416,3,30464,4.287684729064039,20.0,0.0
37105,3,7105,[ 64 318 313 301  11],43,5,30469,4.287784970447509,60.0,20.0
37106,3,7106,[483 282 216 168 286],588,5,30474,4.287885183621781,20.0,0.0
37107,3,7107,[191 238 118  22 222],854,3,30477,4.28770399549803,0.0,0.0
37108,3,7108,[ 64 318 313 301  11],43,5,30482,4.287804191869461,60.0,20.0
37109,3,7109,[ 64 318 313 301  11],43,5,30487,4.287904360056259,60.0,20.0
37110,3,7110,[ 64 318 313 301  11],416,5,30492,4.288004500070314,60.0,20.0
37111,3,7111,[238 172 153  71 135],601,3,30495,4.287823397075366,0.0,0.0
37112,3,7112,[  9  98 211  50 121],43,5,30500,4.287923520314917,0.0,40.0
37113,3,7113,[ 64 318 313 301  11],345,5,30505,4.288023615406241,60.0,20.0
37114,3,7114,[ 64 318 313 301  11],416,5,30510,4.288123682361209,60.0,20.0
37115,3,7115,[ 64 318 313 301  11],43,5,30515,4.288223721191681,60.0,20.0
37116,3,7116,[161 237  79 403 328],43,5,30520,4.288323731909513,0.0,0.0
37117,3,7117,[216  64 135 568 257],642,3,30523,4.288142736723799,20.0,0.0
37118,3,7118,[ 64 318 313 301  11],345,5,30528,4.288242730720607,60.0,20.0
37119,3,7119,[ 82 237 191 276 118],437,3,30531,4.288061797752809,0.0,0.0
37120,3,7120,[ 64 318 313 301  11],345,5,30536,4.288161775031597,60.0,20.0
37121,3,7121,[215  97 111   7 125],618,3,30539,4.287980904240382,0.0,0.0
37122,3,7122,[ 69 288  12 117 100],24,4,30543,4.287940474519163,20.0,20.0
37123,3,7123,[ 64 318 313 301  11],345,5,30548,4.288040426726558,60.0,20.0
37124,3,7124,[ 64 318 313 301  11],345,5,30553,4.288140350877193,60.0,20.0
37125,3,7125,[546 143 215  56 173],314,3,30556,4.287959584619703,0.0,0.0
37126,3,7126,[ 64 318 313 301  11],416,5,30561,4.288059492072401,60.0,20.0
37127,3,7127,[275 216 204   8  28],437,4,30565,4.288019079685746,0.0,0.0
37128,3,7128,[ 64 318 313 301  11],416,5,30570,4.288118950764483,60.0,20.0
37129,3,7129,[475 173 200 318  22],711,4,30574,4.288078541374474,20.0,0.0
37130,3,7130,[ 64 318 313 301  11],345,5,30579,4.288178376104333,60.0,20.0
37131,3,7131,[111 318  50  88  69],416,4,30583,4.288137969713965,20.0,20.0
37132,3,7132,[234 200  12 182 258],297,2,30585,4.287817187719052,20.0,0.0
37133,3,7133,[173 127 318 197  70],198,4,30589,4.287776843285674,20.0,0.0
37134,3,7134,[ 64 318 313 301  11],416,5,30594,4.2878766643307635,60.0,20.0
37135,3,7135,[288  56 302  28 153],297,4,30598,4.287836322869955,0.0,20.0
37136,3,7136,[174   7 196  97 483],496,3,30601,4.287655877819812,20.0,0.0
37137,3,7137,[ 25  28 151 245 237],764,4,30605,4.287615578593443,0.0,0.0
37138,3,7138,[403 117  95 210   4],417,3,30608,4.287435215016108,0.0,0.0
37139,3,7139,[300   1 423 238 318],654,5,30613,4.287535014005602,20.0,0.0
37140,3,7140,[ 64 318 313 301  11],345,5,30618,4.287634785044111,60.0,20.0
37141,3,7141,[ 64 318 313 301  11],43,5,30623,4.287734528143377,60.0,20.0
37142,3,7142,[403 405 179 216  71],62,4,30627,4.287694246115078,0.0,0.0
37143,3,7143,[294 423 153 258 100],416,5,30632,4.287793952967525,0.0,0.0
37144,3,7144,[127 257 172 216 168],43,5,30637,4.287893631910427,0.0,0.0
37145,3,7145,[ 64 318 313 301  11],43,5,30642,4.287993282955499,60.0,20.0
37146,3,7146,[ 64 318 313 301  11],416,5,30647,4.2880929061144535,60.0,20.0
37147,3,7147,[ 64 318 313 301  11],345,5,30652,4.288192501398993,60.0,20.0
37148,3,7148,[ 89 423 655 100 328],62,2,30654,4.287872429710449,0.0,0.0
37149,3,7149,[ 64 318 313 301  11],345,5,30659,4.287972027972028,60.0,20.0
37150,3,7150,[ 64 318 313 301  11],43,5,30664,4.288071598377849,60.0,20.0
37151,3,7151,[204  64 118 302 275],416,4,30668,4.288031319910514,20.0,0.0
37152,3,7152,[ 64 318 313 301  11],416,5,30673,4.288130854187054,60.0,20.0
37153,3,7153,[143 427  50 182  28],230,4,30677,4.288090578697233,0.0,20.0
37154,3,7154,[ 97  82  12 313 151],416,4,30681,4.2880503144654085,40.0,20.0
37155,3,7155,[269 183  25  97 153],297,5,30686,4.2881498043599775,0.0,0.0
37156,3,7156,[588 286 168 275 174],43,5,30691,4.288249266452424,0.0,0.0
37157,3,7157,[ 64 318 313 301  11],345,5,30696,4.2883487007544,60.0,20.0
37158,3,7158,[ 64 318 313 301  11],416,5,30701,4.288448107277553,60.0,20.0
37159,3,7159,[ 64 318 313 301  11],416,5,30706,4.2885474860335195,60.0,20.0
37160,3,7160,[ 64 318 313 301  11],416,5,30711,4.288646837033934,60.0,20.0
37161,3,7161,[215  88 117 197 385],373,3,30714,4.288466908684725,0.0,0.0
37162,3,7162,[ 64 318 313 301  11],416,5,30719,4.288566243194192,60.0,20.0
37163,3,7163,[ 64 318 313 301  11],416,5,30724,4.288665549972083,60.0,20.0
37164,3,7164,[ 64 318 313 301  11],416,5,30729,4.288764829030007,60.0,20.0
37165,3,7165,[ 64 318 313 301  11],345,5,30734,4.28886408037957,60.0,20.0
37166,3,7166,[ 64 318 313 301  11],43,5,30739,4.288963304032371,60.0,20.0
37167,3,7167,[ 64 318 313 301  11],345,5,30744,4.2890625,60.0,20.0
37168,3,7168,[ 64 318 313 301  11],416,5,30749,4.289161668294044,60.0,20.0
37169,3,7169,[  1 121 405 597 655],751,1,30750,4.2887029288702925,0.0,0.0
37170,3,7170,[ 64 318 313 301  11],416,5,30755,4.288802119648585,60.0,20.0
37171,3,7171,[435 588   1 185 515],230,5,30760,4.2889012827663135,0.0,0.0
37172,3,7172,[ 64 318 313 301  11],416,5,30765,4.289000418235048,60.0,20.0
37173,3,7173,[678 245 175 403  97],721,3,30768,4.288820741566769,0.0,0.0
37174,3,7174,[ 79 204   9 132  96],618,2,30770,4.288501742160279,0.0,0.0
37175,3,7175,[ 15 323 301   9 275],43,4,30774,4.288461538461538,0.0,0.0
37176,3,7176,[ 64 318 313 301  11],416,5,30779,4.28856067994984,60.0,20.0
37177,3,7177,[ 64 318 313 301  11],345,5,30784,4.288659793814433,60.0,20.0
37178,3,7178,[ 12 111  88 174 403],805,2,30786,4.288340994567489,20.0,0.0
37179,3,7179,[328  15 172   8  22],62,3,30789,4.28816155988858,0.0,0.0
37180,3,7180,[282 143  12 475   8],342,4,30793,4.288121431555494,20.0,0.0
37181,3,7181,[ 64 318 313 301  11],345,5,30798,4.288220551378446,60.0,20.0
37182,3,7182,[427 496 423   1  69],416,5,30803,4.288319643602952,0.0,0.0
37183,3,7183,[268 173 328 275   8],854,3,30806,4.288140311804009,0.0,0.0
37184,3,7184,[118  79  28 191   4],805,2,30808,4.287821851078636,0.0,0.0
37185,3,7185,[ 64 318 313 301  11],43,5,30813,4.2879209574172,60.0,20.0
37186,3,7186,[ 64 318 313 301  11],345,5,30818,4.288020036176429,60.0,20.0
37187,3,7187,[ 69 100 117 588 211],230,5,30823,4.288119087367836,0.0,0.0
37188,3,7188,[ 64 318 313 301  11],43,5,30828,4.288218111002921,60.0,20.0
37189,3,7189,[ 64 318 313 301  11],345,5,30833,4.288317107093185,60.0,20.0
37190,3,7190,[ 64 318 313 301  11],345,5,30838,4.288416075650118,60.0,20.0
37191,3,7191,[ 88   7 175 483 185],354,3,30841,4.288236929922136,20.0,0.0
37192,3,7192,[173 210  25 182 238],198,4,30845,4.288196858056444,0.0,0.0
37193,3,7193,[ 64 318 313 301  11],345,5,30850,4.28829580205727,60.0,20.0
37194,3,7194,[ 64 318 313 301  11],43,5,30855,4.288394718554552,60.0,20.0
37195,3,7195,[ 64 318 313 301  11],43,5,30860,4.288493607559755,60.0,20.0
37196,3,7196,[ 64 318 313 301  11],345,5,30865,4.288592469084341,60.0,20.0
37197,3,7197,[ 64 318 313 301  11],43,5,30870,4.288691303139761,60.0,20.0
37198,3,7198,[179 742  69  22  82],62,4,30874,4.288651201555772,0.0,0.0
37199,3,7199,[ 64 318 313 301  11],43,5,30879,4.28875,60.0,20.0
37200,3,7200,[ 64 318 313 301  11],416,5,30884,4.2888487710040275,60.0,20.0
37201,3,7201,[ 64 318 313 301  11],345,5,30889,4.2889475145792835,60.0,20.0
37202,3,7202,[ 64 318 313 301  11],416,5,30894,4.289046230737193,60.0,20.0
37203,3,7203,[ 64 318 313 301  11],345,5,30899,4.289144919489173,60.0,20.0
37204,3,7204,[ 64 318 313 301  11],416,5,30904,4.289243580846635,60.0,20.0
37205,3,7205,[183 216 568 222 204],805,2,30906,4.288925895087427,0.0,0.0
37206,3,7206,[471 273  89 216  69],297,3,30909,4.28874705147773,0.0,0.0
37207,3,7207,[ 64 318 313 301  11],416,5,30914,4.288845726970033,60.0,20.0
37208,3,7208,[ 64 318 313 301  11],345,5,30919,4.288944375086698,60.0,20.0
37209,3,7209,[180 172 202 200  71],405,2,30921,4.288626907073509,0.0,0.0
37210,3,7210,[ 64 318 313 301  11],43,5,30926,4.2887255581750106,60.0,20.0
37211,3,7211,[ 64 318 313 301  11],43,5,30931,4.288824181919024,60.0,20.0
37212,3,7212,[ 64 318 313 301  11],345,5,30936,4.288922778316928,60.0,20.0
37213,3,7213,[ 64 318 313 301  11],345,5,30941,4.289021347380094,60.0,20.0
37214,3,7214,[ 98 132 496 197 144],437,4,30945,4.288981288981289,0.0,20.0
37215,3,7215,[ 64 318 313 301  11],43,5,30950,4.289079822616408,60.0,20.0
37216,3,7216,[216 258 282 202 483],588,4,30954,4.289039767216295,20.0,0.0
37217,3,7217,[215 127 269 197 175],721,5,30959,4.289138265447493,0.0,0.0
37218,3,7218,[275 181 144 187  56],618,4,30963,4.289098213048899,0.0,20.0
37219,3,7219,[ 64 318 313 301  11],416,5,30968,4.289196675900277,60.0,20.0
37220,3,7220,[ 64 318 313 301  11],43,5,30973,4.2892951114804045,60.0,20.0
37221,3,7221,[196 179 216 173  12],214,5,30978,4.289393519800609,20.0,0.0
37222,3,7222,[181 174 215  28 257],541,5,30983,4.289491900872214,0.0,20.0
37223,3,7223,[ 64 318 313 301  11],43,5,30988,4.289590254706534,60.0,20.0
37224,3,7224,[ 64 318 313 301  11],345,5,30993,4.289688581314879,60.0,20.0
37225,3,7225,[ 64 318 313 301  11],43,5,30998,4.289786880708553,60.0,20.0
37226,3,7226,[ 64 318 313 301  11],416,5,31003,4.289885152898852,60.0,20.0
37227,3,7227,[597  70  82  50  12],43,4,31007,4.289845047039291,20.0,20.0
37228,3,7228,[ 64 318 313 301  11],43,5,31012,4.2899432839950205,60.0,20.0
37229,3,7229,[ 64 318 313 301  11],43,5,31017,4.2900414937759335,60.0,20.0
37230,3,7230,[111 286 655 179 323],721,3,31020,4.289863089475868,0.0,0.0
37231,3,7231,[238 202 245 173 172],345,3,31023,4.2896847345132745,0.0,0.0
37232,3,7232,[ 64 318 313 301  11],345,5,31028,4.289782939305959,60.0,20.0
37233,3,7233,[ 64 318 313 301  11],345,5,31033,4.289881116947747,60.0,20.0
37234,3,7234,[ 64 318 313 301  11],416,5,31038,4.289979267449897,60.0,20.0
37235,3,7235,[588 273 191 282 176],297,3,31041,4.289800995024875,0.0,0.0
37236,3,7236,[ 64 318 313 301  11],43,5,31046,4.289899129473539,60.0,20.0
37237,3,7237,[ 64 318 313 301  11],43,5,31051,4.289997236805747,60.0,20.0
37238,3,7238,[234 496 238 403 322],416,4,31055,4.289957176405581,0.0,0.0
37239,3,7239,[173 182  56 655 222],198,4,31059,4.289917127071823,0.0,0.0
37240,3,7240,[ 64 318 313 301  11],416,5,31064,4.290015191271924,60.0,20.0
37241,3,7241,[ 64 318 313 301  11],416,5,31069,4.290113228389948,60.0,20.0
37242,3,7242,[ 64 318 313 301  11],43,5,31074,4.290211238437112,60.0,20.0
37243,3,7243,[ 64 318 313 301  11],416,5,31079,4.290309221424628,60.0,20.0
37244,3,7244,[568  64 597  11  25],416,4,31083,4.290269151138716,20.0,0.0
37245,3,7245,[  8 235 194 196   4],297,2,31085,4.289953077560033,0.0,0.0
37246,3,7246,[181 195  88  82 210],373,4,31089,4.289913067476197,0.0,20.0
37247,3,7247,[  7 603 121 117 196],416,5,31094,4.290011037527594,0.0,0.0
37248,3,7248,[ 64 318 313 301  11],345,5,31099,4.290108980549041,60.0,20.0
37249,3,7249,[ 64 318 313 301  11],43,5,31104,4.290206896551724,60.0,20.0
37250,3,7250,[ 64 318 313 301  11],43,5,31109,4.290304785546821,60.0,20.0
37251,3,7251,[ 64 318 313 301  11],416,5,31114,4.290402647545505,60.0,20.0
37252,3,7252,[ 64 318 313 301  11],416,5,31119,4.290500482558941,60.0,20.0
37253,3,7253,[ 64 318 313 301  11],43,5,31124,4.2905982905982905,60.0,20.0
37254,3,7254,[118 288 257 132 483],601,2,31126,4.290282563749138,20.0,20.0
37255,3,7255,[ 25 405  71 258  70],654,3,31129,4.29010474090408,0.0,0.0
37256,3,7256,[172  56 568 357 191],198,4,31133,4.290064765054431,0.0,0.0
37257,3,7257,[ 64 318 313 301  11],416,5,31138,4.290162579222926,60.0,20.0
37258,3,7258,[172  70 288 118 176],618,2,31140,4.289847086375534,0.0,20.0
37259,3,7259,[ 12 197 176 282 588],297,3,31143,4.289669421487603,20.0,0.0
37260,3,7260,[ 64 318 313 301  11],345,5,31148,4.289767249690125,60.0,20.0
37261,3,7261,[ 64 318 313 301  11],416,5,31153,4.2898650509501515,60.0,20.0
37262,3,7262,[ 64 318 313 301  11],345,5,31158,4.289962825278811,60.0,20.0
37263,3,7263,[ 79 568 181  25 748],805,2,31160,4.289647577092511,0.0,20.0
37264,3,7264,[185 588 423 228 180],417,2,31162,4.289332415691672,0.0,0.0
37265,3,7265,[ 64 318 313 301  11],345,5,31167,4.289430222956234,60.0,20.0
37266,3,7266,[294 117  96 118 483],417,4,31171,4.289390394936012,20.0,0.0
37267,3,7267,[ 64 318 313 301  11],43,5,31176,4.28948816730875,60.0,20.0
37268,3,7268,[276  50 200  97 196],416,4,31180,4.289448342275416,0.0,20.0
37269,3,7269,[ 56 257  71  28 294],642,5,31185,4.289546079779917,0.0,0.0
37270,3,7270,[ 56 483 181  89 238],214,4,31189,4.289506257736212,20.0,20.0
37271,3,7271,[ 64 318 313 301  11],416,5,31194,4.28960396039604,60.0,20.0
37272,3,7272,[546  56 144 289  50],416,3,31197,4.289426646500756,0.0,20.0
37273,3,7273,[ 64 318 313 301  11],416,5,31202,4.289524333241682,60.0,20.0
37274,3,7274,[ 64 318 313 301  11],345,5,31207,4.289621993127148,60.0,20.0
37275,3,7275,[ 64 318 313 301  11],416,5,31212,4.289719626168225,60.0,20.0
37276,3,7276,[ 64 318 313 301  11],345,5,31217,4.289817232375979,60.0,20.0
37277,3,7277,[ 64 318 313 301  11],43,5,31222,4.289914811761473,60.0,20.0
37278,3,7278,[ 64 318 313 301  11],43,5,31227,4.290012364335761,60.0,20.0
37279,3,7279,[483 257 100  64 151],214,4,31231,4.2899725274725276,40.0,0.0
37280,3,7280,[186 173 273 286 117],854,2,31233,4.289658014009064,0.0,0.0
37281,3,7281,[98  7 56 64 50],96,5,31238,4.289755561658885,20.0,40.0
37282,3,7282,[ 64 318 313 301  11],43,5,31243,4.289853082520939,60.0,20.0
37283,3,7283,[318 143 258 185 405],262,2,31245,4.289538714991763,20.0,0.0
37284,3,7284,[ 64 318 313 301  11],345,5,31250,4.289636238846946,60.0,20.0
37285,3,7285,[265 258 161 273 508],417,1,31251,4.289184737853417,0.0,0.0
37286,3,7286,[ 64 318 313 301  11],43,5,31256,4.289282283518594,60.0,20.0
37287,3,7287,[257 127 182 742 215],62,2,31258,4.288968166849616,0.0,0.0
37288,3,7288,[588 257 100  12 322],416,3,31261,4.288791329400467,20.0,0.0
37289,3,7289,[302 161  82  97 318],721,4,31265,4.288751714677641,20.0,0.0
37290,3,7290,[ 64 318 313 301  11],416,5,31270,4.288849266218626,60.0,20.0
37291,3,7291,[ 88 588 568 357  56],416,4,31274,4.2888096544157985,0.0,0.0
37292,3,7292,[ 64 318 313 301  11],416,5,31279,4.288907171260113,60.0,20.0
37293,3,7293,[ 15 172 181 568 151],654,3,31282,4.288730463394571,0.0,20.0
37294,3,7294,[ 64 318 313 301  11],345,5,31287,4.28882796435915,60.0,20.0
37295,3,7295,[ 64 318 313 301  11],43,5,31292,4.2889254385964914,60.0,20.0
37296,3,7296,[ 64 318 313 301  11],416,5,31297,4.289022886117583,60.0,20.0
37297,3,7297,[ 64 318 313 301  11],345,5,31302,4.289120306933406,60.0,20.0
37298,3,7298,[282 546  64 111  25],314,4,31306,4.289080695985751,20.0,0.0
37299,3,7299,[471 204 117 210 187],505,3,31309,4.2889041095890414,0.0,0.0
37300,3,7300,[ 64 318 313 301  11],345,5,31314,4.289001506642926,60.0,20.0
37301,3,7301,[ 64 318 313 301  11],416,5,31319,4.2890988770199945,60.0,20.0
37302,3,7302,[323 471 238 302 144],43,2,31321,4.28878543064494,0.0,0.0
37303,3,7303,[ 64 318 313 301  11],43,5,31326,4.288882803943045,60.0,20.0
37304,3,7304,[ 64 318 313 301  11],345,5,31331,4.288980150581794,60.0,20.0
37305,3,7305,[ 64 318 313 301  11],416,5,31336,4.289077470572132,60.0,20.0
37306,3,7306,[ 64 318 313 301  11],345,5,31341,4.289174763925003,60.0,20.0
37307,3,7307,[176   7 471 235 258],297,3,31344,4.288998357963875,0.0,0.0
37308,3,7308,[195 161  15 268 288],416,5,31349,4.289095635517855,0.0,20.0
37309,3,7309,[196 318 118 678 276],416,2,31351,4.288782489740082,20.0,0.0
37310,3,7310,[ 64 318 313 301  11],43,5,31356,4.288879770209274,60.0,20.0
37311,3,7311,[269 405 191 275  11],43,5,31361,4.288977024070022,0.0,0.0
37312,3,7312,[222   8 271 176 185],805,3,31364,4.288800765759606,0.0,0.0
37313,3,7313,[ 64 318 313 301  11],416,5,31369,4.288898003828274,60.0,20.0
37314,3,7314,[ 64 318 313 301  11],345,5,31374,4.2889952153110045,60.0,20.0
37315,3,7315,[ 64 318 313 301  11],345,5,31379,4.289092400218698,60.0,20.0
37316,3,7316,[ 64 318 313 301  11],43,5,31384,4.289189558562252,60.0,20.0
37317,3,7317,[196 127 228   8 118],62,3,31387,4.289013391637059,0.0,0.0
37318,3,7318,[ 64 318 313 301  11],345,5,31392,4.289110534225987,60.0,20.0
37319,3,7319,[294 357 191 508  12],342,2,31394,4.28879781420765,20.0,0.0
37320,3,7320,[187 125 176 200  82],887,4,31398,4.288758366343396,0.0,0.0
37321,3,7321,[323  50 153 216 328],43,4,31402,4.288718929254302,0.0,20.0
37322,3,7322,[ 64 318 313 301  11],43,5,31407,4.288816058992216,60.0,20.0
37323,3,7323,[ 98   7 202 179 357],805,4,31411,4.288776624795194,0.0,20.0
37324,3,7324,[ 64 318 313 301  11],43,5,31416,4.288873720136519,60.0,20.0
37325,3,7325,[ 64 318 313 301  11],345,5,31421,4.288970788970789,60.0,20.0
37326,3,7326,[ 64 318 313 301  11],43,5,31426,4.2890678313088575,60.0,20.0
37327,3,7327,[ 64 318 313 301  11],345,5,31431,4.289164847161572,60.0,20.0
37328,3,7328,[ 64 318 313 301  11],43,5,31436,4.289261836539773,60.0,20.0
37329,3,7329,[258  88 678 238 200],345,4,31440,4.289222373806275,0.0,0.0
37330,3,7330,[ 64 318 313 301  11],345,5,31445,4.28931932887737,60.0,20.0
37331,3,7331,[ 12 286  88 153 235],43,4,31449,4.289279869067103,20.0,0.0
37332,3,7332,[ 98 172 100 568 423],805,3,31452,4.2891040501841,0.0,20.0
37333,3,7333,[ 64 318 313 301  11],416,5,31457,4.289200981728934,60.0,20.0
37334,3,7334,[ 28 423 328 546 185],223,2,31459,4.288888888888889,0.0,0.0
37335,3,7335,[ 64 318 313 301  11],43,5,31464,4.288985823336969,60.0,20.0
37336,3,7336,[  7 222   4 100 405],198,1,31465,4.288537549407114,0.0,0.0
37337,3,7337,[ 95 568 174 117 168],43,5,31470,4.2886345053148,0.0,0.0
37338,3,7338,[655 235 127  22 153],62,4,31474,4.288595176454558,0.0,0.0
37339,3,7339,[ 12 210 235 237   4],345,4,31478,4.288555858310627,20.0,0.0
37340,3,7340,[  7 174 294 215 168],43,5,31483,4.288652772101893,0.0,0.0
37341,3,7341,[ 64 318 313 301  11],43,5,31488,4.288749659493326,60.0,20.0
37342,3,7342,[ 64 318 313 301  11],416,5,31493,4.28884652049571,60.0,20.0
37343,3,7343,[271 161  88  70 328],43,4,31497,4.288807189542483,0.0,0.0
37344,3,7344,[ 64 318 313 301  11],345,5,31502,4.288904016337645,60.0,20.0
37345,3,7345,[ 64 318 313 301  11],43,5,31507,4.289000816771032,60.0,20.0
37346,3,7346,[ 64 318 313 301  11],416,5,31512,4.28909759085341,60.0,20.0
37347,3,7347,[ 64 318 313 301  11],416,5,31517,4.289194338595536,60.0,20.0
37348,3,7348,[ 64 318 313 301  11],345,5,31522,4.289291060008164,60.0,20.0
37349,3,7349,[ 64 318 313 301  11],345,5,31527,4.289387755102041,60.0,20.0
37350,3,7350,[ 64 318 313 301  11],345,5,31532,4.289484423887907,60.0,20.0
37351,3,7351,[ 64 318 313 301  11],416,5,31537,4.289581066376496,60.0,20.0
37352,3,7352,[ 64 318 313 301  11],345,5,31542,4.28967768257854,60.0,20.0
37353,3,7353,[ 64 318 313 301  11],345,5,31547,4.28977427250476,60.0,20.0
37354,3,7354,[ 64 318 313 301  11],416,5,31552,4.289870836165874,60.0,20.0
37355,3,7355,[ 64 318 313 301  11],345,5,31557,4.289967373572594,60.0,20.0
37356,3,7356,[ 64 318 313 301  11],416,5,31562,4.290063884735626,60.0,20.0
37357,3,7357,[ 64 318 313 301  11],416,5,31567,4.29016036966567,60.0,20.0
37358,3,7358,[ 64 318 313 301  11],345,5,31572,4.29025682837342,60.0,20.0
37359,3,7359,[127 211 385 313 588],405,2,31574,4.289945652173913,20.0,20.0
37360,3,7360,[748  98   8 273 161],416,5,31579,4.290042113843228,0.0,20.0
37361,3,7361,[204 194 603 318 655],405,3,31582,4.289866883998913,20.0,0.0
37362,3,7362,[ 64 318 313 301  11],416,5,31587,4.289963330164335,60.0,20.0
37363,3,7363,[ 98 258 127 286 265],416,5,31592,4.2900597501357955,0.0,20.0
37364,3,7364,[265 151 288 117 257],930,1,31593,4.289613034623218,0.0,20.0
37365,3,7365,[ 64 318 313 301  11],416,5,31598,4.289709475970676,60.0,20.0
37366,3,7366,[276 655 196  69 144],437,3,31601,4.289534410207683,0.0,0.0
37367,3,7367,[ 69  88 216 403 655],711,4,31605,4.289495114006515,0.0,0.0
37368,3,7368,[118  22 196 100 179],805,2,31607,4.289184421224046,0.0,0.0
37369,3,7369,[ 64 318 313 301  11],345,5,31612,4.289280868385346,60.0,20.0
37370,3,7370,[ 64 318 313 301  11],345,5,31617,4.289377289377289,60.0,20.0
37371,3,7371,[183 435 202 168 568],405,2,31619,4.28906673901248,0.0,0.0
37372,3,7372,[ 64 318 313 301  11],345,5,31624,4.289163162891632,60.0,20.0
37373,3,7373,[ 64 318 313 301  11],43,5,31629,4.2892595606183885,60.0,20.0
37374,3,7374,[ 64 318 313 301  11],416,5,31634,4.28935593220339,60.0,20.0
37375,3,7375,[ 64 318 313 301  11],416,5,31639,4.289452277657267,60.0,20.0
37376,3,7376,[301 655 385 568 132],588,3,31642,4.289277484072116,0.0,0.0
37377,3,7377,[ 64 318 313 301  11],43,5,31647,4.2893738140417454,60.0,20.0
37378,3,7378,[508 181  95  12  98],417,3,31650,4.289199078465916,20.0,40.0
37379,3,7379,[ 64 318 313 301  11],345,5,31655,4.28929539295393,60.0,20.0
37380,3,7380,[289  69 269   8 301],721,4,31659,4.289256198347108,0.0,0.0
37381,3,7381,[ 64 318 313 301  11],416,5,31664,4.2893524790029804,60.0,20.0
37382,3,7382,[ 64 318 313 301  11],43,5,31669,4.289448733577137,60.0,20.0
37383,3,7383,[181 118 496  12 258],630,2,31671,4.2891386782231855,20.0,20.0
37384,3,7384,[235 237 194 117 748],297,2,31673,4.288828706838186,0.0,0.0
37385,3,7385,[ 64 318 313 301  11],345,5,31678,4.288924993230436,60.0,20.0
37386,3,7386,[ 64 318 313 301  11],43,5,31683,4.28902125355354,60.0,20.0
37387,3,7387,[ 64 318 313 301  11],345,5,31688,4.289117487818084,60.0,20.0
37388,3,7388,[508 323 216  50   7],417,0,31688,4.288537014480985,0.0,20.0
37389,3,7389,[ 12 588 144   1 257],417,2,31690,4.2882273342354535,20.0,0.0
37390,3,7390,[ 64 318 313 301  11],43,5,31695,4.288323636855635,60.0,20.0
37391,3,7391,[ 64 318 313 301  11],345,5,31700,4.288419913419913,60.0,20.0
37392,3,7392,[ 25  89 185 318 181],198,3,31703,4.288245637765454,20.0,20.0
37393,3,7393,[ 64 318 313 301  11],416,5,31708,4.288341898836895,60.0,20.0
37394,3,7394,[ 64 318 313 301  11],43,5,31713,4.288438133874239,60.0,20.0
37395,3,7395,[475 191 174 180 172],437,4,31717,4.2883991346673875,0.0,0.0
37396,3,7396,[ 64 318 313 301  11],43,5,31722,4.2884953359470055,60.0,20.0
37397,3,7397,[ 64 318 313 301  11],345,5,31727,4.2885915112192485,60.0,20.0
37398,3,7398,[313 286  88 268 475],416,3,31730,4.288417353696445,20.0,20.0
37399,3,7399,[202 125  97 357  28],416,5,31735,4.2885135135135135,0.0,0.0
37400,3,7400,[423   1  69 597 405],223,3,31738,4.288339413592758,0.0,0.0
37401,3,7401,[121 196 215  25  50],921,4,31742,4.288300459335315,0.0,20.0
37402,3,7402,[ 64 318 313 301  11],416,5,31747,4.288396595974605,60.0,20.0
37403,3,7403,[ 64 318 313 301  11],416,5,31752,4.288492706645057,60.0,20.0
37404,3,7404,[ 64 318 313 301  11],345,5,31757,4.288588791357191,60.0,20.0
37405,3,7405,[ 64 318 313 301  11],345,5,31762,4.288684850121523,60.0,20.0
37406,3,7406,[182   4  97 423 258],198,2,31764,4.288375860672337,0.0,0.0
37407,3,7407,[135 289 294 427 475],342,2,31766,4.288066954643629,0.0,0.0
37408,3,7408,[ 64 318 313 301  11],345,5,31771,4.288163044945337,60.0,20.0
37409,3,7409,[ 64 318 313 301  11],416,5,31776,4.288259109311741,60.0,20.0
37410,3,7410,[423 603  88 195 151],416,3,31779,4.288085278639859,0.0,0.0
37411,3,7411,[ 82 405 276 323  56],198,1,31780,4.287641662169455,0.0,0.0
37412,3,7412,[258 228 153 195 118],62,3,31783,4.287467961688925,0.0,0.0
37413,3,7413,[ 64 318 313 301  11],345,5,31788,4.287564067979498,60.0,20.0
37414,3,7414,[151 222 597 202 313],588,3,31791,4.287390424814565,20.0,20.0
37415,3,7415,[176 121 328  79 294],854,1,31792,4.286947141316073,0.0,0.0
37416,3,7416,[294 435 357 185 385],230,4,31796,4.286908453552649,0.0,0.0
37417,3,7417,[ 64 318 313 301  11],416,5,31801,4.287004583445673,60.0,20.0
37418,3,7418,[ 64 318 313 301  11],416,5,31806,4.287100687424181,60.0,20.0
37419,3,7419,[471 322 121 185  69],416,4,31810,4.287061994609164,0.0,0.0
37420,3,7420,[ 64 318 313 301  11],43,5,31815,4.287158064950815,60.0,20.0
37421,3,7421,[215 216 288 234 144],618,3,31818,4.28698464025869,0.0,20.0
37422,3,7422,[ 25 183 257 143  69],297,3,31821,4.286811262292874,0.0,0.0
37423,3,7423,[204  22 265  71   8],230,5,31826,4.286907327586207,0.0,0.0
37424,3,7424,[111 318 182 313 185],618,4,31830,4.2868686868686865,40.0,20.0
37425,3,7425,[ 82 301 318 196 286],416,5,31835,4.2869647185564235,20.0,0.0
37426,3,7426,[ 50  98 234 568 403],345,4,31839,4.286926080517032,0.0,40.0
37427,3,7427,[ 97   7 228 135  25],230,1,31840,4.286483575659666,0.0,0.0
37428,3,7428,[ 64 318 313 301  11],416,5,31845,4.286579620406515,60.0,20.0
37429,3,7429,[ 50 161 173 328 588],128,4,31849,4.286541049798116,0.0,20.0
37430,3,7430,[ 64 318 313 301  11],416,5,31854,4.28663706096084,60.0,20.0
37431,3,7431,[ 64 318 313 301  11],345,5,31859,4.286733046286329,60.0,20.0
37432,3,7432,[  7 288 222 194  50],854,4,31863,4.286694470604063,0.0,40.0
37433,3,7433,[  7  15 603  28  82],416,5,31868,4.286790422383643,0.0,0.0
37434,3,7434,[143  70 168 328 172],49,1,31869,4.286348352387357,0.0,0.0
37435,3,7435,[111 238  50 181 546],417,1,31870,4.285906401291017,0.0,40.0
37436,3,7436,[300 471 222  97 210],705,4,31874,4.2858679575097485,0.0,0.0
37437,3,7437,[210 180 181 153 183],805,2,31876,4.285560634579188,0.0,20.0
37438,3,7438,[ 64 318 313 301  11],345,5,31881,4.285656674284178,60.0,20.0
37439,3,7439,[ 64 318 313 301  11],43,5,31886,4.285752688172043,60.0,20.0
37440,3,7440,[271 483 302  70  71],62,2,31888,4.285445504636473,20.0,0.0
37441,3,7441,[ 64 318 313 301  11],43,5,31893,4.285541521096479,60.0,20.0
37442,3,7442,[ 64 318 313 301  11],416,5,31898,4.285637511756012,60.0,20.0
37443,3,7443,[ 64 318 313 301  11],43,5,31903,4.28573347662547,60.0,20.0
37444,3,7444,[ 64 318 313 301  11],345,5,31908,4.285829415715245,60.0,20.0
37445,3,7445,[ 25 471 483 181 216],618,2,31910,4.285522428149342,20.0,20.0
37446,3,7446,[ 64 318 313 301  11],43,5,31915,4.285618369813347,60.0,20.0
37447,3,7447,[200  82 748 483 496],417,4,31919,4.285580021482277,20.0,0.0
37448,3,7448,[ 64 318 313 301  11],345,5,31924,4.285675929654987,60.0,20.0
37449,3,7449,[ 64 318 313 301  11],43,5,31929,4.285771812080537,60.0,20.0
37450,3,7450,[ 64 318 313 301  11],345,5,31934,4.285867668769293,60.0,20.0
37451,3,7451,[ 64 318 313 301  11],416,5,31939,4.285963499731616,60.0,20.0
37452,3,7452,[ 64 318 313 301  11],43,5,31944,4.2860593049778615,60.0,20.0
37453,3,7453,[ 64 318 313 301  11],416,5,31949,4.28615508451838,60.0,20.0
37454,3,7454,[ 64 318 313 301  11],416,5,31954,4.2862508383635145,60.0,20.0
37455,3,7455,[ 64 318 313 301  11],345,5,31959,4.286346566523605,60.0,20.0
37456,3,7456,[ 64 318 313 301  11],43,5,31964,4.286442269008985,60.0,20.0
37457,3,7457,[191 318   9  50 403],416,5,31969,4.2865379458299815,20.0,20.0
37458,3,7458,[238 161  15 286 300],345,2,31971,4.286231398310766,0.0,0.0
37459,3,7459,[ 64 318 313 301  11],416,5,31976,4.286327077747989,60.0,20.0
37460,3,7460,[ 95 475 265 194 196],416,3,31979,4.286154670955636,0.0,0.0
37461,3,7461,[228  25 185   7 186],230,2,31981,4.28584829804342,0.0,0.0
37462,3,7462,[196  96 245 268   9],416,4,31985,4.285809995980169,0.0,0.0
37463,3,7463,[ 64 318 313 301  11],416,5,31990,4.285905680600214,60.0,20.0
37464,3,7464,[196 179 655  28 427],405,3,31993,4.285733422638982,0.0,0.0
37465,3,7465,[ 64 318 313 301  11],416,5,31998,4.285829091883204,60.0,20.0
37466,3,7466,[ 64 318 313 301  11],416,5,32003,4.28592473550288,60.0,20.0
37467,3,7467,[271 191   7  64 235],43,3,32006,4.285752544188537,20.0,0.0
37468,3,7468,[132 405 118 286 200],854,3,32009,4.285580398982461,0.0,0.0
37469,3,7469,[ 64 318 313 301  11],43,5,32014,4.285676037483267,60.0,20.0
37470,3,7470,[427  98  96 179 328],416,4,32018,4.285637799491367,0.0,20.0
37471,3,7471,[ 64 318 313 301  11],345,5,32023,4.28573340471092,60.0,20.0
37472,3,7472,[ 64 318 313 301  11],43,5,32028,4.285828984343637,60.0,20.0
37473,3,7473,[ 64 318 313 301  11],43,5,32033,4.285924538399786,60.0,20.0
37474,3,7474,[ 97   8 237  12 153],654,4,32037,4.285886287625418,20.0,0.0
37475,3,7475,[111 238 313 282 265],618,2,32039,4.285580524344569,20.0,20.0
37476,3,7476,[ 89 117 294 195 118],417,5,32044,4.285676073291427,0.0,0.0
37477,3,7477,[273 117 302 742 100],854,2,32046,4.285370419898369,0.0,0.0
37478,3,7478,[127 275 135 176 216],618,3,32049,4.285198555956678,0.0,0.0
37479,3,7479,[ 64 318 313 301  11],43,5,32054,4.285294117647059,60.0,20.0
37480,3,7480,[ 64 318 313 301  11],43,5,32059,4.285389653789601,60.0,20.0
37481,3,7481,[200  15 588 216 118],416,4,32063,4.285351510291366,0.0,0.0
37482,3,7482,[174  98  97 111 678],297,3,32066,4.28517974074569,0.0,20.0
37483,3,7483,[ 64 318 313 301  11],416,5,32071,4.285275253874933,60.0,20.0
37484,3,7484,[ 11 100 143 183 288],416,5,32076,4.285370741482966,0.0,20.0
37485,3,7485,[ 64 318 313 301  11],416,5,32081,4.285466203580016,60.0,20.0
37486,3,7486,[ 64 318 313 301  11],43,5,32086,4.285561640176305,60.0,20.0
37487,3,7487,[588 423 435 176 191],505,3,32089,4.285389957264957,0.0,0.0
37488,3,7488,[ 64 318 313 301  11],416,5,32094,4.285485378555214,60.0,20.0
37489,3,7489,[ 64 318 313 301  11],345,5,32099,4.285580774365821,60.0,20.0
37490,3,7490,[748 742 423 100 179],805,2,32101,4.28527566413029,0.0,0.0
37491,3,7491,[ 64 318 313 301  11],345,5,32106,4.2853710624666315,60.0,20.0
37492,3,7492,[175 301  25  95 597],43,3,32109,4.285199519551582,0.0,0.0
37493,3,7493,[ 64 318 313 301  11],416,5,32114,4.2852949025887375,60.0,20.0
37494,3,7494,[ 64 318 313 301  11],43,5,32119,4.285390260173449,60.0,20.0
37495,3,7495,[300 245  69 403  82],416,4,32123,4.285352187833511,0.0,0.0
37496,3,7496,[ 64 318 313 301  11],345,5,32128,4.285447512338268,60.0,20.0
37497,3,7497,[ 64 318 313 301  11],416,5,32133,4.285542811416378,60.0,20.0
37498,3,7498,[153  97 237 748 172],198,2,32135,4.285238031737565,0.0,0.0
37499,3,7499,[ 64 318 313 301  11],43,5,32140,4.285333333333333,60.0,20.0
37500,3,7500,[ 64 318 313 301  11],416,5,32145,4.285428609518731,60.0,20.0
37501,3,7501,[ 71 496  95 313  69],618,4,32149,4.285390562516662,20.0,20.0
37502,3,7502,[ 56  82 202 173 151],588,4,32153,4.285352525656404,0.0,0.0
37503,3,7503,[ 64 318 313 301  11],43,5,32158,4.28544776119403,60.0,20.0
37504,3,7504,[168  71   9  28 180],62,4,32162,4.285409726848767,0.0,0.0
37505,3,7505,[ 64 318 313 301  11],416,5,32167,4.2855049293898215,60.0,20.0
37506,3,7506,[ 64 318 313 301  11],43,5,32172,4.285600106567204,60.0,20.0
37507,3,7507,[ 64 318 313 301  11],43,5,32177,4.2856952583910495,60.0,20.0
37508,3,7508,[273 405  70   4 222],764,3,32180,4.285524037821281,0.0,0.0
37509,3,7509,[  7 588 322 235 183],416,3,32183,4.285352862849534,0.0,0.0
37510,3,7510,[300 427 238 179 234],198,3,32186,4.285181733457596,0.0,0.0
37511,3,7511,[ 64 318 313 301  11],345,5,32191,4.28527689030884,60.0,20.0
37512,3,7512,[496 200 161 475  97],437,2,32193,4.284972713962465,0.0,0.0
37513,3,7513,[ 12 168 273 153 144],417,3,32196,4.284801703486824,20.0,0.0
37514,3,7514,[ 64 318 313 301  11],43,5,32201,4.284896872920825,60.0,20.0
37515,3,7515,[ 64 318 313 301  11],416,5,32206,4.284992017030335,60.0,20.0
37516,3,7516,[ 64 318 313 301  11],345,5,32211,4.285087135825462,60.0,20.0
37517,3,7517,[271 289 318  89 483],854,4,32215,4.285049215216813,40.0,0.0
37518,3,7518,[ 64 318 313 301  11],416,5,32220,4.285144301103871,60.0,20.0
37519,3,7519,[  8  82 271 235 204],805,0,32220,4.284574468085107,0.0,0.0
37520,3,7520,[ 64 318 313 301  11],345,5,32225,4.2846695918096,60.0,20.0
37521,3,7521,[ 64 318 313 301  11],416,5,32230,4.284764690241957,60.0,20.0
37522,3,7522,[ 64 318 313 301  11],345,5,32235,4.284859763392264,60.0,20.0
37523,3,7523,[ 64 318 313 301  11],43,5,32240,4.284954811270601,60.0,20.0
37524,3,7524,[ 64 318 313 301  11],43,5,32245,4.285049833887043,60.0,20.0
37525,3,7525,[742 678 132 515 276],416,3,32248,4.28487908583577,0.0,0.0
37526,3,7526,[328 176 288 181 271],62,2,32250,4.284575528098844,0.0,40.0
37527,3,7527,[ 69 333 258 191 269],854,4,32254,4.284537725823592,0.0,0.0
37528,3,7528,[ 64 318 313 301  11],416,5,32259,4.284632753353699,60.0,20.0
37529,3,7529,[ 64 318 313 301  11],416,5,32264,4.284727755644091,60.0,20.0
37530,3,7530,[222  95  70 265 132],711,3,32267,4.284557163723277,0.0,0.0
37531,3,7531,[ 64 318 313 301  11],416,5,32272,4.284652150823154,60.0,20.0
37532,3,7532,[ 64 318 313 301  11],43,5,32277,4.284747112704102,60.0,20.0
37533,3,7533,[ 64 318 313 301  11],43,5,32282,4.284842049376161,60.0,20.0
37534,3,7534,[302  25 288 117 294],417,2,32284,4.284538818845388,0.0,20.0
37535,3,7535,[ 64 318 313 301  11],345,5,32289,4.2846337579617835,60.0,20.0
37536,3,7536,[ 64 318 313 301  11],416,5,32294,4.284728671885365,60.0,20.0
37537,3,7537,[ 64 318 313 301  11],345,5,32299,4.284823560626161,60.0,20.0
37538,3,7538,[127 385 269 183 235],805,2,32301,4.284520493434142,0.0,0.0
37539,3,7539,[ 64 318 313 301  11],416,5,32306,4.2846153846153845,60.0,20.0
37540,3,7540,[ 64 318 313 301  11],345,5,32311,4.28471025062989,60.0,20.0
37541,3,7541,[ 64 318 313 301  11],43,5,32316,4.284805091487669,60.0,20.0
37542,3,7542,[ 12 235  97 275 268],416,4,32320,4.284767333952009,20.0,0.0
37543,3,7543,[ 64 318 313 301  11],345,5,32325,4.284862142099682,60.0,20.0
37544,3,7544,[269 385 257 288 597],416,3,32328,4.284691848906561,0.0,20.0
37545,3,7545,[ 64 318 313 301  11],345,5,32333,4.284786641929499,60.0,20.0
37546,3,7546,[435 117 238 194 245],297,2,32335,4.2844839008877695,0.0,0.0
37547,3,7547,[ 64 318 313 301  11],43,5,32340,4.284578696343402,60.0,20.0
37548,3,7548,[153 385 173 423 235],416,4,32344,4.284540998807789,0.0,0.0
37549,3,7549,[ 69 301  64 143 471],345,4,32348,4.284503311258278,20.0,0.0
37550,3,7550,[333 210 258 132 597],416,4,32352,4.2844656336909015,0.0,0.0
37551,3,7551,[322 271 427   8 173],907,4,32356,4.284427966101695,0.0,0.0
37552,3,7552,[ 79  22   7  71 302],416,5,32361,4.2845227062094535,0.0,0.0
37553,3,7553,[ 64 318 313 301  11],345,5,32366,4.284617421233784,60.0,20.0
37554,3,7554,[210 237   4  22   8],253,5,32371,4.284712111184646,0.0,0.0
37555,3,7555,[ 12 238 588  11  96],805,3,32374,4.284542085759661,20.0,0.0
37556,3,7556,[678 265 173   1 183],416,4,32378,4.284504432976049,0.0,0.0
37557,3,7557,[ 64 318 313 301  11],345,5,32383,4.284599100291082,60.0,20.0
37558,3,7558,[ 64 318 313 301  11],416,5,32388,4.28469374255854,60.0,20.0
37559,3,7559,[ 64 318 313 301  11],345,5,32393,4.28478835978836,60.0,20.0
37560,3,7560,[288 318 237 197 111],437,3,32396,4.28461843671472,20.0,20.0
37561,3,7561,[282 273 268  12 153],416,5,32401,4.284713038878603,20.0,0.0
37562,3,7562,[ 64 318 313 301  11],43,5,32406,4.284807616025387,60.0,20.0
37563,3,7563,[ 70 127 238 181 323],416,4,32410,4.284769962982549,0.0,20.0
37564,3,7564,[ 69 276 118 215 168],43,5,32415,4.284864507600793,0.0,0.0
37565,3,7565,[ 64 318 313 301  11],345,5,32420,4.284959027227068,60.0,20.0
37566,3,7566,[ 64 318 313 301  11],416,5,32425,4.2850535218712835,60.0,20.0
37567,3,7567,[ 64 318 313 301  11],43,5,32430,4.28514799154334,60.0,20.0
37568,3,7568,[ 64 318 313 301  11],43,5,32435,4.285242436253138,60.0,20.0
37569,3,7569,[ 64 318 313 301  11],416,5,32440,4.285336856010568,60.0,20.0
37570,3,7570,[ 22 496 153 748 132],642,3,32443,4.285167084929336,0.0,0.0
37571,3,7571,[ 64 318 313 301  11],345,5,32448,4.2852614896988905,60.0,20.0
37572,3,7572,[ 64 318 313 301  11],43,5,32453,4.285355869536511,60.0,20.0
37573,3,7573,[ 22 176 385 435  89],405,1,32454,4.2849221019276476,0.0,0.0
37574,3,7574,[ 64 318 313 301  11],416,5,32459,4.285016501650165,60.0,20.0
37575,3,7575,[ 64 318 313 301  11],43,5,32464,4.285110876451953,60.0,20.0
37576,3,7576,[ 64 318 313 301  11],43,5,32469,4.28520522634288,60.0,20.0
37577,3,7577,[ 64 318 313 301  11],345,5,32474,4.285299551332805,60.0,20.0
37578,3,7578,[ 64 318 313 301  11],345,5,32479,4.2853938514315875,60.0,20.0
37579,3,7579,[ 64 318 313 301  11],43,5,32484,4.285488126649076,60.0,20.0
37580,3,7580,[143 100  69   8  25],887,3,32487,4.285318559556787,0.0,0.0
37581,3,7581,[ 64 318 313 301  11],416,5,32492,4.285412819836455,60.0,20.0
37582,3,7582,[216 197 175 111   8],854,3,32495,4.285243307398128,0.0,0.0
37583,3,7583,[ 64 318 313 301  11],416,5,32500,4.285337552742616,60.0,20.0
37584,3,7584,[ 64 318 313 301  11],416,5,32505,4.285431773236652,60.0,20.0
37585,3,7585,[ 64 318 313 301  11],416,5,32510,4.28552596889006,60.0,20.0
37586,3,7586,[ 64 318 313 301  11],43,5,32515,4.285620139712666,60.0,20.0
37587,3,7587,[ 64 318 313 301  11],345,5,32520,4.285714285714286,60.0,20.0
37588,3,7588,[ 64 318 313 301  11],345,5,32525,4.285808406904731,60.0,20.0
37589,3,7589,[ 64 318 313 301  11],416,5,32530,4.285902503293808,60.0,20.0
37590,3,7590,[257 405  95 748 117],654,5,32535,4.2859965748913185,0.0,0.0
37591,3,7591,[265 181 748 475  15],437,3,32538,4.285827186512118,0.0,20.0
37592,3,7592,[ 64 318 313 301  11],345,5,32543,4.285921243250362,60.0,20.0
37593,3,7593,[ 64 318 313 301  11],43,5,32548,4.286015275217276,60.0,20.0
37594,3,7594,[ 64 318 313 301  11],345,5,32553,4.286109282422647,60.0,20.0
37595,3,7595,[ 64 318 313 301  11],43,5,32558,4.28620326487625,60.0,20.0
37596,3,7596,[204 423 202 118 405],642,1,32559,4.285770698960116,0.0,0.0
37597,3,7597,[300 288 111 294 118],630,5,32564,4.285864701237168,0.0,20.0
37598,3,7598,[174 237 245 121 234],642,4,32568,4.285827082510857,0.0,0.0
37599,3,7599,[  4 276  15 748 127],416,4,32572,4.28578947368421,0.0,0.0
37600,3,7600,[ 64 318 313 301  11],416,5,32577,4.285883436389948,60.0,20.0
37601,3,7601,[ 64 318 313 301  11],416,5,32582,4.285977374375165,60.0,20.0
37602,3,7602,[273  98 234 194 301],297,3,32585,4.285808233592003,0.0,20.0
37603,3,7603,[289 195 333 678 471],416,3,32588,4.28563913729616,0.0,0.0
37604,3,7604,[ 64 318 313 301  11],345,5,32593,4.285733070348455,60.0,20.0
37605,3,7605,[ 64 318 313 301  11],416,5,32598,4.285826978701025,60.0,20.0
37606,3,7606,[ 64 318 313 301  11],43,5,32603,4.2859208623636125,60.0,20.0
37607,3,7607,[ 64 318 313 301  11],43,5,32608,4.286014721345952,60.0,20.0
37608,3,7608,[ 64 318 313 301  11],416,5,32613,4.286108555657774,60.0,20.0
37609,3,7609,[ 64 318 313 301  11],345,5,32618,4.286202365308804,60.0,20.0
37610,3,7610,[427 215 423  70 204],128,3,32621,4.2860333727499675,0.0,0.0
37611,3,7611,[ 64 318 313 301  11],43,5,32626,4.286127167630058,60.0,20.0
37612,3,7612,[ 64 318 313 301  11],416,5,32631,4.286220937869434,60.0,20.0
37613,3,7613,[ 64 318 313 301  11],345,5,32636,4.286314683477804,60.0,20.0
37614,3,7614,[ 64 318 313 301  11],43,5,32641,4.286408404464872,60.0,20.0
37615,3,7615,[173 172  71 174   1],642,5,32646,4.286502100840337,0.0,0.0
37616,3,7616,[ 64 318 313 301  11],345,5,32651,4.28659577261389,60.0,20.0
37617,3,7617,[546 132 323 318  22],416,3,32654,4.2864268836965085,20.0,0.0
37618,3,7618,[ 64 318 313 301  11],43,5,32659,4.286520540753379,60.0,20.0
37619,3,7619,[ 64 318 313 301  11],345,5,32664,4.2866141732283465,60.0,20.0
37620,3,7620,[ 64 318 313 301  11],43,5,32669,4.286707781131085,60.0,20.0
37621,3,7621,[186 182  64   8  95],230,4,32673,4.286670165310942,20.0,0.0
37622,3,7622,[ 64 318 313 301  11],345,5,32678,4.286763741309196,60.0,20.0
37623,3,7623,[ 12 197 121 228 183],805,3,32681,4.286594963273872,20.0,0.0
37624,3,7624,[ 64 318 313 301  11],345,5,32686,4.286688524590164,60.0,20.0
37625,3,7625,[ 64 318 313 301  11],43,5,32691,4.286782061369001,60.0,20.0
37626,3,7626,[ 64 318 313 301  11],345,5,32696,4.286875573620034,60.0,20.0
37627,3,7627,[265 132 742 258 186],128,2,32698,4.286575773466177,0.0,0.0
37628,3,7628,[ 64 318 313 301  11],43,5,32703,4.2866692882422335,60.0,20.0
37629,3,7629,[ 64 318 313 301  11],416,5,32708,4.2867627785058975,60.0,20.0
37630,3,7630,[ 64 318 313 301  11],345,5,32713,4.286856244266806,60.0,20.0
37631,3,7631,[ 64 318 313 301  11],345,5,32718,4.286949685534591,60.0,20.0
37632,3,7632,[ 64 318 313 301  11],345,5,32723,4.287043102318878,60.0,20.0
37633,3,7633,[  8 153 300 403  64],416,5,32728,4.28713649462929,20.0,0.0
37634,3,7634,[268 403  12 210 204],345,4,32732,4.28709888670596,20.0,0.0
37635,3,7635,[ 64 318 313 301  11],43,5,32737,4.287192247249869,60.0,20.0
37636,3,7636,[202  96 333 161 294],416,5,32742,4.287285583344245,0.0,0.0
37637,3,7637,[ 64 318 313 301  11],43,5,32747,4.287378894998691,60.0,20.0
37638,3,7638,[ 64 318 313 301  11],345,5,32752,4.287472182222804,60.0,20.0
37639,3,7639,[742  69 117  12 144],416,5,32757,4.287565445026178,20.0,0.0
37640,3,7640,[235 238  28 403 313],43,3,32760,4.287396937573616,20.0,20.0
37641,3,7641,[179 546 118  97 182],416,2,32762,4.287097618424496,0.0,0.0
37642,3,7642,[655 168 144 238  96],417,3,32765,4.286929216276332,0.0,0.0
37643,3,7643,[ 64 318 313 301  11],43,5,32770,4.287022501308216,60.0,20.0
37644,3,7644,[ 64 318 313 301  11],43,5,32775,4.2871157619359055,60.0,20.0
37645,3,7645,[ 64 318 313 301  11],43,5,32780,4.287208998168977,60.0,20.0
37646,3,7646,[ 64 318 313 301  11],345,5,32785,4.287302210017,60.0,20.0
37647,3,7647,[175 186 132 288 385],405,3,32788,4.287133891213389,0.0,20.0
37648,3,7648,[135   1  50 216   4],297,3,32791,4.2869656164204475,0.0,20.0
37649,3,7649,[385   1 597   8 204],416,4,32795,4.286928104575163,0.0,0.0
37650,3,7650,[180 258 271 288 183],805,1,32796,4.286498496928506,0.0,20.0
37651,3,7651,[194  25  96 405 302],751,4,32800,4.286461055933089,0.0,0.0
37652,3,7652,[172 186 182  50 288],417,2,32802,4.286162289298314,0.0,40.0
37653,3,7653,[ 64 318 313 301  11],416,5,32807,4.286255552652208,60.0,20.0
37654,3,7654,[ 64 318 313 301  11],416,5,32812,4.286348791639451,60.0,20.0
37655,3,7655,[ 64 318 313 301  11],345,5,32817,4.286442006269592,60.0,20.0
37656,3,7656,[ 64 318 313 301  11],345,5,32822,4.286535196552174,60.0,20.0
37657,3,7657,[269 196 323 271 275],43,3,32825,4.2863671977017495,0.0,0.0
37658,3,7658,[ 64 318 313 301  11],416,5,32830,4.286460373416896,60.0,20.0
37659,3,7659,[176 234 313 238  25],416,5,32835,4.2865535248041775,20.0,20.0
37660,3,7660,[ 64 318 313 301  11],43,5,32840,4.286646651873124,60.0,20.0
37661,3,7661,[ 64 318 313 301  11],43,5,32845,4.286739754633255,60.0,20.0
37662,3,7662,[ 64 318 313 301  11],43,5,32850,4.286832833094088,60.0,20.0
37663,3,7663,[176 288  11 403  96],405,3,32853,4.286664926931106,0.0,20.0
37664,3,7664,[ 64 318 313 301  11],345,5,32858,4.28675799086758,60.0,20.0
37665,3,7665,[ 64 318 313 301  11],345,5,32863,4.286851030524393,60.0,20.0
37666,3,7666,[181 655  15 222  79],128,3,32866,4.286683187687492,0.0,20.0
37667,3,7667,[ 64 318 313 301  11],345,5,32871,4.286776212832551,60.0,20.0
37668,3,7668,[195 483 185 172 100],214,4,32875,4.28673881862042,20.0,0.0
37669,3,7669,[ 25 222 475  82 271],805,3,32878,4.286571056062582,0.0,0.0
37670,3,7670,[ 64 318 313 301  11],43,5,32883,4.286664059444662,60.0,20.0
37671,3,7671,[ 64 318 313 301  11],345,5,32888,4.2867570385818565,60.0,20.0
37672,3,7672,[ 64 318 313 301  11],416,5,32893,4.286849993483644,60.0,20.0
37673,3,7673,[ 64 318 313 301  11],345,5,32898,4.2869429241595,60.0,20.0
37674,3,7674,[313  97 172 268 197],416,5,32903,4.287035830618892,20.0,20.0
37675,3,7675,[ 64 318 313 301  11],416,5,32908,4.287128712871287,60.0,20.0
37676,3,7676,[185 191   4 322 258],417,2,32910,4.286830793278624,0.0,0.0
37677,3,7677,[ 64 318 313 301  11],345,5,32915,4.286923678041156,60.0,20.0
37678,3,7678,[ 64 318 313 301  11],345,5,32920,4.287016538611798,60.0,20.0
37679,3,7679,[ 64 318 313 301  11],43,5,32925,4.287109375,60.0,20.0
37680,3,7680,[275 196 144 197 257],416,4,32929,4.287071995833876,0.0,0.0
37681,3,7681,[ 64 318 313 301  11],43,5,32934,4.287164800833116,60.0,20.0
37682,3,7682,[ 64 318 313 301  11],43,5,32939,4.287257581673825,60.0,20.0
37683,3,7683,[568 546 127 276 405],43,5,32944,4.287350338365434,0.0,0.0
37684,3,7684,[ 64 318 313 301  11],43,5,32949,4.287443070917371,60.0,20.0
37685,3,7685,[ 64 318 313 301  11],43,5,32954,4.287535779339058,60.0,20.0
37686,3,7686,[ 64 318 313 301  11],43,5,32959,4.287628463639911,60.0,20.0
37687,3,7687,[195  96 301 322  25],416,4,32963,4.287591050988554,0.0,0.0
37688,3,7688,[ 82 202 427 121 313],416,5,32968,4.287683703992717,20.0,20.0
37689,3,7689,[ 28 211  82 197 194],416,5,32973,4.28777633289987,0.0,0.0
37690,3,7690,[ 64 318 313 301  11],43,5,32978,4.287868937719412,60.0,20.0
37691,3,7691,[ 64 318 313 301  11],43,5,32983,4.2879615184607385,60.0,20.0
37692,3,7692,[ 64 318 313 301  11],416,5,32988,4.288054075133238,60.0,20.0
37693,3,7693,[302 318 357 111 268],416,5,32993,4.288146607746296,20.0,0.0
37694,3,7694,[ 64 318 313 301  11],43,5,32998,4.288239116309292,60.0,20.0
37695,3,7695,[ 82 515 323 196 300],416,4,33002,4.288201663201663,0.0,0.0
37696,3,7696,[151 275  15 168 405],43,5,33007,4.28829414057425,0.0,0.0
37697,3,7697,[ 82 322 228 245 204],128,2,33009,4.287996882307093,0.0,0.0
37698,3,7698,[ 64 318 313 301  11],345,5,33014,4.288089362254838,60.0,20.0
37699,3,7699,[ 64 318 313 301  11],43,5,33019,4.288181818181818,60.0,20.0
37700,3,7700,[ 64 318 313 301  11],416,5,33024,4.28827425009739,60.0,20.0
37701,3,7701,[222 181   4   8  71],654,3,33027,4.28810698519865,0.0,20.0
37702,3,7702,[ 64 318 313 301  11],416,5,33032,4.288199402830066,60.0,20.0
37703,3,7703,[ 64 318 313 301  11],345,5,33037,4.288291796469367,60.0,20.0
37704,3,7704,[568 174 117 153 151],198,3,33040,4.288124594419208,0.0,0.0
37705,3,7705,[ 64 318 313 301  11],43,5,33045,4.28821697378666,60.0,20.0
37706,3,7706,[ 50 151 245 313 172],345,4,33049,4.288179577007915,20.0,40.0
37707,3,7707,[748 127 318  97  25],373,3,33052,4.288012454592631,20.0,0.0
37708,3,7708,[ 64 318 313 301  11],416,5,33057,4.288104812556752,60.0,20.0
37709,3,7709,[ 64 318 313 301  11],416,5,33062,4.288197146562905,60.0,20.0
37710,3,7710,[597   1 143 181 151],642,4,33066,4.2881597717546365,0.0,20.0
37711,3,7711,[ 64 318 313 301  11],345,5,33071,4.288252074688796,60.0,20.0
37712,3,7712,[ 64 318 313 301  11],43,5,33076,4.2883443536885775,60.0,20.0
37713,3,7713,[ 64 318 313 301  11],345,5,33081,4.288436608763288,60.0,20.0
37714,3,7714,[ 95 748 135  50 276],198,2,33083,4.288139987038237,0.0,20.0
37715,3,7715,[655 111 132 423 385],416,5,33088,4.288232244686366,0.0,0.0
37716,3,7716,[ 64 318 313 301  11],43,5,33093,4.288324478424258,60.0,20.0
37717,3,7717,[ 64 318 313 301  11],43,5,33098,4.288416688261208,60.0,20.0
37718,3,7718,[191 180   4 597   7],62,4,33102,4.288379323746599,0.0,0.0
37719,3,7719,[655 197 196 118 475],198,3,33105,4.28821243523316,0.0,0.0
37720,3,7720,[ 64 318 313 301  11],43,5,33110,4.2883046237534,60.0,20.0
37721,3,7721,[ 64 318 313 301  11],43,5,33115,4.288396788396788,60.0,20.0
37722,3,7722,[ 64 318 313 301  11],345,5,33120,4.288488929172601,60.0,20.0
37723,3,7723,[301 271 294 748  69],297,1,33121,4.288063179699638,0.0,0.0
37724,3,7724,[ 64 318 313 301  11],43,5,33126,4.288155339805825,60.0,20.0
37725,3,7725,[ 64 318 313 301  11],43,5,33131,4.288247476054879,60.0,20.0
37726,3,7726,[ 64 318 313 301  11],416,5,33136,4.288339588456063,60.0,20.0
37727,3,7727,[ 64 318 313 301  11],43,5,33141,4.288431677018633,60.0,20.0
37728,3,7728,[ 64 318 313 301  11],416,5,33146,4.288523741751844,60.0,20.0
37729,3,7729,[ 97  25 174 200 678],297,3,33149,4.288357050452781,0.0,0.0
37730,3,7730,[172  97 181 328 568],505,3,33152,4.288190402276549,0.0,20.0
37731,3,7731,[282 328 215   1 748],416,5,33157,4.288282462493533,0.0,0.0
37732,3,7732,[ 64 318 313 301  11],416,5,33162,4.288374498900815,60.0,20.0
37733,3,7733,[ 64 318 313 301  11],416,5,33167,4.288466511507629,60.0,20.0
37734,3,7734,[ 64 318 313 301  11],416,5,33172,4.288558500323206,60.0,20.0
37735,3,7735,[ 15 111 228 245 186],128,2,33174,4.288262668045501,0.0,0.0
37736,3,7736,[ 64 318 313 301  11],416,5,33179,4.288354659428719,60.0,20.0
37737,3,7737,[742 144 168 182 234],230,3,33182,4.288188162315844,0.0,0.0
37738,3,7738,[ 64 318 313 301  11],43,5,33187,4.2882801395529135,60.0,20.0
37739,3,7739,[ 64 318 313 301  11],345,5,33192,4.288372093023256,60.0,20.0
37740,3,7740,[181 748  95 183 191],805,2,33194,4.288076475907506,0.0,20.0
37741,3,7741,[  9  71  15 117  88],618,3,33197,4.28791010074916,0.0,0.0
37742,3,7742,[ 12 173 742 197 144],297,2,33199,4.2876146196564635,20.0,0.0
37743,3,7743,[ 64 318 313 301  11],43,5,33204,4.287706611570248,60.0,20.0
37744,3,7744,[ 64  98 197 121  69],711,3,33207,4.287540348612008,20.0,20.0
37745,3,7745,[742 301 176 678 423],416,4,33211,4.287503227472244,0.0,0.0
37746,3,7746,[200 118 144 215  12],416,4,33215,4.287466115915838,20.0,0.0
37747,3,7747,[ 64 318 313 301  11],416,5,33220,4.287558079504389,60.0,20.0
37748,3,7748,[117 185 194 301 265],416,5,33225,4.287650019357336,0.0,0.0
37749,3,7749,[ 25 195  22 238 471],618,1,33226,4.287225806451613,0.0,0.0
37750,3,7750,[ 64 318 313 301  11],345,5,33231,4.287317765449619,60.0,20.0
37751,3,7751,[ 64 318 313 301  11],416,5,33236,4.287409700722394,60.0,20.0
37752,3,7752,[288 357 237  50  64],642,3,33239,4.287243647620276,20.0,40.0
37753,3,7753,[ 64 318 313 301  11],43,5,33244,4.287335568738715,60.0,20.0
37754,3,7754,[ 64 318 313 301  11],345,5,33249,4.28742746615087,60.0,20.0
37755,3,7755,[180 179 269 191 125],373,3,33252,4.2872614749871065,0.0,0.0
37756,3,7756,[234 168 423 210 194],405,3,33255,4.287095526621116,0.0,0.0
37757,3,7757,[  4  89 742  22 228],297,2,33257,4.286800721835524,0.0,0.0
37758,3,7758,[ 64 318 313 301  11],345,5,33262,4.286892640804227,60.0,20.0
37759,3,7759,[ 22 125 215 175 127],373,3,33265,4.286726804123711,0.0,0.0
37760,3,7760,[ 64 318 313 301  11],345,5,33270,4.286818708929261,60.0,20.0
37761,3,7761,[ 64 318 313 301  11],43,5,33275,4.286910590054109,60.0,20.0
37762,3,7762,[ 64 318 313 301  11],345,5,33280,4.287002447507407,60.0,20.0
37763,3,7763,[ 64 318 313 301  11],345,5,33285,4.2870942812983,60.0,20.0
37764,3,7764,[269  71 117 168 125],373,5,33290,4.28718609143593,0.0,0.0
37765,3,7765,[ 64 318 313 301  11],345,5,33295,4.287277877929436,60.0,20.0
37766,3,7766,[ 64 318 313 301  11],345,5,33300,4.287369640787949,60.0,20.0
37767,3,7767,[ 11  56 111  98 238],854,4,33304,4.287332646755922,0.0,20.0
37768,3,7768,[423  50 475 117  98],49,2,33306,4.287038228858283,0.0,40.0
37769,3,7769,[276 175 471 588 222],922,2,33308,4.286743886743887,0.0,0.0
37770,3,7770,[ 64 318 313 301  11],345,5,33313,4.286835671084803,60.0,20.0
37771,3,7771,[235 181 273 508 191],62,5,33318,4.286927431806485,0.0,20.0
37772,3,7772,[546  82 257 597 196],705,4,33322,4.28689051846134,0.0,0.0
37773,3,7773,[202 100   7 144 265],618,4,33326,4.286853614612812,0.0,0.0
37774,3,7774,[ 64 318 313 301  11],43,5,33331,4.286945337620579,60.0,20.0
37775,3,7775,[ 64 318 313 301  11],416,5,33336,4.287037037037037,60.0,20.0
37776,3,7776,[301  28 151 173 168],437,2,33338,4.286742960010287,0.0,0.0
37777,3,7777,[ 64 318 313 301  11],416,5,33343,4.286834661866804,60.0,20.0
37778,3,7778,[ 64 318 313 301  11],345,5,33348,4.2869263401465485,60.0,20.0
37779,3,7779,[ 64 318 313 301  11],416,5,33353,4.287017994858612,60.0,20.0
37780,3,7780,[ 64 318 313 301  11],345,5,33358,4.2871096260120805,60.0,20.0
37781,3,7781,[323  12  82 182  69],417,3,33361,4.286944230274994,20.0,0.0
37782,3,7782,[ 96 125   8 275 237],854,2,33363,4.286650391879738,0.0,0.0
37783,3,7783,[403 153 200 215 228],922,2,33365,4.286356628982528,0.0,0.0
37784,3,7784,[ 97  69 323 216 143],416,4,33369,4.2863198458574185,0.0,0.0
37785,3,7785,[ 64 318 313 301  11],43,5,33374,4.286411507834575,60.0,20.0
37786,3,7786,[ 64 318 313 301  11],43,5,33379,4.286503146269423,60.0,20.0
37787,3,7787,[ 64 318 313 301  11],43,5,33384,4.286594761171032,60.0,20.0
37788,3,7788,[ 64 318 313 301  11],345,5,33389,4.2866863525484655,60.0,20.0
37789,3,7789,[ 96  25 151 357 135],854,3,33392,4.286521181001284,0.0,0.0
37790,3,7790,[ 64 318 313 301  11],416,5,33397,4.286612758310872,60.0,20.0
37791,3,7791,[ 64 318 313 301  11],345,5,33402,4.28670431211499,60.0,20.0
37792,3,7792,[ 64 318 313 301  11],416,5,33407,4.286795842422687,60.0,20.0
37793,3,7793,[ 64 318 313 301  11],416,5,33412,4.286887349243007,60.0,20.0
37794,3,7794,[ 64 318 313 301  11],345,5,33417,4.286978832584991,60.0,20.0
37795,3,7795,[ 64 318 313 301  11],345,5,33422,4.2870702924576705,60.0,20.0
37796,3,7796,[ 64 318 313 301  11],345,5,33427,4.287161728870078,60.0,20.0
37797,3,7797,[ 64 318 313 301  11],416,5,33432,4.287253141831239,60.0,20.0
37798,3,7798,[ 95 185 176 357 427],230,5,33437,4.287344531350173,0.0,0.0
37799,3,7799,[ 64 318 313 301  11],416,5,33442,4.2874358974358975,60.0,20.0
37800,3,7800,[ 71 118 742  70 269],416,4,33446,4.287399051403666,0.0,0.0
37801,3,7801,[ 69 176   1 117 132],230,5,33451,4.287490387080235,0.0,0.0
37802,3,7802,[568  11 180 222 318],198,2,33453,4.28719723183391,20.0,0.0
37803,3,7803,[237 195 100 597  11],654,4,33457,4.287160430548437,0.0,0.0
37804,3,7804,[ 64 318 313 301  11],416,5,33462,4.287251761691223,60.0,20.0
37805,3,7805,[ 64 318 313 301  11],416,5,33467,4.287343069433769,60.0,20.0
37806,3,7806,[ 64 318 313 301  11],43,5,33472,4.2874343537850645,60.0,20.0
37807,3,7807,[ 64 318 313 301  11],345,5,33477,4.287525614754099,60.0,20.0
37808,3,7808,[ 64 318 313 301  11],345,5,33482,4.287616852349853,60.0,20.0
37809,3,7809,[ 12  79 121 186  70],437,2,33484,4.2873239436619714,20.0,0.0
37810,3,7810,[ 64 318 313 301  11],43,5,33489,4.287415183715273,60.0,20.0
37811,3,7811,[ 64 318 313 301  11],416,5,33494,4.287506400409626,60.0,20.0
37812,3,7812,[ 64 318 313 301  11],345,5,33499,4.287597593754,60.0,20.0
37813,3,7813,[ 64 318 313 301  11],345,5,33504,4.287688763757359,60.0,20.0
37814,3,7814,[187 111 127 172 423],887,3,33507,4.287523992322456,0.0,0.0
37815,3,7815,[ 64 318 313 301  11],43,5,33512,4.2876151484135105,60.0,20.0
37816,3,7816,[135  98 483 288  11],437,3,33515,4.287450428553154,20.0,40.0
37817,3,7817,[ 64 318 313 301  11],43,5,33520,4.287541570734203,60.0,20.0
37818,3,7818,[ 64 318 313 301  11],416,5,33525,4.287632689602251,60.0,20.0
37819,3,7819,[ 64 318 313 301  11],43,5,33530,4.28772378516624,60.0,20.0
37820,3,7820,[ 64 318 313 301  11],416,5,33535,4.2878148574351105,60.0,20.0
37821,3,7821,[588 211  56 216 143],230,4,33539,4.287778061876758,0.0,0.0
37822,3,7822,[ 64 318 313 301  11],345,5,33544,4.287869103924326,60.0,20.0
37823,3,7823,[  1 237 257 678  56],654,5,33549,4.287960122699387,0.0,0.0
37824,3,7824,[ 64 318 313 301  11],416,5,33554,4.288051118210863,60.0,20.0
37825,3,7825,[211 237  56 238  15],437,5,33559,4.288142090467672,0.0,0.0
37826,3,7826,[  1 258  97 294 174],43,5,33564,4.288233039478728,0.0,0.0
37827,3,7827,[ 64 318 313 301  11],43,5,33569,4.288323965252938,60.0,20.0
37828,3,7828,[ 64 318 313 301  11],43,5,33574,4.288414867799208,60.0,20.0
37829,3,7829,[ 64 318 313 301  11],416,5,33579,4.288505747126437,60.0,20.0
37830,3,7830,[111 597 194 237   7],416,3,33582,4.28834120801941,0.0,0.0
37831,3,7831,[ 64 318 313 301  11],43,5,33587,4.288432073544433,60.0,20.0
37832,3,7832,[568 172 151 588 294],654,4,33591,4.288395250861739,0.0,0.0
37833,3,7833,[ 64 318 313 301  11],416,5,33596,4.288486086290528,60.0,20.0
37834,3,7834,[ 64 318 313 301  11],345,5,33601,4.288576898532227,60.0,20.0
37835,3,7835,[276 153 269 258 273],416,4,33605,4.288540071465033,0.0,0.0
37836,3,7836,[483  82 294 333 161],588,5,33610,4.288630853642975,20.0,0.0
37837,3,7837,[ 64 318 313 301  11],43,5,33615,4.28872161265629,60.0,20.0
37838,3,7838,[ 64 318 313 301  11],345,5,33620,4.288812348513841,60.0,20.0
37839,3,7839,[ 64 318 313 301  11],416,5,33625,4.28890306122449,60.0,20.0
37840,3,7840,[ 64 318 313 301  11],345,5,33630,4.2889937507970926,60.0,20.0
37841,3,7841,[ 64 318 313 301  11],43,5,33635,4.2890844172405,60.0,20.0
37842,3,7842,[ 22 200 121 196   8],805,1,33636,4.288665051638404,0.0,0.0
37843,3,7843,[ 64 318 313 301  11],416,5,33641,4.288755736868945,60.0,20.0
37844,3,7844,[ 64 318 313 301  11],416,5,33646,4.288846398980242,60.0,20.0
37845,3,7845,[ 64 318 313 301  11],43,5,33651,4.288937037981137,60.0,20.0
37846,3,7846,[ 64 318 313 301  11],416,5,33656,4.2890276538804635,60.0,20.0
37847,3,7847,[111  96  69 301 294],416,5,33661,4.289118246687054,0.0,0.0
37848,3,7848,[173 245 257 273 435],297,2,33663,4.288826602114919,0.0,0.0
37849,3,7849,[ 64 318 313 301  11],416,5,33668,4.288917197452229,60.0,20.0
37850,3,7850,[294 288 289 153 125],342,2,33670,4.288625652783085,0.0,20.0
37851,3,7851,[ 64 318 313 301  11],416,5,33675,4.288716250636781,60.0,20.0
37852,3,7852,[ 64 318 313 301  11],416,5,33680,4.288806825417038,60.0,20.0
37853,3,7853,[ 12 135 185  64 515],405,4,33684,4.288770053475936,40.0,0.0
37854,3,7854,[ 64 318 313 301  11],416,5,33689,4.288860598345003,60.0,20.0
37855,3,7855,[ 64 318 313 301  11],416,5,33694,4.288951120162933,60.0,20.0
37856,3,7856,[ 64 318 313 301  11],43,5,33699,4.289041618938526,60.0,20.0
37857,3,7857,[ 64 318 313 301  11],345,5,33704,4.28913209468058,60.0,20.0
37858,3,7858,[ 64 318 313 301  11],345,5,33709,4.2892225473978876,60.0,20.0
37859,3,7859,[ 89 508   8 215 151],62,4,33713,4.289185750636133,0.0,0.0
37860,3,7860,[ 64 318 313 301  11],345,5,33718,4.28927617351482,60.0,20.0
37861,3,7861,[ 95 135  79 427  88],618,4,33722,4.289239379292801,0.0,0.0
37862,3,7862,[ 64 318 313 301  11],345,5,33727,4.28932977235152,60.0,20.0
37863,3,7863,[135 333 318 132  88],496,1,33728,4.288911495422177,20.0,0.0
37864,3,7864,[ 64 318 313 301  11],345,5,33733,4.289001907183725,60.0,20.0
37865,3,7865,[ 89 143 174 294  28],297,4,33737,4.288965166539537,0.0,0.0
37866,3,7866,[ 64 318 313 301  11],43,5,33742,4.289055548493708,60.0,20.0
37867,3,7867,[127 496 471 588  71],416,5,33747,4.289145907473309,0.0,0.0
37868,3,7868,[ 64 318 313 301  11],416,5,33752,4.289236243487101,60.0,20.0
37869,3,7869,[323 286 269 127 245],782,2,33754,4.2889453621346885,0.0,0.0
37870,3,7870,[143  64 228 483 222],128,3,33757,4.288781603354084,40.0,0.0
37871,3,7871,[195  11 151  56 210],922,2,33759,4.288490853658536,0.0,0.0
37872,3,7872,[ 64 318 313 301  11],43,5,33764,4.28858122697828,60.0,20.0
37873,3,7873,[ 64 318 313 301  11],43,5,33769,4.2886715773431545,60.0,20.0
37874,3,7874,[385  12  95 405  98],43,5,33774,4.2887619047619046,20.0,20.0
37875,3,7875,[ 64 318 313 301  11],345,5,33779,4.288852209243271,60.0,20.0
37876,3,7876,[ 56 235 195  88 237],416,2,33781,4.288561635140282,0.0,0.0
37877,3,7877,[168 568 222   1 173],698,3,33784,4.288398070576289,0.0,0.0
37878,3,7878,[ 64 318 313 301  11],416,5,33789,4.288488386851124,60.0,20.0
37879,3,7879,[235 125   4 258  12],854,2,33791,4.288197969543147,20.0,0.0
37880,3,7880,[ 64 318 313 301  11],416,5,33796,4.288288288288288,60.0,20.0
37881,3,7881,[ 64 318 313 301  11],416,5,33801,4.288378584115707,60.0,20.0
37882,3,7882,[257 294  82 151  15],921,2,33803,4.2880882912596725,0.0,0.0
37883,3,7883,[ 64 318 313 301  11],345,5,33808,4.288178589548453,60.0,20.0
37884,3,7884,[294 111 508 427 135],342,1,33809,4.287761572606215,0.0,0.0
37885,3,7885,[ 64 318 313 301  11],43,5,33814,4.287851889424296,60.0,20.0
37886,3,7886,[ 64 318 313 301  11],416,5,33819,4.2879421833396725,60.0,20.0
37887,3,7887,[ 64 318 313 301  11],43,5,33824,4.288032454361055,60.0,20.0
37888,3,7888,[ 64 318 313 301  11],43,5,33829,4.288122702497148,60.0,20.0
37889,3,7889,[265  97 323 273 234],416,4,33833,4.28808618504436,0.0,0.0
37890,3,7890,[ 64 318 313 301  11],43,5,33838,4.288176403497656,60.0,20.0
37891,3,7891,[ 64 318 313 301  11],345,5,33843,4.288266599087684,60.0,20.0
37892,3,7892,[185  97 125 153  70],417,4,33847,4.288230077283669,0.0,0.0
37893,3,7893,[ 79 222 655 282 182],253,4,33851,4.288193564732708,0.0,0.0
37894,3,7894,[ 79 127  64 210 161],405,4,33855,4.288157061431286,20.0,0.0
37895,3,7895,[238 603 597 322  11],805,2,33857,4.287867274569402,0.0,0.0
37896,3,7896,[ 64 318 313 301  11],345,5,33862,4.287957452197037,60.0,20.0
37897,3,7897,[ 64 318 313 301  11],345,5,33867,4.288047606989111,60.0,20.0
37898,3,7898,[ 64 318 313 301  11],416,5,33872,4.288137738954298,60.0,20.0
37899,3,7899,[ 64 318 313 301  11],345,5,33877,4.288227848101266,60.0,20.0
37900,3,7900,[204 483 508 143 185],601,3,33880,4.288064801923807,20.0,0.0
37901,3,7901,[ 64 318 313 301  11],345,5,33885,4.288154897494305,60.0,20.0
37902,3,7902,[151 603 265 216 357],416,4,33889,4.288118436036948,0.0,0.0
37903,3,7903,[ 82 603 191 568  97],416,5,33894,4.2882085020242915,0.0,0.0
37904,3,7904,[ 64 318 313 301  11],345,5,33899,4.288298545224541,60.0,20.0
37905,3,7905,[161  11  56  88 269],805,2,33901,4.288009107007336,0.0,0.0
37906,3,7906,[173 168 271 222  56],297,4,33905,4.287972682433287,0.0,0.0
37907,3,7907,[748 196 202 186 276],437,4,33909,4.28793626707132,0.0,0.0
37908,3,7908,[100 235  97 215 515],416,4,33913,4.287899860917942,0.0,0.0
37909,3,7909,[ 64 318 313 301  11],416,5,33918,4.287989886219974,60.0,20.0
37910,3,7910,[ 64 318 313 301  11],43,5,33923,4.288079888762483,60.0,20.0
37911,3,7911,[ 64 318 313 301  11],345,5,33928,4.288169868554095,60.0,20.0
37912,3,7912,[127   1  11 117 471],43,4,33932,4.288133451282699,0.0,0.0
37913,3,7913,[ 64 318 313 301  11],43,5,33937,4.288223401566843,60.0,20.0
37914,3,7914,[ 70 300 273 245   7],297,3,33940,4.288060644346178,0.0,0.0
37915,3,7915,[181 323 275 678 245],759,3,33943,4.287897928246589,0.0,20.0
37916,3,7916,[ 64 318 313 301  11],43,5,33948,4.287987874194771,60.0,20.0
37917,3,7917,[180 161 143 216 168],128,5,33953,4.2880777974235915,0.0,0.0
37918,3,7918,[ 82 276 210 271  64],62,4,33957,4.288041419371133,20.0,0.0
37919,3,7919,[ 64 318 313 301  11],345,5,33962,4.288131313131313,60.0,20.0
37920,3,7920,[235 403   1 568 237],642,4,33966,4.28809493750789,0.0,0.0
37921,3,7921,[245 100 151 186 483],417,4,33970,4.288058571067912,20.0,0.0
37922,3,7922,[ 64 318 313 301  11],43,5,33975,4.2881484286255205,60.0,20.0
37923,3,7923,[ 64 318 313 301  11],43,5,33980,4.288238263503281,60.0,20.0
37924,3,7924,[100 742 515 228 181],297,3,33983,4.2880757097791795,0.0,20.0
37925,3,7925,[ 64 318 313 301  11],345,5,33988,4.28816553116326,60.0,20.0
37926,3,7926,[ 12 191  70 168 403],405,3,33991,4.288003027627097,20.0,0.0
37927,3,7927,[258 176 238 100 302],62,4,33995,4.287966700302724,0.0,0.0
37928,3,7928,[ 64 318 313 301  11],345,5,34000,4.288056501450372,60.0,20.0
37929,3,7929,[597 289 546  69 183],416,2,34002,4.2877679697351825,0.0,0.0
37930,3,7930,[ 64 318 313 301  11],43,5,34007,4.287857773294666,60.0,20.0
37931,3,7931,[ 64 318 313 301  11],43,5,34012,4.287947554210792,60.0,20.0
37932,3,7932,[ 64 318 313 301  11],345,5,34017,4.288037312492121,60.0,20.0
37933,3,7933,[127 515 161 100 200],417,3,34020,4.287874968490043,0.0,0.0
37934,3,7934,[301 294 313  98 318],345,4,34024,4.287838689350977,40.0,40.0
37935,3,7935,[222 269 234 257 151],297,2,34026,4.287550403225806,0.0,0.0
37936,3,7936,[  9 210 118 228 385],887,4,34030,4.287514174121204,0.0,0.0
37937,3,7937,[ 64 318 313 301  11],416,5,34035,4.287603930461073,60.0,20.0
37938,3,7938,[ 71 197 173  98  82],405,4,34039,4.287567703741026,0.0,20.0
37939,3,7939,[294 748 175 588  69],297,2,34041,4.28727959697733,0.0,0.0
37940,3,7940,[ 64 318 313 301  11],416,5,34046,4.287369348948495,60.0,20.0
37941,3,7941,[ 64 318 313 301  11],43,5,34051,4.287459078317804,60.0,20.0
37942,3,7942,[ 64 318 313 301  11],43,5,34056,4.287548785093794,60.0,20.0
37943,3,7943,[597 176 515 588  95],417,3,34059,4.287386706948641,0.0,0.0
37944,3,7944,[ 64 318 313 301  11],416,5,34064,4.28747640025173,60.0,20.0
37945,3,7945,[ 64 318 313 301  11],345,5,34069,4.287566070979109,60.0,20.0
37946,3,7946,[196  95 186 258 222],198,2,34071,4.287278218195546,0.0,0.0
37947,3,7947,[ 64 318 313 301  11],345,5,34076,4.287367891293407,60.0,20.0
37948,3,7948,[ 64 318 313 301  11],416,5,34081,4.287457541829161,60.0,20.0
37949,3,7949,[ 64 318 313 301  11],43,5,34086,4.287547169811321,60.0,20.0
37950,3,7950,[216 135 588 215 187],405,3,34089,4.2873852345616905,0.0,0.0
37951,3,7951,[204 117 597  97   4],43,4,34093,4.287349094567404,0.0,0.0
37952,3,7952,[ 64 318 313 301  11],345,5,34098,4.287438702376462,60.0,20.0
37953,3,7953,[471 194 191   4 173],373,4,34102,4.287402564747297,0.0,0.0
37954,3,7954,[181 161   9  28 202],43,5,34107,4.287492143306097,0.0,20.0
37955,3,7955,[ 25 174 176 237 286],764,4,34111,4.287456008044243,0.0,0.0
37956,3,7956,[245 183 182 655 238],416,4,34115,4.287419881865024,0.0,0.0
37957,3,7957,[ 64 318 313 301  11],345,5,34120,4.287509424478512,60.0,20.0
37958,3,7958,[ 64 318 313 301  11],345,5,34125,4.287598944591029,60.0,20.0
37959,3,7959,[ 64 318 313 301  11],345,5,34130,4.2876884422110555,60.0,20.0
37960,3,7960,[313  11 210 185  82],416,5,34135,4.287777917347067,20.0,20.0
37961,3,7961,[117  12 301 132  95],437,3,34138,4.28761617683999,20.0,0.0
37962,3,7962,[ 64 318 313 301  11],416,5,34143,4.287705638578426,60.0,20.0
37963,3,7963,[168 301 603 196 204],437,3,34146,4.287543947764942,0.0,0.0
37964,3,7964,[183 196  97  82   7],416,5,34151,4.287633396107973,0.0,0.0
37965,3,7965,[ 64 318 313 301  11],345,5,34156,4.287722821993472,60.0,20.0
37966,3,7966,[222 172 423 405 204],887,3,34159,4.287561189908372,0.0,0.0
37967,3,7967,[187 183 211 175 191],698,0,34159,4.287023092369478,0.0,0.0
37968,3,7968,[ 64 318 313 301  11],345,5,34164,4.287112561174552,60.0,20.0
37969,3,7969,[ 64 318 313 301  11],416,5,34169,4.287202007528231,60.0,20.0
37970,3,7970,[ 69 257  64 118 222],43,5,34174,4.287291431438966,20.0,0.0
37971,3,7971,[202 475 273 245 515],417,4,34178,4.287255393878575,0.0,0.0
37972,3,7972,[ 82   8 191   4 265],405,4,34182,4.287219365358084,0.0,0.0
37973,3,7973,[ 64 318 313 301  11],416,5,34187,4.287308753448708,60.0,20.0
37974,3,7974,[ 64 318 313 301  11],43,5,34192,4.287398119122257,60.0,20.0
37975,3,7975,[ 64 318 313 301  11],43,5,34197,4.287487462387161,60.0,20.0
37976,3,7976,[183 403 271 135  82],805,3,34200,4.287326062429485,0.0,0.0
37977,3,7977,[191 200 435 210 174],405,3,34203,4.287164702933066,0.0,0.0
37978,3,7978,[ 98 294  96 483 237],907,5,34208,4.287254041859883,20.0,20.0
37979,3,7979,[ 64 318 313 301  11],43,5,34213,4.28734335839599,60.0,20.0
37980,3,7980,[238 182  11 210  97],198,4,34217,4.287307354968049,0.0,0.0
37981,3,7981,[282  95 144 483 125],618,2,34219,4.287020796792784,20.0,0.0
37982,3,7982,[ 64 318 313 301  11],345,5,34224,4.287110108981586,60.0,20.0
37983,3,7983,[ 64 318 313 301  11],345,5,34229,4.287199398797595,60.0,20.0
37984,3,7984,[ 64 318 313 301  11],43,5,34234,4.287288666249217,60.0,20.0
37985,3,7985,[173 194 168 234 204],416,5,34239,4.287377911344853,0.0,0.0
37986,3,7986,[257  79 286 118  98],270,4,34243,4.287341930637286,0.0,20.0
37987,3,7987,[300 276 179 357 258],198,3,34246,4.287180771156735,0.0,0.0
37988,3,7988,[ 64 318 313 301  11],43,5,34251,4.287269996244837,60.0,20.0
37989,3,7989,[173 228   9 678 176],805,3,34254,4.287108886107634,0.0,0.0
37990,3,7990,[  7 235 181 195 475],297,3,34257,4.28694781629333,0.0,20.0
37991,3,7991,[ 64 318 313 301  11],345,5,34262,4.287037037037037,60.0,20.0
37992,3,7992,[ 64 318 313 301  11],416,5,34267,4.287126235456024,60.0,20.0
37993,3,7993,[135 195 176 385   7],618,4,34271,4.287090317738303,0.0,0.0
37994,3,7994,[ 64 318 313 301  11],416,5,34276,4.287179487179487,60.0,20.0
37995,3,7995,[182 144 423  71 173],62,3,34279,4.287018509254628,0.0,0.0
37996,3,7996,[200 132   4   7 185],416,5,34284,4.287107665374515,0.0,0.0
37997,3,7997,[180  82 172  28 588],405,3,34287,4.286946736684171,0.0,0.0
37998,3,7998,[ 64 318 313 301  11],416,5,34292,4.287035879484936,60.0,20.0
37999,3,7999,[100  22 117  25 435],297,4,34296,4.287,0.0,0.0
38000,3,8000,[ 64 318 313 301  11],43,5,34301,4.287089113860767,60.0,20.0
38001,3,8001,[ 64 318 313 301  11],345,5,34306,4.287178205448638,60.0,20.0
38002,3,8002,[118 135 211 151 196],417,4,34310,4.287142321629389,0.0,0.0
38003,3,8003,[ 64 318 313 301  11],345,5,34315,4.287231384307846,60.0,20.0
38004,3,8004,[603 174 143  25  95],297,4,34319,4.287195502810743,0.0,0.0
38005,3,8005,[ 64 318 313 301  11],416,5,34324,4.287284536597552,60.0,20.0
38006,3,8006,[ 64 318 313 301  11],416,5,34329,4.287373548145373,60.0,20.0
38007,3,8007,[ 64 318 313 301  11],345,5,34334,4.287462537462537,60.0,20.0
38008,3,8008,[ 64 318 313 301  11],43,5,34339,4.287551504557373,60.0,20.0
38009,3,8009,[143  28 135 144 568],698,0,34339,4.287016229712859,0.0,0.0
38010,3,8010,[742 357 151 302 234],417,3,34342,4.286855573586319,0.0,0.0
38011,3,8011,[300 202 742 183  50],253,5,34347,4.286944583125312,0.0,20.0
38012,3,8012,[125 196 135 268 678],721,2,34349,4.286659178834394,0.0,0.0
38013,3,8013,[ 82  11 118  95  12],416,3,34352,4.286498627402047,20.0,0.0
38014,3,8014,[210 271  22  89  98],805,2,34354,4.286213349968809,0.0,20.0
38015,3,8015,[275   4  64 176 405],854,3,34357,4.2860528942115765,20.0,0.0
38016,3,8016,[ 64 318 313 301  11],345,5,34362,4.286141948359735,60.0,20.0
38017,3,8017,[100 294  28  98  82],230,5,34367,4.286230980294338,0.0,20.0
38018,3,8018,[ 64 318 313 301  11],43,5,34372,4.286319990023694,60.0,20.0
38019,3,8019,[143 174 200 121 301],437,3,34375,4.2861596009975065,0.0,0.0
38020,3,8020,[  9 191 197 300 245],416,4,34379,4.286123924697669,0.0,0.0
38021,3,8021,[ 64 318 313 301  11],43,5,34384,4.286212914485166,60.0,20.0
38022,3,8022,[196  22  50 132  98],416,5,34389,4.286301882088994,0.0,40.0
38023,3,8023,[ 64 318 313 301  11],416,5,34394,4.286390827517447,60.0,20.0
38024,3,8024,[ 12 222 179 181 323],417,2,34396,4.286105919003115,20.0,20.0
38025,3,8025,[ 64 318 313 301  11],416,5,34401,4.286194866683279,60.0,20.0
38026,3,8026,[ 64 318 313 301  11],43,5,34406,4.286283792201321,60.0,20.0
38027,3,8027,[273 294 118 286 174],62,2,34408,4.285999003487793,0.0,0.0
38028,3,8028,[183 182 197 742 273],297,2,34410,4.285714285714286,0.0,0.0
38029,3,8029,[300   1 748 172  56],345,2,34412,4.285429638854296,0.0,0.0
38030,3,8030,[282 151 216 173  95],618,0,34412,4.284896027891919,0.0,0.0
38031,3,8031,[597  28 200 118 275],618,3,34415,4.284736055776892,0.0,0.0
38032,3,8032,[ 64 318 313 301  11],345,5,34420,4.284825096477032,60.0,20.0
38033,3,8033,[ 64 318 313 301  11],416,5,34425,4.284914115011202,60.0,20.0
38034,3,8034,[269  98 135 127 100],854,5,34430,4.285003111387679,0.0,20.0
38035,3,8035,[111 257 276 546 117],223,5,34435,4.285092085614734,0.0,0.0
38036,3,8036,[ 64 318 313 301  11],345,5,34440,4.285181037700634,60.0,20.0
38037,3,8037,[ 64 318 313 301  11],416,5,34445,4.285269967653645,60.0,20.0
38038,3,8038,[235 742 195 180 173],417,3,34448,4.285110088319443,0.0,0.0
38039,3,8039,[678  12 180  56 597],805,3,34451,4.2849502487562185,20.0,0.0
38040,3,8040,[ 64 318 313 301  11],416,5,34456,4.285039174232061,60.0,20.0
38041,3,8041,[185 423 144  28 204],805,1,34457,4.284630688883363,0.0,0.0
38042,3,8042,[ 56 176 127 185  71],405,3,34460,4.284470968544076,0.0,0.0
38043,3,8043,[568 403 100 202 127],416,5,34465,4.2845599204375935,0.0,0.0
38044,3,8044,[588  98 405 496 179],417,2,34467,4.2842759477936605,0.0,20.0
38045,3,8045,[ 64 318 313 301  11],345,5,34472,4.284364901814566,60.0,20.0
38046,3,8046,[ 64 318 313 301  11],416,5,34477,4.284453833726855,60.0,20.0
38047,3,8047,[ 64 318 313 301  11],345,5,34482,4.2845427435387675,60.0,20.0
38048,3,8048,[ 64 318 313 301  11],43,5,34487,4.2846316312585415,60.0,20.0
38049,3,8049,[ 64 318 313 301  11],43,5,34492,4.28472049689441,60.0,20.0
38050,3,8050,[ 64 318 313 301  11],43,5,34497,4.2848093404546015,60.0,20.0
38051,3,8051,[182 405 655 132 313],416,5,34502,4.284898161947342,20.0,20.0
38052,3,8052,[423  96 135 357 210],642,2,34504,4.284614429405191,0.0,0.0
38053,3,8053,[  8 588 655  12 603],416,5,34509,4.284703253041966,20.0,0.0
38054,3,8054,[237 161 301  70  12],345,4,34513,4.2846679081315955,20.0,0.0
38055,3,8055,[ 64 318 313 301  11],43,5,34518,4.284756703078451,60.0,20.0
38056,3,8056,[385 215 678 132  98],345,3,34521,4.284597244631997,0.0,20.0
38057,3,8057,[ 64 318 313 301  11],416,5,34526,4.284686026309258,60.0,20.0
38058,3,8058,[ 64 318 313 301  11],416,5,34531,4.2847747859535925,60.0,20.0
38059,3,8059,[ 70 289 175 286 210],43,4,34535,4.284739454094293,0.0,0.0
38060,3,8060,[ 64 173 100  97 161],198,2,34537,4.284456022825952,20.0,0.0
38061,3,8061,[ 64 318 313 301  11],416,5,34542,4.284544777970727,60.0,20.0
38062,3,8062,[ 64 318 313 301  11],416,5,34547,4.284633511100087,60.0,20.0
38063,3,8063,[195 234  82 173 143],618,3,34550,4.2844742063492065,0.0,0.0
38064,3,8064,[238 181 132 655 496],618,4,34554,4.2844389336639805,0.0,20.0
38065,3,8065,[ 64 318 313 301  11],345,5,34559,4.284527646912968,60.0,20.0
38066,3,8066,[ 64 318 313 301  11],345,5,34564,4.284616338167845,60.0,20.0
38067,3,8067,[ 64 318 313 301  11],43,5,34569,4.284705007436787,60.0,20.0
38068,3,8068,[181 151  11 265 748],417,3,34572,4.284545792539348,0.0,20.0
38069,3,8069,[ 64 318 313 301  11],43,5,34577,4.284634448574969,60.0,20.0
38070,3,8070,[ 64 318 313 301  11],416,5,34582,4.284723082641556,60.0,20.0
38071,3,8071,[180 191 655 237  95],198,2,34584,4.284440039643211,0.0,0.0
38072,3,8072,[ 64 318 313 301  11],43,5,34589,4.284528675833024,60.0,20.0
38073,3,8073,[ 64 318 313 301  11],345,5,34594,4.2846172900668815,60.0,20.0
38074,3,8074,[300 258 385  97 202],505,3,34597,4.284458204334365,0.0,0.0
38075,3,8075,[276   8 183 168 182],416,4,34601,4.284422981674096,0.0,0.0
38076,3,8076,[143  79 234 210 111],416,5,34606,4.284511576080228,0.0,0.0
38077,3,8077,[ 64 318 313 301  11],416,5,34611,4.284600148551622,60.0,20.0
38078,3,8078,[655 385 269 174 678],416,4,34615,4.284564921401164,0.0,0.0
38079,3,8079,[ 64 318 313 301  11],43,5,34620,4.284653465346534,60.0,20.0
38080,3,8080,[ 64 318 313 301  11],345,5,34625,4.284741987377799,60.0,20.0
38081,3,8081,[ 64 318 313 301  11],43,5,34630,4.284830487503093,60.0,20.0
38082,3,8082,[ 64 318 313 301  11],345,5,34635,4.2849189657305455,60.0,20.0
38083,3,8083,[275 202 301 276 483],437,4,34639,4.284883720930233,20.0,0.0
38084,3,8084,[588 245 508 496 222],417,1,34640,4.28447742733457,0.0,0.0
38085,3,8085,[678   1 423 245 143],416,3,34643,4.28431857531536,0.0,0.0
38086,3,8086,[237 238 289   7 196],342,3,34646,4.284159762581922,0.0,0.0
38087,3,8087,[ 64 318 313 301  11],43,5,34651,4.284248269040554,60.0,20.0
38088,3,8088,[ 64 318 313 301  11],345,5,34656,4.284336753616022,60.0,20.0
38089,3,8089,[127 204  69 471  56],416,5,34661,4.28442521631644,0.0,0.0
38090,3,8090,[161 273 204 172  70],618,3,34664,4.28426646891608,0.0,0.0
38091,3,8091,[111 237  64 568 125],314,5,34669,4.2843549184379635,20.0,0.0
38092,3,8092,[ 64 318 313 301  11],345,5,34674,4.284443346101569,60.0,20.0
38093,3,8093,[742 197 475 210 179],416,3,34677,4.2842846553002225,0.0,0.0
38094,3,8094,[ 64 318 313 301  11],345,5,34682,4.28437306979617,60.0,20.0
38095,3,8095,[ 64 318 313 301  11],43,5,34687,4.284461462450593,60.0,20.0
38096,3,8096,[ 64 318 313 301  11],43,5,34692,4.284549833271582,60.0,20.0
38097,3,8097,[ 64 318 313 301  11],43,5,34697,4.284638182267226,60.0,20.0
38098,3,8098,[ 64 318 313 301  11],43,5,34702,4.28472650944561,60.0,20.0
38099,3,8099,[ 64 318 313 301  11],345,5,34707,4.284814814814815,60.0,20.0
38100,3,8100,[ 64 318 313 301  11],43,5,34712,4.284903098382916,60.0,20.0
38101,3,8101,[ 64 318 313 301  11],345,5,34717,4.284991360157986,60.0,20.0
38102,3,8102,[ 64 318 313 301  11],43,5,34722,4.2850796001480935,60.0,20.0
38103,3,8103,[ 64 318 313 301  11],43,5,34727,4.285167818361303,60.0,20.0
38104,3,8104,[ 64 318 313 301  11],43,5,34732,4.285256014805675,60.0,20.0
38105,3,8105,[195 282  70 237 302],416,4,34736,4.285220824080928,0.0,0.0
38106,3,8106,[265 313 215  82 117],618,5,34741,4.285308992228938,20.0,20.0
38107,3,8107,[ 64 318 313 301  11],416,5,34746,4.2853971386285155,60.0,20.0
38108,3,8108,[ 64 318 313 301  11],345,5,34751,4.285485263287705,60.0,20.0
38109,3,8109,[ 64 318 313 301  11],345,5,34756,4.28557336621455,60.0,20.0
38110,3,8110,[ 64 318 313 301  11],345,5,34761,4.2856614474170875,60.0,20.0
38111,3,8111,[ 64 318 313 301  11],416,5,34766,4.285749506903353,60.0,20.0
38112,3,8112,[ 64 318 313 301  11],345,5,34771,4.2858375446813755,60.0,20.0
38113,3,8113,[ 64 318 313 301  11],43,5,34776,4.285925560759182,60.0,20.0
38114,3,8114,[ 64 318 313 301  11],43,5,34781,4.286013555144794,60.0,20.0
38115,3,8115,[ 64 318 313 301  11],416,5,34786,4.286101527846229,60.0,20.0
38116,3,8116,[ 64 318 313 301  11],416,5,34791,4.2861894788715045,60.0,20.0
38117,3,8117,[ 64 318 313 301  11],43,5,34796,4.286277408228628,60.0,20.0
38118,3,8118,[ 64 318 313 301  11],43,5,34801,4.2863653159256065,60.0,20.0
38119,3,8119,[234  70 202 127 215],405,4,34805,4.286330049261084,0.0,0.0
38120,3,8120,[ 64 318 313 301  11],345,5,34810,4.286417928826499,60.0,20.0
38121,3,8121,[ 8 98  4 96 56],875,3,34813,4.286259541984733,0.0,20.0
38122,3,8122,[475  82 655   4 195],62,4,34817,4.28622430136649,0.0,0.0
38123,3,8123,[ 64 318 313 301  11],43,5,34822,4.2863121614968,60.0,20.0
38124,3,8124,[144  64 179 153 176],417,4,34826,4.286276923076923,20.0,0.0
38125,3,8125,[ 79 118 132 403 117],417,4,34830,4.286241693330052,0.0,0.0
38126,3,8126,[ 64 318 313 301  11],43,5,34835,4.2863295188876585,60.0,20.0
38127,3,8127,[ 64 318 313 301  11],43,5,34840,4.286417322834645,60.0,20.0
38128,3,8128,[655 238 121 546  22],416,4,34844,4.286382088817812,0.0,0.0
38129,3,8129,[197 202   8 125 191],618,1,34845,4.285977859778598,0.0,0.0
38130,3,8130,[ 64 318 313 301  11],43,5,34850,4.286065674578772,60.0,20.0
38131,3,8131,[151 546  96 300 100],416,3,34853,4.285907525823905,0.0,0.0
38132,3,8132,[  1 385 210  12 269],805,3,34856,4.28574941595967,20.0,0.0
38133,3,8133,[ 64 318 313 301  11],416,5,34861,4.285837226456848,60.0,20.0
38134,3,8134,[ 64 318 313 301  11],345,5,34866,4.285925015365704,60.0,20.0
38135,3,8135,[ 64 318 313 301  11],416,5,34871,4.286012782694199,60.0,20.0
38136,3,8136,[ 64 318 313 301  11],43,5,34876,4.286100528450289,60.0,20.0
38137,3,8137,[135  82 568 597 191],417,2,34878,4.285819611698206,0.0,0.0
38138,3,8138,[ 64 318 313 301  11],345,5,34883,4.285907359626489,60.0,20.0
38139,3,8139,[423 176 168 483  11],437,2,34885,4.285626535626536,20.0,0.0
38140,3,8140,[204 269 258 273  88],805,1,34886,4.2852229455840805,0.0,0.0
38141,3,8141,[ 64 318 313 301  11],416,5,34891,4.285310734463277,60.0,20.0
38142,3,8142,[ 64 318 313 301  11],416,5,34896,4.28539850178067,60.0,20.0
38143,3,8143,[ 64 318 313 301  11],345,5,34901,4.285486247544204,60.0,20.0
38144,3,8144,[ 69 197 179 328 143],373,2,34903,4.2852056476365865,0.0,0.0
38145,3,8145,[ 64 318 313 301  11],43,5,34908,4.285293395531549,60.0,20.0
38146,3,8146,[ 79  50 197  71 194],416,5,34913,4.285381121885356,0.0,20.0
38147,3,8147,[515 302   4 496 357],416,5,34918,4.28546882670594,0.0,0.0
38148,3,8148,[ 64 117 121  50 173],62,5,34923,4.285556510001227,20.0,20.0
38149,3,8149,[ 64 318 313 301  11],416,5,34928,4.285644171779141,60.0,20.0
38150,3,8150,[ 50 238 300 197 678],416,4,34932,4.285609127714391,0.0,20.0
38151,3,8151,[197 282  11 176  25],854,2,34934,4.285328753680078,0.0,0.0
38152,3,8152,[357 568 603  15 269],416,5,34939,4.285416411137005,0.0,0.0
38153,3,8153,[ 64 318 313 301  11],43,5,34944,4.285504047093451,60.0,20.0
38154,3,8154,[202 121  15 294 483],128,4,34948,4.285469037400368,20.0,0.0
38155,3,8155,[ 64 318 313 301  11],416,5,34953,4.2855566454144185,60.0,20.0
38156,3,8156,[ 64 318 313 301  11],416,5,34958,4.28564423194802,60.0,20.0
38157,3,8157,[ 64 318 313 301  11],43,5,34963,4.2857317970090705,60.0,20.0
38158,3,8158,[ 64 318 313 301  11],43,5,34968,4.2858193406054665,60.0,20.0
38159,3,8159,[210  95 294 234 322],805,1,34969,4.285416666666666,0.0,0.0
38160,3,8160,[ 12 275 172 288 174],618,3,34972,4.285259159416738,20.0,20.0
38161,3,8161,[ 64 318 313 301  11],43,5,34977,4.285346728742955,60.0,20.0
38162,3,8162,[ 64 318 313 301  11],43,5,34982,4.28543427661399,60.0,20.0
38163,3,8163,[265 282 202 144  98],618,3,34985,4.2852768250857425,0.0,20.0
38164,3,8164,[ 64 318 313 301  11],43,5,34990,4.285364360073484,60.0,20.0
38165,3,8165,[185 471 215   7 276],416,4,34994,4.285329414646093,0.0,0.0
38166,3,8166,[ 64 318 313 301  11],345,5,34999,4.285416921758295,60.0,20.0
38167,3,8167,[742 286 258 294 132],345,3,35002,4.285259549461313,0.0,0.0
38168,3,8168,[234 328 603 289 216],416,4,35006,4.2852246296976375,0.0,0.0
38169,3,8169,[475 200 318 286 496],437,3,35009,4.285067319461445,20.0,0.0
38170,3,8170,[508 288  88 153  15],342,2,35011,4.284787663688655,0.0,20.0
38171,3,8171,[168 269 258 257 546],43,5,35016,4.284875183553598,0.0,0.0
38172,3,8172,[588  15 172  28 216],128,4,35020,4.284840327908968,0.0,0.0
38173,3,8173,[172 179 151 483  50],601,4,35024,4.284805480792757,20.0,20.0
38174,3,8174,[ 64 318 313 301  11],416,5,35029,4.284892966360856,60.0,20.0
38175,3,8175,[ 64 318 313 301  11],43,5,35034,4.284980430528376,60.0,20.0
38176,3,8176,[186 275 100 302 286],854,2,35036,4.284700990583343,0.0,0.0
38177,3,8177,[ 64 318 313 301  11],416,5,35041,4.284788456835412,60.0,20.0
38178,3,8178,[ 64 318 313 301  11],416,5,35046,4.284875901699475,60.0,20.0
38179,3,8179,[ 25 200 322 286 111],416,4,35050,4.284841075794621,0.0,0.0
38180,3,8180,[ 64 318 313 301  11],345,5,35055,4.284928492849285,60.0,20.0
38181,3,8181,[ 64 318 313 301  11],345,5,35060,4.285015888535811,60.0,20.0
38182,3,8182,[ 64 318 313 301  11],345,5,35065,4.285103262862031,60.0,20.0
38183,3,8183,[ 82 204 179  12   9],805,2,35067,4.284824046920821,20.0,0.0
38184,3,8184,[ 64 318 313 301  11],416,5,35072,4.28491142333537,60.0,20.0
38185,3,8185,[ 64 318 313 301  11],416,5,35077,4.28499877840215,60.0,20.0
38186,3,8186,[ 64 318 313 301  11],345,5,35082,4.285086112128985,60.0,20.0
38187,3,8187,[ 64 318 313 301  11],416,5,35087,4.285173424523693,60.0,20.0
38188,3,8188,[ 64 318 313 301  11],345,5,35092,4.28526071559409,60.0,20.0
38189,3,8189,[ 64 318 313 301  11],416,5,35097,4.285347985347985,60.0,20.0
38190,3,8190,[ 64 318 313 301  11],416,5,35102,4.285435233793188,60.0,20.0
38191,3,8191,[ 88 135  69 288 204],405,4,35106,4.285400390625,0.0,20.0
38192,3,8192,[ 64 318 313 301  11],43,5,35111,4.285487611375564,60.0,20.0
38193,3,8193,[ 64 318 313 301  11],43,5,35116,4.285574810837198,60.0,20.0
38194,3,8194,[181 275 405 143  97],128,4,35120,4.285539963392313,0.0,20.0
38195,3,8195,[ 64 318 313 301  11],416,5,35125,4.285627135187896,60.0,20.0
38196,3,8196,[ 56 258 185  50   7],198,4,35129,4.285592289862144,0.0,20.0
38197,3,8197,[ 64 318 313 301  11],43,5,35134,4.285679434008295,60.0,20.0
38198,3,8198,[ 64 318 313 301  11],43,5,35139,4.285766556897182,60.0,20.0
38199,3,8199,[ 64 318 313 301  11],43,5,35144,4.285853658536586,60.0,20.0
38200,3,8200,[ 64 318 313 301  11],416,5,35149,4.2859407389342765,60.0,20.0
38201,3,8201,[183 655 151 172 568],417,3,35152,4.285783955132894,0.0,0.0
38202,3,8202,[ 64 318 313 301  11],345,5,35157,4.285871022796538,60.0,20.0
38203,3,8203,[ 64 318 313 301  11],43,5,35162,4.285958069234519,60.0,20.0
38204,3,8204,[ 64 318 313 301  11],43,5,35167,4.286045094454601,60.0,20.0
38205,3,8205,[151 238 588 403 186],417,4,35171,4.286010236412381,0.0,0.0
38206,3,8206,[ 64 318 313 301  11],416,5,35176,4.286097234068478,60.0,20.0
38207,3,8207,[195 271  70 275 357],297,3,35179,4.285940545808967,0.0,0.0
38208,3,8208,[168 181 286 318 151],437,3,35182,4.285783895724205,20.0,20.0
38209,3,8209,[  4  98 161 288 202],405,4,35186,4.285749086479902,0.0,40.0
38210,3,8210,[603 118 742  70  25],416,4,35190,4.285714285714286,0.0,0.0
38211,3,8211,[161 597 151 125  25],588,4,35194,4.285679493424257,0.0,0.0
38212,3,8212,[ 64 318 313 301  11],345,5,35199,4.285766467794959,60.0,20.0
38213,3,8213,[ 64 318 313 301  11],416,5,35204,4.285853420988556,60.0,20.0
38214,3,8214,[ 64 318 313 301  11],345,5,35209,4.285940353012782,60.0,20.0
38215,3,8215,[204 238  70 276  71],230,4,35213,4.285905550146056,0.0,0.0
38216,3,8216,[ 64 318 313 301  11],43,5,35218,4.285992454667153,60.0,20.0
38217,3,8217,[ 64 318 313 301  11],43,5,35223,4.286079338038452,60.0,20.0
38218,3,8218,[161 257 588 125  11],417,2,35225,4.285801192359168,0.0,0.0
38219,3,8219,[ 64 318 313 301  11],345,5,35230,4.285888077858881,60.0,20.0
38220,3,8220,[ 64 318 313 301  11],416,5,35235,4.285974942221141,60.0,20.0
38221,3,8221,[100 222   7 216 237],198,2,35237,4.285696910727317,0.0,0.0
38222,3,8222,[ 64 318 313 301  11],43,5,35242,4.285783777210264,60.0,20.0
38223,3,8223,[ 71 258 132 318  69],588,4,35246,4.285749027237354,20.0,0.0
38224,3,8224,[655 181 294  22 183],922,3,35249,4.285592705167173,0.0,20.0
38225,3,8225,[483  69 144  28 423],437,2,35251,4.285314855336737,20.0,0.0
38226,3,8226,[435 185 179 603 181],405,2,35253,4.285037073052146,0.0,20.0
38227,3,8227,[ 64 318 313 301  11],416,5,35258,4.285123966942149,60.0,20.0
38228,3,8228,[ 64 318 313 301  11],43,5,35263,4.285210839713209,60.0,20.0
38229,3,8229,[ 69  25 202  95  79],588,3,35266,4.28505467800729,0.0,0.0
38230,3,8230,[ 64 318 313 301  11],345,5,35271,4.285141538087717,60.0,20.0
38231,3,8231,[121  82 161   7 143],588,4,35275,4.285106899902818,0.0,0.0
38232,3,8232,[ 64 318 313 301  11],416,5,35280,4.285193732539779,60.0,20.0
38233,3,8233,[ 64 318 313 301  11],416,5,35285,4.2852805440854995,60.0,20.0
38234,3,8234,[496  96 238 121 228],417,1,35286,4.28488160291439,0.0,0.0
38235,3,8235,[ 64 318 313 301  11],416,5,35291,4.284968431277319,60.0,20.0
38236,3,8236,[275 678 588 268 183],416,4,35295,4.284933835134151,0.0,0.0
38237,3,8237,[ 64 318 313 301  11],416,5,35300,4.285020636076718,60.0,20.0
38238,3,8238,[ 64 318 313 301  11],416,5,35305,4.285107415948538,60.0,20.0
38239,3,8239,[ 64 318 313 301  11],43,5,35310,4.285194174757281,60.0,20.0
38240,3,8240,[176   9 127  95 174],698,2,35312,4.284916879019536,0.0,0.0
38241,3,8241,[ 64 318 313 301  11],345,5,35317,4.28500363989323,60.0,20.0
38242,3,8242,[ 22 143 269 403 423],416,5,35322,4.285090379716123,0.0,0.0
38243,3,8243,[286 121 276 275 179],416,3,35325,4.284934497816594,0.0,0.0
38244,3,8244,[ 64 318 313 301  11],416,5,35330,4.285021224984839,60.0,20.0
38245,3,8245,[ 64 318 313 301  11],345,5,35335,4.285107931118118,60.0,20.0
38246,3,8246,[268 173 288 273 182],417,3,35338,4.2849521037953195,0.0,20.0
38247,3,8247,[ 64 318 313 301  11],345,5,35343,4.28503879728419,60.0,20.0
38248,3,8248,[ 64 318 313 301  11],345,5,35348,4.285125469753909,60.0,20.0
38249,3,8249,[191 127 176  71 121],416,5,35353,4.285212121212121,0.0,0.0
38250,3,8250,[ 64 318 313 301  11],43,5,35358,4.285298751666464,60.0,20.0
38251,3,8251,[ 64 318 313 301  11],416,5,35363,4.285385361124576,60.0,20.0
38252,3,8252,[215 173 423  15 172],62,2,35365,4.285108445413789,0.0,0.0
38253,3,8253,[427 268 313 182 333],416,5,35370,4.285195056942088,20.0,20.0
38254,3,8254,[ 95 161 546 405 403],805,1,35371,4.284797092671108,0.0,0.0
38255,3,8255,[161  89 176 151 265],437,1,35372,4.284399224806202,0.0,0.0
38256,3,8256,[ 64 318 313 301  11],345,5,35377,4.284485890759355,60.0,20.0
38257,3,8257,[ 64 318 313 301  11],345,5,35382,4.284572535722935,60.0,20.0
38258,3,8258,[ 64 318 313 301  11],345,5,35387,4.284659159704565,60.0,20.0
38259,3,8259,[ 64 318 313 301  11],416,5,35392,4.284745762711864,60.0,20.0
38260,3,8260,[182 181 228 121 172],505,1,35393,4.284348141871444,0.0,20.0
38261,3,8261,[ 25 111  79  98 235],297,2,35395,4.284071653352699,0.0,20.0
38262,3,8262,[ 64 318 313 301  11],345,5,35400,4.284158296018395,60.0,20.0
38263,3,8263,[215  11  25 173 258],297,4,35404,4.284123910939012,0.0,0.0
38264,3,8264,[ 64 318 313 301  11],345,5,35409,4.28421052631579,60.0,20.0
38265,3,8265,[313 144   1 132 403],416,5,35414,4.284297120735543,20.0,20.0
38266,3,8266,[ 64 318 313 301  11],416,5,35419,4.284383694205879,60.0,20.0
38267,3,8267,[ 64 318 313 301  11],416,5,35424,4.284470246734398,60.0,20.0
38268,3,8268,[181  95 273 200 588],297,3,35427,4.284314911113799,0.0,20.0
38269,3,8269,[ 64 318 313 301  11],416,5,35432,4.2844014510278114,60.0,20.0
38270,3,8270,[ 64 318 313 301  11],416,5,35437,4.284487970015718,60.0,20.0
38271,3,8271,[132 100 179 216  12],342,5,35442,4.284574468085107,20.0,0.0
38272,3,8272,[ 64 318 313 301  11],345,5,35447,4.284660945243563,60.0,20.0
38273,3,8273,[ 64 318 313 301  11],416,5,35452,4.28474740149867,60.0,20.0
38274,3,8274,[655 301 258 742 172],416,5,35457,4.284833836858006,0.0,0.0
38275,3,8275,[271 182 216 153 202],297,2,35459,4.2845577573707105,0.0,0.0
38276,3,8276,[ 64 318 313 301  11],416,5,35464,4.284644194756554,60.0,20.0
38277,3,8277,[ 64 318 313 301  11],416,5,35469,4.284730611258758,60.0,20.0
38278,3,8278,[ 64 318 313 301  11],43,5,35474,4.284817006884889,60.0,20.0
38279,3,8279,[179 180  70  64 546],62,4,35478,4.284782608695652,20.0,0.0
38280,3,8280,[ 64 318 313 301  11],43,5,35483,4.28486897717667,60.0,20.0
38281,3,8281,[ 64 318 313 301  11],345,5,35488,4.284955324800773,60.0,20.0
38282,3,8282,[ 64 318 313 301  11],43,5,35493,4.285041651575516,60.0,20.0
38283,3,8283,[174 318 195  97 275],705,3,35496,4.284886528247224,20.0,0.0
38284,3,8284,[ 64 318 313 301  11],43,5,35501,4.284972842486421,60.0,20.0
38285,3,8285,[ 12  25 144 151 180],854,3,35504,4.284817764904658,20.0,0.0
38286,3,8286,[ 64 318 313 301  11],43,5,35509,4.284904066610354,60.0,20.0
38287,3,8287,[276 125 318 286 185],223,2,35511,4.284628378378378,20.0,0.0
38288,3,8288,[ 64 318 313 301  11],416,5,35516,4.284714682108819,60.0,20.0
38289,3,8289,[ 64 318 313 301  11],416,5,35521,4.2848009650180945,60.0,20.0
38290,3,8290,[ 25 405 235 168  11],43,4,35525,4.284766614401158,0.0,0.0
38291,3,8291,[471 286   8 268 275],854,2,35527,4.284491075735649,0.0,0.0
38292,3,8292,[ 22   8  98 597 313],618,4,35531,4.28445677077053,20.0,40.0
38293,3,8293,[ 64 318 313 301  11],416,5,35536,4.284543043163733,60.0,20.0
38294,3,8294,[ 64 318 313 301  11],416,5,35541,4.284629294755877,60.0,20.0
38295,3,8295,[ 64 318 313 301  11],345,5,35546,4.284715525554484,60.0,20.0
38296,3,8296,[ 64 318 313 301  11],345,5,35551,4.284801735567072,60.0,20.0
38297,3,8297,[161 118 195 234 197],805,2,35553,4.284526391901663,0.0,0.0
38298,3,8298,[216  71 234 385 181],805,1,35554,4.284130618146765,0.0,20.0
38299,3,8299,[ 64 318 313 301  11],43,5,35559,4.28421686746988,60.0,20.0
38300,3,8300,[ 64 318 313 301  11],416,5,35564,4.284303096012529,60.0,20.0
38301,3,8301,[  1  98 268  12 172],345,4,35568,4.2842688508793065,20.0,20.0
38302,3,8302,[ 64 318 313 301  11],416,5,35573,4.284355052390702,60.0,20.0
38303,3,8303,[ 64 318 313 301  11],416,5,35578,4.284441233140655,60.0,20.0
38304,3,8304,[300 127  11 172 153],43,5,35583,4.284527393136664,0.0,0.0
38305,3,8305,[ 64 318 313 301  11],43,5,35588,4.284613532386227,60.0,20.0
38306,3,8306,[118 168 238   4 678],805,3,35591,4.284458890092693,0.0,0.0
38307,3,8307,[275  28 234 268 475],588,3,35594,4.28430428502648,0.0,0.0
38308,3,8308,[ 56 269 182   9  28],416,5,35599,4.284390420026478,0.0,0.0
38309,3,8309,[ 64 318 313 301  11],345,5,35604,4.2844765342960285,60.0,20.0
38310,3,8310,[ 64 318 313 301  11],43,5,35609,4.284562627842618,60.0,20.0
38311,3,8311,[ 64 318 313 301  11],43,5,35614,4.284648700673725,60.0,20.0
38312,3,8312,[111 186  70 258 191],43,4,35618,4.284614459280645,0.0,0.0
38313,3,8313,[204 180 286 588 127],373,1,35619,4.284219388982439,0.0,0.0
38314,3,8314,[ 70 117  15 186  98],417,5,35624,4.2843054720384846,0.0,20.0
38315,3,8315,[ 64 318 313 301  11],416,5,35629,4.284391534391534,60.0,20.0
38316,3,8316,[ 96 318  79 127 568],198,3,35632,4.284237104725261,20.0,0.0
38317,3,8317,[ 64 318 313 301  11],43,5,35637,4.284323154604472,60.0,20.0
38318,3,8318,[ 64 318 313 301  11],416,5,35642,4.28440918379613,60.0,20.0
38319,3,8319,[174 181 588 405  98],345,4,35646,4.284375,0.0,40.0
38320,3,8320,[ 64 318 313 301  11],43,5,35651,4.284461002283379,60.0,20.0
38321,3,8321,[ 64 318 313 301  11],416,5,35656,4.284546983898101,60.0,20.0
38322,3,8322,[ 64 318 313 301  11],345,5,35661,4.284632944851616,60.0,20.0
38323,3,8323,[275 151 322 302  56],854,3,35664,4.284478616049976,0.0,0.0
38324,3,8324,[211 475 435  12 191],297,3,35667,4.2843243243243245,20.0,0.0
38325,3,8325,[ 64 318 313 301  11],43,5,35672,4.284410281047322,60.0,20.0
38326,3,8326,[222 228 204  98  79],805,3,35675,4.284256034586286,0.0,20.0
38327,3,8327,[ 64 318 313 301  11],345,5,35680,4.2843419788664745,60.0,20.0
38328,3,8328,[ 64 318 313 301  11],416,5,35685,4.284427902509305,60.0,20.0
38329,3,8329,[ 71 180   7  96 135],62,5,35690,4.2845138055222085,0.0,0.0
38330,3,8330,[ 64 318 313 301  11],43,5,35695,4.284599687912616,60.0,20.0
38331,3,8331,[ 15 300   4 273 313],416,5,35700,4.28468554968795,20.0,20.0
38332,3,8332,[ 64 318 313 301  11],416,5,35705,4.284771390855634,60.0,20.0
38333,3,8333,[471 269 237 588 197],297,3,35708,4.28461723062155,0.0,0.0
38334,3,8334,[ 64 318 313 301  11],43,5,35713,4.284703059388122,60.0,20.0
38335,3,8335,[ 64 318 313 301  11],416,5,35718,4.28478886756238,60.0,20.0
38336,3,8336,[ 64 318 313 301  11],416,5,35723,4.284874655151733,60.0,20.0
38337,3,8337,[ 64 318 313 301  11],345,5,35728,4.284960422163588,60.0,20.0
38338,3,8338,[151 175 191  12 328],854,4,35732,4.284926250149898,20.0,0.0
38339,3,8339,[ 64 318 313 301  11],43,5,35737,4.285011990407674,60.0,20.0
38340,3,8340,[153   8 403 286 328],62,3,35740,4.284857930703753,0.0,0.0
38341,3,8341,[ 64 318 313 301  11],345,5,35745,4.284943658595061,60.0,20.0
38342,3,8342,[ 95 471 257 300  71],416,3,35748,4.284789644012945,0.0,0.0
38343,3,8343,[ 64 318 313 301  11],416,5,35753,4.2848753595397895,60.0,20.0
38344,3,8344,[ 96 568 118 216 603],416,4,35757,4.2848412222887955,0.0,0.0
38345,3,8345,[ 64 318 313 301  11],416,5,35762,4.284926911095136,60.0,20.0
38346,3,8346,[ 64 318 313 301  11],43,5,35767,4.285012579369833,60.0,20.0
38347,3,8347,[235  12  98 323 151],416,2,35769,4.284738859607091,20.0,20.0
38348,3,8348,[ 64 318 313 301  11],345,5,35774,4.284824529883818,60.0,20.0
38349,3,8349,[125  95 182 181 588],416,4,35778,4.284790419161677,0.0,20.0
38350,3,8350,[271  88 174  97  71],505,5,35783,4.284876062746976,0.0,0.0
38351,3,8351,[117  50 121 269 742],751,4,35787,4.284841954022989,0.0,20.0
38352,3,8352,[ 64 318 313 301  11],416,5,35792,4.284927570932599,60.0,20.0
38353,3,8353,[ 64 318 313 301  11],345,5,35797,4.285013167344984,60.0,20.0
38354,3,8354,[ 64 318 313 301  11],43,5,35802,4.285098743267504,60.0,20.0
38355,3,8355,[ 64 318 313 301  11],416,5,35807,4.285184298707516,60.0,20.0
38356,3,8356,[ 64 318 313 301  11],345,5,35812,4.285269833672371,60.0,20.0
38357,3,8357,[ 64 318 313 301  11],43,5,35817,4.285355348169419,60.0,20.0
38358,3,8358,[ 64 318 313 301  11],43,5,35822,4.285440842206006,60.0,20.0
38359,3,8359,[ 64 318 313 301  11],345,5,35827,4.285526315789474,60.0,20.0
38360,3,8360,[ 64 318 313 301  11],43,5,35832,4.285611768927162,60.0,20.0
38361,3,8361,[ 64 318 313 301  11],345,5,35837,4.285697201626405,60.0,20.0
38362,3,8362,[ 64 318 313 301  11],345,5,35842,4.285782613894535,60.0,20.0
38363,3,8363,[ 64 318 313 301  11],345,5,35847,4.285868005738881,60.0,20.0
38364,3,8364,[ 64 318 313 301  11],345,5,35852,4.285953377166766,60.0,20.0
38365,3,8365,[ 64 318 313 301  11],345,5,35857,4.286038728185512,60.0,20.0
38366,3,8366,[ 70 181 235 328 151],416,3,35860,4.285885024501016,0.0,20.0
38367,3,8367,[185  89 222 271 265],297,3,35863,4.2857313575525815,0.0,0.0
38368,3,8368,[ 64 318 313 301  11],345,5,35868,4.28581670450472,60.0,20.0
38369,3,8369,[ 64 318 313 301  11],43,5,35873,4.285902031063322,60.0,20.0
38370,3,8370,[234 515 238 117  12],297,4,35877,4.285867877195078,20.0,0.0
38371,3,8371,[423 216  11 333 300],416,5,35882,4.285953177257525,0.0,0.0
38372,3,8372,[546 181 268  50  70],417,2,35884,4.285680162426848,0.0,40.0
38373,3,8373,[100 234   4 483 174],618,4,35888,4.285646047289228,20.0,0.0
38374,3,8374,[ 64 318 313 301  11],43,5,35893,4.285731343283582,60.0,20.0
38375,3,8375,[257  50  79 125  69],854,3,35896,4.285577841451767,0.0,20.0
38376,3,8376,[ 64 318 313 301  11],416,5,35901,4.285663125223827,60.0,20.0
38377,3,8377,[ 64 318 313 301  11],43,5,35906,4.2857483886369065,60.0,20.0
38378,3,8378,[234   1   4 300 216],253,5,35911,4.285833631698293,0.0,0.0
38379,3,8379,[ 64 318 313 301  11],43,5,35916,4.285918854415274,60.0,20.0
38380,3,8380,[ 22 125 286 153 181],416,5,35921,4.286004056795131,0.0,20.0
38381,3,8381,[ 64 318 313 301  11],416,5,35926,4.286089238845144,60.0,20.0
38382,3,8382,[ 79 183 173  11 176],437,2,35928,4.285816533460575,0.0,0.0
38383,3,8383,[ 64 318 313 301  11],416,5,35933,4.285901717557252,60.0,20.0
38384,3,8384,[ 64 318 313 301  11],416,5,35938,4.2859868813357185,60.0,20.0
38385,3,8385,[ 50 111   1 196  71],62,3,35941,4.285833532077271,0.0,20.0
38386,3,8386,[ 64 318 313 301  11],416,5,35946,4.285918683677119,60.0,20.0
38387,3,8387,[135 288 117 181 144],417,1,35947,4.285526943252266,0.0,40.0
38388,3,8388,[ 64 318 313 301  11],345,5,35952,4.285612111097866,60.0,20.0
38389,3,8389,[ 64 318 313 301  11],43,5,35957,4.28569725864124,60.0,20.0
38390,3,8390,[ 95 200 168 588   9],416,4,35961,4.285663210582768,0.0,0.0
38391,3,8391,[302 300 187 328 275],416,5,35966,4.285748331744519,0.0,0.0
38392,3,8392,[ 64 318 313 301  11],43,5,35971,4.2858334326224234,60.0,20.0
38393,3,8393,[276 111 161  56  64],416,4,35975,4.285799380509888,20.0,0.0
38394,3,8394,[ 64 318 313 301  11],416,5,35980,4.2858844550327575,60.0,20.0
38395,3,8395,[ 79 423  70 132 568],711,3,35983,4.285731300619343,0.0,0.0
38396,3,8396,[ 64 318 313 301  11],416,5,35988,4.285816362986781,60.0,20.0
38397,3,8397,[ 64 318 313 301  11],345,5,35993,4.2859014050964515,60.0,20.0
38398,3,8398,[ 64 318 313 301  11],416,5,35998,4.28598642695559,60.0,20.0
38399,3,8399,[ 64 318 313 301  11],43,5,36003,4.286071428571429,60.0,20.0
38400,3,8400,[ 64 318 313 301  11],416,5,36008,4.286156409951197,60.0,20.0
38401,3,8401,[748  95  97  11 515],417,5,36013,4.286241371102118,0.0,0.0
38402,3,8402,[271 168 483 269 153],854,5,36018,4.2863263120314175,20.0,0.0
38403,3,8403,[161 301  79 222  88],711,4,36022,4.286292241789624,0.0,0.0
38404,3,8404,[ 64 318 313 301  11],345,5,36027,4.286377156454491,60.0,20.0
38405,3,8405,[ 71  50 204 174 127],62,4,36031,4.286343088270283,0.0,20.0
38406,3,8406,[ 64 318 313 301  11],416,5,36036,4.286427976686095,60.0,20.0
38407,3,8407,[228 172 588 222 288],711,2,36038,4.28615604186489,0.0,20.0
38408,3,8408,[ 22 185 153 275  69],854,4,36042,4.28612201212986,0.0,0.0
38409,3,8409,[238 273 195 185 268],297,4,36046,4.286087990487514,0.0,0.0
38410,3,8410,[191   8 168 742 235],805,2,36048,4.28581619308049,0.0,0.0
38411,3,8411,[ 64 318 313 301  11],416,5,36053,4.285901093675702,60.0,20.0
38412,3,8412,[ 98 385 135 678 183],805,4,36057,4.285867110424343,0.0,20.0
38413,3,8413,[269 328 289  98 195],854,2,36059,4.285595436177799,0.0,20.0
38414,3,8414,[ 64 318 313 301  11],345,5,36064,4.285680332739156,60.0,20.0
38415,3,8415,[273  50 168  82 135],62,5,36069,4.285765209125476,0.0,20.0
38416,3,8416,[173 403 268 269 300],345,3,36072,4.28561245099204,0.0,0.0
38417,3,8417,[ 64 318 313 301  11],345,5,36077,4.285697315276788,60.0,20.0
38418,3,8418,[ 64 318 313 301  11],416,5,36082,4.285782159401354,60.0,20.0
38419,3,8419,[ 64 318 313 301  11],43,5,36087,4.285866983372921,60.0,20.0
38420,3,8420,[ 64 318 313 301  11],345,5,36092,4.28595178719867,60.0,20.0
38421,3,8421,[117  64 228 172  79],373,5,36097,4.286036570885775,20.0,0.0
38422,3,8422,[ 64 318 313 301  11],345,5,36102,4.28612133444141,60.0,20.0
38423,3,8423,[ 64 318 313 301  11],43,5,36107,4.286206077872745,60.0,20.0
38424,3,8424,[ 64 318 313 301  11],43,5,36112,4.286290801186944,60.0,20.0
38425,3,8425,[ 64 318 313 301  11],345,5,36117,4.28637550439117,60.0,20.0
38426,3,8426,[ 64 318 313 301  11],43,5,36122,4.286460187492583,60.0,20.0
38427,3,8427,[ 64 318 313 301  11],345,5,36127,4.2865448504983386,60.0,20.0
38428,3,8428,[ 12 172  82  96 204],805,3,36130,4.286392217344881,20.0,0.0
38429,3,8429,[273 153 121  98 118],630,4,36134,4.286358244365362,0.0,20.0
38430,3,8430,[ 64 318 313 301  11],416,5,36139,4.28644288933697,60.0,20.0
38431,3,8431,[ 64 318 313 301  11],345,5,36144,4.286527514231499,60.0,20.0
38432,3,8432,[322 318 258  56 161],721,3,36147,4.286374955531839,20.0,0.0
38433,3,8433,[ 64 318 313 301  11],43,5,36152,4.286459568413564,60.0,20.0
38434,3,8434,[265 655 121 204 176],618,4,36156,4.286425607587433,0.0,0.0
38435,3,8435,[ 64 318 313 301  11],416,5,36161,4.286510194404931,60.0,20.0
38436,3,8436,[ 64 318 313 301  11],345,5,36166,4.286594761171032,60.0,20.0
38437,3,8437,[ 96 333 385 301 275],416,5,36171,4.286679307892865,0.0,0.0
38438,3,8438,[  1 211 742 265 588],416,5,36176,4.286763834577557,0.0,0.0
38439,3,8439,[269  69  64 313 427],214,3,36179,4.286611374407583,40.0,20.0
38440,3,8440,[ 64 318 313 301  11],43,5,36184,4.286695889112664,60.0,20.0
38441,3,8441,[ 64 318 313 301  11],345,5,36189,4.28678038379531,60.0,20.0
38442,3,8442,[181 678 568 269  96],805,3,36192,4.286627975837972,0.0,20.0
38443,3,8443,[ 64 318 313 301  11],345,5,36197,4.28671245855045,60.0,20.0
38444,3,8444,[ 64 318 313 301  11],43,5,36202,4.28679692125518,60.0,20.0
38445,3,8445,[ 64 318 313 301  11],43,5,36207,4.286881363959271,60.0,20.0
38446,3,8446,[ 64 318 313 301  11],43,5,36212,4.286965786669824,60.0,20.0
38447,3,8447,[111 182 235 173 603],416,4,36216,4.286931818181818,0.0,0.0
38448,3,8448,[ 64 318 313 301  11],416,5,36221,4.287016214936679,60.0,20.0
38449,3,8449,[435 273 245 222   1],297,2,36223,4.286745562130178,0.0,0.0
38450,3,8450,[ 64 318 313 301  11],416,5,36228,4.2868299609513665,60.0,20.0
38451,3,8451,[245 268 301 202 200],416,4,36232,4.2867960246095596,0.0,0.0
38452,3,8452,[ 64 318 313 301  11],345,5,36237,4.286880397492014,60.0,20.0
38453,3,8453,[ 64 318 313 301  11],345,5,36242,4.286964750414005,60.0,20.0
38454,3,8454,[181 328 194 153 210],416,5,36247,4.287049083382614,0.0,20.0
38455,3,8455,[ 70   1 168 181 125],416,5,36252,4.287133396404919,0.0,20.0
38456,3,8456,[ 64 318 313 301  11],43,5,36257,4.287217689487998,60.0,20.0
38457,3,8457,[ 64 318 313 301  11],43,5,36262,4.287301962638922,60.0,20.0
38458,3,8458,[ 64 318 313 301  11],43,5,36267,4.2873862158647595,60.0,20.0
38459,3,8459,[ 64 318 313 301  11],416,5,36272,4.287470449172577,60.0,20.0
38460,3,8460,[ 64 318 313 301  11],43,5,36277,4.287554662569436,60.0,20.0
38461,3,8461,[ 64 318 313 301  11],345,5,36282,4.287638856062396,60.0,20.0
38462,3,8462,[181 568  64 111 121],416,5,36287,4.287723029658514,20.0,20.0
38463,3,8463,[ 64 318 313 301  11],345,5,36292,4.28780718336484,60.0,20.0
38464,3,8464,[ 64 318 313 301  11],345,5,36297,4.287891317188423,60.0,20.0
38465,3,8465,[ 64 318 313 301  11],345,5,36302,4.28797543113631,60.0,20.0
38466,3,8466,[ 64 318 313 301  11],43,5,36307,4.288059525215543,60.0,20.0
38467,3,8467,[294 125   9 153 117],416,5,36312,4.28814359943316,0.0,0.0
38468,3,8468,[ 64 318 313 301  11],345,5,36317,4.288227653796198,60.0,20.0
38469,3,8469,[ 64 318 313 301  11],416,5,36322,4.288311688311689,60.0,20.0
38470,3,8470,[ 70 588   1  15  56],618,3,36325,4.288159603352614,0.0,0.0
38471,3,8471,[ 64 318 313 301  11],416,5,36330,4.288243626062323,60.0,20.0
38472,3,8472,[ 64 318 313 301  11],43,5,36335,4.2883276289389824,60.0,20.0
38473,3,8473,[276 318 186 216 546],43,4,36339,4.288293603965069,20.0,0.0
38474,3,8474,[471   8 132 144  64],618,3,36342,4.288141592920354,20.0,0.0
38475,3,8475,[ 64 318 313 301  11],345,5,36347,4.288225578102879,60.0,20.0
38476,3,8476,[ 64 318 313 301  11],416,5,36352,4.288309543470567,60.0,20.0
38477,3,8477,[ 64 318 313 301  11],43,5,36357,4.288393489030431,60.0,20.0
38478,3,8478,[ 15  95 173  25  69],373,5,36362,4.2884774147894795,0.0,0.0
38479,3,8479,[ 64 318 313 301  11],345,5,36367,4.288561320754717,60.0,20.0
38480,3,8480,[323 403  22 185  15],416,4,36371,4.288527296309398,0.0,0.0
38481,3,8481,[ 50 258 588  15 127],43,5,36376,4.28861117660929,0.0,20.0
38482,3,8482,[ 64 318 313 301  11],345,5,36381,4.28869503713309,60.0,20.0
38483,3,8483,[ 64 318 313 301  11],416,5,36386,4.288778877887789,60.0,20.0
38484,3,8484,[ 64 318 313 301  11],345,5,36391,4.2888626988803775,60.0,20.0
38485,3,8485,[302  12  64  71 172],43,5,36396,4.2889465001178415,40.0,0.0
38486,3,8486,[ 64 318 313 301  11],416,5,36401,4.289030281607164,60.0,20.0
38487,3,8487,[ 56  79 483 222 288],588,4,36405,4.288996229971724,20.0,20.0
38488,3,8488,[ 64 318 313 301  11],43,5,36410,4.28907998586406,60.0,20.0
38489,3,8489,[ 64 318 313 301  11],43,5,36415,4.289163722025913,60.0,20.0
38490,3,8490,[ 50 200 132  11 175],198,4,36419,4.289129666705924,0.0,20.0
38491,3,8491,[ 64 318 313 301  11],416,5,36424,4.289213377296279,60.0,20.0
38492,3,8492,[ 64 318 313 301  11],43,5,36429,4.2892970681737905,60.0,20.0
38493,3,8493,[ 64 318 313 301  11],43,5,36434,4.28938073934542,60.0,20.0
38494,3,8494,[ 64 318 313 301  11],43,5,36439,4.289464390818129,60.0,20.0
38495,3,8495,[ 64 318 313 301  11],43,5,36444,4.28954802259887,60.0,20.0
38496,3,8496,[182 174 294 405 302],62,2,36446,4.289278568906673,0.0,0.0
38497,3,8497,[ 64 318 313 301  11],345,5,36451,4.2893622028712635,60.0,20.0
38498,3,8498,[ 64 318 313 301  11],43,5,36456,4.289445817154959,60.0,20.0
38499,3,8499,[ 64 318 313 301  11],43,5,36461,4.289529411764706,60.0,20.0
38500,3,8500,[ 15 273 269  22 121],854,2,36463,4.289260087048582,0.0,0.0
38501,3,8501,[ 64 318 313 301  11],43,5,36468,4.289343683839097,60.0,20.0
38502,3,8502,[655  69 132 405 117],417,3,36471,4.289192049864754,0.0,0.0
38503,3,8503,[268 100 282 318  95],416,4,36475,4.289158043273754,20.0,0.0
38504,3,8504,[ 64 318 313 301  11],345,5,36480,4.289241622574956,60.0,20.0
38505,3,8505,[ 64 318 313 301  11],416,5,36485,4.289325182224312,60.0,20.0
38506,3,8506,[ 64 318 313 301  11],416,5,36490,4.289408722228753,60.0,20.0
38507,3,8507,[ 64 318 313 301  11],43,5,36495,4.2894922425952045,60.0,20.0
38508,3,8508,[ 64 318 313 301  11],416,5,36500,4.289575743330591,60.0,20.0
38509,3,8509,[ 64 318 313 301  11],416,5,36505,4.2896592244418335,60.0,20.0
38510,3,8510,[143 181 471  50 258],128,4,36509,4.289625190929385,0.0,40.0
38511,3,8511,[ 64 318 313 301  11],416,5,36514,4.289708646616542,60.0,20.0
38512,3,8512,[ 64 318 313 301  11],416,5,36519,4.289792082697051,60.0,20.0
38513,3,8513,[ 64 318 313 301  11],345,5,36524,4.289875499177825,60.0,20.0
38514,3,8514,[ 22 245 515 271 423],297,2,36526,4.2896065766294775,0.0,0.0
38515,3,8515,[ 56 185 186 288 302],417,2,36528,4.28933771723814,0.0,20.0
38516,3,8516,[ 12  79  50 655 588],805,3,36531,4.2891863332159215,20.0,20.0
38517,3,8517,[ 64 318 313 301  11],43,5,36536,4.2892697816388825,60.0,20.0
38518,3,8518,[ 64 318 313 301  11],416,5,36541,4.289353210470712,60.0,20.0
38519,3,8519,[ 64 318 313 301  11],43,5,36546,4.28943661971831,60.0,20.0
38520,3,8520,[ 64 318 313 301  11],345,5,36551,4.2895200093885695,60.0,20.0
38521,3,8521,[ 64 318 313 301  11],43,5,36556,4.289603379488383,60.0,20.0
38522,3,8522,[174 258   4 313 268],654,4,36560,4.289569400445853,20.0,20.0
38523,3,8523,[215 288  82 228  64],405,4,36564,4.28953542937588,20.0,20.0
38524,3,8524,[ 64 318 313 301  11],416,5,36569,4.289618768328446,60.0,20.0
38525,3,8525,[ 64 318 313 301  11],43,5,36574,4.289702087731644,60.0,20.0
38526,3,8526,[748 328 118 222 117],507,4,36578,4.289668113052656,0.0,0.0
38527,3,8527,[ 64 318 313 301  11],416,5,36583,4.289751407129456,60.0,20.0
38528,3,8528,[ 64 318 313 301  11],43,5,36588,4.289834681674288,60.0,20.0
38529,3,8529,[597 187   1 185 288],618,4,36592,4.289800703399766,0.0,20.0
38530,3,8530,[ 64 318 313 301  11],345,5,36597,4.289883952643301,60.0,20.0
38531,3,8531,[238 215  98 271  97],297,3,36600,4.289732770745429,0.0,20.0
38532,3,8532,[ 64 318 313 301  11],416,5,36605,4.289816008437829,60.0,20.0
38533,3,8533,[ 64 318 313 301  11],345,5,36610,4.28989922662292,60.0,20.0
38534,3,8534,[ 64 318 313 301  11],345,5,36615,4.289982425307557,60.0,20.0
38535,3,8535,[ 96 172 222 143 294],921,5,36620,4.2900656044985945,0.0,0.0
38536,3,8536,[ 64 318 313 301  11],416,5,36625,4.290148764202882,60.0,20.0
38537,3,8537,[ 64 318 313 301  11],43,5,36630,4.290231904427267,60.0,20.0
38538,3,8538,[111 322  98 151 200],416,3,36633,4.290080805714955,0.0,20.0
38539,3,8539,[ 64 318 313 301  11],416,5,36638,4.2901639344262295,60.0,20.0
38540,3,8540,[ 98 195 238 173 210],198,4,36642,4.290129961362838,0.0,20.0
38541,3,8541,[ 64 318 313 301  11],416,5,36647,4.2902130648560055,60.0,20.0
38542,3,8542,[161  69 275 118 318],588,2,36649,4.2899449841975885,20.0,0.0
38543,3,8543,[ 64 318 313 301  11],416,5,36654,4.290028089887641,60.0,20.0
38544,3,8544,[172  12  97  79 202],618,4,36658,4.289994148624927,20.0,0.0
38545,3,8545,[172 202  95 678 603],416,3,36661,4.289843201497777,0.0,0.0
38546,3,8546,[ 64 318 313 301  11],416,5,36666,4.2899262899262895,60.0,20.0
38547,3,8547,[196  25  98 179  71],128,3,36669,4.289775386055218,0.0,20.0
38548,3,8548,[ 64 318 313 301  11],43,5,36674,4.289858462978126,60.0,20.0
38549,3,8549,[568 196 515 235 748],416,4,36678,4.289824561403509,0.0,0.0
38550,3,8550,[ 70 475  82 191   4],417,4,36682,4.289790667758157,0.0,0.0
38551,3,8551,[ 64 318 313 301  11],43,5,36687,4.289873713751169,60.0,20.0
38552,3,8552,[ 64 318 313 301  11],43,5,36692,4.2899567403250325,60.0,20.0
38553,3,8553,[ 64 318 313 301  11],345,5,36697,4.290039747486556,60.0,20.0
38554,3,8554,[ 64 318 313 301  11],345,5,36702,4.290122735242548,60.0,20.0
38555,3,8555,[118 197 603 191 276],437,4,36706,4.290088826554465,0.0,0.0
38556,3,8556,[ 69 269 423 588 237],262,3,36709,4.2899380624050485,0.0,0.0
38557,3,8557,[357 132 333 328 385],416,5,36714,4.290021032951624,0.0,0.0
38558,3,8558,[ 64 318 313 301  11],345,5,36719,4.290103984110293,60.0,20.0
38559,3,8559,[ 64 318 313 301  11],345,5,36724,4.29018691588785,60.0,20.0
38560,3,8560,[ 12  28   7 117 173],588,4,36728,4.290153019507067,20.0,0.0
38561,3,8561,[181 132 257 515 135],698,2,36730,4.289885540761504,0.0,20.0
38562,3,8562,[ 82 182 588 496 210],253,3,36733,4.289734905990891,0.0,0.0
38563,3,8563,[ 64 318 313 301  11],43,5,36738,4.289817842129846,60.0,20.0
38564,3,8564,[ 11  95 195 385 238],417,5,36743,4.28990075890251,0.0,0.0
38565,3,8565,[ 96 175 172 313 179],405,2,36745,4.289633434508522,20.0,20.0
38566,3,8566,[ 64 318 313 301  11],416,5,36750,4.289716353449282,60.0,20.0
38567,3,8567,[588 216 228  79 168],128,4,36754,4.2896825396825395,0.0,0.0
38568,3,8568,[ 64 318 313 301  11],43,5,36759,4.289765433539503,60.0,20.0
38569,3,8569,[ 64 318 313 301  11],43,5,36764,4.289848308051342,60.0,20.0
38570,3,8570,[ 64 318 313 301  11],43,5,36769,4.289931163224828,60.0,20.0
38571,3,8571,[ 64 318 313 301  11],416,5,36774,4.290013999066729,60.0,20.0
38572,3,8572,[ 64 318 313 301  11],43,5,36779,4.2900968155838095,60.0,20.0
38573,3,8573,[ 64 318 313 301  11],416,5,36784,4.290179612782832,60.0,20.0
38574,3,8574,[185 143 678 127 100],805,3,36787,4.29002915451895,0.0,0.0
38575,3,8575,[403  96 197 183 211],405,2,36789,4.289762126865671,0.0,0.0
38576,3,8576,[ 64 318 313 301  11],416,5,36794,4.289844934126151,60.0,20.0
38577,3,8577,[265 405  96 318 194],416,5,36799,4.289927722079739,20.0,0.0
38578,3,8578,[ 64 318 313 301  11],416,5,36804,4.290010490733185,60.0,20.0
38579,3,8579,[ 64 318 313 301  11],416,5,36809,4.29009324009324,60.0,20.0
38580,3,8580,[121 238 269  56 168],214,3,36812,4.28994289709824,0.0,0.0
38581,3,8581,[ 64 318 313 301  11],345,5,36817,4.290025635050105,60.0,20.0
38582,3,8582,[204 265 403 186  89],373,4,36821,4.2899918443434695,0.0,0.0
38583,3,8583,[ 64 318 313 301  11],43,5,36826,4.290074557315936,60.0,20.0
38584,3,8584,[ 64 318 313 301  11],416,5,36831,4.290157251019219,60.0,20.0
38585,3,8585,[ 64 318 313 301  11],345,5,36836,4.290239925460051,60.0,20.0
38586,3,8586,[ 88 269 294  79 313],416,4,36840,4.290206125538605,20.0,20.0
38587,3,8587,[ 64 318 313 301  11],43,5,36845,4.2902887750349326,60.0,20.0
38588,3,8588,[ 64 318 313 301  11],43,5,36850,4.290371405285831,60.0,20.0
38589,3,8589,[ 64 318 313 301  11],416,5,36855,4.290454016298021,60.0,20.0
38590,3,8590,[ 50  22 678 195 211],416,4,36859,4.290420207193574,0.0,20.0
38591,3,8591,[ 64 318 313 301  11],416,5,36864,4.290502793296089,60.0,20.0
38592,3,8592,[ 97 603  22 173 435],297,4,36868,4.290468986384266,0.0,0.0
38593,3,8593,[179 151 100  11  69],214,4,36872,4.290435187340004,0.0,0.0
38594,3,8594,[ 64 318 313 301  11],345,5,36877,4.290517742873764,60.0,20.0
38595,3,8595,[ 64 318 313 301  11],43,5,36882,4.290600279199627,60.0,20.0
38596,3,8596,[ 64 318 313 301  11],416,5,36887,4.290682796324299,60.0,20.0
38597,3,8597,[151 228 100   8 423],887,3,36890,4.290532682019074,0.0,0.0
38598,3,8598,[276 174 153 496 204],437,5,36895,4.290615187812536,0.0,0.0
38599,3,8599,[174 235 423 237 483],62,3,36898,4.29046511627907,20.0,0.0
38600,3,8600,[238 288 191  22 118],601,2,36900,4.290198814091385,0.0,20.0
38601,3,8601,[ 12 144  22  97 194],416,5,36905,4.290281329923274,20.0,0.0
38602,3,8602,[  9 385 328 597 275],43,4,36909,4.29024758805068,0.0,0.0
38603,3,8603,[215 117  64 405 588],416,5,36914,4.290330079033008,20.0,0.0
38604,3,8604,[ 64 318 313 301  11],416,5,36919,4.290412550842533,60.0,20.0
38605,3,8605,[300   7  79   8  98],297,3,36922,4.290262607483151,0.0,20.0
38606,3,8606,[ 64 318 313 301  11],345,5,36927,4.290345067967933,60.0,20.0
38607,3,8607,[ 64 318 313 301  11],43,5,36932,4.29042750929368,60.0,20.0
38608,3,8608,[ 64 318 313 301  11],345,5,36937,4.290509931467069,60.0,20.0
38609,3,8609,[ 64 318 313 301  11],416,5,36942,4.290592334494773,60.0,20.0
38610,3,8610,[ 64 318 313 301  11],345,5,36947,4.290674718383463,60.0,20.0
38611,3,8611,[ 64 318 313 301  11],43,5,36952,4.2907570831398045,60.0,20.0
38612,3,8612,[ 64 318 313 301  11],43,5,36957,4.290839428770464,60.0,20.0
38613,3,8613,[403   7 471 215 204],416,5,36962,4.290921755282099,0.0,0.0
38614,3,8614,[  4 200 111  11 234],805,2,36964,4.290655832849681,0.0,0.0
38615,3,8615,[273 135 471 143 546],297,3,36967,4.290506035283194,0.0,0.0
38616,3,8616,[258  69 172 182 210],416,5,36972,4.29058837182314,0.0,0.0
38617,3,8617,[ 64 318 313 301  11],43,5,36977,4.290670689255047,60.0,20.0
38618,3,8618,[127 111 275 427 282],618,2,36979,4.290404919364195,0.0,0.0
38619,3,8619,[ 64 318 313 301  11],416,5,36984,4.290487238979118,60.0,20.0
38620,3,8620,[403  56   1  70 216],62,3,36987,4.290337547848277,0.0,0.0
38621,3,8621,[ 64 318 313 301  11],416,5,36992,4.2904198561818605,60.0,20.0
38622,3,8622,[ 98 655 385  82 125],262,2,36994,4.290154238664038,0.0,20.0
38623,3,8623,[ 64 318 313 301  11],345,5,36999,4.290236549165121,60.0,20.0
38624,3,8624,[ 64 318 313 301  11],43,5,37004,4.29031884057971,60.0,20.0
38625,3,8625,[ 64 318 313 301  11],43,5,37009,4.290401112914445,60.0,20.0
38626,3,8626,[ 64 318 313 301  11],345,5,37014,4.290483366175959,60.0,20.0
38627,3,8627,[302 182 515 174 318],405,3,37017,4.290333796940195,20.0,0.0
38628,3,8628,[ 64 318 313 301  11],416,5,37022,4.290416038938464,60.0,20.0
38629,3,8629,[ 64 318 313 301  11],345,5,37027,4.290498261877173,60.0,20.0
38630,3,8630,[ 15  50  82  25 237],416,4,37031,4.290464604333217,0.0,20.0
38631,3,8631,[323  64 117 135 423],417,3,37034,4.290315106580167,20.0,0.0
38632,3,8632,[ 70 204 175  50 294],43,4,37038,4.290281478049345,0.0,20.0
38633,3,8633,[ 64 318 313 301  11],43,5,37043,4.290363678480427,60.0,20.0
38634,3,8634,[423  89 508 182  98],297,3,37046,4.290214244354372,0.0,20.0
38635,3,8635,[ 64 318 313 301  11],345,5,37051,4.290296433534044,60.0,20.0
38636,3,8636,[ 56  22  50 216 197],297,4,37055,4.290262822739377,0.0,20.0
38637,3,8637,[ 64 318 313 301  11],43,5,37060,4.290344987265571,60.0,20.0
38638,3,8638,[ 64 318 313 301  11],416,5,37065,4.290427132769996,60.0,20.0
38639,3,8639,[245  89   7 508 286],297,4,37069,4.290393518518519,0.0,0.0
38640,3,8640,[ 64 318 313 301  11],416,5,37074,4.290475639393589,60.0,20.0
38641,3,8641,[143 132 121  97 496],734,4,37078,4.290442027308494,0.0,0.0
38642,3,8642,[ 56 742   4 288 215],345,4,37082,4.2904084230012725,0.0,20.0
38643,3,8643,[ 64 216   7 237 286],854,2,37084,4.290143452105506,20.0,0.0
38644,3,8644,[273 588 176 211 475],297,5,37089,4.290225563909774,0.0,0.0
38645,3,8645,[ 82 496 210 125 132],230,5,37094,4.290307656719871,0.0,0.0
38646,3,8646,[ 64 318 313 301  11],345,5,37099,4.290389730542385,60.0,20.0
38647,3,8647,[ 64 318 313 301  11],345,5,37104,4.290471785383904,60.0,20.0
38648,3,8648,[ 64 318 313 301  11],43,5,37109,4.290553821251011,60.0,20.0
38649,3,8649,[ 64 318 313 301  11],345,5,37114,4.290635838150289,60.0,20.0
38650,3,8650,[ 64 318 313 301  11],43,5,37119,4.290717836088313,60.0,20.0
38651,3,8651,[228 515 471 588 144],297,2,37121,4.290453074433657,0.0,0.0
38652,3,8652,[ 79 245   4 475  15],416,3,37124,4.29030394082977,0.0,0.0
38653,3,8653,[ 64 318 313 301  11],345,5,37129,4.2903859486942455,60.0,20.0
38654,3,8654,[176  69 211 588 294],416,5,37134,4.290467937608319,0.0,0.0
38655,3,8655,[ 64 318 313 301  11],345,5,37139,4.2905499075785585,60.0,20.0
38656,3,8656,[313 546 118 471  71],43,4,37143,4.29051634515421,20.0,20.0
38657,3,8657,[237 568 302 655 182],62,1,37144,4.2901362901362905,0.0,0.0
38658,3,8658,[ 64 318 313 301  11],345,5,37149,4.290218270008084,60.0,20.0
38659,3,8659,[ 64 318 313 301  11],43,5,37154,4.290300230946882,60.0,20.0
38660,3,8660,[197 175 603 179 258],805,4,37158,4.29026671285071,0.0,0.0
38661,3,8661,[ 50  71 168 265 194],405,1,37159,4.289886862156546,0.0,20.0
38662,3,8662,[302 187 273  69   9],416,5,37164,4.289968832967794,0.0,0.0
38663,3,8663,[ 64 318 313 301  11],43,5,37169,4.290050784856879,60.0,20.0
38664,3,8664,[ 64 318 313 301  11],43,5,37174,4.290132717830352,60.0,20.0
38665,3,8665,[ 64 318 313 301  11],345,5,37179,4.290214631894761,60.0,20.0
38666,3,8666,[ 64 318 313 301  11],43,5,37184,4.290296527056651,60.0,20.0
38667,3,8667,[ 64 318 313 301  11],416,5,37189,4.290378403322566,60.0,20.0
38668,3,8668,[ 64 318 313 301  11],345,5,37194,4.290460260699042,60.0,20.0
38669,3,8669,[  9   4 215 257  71],62,3,37197,4.290311418685121,0.0,0.0
38670,3,8670,[603   8 323 313  97],416,4,37201,4.2902779379541,20.0,20.0
38671,3,8671,[172 234 238 195 202],712,2,37203,4.2900138376383765,0.0,0.0
38672,3,8672,[ 64 318 313 301  11],345,5,37208,4.290095699296668,60.0,20.0
38673,3,8673,[ 64 318 313 301  11],416,5,37213,4.290177542079778,60.0,20.0
38674,3,8674,[ 64 318 313 301  11],345,5,37218,4.2902593659942365,60.0,20.0
38675,3,8675,[  4 151  50 568 118],618,2,37220,4.289995389580452,0.0,20.0
38676,3,8676,[127  97 265 318 210],416,5,37225,4.290077215627521,20.0,0.0
38677,3,8677,[ 64 318 313 301  11],345,5,37230,4.290159022816317,60.0,20.0
38678,3,8678,[ 64 318 313 301  11],345,5,37235,4.2902408111533585,60.0,20.0
38679,3,8679,[238 546 496 195  98],262,3,37238,4.290092165898617,0.0,20.0
38680,3,8680,[ 64 318 313 301  11],416,5,37243,4.290173943094113,60.0,20.0
38681,3,8681,[ 64 318 313 301  11],43,5,37248,4.2902557014512785,60.0,20.0
38682,3,8682,[ 64 318 313 301  11],416,5,37253,4.290337440976621,60.0,20.0
38683,3,8683,[ 79 546 357  96 196],416,4,37257,4.290304007369875,0.0,0.0
38684,3,8684,[ 64 318 313 301  11],43,5,37262,4.2903857225100746,60.0,20.0
38685,3,8685,[ 64 318 313 301  11],345,5,37267,4.290467418834907,60.0,20.0
38686,3,8686,[211   4  79 405  11],416,5,37272,4.290549096350869,0.0,0.0
38687,3,8687,[ 64 318 313 301  11],345,5,37277,4.2906307550644565,60.0,20.0
38688,3,8688,[111 216 228 144 181],711,2,37279,4.290367130855104,0.0,20.0
38689,3,8689,[118 258 269 546 471],297,2,37281,4.2901035673187575,0.0,0.0
38690,3,8690,[ 64 318 313 301  11],416,5,37286,4.290185249108273,60.0,20.0
38691,3,8691,[ 64 318 313 301  11],345,5,37291,4.290266912103084,60.0,20.0
38692,3,8692,[ 64 318 313 301  11],345,5,37296,4.290348556309675,60.0,20.0
38693,3,8693,[ 64 318 313 301  11],345,5,37301,4.290430181734529,60.0,20.0
38694,3,8694,[ 64 318 313 301  11],345,5,37306,4.290511788384129,60.0,20.0
38695,3,8695,[568 235  28 216  79],43,4,37310,4.290478380864766,0.0,0.0
38696,3,8696,[ 79 175   7 235 603],297,3,37313,4.290329998850178,0.0,0.0
38697,3,8697,[194 168 118 318 496],416,4,37317,4.290296619912624,20.0,0.0
38698,3,8698,[ 64 318 313 301  11],43,5,37322,4.29037820439131,60.0,20.0
38699,3,8699,[ 64 318 313 301  11],416,5,37327,4.290459770114943,60.0,20.0
38700,3,8700,[302 181 435 175 318],721,4,37331,4.290426387771521,20.0,20.0
38701,3,8701,[  4 423 318  56 191],43,5,37336,4.2905079292116755,20.0,0.0
38702,3,8702,[ 64 318 313 301  11],43,5,37341,4.290589451913133,60.0,20.0
38703,3,8703,[100 204 118 286  28],416,4,37345,4.290556066176471,0.0,0.0
38704,3,8704,[ 64 318 313 301  11],416,5,37350,4.290637564618035,60.0,20.0
38705,3,8705,[238  56 144 257 427],342,4,37354,4.290604181024581,0.0,0.0
38706,3,8706,[289 258 496  82 237],588,2,37356,4.29034110485816,0.0,0.0
38707,3,8707,[286  50  88  97 328],43,5,37361,4.290422599908131,0.0,20.0
38708,3,8708,[273 302 174 111 118],297,3,37364,4.290274428751866,0.0,0.0
38709,3,8709,[100 328  64 121 496],253,5,37369,4.290355912743973,20.0,0.0
38710,3,8710,[235  88 125 318   8],642,3,37372,4.290207783262542,20.0,0.0
38711,3,8711,[ 64 318 313 301  11],416,5,37377,4.2902892561983474,60.0,20.0
38712,3,8712,[286 508 282 180 100],854,3,37380,4.290141168369104,0.0,0.0
38713,3,8713,[ 64 318 313 301  11],416,5,37385,4.290222630250172,60.0,20.0
38714,3,8714,[ 64 318 313 301  11],416,5,37390,4.290304073436603,60.0,20.0
38715,3,8715,[ 64 318 313 301  11],43,5,37395,4.290385497934833,60.0,20.0
38716,3,8716,[172 121  79 215 202],345,3,37398,4.2902374670184695,0.0,0.0
38717,3,8717,[174  82  25 294  56],230,3,37401,4.2900894700619405,0.0,0.0
38718,3,8718,[328 127  82 125  56],253,2,37403,4.28982681500172,0.0,0.0
38719,3,8719,[ 64 318 313 301  11],345,5,37408,4.289908256880734,60.0,20.0
38720,3,8720,[ 64 318 313 301  11],43,5,37413,4.289989680082559,60.0,20.0
38721,3,8721,[175 215 318 144 385],373,2,37415,4.289727126805778,20.0,0.0
38722,3,8722,[200 144 597 176 196],805,2,37417,4.289464633726928,0.0,0.0
38723,3,8723,[ 64 318 313 301  11],345,5,37422,4.289546079779917,60.0,20.0
38724,3,8724,[ 64 318 313 301  11],416,5,37427,4.289627507163324,60.0,20.0
38725,3,8725,[ 64 318 313 301  11],416,5,37432,4.289708915883566,60.0,20.0
38726,3,8726,[ 64 318 313 301  11],43,5,37437,4.289790305947061,60.0,20.0
38727,3,8727,[ 64 318 313 301  11],345,5,37442,4.28987167736022,60.0,20.0
38728,3,8728,[ 64 318 313 301  11],43,5,37447,4.289953030129453,60.0,20.0
38729,3,8729,[ 12 655 265 117 322],416,4,37451,4.28991981672394,20.0,0.0
38730,3,8730,[ 64 318 313 301  11],43,5,37456,4.290001145344176,60.0,20.0
38731,3,8731,[ 64 318 313 301  11],345,5,37461,4.290082455336693,60.0,20.0
38732,3,8732,[ 64 318 313 301  11],416,5,37466,4.29016374670789,60.0,20.0
38733,3,8733,[ 64 318 313 301  11],416,5,37471,4.290245019464163,60.0,20.0
38734,3,8734,[ 95 276  69 174 135],922,1,37472,4.289868345735547,0.0,0.0
38735,3,8735,[ 64 318 313 301  11],416,5,37477,4.289949633699634,60.0,20.0
38736,3,8736,[ 64 318 313 301  11],43,5,37482,4.2900309030559685,60.0,20.0
38737,3,8737,[ 64 318 313 301  11],416,5,37487,4.290112153810941,60.0,20.0
38738,3,8738,[318 234 245 235 275],416,3,37490,4.289964526833733,20.0,0.0
38739,3,8739,[238 597 197 258 176],416,4,37494,4.289931350114417,0.0,0.0
38740,3,8740,[318 435 143 238 357],405,4,37498,4.289898180986158,20.0,0.0
38741,3,8741,[427 300 161 258 216],198,3,37501,4.289750629146648,0.0,0.0
38742,3,8742,[ 64 318 313 301  11],345,5,37506,4.289831865492394,60.0,20.0
38743,3,8743,[ 64 318 313 301  11],43,5,37511,4.28991308325709,60.0,20.0
38744,3,8744,[ 64 318 313 301  11],43,5,37516,4.289994282447113,60.0,20.0
38745,3,8745,[546 121  12 238 515],416,4,37520,4.289961125085753,20.0,0.0
38746,3,8746,[144 294 245 238 318],416,4,37524,4.289927975305819,20.0,0.0
38747,3,8747,[ 64 318 313 301  11],345,5,37529,4.290009144947416,60.0,20.0
38748,3,8748,[204 182  79  88 161],128,5,37534,4.290090296033832,0.0,0.0
38749,3,8749,[202 196 195  12 121],618,3,37537,4.289942857142857,20.0,0.0
38750,3,8750,[ 64 318 313 301  11],43,5,37542,4.290023997257456,60.0,20.0
38751,3,8751,[ 64 318 313 301  11],416,5,37547,4.290105118829982,60.0,20.0
38752,3,8752,[ 64 318 313 301  11],416,5,37552,4.290186221866788,60.0,20.0
38753,3,8753,[ 64 318 313 301  11],43,5,37557,4.290267306374229,60.0,20.0
38754,3,8754,[ 64 318 313 301  11],43,5,37562,4.290348372358652,60.0,20.0
38755,3,8755,[143 204 748 151 475],805,2,37564,4.290086797624486,0.0,0.0
38756,3,8756,[ 64 318 313 301  11],345,5,37569,4.290167865707434,60.0,20.0
38757,3,8757,[ 64 318 313 301  11],416,5,37574,4.290248915277461,60.0,20.0
38758,3,8758,[185  25 427 237 471],618,3,37577,4.2901016097728055,0.0,0.0
38759,3,8759,[153  15  11 200 742],416,5,37582,4.290182648401826,0.0,0.0
38760,3,8760,[ 96 118 168  98 172],751,4,37586,4.290149526309782,0.0,20.0
38761,3,8761,[ 64 318 313 301  11],43,5,37591,4.290230540972381,60.0,20.0
38762,3,8762,[ 64 318 313 301  11],416,5,37596,4.290311537144813,60.0,20.0
38763,3,8763,[196 322 204 265 174],128,3,37599,4.290164308534916,0.0,0.0
38764,3,8764,[597 496 237  98 423],43,4,37603,4.290131203650884,0.0,20.0
38765,3,8765,[ 11 288 588 655 194],405,3,37606,4.289984029203742,0.0,20.0
38766,3,8766,[245  82 328 235  98],416,3,37609,4.2898368883312425,0.0,20.0
38767,3,8767,[ 64 318 313 301  11],43,5,37614,4.289917883211679,60.0,20.0
38768,3,8768,[ 64 318 313 301  11],345,5,37619,4.2899988596191125,60.0,20.0
38769,3,8769,[ 64 318 313 301  11],43,5,37624,4.290079817559863,60.0,20.0
38770,3,8770,[ 64 318 313 301  11],345,5,37629,4.290160757040247,60.0,20.0
38771,3,8771,[ 64 318 313 301  11],345,5,37634,4.290241678066575,60.0,20.0
38772,3,8772,[ 64 318 313 301  11],345,5,37639,4.290322580645161,60.0,20.0
38773,3,8773,[ 64 318 313 301  11],416,5,37644,4.290403464782312,60.0,20.0
38774,3,8774,[ 64 318 313 301  11],416,5,37649,4.290484330484331,60.0,20.0
38775,3,8775,[ 64 318 313 301  11],345,5,37654,4.290565177757521,60.0,20.0
38776,3,8776,[ 64 318 313 301  11],345,5,37659,4.29064600660818,60.0,20.0
38777,3,8777,[175 603 655 275 191],373,4,37663,4.290612895876054,0.0,0.0
38778,3,8778,[144 258 195 273   1],297,2,37665,4.290351976307097,0.0,0.0
38779,3,8779,[ 64 318 313 301  11],416,5,37670,4.290432801822323,60.0,20.0
38780,3,8780,[ 64 318 313 301  11],345,5,37675,4.290513608928368,60.0,20.0
38781,3,8781,[ 82 143 265 117 172],373,3,37678,4.2903666590753815,0.0,0.0
38782,3,8782,[ 64 318 313 301  11],345,5,37683,4.290447455311397,60.0,20.0
38783,3,8783,[ 64 318 313 301  11],416,5,37688,4.290528233151184,60.0,20.0
38784,3,8784,[ 64 318 313 301  11],345,5,37693,4.290608992601024,60.0,20.0
38785,3,8785,[182 216 210  11  12],405,3,37696,4.290462098793535,20.0,0.0
38786,3,8786,[ 64 318 313 301  11],345,5,37701,4.2905428473881875,60.0,20.0
38787,3,8787,[ 64 143 172 215  11],43,5,37706,4.290623577605826,20.0,0.0
38788,3,8788,[ 64 318 313 301  11],345,5,37711,4.290704289452725,60.0,20.0
38789,3,8789,[ 64 318 313 301  11],345,5,37716,4.290784982935153,60.0,20.0
38790,3,8790,[ 64 318 313 301  11],43,5,37721,4.290865658059379,60.0,20.0
38791,3,8791,[ 64 318 313 301  11],43,5,37726,4.2909463148316656,60.0,20.0
38792,3,8792,[  7 183 181 237 168],62,4,37730,4.290913226430115,0.0,20.0
38793,3,8793,[ 64 318 313 301  11],416,5,37735,4.290993859449625,60.0,20.0
38794,3,8794,[174 385 168 143 172],922,3,37738,4.290847072200114,0.0,0.0
38795,3,8795,[196   4  50 235 204],62,4,37742,4.2908140063665305,0.0,20.0
38796,3,8796,[ 97 282  79  56 181],588,4,37746,4.290780948050472,0.0,20.0
38797,3,8797,[ 64 318 313 301  11],345,5,37751,4.290861559445329,60.0,20.0
38798,3,8798,[ 64 318 313 301  11],345,5,37756,4.2909421525173315,60.0,20.0
38799,3,8799,[ 64 318 313 301  11],43,5,37761,4.291022727272727,60.0,20.0
38800,3,8800,[ 64 318 313 301  11],416,5,37766,4.291103283717759,60.0,20.0
38801,3,8801,[191  79  82 288  89],711,3,37769,4.290956600772551,0.0,20.0
38802,3,8802,[ 64 318 313 301  11],345,5,37774,4.291037146427354,60.0,20.0
38803,3,8803,[ 64 318 313 301  11],416,5,37779,4.291117673784643,60.0,20.0
38804,3,8804,[ 64 318 313 301  11],416,5,37784,4.291198182850653,60.0,20.0
38805,3,8805,[ 64 318 313 301  11],43,5,37789,4.291278673631615,60.0,20.0
38806,3,8806,[265 300 216 151  22],416,4,37793,4.2912456000908366,0.0,0.0
38807,3,8807,[ 64 318 313 301  11],345,5,37798,4.291326067211626,60.0,20.0
38808,3,8808,[210  64 144 197 176],618,3,37801,4.291179475536383,20.0,0.0
38809,3,8809,[ 64 318 313 301  11],416,5,37806,4.291259931895573,60.0,20.0
38810,3,8810,[403 496  70 117  12],416,5,37811,4.291340369992056,20.0,0.0
38811,3,8811,[151 271 185 322 423],854,4,37815,4.291307308216069,0.0,0.0
38812,3,8812,[ 64 318 313 301  11],416,5,37820,4.291387722682401,60.0,20.0
38813,3,8813,[ 64 318 313 301  11],43,5,37825,4.291468118901747,60.0,20.0
38814,3,8814,[ 64 318 313 301  11],43,5,37830,4.291548496880318,60.0,20.0
38815,3,8815,[282 175  95 194   9],342,3,37833,4.291401996370236,0.0,0.0
38816,3,8816,[ 64 318 313 301  11],345,5,37838,4.291482363615742,60.0,20.0
38817,3,8817,[ 64 318 313 301  11],43,5,37843,4.29156271263325,60.0,20.0
38818,3,8818,[ 64 318 313 301  11],345,5,37848,4.2916430434289605,60.0,20.0
38819,3,8819,[ 64 318 313 301  11],345,5,37853,4.29172335600907,60.0,20.0
38820,3,8820,[ 64 318 313 301  11],43,5,37858,4.291803650379776,60.0,20.0
38821,3,8821,[ 64 318 313 301  11],43,5,37863,4.291883926547269,60.0,20.0
38822,3,8822,[194 143 172 173  71],373,4,37867,4.291850844383997,0.0,0.0
38823,3,8823,[202 222   7 405 300],43,5,37872,4.29193109700816,0.0,0.0
38824,3,8824,[ 22 200 185 161 174],405,3,37875,4.291784702549575,0.0,0.0
38825,3,8825,[ 64 318 313 301  11],416,5,37880,4.291864944482212,60.0,20.0
38826,3,8826,[ 64 318 313 301  11],416,5,37885,4.291945168233828,60.0,20.0
38827,3,8827,[546 175  56 435   1],297,2,37887,4.291685545990032,0.0,0.0
38828,3,8828,[ 64 318 313 301  11],43,5,37892,4.291765771888096,60.0,20.0
38829,3,8829,[ 64 318 313 301  11],345,5,37897,4.291845979614949,60.0,20.0
38830,3,8830,[185 235   8  12 182],297,3,37900,4.2916996942588606,20.0,0.0
38831,3,8831,[127 475 182 245  50],416,3,37903,4.291553442028985,0.0,20.0
38832,3,8832,[435 200  69 271 185],297,1,37904,4.291180799275445,0.0,0.0
38833,3,8833,[ 64 318 313 301  11],416,5,37909,4.291261036902875,60.0,20.0
38834,3,8834,[135 176 323 496 228],417,1,37910,4.290888511601585,0.0,0.0
38835,3,8835,[ 64 318 313 301  11],345,5,37915,4.2909687641466725,60.0,20.0
38836,3,8836,[168 181 216 742 195],654,4,37919,4.2909358379540565,0.0,20.0
38837,3,8837,[ 64 318 313 301  11],345,5,37924,4.29101606698348,60.0,20.0
38838,3,8838,[ 64 318 313 301  11],43,5,37929,4.291096277859486,60.0,20.0
38839,3,8839,[181 173  56 300 161],49,1,37930,4.290723981900452,0.0,20.0
38840,3,8840,[  4  96 196 403 161],373,4,37934,4.290691098292048,0.0,0.0
38841,3,8841,[ 64 318 313 301  11],43,5,37939,4.290771318706175,60.0,20.0
38842,3,8842,[ 64 318 313 301  11],345,5,37944,4.290851520977044,60.0,20.0
38843,3,8843,[ 64 318 313 301  11],345,5,37949,4.290931705110809,60.0,20.0
38844,3,8844,[678 118 151  70 135],297,2,37951,4.290672696438666,0.0,0.0
38845,3,8845,[301 202 143 282   1],588,4,37955,4.29063983721456,0.0,0.0
38846,3,8846,[ 95 204 191 216 273],618,2,37957,4.290380920085905,0.0,0.0
38847,3,8847,[ 64 318 313 301  11],345,5,37962,4.290461121157324,60.0,20.0
38848,3,8848,[ 64 318 313 301  11],416,5,37967,4.290541304102159,60.0,20.0
38849,3,8849,[ 64 318 313 301  11],416,5,37972,4.290621468926553,60.0,20.0
38850,3,8850,[ 64 318 313 301  11],345,5,37977,4.290701615636651,60.0,20.0
38851,3,8851,[ 64 318 313 301  11],43,5,37982,4.29078174423859,60.0,20.0
38852,3,8852,[ 64 318 313 301  11],43,5,37987,4.290861854738507,60.0,20.0
38853,3,8853,[182  64   1  79  56],618,5,37992,4.290941947142534,20.0,0.0
38854,3,8854,[268  22 471 216 289],854,0,37992,4.290457368718238,0.0,0.0
38855,3,8855,[ 64 318 313 301  11],416,5,37997,4.29053748870822,60.0,20.0
38856,3,8856,[546 100 117 276 257],630,1,37998,4.290165970418878,0.0,0.0
38857,3,8857,[ 64 318 313 301  11],345,5,38003,4.290246105215624,60.0,20.0
38858,3,8858,[ 88 288 202 546 135],805,1,38004,4.2898747036911615,0.0,20.0
38859,3,8859,[546 161 179 200 172],49,1,38005,4.289503386004514,0.0,0.0
38860,3,8860,[ 98   8 151 132 185],618,3,38008,4.28935786028665,0.0,20.0
38861,3,8861,[ 64 318 313 301  11],345,5,38013,4.289438050101557,60.0,20.0
38862,3,8862,[ 64 318 313 301  11],416,5,38018,4.289518221821054,60.0,20.0
38863,3,8863,[ 64 318 313 301  11],416,5,38023,4.289598375451264,60.0,20.0
38864,3,8864,[546 176 185 475 234],270,5,38028,4.289678510998308,0.0,0.0
38865,3,8865,[ 64 318 313 301  11],416,5,38033,4.289758628468306,60.0,20.0
38866,3,8866,[ 64 318 313 301  11],345,5,38038,4.289838727867373,60.0,20.0
38867,3,8867,[144 151 153 172  11],805,3,38041,4.289693279206134,0.0,0.0
38868,3,8868,[204 196  25 117 318],314,3,38044,4.289547863344232,20.0,0.0
38869,3,8869,[195 483 238 200 144],854,3,38047,4.289402480270575,20.0,0.0
38870,3,8870,[ 64 318 313 301  11],416,5,38052,4.289482583699695,60.0,20.0
38871,3,8871,[427 176  97 172 385],230,4,38056,4.289449954914337,0.0,0.0
38872,3,8872,[ 64 318 313 301  11],43,5,38061,4.28953003493745,60.0,20.0
38873,3,8873,[  8 678   1 265 161],416,4,38065,4.289497408158666,0.0,0.0
38874,3,8874,[ 64 318 313 301  11],416,5,38070,4.289577464788732,60.0,20.0
38875,3,8875,[ 64 318 313 301  11],416,5,38075,4.2896575033799005,60.0,20.0
38876,3,8876,[ 64 318 313 301  11],416,5,38080,4.289737523938268,60.0,20.0
38877,3,8877,[294 196 275 300 174],43,5,38085,4.289817526469926,0.0,0.0
38878,3,8878,[ 64 318 313 301  11],345,5,38090,4.289897510980967,60.0,20.0
38879,3,8879,[182  12 153 423 234],437,4,38094,4.289864864864865,20.0,0.0
38880,3,8880,[ 64 318 313 301  11],345,5,38099,4.289944826033104,60.0,20.0
38881,3,8881,[ 64 318 313 301  11],416,5,38104,4.290024769196127,60.0,20.0
38882,3,8882,[ 64 318 313 301  11],416,5,38109,4.290104694360013,60.0,20.0
38883,3,8883,[423   8  98  96 173],405,4,38113,4.290072039621792,0.0,20.0
38884,3,8884,[268  79 196  69   1],297,2,38115,4.289814293753517,0.0,0.0
38885,3,8885,[ 64 318 313 301  11],416,5,38120,4.289894215620077,60.0,20.0
38886,3,8886,[ 64 318 313 301  11],345,5,38125,4.2899741195003935,60.0,20.0
38887,3,8887,[ 64 318 313 301  11],416,5,38130,4.29005400540054,60.0,20.0
38888,3,8888,[ 98 173 423 202  56],805,3,38133,4.289908876139048,0.0,20.0
38889,3,8889,[ 64 318 313 301  11],345,5,38138,4.289988751406074,60.0,20.0
38890,3,8890,[357 597 172 288 144],805,2,38140,4.28973118884265,0.0,20.0
38891,3,8891,[ 64 318 313 301  11],43,5,38145,4.289811066126855,60.0,20.0
38892,3,8892,[  7 173  97 471 294],505,2,38147,4.289553581468571,0.0,0.0
38893,3,8893,[ 64 318 313 301  11],416,5,38152,4.289633460760063,60.0,20.0
38894,3,8894,[ 64 318 313 301  11],345,5,38157,4.289713322091062,60.0,20.0
38895,3,8895,[ 64 318 313 301  11],345,5,38162,4.289793165467626,60.0,20.0
38896,3,8896,[ 64 318 313 301  11],43,5,38167,4.289872990895808,60.0,20.0
38897,3,8897,[ 64 318 313 301  11],416,5,38172,4.289952798381659,60.0,20.0
38898,3,8898,[655 237 117 186 215],198,3,38175,4.28980784357793,0.0,0.0
38899,3,8899,[ 64 318 313 301  11],416,5,38180,4.289887640449439,60.0,20.0
38900,3,8900,[ 64 318 313 301  11],345,5,38185,4.28996741939108,60.0,20.0
38901,3,8901,[ 64 318 313 301  11],345,5,38190,4.290047180408897,60.0,20.0
38902,3,8902,[ 64 318 313 301  11],345,5,38195,4.29012692350893,60.0,20.0
38903,3,8903,[204 471 678 210  56],297,2,38197,4.289869721473495,0.0,0.0
38904,3,8904,[403  50 186 172 423],405,5,38202,4.2899494665918025,0.0,20.0
38905,3,8905,[ 64 318 313 301  11],43,5,38207,4.2900291938019315,60.0,20.0
38906,3,8906,[ 64 318 313 301  11],416,5,38212,4.290108903109913,60.0,20.0
38907,3,8907,[258  12 748 235 181],417,3,38215,4.289964077233947,20.0,20.0
38908,3,8908,[ 64 318 313 301  11],416,5,38220,4.290043775956898,60.0,20.0
38909,3,8909,[313 185 603 496 385],416,5,38225,4.290123456790123,20.0,20.0
38910,3,8910,[125   7 191  98 515],417,4,38229,4.290090898889013,0.0,20.0
38911,3,8911,[269 174 302  82  79],416,5,38234,4.290170556552963,0.0,0.0
38912,3,8912,[ 64 318 313 301  11],43,5,38239,4.290250196342421,60.0,20.0
38913,3,8913,[ 89 186 238 117 318],198,4,38243,4.290217635180615,20.0,0.0
38914,3,8914,[ 64 318 313 301  11],416,5,38248,4.29029725182277,60.0,20.0
38915,3,8915,[ 64 318 313 301  11],416,5,38253,4.290376850605653,60.0,20.0
38916,3,8916,[257 180 132 302 183],62,3,38256,4.290232140854547,0.0,0.0
38917,3,8917,[ 64 318 313 301  11],416,5,38261,4.2903117290872395,60.0,20.0
38918,3,8918,[483 121  56 117 135],437,3,38264,4.2901670590873415,20.0,0.0
38919,3,8919,[211 196 200 245   4],417,4,38268,4.290134529147982,0.0,0.0
38920,3,8920,[143 603  12 235 357],416,4,38272,4.290102006501513,20.0,0.0
38921,3,8921,[200  82 234 222 357],198,2,38274,4.289845326160054,0.0,0.0
38922,3,8922,[ 64 318 313 301  11],345,5,38279,4.289924913145803,60.0,20.0
38923,3,8923,[ 64 318 313 301  11],416,5,38284,4.290004482294935,60.0,20.0
38924,3,8924,[275  79 268 546 294],416,4,38288,4.289971988795518,0.0,0.0
38925,3,8925,[322  89 475 195  12],805,3,38291,4.28982747031145,20.0,0.0
38926,3,8926,[ 64 318 313 301  11],345,5,38296,4.28990702363616,60.0,20.0
38927,3,8927,[ 71 174 191  25 183],198,3,38299,4.289762544802867,0.0,0.0
38928,3,8928,[ 64 318 313 301  11],416,5,38304,4.289842087579796,60.0,20.0
38929,3,8929,[202  11 181 403 238],805,2,38306,4.289585666293393,0.0,20.0
38930,3,8930,[ 64 318 313 301  11],345,5,38311,4.289665211062591,60.0,20.0
38931,3,8931,[403 427 204 132 678],416,4,38315,4.2896327810120916,0.0,0.0
38932,3,8932,[ 64 318 313 301  11],416,5,38320,4.289712302697862,60.0,20.0
38933,3,8933,[ 64 318 313 301  11],416,5,38325,4.289791806581598,60.0,20.0
38934,3,8934,[200 568  70 100 172],416,5,38330,4.289871292669278,0.0,0.0
38935,3,8935,[ 25 117 176  11 118],297,4,38334,4.289838854073411,0.0,0.0
38936,3,8936,[ 64 318 313 301  11],43,5,38339,4.28991831710865,60.0,20.0
38937,3,8937,[268 168 132   8 153],854,4,38343,4.289885880510181,0.0,0.0
38938,3,8938,[ 64 318 313 301  11],345,5,38348,4.289965320505649,60.0,20.0
38939,3,8939,[ 64 318 313 301  11],345,5,38353,4.2900447427293065,60.0,20.0
38940,3,8940,[ 64 318 313 301  11],345,5,38358,4.290124147187115,60.0,20.0
38941,3,8941,[ 64 318 313 301  11],43,5,38363,4.290203533885037,60.0,20.0
38942,3,8942,[ 64 318 313 301  11],43,5,38368,4.290282902829028,60.0,20.0
38943,3,8943,[238  12  22 258 185],416,5,38373,4.290362254025045,20.0,0.0
38944,3,8944,[ 64 318 313 301  11],43,5,38378,4.290441587479038,60.0,20.0
38945,3,8945,[222 276   9 405 176],601,3,38381,4.290297339593114,0.0,0.0
38946,3,8946,[ 97 173   8 181 176],405,3,38384,4.290153123952162,0.0,20.0
38947,3,8947,[ 64 318 313 301  11],416,5,38389,4.290232454179705,60.0,20.0
38948,3,8948,[111 204 100 294  70],297,2,38391,4.289976533690915,0.0,0.0
38949,3,8949,[588  71  95  97 181],712,5,38396,4.290055865921787,0.0,20.0
38950,3,8950,[ 22 181  50 132  96],405,4,38400,4.290023461065803,0.0,40.0
38951,3,8951,[ 64 318 313 301  11],43,5,38405,4.290102770330653,60.0,20.0
38952,3,8952,[211 111 603 294   4],297,2,38407,4.289846978666369,0.0,0.0
38953,3,8953,[ 64 318 313 301  11],345,5,38412,4.2899262899262895,60.0,20.0
38954,3,8954,[ 64 318 313 301  11],416,5,38417,4.2900055834729205,60.0,20.0
38955,3,8955,[ 64 318 313 301  11],43,5,38422,4.290084859312193,60.0,20.0
38956,3,8956,[234 403   4 238 313],345,4,38426,4.290052472926203,20.0,20.0
38957,3,8957,[202 238 678 183  70],416,4,38430,4.290020093770931,0.0,0.0
38958,3,8958,[197 655 496 276 265],618,3,38433,4.289876102243554,0.0,0.0
38959,3,8959,[172 202 269 678 288],345,2,38435,4.289620535714286,0.0,20.0
38960,3,8960,[ 64 318 313 301  11],43,5,38440,4.28969981028903,60.0,20.0
38961,3,8961,[ 64 318 313 301  11],345,5,38445,4.289779067172506,60.0,20.0
38962,3,8962,[ 64 318 313 301  11],43,5,38450,4.289858306370635,60.0,20.0
38963,3,8963,[ 28 172  12 135 273],618,5,38455,4.289937527889335,20.0,0.0
38964,3,8964,[ 64 318 313 301  11],345,5,38460,4.290016731734523,60.0,20.0
38965,3,8965,[ 64 318 313 301  11],345,5,38465,4.2900959179121125,60.0,20.0
38966,3,8966,[210 125 215 423 211],416,5,38470,4.290175086428014,0.0,0.0
38967,3,8967,[ 64 318 313 301  11],345,5,38475,4.290254237288136,60.0,20.0
38968,3,8968,[ 64 318 313 301  11],345,5,38480,4.2903333704983835,60.0,20.0
38969,3,8969,[ 64 318 313 301  11],43,5,38485,4.29041248606466,60.0,20.0
38970,3,8970,[ 98 204 216 197  96],805,3,38488,4.290268643406532,0.0,20.0
38971,3,8971,[ 64 318 313 301  11],43,5,38493,4.2903477485510475,60.0,20.0
38972,3,8972,[ 79 275 403 302 100],416,5,38498,4.290426836063747,0.0,0.0
38973,3,8973,[ 64 318 313 301  11],345,5,38503,4.290505905950524,60.0,20.0
38974,3,8974,[269 322  50 196 118],805,2,38505,4.2902506963788305,0.0,20.0
38975,3,8975,[655  25 475 143 273],416,4,38509,4.290218360071301,0.0,0.0
38976,3,8976,[  8 204 318 180 427],711,4,38513,4.290186030968029,20.0,0.0
38977,3,8977,[427 568 289  11 405],416,4,38517,4.290153709066607,0.0,0.0
38978,3,8978,[ 64 318 313 301  11],43,5,38522,4.290232765341352,60.0,20.0
38979,3,8979,[ 64 318 313 301  11],345,5,38527,4.290311804008908,60.0,20.0
38980,3,8980,[276   8 238  64 294],416,4,38531,4.2902794788999,20.0,0.0
38981,3,8981,[ 64 318 313 301  11],416,5,38536,4.290358494767313,60.0,20.0
38982,3,8982,[118 216 135 210  82],198,3,38539,4.290214850272737,0.0,0.0
38983,3,8983,[ 64 318 313 301  11],43,5,38544,4.290293855743544,60.0,20.0
38984,3,8984,[748  15 111 323 237],416,3,38547,4.290150250417362,0.0,0.0
38985,3,8985,[197  98 405  56 143],345,5,38552,4.290229245492989,0.0,20.0
38986,3,8986,[151 597 182 237 471],618,3,38555,4.290085679314566,0.0,0.0
38987,3,8987,[ 64 318 313 301  11],345,5,38560,4.29016466399644,60.0,20.0
38988,3,8988,[ 64 318 313 301  11],345,5,38565,4.290243631104683,60.0,20.0
38989,3,8989,[ 64 318 313 301  11],345,5,38570,4.290322580645161,60.0,20.0
38990,3,8990,[237 111 655 117 182],416,4,38574,4.29029029029029,0.0,0.0
38991,3,8991,[ 64 318 313 301  11],43,5,38579,4.29036921708185,60.0,20.0
38992,3,8992,[ 64 318 313 301  11],345,5,38584,4.290448126320472,60.0,20.0
38993,3,8993,[ 64 318 313 301  11],416,5,38589,4.290527018012008,60.0,20.0
38994,3,8994,[111  12 496 237   1],588,2,38591,4.290272373540856,20.0,0.0
38995,3,8995,[ 64 318 313 301  11],416,5,38596,4.29035126722988,60.0,20.0
38996,3,8996,[ 15 111  97 322 153],416,4,38600,4.2903189952206295,0.0,0.0
38997,3,8997,[ 64 318 313 301  11],416,5,38605,4.290397866192487,60.0,20.0
38998,3,8998,[257 181  50  25 153],416,4,38609,4.290365596177353,0.0,40.0
38999,3,8999,[ 64 318 313 301  11],416,5,38614,4.290444444444445,60.0,20.0
39000,3,9000,[ 64 318 313 301  11],43,5,38619,4.290523275191646,60.0,20.0
39001,3,9001,[ 64 318 313 301  11],416,5,38624,4.290602088424794,60.0,20.0
39002,3,9002,[127 288 161 508 678],38,3,38627,4.290458735976896,0.0,20.0
39003,3,9003,[ 64 318 313 301  11],416,5,38632,4.290537538871613,60.0,20.0
39004,3,9004,[323 168 294 471 132],416,4,38636,4.290505274847307,0.0,0.0
39005,3,9005,[294  79   1 268 302],297,2,38638,4.290250943815234,0.0,0.0
39006,3,9006,[ 64 318 313 301  11],43,5,38643,4.290329743532808,60.0,20.0
39007,3,9007,[403 423 143 282 265],618,4,38647,4.290297513321492,0.0,0.0
39008,3,9008,[202 183 403 568   7],417,3,38650,4.29015429015429,0.0,0.0
39009,3,9009,[ 64 318 313 301  11],345,5,38655,4.29023307436182,60.0,20.0
39010,3,9010,[135  95 568 234 228],417,2,38657,4.28997891465986,0.0,0.0
39011,3,9011,[ 64 318 313 301  11],43,5,38662,4.29005770084332,60.0,20.0
39012,3,9012,[ 64 318 313 301  11],345,5,38667,4.290136469543992,60.0,20.0
39013,3,9013,[172  50 127 423  25],805,3,38670,4.289993343687597,0.0,20.0
39014,3,9014,[ 64 318 313 301  11],345,5,38675,4.290072102052135,60.0,20.0
39015,3,9015,[ 64 318 313 301  11],43,5,38680,4.290150842945874,60.0,20.0
39016,3,9016,[ 64 318 313 301  11],416,5,38685,4.2902295663746255,60.0,20.0
39017,3,9017,[197  70 216  22  28],721,4,38689,4.290197383011754,0.0,0.0
39018,3,9018,[ 64 318 313 301  11],43,5,38694,4.2902760838230405,60.0,20.0
39019,3,9019,[ 50 748 143 175 323],198,1,38695,4.289911308203991,0.0,20.0
39020,3,9020,[ 64 318 313 301  11],43,5,38700,4.289990023279016,60.0,20.0
39021,3,9021,[ 64 318 313 301  11],43,5,38705,4.290068720904456,60.0,20.0
39022,3,9022,[ 64 318 313 301  11],43,5,38710,4.290147401086113,60.0,20.0
39023,3,9023,[ 64 318 313 301  11],43,5,38715,4.290226063829787,60.0,20.0
39024,3,9024,[100 238 294 210  88],43,4,38719,4.2901939058171745,0.0,0.0
39025,3,9025,[ 98  12 175 172 234],805,5,38724,4.290272545978285,20.0,20.0
39026,3,9026,[ 64 318 313 301  11],345,5,38729,4.290351168716074,60.0,20.0
39027,3,9027,[ 64 318 313 301  11],416,5,38734,4.2904297740363315,60.0,20.0
39028,3,9028,[ 64 318 313 301  11],416,5,38739,4.290508361944845,60.0,20.0
39029,3,9029,[568  69 328   4 289],43,5,38744,4.290586932447398,0.0,0.0
39030,3,9030,[ 64 318 313 301  11],345,5,38749,4.290665485549773,60.0,20.0
39031,3,9031,[191 405 202 200  64],417,4,38753,4.29063330380868,20.0,0.0
39032,3,9032,[  1 197  50 357 588],297,3,38756,4.290490424000885,0.0,20.0
39033,3,9033,[237 204  98   4  95],43,5,38761,4.290568961700243,0.0,20.0
39034,3,9034,[181  50 176 168 195],416,5,38766,4.290647482014388,0.0,40.0
39035,3,9035,[ 64 318 313 301  11],416,5,38771,4.290725984949092,60.0,20.0
39036,3,9036,[ 64 318 313 301  11],43,5,38776,4.290804470510125,60.0,20.0
39037,3,9037,[  7 182 276 125 228],230,2,38778,4.290551006859925,0.0,0.0
39038,3,9038,[ 64 318 313 301  11],345,5,38783,4.290629494413099,60.0,20.0
39039,3,9039,[ 64 318 313 301  11],345,5,38788,4.29070796460177,60.0,20.0
39040,3,9040,[ 64 318 313 301  11],345,5,38793,4.2907864174317,60.0,20.0
39041,3,9041,[ 64 318 313 301  11],345,5,38798,4.290864852908649,60.0,20.0
39042,3,9042,[427   1 175 323 100],198,2,38800,4.29061152272476,0.0,0.0
39043,3,9043,[742 655  56 235 275],62,3,38803,4.29046881910659,0.0,0.0
39044,3,9044,[ 64 318 313 301  11],416,5,38808,4.290547263681592,60.0,20.0
39045,3,9045,[127   7  95 144 117],505,2,38810,4.2902940526199425,0.0,0.0
39046,3,9046,[179 385 181 678 269],805,3,38813,4.290151431413729,0.0,20.0
39047,3,9047,[179 257  15 228 427],601,3,38816,4.29000884173298,0.0,0.0
39048,3,9048,[ 11 234 597 117 125],417,4,38820,4.289976793015803,0.0,0.0
39049,3,9049,[ 64 318 313 301  11],43,5,38825,4.290055248618785,60.0,20.0
39050,3,9050,[127  50 135 151 125],62,5,38830,4.290133686885427,0.0,20.0
39051,3,9051,[ 64 318 313 301  11],416,5,38835,4.290212107821476,60.0,20.0
39052,3,9052,[ 56 179 173  98 168],805,5,38840,4.290290511432675,0.0,20.0
39053,3,9053,[238 194 204 286 118],297,2,38842,4.290037552463,0.0,0.0
39054,3,9054,[ 64 318 313 301  11],416,5,38847,4.290115958034235,60.0,20.0
39055,3,9055,[238 172  82 202  79],373,3,38850,4.289973498233215,0.0,0.0
39056,3,9056,[ 64 318 313 301  11],416,5,38855,4.29005189356299,60.0,20.0
39057,3,9057,[235 294 202  95 185],805,1,38856,4.289688672996246,0.0,0.0
39058,3,9058,[135 168  96 183 117],805,4,38860,4.289656694999448,0.0,0.0
39059,3,9059,[ 64 318 313 301  11],416,5,38865,4.289735099337748,60.0,20.0
39060,3,9060,[ 64 318 313 301  11],345,5,38870,4.289813486370158,60.0,20.0
39061,3,9061,[ 56 144 210 222 195],417,2,38872,4.289560803354668,0.0,0.0
39062,3,9062,[ 64 318 313 301  11],345,5,38877,4.289639192320424,60.0,20.0
39063,3,9063,[276 405  71 172 268],654,2,38879,4.289386584289497,0.0,0.0
39064,3,9064,[ 64 318 313 301  11],345,5,38884,4.289464975179261,60.0,20.0
39065,3,9065,[ 50 288  28 333   9],345,2,38886,4.289212442091331,0.0,40.0
39066,3,9066,[ 28  22 603 423 568],805,1,38887,4.2888496746443145,0.0,0.0
39067,3,9067,[200 197 194 273 121],854,3,38890,4.288707543008381,0.0,0.0
39068,3,9068,[ 64 318 313 301  11],416,5,38895,4.2887859741978165,60.0,20.0
39069,3,9069,[ 64 318 313 301  11],416,5,38900,4.288864388092613,60.0,20.0
39070,3,9070,[ 64 318 313 301  11],43,5,38905,4.28894278469849,60.0,20.0
39071,3,9071,[ 64 318 313 301  11],416,5,38910,4.289021164021164,60.0,20.0
39072,3,9072,[ 64 318 313 301  11],345,5,38915,4.289099526066351,60.0,20.0
39073,3,9073,[ 64 318 313 301  11],416,5,38920,4.289177870839762,60.0,20.0
39074,3,9074,[ 64 318 313 301  11],416,5,38925,4.289256198347108,60.0,20.0
39075,3,9075,[ 64 318 313 301  11],43,5,38930,4.289334508594094,60.0,20.0
39076,3,9076,[182  56 234 515 187],405,3,38933,4.2891924644706405,0.0,0.0
39077,3,9077,[ 64 318 313 301  11],416,5,38938,4.289270764485569,60.0,20.0
39078,3,9078,[ 64 318 313 301  11],43,5,38943,4.2893490472519,60.0,20.0
39079,3,9079,[ 64 318 313 301  11],416,5,38948,4.28942731277533,60.0,20.0
39080,3,9080,[ 64 318 313 301  11],43,5,38953,4.289505561061557,60.0,20.0
39081,3,9081,[ 64 318 313 301  11],416,5,38958,4.289583792116274,60.0,20.0
39082,3,9082,[ 64 318 313 301  11],416,5,38963,4.289662005945172,60.0,20.0
39083,3,9083,[ 64 318 313 301  11],416,5,38968,4.289740202553941,60.0,20.0
39084,3,9084,[588 405 121 204 111],416,5,38973,4.289818381948266,0.0,0.0
39085,3,9085,[275 216 117 273 655],416,5,38978,4.289896544133832,0.0,0.0
39086,3,9086,[ 64 318 313 301  11],416,5,38983,4.28997468911632,60.0,20.0
39087,3,9087,[ 64 318 313 301  11],416,5,38988,4.290052816901408,60.0,20.0
39088,3,9088,[ 22 655 423 143  15],262,3,38991,4.28991088128507,0.0,0.0
39089,3,9089,[ 64 318 313 301  11],345,5,38996,4.28998899889989,60.0,20.0
39090,3,9090,[ 64 318 313 301  11],416,5,39001,4.290067099329007,60.0,20.0
39091,3,9091,[ 64 318 313 301  11],43,5,39006,4.29014518257809,60.0,20.0
39092,3,9092,[215 181 151  22   8],711,4,39010,4.290113273946992,0.0,20.0
39093,3,9093,[111 181  88 197 185],618,3,39013,4.289971409720695,0.0,20.0
39094,3,9094,[288 200 515 238 475],416,4,39017,4.289939527212754,0.0,20.0
39095,3,9095,[ 64 318 313 301  11],416,5,39022,4.290017590149517,60.0,20.0
39096,3,9096,[546 216 385  25 151],416,3,39025,4.289875783225239,0.0,0.0
39097,3,9097,[  1 215 238  64 161],198,4,39029,4.289843921741042,20.0,0.0
39098,3,9098,[ 64 318 313 301  11],43,5,39034,4.289921969447192,60.0,20.0
39099,3,9099,[ 64 318 313 301  11],345,5,39039,4.29,60.0,20.0
39100,3,9100,[245  64 197 191  82],721,3,39042,4.289858257334359,20.0,0.0
39101,3,9101,[ 64 318 313 301  11],43,5,39047,4.289936277741155,60.0,20.0
39102,3,9102,[301 173 125 435 197],721,4,39051,4.289904427111941,0.0,0.0
39103,3,9103,[ 79  70 328   7 238],43,4,39055,4.289872583479789,0.0,0.0
39104,3,9104,[257 211 100 117 323],416,3,39058,4.289730917078528,0.0,0.0
39105,3,9105,[597  70  25 678 268],416,3,39061,4.2895892817922245,0.0,0.0
39106,3,9106,[  8  11 238 222 151],854,5,39066,4.28966728889865,0.0,0.0
39107,3,9107,[100   1 269  22 546],654,4,39070,4.2896354852876595,0.0,0.0
39108,3,9108,[ 64 318 313 301  11],416,5,39075,4.289713470194314,60.0,20.0
39109,3,9109,[ 64 318 313 301  11],345,5,39080,4.2897914379802415,60.0,20.0
39110,3,9110,[ 64 318 313 301  11],43,5,39085,4.2898693886510815,60.0,20.0
39111,3,9111,[ 64 318 313 301  11],43,5,39090,4.289947322212467,60.0,20.0
39112,3,9112,[ 64 318 313 301  11],416,5,39095,4.290025238670032,60.0,20.0
39113,3,9113,[ 64 318 313 301  11],416,5,39100,4.290103138029405,60.0,20.0
39114,3,9114,[ 64 318 313 301  11],43,5,39105,4.290181020296215,60.0,20.0
39115,3,9115,[ 64 318 313 301  11],43,5,39110,4.290258885476086,60.0,20.0
39116,3,9116,[135 153 483 235 183],62,5,39115,4.290336733574641,20.0,0.0
39117,3,9117,[ 64 318 313 301  11],345,5,39120,4.2904145645975,60.0,20.0
39118,3,9118,[ 64 318 313 301  11],416,5,39125,4.2904923785502795,60.0,20.0
39119,3,9119,[ 64 318 313 301  11],416,5,39130,4.290570175438597,60.0,20.0
39120,3,9120,[ 64 318 313 301  11],43,5,39135,4.290647955268063,60.0,20.0
39121,3,9121,[100 245 237 238 742],62,2,39137,4.290396842797632,0.0,0.0
39122,3,9122,[265 174   9 742  71],416,5,39142,4.290474624575249,0.0,0.0
39123,3,9123,[ 64 318 313 301  11],43,5,39147,4.290552389302937,60.0,20.0
39124,3,9124,[118 568 161 322 222],417,1,39148,4.290191780821917,0.0,0.0
39125,3,9125,[173 191 187 318  50],618,4,39152,4.290159982467674,20.0,20.0
39126,3,9126,[179 183 181 176   4],416,4,39156,4.290128191081407,0.0,20.0
39127,3,9127,[238  79  98  64 655],416,5,39161,4.290205959684488,20.0,20.0
39128,3,9128,[ 64 318 313 301  11],416,5,39166,4.290283711249863,60.0,20.0
39129,3,9129,[197 117 168  22 185],618,4,39170,4.290251916757941,0.0,0.0
39130,3,9130,[597 742  97 143 405],43,4,39174,4.290220129230096,0.0,0.0
39131,3,9131,[174 423 357 210 318],373,4,39178,4.290188348664039,20.0,0.0
39132,3,9132,[405  11 176 181 294],417,3,39181,4.290047082010292,0.0,20.0
39133,3,9133,[ 64 318 313 301  11],345,5,39186,4.290124808408145,60.0,20.0
39134,3,9134,[182 121  25  11 181],198,3,39189,4.289983579638752,0.0,20.0
39135,3,9135,[ 64 318 313 301  11],43,5,39194,4.290061295971979,60.0,20.0
39136,3,9136,[423 228 168 204 216],805,1,39195,4.289701214840758,0.0,0.0
39137,3,9137,[ 64 318 313 301  11],416,5,39200,4.289778945064565,60.0,20.0
39138,3,9138,[ 64 318 313 301  11],416,5,39205,4.289856658277711,60.0,20.0
39139,3,9139,[197  56 161  71 182],128,4,39209,4.289824945295405,0.0,0.0
39140,3,9140,[ 64 318 313 301  11],416,5,39214,4.289902636473034,60.0,20.0
39141,3,9141,[185 546 111 191 597],416,3,39217,4.289761540144388,0.0,0.0
39142,3,9142,[127 742 257  96 216],417,1,39218,4.289401728097999,0.0,0.0
39143,3,9143,[210 475 186 222   1],417,3,39221,4.289260717410324,0.0,0.0
39144,3,9144,[ 64 318 313 301  11],416,5,39226,4.289338436303991,60.0,20.0
39145,3,9145,[357  25 211 183  89],417,4,39230,4.289306800787229,0.0,0.0
39146,3,9146,[ 88 475 423 144 655],416,3,39233,4.289165846725703,0.0,0.0
39147,3,9147,[496 234 135 568  97],230,3,39236,4.289024923480542,0.0,0.0
39148,3,9148,[ 79 385  89 655 168],805,3,39239,4.288884031041644,0.0,0.0
39149,3,9149,[195 245 151 235 216],297,1,39240,4.288524590163934,0.0,0.0
39150,3,9150,[ 64 318 313 301  11],43,5,39245,4.288602338542236,60.0,20.0
39151,3,9151,[483 318 135 655 385],618,5,39250,4.28868006993007,40.0,0.0
39152,3,9152,[568  69  79 100  98],214,4,39254,4.288648530536436,0.0,20.0
39153,3,9153,[200 202  82 423 471],618,3,39257,4.288507756172165,0.0,0.0
39154,3,9154,[ 64 318 313 301  11],416,5,39262,4.2885854724194425,60.0,20.0
39155,3,9155,[ 64 318 313 301  11],43,5,39267,4.288663171690694,60.0,20.0
39156,3,9156,[185 121  12 191 144],618,5,39272,4.288740853991482,20.0,0.0
39157,3,9157,[ 64 318 313 301  11],43,5,39277,4.288818519327364,60.0,20.0
39158,3,9158,[153 234 288 176  28],297,3,39280,4.288677803253631,0.0,20.0
39159,3,9159,[318 132 273 588 200],416,5,39285,4.288755458515284,20.0,0.0
39160,3,9160,[ 64 318 313 301  11],345,5,39290,4.288833096823491,60.0,20.0
39161,3,9161,[ 64 318 313 301  11],43,5,39295,4.288910718183803,60.0,20.0
39162,3,9162,[ 64 318 313 301  11],43,5,39300,4.288988322601768,60.0,20.0
39163,3,9163,[ 56 183 204 748 300],297,2,39302,4.288738542121345,0.0,0.0
39164,3,9164,[322 269 289 204 282],416,3,39305,4.288597926895799,0.0,0.0
39165,3,9165,[ 64 318 313 301  11],43,5,39310,4.288675540039276,60.0,20.0
39166,3,9166,[ 96 427   7 655 100],618,4,39314,4.2886440493072975,0.0,0.0
39167,3,9167,[153 111 268 210 597],417,2,39316,4.288394415357766,0.0,0.0
39168,3,9168,[ 64 318 313 301  11],43,5,39321,4.28847202530265,60.0,20.0
39169,3,9169,[100 423  96 228 191],373,3,39324,4.288331515812432,0.0,0.0
39170,3,9170,[423 300 175 508 302],297,3,39327,4.288191036964344,0.0,0.0
39171,3,9171,[ 64 318 313 301  11],416,5,39332,4.288268643698212,60.0,20.0
39172,3,9172,[194 313 405 143 301],416,5,39337,4.288346233511392,20.0,20.0
39173,3,9173,[ 64 318 313 301  11],345,5,39342,4.288423806409418,60.0,20.0
39174,3,9174,[ 64 318 313 301  11],345,5,39347,4.28850136239782,60.0,20.0
39175,3,9175,[ 64 318 313 301  11],43,5,39352,4.288578901482127,60.0,20.0
39176,3,9176,[245 211  15  64 132],417,5,39357,4.288656423667866,20.0,0.0
39177,3,9177,[ 64 318 313 301  11],43,5,39362,4.288733928960558,60.0,20.0
39178,3,9178,[ 64 318 313 301  11],345,5,39367,4.288811417365726,60.0,20.0
39179,3,9179,[ 64 318 313 301  11],43,5,39372,4.288888888888889,60.0,20.0
39180,3,9180,[ 64 318 313 301  11],345,5,39377,4.288966343535563,60.0,20.0
39181,3,9181,[ 64 318 313 301  11],345,5,39382,4.289043781311261,60.0,20.0
39182,3,9182,[ 64 318 313 301  11],43,5,39387,4.289121202221496,60.0,20.0
39183,3,9183,[ 64 318 313 301  11],416,5,39392,4.289198606271777,60.0,20.0
39184,3,9184,[153 257   9  79 475],416,3,39395,4.289058247142079,0.0,0.0
39185,3,9185,[ 64 318 313 301  11],43,5,39400,4.28913564119312,60.0,20.0
39186,3,9186,[ 64 318 313 301  11],345,5,39405,4.289213018395559,60.0,20.0
39187,3,9187,[ 22 496 237 286 289],588,2,39407,4.288963865912059,0.0,0.0
39188,3,9188,[ 64 318 313 301  11],43,5,39412,4.289041244966808,60.0,20.0
39189,3,9189,[111 323 172 211 268],416,4,39416,4.289009793253537,0.0,0.0
39190,3,9190,[ 64 318 313 301  11],345,5,39421,4.289087150473289,60.0,20.0
39191,3,9191,[322 742 235 100  56],854,2,39423,4.2888381201044385,0.0,0.0
39192,3,9192,[ 64 318 313 301  11],43,5,39428,4.288915479168933,60.0,20.0
39193,3,9193,[ 64 318 313 301  11],345,5,39433,4.288992821405264,60.0,20.0
39194,3,9194,[ 64 318 313 301  11],345,5,39438,4.289070146818923,60.0,20.0
39195,3,9195,[ 64 318 313 301  11],43,5,39443,4.289147455415398,60.0,20.0
39196,3,9196,[100  70 174 496 181],437,4,39447,4.289116016092204,0.0,20.0
39197,3,9197,[ 64 318 313 301  11],416,5,39452,4.289193302891933,60.0,20.0
39198,3,9198,[276  12 151  79 132],618,3,39455,4.289053157951951,20.0,0.0
39199,3,9199,[257 143 202  97   1],642,4,39459,4.289021739130435,0.0,0.0
39200,3,9200,[153 471  70  98 508],297,4,39463,4.288990327138355,0.0,20.0
39201,3,9201,[742  56 323 174 245],764,3,39466,4.288850249945664,0.0,0.0
39202,3,9202,[294 257  22 234 588],416,4,39470,4.288818863414104,0.0,0.0
39203,3,9203,[235 204 202 197  25],345,2,39472,4.288570186875272,0.0,0.0
39204,3,9204,[ 64 318 313 301  11],416,5,39477,4.288647474198805,60.0,20.0
39205,3,9205,[ 64 318 313 301  11],416,5,39482,4.288724744731697,60.0,20.0
39206,3,9206,[ 64 318 313 301  11],416,5,39487,4.288801998479418,60.0,20.0
39207,3,9207,[ 64 318 313 301  11],43,5,39492,4.288879235447437,60.0,20.0
39208,3,9208,[ 64 318 313 301  11],416,5,39497,4.2889564556412205,60.0,20.0
39209,3,9209,[185  79  22   7 196],618,5,39502,4.289033659066233,0.0,0.0
39210,3,9210,[ 25 176 172 132 568],230,3,39505,4.288893714037564,0.0,0.0
39211,3,9211,[ 64 318 313 301  11],345,5,39510,4.288970907511941,60.0,20.0
39212,3,9212,[ 64 318 313 301  11],43,5,39515,4.289048084228807,60.0,20.0
39213,3,9213,[403 172 191 210  98],922,2,39517,4.2887996527024095,0.0,20.0
39214,3,9214,[176 111  22 471 151],618,2,39519,4.288551275094954,0.0,0.0
39215,3,9215,[258 475 271 200 471],854,4,39523,4.288519965277778,0.0,0.0
39216,3,9216,[ 64 318 313 301  11],345,5,39528,4.288597157426494,60.0,20.0
39217,3,9217,[ 82 276 151  22 483],618,3,39531,4.288457366022999,20.0,0.0
39218,3,9218,[ 64 318 313 301  11],345,5,39536,4.288534548215641,60.0,20.0
39219,3,9219,[333  82 194 235 176],416,4,39540,4.288503253796096,0.0,0.0
39220,3,9220,[153  56  82 237 216],416,4,39544,4.288471966164191,0.0,0.0
39221,3,9221,[ 79 655 179 276 275],128,3,39547,4.288332248969855,0.0,0.0
39222,3,9222,[ 64 318 313 301  11],416,5,39552,4.288409411254473,60.0,20.0
39223,3,9223,[173  11 216  69 179],214,4,39556,4.288378143972246,0.0,0.0
39224,3,9224,[ 64 318 313 301  11],345,5,39561,4.288455284552845,60.0,20.0
39225,3,9225,[ 64 318 313 301  11],345,5,39566,4.288532408411013,60.0,20.0
39226,3,9226,[ 64 318 313 301  11],345,5,39571,4.288609515552184,60.0,20.0
39227,3,9227,[427 143 111  82 423],128,4,39575,4.288578240138708,0.0,0.0
39228,3,9228,[174   4 235 125 286],416,4,39579,4.288546971502871,0.0,0.0
39229,3,9229,[ 64 318 313 301  11],416,5,39584,4.288624052004334,60.0,20.0
39230,3,9230,[ 64 318 313 301  11],345,5,39589,4.288701115805438,60.0,20.0
39231,3,9231,[176 132 257 405 174],854,2,39591,4.2884532062391685,0.0,0.0
39232,3,9232,[ 64 318 313 301  11],416,5,39596,4.288530271850969,60.0,20.0
39233,3,9233,[ 64 318 313 301  11],345,5,39601,4.288607320771064,60.0,20.0
39234,3,9234,[ 64 318 313 301  11],43,5,39606,4.288684353004872,60.0,20.0
39235,3,9235,[174 385 588  88 222],805,1,39607,4.28832828064097,0.0,0.0
39236,3,9236,[ 64 318 313 301  11],43,5,39612,4.288405326404677,60.0,20.0
39237,3,9237,[ 64 318 313 301  11],416,5,39617,4.288482355488201,60.0,20.0
39238,3,9238,[ 79 286 357  96  15],417,3,39620,4.288342894252625,0.0,0.0
39239,3,9239,[ 64 318 313 301  11],43,5,39625,4.288419913419913,60.0,20.0
39240,3,9240,[ 64 318 313 301  11],416,5,39630,4.2884969159181905,60.0,20.0
39241,3,9241,[127 143 603 125 172],416,5,39635,4.2885739017528675,0.0,0.0
39242,3,9242,[ 64 318 313 301  11],416,5,39640,4.288650870929352,60.0,20.0
39243,3,9243,[173 282 153 748 678],654,4,39644,4.288619645175249,0.0,0.0
39244,3,9244,[ 69  70  25 161 568],128,3,39647,4.288480259599783,0.0,0.0
39245,3,9245,[ 64 318 313 301  11],416,5,39652,4.288557213930348,60.0,20.0
39246,3,9246,[748  56  97   9 568],416,5,39657,4.2886341516167406,0.0,0.0
39247,3,9247,[ 64 318 313 301  11],345,5,39662,4.28871107266436,60.0,20.0
39248,3,9248,[ 64 318 313 301  11],345,5,39667,4.288787977078603,60.0,20.0
39249,3,9249,[  1 238   7 176 135],62,4,39671,4.288756756756757,0.0,0.0
39250,3,9250,[ 64 318 313 301  11],43,5,39676,4.288833639606529,60.0,20.0
39251,3,9251,[ 64 318 313 301  11],416,5,39681,4.288910505836576,60.0,20.0
39252,3,9252,[153 179 172 191 111],721,4,39685,4.288879282394899,0.0,0.0
39253,3,9253,[215 196 176 210 423],618,4,39689,4.288848065701318,0.0,0.0
39254,3,9254,[ 64 318 313 301  11],43,5,39694,4.28892490545651,60.0,20.0
39255,3,9255,[ 64 318 313 301  11],43,5,39699,4.28900172860847,60.0,20.0
39256,3,9256,[ 89   4 568 276  15],62,3,39702,4.288862482445717,0.0,0.0
39257,3,9257,[ 82 294  28 173 211],416,5,39707,4.288939295744221,0.0,0.0
39258,3,9258,[ 71  79 121  25 405],198,0,39707,4.288476077330166,0.0,0.0
39259,3,9259,[ 28 748 258 568 173],654,5,39712,4.288552915766739,0.0,0.0
39260,3,9260,[ 88  70 121  28  12],618,4,39716,4.288521757909513,20.0,0.0
39261,3,9261,[  7 678  22 258 168],416,4,39720,4.288490606780393,0.0,0.0
39262,3,9262,[ 12 385 143  70 257],43,5,39725,4.2885674187628195,20.0,0.0
39263,3,9263,[ 64 318 313 301  11],345,5,39730,4.288644214162349,60.0,20.0
39264,3,9264,[ 64 318 313 301  11],345,5,39735,4.2887209929843495,60.0,20.0
39265,3,9265,[125 117 238 202  50],230,4,39739,4.2886898338009924,0.0,20.0
39266,3,9266,[111 153 222 423 294],297,2,39741,4.288442861767562,0.0,0.0
39267,3,9267,[ 64 318 313 301  11],416,5,39746,4.288519637462236,60.0,20.0
39268,3,9268,[ 56 238  97  15 234],618,3,39749,4.28838062358399,0.0,0.0
39269,3,9269,[ 64 318 313 301  11],345,5,39754,4.288457389428263,60.0,20.0
39270,3,9270,[ 64 318 313 301  11],345,5,39759,4.288534138712113,60.0,20.0
39271,3,9271,[655 195 100  82  11],417,4,39763,4.288503019844693,0.0,0.0
39272,3,9272,[ 64 318 313 301  11],345,5,39768,4.288579747654481,60.0,20.0
39273,3,9273,[200 294 121  11 172],416,5,39773,4.288656458917403,0.0,0.0
39274,3,9274,[216  70  22  98 127],630,2,39775,4.288409703504043,0.0,20.0
39275,3,9275,[ 64 318 313 301  11],416,5,39780,4.288486416558862,60.0,20.0
39276,3,9276,[ 69 181 135 588 238],437,3,39783,4.2883475261399155,0.0,20.0
39277,3,9277,[ 64 318 313 301  11],416,5,39788,4.288424229359776,60.0,20.0
39278,3,9278,[ 64 318 313 301  11],416,5,39793,4.288500916046988,60.0,20.0
39279,3,9279,[288  97 216 546 269],297,3,39796,4.288362068965517,0.0,20.0
39280,3,9280,[ 64 318 313 301  11],345,5,39801,4.288438745824803,60.0,20.0
39281,3,9281,[173 151  88 125  56],345,4,39805,4.288407670760612,0.0,0.0
39282,3,9282,[ 64 318 313 301  11],43,5,39810,4.288484326187655,60.0,20.0
39283,3,9283,[174 275 588 194 282],297,3,39813,4.288345540715209,0.0,0.0
39284,3,9284,[ 64 318 313 301  11],416,5,39818,4.288422186322025,60.0,20.0
39285,3,9285,[ 28 678 333  69 748],345,1,39819,4.288068059444325,0.0,0.0
39286,3,9286,[357 678  64 333 258],721,2,39821,4.287821686228061,20.0,0.0
39287,3,9287,[ 64 318 313 301  11],345,5,39826,4.2878983634797585,60.0,20.0
39288,3,9288,[153  79   9  97  71],24,5,39831,4.287975024222198,0.0,0.0
39289,3,9289,[100 176 269 127  88],416,4,39835,4.28794402583423,0.0,0.0
39290,3,9290,[ 64 318 313 301  11],416,5,39840,4.2880206651598325,60.0,20.0
39291,3,9291,[ 64 318 313 301  11],43,5,39845,4.288097287989668,60.0,20.0
39292,3,9292,[ 64 318 313 301  11],43,5,39850,4.288173894329065,60.0,20.0
39293,3,9293,[ 64 318 313 301  11],416,5,39855,4.288250484183344,60.0,20.0
39294,3,9294,[ 12 405 173 174  11],805,2,39857,4.288004303388918,20.0,0.0
39295,3,9295,[153 313  97  70  95],416,4,39861,4.287973321858864,20.0,20.0
39296,3,9296,[ 64 318 313 301  11],43,5,39866,4.288049908572658,60.0,20.0
39297,3,9297,[121 333 125 222 127],854,2,39868,4.287803828780383,0.0,0.0
39298,3,9298,[ 64 318 313 301  11],345,5,39873,4.287880417249166,60.0,20.0
39299,3,9299,[ 64 318 313 301  11],416,5,39878,4.287956989247312,60.0,20.0
39300,3,9300,[  4 313  28 204 196],618,3,39881,4.287818514138265,20.0,20.0
39301,3,9301,[132 144 515 300 597],416,4,39885,4.28778757256504,0.0,0.0
39302,3,9302,[200 111  89   1   4],805,3,39888,4.287649145436956,0.0,0.0
39303,3,9303,[ 64 318 313 301  11],345,5,39893,4.287725709372313,60.0,20.0
39304,3,9304,[273 181 118   7 143],618,4,39897,4.2876947877485225,0.0,20.0
39305,3,9305,[ 22 237 172 423  12],654,5,39902,4.287771330324522,20.0,0.0
39306,3,9306,[ 64 318 313 301  11],345,5,39907,4.2878478564521325,60.0,20.0
39307,3,9307,[ 25 276 742 216 237],654,3,39910,4.287709497206704,0.0,0.0
39308,3,9308,[ 64 318 313 301  11],43,5,39915,4.287786013535288,60.0,20.0
39309,3,9309,[202 323 168 181 111],751,3,39918,4.287647690655209,0.0,20.0
39310,3,9310,[ 64 318 313 301  11],345,5,39923,4.287724197186124,60.0,20.0
39311,3,9311,[ 64 318 313 301  11],416,5,39928,4.287800687285223,60.0,20.0
39312,3,9312,[181  88 197 125  64],416,4,39932,4.287769784172662,20.0,20.0
39313,3,9313,[ 64 318 313 301  11],416,5,39937,4.287846252952544,60.0,20.0
39314,3,9314,[ 89 597 176 151 405],62,3,39940,4.287707997852926,0.0,0.0
39315,3,9315,[183 238 144 191 423],437,3,39943,4.287569772434521,0.0,0.0
39316,3,9316,[191 210  71 471  15],128,5,39948,4.2876462380594615,0.0,0.0
39317,3,9317,[ 64 318 313 301  11],416,5,39953,4.2877226872719465,60.0,20.0
39318,3,9318,[ 98 176 202 100 515],416,5,39958,4.287799120077262,0.0,20.0
39319,3,9319,[ 64 318 313 301  11],416,5,39963,4.287875536480687,60.0,20.0
39320,3,9320,[405 216 323  56   7],43,4,39967,4.287844651861389,0.0,0.0
39321,3,9321,[ 64 318 313 301  11],43,5,39972,4.287921046985625,60.0,20.0
39322,3,9322,[ 64 318 313 301  11],345,5,39977,4.2879974257213345,60.0,20.0
39323,3,9323,[ 64 318 313 301  11],43,5,39982,4.288073788073788,60.0,20.0
39324,3,9324,[ 64 318 313 301  11],43,5,39987,4.288150134048258,60.0,20.0
39325,3,9325,[ 64 318 313 301  11],43,5,39992,4.288226463650011,60.0,20.0
39326,3,9326,[ 64 318 313 301  11],43,5,39997,4.288302776884314,60.0,20.0
39327,3,9327,[ 64 318 313 301  11],416,5,40002,4.288379073756432,60.0,20.0
39328,3,9328,[173 202   1 546 475],805,3,40005,4.288240969021332,0.0,0.0
39329,3,9329,[ 64 318 313 301  11],43,5,40010,4.288317256162915,60.0,20.0
39330,3,9330,[ 64 318 313 301  11],43,5,40015,4.288393526953167,60.0,20.0
39331,3,9331,[ 64 318 313 301  11],345,5,40020,4.2884697813973425,60.0,20.0
39332,3,9332,[ 64 318 313 301  11],416,5,40025,4.288546019500696,60.0,20.0
39333,3,9333,[234 204 288 132 546],416,4,40029,4.288515106063852,0.0,20.0
39334,3,9334,[357 483 475 597  98],854,4,40033,4.288484199250134,20.0,20.0
39335,3,9335,[ 64 318 313 301  11],416,5,40038,4.288560411311054,60.0,20.0
39336,3,9336,[ 15 174 132 301 678],345,4,40042,4.288529506265395,0.0,0.0
39337,3,9337,[ 64 318 313 301  11],416,5,40047,4.288605697151424,60.0,20.0
39338,3,9338,[211 168 121 132 183],437,2,40049,4.28836063818396,0.0,0.0
39339,3,9339,[328 238 216   8 403],62,4,40053,4.2883297644539615,0.0,0.0
39340,3,9340,[ 64 318 313 301  11],416,5,40058,4.288405952253506,60.0,20.0
39341,3,9341,[ 64 318 313 301  11],416,5,40063,4.28848212374224,60.0,20.0
39342,3,9342,[100  22 300  96 588],698,3,40066,4.2883442149202615,0.0,0.0
39343,3,9343,[ 64 318 313 301  11],345,5,40071,4.288420376712328,60.0,20.0
39344,3,9344,[ 64 318 313 301  11],43,5,40076,4.288496522204388,60.0,20.0
39345,3,9345,[ 79 143   1 475 181],588,4,40080,4.288465653755617,0.0,20.0
39346,3,9346,[ 64 318 313 301  11],345,5,40085,4.288541778110623,60.0,20.0
39347,3,9347,[ 64 318 313 301  11],43,5,40090,4.288617886178862,60.0,20.0
39348,3,9348,[216  95 174  89   1],297,3,40093,4.28848005134239,0.0,0.0
39349,3,9349,[ 15 294  64   7  12],43,5,40098,4.28855614973262,40.0,0.0
39350,3,9350,[ 64 318 313 301  11],43,5,40103,4.2886322318468615,60.0,20.0
39351,3,9351,[ 64 318 313 301  11],43,5,40108,4.2887082976903335,60.0,20.0
39352,3,9352,[ 64 318 313 301  11],43,5,40113,4.2887843472682565,60.0,20.0
39353,3,9353,[ 64 318 313 301  11],43,5,40118,4.288860380585846,60.0,20.0
39354,3,9354,[268 172 235 174 200],416,4,40122,4.288829502939604,0.0,0.0
39355,3,9355,[322 328 471   9 678],416,3,40125,4.288691748610518,0.0,0.0
39356,3,9356,[191   8  88 258 151],805,2,40127,4.288447151864914,0.0,0.0
39357,3,9357,[228 211 174 588  96],417,1,40128,4.288095746954477,0.0,0.0
39358,3,9358,[ 64 318 313 301  11],43,5,40133,4.288171813227909,60.0,20.0
39359,3,9359,[405 186 135 286  69],417,2,40135,4.28792735042735,0.0,0.0
39360,3,9360,[ 64 318 313 301  11],345,5,40140,4.288003418438201,60.0,20.0
39361,3,9361,[ 64 318 313 301  11],345,5,40145,4.288079470198675,60.0,20.0
39362,3,9362,[515 235 168 187 200],416,4,40149,4.288048702338994,0.0,0.0
39363,3,9363,[143 117 174 216 181],654,4,40153,4.288017941050833,0.0,20.0
39364,3,9364,[ 64 318 313 301  11],345,5,40158,4.288093966898025,60.0,20.0
39365,3,9365,[ 64 318 313 301  11],416,5,40163,4.288169976510783,60.0,20.0
39366,3,9366,[475  70 273 186 211],417,4,40167,4.288139212127683,0.0,0.0
39367,3,9367,[151 288 300  22 222],654,4,40171,4.288108454312553,0.0,20.0
39368,3,9368,[ 64 318 313 301  11],345,5,40176,4.2881844380403455,60.0,20.0
39369,3,9369,[ 25 153 161   7   9],416,5,40181,4.288260405549626,0.0,0.0
39370,3,9370,[ 64 318 313 301  11],416,5,40186,4.288336356845588,60.0,20.0
39371,3,9371,[ 64 318 313 301  11],345,5,40191,4.288412291933419,60.0,20.0
39372,3,9372,[ 64 318 313 301  11],43,5,40196,4.288488210818308,60.0,20.0
39373,3,9373,[196 748  15 216 294],654,3,40199,4.288350757414124,0.0,0.0
39374,3,9374,[496 423 215 121  56],588,3,40202,4.288213333333333,0.0,0.0
39375,3,9375,[ 64 318 313 301  11],43,5,40207,4.288289249146757,60.0,20.0
39376,3,9376,[ 64 318 313 301  11],416,5,40212,4.288365148768262,60.0,20.0
39377,3,9377,[ 64 318 313 301  11],345,5,40217,4.288441032203028,60.0,20.0
39378,3,9378,[ 64 318 313 301  11],416,5,40222,4.288516899456232,60.0,20.0
39379,3,9379,[ 64 318 313 301  11],43,5,40227,4.2885927505330494,60.0,20.0
39380,3,9380,[ 64 318 313 301  11],345,5,40232,4.288668585438653,60.0,20.0
39381,3,9381,[403 100   4  97 276],62,4,40236,4.288637817096568,0.0,0.0
39382,3,9382,[ 64 318 313 301  11],43,5,40241,4.288713631034851,60.0,20.0
39383,3,9383,[ 64 318 313 301  11],43,5,40246,4.288789428815004,60.0,20.0
39384,3,9384,[111  25 125 300 323],223,1,40247,4.288438998401705,0.0,0.0
39385,3,9385,[ 64 318 313 301  11],416,5,40252,4.288514809290432,60.0,20.0
39386,3,9386,[ 64 318 313 301  11],416,5,40257,4.2885906040268456,60.0,20.0
39387,3,9387,[ 64 318 313 301  11],416,5,40262,4.288666382616106,60.0,20.0
39388,3,9388,[ 64 318 313 301  11],416,5,40267,4.288742145063372,60.0,20.0
39389,3,9389,[ 64 318 313 301  11],416,5,40272,4.288817891373802,60.0,20.0
39390,3,9390,[ 64 318 313 301  11],345,5,40277,4.288893621552551,60.0,20.0
39391,3,9391,[144  82 301 143  98],751,5,40282,4.2889693356047704,0.0,20.0
39392,3,9392,[ 64 318 313 301  11],416,5,40287,4.289045033535611,60.0,20.0
39393,3,9393,[ 64 318 313 301  11],43,5,40292,4.289120715350224,60.0,20.0
39394,3,9394,[ 64 318 313 301  11],345,5,40297,4.289196381053752,60.0,20.0
39395,3,9395,[216  95 405 175 427],198,2,40299,4.288952745849298,0.0,0.0
39396,3,9396,[ 64 318 313 301  11],416,5,40304,4.289028413323401,60.0,20.0
39397,3,9397,[ 64  69 322 100 183],416,4,40308,4.288997659076399,20.0,0.0
39398,3,9398,[ 64 318 313 301  11],345,5,40313,4.289073305670816,60.0,20.0
39399,3,9399,[655 597  69 568 180],887,3,40316,4.288936170212766,0.0,0.0
39400,3,9400,[ 64 318 313 301  11],416,5,40321,4.289011807254547,60.0,20.0
39401,3,9401,[ 64 318 313 301  11],345,5,40326,4.289087428206765,60.0,20.0
39402,3,9402,[ 64 318 313 301  11],345,5,40331,4.2891630330745505,60.0,20.0
39403,3,9403,[ 64 318 313 301  11],416,5,40336,4.289238621863037,60.0,20.0
39404,3,9404,[435 427 127 176 153],698,2,40338,4.2889952153110045,0.0,0.0
39405,3,9405,[210  89 144 182 117],297,3,40341,4.2888581756325745,0.0,0.0
39406,3,9406,[ 64 318 313 301  11],345,5,40346,4.288933772722441,60.0,20.0
39407,3,9407,[  8 238 288 568 301],416,5,40351,4.289009353741497,0.0,20.0
39408,3,9408,[ 64 318 313 301  11],416,5,40356,4.289084918694867,60.0,20.0
39409,3,9409,[ 64 318 313 301  11],345,5,40361,4.289160467587672,60.0,20.0
39410,3,9410,[ 64 318 313 301  11],345,5,40366,4.289236000425035,60.0,20.0
39411,3,9411,[ 64 318 313 301  11],416,5,40371,4.289311517212069,60.0,20.0
39412,3,9412,[313  69 588 318 132],588,4,40375,4.289280781897376,40.0,20.0
39413,3,9413,[ 64 318 313 301  11],416,5,40380,4.289356277884003,60.0,20.0
39414,3,9414,[ 64 318 313 301  11],345,5,40385,4.289431757833245,60.0,20.0
39415,3,9415,[151  12 471  82 403],588,4,40389,4.289401019541207,20.0,0.0
39416,3,9416,[181 100 183  69 174],601,4,40393,4.289370287777424,0.0,20.0
39417,3,9417,[655 172  56 204 173],62,3,40396,4.28923338288384,0.0,0.0
39418,3,9418,[275 276 168 238 742],62,4,40400,4.289202675443253,0.0,0.0
39419,3,9419,[273  15 742 118  11],764,2,40402,4.28895966029724,0.0,0.0
39420,3,9420,[173 655 403 185  98],711,4,40406,4.288928988430103,0.0,20.0
39421,3,9421,[245 235 132  50 597],62,3,40409,4.2887921884950115,0.0,20.0
39422,3,9422,[ 64 318 313 301  11],416,5,40414,4.2888676642258305,60.0,20.0
39423,3,9423,[174 302 215 172  69],654,5,40419,4.288943123938879,0.0,0.0
39424,3,9424,[ 64 318 313 301  11],43,5,40424,4.289018567639257,60.0,20.0
39425,3,9425,[748 117 269 496  15],654,4,40428,4.288987905792489,0.0,0.0
39426,3,9426,[ 64 318 313 301  11],416,5,40433,4.289063328736607,60.0,20.0
39427,3,9427,[ 64 318 313 301  11],345,5,40438,4.28913873568095,60.0,20.0
39428,3,9428,[ 64 318 313 301  11],416,5,40443,4.289214126630608,60.0,20.0
39429,3,9429,[ 15  88 100 496  70],373,4,40447,4.289183457051962,0.0,0.0
39430,3,9430,[ 64 318 313 301  11],43,5,40452,4.289258827271763,60.0,20.0
39431,3,9431,[210 323 174 202 216],751,4,40456,4.289228159457167,0.0,0.0
39432,3,9432,[275 546  64 172 405],43,5,40461,4.2893035089579135,20.0,0.0
39433,3,9433,[ 64 318 313 301  11],43,5,40466,4.28937884248463,60.0,20.0
39434,3,9434,[245 168 100  25 748],416,4,40470,4.289348171701113,0.0,0.0
39435,3,9435,[496 216   1  56 195],618,3,40473,4.289211530309453,0.0,0.0
39436,3,9436,[ 64 318 313 301  11],43,5,40478,4.289286849634418,60.0,20.0
39437,3,9437,[ 11  88 269  89 176],805,3,40481,4.2891502436956985,0.0,0.0
39438,3,9438,[258 748  96 183   7],805,3,40484,4.289013666701981,0.0,0.0
39439,3,9439,[ 64 318 313 301  11],43,5,40489,4.289088983050847,60.0,20.0
39440,3,9440,[ 64 318 313 301  11],345,5,40494,4.28916428344455,60.0,20.0
39441,3,9441,[ 64 318 313 301  11],345,5,40499,4.289239567888159,60.0,20.0
39442,3,9442,[172  95 257 238  96],417,2,40501,4.288997140739172,0.0,0.0
39443,3,9443,[237 121  97 597  28],588,3,40504,4.288860652265989,0.0,0.0
39444,3,9444,[323 275  22   4 125],764,3,40507,4.288724192694548,0.0,0.0
39445,3,9445,[ 64 318 313 301  11],416,5,40512,4.288799491848401,60.0,20.0
39446,3,9446,[ 97 168 174 118   7],62,3,40515,4.28866306764052,0.0,0.0
39447,3,9447,[405 100  56 588   1],417,2,40517,4.28842082980525,0.0,0.0
39448,3,9448,[153 748  22 191 216],721,3,40520,4.288284474547571,0.0,0.0
39449,3,9449,[ 64 318 313 301  11],345,5,40525,4.288359788359788,60.0,20.0
39450,3,9450,[ 64 318 313 301  11],416,5,40530,4.288435086234261,60.0,20.0
39451,3,9451,[ 89  25 143 153 403],373,3,40533,4.288298772746509,0.0,0.0
39452,3,9452,[ 64 318 313 301  11],345,5,40538,4.28837406114461,60.0,20.0
39453,3,9453,[496  89 294 568   8],642,4,40542,4.288343558282208,0.0,0.0
39454,3,9454,[ 64 318 313 301  11],416,5,40547,4.28841882601798,60.0,20.0
39455,3,9455,[ 64 318 313 301  11],43,5,40552,4.288494077834179,60.0,20.0
39456,3,9456,[748  28 174 191 197],437,4,40556,4.28846357195728,0.0,0.0
39457,3,9457,[ 12 286 195 100 210],437,2,40558,4.28822161133432,20.0,0.0
39458,3,9458,[ 28 385 196 191   4],43,5,40563,4.288296860133206,0.0,0.0
39459,3,9459,[ 64 318 313 301  11],345,5,40568,4.288372093023256,60.0,20.0
39460,3,9460,[ 64 318 313 301  11],345,5,40573,4.288447310009513,60.0,20.0
39461,3,9461,[ 64 318 313 301  11],416,5,40578,4.288522511097019,60.0,20.0
39462,3,9462,[ 64 318 313 301  11],345,5,40583,4.288597696290817,60.0,20.0
39463,3,9463,[197 301 185 234 322],416,4,40587,4.288567202028741,0.0,0.0
39464,3,9464,[ 64 318 313 301  11],345,5,40592,4.288642366613841,60.0,20.0
39465,3,9465,[568 496  82  50 748],416,5,40597,4.28871751531798,0.0,20.0
39466,3,9466,[ 64 282 546 268 405],314,5,40602,4.288792648146192,20.0,0.0
39467,3,9467,[202 234 403  95 238],417,5,40607,4.2888677651035065,0.0,0.0
39468,3,9468,[172 238  88 282  70],345,4,40611,4.28883725842222,0.0,0.0
39469,3,9469,[216 100 294 111  12],416,5,40616,4.288912354804646,20.0,0.0
39470,3,9470,[588 187 403 496 322],416,4,40620,4.28888184985746,0.0,0.0
39471,3,9471,[ 64 318 313 301  11],43,5,40625,4.288956925675675,60.0,20.0
39472,3,9472,[ 64 318 313 301  11],43,5,40630,4.289031985643407,60.0,20.0
39473,3,9473,[200 483  98 202  82],618,4,40634,4.289001477728521,20.0,20.0
39474,3,9474,[ 64 318 313 301  11],345,5,40639,4.289076517150396,60.0,20.0
39475,3,9475,[151 294   4  98  50],345,4,40643,4.289046010975095,0.0,40.0
39476,3,9476,[144 678 172 204 271],805,2,40645,4.288804473989659,0.0,0.0
39477,3,9477,[ 64 318 313 301  11],416,5,40650,4.288879510445241,60.0,20.0
39478,3,9478,[288   7 222 228  70],417,1,40651,4.2885325456271755,0.0,20.0
39479,3,9479,[ 64 318 313 301  11],416,5,40656,4.288607594936709,60.0,20.0
39480,3,9480,[ 64 318 313 301  11],416,5,40661,4.288682628414724,60.0,20.0
39481,3,9481,[302 403 211 427 245],416,4,40665,4.288652183083737,0.0,0.0
39482,3,9482,[ 64 318 313 301  11],43,5,40670,4.28872719603501,60.0,20.0
39483,3,9483,[ 98  82 237 187 144],505,2,40672,4.288485870940532,0.0,20.0
39484,3,9484,[ 64 318 313 301  11],43,5,40677,4.288560885608856,60.0,20.0
39485,3,9485,[185 405 276 100 117],230,5,40682,4.2886358844613115,0.0,0.0
39486,3,9486,[ 64 318 313 301  11],345,5,40687,4.288710867502899,60.0,20.0
39487,3,9487,[ 64 318 313 301  11],416,5,40692,4.288785834738618,60.0,20.0
39488,3,9488,[ 64 318 313 301  11],43,5,40697,4.288860786173464,60.0,20.0
39489,3,9489,[ 64 318 313 301  11],416,5,40702,4.288935721812434,60.0,20.0
39490,3,9490,[118 275 268 282 172],588,3,40705,4.288799915709619,0.0,0.0
39491,3,9491,[ 64 318 313 301  11],345,5,40710,4.288874841972187,60.0,20.0
39492,3,9492,[ 56 181 100 742  22],416,5,40715,4.288949752449173,0.0,20.0
39493,3,9493,[ 64 318 313 301  11],416,5,40720,4.289024647145566,60.0,20.0
39494,3,9494,[ 64 318 313 301  11],345,5,40725,4.289099526066351,60.0,20.0
39495,3,9495,[313 245 257  96  25],416,3,40728,4.288963774220725,20.0,20.0
39496,3,9496,[135 196   7 132 161],230,3,40731,4.288828050963462,0.0,0.0
39497,3,9497,[427   7 403 151  79],416,4,40735,4.28879764160876,0.0,0.0
39498,3,9498,[ 64 318 313 301  11],345,5,40740,4.288872512896094,60.0,20.0
39499,3,9499,[ 64 318 313 301  11],345,5,40745,4.288947368421053,60.0,20.0
39500,3,9500,[ 64 318 313 301  11],43,5,40750,4.289022208188611,60.0,20.0
39501,3,9501,[ 64 318 313 301  11],345,5,40755,4.289097032203746,60.0,20.0
39502,3,9502,[ 64 318 313 301  11],345,5,40760,4.28917184047143,60.0,20.0
39503,3,9503,[ 64 318 313 301  11],345,5,40765,4.289246632996633,60.0,20.0
39504,3,9504,[ 64 318 313 301  11],416,5,40770,4.289321409784324,60.0,20.0
39505,3,9505,[ 64 318 313 301  11],345,5,40775,4.28939617083947,60.0,20.0
39506,3,9506,[ 64 318 313 301  11],416,5,40780,4.289470916167035,60.0,20.0
39507,3,9507,[276 322 301  97 185],416,3,40783,4.289335296592343,0.0,0.0
39508,3,9508,[ 64 318 313 301  11],43,5,40788,4.289410032600694,60.0,20.0
39509,3,9509,[655 117  98   8 143],805,1,40789,4.28906414300736,0.0,20.0
39510,3,9510,[328 195  82  56 568],416,5,40794,4.2891388918094835,0.0,0.0
39511,3,9511,[ 64 318 313 301  11],345,5,40799,4.289213624894869,60.0,20.0
39512,3,9512,[471 144 182 143 273],297,2,40801,4.288972984337223,0.0,0.0
39513,3,9513,[ 98 568 117 168 197],198,3,40804,4.288837502627707,0.0,20.0
39514,3,9514,[196 313  88 204 403],405,3,40807,4.288702049395691,20.0,20.0
39515,3,9515,[117 234 202 125  88],588,3,40810,4.288566624632199,0.0,0.0
39516,3,9516,[258   7 174   1 238],262,3,40813,4.288431228328255,0.0,0.0
39517,3,9517,[ 64 318 313 301  11],43,5,40818,4.288505988653078,60.0,20.0
39518,3,9518,[286 161  22  71 273],416,5,40823,4.288580733270302,0.0,0.0
39519,3,9519,[ 64 318 313 301  11],43,5,40828,4.288655462184874,60.0,20.0
39520,3,9520,[ 98 423 175 588  11],297,4,40832,4.288625144417603,0.0,20.0
39521,3,9521,[197 257  64 173  89],711,3,40835,4.288489813064483,20.0,0.0
39522,3,9522,[235 405 181 245 322],907,5,40840,4.288564527984879,0.0,20.0
39523,3,9523,[ 64 318 313 301  11],416,5,40845,4.288639227215456,60.0,20.0
39524,3,9524,[ 64 318 313 301  11],43,5,40850,4.288713910761155,60.0,20.0
39525,3,9525,[ 64 318 313 301  11],43,5,40855,4.2887885786269155,60.0,20.0
39526,3,9526,[  1 748  64  89 186],198,4,40859,4.2887582659808965,20.0,0.0
39527,3,9527,[ 64 318 313 301  11],416,5,40864,4.288832913518052,60.0,20.0
39528,3,9528,[234 191 742 294 385],417,4,40868,4.288802602581593,0.0,0.0
39529,3,9529,[180 385 202 403 423],405,3,40871,4.288667366211962,0.0,0.0
39530,3,9530,[ 22 144 228 265 238],297,2,40873,4.288427237435736,0.0,0.0
39531,3,9531,[ 64 318 313 301  11],345,5,40878,4.288501888375997,60.0,20.0
39532,3,9532,[ 64 318 313 301  11],416,5,40883,4.288576523654673,60.0,20.0
39533,3,9533,[153 144 271 127 125],62,3,40886,4.288441367736522,0.0,0.0
39534,3,9534,[ 64 318 313 301  11],43,5,40891,4.288515993707394,60.0,20.0
39535,3,9535,[ 64 318 313 301  11],345,5,40896,4.2885906040268456,60.0,20.0
39536,3,9536,[655  64  98 257 161],711,4,40900,4.288560343923666,20.0,20.0
39537,3,9537,[ 64 318 313 301  11],43,5,40905,4.288634933948416,60.0,20.0
39538,3,9538,[234  82 216 183 215],405,3,40908,4.288499842750812,0.0,0.0
39539,3,9539,[ 64 318 313 301  11],416,5,40913,4.2885744234800836,60.0,20.0
39540,3,9540,[ 64 318 313 301  11],43,5,40918,4.288648988575621,60.0,20.0
39541,3,9541,[294 302 271 151 300],297,1,40919,4.288304338713058,0.0,0.0
39542,3,9542,[603 121 234 258 546],416,4,40923,4.28827412763282,0.0,0.0
39543,3,9543,[ 64 318 313 301  11],416,5,40928,4.2883487007544,60.0,20.0
39544,3,9544,[ 64 318 313 301  11],416,5,40933,4.2884232582503925,60.0,20.0
39545,3,9545,[ 64 318 313 301  11],345,5,40938,4.2884978001257075,60.0,20.0
39546,3,9546,[ 64 318 313 301  11],345,5,40943,4.2885723263852515,60.0,20.0
39547,3,9547,[678 135 568 405 403],805,3,40946,4.288437369082531,0.0,0.0
39548,3,9548,[ 64 318 313 301  11],345,5,40951,4.288511886061368,60.0,20.0
39549,3,9549,[ 64 318 313 301  11],416,5,40956,4.288586387434555,60.0,20.0
39550,3,9550,[ 64 318 313 301  11],43,5,40961,4.288660873206994,60.0,20.0
39551,3,9551,[ 64 318 313 301  11],416,5,40966,4.288735343383585,60.0,20.0
39552,3,9552,[ 64 185  70  69 234],198,2,40968,4.288495760494086,20.0,0.0
39553,3,9553,[ 64 318 313 301  11],43,5,40973,4.288570232363408,60.0,20.0
39554,3,9554,[ 98 423 216 328 237],128,4,40977,4.288540031397174,0.0,20.0
39555,3,9555,[265 427 471 172 175],373,3,40980,4.288405190456258,0.0,0.0
39556,3,9556,[546 125 475 276 508],62,5,40985,4.288479648425238,0.0,0.0
39557,3,9557,[318 143 182 187 286],416,5,40990,4.288554090813978,20.0,0.0
39558,3,9558,[ 64 318 313 301  11],416,5,40995,4.288628517627367,60.0,20.0
39559,3,9559,[172  15  50 228  70],198,2,40997,4.288389121338912,0.0,20.0
39560,3,9560,[175 568 427 211 357],405,3,41000,4.288254366698044,0.0,0.0
39561,3,9561,[ 97 161 216 228 195],12,5,41005,4.288328801505961,0.0,0.0
39562,3,9562,[ 64 318 313 301  11],416,5,41010,4.288403220746628,60.0,20.0
39563,3,9563,[ 64 318 313 301  11],345,5,41015,4.288477624424927,60.0,20.0
39564,3,9564,[ 64 318 313 301  11],416,5,41020,4.28855201254574,60.0,20.0
39565,3,9565,[323  22  64 181 245],416,3,41023,4.2884173113108925,20.0,20.0
39566,3,9566,[  4 181 151  95 161],417,2,41025,4.288178112260897,0.0,20.0
39567,3,9567,[268 176 313   4 200],416,5,41030,4.288252508361204,20.0,20.0
39568,3,9568,[ 64 318 313 301  11],416,5,41035,4.2883268889121124,60.0,20.0
39569,3,9569,[588 568 742 153 111],654,5,41040,4.2884012539184955,0.0,0.0
39570,3,9570,[  8  82  96 222 111],887,4,41044,4.288371121094975,0.0,0.0
39571,3,9571,[ 64 318 313 301  11],416,5,41049,4.288445465942332,60.0,20.0
39572,3,9572,[ 22 182 496 313 328],416,5,41054,4.288519795257495,20.0,20.0
39573,3,9573,[ 64 318 313 301  11],345,5,41059,4.288594109045331,60.0,20.0
39574,3,9574,[ 64 318 313 301  11],416,5,41064,4.288668407310705,60.0,20.0
39575,3,9575,[ 64 318 313 301  11],416,5,41069,4.28874269005848,60.0,20.0
39576,3,9576,[385 245 132 323 546],417,3,41072,4.288608123629529,0.0,0.0
39577,3,9577,[ 64 318 313 301  11],43,5,41077,4.288682397160159,60.0,20.0
39578,3,9578,[ 64 318 313 301  11],43,5,41082,4.288756655183214,60.0,20.0
39579,3,9579,[ 64 318 313 301  11],345,5,41087,4.288830897703549,60.0,20.0
39580,3,9580,[333 183 185 655 568],416,5,41092,4.28890512472602,0.0,0.0
39581,3,9581,[268  70  22 258  56],721,2,41094,4.2886662492172825,0.0,0.0
39582,3,9582,[195  56 168 172  11],417,4,41098,4.288636126473964,0.0,0.0
39583,3,9583,[ 64 318 313 301  11],43,5,41103,4.288710350584307,60.0,20.0
39584,3,9584,[ 64 318 313 301  11],416,5,41108,4.288784559207095,60.0,20.0
39585,3,9585,[ 64 318 313 301  11],43,5,41113,4.288858752347173,60.0,20.0
39586,3,9586,[515  95 265 144  97],230,4,41117,4.288828622092417,0.0,0.0
39587,3,9587,[ 25 748 282  15   1],907,5,41122,4.288902795160618,0.0,0.0
39588,3,9588,[  1 211   4 245 125],417,4,41126,4.288872666597142,0.0,0.0
39589,3,9589,[300  11  71 588   9],345,2,41128,4.288633993743483,0.0,0.0
39590,3,9590,[313 288  89 603  79],214,4,41132,4.288603899489105,20.0,40.0
39591,3,9591,[ 64 318 313 301  11],43,5,41137,4.288678065054212,60.0,20.0
39592,3,9592,[ 64 318 313 301  11],416,5,41142,4.288752215156885,60.0,20.0
39593,3,9593,[ 64 318 313 301  11],345,5,41147,4.288826349801959,60.0,20.0
39594,3,9594,[ 64 318 313 301  11],416,5,41152,4.288900468994268,60.0,20.0
39595,3,9595,[ 64 318 313 301  11],416,5,41157,4.288974572738641,60.0,20.0
39596,3,9596,[ 64 318 313 301  11],345,5,41162,4.289048661039908,60.0,20.0
39597,3,9597,[135 257  12 597   4],62,3,41165,4.288914357157741,20.0,0.0
39598,3,9598,[121 742 111 173   8],805,1,41166,4.288571726221481,0.0,0.0
39599,3,9599,[176 265 182 215  50],618,5,41171,4.288645833333334,0.0,20.0
39600,3,9600,[185  96 245 257 196],921,2,41173,4.288407457556504,0.0,0.0
39601,3,9601,[ 64 318 313 301  11],416,5,41178,4.288481566340346,60.0,20.0
39602,3,9602,[125 135   4 173  28],642,3,41181,4.288347391440175,0.0,0.0
39603,3,9603,[ 97  69 181 286 172],721,5,41186,4.288421491045398,0.0,20.0
39604,3,9604,[ 64 318 313 301  11],345,5,41191,4.288495575221239,60.0,20.0
39605,3,9605,[ 64 318 313 301  11],345,5,41196,4.288569643972517,60.0,20.0
39606,3,9606,[ 64 318 313 301  11],416,5,41201,4.288643697304049,60.0,20.0
39607,3,9607,[ 64 318 313 301  11],416,5,41206,4.28871773522065,60.0,20.0
39608,3,9608,[546  97   1 132 180],417,4,41210,4.288687688625247,0.0,0.0
39609,3,9609,[ 64 318 313 301  11],43,5,41215,4.288761706555671,60.0,20.0
39610,3,9610,[ 64 318 313 301  11],43,5,41220,4.288835709083342,60.0,20.0
39611,3,9611,[ 64 318 313 301  11],43,5,41225,4.288909696213067,60.0,20.0
39612,3,9612,[168 427 172 515 597],416,4,41229,4.288879642151254,0.0,0.0
39613,3,9613,[ 64 318 313 301  11],43,5,41234,4.2889536093197425,60.0,20.0
39614,3,9614,[ 64 318 313 301  11],345,5,41239,4.289027561102444,60.0,20.0
39615,3,9615,[ 64 318 313 301  11],345,5,41244,4.28910149750416,60.0,20.0
39616,3,9616,[200  98  82 174   1],805,3,41247,4.2889674534678175,0.0,20.0
39617,3,9617,[179 427 144 237 678],416,2,41249,4.2887294655853605,0.0,0.0
39618,3,9618,[197 172 237 748 222],721,3,41252,4.288595488096476,0.0,0.0
39619,3,9619,[597 173 423 475 282],854,3,41255,4.288461538461538,0.0,0.0
39620,3,9620,[ 64 318 313 301  11],416,5,41260,4.288535495270762,60.0,20.0
39621,3,9621,[ 64 318 313 301  11],416,5,41265,4.288609436707545,60.0,20.0
39622,3,9622,[ 64 318 313 301  11],416,5,41270,4.2886833627766805,60.0,20.0
39623,3,9623,[ 64 318 313 301  11],43,5,41275,4.288757273482959,60.0,20.0
39624,3,9624,[ 64 318 313 301  11],345,5,41280,4.288831168831169,60.0,20.0
39625,3,9625,[ 64 318 313 301  11],345,5,41285,4.288905048826096,60.0,20.0
39626,3,9626,[ 64 318 313 301  11],416,5,41290,4.288978913472525,60.0,20.0
39627,3,9627,[ 64 318 313 301  11],345,5,41295,4.289052762775239,60.0,20.0
39628,3,9628,[546 127 323 191  12],417,3,41298,4.288918890850556,20.0,0.0
39629,3,9629,[ 64 318 313 301  11],43,5,41303,4.288992731048806,60.0,20.0
39630,3,9630,[655  64 302  69 153],417,3,41306,4.288858893157512,20.0,0.0
39631,3,9631,[ 56  50 127 222 603],805,4,41310,4.288828903654485,0.0,20.0
39632,3,9632,[ 64 318 313 301  11],416,5,41315,4.288902730198277,60.0,20.0
39633,3,9633,[ 64 318 313 301  11],345,5,41320,4.288976541415819,60.0,20.0
39634,3,9634,[ 64 318 313 301  11],43,5,41325,4.289050337311884,60.0,20.0
39635,3,9635,[ 64 318 313 301  11],43,5,41330,4.289124117891241,60.0,20.0
39636,3,9636,[ 64 318 313 301  11],43,5,41335,4.28919788315866,60.0,20.0
39637,3,9637,[318   8 294 144  12],588,4,41339,4.289167877152936,40.0,0.0
39638,3,9638,[258   9 423 125 168],416,5,41344,4.289241622574956,0.0,0.0
39639,3,9639,[ 64 318 313 301  11],43,5,41349,4.289315352697096,60.0,20.0
39640,3,9640,[655 127 168 151 276],198,4,41353,4.289285343844,0.0,0.0
39641,3,9641,[ 64 318 313 301  11],416,5,41358,4.289359054138146,60.0,20.0
39642,3,9642,[ 71 385 121 237 265],588,3,41361,4.289225344809706,0.0,0.0
39643,3,9643,[ 64 318 313 301  11],345,5,41366,4.289299046038988,60.0,20.0
39644,3,9644,[ 64 318 313 301  11],416,5,41371,4.289372731985485,60.0,20.0
39645,3,9645,[257 191 197 132 183],416,4,41375,4.289342732738959,0.0,0.0
39646,3,9646,[172 200   9  88 195],618,3,41378,4.289209080543174,0.0,0.0
39647,3,9647,[132 182 222  82 655],417,4,41382,4.289179104477612,0.0,0.0
39648,3,9648,[258 132 357 125  69],62,5,41387,4.289252772308012,0.0,0.0
39649,3,9649,[ 64 318 313 301  11],43,5,41392,4.289326424870466,60.0,20.0
39650,3,9650,[215  11  15   7 182],198,4,41396,4.2892964459641485,0.0,0.0
39651,3,9651,[ 64 318 313 301  11],416,5,41401,4.289370078740157,60.0,20.0
39652,3,9652,[ 64 318 313 301  11],345,5,41406,4.28944369626023,60.0,20.0
39653,3,9653,[ 64 318 313 301  11],416,5,41411,4.289517298529107,60.0,20.0
39654,3,9654,[ 56 127  82 200 655],618,5,41416,4.289590885551528,0.0,0.0
39655,3,9655,[ 98 173 125 742  22],764,3,41419,4.289457332228666,0.0,20.0
39656,3,9656,[ 64 318 313 301  11],345,5,41424,4.289530910220566,60.0,20.0
39657,3,9657,[ 64 318 313 301  11],43,5,41429,4.289604472975771,60.0,20.0
39658,3,9658,[ 64 318 313 301  11],43,5,41434,4.289678020499016,60.0,20.0
39659,3,9659,[196  64 423 385   7],416,5,41439,4.289751552795031,20.0,0.0
39660,3,9660,[ 64 318 313 301  11],416,5,41444,4.289825069868543,60.0,20.0
39661,3,9661,[ 64 318 313 301  11],43,5,41449,4.28989857172428,60.0,20.0
39662,3,9662,[ 64 318 313 301  11],43,5,41454,4.289972058366967,60.0,20.0
39663,3,9663,[323 180 125 748 405],417,3,41457,4.289838576158941,0.0,0.0
39664,3,9664,[ 70 196  69   9 403],618,3,41460,4.289705121572685,0.0,0.0
39665,3,9665,[ 64 318 313 301  11],345,5,41465,4.289778605421064,60.0,20.0
39666,3,9666,[597 273 258  15 245],159,5,41470,4.2898520740664114,0.0,0.0
39667,3,9667,[588   9 427 195 132],618,3,41473,4.289718659495242,0.0,0.0
39668,3,9668,[174 135  28 496 183],618,5,41478,4.289792119143655,0.0,0.0
39669,3,9669,[ 64 318 313 301  11],416,5,41483,4.2898655635987595,60.0,20.0
39670,3,9670,[385  97 185 748 257],416,4,41487,4.289835590941991,0.0,0.0
39671,3,9671,[ 11 180 191 183 211],405,2,41489,4.289598842018197,0.0,0.0
39672,3,9672,[ 64 318 313 301  11],345,5,41494,4.289672283676212,60.0,20.0
39673,3,9673,[ 64 318 313 301  11],345,5,41499,4.28974571015092,60.0,20.0
39674,3,9674,[568 294 174 235 302],62,2,41501,4.289509043927649,0.0,0.0
39675,3,9675,[ 64 318 313 301  11],43,5,41506,4.2895824720959075,60.0,20.0
39676,3,9676,[ 64 318 313 301  11],43,5,41511,4.2896558850883535,60.0,20.0
39677,3,9677,[ 64 318 313 301  11],43,5,41516,4.2897292829096925,60.0,20.0
39678,3,9678,[ 64 318 313 301  11],43,5,41521,4.289802665564625,60.0,20.0
39679,3,9679,[ 64 318 313 301  11],43,5,41526,4.289876033057851,60.0,20.0
39680,3,9680,[ 64 318 313 301  11],345,5,41531,4.2899493853940704,60.0,20.0
39681,3,9681,[ 64 318 313 301  11],416,5,41536,4.29002272257798,60.0,20.0
39682,3,9682,[ 64 318 313 301  11],345,5,41541,4.290096044614272,60.0,20.0
39683,3,9683,[ 64 318 313 301  11],43,5,41546,4.290169351507641,60.0,20.0
39684,3,9684,[ 64 318 313 301  11],345,5,41551,4.290242643262777,60.0,20.0
39685,3,9685,[403 153  25 269 216],373,4,41555,4.290212678092091,0.0,0.0
39686,3,9686,[471 174 117 678 200],345,3,41558,4.290079487973573,0.0,0.0
39687,3,9687,[496 172 245 179 196],416,3,41561,4.289946325350949,0.0,0.0
39688,3,9688,[ 64 318 313 301  11],43,5,41566,4.290019609866859,60.0,20.0
39689,3,9689,[ 64 318 313 301  11],345,5,41571,4.290092879256966,60.0,20.0
39690,3,9690,[172 196 271 423 210],805,1,41572,4.289753379424208,0.0,0.0
39691,3,9691,[135 403 143 179  56],198,4,41576,4.289723483285184,0.0,0.0
39692,3,9692,[ 64 318 313 301  11],416,5,41581,4.28979676054885,60.0,20.0
39693,3,9693,[ 64 318 313 301  11],43,5,41586,4.28987002269445,60.0,20.0
39694,3,9694,[ 64 318 313 301  11],43,5,41591,4.289943269726663,60.0,20.0
39695,3,9695,[423 265  50  82  97],437,2,41593,4.289707095709571,0.0,20.0
39696,3,9696,[427 181  79  82  28],705,4,41597,4.289677219758688,0.0,20.0
39697,3,9697,[197 323 597 143 153],416,3,41600,4.289544235924933,0.0,0.0
39698,3,9698,[117 204  50 496 568],505,3,41603,4.289411279513352,0.0,20.0
39699,3,9699,[ 64 318 313 301  11],345,5,41608,4.289484536082474,60.0,20.0
39700,3,9700,[215  64  50  98  97],416,5,41613,4.289557777548707,20.0,40.0
39701,3,9701,[ 64 318 313 301  11],43,5,41618,4.2896310039167185,60.0,20.0
39702,3,9702,[153 435 238 357 172],373,5,41623,4.289704215191178,0.0,0.0
39703,3,9703,[ 64 318 313 301  11],416,5,41628,4.289777411376752,60.0,20.0
39704,3,9704,[143 111 228 234 200],297,1,41629,4.289438433797012,0.0,0.0
39705,3,9705,[ 64 318 313 301  11],416,5,41634,4.289511642283124,60.0,20.0
39706,3,9706,[ 64 318 313 301  11],345,5,41639,4.289584835685588,60.0,20.0
39707,3,9707,[ 64 318 313 301  11],416,5,41644,4.289658014009064,60.0,20.0
39708,3,9708,[111 273 210 143  97],416,5,41649,4.289731177258214,0.0,0.0
39709,3,9709,[185 515  96  11 172],230,4,41653,4.289701338825953,0.0,0.0
39710,3,9710,[210 144  28 568   1],43,5,41658,4.289774482545567,0.0,0.0
39711,3,9711,[180  12  50 173  97],417,4,41662,4.289744645799011,20.0,20.0
39712,3,9712,[ 64 318 313 301  11],416,5,41667,4.289817769998971,60.0,20.0
39713,3,9713,[ 64 318 313 301  11],416,5,41672,4.289890879143504,60.0,20.0
39714,3,9714,[174 471 288 135  11],922,2,41674,4.289655172413793,0.0,20.0
39715,3,9715,[ 64 318 313 301  11],416,5,41679,4.289728283244133,60.0,20.0
39716,3,9716,[ 64 318 313 301  11],345,5,41684,4.289801379026448,60.0,20.0
39717,3,9717,[276 568 153 202 294],416,4,41688,4.289771557933731,0.0,0.0
39718,3,9718,[200 215 216 118  97],416,4,41692,4.2897417429776725,0.0,0.0
39719,3,9719,[333 318 302 405 197],416,5,41697,4.2898148148148145,20.0,0.0
39720,3,9720,[ 64 318 313 301  11],416,5,41702,4.289887871618146,60.0,20.0
39721,3,9721,[ 64 318 313 301  11],43,5,41707,4.2899609133923065,60.0,20.0
39722,3,9722,[ 64 318 313 301  11],43,5,41712,4.290033940141932,60.0,20.0
39723,3,9723,[ 64 318 313 301  11],345,5,41717,4.290106951871658,60.0,20.0
39724,3,9724,[ 95  25  69 196 132],416,4,41721,4.290077120822622,0.0,0.0
39725,3,9725,[ 64 318 313 301  11],345,5,41726,4.29015011309891,60.0,20.0
39726,3,9726,[ 64 318 313 301  11],43,5,41731,4.29022309036702,60.0,20.0
39727,3,9727,[ 64 318 313 301  11],345,5,41736,4.290296052631579,60.0,20.0
39728,3,9728,[100 546  11 471 286],416,4,41740,4.290266214410525,0.0,0.0
39729,3,9729,[ 71 496  50  95  82],437,3,41743,4.290133607399794,0.0,20.0
39730,3,9730,[ 64 318 313 301  11],43,5,41748,4.290206556366252,60.0,20.0
39731,3,9731,[ 64 318 313 301  11],43,5,41753,4.290279490341143,60.0,20.0
39732,3,9732,[ 64 318 313 301  11],416,5,41758,4.290352409329087,60.0,20.0
39733,3,9733,[  1 286 181 258 471],345,2,41760,4.290117115266078,0.0,20.0
39734,3,9734,[403 318 191 153 125],62,5,41765,4.290190035952747,20.0,0.0
39735,3,9735,[ 64 318 313 301  11],43,5,41770,4.290262941659819,60.0,20.0
39736,3,9736,[ 64 318 313 301  11],43,5,41775,4.290335832391907,60.0,20.0
39737,3,9737,[ 64 318 313 301  11],416,5,41780,4.290408708153625,60.0,20.0
39738,3,9738,[ 71   8 210  82 742],805,0,41780,4.289968169216552,0.0,0.0
39739,3,9739,[ 64 318 313 301  11],345,5,41785,4.290041067761807,60.0,20.0
39740,3,9740,[  9 194  12 282 176],416,5,41790,4.290113951339698,20.0,0.0
39741,3,9741,[ 64 318 313 301  11],43,5,41795,4.290186819954835,60.0,20.0
39742,3,9742,[ 64 318 313 301  11],43,5,41800,4.290259673611824,60.0,20.0
39743,3,9743,[ 64 318 313 301  11],416,5,41805,4.290332512315271,60.0,20.0
39744,3,9744,[191 151 276 174 423],618,3,41808,4.290200102616726,0.0,0.0
39745,3,9745,[ 64 318 313 301  11],43,5,41813,4.290272932485122,60.0,20.0
39746,3,9746,[ 64 318 313 301  11],416,5,41818,4.290345747409459,60.0,20.0
39747,3,9747,[234 127 216  64 245],417,4,41822,4.290315962248666,20.0,0.0
39748,3,9748,[ 64 318 313 301  11],43,5,41827,4.290388757821315,60.0,20.0
39749,3,9749,[ 64 318 313 301  11],43,5,41832,4.290461538461538,60.0,20.0
39750,3,9750,[483 603  98 276 196],354,2,41834,4.290226643421188,20.0,20.0
39751,3,9751,[ 64 318 313 301  11],416,5,41839,4.2902994257588185,60.0,20.0
39752,3,9752,[ 64 318 313 301  11],43,5,41844,4.290372193171332,60.0,20.0
39753,3,9753,[ 64 318 313 301  11],345,5,41849,4.290444945663317,60.0,20.0
39754,3,9754,[ 64 318 313 301  11],43,5,41854,4.290517683239364,60.0,20.0
39755,3,9755,[ 64 318 313 301  11],43,5,41859,4.290590405904059,60.0,20.0
39756,3,9756,[ 64 318 313 301  11],345,5,41864,4.290663113661986,60.0,20.0
39757,3,9757,[ 64 318 313 301  11],416,5,41869,4.290735806517729,60.0,20.0
39758,3,9758,[211  64 181 151  79],43,5,41874,4.2908084844758685,20.0,20.0
39759,3,9759,[111 176  50 168   9],62,4,41878,4.29077868852459,0.0,20.0
39760,3,9760,[ 82 357 288  56 200],405,4,41882,4.290748898678414,0.0,20.0
39761,3,9761,[ 64 318 313 301  11],345,5,41887,4.290821552960459,60.0,20.0
39762,3,9762,[ 64 318 313 301  11],43,5,41892,4.290894192358906,60.0,20.0
39763,3,9763,[ 64 318 313 301  11],43,5,41897,4.290966816878329,60.0,20.0
39764,3,9764,[ 64 318 313 301  11],345,5,41902,4.291039426523297,60.0,20.0
39765,3,9765,[ 64 318 313 301  11],416,5,41907,4.291112021298382,60.0,20.0
39766,3,9766,[ 64 318 313 301  11],416,5,41912,4.29118460120815,60.0,20.0
39767,3,9767,[100 118  25 187 186],618,3,41915,4.291052416052416,0.0,0.0
39768,3,9768,[ 64 318 313 301  11],43,5,41920,4.291124987204422,60.0,20.0
39769,3,9769,[ 64 318 313 301  11],345,5,41925,4.291197543500512,60.0,20.0
39770,3,9770,[423 603 237 197   4],297,2,41927,4.290963053935114,0.0,0.0
39771,3,9771,[ 64 318 313 301  11],416,5,41932,4.291035611952517,60.0,20.0
39772,3,9772,[385 174 202 196 275],43,5,41937,4.291108155121252,0.0,0.0
39773,3,9773,[172  89 423 186 286],417,4,41941,4.291078371188869,0.0,0.0
39774,3,9774,[ 64 318 313 301  11],345,5,41946,4.291150895140665,60.0,20.0
39775,3,9775,[ 64 318 313 301  11],43,5,41951,4.2912234042553195,60.0,20.0
39776,3,9776,[ 89 202 273 216 186],417,3,41954,4.291091336810883,0.0,0.0
39777,3,9777,[ 97 176   9 168 132],618,4,41958,4.291061566782573,0.0,0.0
39778,3,9778,[ 64 318 313 301  11],43,5,41963,4.291134062787606,60.0,20.0
39779,3,9779,[100 269 385 357 427],373,3,41966,4.291002044989775,0.0,0.0
39780,3,9780,[ 64 318 313 301  11],43,5,41971,4.291074532256416,60.0,20.0
39781,3,9781,[144   9 234  70 173],416,5,41976,4.291147004702514,0.0,0.0
39782,3,9782,[ 82  97  56 204   1],618,4,41980,4.291117244199121,0.0,0.0
39783,3,9783,[153 174 742  70  95],751,4,41984,4.2910874897792315,0.0,0.0
39784,3,9784,[ 64 318 313 301  11],345,5,41989,4.2911599386816555,60.0,20.0
39785,3,9785,[ 64 318 313 301  11],416,5,41994,4.291232372777437,60.0,20.0
39786,3,9786,[245 655 180 237  82],62,2,41996,4.290998263001941,0.0,0.0
39787,3,9787,[271 235 168   1  82],62,3,41999,4.290866366979976,0.0,0.0
39788,3,9788,[  4 294 216 211  69],416,5,42004,4.290938808867096,0.0,0.0
39789,3,9789,[ 64 318 313 301  11],43,5,42009,4.2910112359550565,60.0,20.0
39790,3,9790,[ 64 318 313 301  11],345,5,42014,4.291083648248391,60.0,20.0
39791,3,9791,[ 64 318 313 301  11],345,5,42019,4.291156045751634,60.0,20.0
39792,3,9792,[  8 197 200 294  28],297,2,42021,4.290922087205146,0.0,0.0
39793,3,9793,[ 64 318 313 301  11],416,5,42026,4.290994486420257,60.0,20.0
39794,3,9794,[ 64 318 313 301  11],345,5,42031,4.291066870852476,60.0,20.0
39795,3,9795,[ 64 318 313 301  11],416,5,42036,4.291139240506329,60.0,20.0
39796,3,9796,[ 64 318 313 301  11],345,5,42041,4.291211595386343,60.0,20.0
39797,3,9797,[ 64 318 313 301  11],416,5,42046,4.29128393549704,60.0,20.0
39798,3,9798,[ 64 318 313 301  11],416,5,42051,4.291356260842943,60.0,20.0
39799,3,9799,[191  95 403 111 132],416,4,42055,4.291326530612245,0.0,0.0
39800,3,9800,[ 64 318 313 301  11],345,5,42060,4.291398836853382,60.0,20.0
39801,3,9801,[ 97 210 161  69 655],705,2,42062,4.291165068353397,0.0,0.0
39802,3,9802,[ 56 151 182 286 603],437,3,42065,4.2910333571355705,0.0,0.0
39803,3,9803,[200 196 475  69 294],297,2,42067,4.290799673602611,0.0,0.0
39804,3,9804,[ 64 318 313 301  11],416,5,42072,4.290872004079551,60.0,20.0
39805,3,9805,[ 64 318 313 301  11],43,5,42077,4.290944319804201,60.0,20.0
39806,3,9806,[ 64 318 313 301  11],345,5,42082,4.2910166207810745,60.0,20.0
39807,3,9807,[ 64 318 313 301  11],43,5,42087,4.291088907014682,60.0,20.0
39808,3,9808,[215 151 173 118 245],62,2,42089,4.290855336935468,0.0,0.0
39809,3,9809,[ 64 318 313 301  11],416,5,42094,4.290927624872579,60.0,20.0
39810,3,9810,[ 64 318 313 301  11],43,5,42099,4.290999898073591,60.0,20.0
39811,3,9811,[127 173 496  69  96],505,2,42101,4.290766408479413,0.0,0.0
39812,3,9812,[ 71 100 222 228 183],805,3,42104,4.290634872108428,0.0,0.0
39813,3,9813,[ 64 318 313 301  11],345,5,42109,4.290707153046668,60.0,20.0
39814,3,9814,[ 64 318 313 301  11],43,5,42114,4.29077941925624,60.0,20.0
39815,3,9815,[ 64 318 313 301  11],416,5,42119,4.290851670741646,60.0,20.0
39816,3,9816,[ 64 318 313 301  11],416,5,42124,4.290923907507385,60.0,20.0
39817,3,9817,[322 483 333 144 180],854,2,42126,4.290690568343858,20.0,0.0
39818,3,9818,[ 64 318 313 301  11],345,5,42131,4.290762806803137,60.0,20.0
39819,3,9819,[276  50  28 515  71],416,4,42135,4.290733197556008,0.0,20.0
39820,3,9820,[ 64 318 313 301  11],43,5,42140,4.290805416963649,60.0,20.0
39821,3,9821,[235 174 265 197  70],297,2,42142,4.290572184891061,0.0,0.0
39822,3,9822,[ 64 318 313 301  11],43,5,42147,4.290644405985951,60.0,20.0
39823,3,9823,[328 515 235 118 275],416,3,42150,4.290513029315961,0.0,0.0
39824,3,9824,[ 64 318 313 301  11],416,5,42155,4.29058524173028,60.0,20.0
39825,3,9825,[234 235  28  22 196],297,3,42158,4.290453897822105,0.0,0.0
39826,3,9826,[273 235 748 168 151],805,2,42160,4.290220820189274,0.0,0.0
39827,3,9827,[ 64 318 313 301  11],416,5,42165,4.29029304029304,60.0,20.0
39828,3,9828,[ 64 318 313 301  11],416,5,42170,4.290365245701495,60.0,20.0
39829,3,9829,[ 64 318 313 301  11],345,5,42175,4.290437436419126,60.0,20.0
39830,3,9830,[ 64 318 313 301  11],345,5,42180,4.290509612450412,60.0,20.0
39831,3,9831,[ 64 318 313 301  11],43,5,42185,4.290581773799837,60.0,20.0
39832,3,9832,[ 64 318 313 301  11],416,5,42190,4.290653920471881,60.0,20.0
39833,3,9833,[ 64 318 313 301  11],43,5,42195,4.290726052471019,60.0,20.0
39834,3,9834,[ 64 318 313 301  11],43,5,42200,4.290798169801729,60.0,20.0
39835,3,9835,[ 64 318 313 301  11],345,5,42205,4.290870272468483,60.0,20.0
39836,3,9836,[ 64 318 313 301  11],416,5,42210,4.290942360475754,60.0,20.0
39837,3,9837,[ 64 318 313 301  11],43,5,42215,4.291014433828014,60.0,20.0
39838,3,9838,[222 168 496 210  82],601,4,42219,4.290984856184572,0.0,0.0
39839,3,9839,[  1 678  56 300 302],416,4,42223,4.290955284552846,0.0,0.0
39840,3,9840,[ 64 318 313 301  11],416,5,42228,4.291027334620465,60.0,20.0
39841,3,9841,[ 64 318 313 301  11],345,5,42233,4.291099370046738,60.0,20.0
39842,3,9842,[ 64 318 313 301  11],345,5,42238,4.291171390836127,60.0,20.0
39843,3,9843,[ 64 318 313 301  11],345,5,42243,4.291243396993092,60.0,20.0
39844,3,9844,[ 97  25 588 471 237],43,4,42247,4.291213814118842,0.0,0.0
39845,3,9845,[ 64 318 313 301  11],345,5,42252,4.291285801340646,60.0,20.0
39846,3,9846,[ 64 318 313 301  11],345,5,42257,4.291357773941302,60.0,20.0
39847,3,9847,[ 64 318 313 301  11],416,5,42262,4.291429731925264,60.0,20.0
39848,3,9848,[ 64 318 313 301  11],416,5,42267,4.291501675296985,60.0,20.0
39849,3,9849,[132 328 185 143 288],921,2,42269,4.291269035532995,0.0,20.0
39850,3,9850,[173 276 546  22 216],223,5,42274,4.291340980611105,0.0,0.0
39851,3,9851,[ 28 135  56 210  79],618,4,42278,4.291311408850995,0.0,0.0
39852,3,9852,[118 588 176 597  50],417,2,42280,4.291078859230691,0.0,20.0
39853,3,9853,[ 64 318 313 301  11],43,5,42285,4.291150801704892,60.0,20.0
39854,3,9854,[ 88 328   4 568 172],373,5,42290,4.291222729578894,0.0,0.0
39855,3,9855,[ 64 318 313 301  11],43,5,42295,4.291294642857143,60.0,20.0
39856,3,9856,[ 97 151 197 655   4],618,2,42297,4.291062189307091,0.0,0.0
39857,3,9857,[300  82 181   1  89],751,2,42299,4.290829782917427,0.0,20.0
39858,3,9858,[234 185 179 403 228],405,3,42302,4.290698853839132,0.0,0.0
39859,3,9859,[ 64 318 313 301  11],43,5,42307,4.290770791075051,60.0,20.0
39860,3,9860,[ 64 318 313 301  11],43,5,42312,4.290842713720718,60.0,20.0
39861,3,9861,[ 64 318 313 301  11],345,5,42317,4.290914621780572,60.0,20.0
39862,3,9862,[ 64 318 313 301  11],416,5,42322,4.290986515259049,60.0,20.0
39863,3,9863,[288 597 174 273 153],630,3,42325,4.290855636658557,0.0,20.0
39864,3,9864,[ 64 318 313 301  11],416,5,42330,4.290927521540801,60.0,20.0
39865,3,9865,[228 435 180 194 496],373,4,42334,4.290898033650922,0.0,0.0
39866,3,9866,[357 302 191  12 196],297,4,42338,4.290868551738117,20.0,0.0
39867,3,9867,[ 64 318 313 301  11],345,5,42343,4.2909404134576405,60.0,20.0
39868,3,9868,[385 268 515 302 191],416,5,42348,4.291012260614044,0.0,0.0
39869,3,9869,[ 64 318 313 301  11],345,5,42353,4.291084093211753,60.0,20.0
39870,3,9870,[ 64 318 313 301  11],416,5,42358,4.291155911255192,60.0,20.0
39871,3,9871,[ 64 318 313 301  11],416,5,42363,4.291227714748785,60.0,20.0
39872,3,9872,[ 64 318 313 301  11],416,5,42368,4.291299503696951,60.0,20.0
39873,3,9873,[ 64 318 313 301  11],345,5,42373,4.291371278104112,60.0,20.0
39874,3,9874,[748 197 238 182 173],297,2,42375,4.291139240506329,0.0,0.0
39875,3,9875,[ 64 318 313 301  11],416,5,42380,4.291211016605914,60.0,20.0
39876,3,9876,[ 64 318 313 301  11],345,5,42385,4.291282778171509,60.0,20.0
39877,3,9877,[ 64 318 313 301  11],416,5,42390,4.291354525207532,60.0,20.0
39878,3,9878,[ 64 318 313 301  11],345,5,42395,4.291426257718393,60.0,20.0
39879,3,9879,[ 64 318 313 301  11],43,5,42400,4.291497975708502,60.0,20.0
39880,3,9880,[  1  12  69 237 271],62,2,42402,4.2912660661876325,20.0,0.0
39881,3,9881,[ 64 318 313 301  11],43,5,42407,4.291337785873305,60.0,20.0
39882,3,9882,[748 423 257  11 176],297,2,42409,4.291105939492057,0.0,0.0
39883,3,9883,[ 69 196 268 496 179],417,3,42412,4.290975313638203,0.0,0.0
39884,3,9884,[ 64 318 313 301  11],416,5,42417,4.2910470409711685,60.0,20.0
39885,3,9885,[ 64 318 313 301  11],43,5,42422,4.291118753793243,60.0,20.0
39886,3,9886,[ 71 748 655 196  97],198,1,42423,4.290785880449074,0.0,0.0
39887,3,9887,[ 64 318 313 301  11],43,5,42428,4.290857605177994,60.0,20.0
39888,3,9888,[ 64 318 313 301  11],43,5,42433,4.290929315400951,60.0,20.0
39889,3,9889,[179  69 435 143  89],437,2,42435,4.290697674418604,0.0,0.0
39890,3,9890,[196  70 211 215  82],405,2,42437,4.290466080274998,0.0,0.0
39891,3,9891,[ 64 318 313 301  11],416,5,42442,4.2905378083299635,60.0,20.0
39892,3,9892,[ 64 318 313 301  11],43,5,42447,4.290609521884161,60.0,20.0
39893,3,9893,[ 64 318 313 301  11],416,5,42452,4.290681220941985,60.0,20.0
39894,3,9894,[ 64 318 313 301  11],43,5,42457,4.290752905507833,60.0,20.0
39895,3,9895,[ 64 318 313 301  11],345,5,42462,4.290824575586095,60.0,20.0
39896,3,9896,[ 64 318 313 301  11],43,5,42467,4.290896231181166,60.0,20.0
39897,3,9897,[ 64 318 313 301  11],416,5,42472,4.290967872297434,60.0,20.0
39898,3,9898,[172 191 196 385  15],416,5,42477,4.291039498939287,0.0,0.0
39899,3,9899,[ 64 318 313 301  11],345,5,42482,4.291111111111111,60.0,20.0
39900,3,9900,[508 268  12   8 168],214,3,42485,4.290980709019291,20.0,0.0
39901,3,9901,[ 64 318 313 301  11],345,5,42490,4.2910523126641085,60.0,20.0
39902,3,9902,[ 64 318 313 301  11],345,5,42495,4.291123901847925,60.0,20.0
39903,3,9903,[235 405 118 215 678],541,3,42498,4.290993537964459,0.0,0.0
39904,3,9904,[  4 597 258 204 568],654,5,42503,4.291065118626956,0.0,0.0
39905,3,9905,[234 742 405 235 588],345,3,42506,4.290934786997779,0.0,0.0
39906,3,9906,[ 64 318 313 301  11],345,5,42511,4.291006359140002,60.0,20.0
39907,3,9907,[ 64 318 313 301  11],345,5,42516,4.2910779168348805,60.0,20.0
39908,3,9908,[ 64 318 313 301  11],416,5,42521,4.29114946008679,60.0,20.0
39909,3,9909,[357  96 228 183 423],417,3,42524,4.291019172552977,0.0,0.0
39910,3,9910,[ 82 471   8 173 496],416,5,42529,4.2910907072949245,0.0,0.0
39911,3,9911,[ 64 318 313 301  11],416,5,42534,4.291162227602905,60.0,20.0
39912,3,9912,[ 64 318 313 301  11],43,5,42539,4.291233733481287,60.0,20.0
39913,3,9913,[173 405 222 475 333],854,4,42543,4.291204357474279,0.0,0.0
39914,3,9914,[ 64 318 313 301  11],345,5,42548,4.291275844679778,60.0,20.0
39915,3,9915,[ 64 318 313 301  11],416,5,42553,4.2913473174667205,60.0,20.0
39916,3,9916,[172 179 153  56 204],601,3,42556,4.291217101946153,0.0,0.0
39917,3,9917,[ 64 318 313 301  11],345,5,42561,4.291288566243194,60.0,20.0
39918,3,9918,[204 269 597 678  88],416,2,42563,4.291057566286924,0.0,0.0
39919,3,9919,[121 405 475 204 588],416,4,42567,4.291028225806452,0.0,0.0
39920,3,9920,[ 64 318 313 301  11],416,5,42572,4.291099687531499,60.0,20.0
39921,3,9921,[496 289 168 118 195],887,5,42577,4.291171134851845,0.0,0.0
39922,3,9922,[ 64 318 313 301  11],345,5,42582,4.291242567771843,60.0,20.0
39923,3,9923,[ 64 318 313 301  11],43,5,42587,4.291313986295848,60.0,20.0
39924,3,9924,[  4 151  22 245 181],416,3,42590,4.291183879093199,0.0,20.0
39925,3,9925,[132 204 182 508 237],62,3,42593,4.291053798105985,0.0,0.0
39926,3,9926,[ 28  97 185  82 211],230,5,42598,4.2911252140626575,0.0,0.0
39927,3,9927,[216  64 127 237  15],43,5,42603,4.291196615632554,20.0,0.0
39928,3,9928,[118 135 508 173 215],62,3,42606,4.291066572665928,0.0,0.0
39929,3,9929,[ 64 318 313 301  11],416,5,42611,4.291137965760322,60.0,20.0
39930,3,9930,[111  11  70 202 471],297,2,42613,4.290907260094653,0.0,0.0
39931,3,9931,[ 64 318 313 301  11],416,5,42618,4.290978654853,60.0,20.0
39932,3,9932,[265  79 385 179 191],198,2,42620,4.290748011678244,0.0,0.0
39933,3,9933,[ 82 168 143 265  50],922,3,42623,4.290618079323536,0.0,20.0
39934,3,9934,[ 64 318 313 301  11],345,5,42628,4.290689481630599,60.0,20.0
39935,3,9935,[194 302   7 475   4],854,2,42630,4.290458937198068,0.0,0.0
39936,3,9936,[257  97 265 181 318],416,4,42634,4.290429707155077,20.0,20.0
39937,3,9937,[ 64 318 313 301  11],345,5,42639,4.290501106862548,60.0,20.0
39938,3,9938,[ 64 318 313 301  11],43,5,42644,4.290572492202434,60.0,20.0
39939,3,9939,[655 144 257 174 471],416,4,42648,4.290543259557344,0.0,0.0
39940,3,9940,[ 79 475 288 132  98],711,4,42652,4.290514032793482,0.0,40.0
39941,3,9941,[ 64 318 313 301  11],416,5,42657,4.290585395292697,60.0,20.0
39942,3,9942,[ 64 318 313 301  11],416,5,42662,4.290656743437594,60.0,20.0
39943,3,9943,[385  69 496 185   7],262,3,42665,4.290526950925181,0.0,0.0
39944,3,9944,[ 64 318 313 301  11],43,5,42670,4.2905982905982905,60.0,20.0
39945,3,9945,[173 423  82 181 603],128,5,42675,4.290669615926,0.0,20.0
39946,3,9946,[ 64 318 313 301  11],345,5,42680,4.290740926912637,60.0,20.0
39947,3,9947,[187  88 144 143  28],618,5,42685,4.290812223562525,0.0,0.0
39948,3,9948,[ 64 318 313 301  11],416,5,42690,4.290883505879988,60.0,20.0
39949,3,9949,[ 64 318 313 301  11],43,5,42695,4.2909547738693465,60.0,20.0
39950,3,9950,[403  82 234 496 588],417,3,42698,4.290825042709275,0.0,0.0
39951,3,9951,[ 82 215 403  96  22],416,5,42703,4.290896302250804,0.0,0.0
39952,3,9952,[ 64 318 313 301  11],43,5,42708,4.290967547473124,60.0,20.0
39953,3,9953,[ 64 318 313 301  11],345,5,42713,4.291038778380551,60.0,20.0
39954,3,9954,[748 151 423   4 180],198,1,42714,4.290708186840783,0.0,0.0
39955,3,9955,[234 197  82 357  50],198,3,42717,4.290578545600643,0.0,20.0
39956,3,9956,[ 64 318 313 301  11],416,5,42722,4.290649794114693,60.0,20.0
39957,3,9957,[ 79 265  11 546 323],417,1,42723,4.29031934123318,0.0,0.0
39958,3,9958,[153  15 216 427 151],373,5,42728,4.290390601466011,0.0,0.0
39959,3,9959,[ 64 318 313 301  11],345,5,42733,4.290461847389558,60.0,20.0
39960,3,9960,[  9 318   7 222 132],764,5,42738,4.2905330790081315,20.0,0.0
39961,3,9961,[ 64 318 313 301  11],43,5,42743,4.290604296326039,60.0,20.0
39962,3,9962,[ 11 318 195  22 176],405,4,42747,4.290575127973502,20.0,0.0
39963,3,9963,[  9 268  15  64 357],416,5,42752,4.290646326776395,20.0,0.0
39964,3,9964,[ 64 318 313 301  11],345,5,42757,4.290717511289514,60.0,20.0
39965,3,9965,[ 64 318 313 301  11],43,5,42762,4.290788681517158,60.0,20.0
39966,3,9966,[ 64 318 313 301  11],345,5,42767,4.29085983746363,60.0,20.0
39967,3,9967,[ 64 318 313 301  11],416,5,42772,4.290930979133226,60.0,20.0
39968,3,9968,[ 64 318 313 301  11],43,5,42777,4.291002106530244,60.0,20.0
39969,3,9969,[273 181 118  98 258],805,1,42778,4.290672016048145,0.0,40.0
39970,3,9970,[181 294  56 143 121],642,5,42783,4.290743155149935,0.0,20.0
39971,3,9971,[ 64 318 313 301  11],345,5,42788,4.290814279983955,60.0,20.0
39972,3,9972,[ 64 318 313 301  11],345,5,42793,4.2908853905544975,60.0,20.0
39973,3,9973,[245 322 179  56 182],416,2,42795,4.290655704832565,0.0,0.0
39974,3,9974,[ 82 181 196 302 121],416,5,42800,4.290726817042606,0.0,20.0
39975,3,9975,[423 301  79 237 191],43,5,42805,4.2907979149959905,0.0,0.0
39976,3,9976,[475 471 235 423 182],416,3,42808,4.290668537636564,0.0,0.0
39977,3,9977,[ 64 318 313 301  11],43,5,42813,4.2907396271797955,60.0,20.0
39978,3,9978,[ 64 318 313 301  11],345,5,42818,4.290810702475198,60.0,20.0
39979,3,9979,[603 168 423 153 194],854,4,42822,4.290781563126252,0.0,0.0
39980,3,9980,[302 546  56 496 216],654,5,42827,4.290852619977958,0.0,0.0
39981,3,9981,[180 216 191 100 181],805,2,42829,4.290623121618914,0.0,20.0
39982,3,9982,[ 64 318 313 301  11],416,5,42834,4.290694180106181,60.0,20.0
39983,3,9983,[546 385 197 258 202],805,1,42835,4.290364583333333,0.0,0.0
39984,3,9984,[195 235 127 222  82],805,1,42836,4.290035052578868,0.0,0.0
39985,3,9985,[385  25  82 294 204],230,3,42839,4.289905868215501,0.0,0.0
39986,3,9986,[ 64 318 313 301  11],416,5,42844,4.28997697006108,60.0,20.0
39987,3,9987,[475 258 405 273 333],416,4,42848,4.28994793752503,0.0,0.0
39988,3,9988,[ 56 186 135  97 173],642,4,42852,4.289918910801882,0.0,0.0
39989,3,9989,[357 508 151  64   8],62,5,42857,4.28998998998999,20.0,0.0
39990,3,9990,[210 202 403 200 173],922,2,42859,4.289760784706235,0.0,0.0
39991,3,9991,[318 322 276  95 176],416,2,42861,4.28953162530024,20.0,0.0
39992,3,9992,[143 385 286   4 515],416,5,42866,4.289602721905334,0.0,0.0
39993,3,9993,[ 64 318 313 301  11],345,5,42871,4.28967380428257,60.0,20.0
39994,3,9994,[427 143 318 196 168],198,3,42874,4.2895447723861935,20.0,0.0
39995,3,9995,[118  15 318 196  12],416,4,42878,4.289515806322529,40.0,0.0
39996,3,9996,[ 64 318 313 301  11],345,5,42883,4.289586876062819,60.0,20.0
39997,3,9997,[ 64 318 313 301  11],416,5,42888,4.2896579315863175,60.0,20.0
39998,3,9998,[ 64 318 313 301  11],416,5,42893,4.28972897289729,60.0,20.0
39999,3,9999,[118 222  12 180 238],805,3,42896,4.2896,20.0,0.0
40000,4,0,[568 153 125 168 173],642,4,4,4.0,0.0,0.0
40001,4,1,[210 302 258 194 427],416,5,9,4.5,0.0,0.0
40002,4,2,[655 172 257   7  98],416,4,13,4.333333333333333,0.0,20.0
40003,4,3,[172 568  98 168 125],416,5,18,4.5,0.0,20.0
40004,4,4,[172 568  98 168 125],588,3,21,4.2,0.0,20.0
40005,4,5,[172 210 168 173 655],416,5,26,4.333333333333333,0.0,0.0
40006,4,6,[172 210 168 173 655],417,3,29,4.142857142857143,0.0,0.0
40007,4,7,[322 302 100  22 183],416,4,33,4.125,0.0,0.0
40008,4,8,[ 22 568 168 173 427],642,4,37,4.111111111111111,0.0,0.0
40009,4,9,[204 200 174 496 182],618,4,41,4.1,0.0,0.0
40010,4,10,[173 168 194 258 655],416,5,46,4.181818181818182,0.0,0.0
40011,4,11,[173 168 194 258 655],416,5,51,4.25,0.0,0.0
40012,4,12,[ 15 423 194  28 144],342,2,53,4.076923076923077,0.0,0.0
40013,4,13,[215  82 385 357  71],416,5,58,4.142857142857143,0.0,0.0
40014,4,14,[ 79 238 215 275 568],43,4,62,4.133333333333334,0.0,0.0
40015,4,15,[258  82 100  71  22],416,5,67,4.1875,0.0,0.0
40016,4,16,[258  82 100  71  22],654,3,70,4.117647058823529,0.0,0.0
40017,4,17,[258 173  22   7 275],297,5,75,4.166666666666667,0.0,0.0
40018,4,18,[ 69  98  12 222 181],62,5,80,4.2105263157894735,20.0,40.0
40019,4,19,[181  82 302   7 275],43,5,85,4.25,0.0,20.0
40020,4,20,[216  96 174  25 172],805,3,88,4.190476190476191,0.0,0.0
40021,4,21,[423 144 302   7 275],43,5,93,4.2272727272727275,0.0,0.0
40022,4,22,[195 127 173 183   4],405,4,97,4.217391304347826,0.0,0.0
40023,4,23,[ 50 742 121 238 546],417,1,98,4.083333333333333,0.0,20.0
40024,4,24,[ 95 215  64 323 132],198,3,101,4.04,20.0,0.0
40025,4,25,[168   9 121 742 161],43,5,106,4.076923076923077,0.0,0.0
40026,4,26,[200 182 275   4  69],297,1,107,3.962962962962963,0.0,0.0
40027,4,27,[ 82  95  69 117 271],505,4,111,3.9642857142857144,0.0,0.0
40028,4,28,[ 25 210  79  69 153],198,3,114,3.9310344827586206,0.0,0.0
40029,4,29,[135 172 275 257 125],62,4,118,3.933333333333333,0.0,0.0
40030,4,30,[ 25 423  50 568 496],711,3,121,3.903225806451613,0.0,20.0
40031,4,31,[ 12 313 237 238  88],345,5,126,3.9375,40.0,20.0
40032,4,32,[168  96 496 313 161],618,4,130,3.9393939393939394,20.0,20.0
40033,4,33,[127 405 289  11 313],416,4,134,3.9411764705882355,20.0,20.0
40034,4,34,[179  96 211 275  89],373,4,138,3.942857142857143,0.0,0.0
40035,4,35,[191 568 276 742  64],630,3,141,3.9166666666666665,20.0,0.0
40036,4,36,[ 95   1 222 357  22],805,3,144,3.891891891891892,0.0,0.0
40037,4,37,[  1 185  11 475 423],417,4,148,3.8947368421052633,0.0,0.0
40038,4,38,[496 258 211 161 215],43,5,153,3.923076923076923,0.0,0.0
40039,4,39,[748 282 268  11 257],654,3,156,3.9,0.0,0.0
40040,4,40,[655  11 313  88 211],405,3,159,3.8780487804878048,20.0,20.0
40041,4,41,[194 318 435 195 183],96,3,162,3.857142857142857,20.0,0.0
40042,4,42,[144 313  64  12 496],43,5,167,3.883720930232558,60.0,20.0
40043,4,43,[ 22 185 144  28 176],618,5,172,3.909090909090909,0.0,0.0
40044,4,44,[168 196 132  71 318],618,5,177,3.933333333333333,20.0,0.0
40045,4,45,[357  11 475 313 176],416,4,181,3.9347826086956523,20.0,20.0
40046,4,46,[357  12 313 176 161],405,3,184,3.9148936170212765,40.0,20.0
40047,4,47,[268 153  56 300 385],654,4,188,3.9166666666666665,0.0,0.0
40048,4,48,[357 300  12 313  56],416,5,193,3.938775510204082,40.0,20.0
40049,4,49,[168 238 117 515  79],297,4,197,3.94,0.0,0.0
40050,4,50,[357  89 300 181 258],198,4,201,3.9411764705882355,0.0,20.0
40051,4,51,[357 302 181 258 215],297,4,205,3.9423076923076925,0.0,20.0
40052,4,52,[357 117 313 181 258],642,3,208,3.9245283018867925,20.0,40.0
40053,4,53,[748 111 405  95  12],654,5,213,3.9444444444444446,20.0,0.0
40054,4,54,[322  25  95 216 215],314,3,216,3.9272727272727272,0.0,0.0
40055,4,55,[238 475 423 271 286],854,4,220,3.9285714285714284,0.0,0.0
40056,4,56,[405 655 275   7 496],416,5,225,3.9473684210526314,0.0,0.0
40057,4,57,[268   9 197 202 257],354,2,227,3.913793103448276,0.0,0.0
40058,4,58,[257 655 423  98 187],887,2,229,3.8813559322033897,0.0,20.0
40059,4,59,[568 294 173 196 300],43,5,234,3.9,0.0,0.0
40060,4,60,[215 161 237 655 286],345,3,237,3.8852459016393444,0.0,0.0
40061,4,61,[196 275 117 271 144],297,3,240,3.870967741935484,0.0,0.0
40062,4,62,[196   1   7 117 496],416,5,245,3.888888888888889,0.0,0.0
40063,4,63,[216 172 174 385 258],198,4,249,3.890625,0.0,0.0
40064,4,64,[196 313 275   7 117],416,5,254,3.9076923076923076,20.0,20.0
40065,4,65,[196 313 275   7 117],416,5,259,3.9242424242424243,20.0,20.0
40066,4,66,[  1 268 185  11 210],297,4,263,3.925373134328358,0.0,0.0
40067,4,67,[118 294  71   9 289],345,1,264,3.8823529411764706,0.0,0.0
40068,4,68,[196 222 275   7 117],297,5,269,3.898550724637681,0.0,0.0
40069,4,69,[186  50 742  71 276],128,4,273,3.9,0.0,20.0
40070,4,70,[183 210  98 118 748],416,4,277,3.9014084507042255,0.0,20.0
40071,4,71,[  7 742 265  71  98],230,4,281,3.9027777777777777,0.0,20.0
40072,4,72,[275 195 168 132 135],854,4,285,3.904109589041096,0.0,0.0
40073,4,73,[153 111 357 211   1],417,4,289,3.9054054054054053,0.0,0.0
40074,4,74,[423   9 168 597 318],887,3,292,3.8933333333333335,20.0,0.0
40075,4,75,[117  89 173 275 597],854,3,295,3.8815789473684212,0.0,0.0
40076,4,76,[186 173 179 180 185],437,4,299,3.883116883116883,0.0,0.0
40077,4,77,[195 300 228 405  56],198,1,300,3.8461538461538463,0.0,0.0
40078,4,78,[318 496 173 302 127],214,5,305,3.8607594936708862,20.0,0.0
40079,4,79,[318 496 173 302 127],416,5,310,3.875,20.0,0.0
40080,4,80,[483 228 238 135 748],417,3,313,3.8641975308641974,20.0,0.0
40081,4,81,[186 185 135 181   9],601,5,318,3.8780487804878048,0.0,20.0
40082,4,82,[318  89 222 173 127],62,5,323,3.891566265060241,20.0,0.0
40083,4,83,[318  89 222 173 127],854,5,328,3.9047619047619047,20.0,0.0
40084,4,84,[318  89 222 173 127],854,5,333,3.9176470588235293,20.0,0.0
40085,4,85,[302 588  11 172 748],345,3,336,3.9069767441860463,0.0,0.0
40086,4,86,[179   1 185 678 268],416,3,339,3.896551724137931,0.0,0.0
40087,4,87,[183 100 475 546   7],297,4,343,3.897727272727273,0.0,0.0
40088,4,88,[568 161 546 655 118],416,3,346,3.8876404494382024,0.0,0.0
40089,4,89,[318  89 173 222 127],198,4,350,3.888888888888889,20.0,0.0
40090,4,90,[318 515 127 196 313],405,3,353,3.879120879120879,40.0,20.0
40091,4,91,[318 173 275 313 237],43,5,358,3.891304347826087,40.0,20.0
40092,4,92,[318 173 275 313 237],416,4,362,3.89247311827957,40.0,20.0
40093,4,93,[288 257 357 603 195],854,3,365,3.882978723404255,0.0,20.0
40094,4,94,[ 56  11  64 496 181],262,4,369,3.8842105263157896,20.0,20.0
40095,4,95,[ 56  11  64 496  89],214,5,374,3.8958333333333335,20.0,0.0
40096,4,96,[ 56  11  64 496  89],417,4,378,3.8969072164948453,20.0,0.0
40097,4,97,[ 56  11  64  89 288],417,4,382,3.8979591836734695,20.0,20.0
40098,4,98,[ 56 483  89 302 318],62,4,386,3.898989898989899,40.0,0.0
40099,4,99,[268 588 323 180 322],417,2,388,3.88,0.0,0.0
40100,4,100,[ 71  95 204  12 318],373,5,393,3.891089108910891,40.0,0.0
40101,4,101,[196 318 302 238 322],416,4,397,3.892156862745098,20.0,0.0
40102,4,102,[318  82 173 313  11],618,4,401,3.8932038834951457,40.0,20.0
40103,4,103,[318 197 313  11  12],618,4,405,3.894230769230769,60.0,20.0
40104,4,104,[403 191 568 195  97],417,4,409,3.895238095238095,0.0,0.0
40105,4,105,[ 97  64 275 403 180],373,2,411,3.8773584905660377,20.0,0.0
40106,4,106,[301 289 323  15 191],416,3,414,3.869158878504673,0.0,0.0
40107,4,107,[125 202 313  88 423],618,3,417,3.861111111111111,20.0,20.0
40108,4,108,[132  56  12 168  64],405,4,421,3.8623853211009176,40.0,0.0
40109,4,109,[286 257 222 111 216],711,2,423,3.8454545454545452,0.0,0.0
40110,4,110,[211  11 427 172 597],416,4,427,3.8468468468468466,0.0,0.0
40111,4,111,[ 12 187 318 313 483],618,5,432,3.857142857142857,80.0,20.0
40112,4,112,[ 22  98 265  79 183],405,3,435,3.849557522123894,0.0,20.0
40113,4,113,[385 471 202 294 118],43,4,439,3.8508771929824563,0.0,0.0
40114,4,114,[132  64  12 483 275],618,4,443,3.8521739130434782,60.0,0.0
40115,4,115,[132 127  12 483 313],214,5,448,3.8620689655172415,60.0,20.0
40116,4,116,[132 127  12 483 313],618,5,453,3.871794871794872,60.0,20.0
40117,4,117,[180 294 176 423 228],417,4,457,3.8728813559322033,0.0,0.0
40118,4,118,[568 204 268  56 328],128,2,459,3.857142857142857,0.0,0.0
40119,4,119,[ 89 483  82 301 318],437,2,461,3.841666666666667,40.0,0.0
40120,4,120,[132 187 127 313  11],618,5,466,3.8512396694214877,20.0,20.0
40121,4,121,[132 187 127 313  11],214,5,471,3.860655737704918,20.0,20.0
40122,4,122,[132 187 127 313  11],618,5,476,3.869918699186992,20.0,20.0
40123,4,123,[132 187 127 313  11],214,5,481,3.879032258064516,20.0,20.0
40124,4,124,[132 187 127 313  11],405,5,486,3.888,20.0,20.0
40125,4,125,[132 187 127 313  11],214,5,491,3.8968253968253967,20.0,20.0
40126,4,126,[132 187 127 313  11],214,5,496,3.905511811023622,20.0,20.0
40127,4,127,[132 187 127 313  11],416,5,501,3.9140625,20.0,20.0
40128,4,128,[132 187 127 313  11],214,5,506,3.9224806201550386,20.0,20.0
40129,4,129,[132 187 127 313  11],416,5,511,3.9307692307692306,20.0,20.0
40130,4,130,[132 187 127 313  11],416,5,516,3.9389312977099236,20.0,20.0
40131,4,131,[132 187 127 313  11],405,5,521,3.946969696969697,20.0,20.0
40132,4,132,[132 187 127 313  11],618,5,526,3.954887218045113,20.0,20.0
40133,4,133,[ 79 300  96 588 100],751,4,530,3.955223880597015,0.0,0.0
40134,4,134,[132  11 318  12  64],214,5,535,3.962962962962963,60.0,0.0
40135,4,135,[132  11 318  12  64],618,5,540,3.9705882352941178,60.0,0.0
40136,4,136,[132  11 318  12  64],345,5,545,3.978102189781022,60.0,0.0
40137,4,137,[132  11 318  12  64],214,5,550,3.9855072463768115,60.0,0.0
40138,4,138,[132  11 318  12  64],214,5,555,3.9928057553956835,60.0,0.0
40139,4,139,[132  11 318  12  64],214,5,560,4.0,60.0,0.0
40140,4,140,[132  11 318  12  64],854,5,565,4.00709219858156,60.0,0.0
40141,4,141,[132  11 318  12  64],405,5,570,4.014084507042254,60.0,0.0
40142,4,142,[132  11 318  12  64],214,5,575,4.020979020979021,60.0,0.0
40143,4,143,[294 185 216 182  28],416,5,580,4.027777777777778,0.0,0.0
40144,4,144,[127  12  64 132 313],416,5,585,4.0344827586206895,60.0,20.0
40145,4,145,[423 427 323  28   7],416,4,589,4.034246575342466,0.0,0.0
40146,4,146,[127  12  64 132 313],405,5,594,4.040816326530612,60.0,20.0
40147,4,147,[191 265  22  88 168],618,5,599,4.047297297297297,0.0,0.0
40148,4,148,[318 127 313 603 132],214,5,604,4.053691275167785,40.0,20.0
40149,4,149,[211  12 125 191   1],417,5,609,4.06,20.0,0.0
40150,4,150,[318 127 313 603 132],214,5,614,4.066225165562914,40.0,20.0
40151,4,151,[318 127 313 603 132],405,4,618,4.065789473684211,40.0,20.0
40152,4,152,[318 127 313 132  64],405,5,623,4.071895424836601,60.0,20.0
40153,4,153,[318 127 313 132  64],416,5,628,4.077922077922078,60.0,20.0
40154,4,154,[318 127 313 132  64],405,5,633,4.083870967741936,60.0,20.0
40155,4,155,[216 197  28 195 175],373,2,635,4.07051282051282,0.0,0.0
40156,4,156,[265 135 153 742  25],417,1,636,4.050955414012739,0.0,0.0
40157,4,157,[127 483 318 132  64],62,5,641,4.056962025316456,60.0,0.0
40158,4,158,[127 483 318 132  64],601,5,646,4.062893081761007,60.0,0.0
40159,4,159,[127 483 318 132  64],601,5,651,4.06875,60.0,0.0
40160,4,160,[127 483 318 132  64],601,5,656,4.074534161490683,60.0,0.0
40161,4,161,[127 483 318 132  64],618,5,661,4.080246913580247,60.0,0.0
40162,4,162,[127 483 318 132  64],214,5,666,4.085889570552148,60.0,0.0
40163,4,163,[276 151  70  15 215],654,3,669,4.079268292682927,0.0,0.0
40164,4,164,[228  89 200 655 196],805,2,671,4.066666666666666,0.0,0.0
40165,4,165,[161 196 328 143 276],416,4,675,4.066265060240964,0.0,0.0
40166,4,166,[ 70 143  12  64 132],405,4,679,4.065868263473054,40.0,0.0
40167,4,167,[216 405  69 235  79],854,3,682,4.059523809523809,0.0,0.0
40168,4,168,[127 143 132 318  64],405,5,687,4.06508875739645,40.0,0.0
40169,4,169,[ 98 143 121   4 200],805,2,689,4.052941176470588,0.0,20.0
40170,4,170,[127 483 132 318  64],618,5,694,4.058479532163743,60.0,0.0
40171,4,171,[127 483 132 318  64],214,5,699,4.063953488372093,60.0,0.0
40172,4,172,[127 483 132 318  64],62,5,704,4.069364161849711,60.0,0.0
40173,4,173,[127 483 132 318  64],601,5,709,4.074712643678161,60.0,0.0
40174,4,174,[127 483 132 318  64],618,5,714,4.08,60.0,0.0
40175,4,175,[127 483 132 318  64],62,5,719,4.0852272727272725,60.0,0.0
40176,4,176,[210 176 181 515 183],297,5,724,4.090395480225989,0.0,20.0
40177,4,177,[ 11  64 151 132 318],214,5,729,4.095505617977528,40.0,0.0
40178,4,178,[ 11  64 151 132 318],764,5,734,4.100558659217877,40.0,0.0
40179,4,179,[300 357 187 302  50],875,4,738,4.1,0.0,20.0
40180,4,180,[127 483 132 318  64],62,5,743,4.104972375690608,60.0,0.0
40181,4,181,[127 483 132 318  64],601,5,748,4.1098901098901095,60.0,0.0
40182,4,182,[127 483 132 318  64],214,5,753,4.114754098360656,60.0,0.0
40183,4,183,[ 12   4 172  28 174],43,5,758,4.119565217391305,20.0,0.0
40184,4,184,[127 483 132 318  64],214,5,763,4.124324324324324,60.0,0.0
40185,4,185,[127 483 132 318  64],601,5,768,4.129032258064516,60.0,0.0
40186,4,186,[127 483 132 318  64],253,5,773,4.133689839572193,60.0,0.0
40187,4,187,[127 483 132 318  64],253,5,778,4.138297872340425,60.0,0.0
40188,4,188,[127 483 132 318  64],618,5,783,4.142857142857143,60.0,0.0
40189,4,189,[127 483 132 318  64],601,5,788,4.147368421052631,60.0,0.0
40190,4,190,[127 483 132 318  64],618,5,793,4.151832460732984,60.0,0.0
40191,4,191,[180  89  95 161 475],417,4,797,4.151041666666667,0.0,0.0
40192,4,192,[403  12 475   8 289],588,2,799,4.139896373056994,20.0,0.0
40193,4,193,[ 12 127  64   8 151],214,5,804,4.144329896907217,40.0,0.0
40194,4,194,[ 12 127  64   8 151],601,2,806,4.133333333333334,40.0,0.0
40195,4,195,[318 215  12 276 117],654,4,810,4.13265306122449,40.0,0.0
40196,4,196,[ 11 318 313 483 187],618,5,815,4.137055837563452,60.0,20.0
40197,4,197,[ 11 318 313 483 187],618,5,820,4.141414141414141,60.0,20.0
40198,4,198,[ 11 318 313 483 187],618,5,825,4.1457286432160805,60.0,20.0
40199,4,199,[111 185 196 197 234],805,3,828,4.14,0.0,0.0
40200,4,200,[ 11 483  64 132 318],214,5,833,4.144278606965174,60.0,0.0
40201,4,201,[202  11 300 204  12],297,2,835,4.133663366336633,20.0,0.0
40202,4,202,[ 11 483 234 132  64],618,5,840,4.137931034482759,40.0,0.0
40203,4,203,[333 204 301 144 288],416,5,845,4.142156862745098,0.0,20.0
40204,4,204,[ 64 187 234 318 127],96,5,850,4.146341463414634,40.0,0.0
40205,4,205,[603 174  25 471 176],416,5,855,4.150485436893204,0.0,0.0
40206,4,206,[132 483 234 333 318],588,5,860,4.154589371980676,40.0,0.0
40207,4,207,[172 186 168  88 238],373,5,865,4.158653846153846,0.0,0.0
40208,4,208,[132 483 234 333 318],588,5,870,4.162679425837321,40.0,0.0
40209,4,209,[235 228 144 132  64],417,2,872,4.152380952380953,20.0,0.0
40210,4,210,[132 483 234 333 318],588,5,877,4.156398104265403,40.0,0.0
40211,4,211,[132 483 234 333 318],588,5,882,4.160377358490566,40.0,0.0
40212,4,212,[132 483 234 333 318],588,5,887,4.164319248826291,40.0,0.0
40213,4,213,[235  56  50  25 286],416,4,891,4.163551401869159,0.0,20.0
40214,4,214,[132 483 234 333 318],588,5,896,4.167441860465116,40.0,0.0
40215,4,215,[132 483 234 333 318],253,4,900,4.166666666666667,40.0,0.0
40216,4,216,[235  70   9  11 172],345,4,904,4.1658986175115205,0.0,0.0
40217,4,217,[132 234  64 127 318],253,5,909,4.169724770642202,40.0,0.0
40218,4,218,[475  69  15 234 186],417,4,913,4.168949771689498,0.0,0.0
40219,4,219,[237 197 118 144 176],618,3,916,4.163636363636364,0.0,0.0
40220,4,220,[174 269 111   7 318],262,3,919,4.158371040723982,20.0,0.0
40221,4,221,[313 187  64 234 132],405,5,924,4.162162162162162,40.0,20.0
40222,4,222,[313 187  64 234 132],618,5,929,4.165919282511211,40.0,20.0
40223,4,223,[313 187  64 234 132],416,5,934,4.169642857142857,40.0,20.0
40224,4,224,[313 187  64 234 132],405,5,939,4.173333333333333,40.0,20.0
40225,4,225,[313 187  64 234 132],416,5,944,4.176991150442478,40.0,20.0
40226,4,226,[288 172  50   8 423],588,4,948,4.176211453744493,0.0,40.0
40227,4,227,[ 64 127 318 132 234],405,5,953,4.1798245614035086,40.0,0.0
40228,4,228,[ 64 127 318 132 234],601,4,957,4.179039301310044,40.0,0.0
40229,4,229,[ 64 127 318 132 313],405,5,962,4.182608695652174,60.0,20.0
40230,4,230,[405  28  97 161 268],416,5,967,4.186147186147186,0.0,0.0
40231,4,231,[603 302 185 132   8],416,5,972,4.189655172413793,0.0,0.0
40232,4,232,[ 98 568 385 132 238],417,4,976,4.1888412017167385,0.0,20.0
40233,4,233,[187 127 313 132  11],416,5,981,4.1923076923076925,20.0,20.0
40234,4,234,[187 127 313 132  11],214,5,986,4.195744680851064,20.0,20.0
40235,4,235,[187 127 313 132  11],405,5,991,4.1991525423728815,20.0,20.0
40236,4,236,[187 127 313 132  11],214,5,996,4.2025316455696204,20.0,20.0
40237,4,237,[187 127 313 132  11],405,5,1001,4.205882352941177,20.0,20.0
40238,4,238,[187 127 313 132  11],618,5,1006,4.2092050209205025,20.0,20.0
40239,4,239,[111 161 210 195 211],416,5,1011,4.2125,0.0,0.0
40240,4,240,[187 127 313 132  11],416,5,1016,4.215767634854772,20.0,20.0
40241,4,241,[187 127 313 132  11],505,3,1019,4.210743801652892,20.0,20.0
40242,4,242,[483  64 313 132  11],618,5,1024,4.2139917695473255,60.0,20.0
40243,4,243,[515 174 176 357 195],417,4,1028,4.213114754098361,0.0,0.0
40244,4,244,[ 64 197  88 471   8],618,2,1030,4.204081632653061,20.0,0.0
40245,4,245,[483 318  64 313 132],214,5,1035,4.2073170731707314,80.0,20.0
40246,4,246,[257 603  12 175 182],214,4,1039,4.206477732793522,20.0,0.0
40247,4,247,[143  79 603 127 144],416,5,1044,4.209677419354839,0.0,0.0
40248,4,248,[ 64  11 483 318 132],496,3,1047,4.204819277108434,60.0,0.0
40249,4,249,[161 125 265 234 257],417,2,1049,4.196,0.0,0.0
40250,4,250,[ 96 323  97 273 195],416,4,1053,4.195219123505976,0.0,0.0
40251,4,251,[318 273 313 483  11],618,5,1058,4.198412698412699,60.0,20.0
40252,4,252,[168 216  56 471 328],854,2,1060,4.189723320158103,0.0,0.0
40253,4,253,[318 273 313 483  11],618,5,1065,4.192913385826771,60.0,20.0
40254,4,254,[318 273 313 483  11],618,5,1070,4.196078431372549,60.0,20.0
40255,4,255,[318 273 313 483  11],618,5,1075,4.19921875,60.0,20.0
40256,4,256,[ 50 282   1  25  69],764,3,1078,4.19455252918288,0.0,20.0
40257,4,257,[ 11 483 318 313 273],618,5,1083,4.1976744186046515,60.0,20.0
40258,4,258,[ 11 483 318 313 273],618,5,1088,4.2007722007722,60.0,20.0
40259,4,259,[ 11 483 318 313 273],618,5,1093,4.203846153846154,60.0,20.0
40260,4,260,[127 143  70 151 403],373,2,1095,4.195402298850575,0.0,0.0
40261,4,261,[202 132 742  22 300],505,4,1099,4.194656488549619,0.0,0.0
40262,4,262,[ 11 273 313 483 318],618,5,1104,4.197718631178708,60.0,20.0
40263,4,263,[ 11 273 313 483 318],618,5,1109,4.200757575757576,60.0,20.0
40264,4,264,[ 64  70 403   7 276],416,4,1113,4.2,20.0,0.0
40265,4,265,[176 238 403 257 186],417,4,1117,4.1992481203007515,0.0,0.0
40266,4,266,[268 100  79  12  50],416,5,1122,4.202247191011236,20.0,20.0
40267,4,267,[597 216  82 200 172],805,2,1124,4.1940298507462686,0.0,0.0
40268,4,268,[313 483  11 318 273],618,5,1129,4.197026022304833,60.0,20.0
40269,4,269,[ 50 175 238 216 100],297,5,1134,4.2,0.0,20.0
40270,4,270,[288 234 196 118  79],805,2,1136,4.191881918819188,0.0,20.0
40271,4,271,[313 118 405 323  25],674,3,1139,4.1875,20.0,20.0
40272,4,272,[273 318 313 483  11],618,5,1144,4.190476190476191,60.0,20.0
40273,4,273,[323 294 385 289  71],43,4,1148,4.189781021897811,0.0,0.0
40274,4,274,[168  79 191 182 235],297,1,1149,4.178181818181818,0.0,0.0
40275,4,275,[195 318 269 385 546],262,1,1150,4.166666666666667,20.0,0.0
40276,4,276,[655 173  88 286 125],416,4,1154,4.166064981949458,0.0,0.0
40277,4,277,[127 195 132  89 173],373,3,1157,4.161870503597123,0.0,0.0
40278,4,278,[ 98 483  50  15 427],618,4,1161,4.161290322580645,20.0,40.0
40279,4,279,[475  69 210  64 742],417,2,1163,4.1535714285714285,20.0,0.0
40280,4,280,[186 258  56 286 202],588,4,1167,4.153024911032029,0.0,0.0
40281,4,281,[385 173 168 318 153],642,3,1170,4.148936170212766,20.0,0.0
40282,4,282,[153  70 423 100  56],297,4,1174,4.148409893992933,0.0,0.0
40283,4,283,[183 423 597 216 238],62,3,1177,4.144366197183099,0.0,0.0
40284,4,284,[151 357 179 204  12],601,2,1179,4.136842105263158,20.0,0.0
40285,4,285,[403   7 322  79  64],416,4,1183,4.136363636363637,20.0,0.0
40286,4,286,[318 483 475 125 357],854,4,1187,4.13588850174216,40.0,0.0
40287,4,287,[483 313  11 273 318],618,5,1192,4.138888888888889,60.0,20.0
40288,4,288,[176 185 313 127 183],405,3,1195,4.134948096885813,20.0,20.0
40289,4,289,[ 64 144 143 181   8],416,5,1200,4.137931034482759,20.0,20.0
40290,4,290,[173 216  64 273  50],416,5,1205,4.140893470790378,20.0,20.0
40291,4,291,[173 191 176 196 197],416,5,1210,4.1438356164383565,0.0,0.0
40292,4,292,[ 64  69 655 153 187],198,5,1215,4.146757679180888,20.0,0.0
40293,4,293,[196 127   1 172 179],417,4,1219,4.14625850340136,0.0,0.0
40294,4,294,[  1  50 117 202 172],642,4,1223,4.145762711864407,0.0,20.0
40295,4,295,[173 197  95 603 168],437,4,1227,4.14527027027027,0.0,0.0
40296,4,296,[483 313  11 273 318],618,5,1232,4.148148148148148,60.0,20.0
40297,4,297,[245 546 121 118 222],417,2,1234,4.140939597315437,0.0,0.0
40298,4,298,[ 89 196 202 228 655],373,4,1238,4.1404682274247495,0.0,0.0
40299,4,299,[  4 357 271 475  50],62,4,1242,4.14,0.0,20.0
40300,4,300,[  7   1 143 300 196],751,2,1244,4.132890365448505,0.0,0.0
40301,4,301,[161 282 222 132 118],588,3,1247,4.129139072847682,0.0,0.0
40302,4,302,[508 496 168 211  56],417,3,1250,4.125412541254126,0.0,0.0
40303,4,303,[173 294 597 222 135],417,2,1252,4.118421052631579,0.0,0.0
40304,4,304,[144  12 196   7 257],314,3,1255,4.114754098360656,20.0,0.0
40305,4,305,[202 273 174 187 172],416,5,1260,4.117647058823529,0.0,0.0
40306,4,306,[568 286 655 202 269],373,3,1263,4.11400651465798,0.0,0.0
40307,4,307,[174 210 172 151 111],654,5,1268,4.116883116883117,0.0,0.0
40308,4,308,[423 288 258 323 197],416,4,1272,4.116504854368932,0.0,20.0
40309,4,309,[ 97 423   4 603 153],373,3,1275,4.112903225806452,0.0,0.0
40310,4,310,[202 144   7  79 161],588,2,1277,4.106109324758842,0.0,0.0
40311,4,311,[268  96 151 197 289],854,2,1279,4.0993589743589745,0.0,0.0
40312,4,312,[300  79 294  89 168],297,2,1281,4.092651757188499,0.0,0.0
40313,4,313,[194 275 423 211 245],416,4,1285,4.092356687898089,0.0,0.0
40314,4,314,[196 181  50  25 588],654,3,1288,4.088888888888889,0.0,40.0
40315,4,315,[173 423 403 179  12],405,4,1292,4.0886075949367084,20.0,0.0
40316,4,316,[313 483  11 273 318],618,5,1297,4.091482649842272,60.0,20.0
40317,4,317,[121 222 173 183 191],601,4,1301,4.091194968553459,0.0,0.0
40318,4,318,[216 197 603  70 289],416,4,1305,4.090909090909091,0.0,0.0
40319,4,319,[403  25 121 275 144],618,3,1308,4.0875,0.0,0.0
40320,4,320,[ 11 273 313 483 318],618,5,1313,4.090342679127726,60.0,20.0
40321,4,321,[ 11 273 313 483 318],618,5,1318,4.093167701863354,60.0,20.0
40322,4,322,[ 56 118 333 182 191],416,4,1322,4.0928792569659445,0.0,0.0
40323,4,323,[127 174  22 151 235],854,2,1324,4.08641975308642,0.0,0.0
40324,4,324,[483 273 313  11 318],618,5,1329,4.0892307692307694,60.0,20.0
40325,4,325,[ 97   4 197 275 186],618,2,1331,4.08282208588957,0.0,0.0
40326,4,326,[ 11 273 483 313 318],618,5,1336,4.085626911314985,60.0,20.0
40327,4,327,[  7 181   4 200 271],805,2,1338,4.079268292682927,0.0,20.0
40328,4,328,[ 11 483 313 273 318],618,5,1343,4.0820668693009114,60.0,20.0
40329,4,329,[ 11 483 313 273 318],618,5,1348,4.084848484848485,60.0,20.0
40330,4,330,[ 11 483 313 273 318],618,5,1353,4.087613293051359,60.0,20.0
40331,4,331,[ 64 268  70 216  69],416,5,1358,4.090361445783133,20.0,0.0
40332,4,332,[ 11 483 313 273 318],618,5,1363,4.093093093093093,60.0,20.0
40333,4,333,[125 195 127 273 197],854,3,1366,4.089820359281437,0.0,0.0
40334,4,334,[313 483  11 273 318],618,5,1371,4.092537313432836,60.0,20.0
40335,4,335,[196 257  79 678 151],541,4,1375,4.092261904761905,0.0,0.0
40336,4,336,[ 11 483 313 273 318],618,5,1380,4.094955489614243,60.0,20.0
40337,4,337,[173 210  56 202 588],405,4,1384,4.094674556213017,0.0,0.0
40338,4,338,[483 313 273  11 318],618,5,1389,4.097345132743363,60.0,20.0
40339,4,339,[191 153 302 257  28],297,3,1392,4.094117647058823,0.0,0.0
40340,4,340,[403  25 135 265 100],198,2,1394,4.087976539589443,0.0,0.0
40341,4,341,[ 11 194 100 216 282],342,3,1397,4.084795321637427,0.0,0.0
40342,4,342,[ 11 273 313 483 318],618,5,1402,4.087463556851312,60.0,20.0
40343,4,343,[ 56 603 216 143 197],405,3,1405,4.084302325581396,0.0,0.0
40344,4,344,[ 11 273 313 483 318],618,5,1410,4.086956521739131,60.0,20.0
40345,4,345,[228 273 238   4  25],805,2,1412,4.08092485549133,0.0,0.0
40346,4,346,[475 655 588 174 405],417,2,1414,4.07492795389049,0.0,0.0
40347,4,347,[471   4 176 173 181],297,3,1417,4.07183908045977,0.0,20.0
40348,4,348,[ 11 483 313 318  64],214,5,1422,4.074498567335244,80.0,20.0
40349,4,349,[151 185 196 143  71],437,4,1426,4.074285714285714,0.0,0.0
40350,4,350,[235   1 173 423 151],43,4,1430,4.074074074074074,0.0,0.0
40351,4,351,[289   4 173 294  89],854,2,1432,4.068181818181818,0.0,0.0
40352,4,352,[483 313  11 318  64],214,5,1437,4.070821529745042,80.0,20.0
40353,4,353,[  8 475 471 173  89],854,4,1441,4.070621468926554,0.0,0.0
40354,4,354,[588 568 181  98 300],43,5,1446,4.073239436619718,0.0,40.0
40355,4,355,[313 483  11 318  64],618,5,1451,4.075842696629214,80.0,20.0
40356,4,356,[313 483  11 318  64],618,5,1456,4.078431372549019,80.0,20.0
40357,4,357,[313 483  11 318  64],618,5,1461,4.081005586592179,80.0,20.0
40358,4,358,[313 483  11 318  64],618,5,1466,4.0835654596100275,80.0,20.0
40359,4,359,[118 403 245 181 182],62,3,1469,4.080555555555556,0.0,20.0
40360,4,360,[313 483  11 318  64],214,5,1474,4.083102493074792,80.0,20.0
40361,4,361,[313 483  11 318  64],618,5,1479,4.085635359116022,80.0,20.0
40362,4,362,[546 235  15 202 174],417,2,1481,4.079889807162535,0.0,0.0
40363,4,363,[ 82  79 125 173  50],505,1,1482,4.071428571428571,0.0,20.0
40364,4,364,[ 71 427 385 286 191],416,5,1487,4.073972602739726,0.0,0.0
40365,4,365,[313 483  11 318  64],618,5,1492,4.076502732240437,80.0,20.0
40366,4,366,[313 483  11 318  64],214,5,1497,4.079019073569483,80.0,20.0
40367,4,367,[313 483  11 318  64],214,5,1502,4.081521739130435,80.0,20.0
40368,4,368,[313 483  11 318  64],214,5,1507,4.084010840108401,80.0,20.0
40369,4,369,[313 483  11 318  64],214,5,1512,4.0864864864864865,80.0,20.0
40370,4,370,[313 483  11 318  64],214,5,1517,4.0889487870619945,80.0,20.0
40371,4,371,[275 508 182 405 172],128,4,1521,4.088709677419355,0.0,0.0
40372,4,372,[210 597 181  69 196],654,4,1525,4.088471849865952,0.0,20.0
40373,4,373,[196 238  96 235 187],416,4,1529,4.088235294117647,0.0,0.0
40374,4,374,[ 11 313 483 318  64],618,5,1534,4.0906666666666665,80.0,20.0
40375,4,375,[ 70 202 191 181  96],373,4,1538,4.090425531914893,0.0,20.0
40376,4,376,[385 143 180  82 357],198,1,1539,4.082228116710875,0.0,0.0
40377,4,377,[288 294 273 322 515],416,4,1543,4.082010582010582,0.0,20.0
40378,4,378,[313  11 483 318  64],214,5,1548,4.084432717678101,80.0,20.0
40379,4,379,[313  11 483 318  64],618,5,1553,4.086842105263158,80.0,20.0
40380,4,380,[  8  95  50 423 174],541,4,1557,4.086614173228346,0.0,20.0
40381,4,381,[294 588 118 300 173],297,2,1559,4.0811518324607325,0.0,0.0
40382,4,382,[ 98 143 385 276  97],654,3,1562,4.078328981723238,0.0,20.0
40383,4,383,[ 11 313 483 318  64],214,5,1567,4.080729166666667,80.0,20.0
40384,4,384,[257 289 508   9 405],854,3,1570,4.077922077922078,0.0,0.0
40385,4,385,[483 313  11 318  64],214,5,1575,4.080310880829016,80.0,20.0
40386,4,386,[483 313  11 318  64],214,5,1580,4.082687338501292,80.0,20.0
40387,4,387,[483 313  11 318  64],214,5,1585,4.085051546391752,80.0,20.0
40388,4,388,[111 125  79 228  70],417,2,1587,4.079691516709511,0.0,0.0
40389,4,389,[483 313  11 318  64],618,5,1592,4.082051282051282,80.0,20.0
40390,4,390,[483 313  11 318  64],618,5,1597,4.084398976982097,80.0,20.0
40391,4,391,[483 313  11 318  64],618,5,1602,4.086734693877551,80.0,20.0
40392,4,392,[ 69 191 215 132 405],128,3,1605,4.083969465648855,0.0,0.0
40393,4,393,[ 97 195   9 302  22],416,5,1610,4.086294416243655,0.0,0.0
40394,4,394,[483 313  11 318  64],214,5,1615,4.0886075949367084,80.0,20.0
40395,4,395,[483 313  11 318  64],618,5,1620,4.090909090909091,80.0,20.0
40396,4,396,[483 313  11 318  64],618,5,1625,4.093198992443325,80.0,20.0
40397,4,397,[483 313  11 318  64],214,5,1630,4.0954773869346734,80.0,20.0
40398,4,398,[276 318 257 118 183],601,3,1633,4.0927318295739346,20.0,0.0
40399,4,399,[300 195  28 210 191],698,3,1636,4.09,0.0,0.0
40400,4,400,[313 483  11 318  64],214,5,1641,4.092269326683292,80.0,20.0
40401,4,401,[ 22 286   9 183  28],62,3,1644,4.08955223880597,0.0,0.0
40402,4,402,[313 483  11 318  64],214,5,1649,4.091811414392059,80.0,20.0
40403,4,403,[234  82 186 222 181],417,3,1652,4.089108910891089,0.0,20.0
40404,4,404,[202 742 216 118  95],38,4,1656,4.088888888888889,0.0,0.0
40405,4,405,[269 191 257 211 125],416,4,1660,4.088669950738916,0.0,0.0
40406,4,406,[483 313  11 318  64],214,5,1665,4.090909090909091,80.0,20.0
40407,4,407,[483 313  11 318  64],214,5,1670,4.0931372549019605,80.0,20.0
40408,4,408,[483 313  11 318  64],214,5,1675,4.095354523227384,80.0,20.0
40409,4,409,[268  70 333  15 176],416,5,1680,4.097560975609756,0.0,0.0
40410,4,410,[100  28 125 180 121],62,4,1684,4.097323600973236,0.0,0.0
40411,4,411,[313  11 483 318  64],618,5,1689,4.099514563106796,80.0,20.0
40412,4,412,[ 12 313 603 181 286],416,5,1694,4.101694915254237,40.0,40.0
40413,4,413,[385 228 210 748 180],373,3,1697,4.099033816425121,0.0,0.0
40414,4,414,[195 181  89 275 328],62,4,1701,4.098795180722892,0.0,20.0
40415,4,415,[168 135 228 294 144],230,2,1703,4.09375,0.0,0.0
40416,4,416,[405  79 183  69 210],198,3,1706,4.091127098321343,0.0,0.0
40417,4,417,[215 191 403  69 196],198,4,1710,4.090909090909091,0.0,0.0
40418,4,418,[313  11 483 318  64],214,5,1715,4.093078758949881,80.0,20.0
40419,4,419,[313  11 483 318  64],214,5,1720,4.095238095238095,80.0,20.0
40420,4,420,[313  11 483 318  64],214,5,1725,4.097387173396674,80.0,20.0
40421,4,421,[313  11 483 318  64],214,5,1730,4.099526066350711,80.0,20.0
40422,4,422,[  8 322 197 200   7],854,4,1734,4.099290780141844,0.0,0.0
40423,4,423,[597 118 111  12 181],417,2,1736,4.09433962264151,20.0,20.0
40424,4,424,[185 748 403 268 161],416,5,1741,4.096470588235294,0.0,0.0
40425,4,425,[313  11 483 318  64],618,5,1746,4.098591549295775,80.0,20.0
40426,4,426,[168  79 186 215 117],588,5,1751,4.100702576112412,0.0,0.0
40427,4,427,[313  11 483 318  64],214,5,1756,4.102803738317757,80.0,20.0
40428,4,428,[508 180 100 276 174],214,4,1760,4.102564102564102,0.0,0.0
40429,4,429,[405   1 294 196 276],62,2,1762,4.097674418604651,0.0,0.0
40430,4,430,[ 79 286 405 273   8],854,4,1766,4.0974477958236655,0.0,0.0
40431,4,431,[  9 174 273 117  88],416,4,1770,4.097222222222222,0.0,0.0
40432,4,432,[172   8 144 655 118],416,4,1774,4.096997690531178,0.0,0.0
40433,4,433,[168 234 655  82 175],405,3,1777,4.094470046082949,0.0,0.0
40434,4,434,[313  11 483 318  64],618,5,1782,4.096551724137931,80.0,20.0
40435,4,435,[216 121  15 276  69],128,5,1787,4.098623853211009,0.0,0.0
40436,4,436,[313  11 483 318  64],618,5,1792,4.100686498855835,80.0,20.0
40437,4,437,[ 98  88  28 179 603],416,3,1795,4.098173515981735,0.0,20.0
40438,4,438,[  8  28 301  95 200],297,3,1798,4.095671981776765,0.0,0.0
40439,4,439,[181 313 172  98 301],43,5,1803,4.097727272727273,20.0,60.0
40440,4,440,[174 144  95 678 588],588,2,1805,4.09297052154195,0.0,0.0
40441,4,441,[423 183 135 588 117],618,5,1810,4.095022624434389,0.0,0.0
40442,4,442,[483 313  11 318  64],618,5,1815,4.0970654627539504,80.0,20.0
40443,4,443,[483 313  11 318  64],618,5,1820,4.099099099099099,80.0,20.0
40444,4,444,[328 289 322 196 204],721,4,1824,4.098876404494382,0.0,0.0
40445,4,445,[174  12  96 181 132],62,5,1829,4.1008968609865475,20.0,20.0
40446,4,446,[483 313  11 318  64],214,5,1834,4.1029082774049215,80.0,20.0
40447,4,447,[483 313  11 318  64],618,5,1839,4.104910714285714,80.0,20.0
40448,4,448,[483 313  11 318  64],214,5,1844,4.106904231625835,80.0,20.0
40449,4,449,[ 50  25 196 127 182],198,3,1847,4.104444444444445,0.0,20.0
40450,4,450,[483 313  11 318  64],214,5,1852,4.106430155210643,80.0,20.0
40451,4,451,[268 403 273 385 127],417,4,1856,4.106194690265487,0.0,0.0
40452,4,452,[202 168   8 265 194],297,2,1858,4.101545253863135,0.0,0.0
40453,4,453,[313 483  11 318  64],214,5,1863,4.10352422907489,80.0,20.0
40454,4,454,[313 483  11 318  64],618,5,1868,4.105494505494505,80.0,20.0
40455,4,455,[172 322 182 215 185],416,4,1872,4.105263157894737,0.0,0.0
40456,4,456,[313  11 483 318  64],214,5,1877,4.107221006564552,80.0,20.0
40457,4,457,[313  11 483 318  64],214,5,1882,4.109170305676856,80.0,20.0
40458,4,458,[313  11 483 318  64],618,5,1887,4.111111111111111,80.0,20.0
40459,4,459,[313  11 483 318  64],618,5,1892,4.113043478260869,80.0,20.0
40460,4,460,[  4 235 216  95 121],805,0,1892,4.10412147505423,0.0,0.0
40461,4,461,[483 313  11 318  64],214,5,1897,4.106060606060606,80.0,20.0
40462,4,462,[483 313  11 318  64],214,5,1902,4.107991360691145,80.0,20.0
40463,4,463,[483 313  11 318  64],214,5,1907,4.109913793103448,80.0,20.0
40464,4,464,[483 313  11 318  64],618,5,1912,4.111827956989248,80.0,20.0
40465,4,465,[483 313  11 318  64],214,5,1917,4.113733905579399,80.0,20.0
40466,4,466,[483 313  11 318  64],214,5,1922,4.115631691648822,80.0,20.0
40467,4,467,[483 313  11 318  64],618,5,1927,4.117521367521367,80.0,20.0
40468,4,468,[ 98  11   1 475  50],297,4,1931,4.11727078891258,0.0,40.0
40469,4,469,[588 228 515 196 135],405,1,1932,4.110638297872341,0.0,0.0
40470,4,470,[237  95 323 318 187],198,2,1934,4.10615711252654,20.0,0.0
40471,4,471,[313  11 483 318  64],214,5,1939,4.108050847457627,80.0,20.0
40472,4,472,[313  11 483 318  64],618,5,1944,4.1099365750528545,80.0,20.0
40473,4,473,[289 678 313 275 471],416,3,1947,4.1075949367088604,20.0,20.0
40474,4,474,[ 50 405 153   1  97],654,4,1951,4.107368421052632,0.0,20.0
40475,4,475,[313  11 483 318  64],618,5,1956,4.109243697478991,80.0,20.0
40476,4,476,[313  11 483 318  64],214,5,1961,4.111111111111111,80.0,20.0
40477,4,477,[191   4  64 215 302],416,5,1966,4.112970711297071,20.0,0.0
40478,4,478,[151  50 195 357 496],373,5,1971,4.11482254697286,0.0,20.0
40479,4,479,[185 588 403 475   4],805,3,1974,4.1125,0.0,0.0
40480,4,480,[313  11 483 318  64],214,5,1979,4.114345114345114,80.0,20.0
40481,4,481,[ 64 405 237 204  69],314,5,1984,4.1161825726141075,20.0,0.0
40482,4,482,[313  11 483 318  64],618,5,1989,4.118012422360248,80.0,20.0
40483,4,483,[313  11 483 318  64],618,5,1994,4.119834710743802,80.0,20.0
40484,4,484,[313  11 483 318  64],618,5,1999,4.121649484536082,80.0,20.0
40485,4,485,[ 70 235  50  98 603],416,4,2003,4.121399176954733,0.0,40.0
40486,4,486,[237 294 289  82  71],588,3,2006,4.119096509240246,0.0,0.0
40487,4,487,[483 313  11 318  64],214,5,2011,4.120901639344262,80.0,20.0
40488,4,488,[ 98 302 143 211 172],405,4,2015,4.120654396728017,0.0,20.0
40489,4,489,[483 313  11 318  64],618,5,2020,4.122448979591836,80.0,20.0
40490,4,490,[282  56   8 294 168],253,3,2023,4.120162932790224,0.0,0.0
40491,4,491,[286 204 172  25  71],588,5,2028,4.121951219512195,0.0,0.0
40492,4,492,[ 56  70 357  11 172],416,5,2033,4.123732251521298,0.0,0.0
40493,4,493,[ 11 313 483 318  64],618,5,2038,4.125506072874494,80.0,20.0
40494,4,494,[ 11 313 483 318  64],618,5,2043,4.127272727272727,80.0,20.0
40495,4,495,[151 195  22 323  95],416,2,2045,4.122983870967742,0.0,0.0
40496,4,496,[471 288 153 195 276],630,3,2048,4.120724346076459,0.0,20.0
40497,4,497,[483 313  11 318  64],214,5,2053,4.122489959839357,80.0,20.0
40498,4,498,[174 117 202 655  95],618,3,2056,4.1202404809619235,0.0,0.0
40499,4,499,[132 568 234   7 204],588,4,2060,4.12,0.0,0.0
40500,4,500,[496 117 300 118 127],416,4,2064,4.119760479041916,0.0,0.0
40501,4,501,[313  11 483 318  64],214,5,2069,4.121513944223108,80.0,20.0
40502,4,502,[ 28 195  79 191 276],416,4,2073,4.121272365805169,0.0,0.0
40503,4,503,[288 385 161 228  25],417,1,2074,4.115079365079365,0.0,20.0
40504,4,504,[100 197 275 144 200],854,4,2078,4.114851485148515,0.0,0.0
40505,4,505,[313  11 483 318  64],214,5,2083,4.116600790513834,80.0,20.0
40506,4,506,[313  11 483 318  64],214,5,2088,4.118343195266272,80.0,20.0
40507,4,507,[273 179 210 135 202],417,2,2090,4.1141732283464565,0.0,0.0
40508,4,508,[313  11 483 318  64],214,5,2095,4.115913555992141,80.0,20.0
40509,4,509,[568 597 496 588  70],654,5,2100,4.117647058823529,0.0,0.0
40510,4,510,[313  11 483 318  64],618,5,2105,4.119373776908024,80.0,20.0
40511,4,511,[132  11 204 237  70],345,5,2110,4.12109375,0.0,0.0
40512,4,512,[313  12 333  25  28],416,5,2115,4.12280701754386,40.0,20.0
40513,4,513,[161 471 121 294  22],505,3,2118,4.120622568093385,0.0,0.0
40514,4,514,[483  11 313 318  64],214,5,2123,4.122330097087379,80.0,20.0
40515,4,515,[483  11 313 318  64],214,5,2128,4.124031007751938,80.0,20.0
40516,4,516,[742 333 161 655 173],416,5,2133,4.1257253384912955,0.0,0.0
40517,4,517,[275  89 196 161 135],711,5,2138,4.127413127413128,0.0,0.0
40518,4,518,[302 202 235 313 215],43,4,2142,4.127167630057803,20.0,20.0
40519,4,519,[322 135  95 173 385],417,3,2145,4.125,0.0,0.0
40520,4,520,[197 151  98 273  11],854,5,2150,4.126679462571977,0.0,20.0
40521,4,521,[  1   7 202 121 183],805,3,2153,4.124521072796935,0.0,0.0
40522,4,522,[ 95 182 211 197  50],437,4,2157,4.124282982791587,0.0,20.0
40523,4,523,[172 186 175 603 180],405,2,2159,4.120229007633588,0.0,0.0
40524,4,524,[ 11 483 313 318  64],214,5,2164,4.121904761904762,80.0,20.0
40525,4,525,[ 11 483 313 318  64],618,5,2169,4.123574144486692,80.0,20.0
40526,4,526,[ 11 483 313 318  64],618,5,2174,4.125237191650854,80.0,20.0
40527,4,527,[  4  96 318 191 204],405,4,2178,4.125,20.0,0.0
40528,4,528,[ 11 483 313 318  64],214,5,2183,4.126654064272212,80.0,20.0
40529,4,529,[265 568 161 385  50],505,3,2186,4.124528301886793,0.0,20.0
40530,4,530,[ 11 483 313 318  64],618,5,2191,4.126177024482109,80.0,20.0
40531,4,531,[ 11 483 313 318  64],618,5,2196,4.12781954887218,80.0,20.0
40532,4,532,[153 483 300 222 182],253,3,2199,4.125703564727955,20.0,0.0
40533,4,533,[ 11 483 313 318  64],618,5,2204,4.127340823970037,80.0,20.0
40534,4,534,[ 11 483 313 318  64],618,5,2209,4.128971962616823,80.0,20.0
40535,4,535,[ 11 483 313 318  64],214,5,2214,4.130597014925373,80.0,20.0
40536,4,536,[ 15 143  11 288  64],618,3,2217,4.128491620111732,20.0,20.0
40537,4,537,[483 313  11 318  64],618,5,2222,4.130111524163569,80.0,20.0
40538,4,538,[483 313  11 318  64],214,5,2227,4.131725417439704,80.0,20.0
40539,4,539,[300 168  69 204 655],198,3,2230,4.12962962962963,0.0,0.0
40540,4,540,[483 313  11 318  64],214,5,2235,4.131238447319778,80.0,20.0
40541,4,541,[238 403 210  70  96],198,4,2239,4.130996309963099,0.0,0.0
40542,4,542,[483 313  11 318  64],214,5,2244,4.132596685082873,80.0,20.0
40543,4,543,[172 546  89 238 117],62,5,2249,4.134191176470588,0.0,0.0
40544,4,544,[483 313  11 318  64],618,5,2254,4.135779816513762,80.0,20.0
40545,4,545,[195 385 318 143   7],262,2,2256,4.131868131868132,20.0,0.0
40546,4,546,[194  11 268 269  50],416,5,2261,4.13345521023766,0.0,20.0
40547,4,547,[483 313  11 318  64],214,5,2266,4.135036496350365,80.0,20.0
40548,4,548,[483 313  11 318  64],618,5,2271,4.136612021857924,80.0,20.0
40549,4,549,[237 121 181 403 318],345,3,2274,4.134545454545455,20.0,20.0
40550,4,550,[568  12  25 151 174],345,4,2278,4.1343012704174225,20.0,0.0
40551,4,551,[483 313  11 318  64],618,5,2283,4.135869565217392,80.0,20.0
40552,4,552,[483 313  11 318  64],214,5,2288,4.137432188065099,80.0,20.0
40553,4,553,[483 313  11 318  64],618,5,2293,4.1389891696750905,80.0,20.0
40554,4,554,[483 313  11 318  64],214,5,2298,4.140540540540541,80.0,20.0
40555,4,555,[483 313  11 318  64],618,5,2303,4.142086330935252,80.0,20.0
40556,4,556,[496 195 257  82 588],417,2,2305,4.138240574506284,0.0,0.0
40557,4,557,[483 313  11 318  64],618,5,2310,4.139784946236559,80.0,20.0
40558,4,558,[483 313  11 318  64],214,5,2315,4.141323792486583,80.0,20.0
40559,4,559,[181 111 151  79  50],437,4,2319,4.141071428571428,0.0,40.0
40560,4,560,[483 313  11 318  64],214,5,2324,4.142602495543672,80.0,20.0
40561,4,561,[  9  70 228 100 271],62,2,2326,4.1387900355871885,0.0,0.0
40562,4,562,[301 238 471 210   8],416,5,2331,4.140319715808171,0.0,0.0
40563,4,563,[483 313  11 318  64],618,5,2336,4.141843971631205,80.0,20.0
40564,4,564,[483 313  11 318  64],214,5,2341,4.143362831858407,80.0,20.0
40565,4,565,[546  98 322  25 168],417,2,2343,4.139575971731449,0.0,20.0
40566,4,566,[268 172 200  95 742],416,4,2347,4.139329805996472,0.0,0.0
40567,4,567,[313 483  11 318  64],214,5,2352,4.140845070422535,80.0,20.0
40568,4,568,[313 483  11 318  64],618,5,2357,4.142355008787346,80.0,20.0
40569,4,569,[ 82 268 235 174 257],416,3,2360,4.140350877192983,0.0,0.0
40570,4,570,[  4 153 118 235  82],416,3,2363,4.138353765323993,0.0,0.0
40571,4,571,[483 313  11 318  64],214,5,2368,4.13986013986014,80.0,20.0
40572,4,572,[172 179 427   8  88],416,3,2371,4.137870855148342,0.0,0.0
40573,4,573,[ 50  69 588 168 191],43,5,2376,4.139372822299651,0.0,20.0
40574,4,574,[ 89 258  79   4   1],417,3,2379,4.137391304347826,0.0,0.0
40575,4,575,[117   1 143  88 132],345,4,2383,4.137152777777778,0.0,0.0
40576,4,576,[173 121 265  79 238],654,5,2388,4.138648180242634,0.0,0.0
40577,4,577,[ 11 483 313 318  64],214,5,2393,4.140138408304498,80.0,20.0
40578,4,578,[ 70 265 121  97 302],654,4,2397,4.139896373056994,0.0,0.0
40579,4,579,[ 11 483 313 318  64],618,5,2402,4.141379310344828,80.0,20.0
40580,4,580,[118 183  97 117 238],62,3,2405,4.139414802065405,0.0,0.0
40581,4,581,[ 11 483 313 318  64],618,5,2410,4.140893470790378,80.0,20.0
40582,4,582,[ 11 483 313 318  64],214,5,2415,4.1423670668953685,80.0,20.0
40583,4,583,[204 588  82 655 100],618,4,2419,4.142123287671233,0.0,0.0
40584,4,584,[483  11 313 318  64],214,5,2424,4.143589743589744,80.0,20.0
40585,4,585,[302 357 294 121  25],416,5,2429,4.145051194539249,0.0,0.0
40586,4,586,[508  98   7 294 742],24,4,2433,4.144804088586031,0.0,20.0
40587,4,587,[216 161 143 228 568],805,0,2433,4.137755102040816,0.0,0.0
40588,4,588,[161 143 515 273 603],416,5,2438,4.139219015280136,0.0,0.0
40589,4,589,[483  11 313 318  64],214,5,2443,4.140677966101695,80.0,20.0
40590,4,590,[210 174 111 655 475],416,4,2447,4.140439932318105,0.0,0.0
40591,4,591,[483  11 313 318  64],618,5,2452,4.141891891891892,80.0,20.0
40592,4,592,[483  11 313 318  64],618,5,2457,4.143338954468803,80.0,20.0
40593,4,593,[144 258  79 121 234],417,2,2459,4.13973063973064,0.0,0.0
40594,4,594,[483  11 313 318  64],214,5,2464,4.141176470588236,80.0,20.0
40595,4,595,[483  11 313 318  64],618,5,2469,4.14261744966443,80.0,20.0
40596,4,596,[186 132 483 180 210],128,4,2473,4.142378559463987,20.0,0.0
40597,4,597,[269  50  22 271  56],297,4,2477,4.142140468227424,0.0,20.0
40598,4,598,[ 11 483 313 318  64],618,5,2482,4.143572621035059,80.0,20.0
40599,4,599,[288  89 111 143  97],437,1,2483,4.138333333333334,0.0,20.0
40600,4,600,[ 69   7 161 186 742],230,4,2487,4.13810316139767,0.0,0.0
40601,4,601,[237 301 333 151  56],588,4,2491,4.137873754152824,0.0,0.0
40602,4,602,[313  11 483 318  64],214,5,2496,4.1393034825870645,80.0,20.0
40603,4,603,[313  11 483 318  64],618,5,2501,4.1407284768211925,80.0,20.0
40604,4,604,[268 568  15 194  70],416,5,2506,4.142148760330579,0.0,0.0
40605,4,605,[151 202 174 180 405],128,2,2508,4.138613861386139,0.0,0.0
40606,4,606,[ 69 176 269 357 194],297,3,2511,4.136738056013179,0.0,0.0
40607,4,607,[313 483  11 318  64],618,5,2516,4.1381578947368425,80.0,20.0
40608,4,608,[235 301 111 132 471],345,3,2519,4.136288998357964,0.0,0.0
40609,4,609,[313 483  11 318  64],618,5,2524,4.137704918032787,80.0,20.0
40610,4,610,[  7   4 385 111 655],417,2,2526,4.134206219312603,0.0,0.0
40611,4,611,[301 100 204 195 546],297,2,2528,4.130718954248366,0.0,0.0
40612,4,612,[313  11 483 318  64],214,5,2533,4.132137030995106,80.0,20.0
40613,4,613,[313  11 483 318  64],214,5,2538,4.133550488599348,80.0,20.0
40614,4,614,[313  11 483 318  64],618,5,2543,4.134959349593496,80.0,20.0
40615,4,615,[211 276 597 588 118],43,4,2547,4.134740259740259,0.0,0.0
40616,4,616,[655  64  56 197  11],405,5,2552,4.136142625607779,20.0,0.0
40617,4,617,[186 215 174  71 179],437,2,2554,4.132686084142395,0.0,0.0
40618,4,618,[483 313  11 318  64],618,5,2559,4.1340872374798066,80.0,20.0
40619,4,619,[483 313  11 318  64],618,5,2564,4.135483870967742,80.0,20.0
40620,4,620,[195 200 234 748  71],437,3,2567,4.1336553945249594,0.0,0.0
40621,4,621,[235  98 135 183 151],922,2,2569,4.130225080385852,0.0,20.0
40622,4,622,[294 748 597  25  22],805,1,2570,4.125200642054574,0.0,0.0
40623,4,623,[313  11 483 318  64],214,5,2575,4.126602564102564,80.0,20.0
40624,4,624,[403 121 546  82  96],705,4,2579,4.1264,0.0,0.0
40625,4,625,[121 179 423 427 216],262,3,2582,4.124600638977636,0.0,0.0
40626,4,626,[313  11 483 318  64],214,5,2587,4.1259968102073366,80.0,20.0
40627,4,627,[313  11 483 318  64],214,5,2592,4.127388535031847,80.0,20.0
40628,4,628,[ 82 271   1 179  64],62,3,2595,4.125596184419714,20.0,0.0
40629,4,629,[435 196 245  95 742],297,1,2596,4.12063492063492,0.0,0.0
40630,4,630,[ 11 483 313 318  64],618,5,2601,4.12202852614897,80.0,20.0
40631,4,631,[257 238 168 111 294],62,2,2603,4.118670886075949,0.0,0.0
40632,4,632,[  9 196 143 181 238],43,4,2607,4.118483412322274,0.0,20.0
40633,4,633,[588 173 268 508 546],297,4,2611,4.118296529968454,0.0,0.0
40634,4,634,[ 12 357  96 742 405],805,3,2614,4.116535433070866,20.0,0.0
40635,4,635,[ 11 483 313 318  64],214,5,2619,4.117924528301887,80.0,20.0
40636,4,636,[ 11 483 313 318  64],618,5,2624,4.119309262166405,80.0,20.0
40637,4,637,[ 11 483 313 318  64],618,5,2629,4.120689655172414,80.0,20.0
40638,4,638,[ 11 483 313 318  64],618,5,2634,4.122065727699531,80.0,20.0
40639,4,639,[182 197 483 294 655],342,4,2638,4.121875,20.0,0.0
40640,4,640,[603 181  98 265 276],416,4,2642,4.121684867394696,0.0,40.0
40641,4,641,[403 276  88 143 300],43,5,2647,4.123052959501558,0.0,0.0
40642,4,642,[271 483 176  15 237],854,2,2649,4.119751166407465,20.0,0.0
40643,4,643,[483 202 748  98 144],907,5,2654,4.12111801242236,20.0,20.0
40644,4,644,[ 11 483 313 318  64],618,5,2659,4.122480620155039,80.0,20.0
40645,4,645,[ 11 483 313 318  64],214,5,2664,4.123839009287925,80.0,20.0
40646,4,646,[ 11 483 313 318  64],618,5,2669,4.125193199381762,80.0,20.0
40647,4,647,[234 318  11 275  64],618,4,2673,4.125,40.0,0.0
40648,4,648,[ 11 483 313 318  64],214,5,2678,4.126348228043144,80.0,20.0
40649,4,649,[ 11 483 313 318  64],214,5,2683,4.127692307692308,80.0,20.0
40650,4,650,[ 11 483 313 318  64],214,5,2688,4.129032258064516,80.0,20.0
40651,4,651,[185 245 182  22 475],297,3,2691,4.127300613496932,0.0,0.0
40652,4,652,[194 200 228 197  56],405,2,2693,4.124042879019908,0.0,0.0
40653,4,653,[ 11 483 313 318  64],214,5,2698,4.125382262996942,80.0,20.0
40654,4,654,[ 11 483 313 318  64],618,5,2703,4.126717557251909,80.0,20.0
40655,4,655,[ 11 483 313 318  64],214,5,2708,4.128048780487805,80.0,20.0
40656,4,656,[ 11 483 313 318  64],618,5,2713,4.12937595129376,80.0,20.0
40657,4,657,[ 11 483 313 318  64],618,5,2718,4.130699088145897,80.0,20.0
40658,4,658,[ 11 483 313 318  64],618,5,2723,4.132018209408194,80.0,20.0
40659,4,659,[ 11 483 313 318  64],214,5,2728,4.133333333333334,80.0,20.0
40660,4,660,[ 11 483 313 318  64],618,5,2733,4.1346444780635405,80.0,20.0
40661,4,661,[ 11 483 313 318  64],214,5,2738,4.13595166163142,80.0,20.0
40662,4,662,[ 11 483 313 318  64],214,5,2743,4.137254901960785,80.0,20.0
40663,4,663,[ 11 483 313 318  64],214,5,2748,4.13855421686747,80.0,20.0
40664,4,664,[ 11 483 313 318  64],214,5,2753,4.13984962406015,80.0,20.0
40665,4,665,[ 11 483 313 318  64],214,5,2758,4.141141141141141,80.0,20.0
40666,4,666,[ 25 191 196 125   4],373,5,2763,4.142428785607196,0.0,0.0
40667,4,667,[135 216 427 195 588],373,3,2766,4.140718562874252,0.0,0.0
40668,4,668,[151 210 174 265 403],618,3,2769,4.139013452914798,0.0,0.0
40669,4,669,[568 322 144   4 385],416,4,2773,4.138805970149254,0.0,0.0
40670,4,670,[313  11 483 318  64],618,5,2778,4.140089418777944,80.0,20.0
40671,4,671,[385 173  15 313   7],43,5,2783,4.1413690476190474,20.0,20.0
40672,4,672,[204 183 245 301 269],297,3,2786,4.139673105497772,0.0,0.0
40673,4,673,[313 483  11 318  64],214,5,2791,4.140949554896142,80.0,20.0
40674,4,674,[144 742 245  50 125],416,4,2795,4.140740740740741,0.0,20.0
40675,4,675,[ 70 118 655  95 135],417,4,2799,4.140532544378698,0.0,0.0
40676,4,676,[313 483  11 318  64],618,5,2804,4.141802067946824,80.0,20.0
40677,4,677,[313 483  11 318  64],214,5,2809,4.14306784660767,80.0,20.0
40678,4,678,[313 483  11 318  64],618,5,2814,4.144329896907217,80.0,20.0
40679,4,679,[322 161  82 269  71],805,1,2815,4.139705882352941,0.0,0.0
40680,4,680,[483  11 313 318  64],618,5,2820,4.140969162995595,80.0,20.0
40681,4,681,[ 28 196 300 144 655],705,3,2823,4.139296187683285,0.0,0.0
40682,4,682,[483 313  11 318  64],618,5,2828,4.1405563689604685,80.0,20.0
40683,4,683,[483 313  11 318  64],618,5,2833,4.141812865497076,80.0,20.0
40684,4,684,[275 210  25   9 301],43,5,2838,4.143065693430657,0.0,0.0
40685,4,685,[181 289 333 568 288],416,4,2842,4.142857142857143,0.0,40.0
40686,4,686,[173 200 187  69 174],198,5,2847,4.14410480349345,0.0,0.0
40687,4,687,[196 202  95 215 300],43,5,2852,4.145348837209302,0.0,0.0
40688,4,688,[196 282 185  71  22],416,5,2857,4.146589259796807,0.0,0.0
40689,4,689,[143 427 475 597 183],416,3,2860,4.144927536231884,0.0,0.0
40690,4,690,[313 483  11 318  64],214,5,2865,4.1461649782923296,80.0,20.0
40691,4,691,[117 423   4 748  22],805,0,2865,4.140173410404624,0.0,0.0
40692,4,692,[ 11 313 483 318  64],618,5,2870,4.141414141414141,80.0,20.0
40693,4,693,[186 210 135 117  98],437,2,2872,4.138328530259366,0.0,20.0
40694,4,694,[ 69 568 117   8 268],416,5,2877,4.139568345323741,0.0,0.0
40695,4,695,[ 11 313 483 318  64],214,5,2882,4.140804597701149,80.0,20.0
40696,4,696,[172   9 173 238 403],62,5,2887,4.142037302725968,0.0,0.0
40697,4,697,[ 25 215 175 257  88],43,4,2891,4.141833810888252,0.0,0.0
40698,4,698,[ 11 313 483 318  64],618,5,2896,4.143061516452074,80.0,20.0
40699,4,699,[238 357 237 132 678],416,3,2899,4.1414285714285715,0.0,0.0
40700,4,700,[515 151  82  97  79],416,4,2903,4.141226818830242,0.0,0.0
40701,4,701,[ 11 313 483 318  64],618,5,2908,4.1424501424501425,80.0,20.0
40702,4,702,[ 11 313 483 318  64],618,5,2913,4.143669985775249,80.0,20.0
40703,4,703,[222  89 405 237  64],62,3,2916,4.142045454545454,20.0,0.0
40704,4,704,[313 483  11 318  64],618,5,2921,4.143262411347518,80.0,20.0
40705,4,705,[313 483  11 318  64],618,5,2926,4.144475920679887,80.0,20.0
40706,4,706,[132 597 144 195  82],416,4,2930,4.144271570014144,0.0,0.0
40707,4,707,[483  11 313 318  64],214,5,2935,4.145480225988701,80.0,20.0
40708,4,708,[  4 173 196 237 328],62,3,2938,4.143864598025388,0.0,0.0
40709,4,709,[483  11 313 318  64],618,5,2943,4.145070422535211,80.0,20.0
40710,4,710,[ 97  15 173 174 603],416,5,2948,4.146272855133614,0.0,0.0
40711,4,711,[173 222 403 588 185],417,2,2950,4.143258426966292,0.0,0.0
40712,4,712,[ 11 195 100  50 191],198,3,2953,4.141654978962132,0.0,20.0
40713,4,713,[118 322 100  11 275],854,3,2956,4.140056022408964,0.0,0.0
40714,4,714,[234 301   7 194 357],297,3,2959,4.138461538461539,0.0,0.0
40715,4,715,[483 313  11 318  64],214,5,2964,4.139664804469274,80.0,20.0
40716,4,716,[483 313  11 318  64],618,5,2969,4.140864714086471,80.0,20.0
40717,4,717,[144  11 153 197 196],416,5,2974,4.142061281337047,0.0,0.0
40718,4,718,[286 238 176 655  96],417,4,2978,4.141863699582754,0.0,0.0
40719,4,719,[313 483  11 318  64],618,5,2983,4.143055555555556,80.0,20.0
40720,4,720,[483 143 100 333 748],907,5,2988,4.144244105409154,20.0,0.0
40721,4,721,[174 588 187 144 117],505,3,2991,4.142659279778393,0.0,0.0
40722,4,722,[216  82 200 222 238],417,3,2994,4.141078838174274,0.0,0.0
40723,4,723,[ 64 135 302 194 286],721,3,2997,4.139502762430939,20.0,0.0
40724,4,724,[423   4 187 174 127],416,5,3002,4.140689655172414,0.0,0.0
40725,4,725,[125 313 173 234   4],345,4,3006,4.140495867768595,20.0,20.0
40726,4,726,[161 318  28 237 568],588,4,3010,4.140302613480055,20.0,0.0
40727,4,727,[318   1 282 183 215],705,3,3013,4.138736263736264,20.0,0.0
40728,4,728,[313 483  11 318  64],214,5,3018,4.139917695473251,80.0,20.0
40729,4,729,[313 483  11 318  64],214,5,3023,4.141095890410959,80.0,20.0
40730,4,730,[ 11 546   4 269 475],805,2,3025,4.138166894664843,0.0,0.0
40731,4,731,[151  50 318 385 204],588,4,3029,4.137978142076503,20.0,20.0
40732,4,732,[313 483 318  11  64],618,5,3034,4.139154160982264,80.0,20.0
40733,4,733,[  8 318 216 100   4],416,5,3039,4.140326975476839,20.0,0.0
40734,4,734,[313 483 318  11  64],214,5,3044,4.141496598639455,80.0,20.0
40735,4,735,[313 483 318  11  64],214,5,3049,4.142663043478261,80.0,20.0
40736,4,736,[268 234   4  11 195],417,4,3053,4.14246947082768,0.0,0.0
40737,4,737,[655  82 515 176 286],417,5,3058,4.143631436314363,0.0,0.0
40738,4,738,[144  96 121  25 117],618,3,3061,4.142083897158322,0.0,0.0
40739,4,739,[313 483 318  11  64],618,5,3066,4.143243243243243,80.0,20.0
40740,4,740,[313 483 318  11  64],618,5,3071,4.144399460188934,80.0,20.0
40741,4,741,[  1   9 174 100 235],416,4,3075,4.144204851752021,0.0,0.0
40742,4,742,[ 71 179 174 265 210],373,4,3079,4.144010767160162,0.0,0.0
40743,4,743,[202 173 215  11  56],922,3,3082,4.14247311827957,0.0,0.0
40744,4,744,[ 89 216 385 235 191],642,2,3084,4.139597315436242,0.0,0.0
40745,4,745,[ 69 117 176 132 191],416,5,3089,4.140750670241287,0.0,0.0
40746,4,746,[313 483 318  11  64],618,5,3094,4.14190093708166,80.0,20.0
40747,4,747,[127 257 125 235  28],887,3,3097,4.140374331550802,0.0,0.0
40748,4,748,[196 179 197 357  69],416,4,3101,4.140186915887851,0.0,0.0
40749,4,749,[313 483 318  11  64],618,5,3106,4.141333333333334,80.0,20.0
40750,4,750,[313 483 318  11  64],214,5,3111,4.142476697736352,80.0,20.0
40751,4,751,[294  89   8  22 194],297,3,3114,4.14095744680851,0.0,0.0
40752,4,752,[313 483 318  11  64],618,5,3119,4.142098273572377,80.0,20.0
40753,4,753,[313 483 318  11  64],214,5,3124,4.143236074270557,80.0,20.0
40754,4,754,[313 483 318  11  64],618,5,3129,4.144370860927152,80.0,20.0
40755,4,755,[313 483 318  11  64],214,5,3134,4.145502645502646,80.0,20.0
40756,4,756,[172  25  71 435  96],373,5,3139,4.146631439894319,0.0,0.0
40757,4,757,[288 546 117 144 121],805,0,3139,4.141160949868074,0.0,20.0
40758,4,758,[313 483 318  11  64],214,5,3144,4.142292490118577,80.0,20.0
40759,4,759,[313 483 318  11  64],618,5,3149,4.143421052631579,80.0,20.0
40760,4,760,[313 483 318  11  64],618,5,3154,4.144546649145861,80.0,20.0
40761,4,761,[313 483 318  11  64],214,5,3159,4.145669291338582,80.0,20.0
40762,4,762,[322 546 742 655  71],416,3,3162,4.144167758846658,0.0,0.0
40763,4,763,[181 423  96 180 174],405,3,3165,4.142670157068062,0.0,20.0
40764,4,764,[294 172 211 475 546],417,3,3168,4.141176470588236,0.0,0.0
40765,4,765,[313 483 318  11  64],618,5,3173,4.142297650130549,80.0,20.0
40766,4,766,[313 483 318  11  64],618,5,3178,4.14341590612777,80.0,20.0
40767,4,767,[ 50  95 588   4   1],642,4,3182,4.143229166666667,0.0,20.0
40768,4,768,[483 265 143 237 176],618,5,3187,4.144343302990897,20.0,0.0
40769,4,769,[185 144 238 423  79],437,4,3191,4.144155844155844,0.0,0.0
40770,4,770,[172 289 144  71 100],416,4,3195,4.143968871595331,0.0,0.0
40771,4,771,[313 483 318  11  64],618,5,3200,4.1450777202072535,80.0,20.0
40772,4,772,[  4  97 210 182  82],416,5,3205,4.146183699870634,0.0,0.0
40773,4,773,[286 258  98 405 211],43,5,3210,4.147286821705427,0.0,20.0
40774,4,774,[ 28 216  22  98 294],805,1,3211,4.143225806451613,0.0,20.0
40775,4,775,[202   1 228 180 144],805,1,3212,4.139175257731959,0.0,0.0
40776,4,776,[143 196 603 174 328],373,4,3216,4.138996138996139,0.0,0.0
40777,4,777,[117 197  69  70 496],618,3,3219,4.137532133676093,0.0,0.0
40778,4,778,[313 483 318  11  64],214,5,3224,4.138639281129653,80.0,20.0
40779,4,779,[313 483 318  11  64],214,5,3229,4.13974358974359,80.0,20.0
40780,4,780,[313 483 318  11  64],214,5,3234,4.140845070422535,80.0,20.0
40781,4,781,[357  88 748 127 300],416,4,3238,4.140664961636829,0.0,0.0
40782,4,782,[597 216 180 111  96],854,1,3239,4.136653895274585,0.0,0.0
40783,4,783,[483 313 318  11  64],618,5,3244,4.137755102040816,80.0,20.0
40784,4,784,[483 313 318  11  64],618,5,3249,4.138853503184714,80.0,20.0
40785,4,785,[483 313 318  11  64],618,5,3254,4.139949109414759,80.0,20.0
40786,4,786,[ 79  71 238 405 268],654,3,3257,4.138500635324015,0.0,0.0
40787,4,787,[313 483 318  11  64],214,5,3262,4.1395939086294415,80.0,20.0
40788,4,788,[313 483 318  11  64],618,5,3267,4.140684410646388,80.0,20.0
40789,4,789,[597 182  79 603   8],416,4,3271,4.140506329113924,0.0,0.0
40790,4,790,[313 483 318  11  64],214,5,3276,4.1415929203539825,80.0,20.0
40791,4,791,[313 483 318  11  64],618,5,3281,4.142676767676767,80.0,20.0
40792,4,792,[313 483 318  11  64],618,5,3286,4.1437578814627996,80.0,20.0
40793,4,793,[135 318  28 117 151],642,2,3288,4.141057934508816,20.0,0.0
40794,4,794,[151 197 183   8 483],437,4,3292,4.140880503144654,20.0,0.0
40795,4,795,[288 182 117  50 185],297,3,3295,4.139447236180905,0.0,40.0
40796,4,796,[228 153 176  12 191],297,3,3298,4.13801756587202,20.0,0.0
40797,4,797,[191 161 300 508 100],345,3,3301,4.136591478696742,0.0,0.0
40798,4,798,[313 483  11  64 318],214,5,3306,4.137672090112641,80.0,20.0
40799,4,799,[313 483  11  64 318],618,5,3311,4.13875,80.0,20.0
40800,4,800,[ 56 322 333 286 257],416,3,3314,4.1373283395755305,0.0,0.0
40801,4,801,[125  79  25 271   9],854,3,3317,4.135910224438903,0.0,0.0
40802,4,802,[172 143 180 168  69],405,3,3320,4.134495641344956,0.0,0.0
40803,4,803,[175  95  98 172 180],405,2,3322,4.1318407960199,0.0,20.0
40804,4,804,[204 748 435  25 197],297,1,3323,4.127950310559006,0.0,0.0
40805,4,805,[ 95 185 191 471  98],618,3,3326,4.126550868486352,0.0,20.0
40806,4,806,[483 313  11  64 318],214,5,3331,4.127633209417596,80.0,20.0
40807,4,807,[483 313  11  64 318],618,5,3336,4.128712871287129,80.0,20.0
40808,4,808,[483 313  11  64 318],214,5,3341,4.129789864029666,80.0,20.0
40809,4,809,[483 313  11  64 318],214,5,3346,4.130864197530864,80.0,20.0
40810,4,810,[597  12 172 475 100],417,2,3348,4.1282367447595565,20.0,0.0
40811,4,811,[483 313  11  64 318],618,5,3353,4.129310344827586,80.0,20.0
40812,4,812,[483 313  11  64 318],618,5,3358,4.130381303813038,80.0,20.0
40813,4,813,[289  11 318 144 275],854,3,3361,4.128992628992629,20.0,0.0
40814,4,814,[483 313  11  64 318],618,5,3366,4.130061349693252,80.0,20.0
40815,4,815,[265  98 496 483 655],128,4,3370,4.129901960784314,20.0,20.0
40816,4,816,[191 328 275 172 132],62,4,3374,4.129742962056303,0.0,0.0
40817,4,817,[301 168 257  88 127],43,5,3379,4.13080684596577,0.0,0.0
40818,4,818,[ 12 172 183 318  89],62,5,3384,4.131868131868132,40.0,0.0
40819,4,819,[483 313  11  64 318],618,5,3389,4.132926829268293,80.0,20.0
40820,4,820,[ 11 588  70 273 655],618,4,3393,4.132764920828258,0.0,0.0
40821,4,821,[ 25 215   1  79  28],654,4,3397,4.132603406326034,0.0,0.0
40822,4,822,[313 483  11  64 318],618,5,3402,4.133657351154313,80.0,20.0
40823,4,823,[313 483  11  64 318],618,5,3407,4.134708737864078,80.0,20.0
40824,4,824,[313 483  11  64 318],214,5,3412,4.135757575757576,80.0,20.0
40825,4,825,[258 475 121 483 294],854,3,3415,4.134382566585956,20.0,0.0
40826,4,826,[175  12   4 111 405],805,2,3417,4.13180169286578,20.0,0.0
40827,4,827,[125 235 202 286 357],417,4,3421,4.131642512077295,0.0,0.0
40828,4,828,[144 496 197 508 655],342,4,3425,4.131483715319662,0.0,0.0
40829,4,829,[216 196  79 333 318],345,4,3429,4.13132530120482,20.0,0.0
40830,4,830,[508  97 483 144 423],62,2,3431,4.128760529482551,20.0,0.0
40831,4,831,[216 202  56   9 655],416,5,3436,4.1298076923076925,0.0,0.0
40832,4,832,[265 182 216 271 508],297,2,3438,4.127250900360144,0.0,0.0
40833,4,833,[  4 204 300 127 318],416,5,3443,4.128297362110311,20.0,0.0
40834,4,834,[313 483  11  64 318],618,5,3448,4.129341317365269,80.0,20.0
40835,4,835,[313 483  11  64 318],618,5,3453,4.130382775119617,80.0,20.0
40836,4,836,[313 483  11  64 318],618,5,3458,4.13142174432497,80.0,20.0
40837,4,837,[313 483  11  64 318],214,5,3463,4.1324582338902145,80.0,20.0
40838,4,838,[257 568  95 168 135],711,3,3466,4.131108462455304,0.0,0.0
40839,4,839,[ 98 215 143 318 202],437,4,3470,4.130952380952381,20.0,20.0
40840,4,840,[313 483  11  64 318],214,5,3475,4.1319857312722945,80.0,20.0
40841,4,841,[313 483  11  64 318],618,5,3480,4.133016627078385,80.0,20.0
40842,4,842,[ 71  82  88  69 483],618,5,3485,4.134045077105576,20.0,0.0
40843,4,843,[678 423 118 333 181],416,3,3488,4.132701421800948,0.0,20.0
40844,4,844,[313 483  11  64 318],214,5,3493,4.133727810650887,80.0,20.0
40845,4,845,[313 483  11  64 318],618,5,3498,4.134751773049645,80.0,20.0
40846,4,846,[313 483  11  64 318],618,5,3503,4.135773317591499,80.0,20.0
40847,4,847,[313 483  11  64 318],214,5,3508,4.136792452830188,80.0,20.0
40848,4,848,[118 117 200   1 385],416,4,3512,4.136631330977621,0.0,0.0
40849,4,849,[ 50 300 228  64 172],198,3,3515,4.135294117647059,20.0,20.0
40850,4,850,[118 258 197 196 603],128,4,3519,4.135135135135135,0.0,0.0
40851,4,851,[313 301 215 323 196],751,3,3522,4.133802816901408,20.0,20.0
40852,4,852,[ 82 161  97  70 742],43,5,3527,4.1348182883939035,0.0,0.0
40853,4,853,[275 257   4 269 597],416,3,3530,4.133489461358314,0.0,0.0
40854,4,854,[483  11 313  64 318],214,5,3535,4.1345029239766085,80.0,20.0
40855,4,855,[483  11 313  64 318],618,5,3540,4.135514018691588,80.0,20.0
40856,4,856,[483  11 313  64 318],618,5,3545,4.136522753792299,80.0,20.0
40857,4,857,[655 210 183 568 357],416,5,3550,4.137529137529137,0.0,0.0
40858,4,858,[483  11 313  64 318],618,5,3555,4.138533178114086,80.0,20.0
40859,4,859,[471  15 100 222 286],854,2,3557,4.136046511627907,0.0,0.0
40860,4,860,[ 22 125  11  25 282],223,2,3559,4.133565621370499,0.0,0.0
40861,4,861,[483 313  64 318  11],618,5,3564,4.134570765661253,80.0,20.0
40862,4,862,[483 313  64 318  11],618,5,3569,4.135573580533024,80.0,20.0
40863,4,863,[483 313  64 318  11],214,5,3574,4.136574074074074,80.0,20.0
40864,4,864,[483 313  64 318  11],618,5,3579,4.13757225433526,80.0,20.0
40865,4,865,[ 97  12 182 121 603],437,2,3581,4.135103926096997,20.0,0.0
40866,4,866,[483 313  64 318  11],618,5,3586,4.136101499423298,80.0,20.0
40867,4,867,[483 313  64 318  11],214,5,3591,4.137096774193548,80.0,20.0
40868,4,868,[216 175 588   4 300],297,3,3594,4.135788262370541,0.0,0.0
40869,4,869,[483 313  64 318  11],214,5,3599,4.136781609195403,80.0,20.0
40870,4,870,[483 313  64 318  11],618,5,3604,4.137772675086108,80.0,20.0
40871,4,871,[483 313  64 318  11],214,5,3609,4.138761467889908,80.0,20.0
40872,4,872,[216  70  88 215 483],751,5,3614,4.139747995418099,20.0,0.0
40873,4,873,[483 313  64 318  11],214,5,3619,4.140732265446224,80.0,20.0
40874,4,874,[483 313  64 318  11],618,5,3624,4.1417142857142855,80.0,20.0
40875,4,875,[111 117  11   4  71],618,3,3627,4.140410958904109,0.0,0.0
40876,4,876,[ 50  12 173 313 168],618,4,3631,4.140250855188142,40.0,40.0
40877,4,877,[483 313  64 318  11],214,5,3636,4.14123006833713,80.0,20.0
40878,4,878,[483 313  64 318  11],214,5,3641,4.1422070534698525,80.0,20.0
40879,4,879,[483 313  64 318  11],618,5,3646,4.1431818181818185,80.0,20.0
40880,4,880,[118   9 318  98 235],887,2,3648,4.140749148694665,20.0,20.0
40881,4,881,[483 313  64 318  11],618,5,3653,4.14172335600907,80.0,20.0
40882,4,882,[111   1 588 258  98],417,3,3656,4.140430351075878,0.0,20.0
40883,4,883,[483 313  64 318  11],618,5,3661,4.141402714932127,80.0,20.0
40884,4,884,[ 70 294 151 235 174],62,3,3664,4.140112994350282,0.0,0.0
40885,4,885,[483 313  64 318  11],618,5,3669,4.1410835214446955,80.0,20.0
40886,4,886,[173 197 294 125  88],416,4,3673,4.140924464487035,0.0,0.0
40887,4,887,[483 313  64 318  11],618,5,3678,4.141891891891892,80.0,20.0
40888,4,888,[496 210  64 118 143],43,5,3683,4.142857142857143,20.0,0.0
40889,4,889,[483 313  64 318  11],214,5,3688,4.143820224719101,80.0,20.0
40890,4,890,[288 286  71 427  22],416,5,3693,4.1447811447811445,0.0,20.0
40891,4,891,[546   1 121  50 568],43,5,3698,4.145739910313901,0.0,20.0
40892,4,892,[483 313  64 318  11],214,5,3703,4.146696528555431,80.0,20.0
40893,4,893,[483 313  64 318  11],618,5,3708,4.147651006711409,80.0,20.0
40894,4,894,[483 313  64 318  11],214,5,3713,4.148603351955307,80.0,20.0
40895,4,895,[483 313  64 318  11],214,5,3718,4.149553571428571,80.0,20.0
40896,4,896,[ 64 161 276  28 175],43,4,3722,4.149386845039019,20.0,0.0
40897,4,897,[483 313  64 318  11],618,5,3727,4.150334075723831,80.0,20.0
40898,4,898,[483 313  64 318  11],214,5,3732,4.151279199110123,80.0,20.0
40899,4,899,[181 742 132  97 318],588,4,3736,4.151111111111111,20.0,20.0
40900,4,900,[483 313  64 318  11],214,5,3741,4.152053274139845,80.0,20.0
40901,4,901,[483 313  64 318  11],214,5,3746,4.1529933481153,80.0,20.0
40902,4,902,[483 313  64 318  11],214,5,3751,4.153931339977851,80.0,20.0
40903,4,903,[483 313  64 318  11],618,5,3756,4.154867256637168,80.0,20.0
40904,4,904,[183 186 143 127 185],601,4,3760,4.154696132596685,0.0,0.0
40905,4,905,[483 313  64 318  11],618,5,3765,4.155629139072848,80.0,20.0
40906,4,906,[258 546 180   7 483],417,3,3768,4.154355016538037,20.0,0.0
40907,4,907,[235 508   1 200 172],345,3,3771,4.153083700440528,0.0,0.0
40908,4,908,[143 173 603 471  70],297,4,3775,4.152915291529153,0.0,0.0
40909,4,909,[483 313  64 318  11],618,5,3780,4.153846153846154,80.0,20.0
40910,4,910,[483 313  64 318  11],618,5,3785,4.154774972557629,80.0,20.0
40911,4,911,[483 313  64 318  11],618,5,3790,4.155701754385965,80.0,20.0
40912,4,912,[483 313  64 318  11],618,5,3795,4.156626506024097,80.0,20.0
40913,4,913,[483 313  64 318  11],618,5,3800,4.157549234135668,80.0,20.0
40914,4,914,[ 56 161  95 153 185],230,4,3804,4.157377049180328,0.0,0.0
40915,4,915,[151  95 257 258 235],416,1,3805,4.153930131004367,0.0,0.0
40916,4,916,[483 313  64 318  11],618,5,3810,4.154852780806979,80.0,20.0
40917,4,917,[191 483 275 276 118],618,2,3812,4.152505446623094,20.0,0.0
40918,4,918,[483 313  64 318  11],618,5,3817,4.153427638737758,80.0,20.0
40919,4,919,[288 405 185 471 118],854,3,3820,4.1521739130434785,0.0,20.0
40920,4,920,[ 82 423 187 237 210],505,3,3823,4.150922909880564,0.0,0.0
40921,4,921,[483 313  64 318  11],214,5,3828,4.151843817787419,80.0,20.0
40922,4,922,[588 294  96 172  25],416,5,3833,4.1527627302275185,0.0,0.0
40923,4,923,[483 313  64 318  11],618,5,3838,4.153679653679654,80.0,20.0
40924,4,924,[483 313  64 318  11],214,5,3843,4.154594594594594,80.0,20.0
40925,4,925,[ 89  69  82 132 288],405,4,3847,4.154427645788337,0.0,20.0
40926,4,926,[228 597  50  95 216],805,1,3848,4.151024811218986,0.0,20.0
40927,4,927,[168 182 568 151 237],416,3,3851,4.149784482758621,0.0,0.0
40928,4,928,[182  97  11 427  56],618,5,3856,4.1506996770721205,0.0,0.0
40929,4,929,[483 313  64 318  11],214,5,3861,4.151612903225806,80.0,20.0
40930,4,930,[186 238  50 289  56],43,3,3864,4.150375939849624,0.0,20.0
40931,4,931,[483 313  64 318  11],618,5,3869,4.151287553648069,80.0,20.0
40932,4,932,[357 161  22 153 302],416,5,3874,4.152197213290461,0.0,0.0
40933,4,933,[211  79 215   4  95],297,1,3875,4.1488222698072805,0.0,0.0
40934,4,934,[568 153 181 215 228],62,2,3877,4.146524064171123,0.0,20.0
40935,4,935,[483 313  64 318  11],214,5,3882,4.147435897435898,80.0,20.0
40936,4,936,[483 313  64 318  11],214,5,3887,4.148345784418357,80.0,20.0
40937,4,937,[174 111 182  15 245],417,3,3890,4.1471215351812365,0.0,0.0
40938,4,938,[121 496 111 655 423],588,1,3891,4.143769968051118,0.0,0.0
40939,4,939,[483 313  64 318  11],214,5,3896,4.14468085106383,80.0,20.0
40940,4,940,[483 313  64 318  11],214,5,3901,4.1455897980871415,80.0,20.0
40941,4,941,[483 313  64 318  11],618,5,3906,4.146496815286624,80.0,20.0
40942,4,942,[ 28 210 174  88 235],43,4,3910,4.146341463414634,0.0,0.0
40943,4,943,[286 318 313 182 125],416,5,3915,4.147245762711864,40.0,20.0
40944,4,944,[ 70 300 508 200 288],345,3,3918,4.146031746031746,0.0,20.0
40945,4,945,[196  79 194   1 173],297,2,3920,4.143763213530655,0.0,0.0
40946,4,946,[483 313  64 318  11],618,5,3925,4.1446673706441395,80.0,20.0
40947,4,947,[483 313  64 318  11],618,5,3930,4.1455696202531644,80.0,20.0
40948,4,948,[143  22 200 427 183],887,3,3933,4.14436248682824,0.0,0.0
40949,4,949,[483 313  64 318  11],214,5,3938,4.145263157894737,80.0,20.0
40950,4,950,[483 313  64 318  11],618,5,3943,4.146161934805468,80.0,20.0
40951,4,951,[258 300  25 222 127],630,2,3945,4.14390756302521,0.0,0.0
40952,4,952,[483 313  64 318  11],214,5,3950,4.144805876180483,80.0,20.0
40953,4,953,[191 245 597 258  28],416,3,3953,4.143605870020965,0.0,0.0
40954,4,954,[132 118 405 127 235],417,3,3956,4.142408376963351,0.0,0.0
40955,4,955,[483 313  64 318  11],618,5,3961,4.143305439330544,80.0,20.0
40956,4,956,[483 313  64 318  11],618,5,3966,4.144200626959248,80.0,20.0
40957,4,957,[483 313  64 318  11],618,5,3971,4.145093945720251,80.0,20.0
40958,4,958,[483 313  64 318  11],618,5,3976,4.145985401459854,80.0,20.0
40959,4,959,[191  11 172 276 568],922,2,3978,4.14375,0.0,0.0
40960,4,960,[196   9 496 289  15],342,2,3980,4.141519250780437,0.0,0.0
40961,4,961,[483 313  64 318  11],214,5,3985,4.142411642411642,80.0,20.0
40962,4,962,[204  88  96  50 403],805,3,3988,4.14122533748702,0.0,20.0
40963,4,963,[483 313  64 318  11],214,5,3993,4.1421161825726145,80.0,20.0
40964,4,964,[258 175 185 216 269],805,3,3996,4.140932642487047,0.0,0.0
40965,4,965,[483 313  64 318  11],618,5,4001,4.141821946169772,80.0,20.0
40966,4,966,[245 237 271 286  89],297,3,4004,4.140641158221303,0.0,0.0
40967,4,967,[483 313  64 318  11],618,5,4009,4.141528925619835,80.0,20.0
40968,4,968,[483 313  64 318  11],214,5,4014,4.142414860681114,80.0,20.0
40969,4,969,[483 313  64 318  11],214,5,4019,4.143298969072165,80.0,20.0
40970,4,970,[173  28 175 181 268],721,5,4024,4.144181256436664,0.0,20.0
40971,4,971,[483 313  64 318  11],618,5,4029,4.145061728395062,80.0,20.0
40972,4,972,[483 313  64 318  11],214,5,4034,4.145940390544707,80.0,20.0
40973,4,973,[483 313  64 318  11],214,5,4039,4.146817248459959,80.0,20.0
40974,4,974,[483 313  64 318  11],618,5,4044,4.147692307692307,80.0,20.0
40975,4,975,[176 174 403 323 118],198,3,4047,4.146516393442623,0.0,0.0
40976,4,976,[ 64 357  88  56   1],416,4,4051,4.146366427840327,20.0,0.0
40977,4,977,[ 70   1 276 204 294],62,1,4052,4.143149284253579,0.0,0.0
40978,4,978,[423 318  88 216 196],373,4,4056,4.143003064351379,20.0,0.0
40979,4,979,[269 100 546 588 196],43,5,4061,4.143877551020408,0.0,0.0
40980,4,980,[483 313  64 318  11],214,5,4066,4.144750254841998,80.0,20.0
40981,4,981,[111 475 185 202  71],711,3,4069,4.143584521384929,0.0,0.0
40982,4,982,[182 121 275 238 185],437,3,4072,4.142421159715158,0.0,0.0
40983,4,983,[ 50 191 111 294 603],128,4,4076,4.142276422764228,0.0,20.0
40984,4,984,[483 313  64 318  11],214,5,4081,4.143147208121827,80.0,20.0
40985,4,985,[483 313  64 318  11],618,5,4086,4.144016227180527,80.0,20.0
40986,4,986,[ 22 182 597 176 181],416,4,4090,4.14387031408308,0.0,20.0
40987,4,987,[ 12 175 125 238 194],373,4,4094,4.1437246963562755,20.0,0.0
40988,4,988,[483 313  64 318  11],618,5,4099,4.1445904954499495,80.0,20.0
40989,4,989,[483 313  64 318  11],214,5,4104,4.1454545454545455,80.0,20.0
40990,4,990,[483 313  64 318  11],214,5,4109,4.146316851664984,80.0,20.0
40991,4,991,[483 313  64 318  11],214,5,4114,4.147177419354839,80.0,20.0
40992,4,992,[483 313  64 318  11],214,5,4119,4.148036253776435,80.0,20.0
40993,4,993,[288  97  79   1 195],654,3,4122,4.146881287726358,0.0,20.0
40994,4,994,[118  69 268  79 204],128,4,4126,4.146733668341708,0.0,0.0
40995,4,995,[483 313  64 318  11],618,5,4131,4.147590361445783,80.0,20.0
40996,4,996,[200 216 195   4  64],618,2,4133,4.14543630892678,20.0,0.0
40997,4,997,[483 313  64 318  11],214,5,4138,4.1462925851703405,80.0,20.0
40998,4,998,[748  64 323 186 237],198,2,4140,4.1441441441441444,20.0,0.0
40999,4,999,[ 69 237 151 196  70],345,5,4145,4.145,0.0,0.0
41000,4,1000,[483 313  64 318  11],214,5,4150,4.145854145854146,80.0,20.0
41001,4,1001,[546   7 385 276 204],43,5,4155,4.1467065868263475,0.0,0.0
41002,4,1002,[423 144 121  11 405],805,0,4155,4.142572283150549,0.0,0.0
41003,4,1003,[191 286 475 174 235],297,3,4158,4.1414342629482075,0.0,0.0
41004,4,1004,[483 313  64 318  11],618,5,4163,4.142288557213931,80.0,20.0
41005,4,1005,[483 313  64 318  11],214,5,4168,4.143141153081511,80.0,20.0
41006,4,1006,[483 313  64 318  11],618,5,4173,4.143992055610725,80.0,20.0
41007,4,1007,[483 313  64 318  11],214,5,4178,4.14484126984127,80.0,20.0
41008,4,1008,[483 313  64 318  11],214,5,4183,4.145688800792864,80.0,20.0
41009,4,1009,[161 423 111 435  50],721,5,4188,4.146534653465347,0.0,20.0
41010,4,1010,[257  96 318 271 182],62,3,4191,4.14540059347181,20.0,0.0
41011,4,1011,[483 313  64 318  11],618,5,4196,4.146245059288537,80.0,20.0
41012,4,1012,[197 153  71 678  28],805,3,4199,4.145113524185588,0.0,0.0
41013,4,1013,[ 96 117 427 275 202],907,5,4204,4.145956607495069,0.0,0.0
41014,4,1014,[185 196 172 121 268],214,3,4207,4.144827586206897,0.0,0.0
41015,4,1015,[288  82 173 300  50],654,4,4211,4.144685039370079,0.0,40.0
41016,4,1016,[ 28 172 288 294 405],887,5,4216,4.145526057030482,0.0,20.0
41017,4,1017,[132   8 210 228 234],230,4,4220,4.145383104125736,0.0,0.0
41018,4,1018,[423 313 385  69  11],43,5,4225,4.146221786064769,20.0,20.0
41019,4,1019,[357  70 257 235 435],297,2,4227,4.144117647058824,0.0,0.0
41020,4,1020,[483 313  64 318  11],618,5,4232,4.144955925563173,80.0,20.0
41021,4,1021,[483 313  64 318  11],214,5,4237,4.145792563600783,80.0,20.0
41022,4,1022,[269  28 496  70   9],416,5,4242,4.146627565982405,0.0,0.0
41023,4,1023,[118  96   4 132  11],618,2,4244,4.14453125,0.0,0.0
41024,4,1024,[483 313  64 318  11],618,5,4249,4.145365853658537,80.0,20.0
41025,4,1025,[175 603  96 483 135],698,2,4251,4.143274853801169,20.0,0.0
41026,4,1026,[313  64 483 318  11],214,5,4256,4.144109055501461,80.0,20.0
41027,4,1027,[313  64 483 318  11],618,5,4261,4.1449416342412455,80.0,20.0
41028,4,1028,[135 117 180 508 483],854,4,4265,4.144800777453838,20.0,0.0
41029,4,1029,[313  64 483 318  11],214,5,4270,4.145631067961165,80.0,20.0
41030,4,1030,[127 655   9  12 322],416,4,4274,4.1454898157129,20.0,0.0
41031,4,1031,[197 405  56 173 257],751,3,4277,4.14437984496124,0.0,0.0
41032,4,1032,[186 269 194  71 588],373,4,4281,4.144240077444337,0.0,0.0
41033,4,1033,[117 234 176 258 313],416,5,4286,4.145067698259187,20.0,20.0
41034,4,1034,[313  64 483 318  11],618,5,4291,4.145893719806764,80.0,20.0
41035,4,1035,[183 216 471 135 211],297,4,4295,4.145752895752896,0.0,0.0
41036,4,1036,[275 132 405  50 174],262,1,4296,4.142719382835101,0.0,20.0
41037,4,1037,[313  64 483 318  11],618,5,4301,4.14354527938343,80.0,20.0
41038,4,1038,[313  64 483 318  11],618,5,4306,4.144369586140519,80.0,20.0
41039,4,1039,[328  89 423  71 318],62,3,4309,4.1432692307692305,20.0,0.0
41040,4,1040,[742 175  98 258 204],805,2,4311,4.141210374639769,0.0,20.0
41041,4,1041,[313  64 483 318  11],618,5,4316,4.142034548944338,80.0,20.0
41042,4,1042,[655 258 196 202  22],805,0,4316,4.138063279002877,0.0,0.0
41043,4,1043,[ 98 385 204 294 435],230,4,4320,4.137931034482759,0.0,20.0
41044,4,1044,[ 56 182 655 385 483],618,5,4325,4.138755980861244,20.0,0.0
41045,4,1045,[ 95 568   1 323  56],417,3,4328,4.137667304015296,0.0,0.0
41046,4,1046,[313 483  64 318  11],214,5,4333,4.138490926456543,80.0,20.0
41047,4,1047,[111  95 197 175 289],342,3,4336,4.137404580152672,0.0,0.0
41048,4,1048,[357 568 546  12   4],416,4,4340,4.137273593898952,20.0,0.0
41049,4,1049,[194 153 195  70 210],297,3,4343,4.136190476190476,0.0,0.0
41050,4,1050,[318 245 234 176 276],416,3,4346,4.135109419600381,20.0,0.0
41051,4,1051,[313 483  64 318  11],214,5,4351,4.135931558935361,80.0,20.0
41052,4,1052,[168 323  69 748 257],416,3,4354,4.134852801519468,0.0,0.0
41053,4,1053,[144 118   9 288 423],618,2,4356,4.132827324478178,0.0,20.0
41054,4,1054,[313 483  64 318  11],214,5,4361,4.133649289099526,80.0,20.0
41055,4,1055,[ 12 228 197 210 568],405,4,4365,4.1335227272727275,20.0,0.0
41056,4,1056,[313 483  64 318  11],214,5,4370,4.134342478713339,80.0,20.0
41057,4,1057,[313 483  64 318  11],618,5,4375,4.1351606805293,80.0,20.0
41058,4,1058,[271  96 302  22 168],854,2,4377,4.1331444759206795,0.0,0.0
41059,4,1059,[313 483  64 318  11],214,5,4382,4.133962264150943,80.0,20.0
41060,4,1060,[ 89 176 302 742  50],417,2,4384,4.131950989632422,0.0,20.0
41061,4,1061,[313 483  64 318  11],214,5,4389,4.132768361581921,80.0,20.0
41062,4,1062,[496 423 117 200  50],437,4,4393,4.132643461900282,0.0,20.0
41063,4,1063,[  4  89 546 121 127],62,5,4398,4.133458646616542,0.0,0.0
41064,4,1064,[  1 235 173 294 125],907,5,4403,4.134272300469483,0.0,0.0
41065,4,1065,[313 483  64 318  11],618,5,4408,4.135084427767355,80.0,20.0
41066,4,1066,[313 483  64 318  11],618,5,4413,4.1358950328022495,80.0,20.0
41067,4,1067,[313 483  64 318  11],618,5,4418,4.1367041198501875,80.0,20.0
41068,4,1068,[313 483  64 318  11],214,5,4423,4.137511693171188,80.0,20.0
41069,4,1069,[127 318 151 385 117],198,3,4426,4.136448598130841,20.0,0.0
41070,4,1070,[235 294 515  70 135],417,3,4429,4.135387488328665,0.0,0.0
41071,4,1071,[ 97  56 269 742 546],297,3,4432,4.134328358208955,0.0,0.0
41072,4,1072,[302  70 318 597 286],43,4,4436,4.134203168685928,20.0,0.0
41073,4,1073,[202 678 185 257 144],416,3,4439,4.133147113594041,0.0,0.0
41074,4,1074,[427  56  82 132 265],128,3,4442,4.1320930232558135,0.0,0.0
41075,4,1075,[301   8 216 313 151],43,5,4447,4.132899628252788,20.0,20.0
41076,4,1076,[174  79 301 173 117],345,5,4452,4.133704735376044,0.0,0.0
41077,4,1077,[313 483  64 318  11],618,5,4457,4.134508348794063,80.0,20.0
41078,4,1078,[ 95 161   7  69 211],416,4,4461,4.134383688600556,0.0,0.0
41079,4,1079,[ 12 302 144 288 204],654,4,4465,4.1342592592592595,20.0,20.0
41080,4,1080,[210 588  98  71 427],230,5,4470,4.135060129509713,0.0,20.0
41081,4,1081,[313 483  64 318  11],214,5,4475,4.135859519408503,80.0,20.0
41082,4,1082,[ 97 191 100 273 333],416,5,4480,4.136657433056325,0.0,0.0
41083,4,1083,[313 483  64 318  11],214,5,4485,4.137453874538745,80.0,20.0
41084,4,1084,[313 483  64 318  11],214,5,4490,4.138248847926267,80.0,20.0
41085,4,1085,[313 483  64 318  11],214,5,4495,4.139042357274401,80.0,20.0
41086,4,1086,[ 28 508 588 546  97],654,3,4498,4.137994480220791,0.0,0.0
41087,4,1087,[313 483  64 318  11],214,5,4503,4.138786764705882,80.0,20.0
41088,4,1088,[385  82 301 168 175],43,4,4507,4.138659320477502,0.0,0.0
41089,4,1089,[313 483  64 318  11],214,5,4512,4.139449541284404,80.0,20.0
41090,4,1090,[546 475   1  22 257],416,2,4514,4.1374885426214485,0.0,0.0
41091,4,1091,[153 302 127 118 655],417,4,4518,4.137362637362638,0.0,0.0
41092,4,1092,[186 427  71 515 216],405,2,4520,4.1354071363220495,0.0,0.0
41093,4,1093,[182 302 357 515  15],416,5,4525,4.1361974405850095,0.0,0.0
41094,4,1094,[655 186   1 210 195],198,4,4529,4.13607305936073,0.0,0.0
41095,4,1095,[313 483  64 318  11],618,5,4534,4.136861313868613,80.0,20.0
41096,4,1096,[237 173   4 216 483],618,2,4536,4.134913400182316,20.0,0.0
41097,4,1097,[568 215 588 275  22],618,4,4540,4.134790528233151,0.0,0.0
41098,4,1098,[127 161 258 357  97],417,4,4544,4.134667879890809,0.0,0.0
41099,4,1099,[265 228 568  11  22],230,3,4547,4.133636363636364,0.0,0.0
41100,4,1100,[294 151  12 546 181],805,2,4549,4.131698455949137,20.0,20.0
41101,4,1101,[313 483  64 318  11],618,5,4554,4.132486388384755,80.0,20.0
41102,4,1102,[515 117 161 385  12],416,5,4559,4.133272892112421,20.0,0.0
41103,4,1103,[313 483  64 318  11],618,5,4564,4.134057971014493,80.0,20.0
41104,4,1104,[313 483  64 318  11],618,5,4569,4.134841628959276,80.0,20.0
41105,4,1105,[313 483  64 318  11],618,5,4574,4.135623869801085,80.0,20.0
41106,4,1106,[ 96  25 318 496 403],618,3,4577,4.134598012646793,20.0,0.0
41107,4,1107,[313 483  64 318  11],618,5,4582,4.135379061371841,80.0,20.0
41108,4,1108,[168   1  15  56 204],618,3,4585,4.134355275022543,0.0,0.0
41109,4,1109,[181 313 258 301 302],782,2,4587,4.132432432432433,20.0,40.0
41110,4,1110,[313 483  64 318  11],214,5,4592,4.133213321332133,80.0,20.0
41111,4,1111,[200 215 403  15 191],198,4,4596,4.133093525179856,0.0,0.0
41112,4,1112,[313 483  64 318  11],618,5,4601,4.133872416891284,80.0,20.0
41113,4,1113,[748 300 185 273 202],416,5,4606,4.134649910233393,0.0,0.0
41114,4,1114,[132 179 153 475 289],342,4,4610,4.134529147982063,0.0,0.0
41115,4,1115,[237 195   4 117  15],618,2,4612,4.132616487455197,0.0,0.0
41116,4,1116,[313 483  64 318  11],618,5,4617,4.133393017009848,80.0,20.0
41117,4,1117,[313 483  64 318  11],214,5,4622,4.1341681574239715,80.0,20.0
41118,4,1118,[ 12 210 197 144 175],297,3,4625,4.133154602323503,20.0,0.0
41119,4,1119,[313 483  64 318  11],214,5,4630,4.133928571428571,80.0,20.0
41120,4,1120,[313 483  64 318  11],618,5,4635,4.134701159678858,80.0,20.0
41121,4,1121,[211 403  15 191 597],43,4,4639,4.134581105169341,0.0,0.0
41122,4,1122,[742 111 588 257 172],417,0,4639,4.1308993766696345,0.0,0.0
41123,4,1123,[ 89  97 318  79 173],405,3,4642,4.129893238434164,20.0,0.0
41124,4,1124,[313 483  64 318  11],214,5,4647,4.1306666666666665,80.0,20.0
41125,4,1125,[153 191  12 423 100],416,5,4652,4.131438721136767,20.0,0.0
41126,4,1126,[294 508 215 282 302],297,2,4654,4.129547471162378,0.0,0.0
41127,4,1127,[313 483  64 318  11],214,5,4659,4.13031914893617,80.0,20.0
41128,4,1128,[313 483  64 318  11],214,5,4664,4.131089459698848,80.0,20.0
41129,4,1129,[313 483  64 318  11],214,5,4669,4.131858407079646,80.0,20.0
41130,4,1130,[143  97 185 508 275],297,5,4674,4.13262599469496,0.0,0.0
41131,4,1131,[313 483  64 318  11],214,5,4679,4.13339222614841,80.0,20.0
41132,4,1132,[357 234  11  98 427],198,4,4683,4.133274492497794,0.0,20.0
41133,4,1133,[ 11   4 185  22 405],805,1,4684,4.1305114638447975,0.0,0.0
41134,4,1134,[313 483  64 318  11],618,5,4689,4.131277533039648,80.0,20.0
41135,4,1135,[313 483  64 318  11],618,5,4694,4.132042253521127,80.0,20.0
41136,4,1136,[96 98  8 64 95],230,4,4698,4.1319261213720315,20.0,20.0
41137,4,1137,[237 168 111  50 300],297,3,4701,4.1309314586994725,0.0,20.0
41138,4,1138,[313 483  64 318  11],618,5,4706,4.131694468832309,80.0,20.0
41139,4,1139,[ 70 234 515 318 403],405,3,4709,4.1307017543859645,20.0,0.0
41140,4,1140,[ 56  25 216 100 161],588,4,4713,4.130587204206836,0.0,0.0
41141,4,1141,[313 483  64 318  11],618,5,4718,4.131348511383537,80.0,20.0
41142,4,1142,[313 483  64 318  11],618,5,4723,4.132108486439195,80.0,20.0
41143,4,1143,[475 173 234  15  69],588,3,4726,4.131118881118881,0.0,0.0
41144,4,1144,[182 273 257 742 191],417,2,4728,4.129257641921398,0.0,0.0
41145,4,1145,[313 483  64 318  11],214,5,4733,4.130017452006981,80.0,20.0
41146,4,1146,[655 748 302 294  79],416,5,4738,4.1307759372275505,0.0,0.0
41147,4,1147,[313 483  64 318  11],618,5,4743,4.131533101045296,80.0,20.0
41148,4,1148,[313 483  64 318  11],214,5,4748,4.132288946910357,80.0,20.0
41149,4,1149,[313 483  64 318  11],618,5,4753,4.13304347826087,80.0,20.0
41150,4,1150,[313 483  64 318  11],214,5,4758,4.133796698523024,80.0,20.0
41151,4,1151,[144 180  12 200 222],854,4,4762,4.133680555555555,20.0,0.0
41152,4,1152,[257 302 588 385  56],751,5,4767,4.134431916738942,0.0,0.0
41153,4,1153,[313 483  64 318  11],214,5,4772,4.135181975736568,80.0,20.0
41154,4,1154,[ 79 235 202 179  96],805,3,4775,4.134199134199134,0.0,0.0
41155,4,1155,[313 483  64 318  11],618,5,4780,4.134948096885813,80.0,20.0
41156,4,1156,[ 97 111 268  22 118],588,2,4782,4.133102852203976,0.0,0.0
41157,4,1157,[  8 182 678 183 273],416,4,4786,4.132987910189983,0.0,0.0
41158,4,1158,[135 318 132 117  15],618,4,4790,4.132873166522865,20.0,0.0
41159,4,1159,[313 483  64 318  11],214,5,4795,4.133620689655173,80.0,20.0
41160,4,1160,[313 483  64 318  11],214,5,4800,4.134366925064599,80.0,20.0
41161,4,1161,[313 483  64 318  11],618,5,4805,4.135111876075731,80.0,20.0
41162,4,1162,[216 655  96 174 195],416,5,4810,4.13585554600172,0.0,0.0
41163,4,1163,[313 483  64 318  11],214,5,4815,4.13659793814433,80.0,20.0
41164,4,1164,[313 483  64 318  11],214,5,4820,4.1373390557939915,80.0,20.0
41165,4,1165,[313 483  64 318  11],618,5,4825,4.138078902229846,80.0,20.0
41166,4,1166,[313 483  64 318  11],618,5,4830,4.138817480719794,80.0,20.0
41167,4,1167,[313 483  64 318  11],214,5,4835,4.1395547945205475,80.0,20.0
41168,4,1168,[ 50 288 475 185 197],297,3,4838,4.13857998289136,0.0,40.0
41169,4,1169,[313 483  64 318  11],618,5,4843,4.13931623931624,80.0,20.0
41170,4,1170,[ 69 318  15 132  28],618,4,4847,4.139197267292912,20.0,0.0
41171,4,1171,[357   7 111 268 174],854,2,4849,4.137372013651877,0.0,0.0
41172,4,1172,[ 71  28 423 237 568],654,4,4853,4.137254901960785,0.0,0.0
41173,4,1173,[313 483  64 318  11],214,5,4858,4.137989778534924,80.0,20.0
41174,4,1174,[313 483  64 318  11],618,5,4863,4.138723404255319,80.0,20.0
41175,4,1175,[313 483  64 318  11],214,5,4868,4.139455782312925,80.0,20.0
41176,4,1176,[313 483  64 318  11],214,5,4873,4.140186915887851,80.0,20.0
41177,4,1177,[318  28  98 168 202],12,5,4878,4.140916808149406,20.0,20.0
41178,4,1178,[245 471 121 742  15],416,4,4882,4.140797285835454,0.0,0.0
41179,4,1179,[313 483  64 318  11],618,5,4887,4.1415254237288135,80.0,20.0
41180,4,1180,[237 258 275 289 153],43,5,4892,4.14225232853514,0.0,0.0
41181,4,1181,[  4   8 276 302  12],43,5,4897,4.142978003384095,20.0,0.0
41182,4,1182,[245 197 508  50 125],345,3,4900,4.1420118343195265,0.0,20.0
41183,4,1183,[127 187 405 235 288],416,4,4904,4.141891891891892,0.0,20.0
41184,4,1184,[313 483  64 318  11],618,5,4909,4.142616033755274,80.0,20.0
41185,4,1185,[ 28 173 475 276 427],416,3,4912,4.141652613827993,0.0,0.0
41186,4,1186,[234 300 117 515 546],297,2,4914,4.139848357203033,0.0,0.0
41187,4,1187,[313 483  64 318  11],214,5,4919,4.140572390572391,80.0,20.0
41188,4,1188,[ 56  95 135 588 234],805,3,4922,4.139613120269134,0.0,0.0
41189,4,1189,[328  56 211 121  82],43,5,4927,4.140336134453782,0.0,0.0
41190,4,1190,[ 82  69 132  50 475],601,3,4930,4.139378673383711,0.0,20.0
41191,4,1191,[313 483  64 318  11],618,5,4935,4.14010067114094,80.0,20.0
41192,4,1192,[186 191 515 153 197],354,3,4938,4.139145012573344,0.0,0.0
41193,4,1193,[175 333 127 323 181],721,3,4941,4.13819095477387,0.0,20.0
41194,4,1194,[313 483  64 318  11],214,5,4946,4.138912133891213,80.0,20.0
41195,4,1195,[313 483  64 318  11],214,5,4951,4.139632107023411,80.0,20.0
41196,4,1196,[568  12 161 196 265],416,5,4956,4.140350877192983,20.0,0.0
41197,4,1197,[313 483  64 318  11],214,5,4961,4.141068447412354,80.0,20.0
41198,4,1198,[125 245 294  28  22],62,2,4963,4.139282735613011,0.0,0.0
41199,4,1199,[ 97 235 271  11 215],43,3,4966,4.138333333333334,0.0,0.0
41200,4,1200,[313 483  64 318  11],618,5,4971,4.139050791007493,80.0,20.0
41201,4,1201,[313 483  64 318  11],618,5,4976,4.139767054908486,80.0,20.0
41202,4,1202,[ 56  82 508  50 483],601,3,4979,4.13881961762261,20.0,20.0
41203,4,1203,[313 483  64 318  11],214,5,4984,4.1395348837209305,80.0,20.0
41204,4,1204,[238 121 471  71 568],43,3,4987,4.138589211618258,0.0,0.0
41205,4,1205,[301 235 515 245 496],416,3,4990,4.137645107794362,0.0,0.0
41206,4,1206,[210 258 168 211 143],354,3,4993,4.136702568351284,0.0,0.0
41207,4,1207,[121 302 174  12 471],416,5,4998,4.137417218543046,20.0,0.0
41208,4,1208,[313 483  64 318  11],618,5,5003,4.138130686517783,80.0,20.0
41209,4,1209,[  7  28 282 118 678],416,3,5006,4.137190082644628,0.0,0.0
41210,4,1210,[313 483  64 318  11],618,5,5011,4.137902559867878,80.0,20.0
41211,4,1211,[313 483  64 318  11],618,5,5016,4.138613861386139,80.0,20.0
41212,4,1212,[ 28 302  12 234 204],405,5,5021,4.139323990107172,20.0,0.0
41213,4,1213,[313 483  64 318  11],618,5,5026,4.14003294892916,80.0,20.0
41214,4,1214,[288 742 269 173 313],345,4,5030,4.139917695473251,20.0,40.0
41215,4,1215,[176   9 322  15  71],416,4,5034,4.139802631578948,0.0,0.0
41216,4,1216,[423  88 313  64 568],43,5,5039,4.1405094494659,40.0,20.0
41217,4,1217,[313 483  64 318  11],618,5,5044,4.141215106732348,80.0,20.0
41218,4,1218,[143 427  96 161 200],405,2,5046,4.139458572600492,0.0,0.0
41219,4,1219,[271  69 100  50  28],43,4,5050,4.139344262295082,0.0,20.0
41220,4,1220,[191 161   1 427 143],198,3,5053,4.138411138411138,0.0,0.0
41221,4,1221,[313 483  64 318  11],214,5,5058,4.13911620294599,80.0,20.0
41222,4,1222,[357 181 191 215 328],416,5,5063,4.139820114472609,0.0,20.0
41223,4,1223,[313 483  64 318  11],618,5,5068,4.140522875816994,80.0,20.0
41224,4,1224,[313 483  64 318  11],618,5,5073,4.141224489795919,80.0,20.0
41225,4,1225,[313 483  64 318  11],618,5,5078,4.141924959216966,80.0,20.0
41226,4,1226,[ 64 294 546  69 313],416,4,5082,4.141809290953545,40.0,20.0
41227,4,1227,[313  64 483 318  11],618,5,5087,4.142508143322476,80.0,20.0
41228,4,1228,[ 96 100 196 265 200],618,4,5091,4.142392188771359,0.0,0.0
41229,4,1229,[313  64 483 318  11],618,5,5096,4.143089430894309,80.0,20.0
41230,4,1230,[ 11 161 234 216 588],417,2,5098,4.141348497156783,0.0,0.0
41231,4,1231,[202 197 271 151 172],805,3,5101,4.140422077922078,0.0,0.0
41232,4,1232,[313  64 483 318  11],214,5,5106,4.141119221411192,80.0,20.0
41233,4,1233,[313  64 483 318  11],618,5,5111,4.141815235008104,80.0,20.0
41234,4,1234,[313  64 483 318  11],618,5,5116,4.14251012145749,80.0,20.0
41235,4,1235,[313  64 483 318  11],618,5,5121,4.143203883495145,80.0,20.0
41236,4,1236,[271  98 471 237  56],43,3,5124,4.142279708973323,0.0,20.0
41237,4,1237,[313  64 483 318  11],214,5,5129,4.14297253634895,80.0,20.0
41238,4,1238,[301 195 475 423 588],297,3,5132,4.142050040355125,0.0,0.0
41239,4,1239,[313  64 483 318  11],618,5,5137,4.142741935483871,80.0,20.0
41240,4,1240,[322   4 258 655 268],417,3,5140,4.141821112006446,0.0,0.0
41241,4,1241,[288  56 173   8 135],618,2,5142,4.140096618357488,0.0,20.0
41242,4,1242,[ 96 385 300 655 228],705,3,5145,4.13917940466613,0.0,0.0
41243,4,1243,[313  64 483 318  11],618,5,5150,4.139871382636656,80.0,20.0
41244,4,1244,[313  64 483 318  11],214,5,5155,4.140562248995984,80.0,20.0
41245,4,1245,[405 182 204 238   7],416,5,5160,4.141252006420546,0.0,0.0
41246,4,1246,[197 655 275 191 132],437,5,5165,4.141940657578187,0.0,0.0
41247,4,1247,[313  64 483 318  11],214,5,5170,4.142628205128205,80.0,20.0
41248,4,1248,[597  70 742 172  97],416,4,5174,4.142514011208967,0.0,0.0
41249,4,1249,[313  64 483 318  11],214,5,5179,4.1432,80.0,20.0
41250,4,1250,[318 197 210  89  71],373,4,5183,4.14308553157474,20.0,0.0
41251,4,1251,[200  71 403 588 496],416,5,5188,4.143769968051118,0.0,0.0
41252,4,1252,[313  64 483 318  11],214,5,5193,4.144453312051078,80.0,20.0
41253,4,1253,[313  64 483 318  11],618,5,5198,4.1451355661881975,80.0,20.0
41254,4,1254,[179  88 200 211  89],405,0,5198,4.141832669322709,0.0,0.0
41255,4,1255,[181  97  50 173  79],654,3,5201,4.140923566878981,0.0,40.0
41256,4,1256,[313  64 483 318  11],214,5,5206,4.141607000795545,80.0,20.0
41257,4,1257,[313  64 483 318  11],214,5,5211,4.142289348171701,80.0,20.0
41258,4,1258,[313  64 483 318  11],214,5,5216,4.142970611596505,80.0,20.0
41259,4,1259,[546  96 191  50  56],262,3,5219,4.1420634920634924,0.0,20.0
41260,4,1260,[313  64 483 318  11],618,5,5224,4.142743854084061,80.0,20.0
41261,4,1261,[313  64 483 318  11],618,5,5229,4.143423137876387,80.0,20.0
41262,4,1262,[435 183 475 300  12],297,3,5232,4.14251781472684,20.0,0.0
41263,4,1263,[313  64 483 318  11],618,5,5237,4.143196202531645,80.0,20.0
41264,4,1264,[597 215  28   7 143],43,4,5241,4.143083003952569,0.0,0.0
41265,4,1265,[313  64 483 318  11],214,5,5246,4.143759873617694,80.0,20.0
41266,4,1266,[179 237 185  71 235],262,2,5248,4.142067876874506,0.0,0.0
41267,4,1267,[313  64 483 318  11],618,5,5253,4.142744479495268,80.0,20.0
41268,4,1268,[313  64 483 318  11],214,5,5258,4.143420015760442,80.0,20.0
41269,4,1269,[313  64 483 318  11],618,5,5263,4.144094488188976,80.0,20.0
41270,4,1270,[313  64 483 318  11],214,5,5268,4.144767899291896,80.0,20.0
41271,4,1271,[ 71 132  64 597 144],62,3,5271,4.143867924528302,20.0,0.0
41272,4,1272,[385  95 655 302 318],416,4,5275,4.143754909662215,20.0,0.0
41273,4,1273,[405 153 143 173 403],805,3,5278,4.142857142857143,0.0,0.0
41274,4,1274,[ 79 265 257 655 121],416,4,5282,4.1427450980392155,0.0,0.0
41275,4,1275,[182 153 121 300   8],253,3,5285,4.141849529780564,0.0,0.0
41276,4,1276,[132 127  12 273 215],175,3,5288,4.14095536413469,20.0,0.0
41277,4,1277,[313  64 483 318  11],214,5,5293,4.141627543035994,80.0,20.0
41278,4,1278,[179 655  15  56 228],721,3,5296,4.140734949179046,0.0,0.0
41279,4,1279,[ 82   1 144  11 127],805,1,5297,4.13828125,0.0,0.0
41280,4,1280,[127 100 172  50 313],43,5,5302,4.1389539422326305,20.0,40.0
41281,4,1281,[168 183 228 357 603],698,2,5304,4.137285491419656,0.0,0.0
41282,4,1282,[313  64 483 318  11],214,5,5309,4.137957911145752,80.0,20.0
41283,4,1283,[117 216 118 125 180],62,4,5313,4.13785046728972,0.0,0.0
41284,4,1284,[  1  64  96 234   7],618,4,5317,4.137743190661479,20.0,0.0
41285,4,1285,[168  79 258 275 333],416,5,5322,4.138413685847589,0.0,0.0
41286,4,1286,[313  64 483 318  11],214,5,5327,4.139083139083139,80.0,20.0
41287,4,1287,[313  64 483 318  11],214,5,5332,4.1397515527950315,80.0,20.0
41288,4,1288,[313  64 483 318  11],618,5,5337,4.140418929402638,80.0,20.0
41289,4,1289,[313  64 483 318  11],618,5,5342,4.14108527131783,80.0,20.0
41290,4,1290,[183 144 427 143 151],618,4,5346,4.140975987606507,0.0,0.0
41291,4,1291,[  8 127 132 168 258],887,3,5349,4.140092879256966,0.0,0.0
41292,4,1292,[194 655 286 427   7],342,4,5353,4.139984532095901,0.0,0.0
41293,4,1293,[313  64 483 318  11],618,5,5358,4.14064914992272,80.0,20.0
41294,4,1294,[313  64 483 318  11],214,5,5363,4.141312741312741,80.0,20.0
41295,4,1295,[143 127 405  15 153],416,5,5368,4.1419753086419755,0.0,0.0
41296,4,1296,[313  64 483 318  11],214,5,5373,4.142636854279106,80.0,20.0
41297,4,1297,[313  64 483 318  11],214,5,5378,4.143297380585516,80.0,20.0
41298,4,1298,[ 69 117 175 135 197],373,2,5380,4.141647421093149,0.0,0.0
41299,4,1299,[257  79 216 100 175],297,3,5383,4.140769230769231,0.0,0.0
41300,4,1300,[ 28 168   1 202   8],588,4,5387,4.140661029976941,0.0,0.0
41301,4,1301,[ 11 288 153 185 323],805,3,5390,4.139784946236559,0.0,20.0
41302,4,1302,[ 11 191 275  70 173],416,5,5395,4.140445126630852,0.0,0.0
41303,4,1303,[471 289 185  64 269],854,3,5398,4.139570552147239,20.0,0.0
41304,4,1304,[313  64 483 318  11],618,5,5403,4.1402298850574715,80.0,20.0
41305,4,1305,[313  64 483 318  11],618,5,5408,4.1408882082695255,80.0,20.0
41306,4,1306,[176 210 173 180 403],805,3,5411,4.1400153022188215,0.0,0.0
41307,4,1307,[313  64 483 318  11],214,5,5416,4.140672782874618,80.0,20.0
41308,4,1308,[313  64 483 318  11],618,5,5421,4.1413292589763175,80.0,20.0
41309,4,1309,[ 11  97 200 210 275],437,2,5423,4.139694656488549,0.0,0.0
41310,4,1310,[313  64 483 318  11],214,5,5428,4.140350877192983,80.0,20.0
41311,4,1311,[313  64 483 318  11],214,5,5433,4.141006097560975,80.0,20.0
41312,4,1312,[228 257  50 568 515],698,2,5435,4.139375476009139,0.0,20.0
41313,4,1313,[318  12 168 127 161],618,5,5440,4.140030441400304,40.0,0.0
41314,4,1314,[313  64 483 318  11],214,5,5445,4.140684410646388,80.0,20.0
41315,4,1315,[313  64 483 318  11],214,5,5450,4.141337386018237,80.0,20.0
41316,4,1316,[313  64 483 318  11],214,5,5455,4.141989369779803,80.0,20.0
41317,4,1317,[168   8 385  22 655],618,4,5459,4.141881638846738,0.0,0.0
41318,4,1318,[313  64 483 318  11],618,5,5464,4.142532221379833,80.0,20.0
41319,4,1319,[111 234 121 222 235],805,2,5466,4.140909090909091,0.0,0.0
41320,4,1320,[475  11 143   9  79],805,2,5468,4.139288417865254,0.0,0.0
41321,4,1321,[313  64 483 318  11],618,5,5473,4.139939485627837,80.0,20.0
41322,4,1322,[748  50 181 196  98],805,2,5475,4.138321995464852,0.0,60.0
41323,4,1323,[748 185 515 132 333],416,5,5480,4.138972809667674,0.0,0.0
41324,4,1324,[742 237   1 405 568],416,4,5484,4.138867924528302,0.0,0.0
41325,4,1325,[313  64 483 318  11],214,5,5489,4.139517345399699,80.0,20.0
41326,4,1326,[161   4 182  64  79],618,4,5493,4.1394122079879425,20.0,0.0
41327,4,1327,[313  64 483 318  11],618,5,5498,4.140060240963855,80.0,20.0
41328,4,1328,[313  64 483 318  11],618,5,5503,4.140707298720843,80.0,20.0
41329,4,1329,[ 22 174  69 210 275],297,4,5507,4.140601503759399,0.0,0.0
41330,4,1330,[313  64 483 318  11],618,5,5512,4.141247182569496,80.0,20.0
41331,4,1331,[313  64 483 318  11],618,5,5517,4.141891891891892,80.0,20.0
41332,4,1332,[313  64 483 318  11],618,5,5522,4.142535633908477,80.0,20.0
41333,4,1333,[121 211 143 302  69],43,5,5527,4.143178410794603,0.0,0.0
41334,4,1334,[185 748 245 143 195],416,4,5531,4.143071161048689,0.0,0.0
41335,4,1335,[313  64 483 318  11],214,5,5536,4.1437125748503,80.0,20.0
41336,4,1336,[204 496  95 186 234],230,5,5541,4.144353029169783,0.0,0.0
41337,4,1337,[258 265 748  97 588],297,3,5544,4.143497757847534,0.0,0.0
41338,4,1338,[313  64 483 318  11],214,5,5549,4.144137415982076,80.0,20.0
41339,4,1339,[181 196 174 273 161],416,5,5554,4.1447761194029855,0.0,20.0
41340,4,1340,[313  64 483 318  11],214,5,5559,4.145413870246085,80.0,20.0
41341,4,1341,[313  64 483 318  11],618,5,5564,4.146050670640834,80.0,20.0
41342,4,1342,[313  64 483 318  11],618,5,5569,4.1466865227103495,80.0,20.0
41343,4,1343,[313  64 483 318  11],618,5,5574,4.147321428571429,80.0,20.0
41344,4,1344,[179 144 174 435 175],373,2,5576,4.145724907063197,0.0,0.0
41345,4,1345,[313  64 483 318  11],618,5,5581,4.146359583952452,80.0,20.0
41346,4,1346,[ 96 228 180 269  56],805,3,5584,4.14550853749072,0.0,0.0
41347,4,1347,[655  71 210  79 403],373,4,5588,4.14540059347181,0.0,0.0
41348,4,1348,[313  64 483 318  11],618,5,5593,4.146034099332839,80.0,20.0
41349,4,1349,[313  64 483 318  11],618,5,5598,4.1466666666666665,80.0,20.0
41350,4,1350,[  7 200 175 118  56],297,3,5601,4.145817912657291,0.0,0.0
41351,4,1351,[202 179 174 183  22],805,2,5603,4.144230769230769,0.0,0.0
41352,4,1352,[ 15 132 300 174 228],12,5,5608,4.144863266814486,0.0,0.0
41353,4,1353,[222 111 216  25 238],128,2,5610,4.14327917282127,0.0,0.0
41354,4,1354,[216  69 238 222 276],654,4,5614,4.143173431734318,0.0,0.0
41355,4,1355,[313  64 483 318  11],214,5,5619,4.143805309734513,80.0,20.0
41356,4,1356,[135  96 180 258 182],62,5,5624,4.1444362564480475,0.0,0.0
41357,4,1357,[313  64 483 318  11],618,5,5629,4.145066273932254,80.0,20.0
41358,4,1358,[385 273  64 197 121],416,5,5634,4.145695364238411,20.0,0.0
41359,4,1359,[313  64 483 318  11],618,5,5639,4.146323529411765,80.0,20.0
41360,4,1360,[ 12 268 216 515   8],297,5,5644,4.14695077149155,20.0,0.0
41361,4,1361,[313  64 483 318  11],618,5,5649,4.147577092511013,80.0,20.0
41362,4,1362,[174 301 235  69 288],345,3,5652,4.146735143066764,0.0,20.0
41363,4,1363,[313  64 483 318  11],214,5,5657,4.147360703812317,80.0,20.0
41364,4,1364,[313  64 483 318  11],214,5,5662,4.147985347985348,80.0,20.0
41365,4,1365,[ 64 173 235 161 286],43,4,5666,4.147877013177159,20.0,0.0
41366,4,1366,[294 245  98 127 210],417,4,5670,4.147768836869056,0.0,20.0
41367,4,1367,[153 258 135 568 222],698,1,5671,4.14546783625731,0.0,0.0
41368,4,1368,[313  64 483 318  11],618,5,5676,4.14609203798393,80.0,20.0
41369,4,1369,[313  64 483 318  11],618,5,5681,4.146715328467153,80.0,20.0
41370,4,1370,[313  64 483 318  11],214,5,5686,4.147337709700948,80.0,20.0
41371,4,1371,[313  64 483 318  11],618,5,5691,4.1479591836734695,80.0,20.0
41372,4,1372,[191 302 151 258   1],297,2,5693,4.14639475600874,0.0,0.0
41373,4,1373,[161 385 127 742 268],416,5,5698,4.1470160116448325,0.0,0.0
41374,4,1374,[ 56 515  28 216 496],416,5,5703,4.147636363636364,0.0,0.0
41375,4,1375,[181 271 235 168 195],922,1,5704,4.145348837209302,0.0,20.0
41376,4,1376,[313  64 483 318  11],618,5,5709,4.1459694989106755,80.0,20.0
41377,4,1377,[313  64 483 318  11],214,5,5714,4.146589259796807,80.0,20.0
41378,4,1378,[143 294  12 181  95],805,1,5715,4.144307469180566,20.0,20.0
41379,4,1379,[313  64 483 318  11],618,5,5720,4.144927536231884,80.0,20.0
41380,4,1380,[405  15 194 187 268],416,5,5725,4.145546705286025,0.0,0.0
41381,4,1381,[187 318 282   4 496],416,5,5730,4.1461649782923296,20.0,0.0
41382,4,1382,[ 22 273 427 118 385],416,4,5734,4.146059291395517,0.0,0.0
41383,4,1383,[ 11  97 423 515 385],416,5,5739,4.146676300578035,0.0,0.0
41384,4,1384,[185  64  89 191 294],854,4,5743,4.146570397111914,20.0,0.0
41385,4,1385,[175  11  56 265 200],198,3,5746,4.145743145743146,0.0,0.0
41386,4,1386,[313  64 483 318  11],618,5,5751,4.146359048305696,80.0,20.0
41387,4,1387,[546  15 100 742 302],417,1,5752,4.144092219020173,0.0,0.0
41388,4,1388,[588 204 216  28 118],588,4,5756,4.143988480921526,0.0,0.0
41389,4,1389,[228 127 143 144 175],805,1,5757,4.141726618705036,0.0,0.0
41390,4,1390,[403   4 655  22  28],373,3,5760,4.140905823148814,0.0,0.0
41391,4,1391,[313  64 483 318  11],618,5,5765,4.141522988505747,80.0,20.0
41392,4,1392,[313  64 483 318  11],214,5,5770,4.1421392677674085,80.0,20.0
41393,4,1393,[313  64 483 318  11],214,5,5775,4.142754662840746,80.0,20.0
41394,4,1394,[275 269 588 215 294],43,5,5780,4.14336917562724,0.0,0.0
41395,4,1395,[313  64 483 318  11],618,5,5785,4.143982808022923,80.0,20.0
41396,4,1396,[132  11 215 210 121],437,1,5786,4.141732283464567,0.0,0.0
41397,4,1397,[313  64 483 318  11],214,5,5791,4.142346208869814,80.0,20.0
41398,4,1398,[403 202   7  50 483],417,3,5794,4.141529664045747,20.0,20.0
41399,4,1399,[313  64 483 318  11],214,5,5799,4.142142857142857,80.0,20.0
41400,4,1400,[191 269 181 515 135],297,4,5803,4.142041399000714,0.0,20.0
41401,4,1401,[174 195 180 151 196],805,1,5804,4.139800285306705,0.0,0.0
41402,4,1402,[313  64 483 318  11],214,5,5809,4.140413399857448,80.0,20.0
41403,4,1403,[403  25 125 100 385],373,2,5811,4.138888888888889,0.0,0.0
41404,4,1404,[ 82 111 282 597 172],416,4,5815,4.1387900355871885,0.0,0.0
41405,4,1405,[313  64 483 318  11],618,5,5820,4.139402560455192,80.0,20.0
41406,4,1406,[313  64 483 318  11],618,5,5825,4.14001421464108,80.0,20.0
41407,4,1407,[313  64 483 318  11],618,5,5830,4.140625,80.0,20.0
41408,4,1408,[313  64 483 318  11],214,5,5835,4.141234918381831,80.0,20.0
41409,4,1409,[322 258 475  11 238],805,2,5837,4.139716312056738,0.0,0.0
41410,4,1410,[313  64 483 318  11],214,5,5842,4.140326009922041,80.0,20.0
41411,4,1411,[185 191 423 257 588],297,2,5844,4.138810198300283,0.0,0.0
41412,4,1412,[125 403  88 678 282],345,1,5845,4.13658881811748,0.0,0.0
41413,4,1413,[318 427 168 238 357],416,5,5850,4.137199434229137,20.0,0.0
41414,4,1414,[100 173  12 175 185],49,4,5854,4.137102473498233,20.0,0.0
41415,4,1415,[ 50 258 294 300 181],654,3,5857,4.136299435028248,0.0,40.0
41416,4,1416,[313  64 483 318  11],618,5,5862,4.136908962597036,80.0,20.0
41417,4,1417,[588  97  56 132 265],416,5,5867,4.137517630465444,0.0,0.0
41418,4,1418,[313  64 483 318  11],214,5,5872,4.138125440451022,80.0,20.0
41419,4,1419,[135 183 153 423 238],297,4,5876,4.138028169014085,0.0,0.0
41420,4,1420,[313  64 483 318  11],214,5,5881,4.1386347642505275,80.0,20.0
41421,4,1421,[546  50 385 118 403],43,5,5886,4.139240506329114,0.0,20.0
41422,4,1422,[313  64 483 318  11],618,5,5891,4.139845397048489,80.0,20.0
41423,4,1423,[313  64 483 318  11],618,5,5896,4.140449438202247,80.0,20.0
41424,4,1424,[ 82 168 265 655 318],711,3,5899,4.139649122807017,20.0,0.0
41425,4,1425,[313  64 483 318  11],214,5,5904,4.140252454417952,80.0,20.0
41426,4,1426,[ 79  56 423 144 318],618,5,5909,4.140854940434478,20.0,0.0
41427,4,1427,[195  97 176 143 125],416,5,5914,4.141456582633054,0.0,0.0
41428,4,1428,[313  64 483 318  11],214,5,5919,4.142057382785165,80.0,20.0
41429,4,1429,[182 210 318 211 195],416,5,5924,4.142657342657342,20.0,0.0
41430,4,1430,[678 118 471 655 234],416,3,5927,4.1418588399720475,0.0,0.0
41431,4,1431,[313  64 483 318  11],214,5,5932,4.14245810055866,80.0,20.0
41432,4,1432,[313  64 483 318  11],214,5,5937,4.143056524773203,80.0,20.0
41433,4,1433,[ 11 333 508 318 475],854,4,5941,4.142956764295676,20.0,0.0
41434,4,1434,[313  64 483 318  11],214,5,5946,4.143554006968641,80.0,20.0
41435,4,1435,[313  64 483 318  11],618,5,5951,4.144150417827298,80.0,20.0
41436,4,1436,[313  64 483 318  11],618,5,5956,4.144745998608212,80.0,20.0
41437,4,1437,[313  64 483 318  11],214,5,5961,4.145340751043116,80.0,20.0
41438,4,1438,[313  64 483 318  11],618,5,5966,4.14593467685893,80.0,20.0
41439,4,1439,[313  64 483 318  11],214,5,5971,4.146527777777778,80.0,20.0
41440,4,1440,[  7 216 183 282 508],297,4,5975,4.146426092990978,0.0,0.0
41441,4,1441,[313  64 483 318  11],214,5,5980,4.147018030513176,80.0,20.0
41442,4,1442,[313  64 483 318  11],618,5,5985,4.147609147609147,80.0,20.0
41443,4,1443,[313  64 483 318  11],618,5,5990,4.148199445983379,80.0,20.0
41444,4,1444,[121 172 265 185 135],711,3,5993,4.147404844290658,0.0,0.0
41445,4,1445,[313  64 483 318  11],214,5,5998,4.1479944674965425,80.0,20.0
41446,4,1446,[313  64 483 318  11],618,5,6003,4.148583275742916,80.0,20.0
41447,4,1447,[313  64 483 318  11],618,5,6008,4.149171270718232,80.0,20.0
41448,4,1448,[318   7  71  82 125],887,5,6013,4.14975845410628,20.0,0.0
41449,4,1449,[ 28 385 269 289  79],43,5,6018,4.150344827586207,0.0,0.0
41450,4,1450,[282 603  50 318 222],734,4,6022,4.1502412129565815,20.0,20.0
41451,4,1451,[313  64 483 318  11],618,5,6027,4.150826446280992,80.0,20.0
41452,4,1452,[181 127 216 210 288],416,5,6032,4.151410874053682,0.0,40.0
41453,4,1453,[  1 258 273 204  82],416,5,6037,4.151994497936727,0.0,0.0
41454,4,1454,[313  64 483 318  11],214,5,6042,4.152577319587629,80.0,20.0
41455,4,1455,[245 603 196 546 153],416,3,6045,4.151785714285714,0.0,0.0
41456,4,1456,[313  64 483 318  11],214,5,6050,4.152367879203844,80.0,20.0
41457,4,1457,[313  64 483 318  11],214,5,6055,4.152949245541838,80.0,20.0
41458,4,1458,[313  64 483 318  11],618,5,6060,4.153529814941741,80.0,20.0
41459,4,1459,[313  64 483 318  11],618,5,6065,4.154109589041096,80.0,20.0
41460,4,1460,[313  64 483 318  11],214,5,6070,4.154688569472964,80.0,20.0
41461,4,1461,[313  64 483 318  11],618,5,6075,4.155266757865937,80.0,20.0
41462,4,1462,[168 197 588 655 216],751,3,6078,4.154477101845523,0.0,0.0
41463,4,1463,[ 89 183 216 117 121],437,1,6079,4.152322404371585,0.0,0.0
41464,4,1464,[ 82 271 235 273 180],805,0,6079,4.149488054607509,0.0,0.0
41465,4,1465,[313  64 483 318  11],618,5,6084,4.150068212824011,80.0,20.0
41466,4,1466,[ 56 174 135  97 222],297,5,6089,4.150647580095433,0.0,0.0
41467,4,1467,[313  64 483 318  11],618,5,6094,4.151226158038147,80.0,20.0
41468,4,1468,[187  82   8  50 215],618,4,6098,4.1511232130701154,0.0,20.0
41469,4,1469,[313  64 483 318  11],618,5,6103,4.151700680272109,80.0,20.0
41470,4,1470,[313  64 483 318  11],618,5,6108,4.152277362338546,80.0,20.0
41471,4,1471,[121  79  11 125 186],230,5,6113,4.152853260869565,0.0,0.0
41472,4,1472,[202  88 181 174  15],345,4,6117,4.15274949083503,0.0,20.0
41473,4,1473,[423  25 357 403 200],805,4,6121,4.152645861601085,0.0,0.0
41474,4,1474,[313  64 483 318  11],618,5,6126,4.153220338983051,80.0,20.0
41475,4,1475,[300  50 117   4 294],43,5,6131,4.153794037940379,0.0,20.0
41476,4,1476,[301  89 286 111 153],437,1,6132,4.151658767772512,0.0,0.0
41477,4,1477,[588 204  82  50 211],405,3,6135,4.150879566982408,0.0,20.0
41478,4,1478,[318   8 181  50 182],214,3,6138,4.150101419878296,20.0,40.0
41479,4,1479,[265 215 168 200 144],618,5,6143,4.150675675675676,0.0,0.0
41480,4,1480,[313  64 483 318  11],214,5,6148,4.151249155975692,80.0,20.0
41481,4,1481,[313  64 483 318  11],618,5,6153,4.151821862348178,80.0,20.0
41482,4,1482,[187  15 300 568 179],416,4,6157,4.151719487525287,0.0,0.0
41483,4,1483,[313  64 483 318  11],618,5,6162,4.152291105121294,80.0,20.0
41484,4,1484,[196 546  97  22 403],705,3,6165,4.151515151515151,0.0,0.0
41485,4,1485,[313  64 483 318  11],214,5,6170,4.152086137281292,80.0,20.0
41486,4,1486,[300 197  25 204 323],345,2,6172,4.150638870208473,0.0,0.0
41487,4,1487,[ 56  95  97  96 153],198,3,6175,4.149865591397849,0.0,0.0
41488,4,1488,[185 204  82 191 323],805,3,6178,4.149093351242445,0.0,0.0
41489,4,1489,[313  64 483 318  11],214,5,6183,4.149664429530201,80.0,20.0
41490,4,1490,[313  64 483 318  11],618,5,6188,4.150234741784038,80.0,20.0
41491,4,1491,[235 300 216 161 323],416,3,6191,4.149463806970509,0.0,0.0
41492,4,1492,[313  64 483 318  11],618,5,6196,4.1500334896182185,80.0,20.0
41493,4,1493,[313  64 483 318  11],214,5,6201,4.150602409638554,80.0,20.0
41494,4,1494,[ 15 288 235 111 118],854,1,6202,4.148494983277592,0.0,20.0
41495,4,1495,[ 95  98 403 313  50],711,5,6207,4.149064171122995,20.0,60.0
41496,4,1496,[ 97  82 196 318 144],437,2,6209,4.147628590514362,20.0,0.0
41497,4,1497,[313  64 483 318  11],214,5,6214,4.148197596795727,80.0,20.0
41498,4,1498,[357 742  64 191 333],416,5,6219,4.148765843895931,20.0,0.0
41499,4,1499,[276  64 275  96  70],416,4,6223,4.148666666666666,20.0,0.0
41500,4,1500,[180 322 194  15 174],854,1,6224,4.146568954030646,0.0,0.0
41501,4,1501,[173  64 294 385 202],417,5,6229,4.147137150466046,20.0,0.0
41502,4,1502,[313  64 483 318  11],214,5,6234,4.147704590818363,80.0,20.0
41503,4,1503,[313  64 483 318  11],214,5,6239,4.148271276595745,80.0,20.0
41504,4,1504,[ 56 200 117  98 273],297,4,6243,4.148172757475083,0.0,20.0
41505,4,1505,[288 258 195 318 127],416,5,6248,4.148738379814077,20.0,20.0
41506,4,1506,[323 118 748  15 405],345,2,6250,4.147312541473125,0.0,0.0
41507,4,1507,[546 403  96 143 269],805,3,6253,4.146551724137931,0.0,0.0
41508,4,1508,[ 11 237 568  97 202],230,4,6257,4.146454605699138,0.0,0.0
41509,4,1509,[328  50 238 200  15],12,4,6261,4.14635761589404,0.0,20.0
41510,4,1510,[313  64 483 318  11],214,5,6266,4.14692256783587,80.0,20.0
41511,4,1511,[127  12 135 182  50],214,3,6269,4.146164021164021,20.0,20.0
41512,4,1512,[313  64 483 318  11],618,5,6274,4.146728354263054,80.0,20.0
41513,4,1513,[313  64 483 318  11],214,5,6279,4.147291941875825,80.0,20.0
41514,4,1514,[313  64 483 318  11],618,5,6284,4.147854785478548,80.0,20.0
41515,4,1515,[ 98 289 313 282  71],345,2,6286,4.146437994722955,20.0,40.0
41516,4,1516,[ 15 161 211 258 172],43,5,6291,4.147000659195781,0.0,0.0
41517,4,1517,[313  64 483 318  11],618,5,6296,4.147562582345191,80.0,20.0
41518,4,1518,[  1 546  96 173 144],805,3,6299,4.146807109940751,0.0,0.0
41519,4,1519,[313  64 483 318  11],618,5,6304,4.147368421052631,80.0,20.0
41520,4,1520,[588 423  12 174 117],417,3,6307,4.146614069690993,20.0,0.0
41521,4,1521,[313  64 483 318  11],214,5,6312,4.147174770039422,80.0,20.0
41522,4,1522,[313  64 483 318  11],618,5,6317,4.147734734077479,80.0,20.0
41523,4,1523,[194 748 471 257 211],297,1,6318,4.145669291338582,0.0,0.0
41524,4,1524,[237 176 515 427  11],416,4,6322,4.145573770491803,0.0,0.0
41525,4,1525,[313  64 483 318  11],618,5,6327,4.14613368283093,80.0,20.0
41526,4,1526,[  8  97 151 182 174],62,4,6331,4.14603798297315,0.0,0.0
41527,4,1527,[ 95 268  22  56 245],416,3,6334,4.145287958115183,0.0,0.0
41528,4,1528,[276 172 215 183 187],198,4,6338,4.145192936559843,0.0,0.0
41529,4,1529,[ 50 181 196 323  56],805,3,6341,4.144444444444445,0.0,40.0
41530,4,1530,[313  64 483 318  11],618,5,6346,4.14500326583932,80.0,20.0
41531,4,1531,[313  64 483 318  11],214,5,6351,4.14556135770235,80.0,20.0
41532,4,1532,[191 742 257  70   8],62,2,6353,4.144161774298761,0.0,0.0
41533,4,1533,[118 172 508 294 222],128,3,6356,4.14341590612777,0.0,0.0
41534,4,1534,[179 173 216 118 144],751,4,6360,4.143322475570033,0.0,0.0
41535,4,1535,[195 173 135  98   9],601,3,6363,4.142578125,0.0,20.0
41536,4,1536,[313  64 483 318  11],214,5,6368,4.143135979180221,80.0,20.0
41537,4,1537,[313  64 483 318  11],618,5,6373,4.143693107932379,80.0,20.0
41538,4,1538,[313  64 483 318  11],618,5,6378,4.144249512670565,80.0,20.0
41539,4,1539,[132 237  22 333 210],253,4,6382,4.144155844155844,0.0,0.0
41540,4,1540,[313  64 483 318  11],618,5,6387,4.144711226476314,80.0,20.0
41541,4,1541,[194 265 182  95 204],405,1,6388,4.142671854734112,0.0,0.0
41542,4,1542,[313  64 483 318  11],214,5,6393,4.143227478937136,80.0,20.0
41543,4,1543,[204 186 174 216  70],642,3,6396,4.142487046632124,0.0,0.0
41544,4,1544,[265 161 186  56 210],417,2,6398,4.141100323624595,0.0,0.0
41545,4,1545,[185 118 257  98 322],416,2,6400,4.139715394566624,0.0,20.0
41546,4,1546,[132 423 403  15 135],62,3,6403,4.1389786683904335,0.0,0.0
41547,4,1547,[313  64 483 318  11],618,5,6408,4.1395348837209305,80.0,20.0
41548,4,1548,[238  71 748 183  69],416,5,6413,4.140090380890897,0.0,0.0
41549,4,1549,[313  64 483 318  11],214,5,6418,4.140645161290323,80.0,20.0
41550,4,1550,[313  64 483 318  11],618,5,6423,4.141199226305609,80.0,20.0
41551,4,1551,[313  64 483 318  11],618,5,6428,4.141752577319588,80.0,20.0
41552,4,1552,[313  64 483 318  11],618,5,6433,4.142305215711526,80.0,20.0
41553,4,1553,[313  64 483 318  11],618,5,6438,4.142857142857143,80.0,20.0
41554,4,1554,[403 175  71  89 195],405,2,6440,4.141479099678457,0.0,0.0
41555,4,1555,[313  64 483 318  11],214,5,6445,4.142030848329049,80.0,20.0
41556,4,1556,[234 168 200  98  28],437,3,6448,4.1412973667308925,0.0,20.0
41557,4,1557,[197 111 515  97  88],416,4,6452,4.141206675224647,0.0,0.0
41558,4,1558,[ 64 597 117 132 211],417,4,6456,4.141116100064144,20.0,0.0
41559,4,1559,[174 245 288 181 215],297,2,6458,4.13974358974359,0.0,40.0
41560,4,1560,[313  64 483 318  11],214,5,6463,4.14029468289558,80.0,20.0
41561,4,1561,[313  64 483 318  11],618,5,6468,4.140845070422535,80.0,20.0
41562,4,1562,[313  64 483 318  11],214,5,6473,4.1413947536788225,80.0,20.0
41563,4,1563,[ 69 435 357 191 568],373,5,6478,4.141943734015345,0.0,0.0
41564,4,1564,[496 302 238  69 318],416,5,6483,4.142492012779552,20.0,0.0
41565,4,1565,[265  82  97 195 179],416,4,6487,4.1424010217113665,0.0,0.0
41566,4,1566,[313  64 483 318  11],214,5,6492,4.142948308870453,80.0,20.0
41567,4,1567,[174 271 273  25  71],805,1,6493,4.14094387755102,0.0,0.0
41568,4,1568,[313  64 483 318  11],214,5,6498,4.141491395793499,80.0,20.0
41569,4,1569,[313  64 483 318  11],618,5,6503,4.142038216560509,80.0,20.0
41570,4,1570,[313  64 483 318  11],618,5,6508,4.14258434118396,80.0,20.0
41571,4,1571,[403 237  70 202  28],642,3,6511,4.141857506361323,0.0,0.0
41572,4,1572,[144 471 318 173 483],907,5,6516,4.142403051493961,40.0,0.0
41573,4,1573,[313  64 483 318  11],618,5,6521,4.142947903430749,80.0,20.0
41574,4,1574,[313  64 483 318  11],618,5,6526,4.143492063492063,80.0,20.0
41575,4,1575,[127  79  88 238 423],405,4,6530,4.143401015228426,0.0,0.0
41576,4,1576,[385 174  79 423   7],505,3,6533,4.1426759670259985,0.0,0.0
41577,4,1577,[ 70 323 238 210 181],751,3,6536,4.141951837769328,0.0,20.0
41578,4,1578,[202 496  70 269  11],43,5,6541,4.142495250158328,0.0,0.0
41579,4,1579,[313  64 483 318  11],214,5,6546,4.143037974683544,80.0,20.0
41580,4,1580,[313  64 483 318  11],618,5,6551,4.143580012650221,80.0,20.0
41581,4,1581,[313  64 483 318  11],618,5,6556,4.144121365360303,80.0,20.0
41582,4,1582,[ 97 568 186 132 655],417,4,6560,4.144030322173089,0.0,0.0
41583,4,1583,[313  64 483 318  11],618,5,6565,4.144570707070707,80.0,20.0
41584,4,1584,[313  64 483 318  11],618,5,6570,4.145110410094637,80.0,20.0
41585,4,1585,[313  64 483 318  11],214,5,6575,4.145649432534679,80.0,20.0
41586,4,1586,[313  64 483 318  11],618,5,6580,4.146187775677379,80.0,20.0
41587,4,1587,[ 12  69 143 228 655],373,4,6584,4.146095717884131,20.0,0.0
41588,4,1588,[313  64 483 318  11],618,5,6589,4.146633102580239,80.0,20.0
41589,4,1589,[ 69 294 288 172 302],417,1,6590,4.144654088050315,0.0,20.0
41590,4,1590,[117 294 275 151 111],416,4,6594,4.144563167818982,0.0,0.0
41591,4,1591,[ 15 172  64  56 197],618,3,6597,4.143844221105527,20.0,0.0
41592,4,1592,[678 405 475 172 100],805,4,6601,4.14375392341494,0.0,0.0
41593,4,1593,[313  64 483 318  11],214,5,6606,4.144291091593476,80.0,20.0
41594,4,1594,[313  64 483 318  11],214,5,6611,4.144827586206897,80.0,20.0
41595,4,1595,[195  69  95 121 204],437,2,6613,4.143483709273183,0.0,0.0
41596,4,1596,[182 238 197   8  15],342,4,6617,4.143393863494051,0.0,0.0
41597,4,1597,[195  69 245 176  12],416,4,6621,4.143304130162703,20.0,0.0
41598,4,1598,[204 210 275  88 191],618,2,6623,4.141963727329581,0.0,0.0
41599,4,1599,[313  64 483 318  11],214,5,6628,4.1425,80.0,20.0
41600,4,1600,[127 173 475 597 132],854,4,6632,4.142410993129294,0.0,0.0
41601,4,1601,[195 151 318 121 144],854,2,6634,4.14107365792759,20.0,0.0
41602,4,1602,[313  64 483 318  11],214,5,6639,4.141609482220836,80.0,20.0
41603,4,1603,[742 144  56 179 143],805,2,6641,4.140274314214464,0.0,0.0
41604,4,1604,[403 127  28 294  15],43,5,6646,4.140809968847352,0.0,0.0
41605,4,1605,[313  64 483 318  11],214,5,6651,4.14134495641345,80.0,20.0
41606,4,1606,[313  64 483 318  11],214,5,6656,4.141879278158059,80.0,20.0
41607,4,1607,[173 483 423 333   9],854,4,6660,4.141791044776119,20.0,0.0
41608,4,1608,[313  64 483 318  11],214,5,6665,4.142324425108764,80.0,20.0
41609,4,1609,[313  64 483 318  11],214,5,6670,4.142857142857143,80.0,20.0
41610,4,1610,[313  64 483 318  11],214,5,6675,4.143389199255121,80.0,20.0
41611,4,1611,[313  64 483 318  11],214,5,6680,4.143920595533499,80.0,20.0
41612,4,1612,[313  64 483 318  11],618,5,6685,4.144451332920025,80.0,20.0
41613,4,1613,[237  50 273   4  22],62,4,6689,4.144361833952912,0.0,20.0
41614,4,1614,[153 161 180 742 483],417,3,6692,4.143653250773994,20.0,0.0
41615,4,1615,[ 28 121 100 172 204],887,4,6696,4.143564356435643,0.0,0.0
41616,4,1616,[191 176  22 143 258],601,3,6699,4.142857142857143,0.0,0.0
41617,4,1617,[313  64 483 318  11],618,5,6704,4.143386897404203,80.0,20.0
41618,4,1618,[313  64 483 318  11],214,5,6709,4.143915997529339,80.0,20.0
41619,4,1619,[313  64 483 318  11],214,5,6714,4.144444444444445,80.0,20.0
41620,4,1620,[313  64 483 318  11],618,5,6719,4.14497223935842,80.0,20.0
41621,4,1621,[385 258 423 318 202],588,2,6721,4.143649815043156,20.0,0.0
41622,4,1622,[ 25 173   1 132  64],764,3,6724,4.14294516327788,20.0,0.0
41623,4,1623,[313  64 483 318  11],214,5,6729,4.143472906403941,80.0,20.0
41624,4,1624,[294  28 323 318  88],416,3,6732,4.142769230769231,20.0,0.0
41625,4,1625,[742 234   4 257 237],297,1,6733,4.140836408364084,0.0,0.0
41626,4,1626,[186 234 237  56  79],230,4,6737,4.140749846342962,0.0,0.0
41627,4,1627,[313  64 483 318  11],214,5,6742,4.141277641277641,80.0,20.0
41628,4,1628,[ 50 269 127 211 216],43,5,6747,4.141804788213628,0.0,20.0
41629,4,1629,[ 89 275 204 265 435],437,2,6749,4.140490797546012,0.0,0.0
41630,4,1630,[313  64 483 318  11],214,5,6754,4.141017780502759,80.0,20.0
41631,4,1631,[ 96 179 427 173 187],198,5,6759,4.141544117647059,0.0,0.0
41632,4,1632,[313  64 483 318  11],618,5,6764,4.1420698101653395,80.0,20.0
41633,4,1633,[313  64 483 318  11],214,5,6769,4.142594859241126,80.0,20.0
41634,4,1634,[276 234  12  97 144],437,3,6772,4.141896024464832,20.0,0.0
41635,4,1635,[471 117 118 286 210],43,4,6776,4.141809290953545,0.0,0.0
41636,4,1636,[  4  98 111  22 118],62,3,6779,4.141111789859499,0.0,20.0
41637,4,1637,[181 282 385  97   8],705,3,6782,4.140415140415141,0.0,20.0
41638,4,1638,[313  64 483 318  11],618,5,6787,4.140939597315437,80.0,20.0
41639,4,1639,[204 475 588 132 288],711,3,6790,4.140243902439025,0.0,20.0
41640,4,1640,[313  64 483 318  11],214,5,6795,4.140767824497257,80.0,20.0
41641,4,1641,[275 144 302 273  96],62,3,6798,4.140073081607795,0.0,0.0
41642,4,1642,[313  64 483 318  11],214,5,6803,4.140596469872185,80.0,20.0
41643,4,1643,[313 423  50  28 176],416,5,6808,4.141119221411192,20.0,40.0
41644,4,1644,[302 176 222 210 508],297,5,6813,4.141641337386019,0.0,0.0
41645,4,1645,[313  64 483 318  11],618,5,6818,4.142162818955042,80.0,20.0
41646,4,1646,[275 423 603  28  70],416,5,6823,4.142683667273832,0.0,0.0
41647,4,1647,[132 173 153  69 275],373,4,6827,4.142597087378641,0.0,0.0
41648,4,1648,[588 186  97 215 183],405,2,6829,4.141297756215889,0.0,0.0
41649,4,1649,[313  64 483 318  11],214,5,6834,4.141818181818182,80.0,20.0
41650,4,1650,[313  64 483 318  11],618,5,6839,4.142337976983646,80.0,20.0
41651,4,1651,[ 12 182 288 655 215],416,5,6844,4.142857142857143,20.0,20.0
41652,4,1652,[ 82  50 328  56  28],721,4,6848,4.142770719903206,0.0,20.0
41653,4,1653,[313  64 483 318  11],618,5,6853,4.143288996372431,80.0,20.0
41654,4,1654,[258  70 180 172  25],417,3,6856,4.142598187311179,0.0,0.0
41655,4,1655,[202 173  64   7 318],764,4,6860,4.142512077294686,40.0,0.0
41656,4,1656,[313  64 483 318  11],214,5,6865,4.143029571514786,80.0,20.0
41657,4,1657,[655 235 294 385 357],805,1,6866,4.141133896260555,0.0,0.0
41658,4,1658,[135 216 288 678  22],297,3,6869,4.140446051838457,0.0,20.0
41659,4,1659,[ 95 475 182 174 175],198,3,6872,4.139759036144579,0.0,0.0
41660,4,1660,[508 216  79 118 288],345,3,6875,4.139072847682119,0.0,20.0
41661,4,1661,[ 50  79  88 125 471],907,5,6880,4.139590854392298,0.0,20.0
41662,4,1662,[153 172 111 294 301],721,4,6884,4.139506915213469,0.0,0.0
41663,4,1663,[ 25 471  69 234 508],345,3,6887,4.138822115384615,0.0,0.0
41664,4,1664,[168   7  88 588 597],618,5,6892,4.139339339339339,0.0,0.0
41665,4,1665,[181 153 210 194   1],297,3,6895,4.138655462184874,0.0,20.0
41666,4,1666,[435  97 194 228 403],405,1,6896,4.136772645470906,0.0,0.0
41667,4,1667,[  7 603 423 153  50],297,4,6900,4.136690647482014,0.0,20.0
41668,4,1668,[313  64 483 318  11],618,5,6905,4.137207908927501,80.0,20.0
41669,4,1669,[313  64 483 318  11],618,5,6910,4.137724550898204,80.0,20.0
41670,4,1670,[678   1 269 237  22],297,3,6913,4.13704368641532,0.0,0.0
41671,4,1671,[196 183 121 568 195],62,4,6917,4.136961722488039,0.0,0.0
41672,4,1672,[ 89 235  69  79 195],297,1,6918,4.135086670651524,0.0,0.0
41673,4,1673,[121 273 182 153 216],253,2,6920,4.133811230585424,0.0,0.0
41674,4,1674,[313  64 483 318  11],618,5,6925,4.134328358208955,80.0,20.0
41675,4,1675,[313  64 483 318  11],618,5,6930,4.134844868735083,80.0,20.0
41676,4,1676,[313  64 483 318  11],618,5,6935,4.13536076326774,80.0,20.0
41677,4,1677,[174 496 216   1 268],128,3,6938,4.134684147794994,0.0,0.0
41678,4,1678,[ 11 127 288 216 173],24,4,6942,4.134603930911257,0.0,20.0
41679,4,1679,[273  98 588 173 132],417,3,6945,4.133928571428571,0.0,20.0
41680,4,1680,[313 385 143   4 200],416,5,6950,4.134443783462225,20.0,20.0
41681,4,1681,[313  64 483 318  11],618,5,6955,4.134958382877527,80.0,20.0
41682,4,1682,[  8 423  56  69 588],588,3,6958,4.134284016636958,0.0,0.0
41683,4,1683,[ 88 403 161  82 204],711,3,6961,4.133610451306414,0.0,0.0
41684,4,1684,[161 245 276  15 194],416,3,6964,4.1329376854599404,0.0,0.0
41685,4,1685,[313  64 483 318  11],618,5,6969,4.133451957295374,80.0,20.0
41686,4,1686,[313  64 483 318  11],214,5,6974,4.133965619442798,80.0,20.0
41687,4,1687,[  8 318 294 286 204],43,5,6979,4.134478672985782,20.0,0.0
41688,4,1688,[ 88 568 197 173 186],618,3,6982,4.133806986382475,0.0,0.0
41689,4,1689,[111  79 423 204 174],416,5,6987,4.134319526627219,0.0,0.0
41690,4,1690,[  4 173 176 179 143],198,3,6990,4.133648728562981,0.0,0.0
41691,4,1691,[282  98 483 143 588],618,4,6994,4.133569739952718,20.0,20.0
41692,4,1692,[ 79  82 655 235 515],416,4,6998,4.133490844654459,0.0,0.0
41693,4,1693,[ 64 475 238 546 245],417,4,7002,4.133412042502951,20.0,0.0
41694,4,1694,[313  64 483 318  11],618,5,7007,4.133923303834808,80.0,20.0
41695,4,1695,[313  64 483 318  11],618,5,7012,4.134433962264151,80.0,20.0
41696,4,1696,[313  64 483 318  11],214,5,7017,4.134944018856806,80.0,20.0
41697,4,1697,[568 318 118 181 258],654,3,7020,4.134275618374558,20.0,20.0
41698,4,1698,[234  56  71 496 143],230,4,7024,4.134196586227192,0.0,0.0
41699,4,1699,[181 222 471 322 655],721,4,7028,4.134117647058823,0.0,20.0
41700,4,1700,[210 403 265  82 181],618,4,7032,4.134038800705468,0.0,20.0
41701,4,1701,[313  64 483 318  11],618,5,7037,4.13454759106933,80.0,20.0
41702,4,1702,[313  64 483 318  11],214,5,7042,4.135055783910746,80.0,20.0
41703,4,1703,[ 64 742  56 318 125],253,3,7045,4.134389671361502,40.0,0.0
41704,4,1704,[174  96 202  69 125],618,2,7047,4.133137829912023,0.0,0.0
41705,4,1705,[313  64 483 318  11],214,5,7052,4.133645955451348,80.0,20.0
41706,4,1706,[313  64 483 318  11],214,5,7057,4.134153485647334,80.0,20.0
41707,4,1707,[313  64 483 318  11],214,5,7062,4.134660421545667,80.0,20.0
41708,4,1708,[313  64 483 318  11],214,5,7067,4.135166764189584,80.0,20.0
41709,4,1709,[313  64 483 318  11],214,5,7072,4.135672514619883,80.0,20.0
41710,4,1710,[ 22 182 322 173 132],416,4,7076,4.135593220338983,0.0,0.0
41711,4,1711,[175  69 135 403 216],405,3,7079,4.134929906542056,0.0,0.0
41712,4,1712,[313  64 483 318  11],618,5,7084,4.13543490951547,80.0,20.0
41713,4,1713,[313  64 483 318  11],214,5,7089,4.135939323220537,80.0,20.0
41714,4,1714,[471  71 191 403 117],618,4,7093,4.135860058309038,0.0,0.0
41715,4,1715,[ 89   9  79 197 161],805,3,7096,4.135198135198135,0.0,0.0
41716,4,1716,[313  64 483 318  11],214,5,7101,4.135701805474665,80.0,20.0
41717,4,1717,[313  64 483 318  11],618,5,7106,4.136204889406287,80.0,20.0
41718,4,1718,[471 211 258 318 328],43,4,7110,4.136125654450262,20.0,0.0
41719,4,1719,[257 508 183  69 385],417,2,7112,4.134883720930232,0.0,0.0
41720,4,1720,[ 97 144  22 132 195],230,3,7115,4.134224288204532,0.0,0.0
41721,4,1721,[222  79 655 151 196],805,3,7118,4.133565621370499,0.0,0.0
41722,4,1722,[313  64 483 318  11],618,5,7123,4.134068485200232,80.0,20.0
41723,4,1723,[748 143 435  79 204],297,1,7124,4.132250580046404,0.0,0.0
41724,4,1724,[318   8 238 175 294],214,4,7128,4.132173913043478,20.0,0.0
41725,4,1725,[144 276  95   8 204],416,3,7131,4.131517960602549,0.0,0.0
41726,4,1726,[313 196  64 181 385],405,3,7134,4.130862767805443,40.0,40.0
41727,4,1727,[313  64 483 318  11],214,5,7139,4.1313657407407405,80.0,20.0
41728,4,1728,[313  64 483 318  11],618,5,7144,4.131868131868132,80.0,20.0
41729,4,1729,[655 197  97  88   4],373,3,7147,4.13121387283237,0.0,0.0
41730,4,1730,[196 176  98  64 228],198,3,7150,4.130560369728481,20.0,20.0
41731,4,1731,[357 568 132   4  70],416,5,7155,4.131062355658199,0.0,0.0
41732,4,1732,[275 276 603 238  88],437,4,7159,4.130986728216965,0.0,0.0
41733,4,1733,[ 71 175 435 185 204],405,2,7161,4.129757785467128,0.0,0.0
41734,4,1734,[288 423 475 273 135],854,5,7166,4.130259365994236,0.0,20.0
41735,4,1735,[111 161 238 210  64],128,4,7170,4.130184331797235,20.0,0.0
41736,4,1736,[222 161 568 172 235],43,4,7174,4.130109383995395,0.0,0.0
41737,4,1737,[183  64 269 357 496],875,5,7179,4.130609896432682,20.0,0.0
41738,4,1738,[ 64 313 483 318  11],214,5,7184,4.131109833237493,80.0,20.0
41739,4,1739,[294 228 483 183 191],62,3,7187,4.130459770114943,20.0,0.0
41740,4,1740,[100 176 568 385  89],198,2,7189,4.129236071223435,0.0,0.0
41741,4,1741,[ 64 313 483 318  11],214,5,7194,4.129735935706085,80.0,20.0
41742,4,1742,[ 64 313 483 318  11],618,5,7199,4.130235226620769,80.0,20.0
41743,4,1743,[144  64 269 182 286],416,5,7204,4.1307339449541285,20.0,0.0
41744,4,1744,[655 286 179 275 435],437,3,7207,4.1300859598853865,0.0,0.0
41745,4,1745,[174 265 168   8  97],618,4,7211,4.130011454753723,0.0,0.0
41746,4,1746,[ 64 313 483 318  11],214,5,7216,4.13050944476245,80.0,20.0
41747,4,1747,[313 196  95  11  15],618,3,7219,4.129862700228833,20.0,20.0
41748,4,1748,[ 64 313 483 318  11],618,5,7224,4.130360205831904,80.0,20.0
41749,4,1749,[172 258 471 210 238],43,3,7227,4.129714285714286,0.0,0.0
41750,4,1750,[  7 132  25 405 294],417,2,7229,4.128498001142204,0.0,0.0
41751,4,1751,[ 97  15 181 568 118],588,3,7232,4.127853881278539,0.0,20.0
41752,4,1752,[ 64 313 483 318  11],618,5,7237,4.128351397604107,80.0,20.0
41753,4,1753,[185 153 423 132 182],437,4,7241,4.1282782212086655,0.0,0.0
41754,4,1754,[ 64 313 483 318  11],214,5,7246,4.128774928774929,80.0,20.0
41755,4,1755,[286 238 403 143 200],711,5,7251,4.129271070615034,0.0,0.0
41756,4,1756,[235 475 173   1 118],854,2,7253,4.128059191804212,0.0,0.0
41757,4,1757,[ 64 313 483 318  11],618,5,7258,4.1285551763367465,80.0,20.0
41758,4,1758,[ 64 313 483 318  11],214,5,7263,4.129050596930074,80.0,20.0
41759,4,1759,[ 56 100 168  69 111],588,2,7265,4.127840909090909,0.0,0.0
41760,4,1760,[ 64 313 483 318  11],214,5,7270,4.128336172629188,80.0,20.0
41761,4,1761,[ 64 313 483 318  11],618,5,7275,4.128830874006811,80.0,20.0
41762,4,1762,[269 117 143 168 655],805,2,7277,4.127623369256948,0.0,0.0
41763,4,1763,[202 357  56 588 300],416,5,7282,4.1281179138322,0.0,0.0
41764,4,1764,[258 235  69  98   7],416,4,7286,4.128045325779037,0.0,20.0
41765,4,1765,[ 64 313 483 318  11],214,5,7291,4.128539071347678,80.0,20.0
41766,4,1766,[ 64 313 483 318  11],618,5,7296,4.129032258064516,80.0,20.0
41767,4,1767,[435   7  11 174 216],230,4,7300,4.1289592760181,0.0,0.0
41768,4,1768,[153 186 182 117 742],417,4,7304,4.128886376483889,0.0,0.0
41769,4,1769,[ 64 313 483 318  11],618,5,7309,4.1293785310734465,80.0,20.0
41770,4,1770,[ 71 385 235 179 655],262,3,7312,4.128740824392998,0.0,0.0
41771,4,1771,[ 64 313 483 318  11],214,5,7317,4.1292325056433405,80.0,20.0
41772,4,1772,[ 64 313 483 318  11],618,5,7322,4.129723632261704,80.0,20.0
41773,4,1773,[176  28 182  96 179],62,4,7326,4.129650507328072,0.0,0.0
41774,4,1774,[153  96 191  64 111],416,5,7331,4.1301408450704225,20.0,0.0
41775,4,1775,[423 245 168 222 234],297,2,7333,4.128941441441442,0.0,0.0
41776,4,1776,[ 64 313 483 318  11],214,5,7338,4.1294316263365225,80.0,20.0
41777,4,1777,[ 64 313 483 318  11],214,5,7343,4.1299212598425195,80.0,20.0
41778,4,1778,[ 95 288  22 405   9],416,4,7347,4.129848229342327,0.0,20.0
41779,4,1779,[200 235 483 333 144],854,2,7349,4.128651685393258,20.0,0.0
41780,4,1780,[ 64 313 483 318  11],618,5,7354,4.12914093206064,80.0,20.0
41781,4,1781,[ 64 313 483 318  11],618,5,7359,4.12962962962963,80.0,20.0
41782,4,1782,[ 64 313 483 318  11],618,5,7364,4.130117779024117,80.0,20.0
41783,4,1783,[118  82 117 282 234],618,3,7367,4.129484304932736,0.0,0.0
41784,4,1784,[179 222 117 174   7],805,3,7370,4.128851540616247,0.0,0.0
41785,4,1785,[197 210 179 333 144],416,4,7374,4.128779395296752,0.0,0.0
41786,4,1786,[ 64 313 483 318  11],618,5,7379,4.129266927811975,80.0,20.0
41787,4,1787,[  7 132 385 200  88],618,5,7384,4.1297539149888145,0.0,0.0
41788,4,1788,[ 64 313 483 318  11],618,5,7389,4.130240357741755,80.0,20.0
41789,4,1789,[ 64 313 483 318  11],618,5,7394,4.13072625698324,80.0,20.0
41790,4,1790,[191 182 475 187 301],416,4,7398,4.130653266331659,0.0,0.0
41791,4,1791,[ 64 313 483 318  11],618,5,7403,4.131138392857143,80.0,20.0
41792,4,1792,[222 168 235 143  50],922,3,7406,4.1305075292805356,0.0,20.0
41793,4,1793,[238  79  97 172 185],618,4,7410,4.130434782608695,0.0,0.0
41794,4,1794,[ 97 121 265 132 111],128,2,7412,4.129247910863509,0.0,0.0
41795,4,1795,[ 64 313 483 318  11],618,5,7417,4.129732739420936,80.0,20.0
41796,4,1796,[ 15 168 269 125 135],854,3,7420,4.129104062326099,0.0,0.0
41797,4,1797,[ 64 313 483 318  11],214,5,7425,4.129588431590657,80.0,20.0
41798,4,1798,[216 294 173 234 588],253,5,7430,4.130072262367983,0.0,0.0
41799,4,1799,[269 603 111 258   9],854,4,7434,4.13,0.0,0.0
41800,4,1800,[ 64 313 483 318  11],214,5,7439,4.130483064963909,80.0,20.0
41801,4,1801,[ 64 313 483 318  11],618,5,7444,4.130965593784683,80.0,20.0
41802,4,1802,[ 56 323 222 197   4],198,2,7446,4.129783693843594,0.0,0.0
41803,4,1803,[ 64 313 483 318  11],214,5,7451,4.130266075388026,80.0,20.0
41804,4,1804,[496  89 328 300 182],253,4,7455,4.130193905817174,0.0,0.0
41805,4,1805,[ 64 313 483 318  11],214,5,7460,4.130675526024363,80.0,20.0
41806,4,1806,[475 211  98 195 273],417,4,7464,4.130603209739901,0.0,20.0
41807,4,1807,[ 89 202 546 216 100],417,2,7466,4.129424778761062,0.0,0.0
41808,4,1808,[294 173 185 286  64],854,3,7469,4.1288004422332785,20.0,0.0
41809,4,1809,[ 64 313 483 318  11],618,5,7474,4.129281767955801,80.0,20.0
41810,4,1810,[ 64 313 483 318  11],618,5,7479,4.1297625621203755,80.0,20.0
41811,4,1811,[ 64 313 483 318  11],214,5,7484,4.1302428256070645,80.0,20.0
41812,4,1812,[ 64 313 483 318  11],618,5,7489,4.130722559293988,80.0,20.0
41813,4,1813,[ 64 313 483 318  11],618,5,7494,4.131201764057332,80.0,20.0
41814,4,1814,[ 64 313 483 318  11],214,5,7499,4.131680440771349,80.0,20.0
41815,4,1815,[ 64 313 483 318  11],214,5,7504,4.13215859030837,80.0,20.0
41816,4,1816,[568 357 245 186 183],417,4,7508,4.132085855806274,0.0,0.0
41817,4,1817,[118  96 318 196 121],705,5,7513,4.132563256325633,20.0,0.0
41818,4,1818,[ 64 313 483 318  11],214,5,7518,4.133040131940627,80.0,20.0
41819,4,1819,[125 276 282 496 748],416,4,7522,4.132967032967033,0.0,0.0
41820,4,1820,[210 153 357 258 175],698,2,7524,4.13179571663921,0.0,0.0
41821,4,1821,[748 258  95 588 127],416,4,7528,4.13172338090011,0.0,0.0
41822,4,1822,[ 64 313 483 318  11],214,5,7533,4.132199670872189,80.0,20.0
41823,4,1823,[ 64 313 483 318  11],214,5,7538,4.1326754385964914,80.0,20.0
41824,4,1824,[ 64 313 483 318  11],214,5,7543,4.133150684931507,80.0,20.0
41825,4,1825,[ 64 313 483 318  11],214,5,7548,4.133625410733845,80.0,20.0
41826,4,1826,[ 64 313 483 318  11],214,5,7553,4.134099616858237,80.0,20.0
41827,4,1827,[546 216 257 282 121],223,4,7557,4.134026258205689,0.0,0.0
41828,4,1828,[ 64 313 483 318  11],618,5,7562,4.134499726626572,80.0,20.0
41829,4,1829,[ 64 313 483 318  11],214,5,7567,4.134972677595629,80.0,20.0
41830,4,1830,[ 64 313 483 318  11],618,5,7572,4.135445111960677,80.0,20.0
41831,4,1831,[ 64 313 483 318  11],618,5,7577,4.135917030567685,80.0,20.0
41832,4,1832,[  1  71 475   8  95],805,2,7579,4.134751773049645,0.0,0.0
41833,4,1833,[385  82 597  64 211],417,4,7583,4.134678298800436,20.0,0.0
41834,4,1834,[245  82 742 228  88],128,2,7585,4.133514986376022,0.0,0.0
41835,4,1835,[ 64 313 483 318  11],214,5,7590,4.133986928104576,80.0,20.0
41836,4,1836,[ 97 313 144  79 173],505,2,7592,4.132825258573762,20.0,20.0
41837,4,1837,[118   8 173 238 200],437,4,7596,4.132752992383025,0.0,0.0
41838,4,1838,[ 64 313 483 318  11],214,5,7601,4.133224578575312,80.0,20.0
41839,4,1839,[ 64 313 483 318  11],214,5,7606,4.133695652173913,80.0,20.0
41840,4,1840,[ 64 313 483 318  11],618,5,7611,4.134166214014122,80.0,20.0
41841,4,1841,[ 22 195 204  28  12],373,4,7615,4.134093376764387,20.0,0.0
41842,4,1842,[ 64 313 483 318  11],618,5,7620,4.134563212154097,80.0,20.0
41843,4,1843,[ 64 313 483 318  11],618,5,7625,4.135032537960955,80.0,20.0
41844,4,1844,[202 174  97 742  12],297,3,7628,4.134417344173442,20.0,0.0
41845,4,1845,[181  79 173 135 294],297,3,7631,4.133802816901408,0.0,20.0
41846,4,1846,[ 64 313 483 318  11],214,5,7636,4.13427179209529,80.0,20.0
41847,4,1847,[423 294 318 313  50],642,3,7639,4.133658008658009,40.0,40.0
41848,4,1848,[ 64 313 483 318  11],618,5,7644,4.134126554894538,80.0,20.0
41849,4,1849,[ 71   8 496 546  88],416,3,7647,4.133513513513513,0.0,0.0
41850,4,1850,[ 64 313 483 318  11],214,5,7652,4.133981631550514,80.0,20.0
41851,4,1851,[475  98  88 100 286],437,2,7654,4.132829373650108,0.0,20.0
41852,4,1852,[ 64 313 483 318  11],618,5,7659,4.133297355639503,80.0,20.0
41853,4,1853,[265 357 196 210 228],230,4,7663,4.133225458468177,0.0,0.0
41854,4,1854,[135 748 125 181 423],721,2,7665,4.132075471698113,0.0,20.0
41855,4,1855,[ 64 313 483 318  11],618,5,7670,4.132543103448276,80.0,20.0
41856,4,1856,[318 161  79 194 191],373,5,7675,4.133010231556273,20.0,0.0
41857,4,1857,[143 294 111 678 117],416,4,7679,4.132938643702906,0.0,0.0
41858,4,1858,[ 96 172 168 318  95],416,4,7683,4.1328671328671325,20.0,0.0
41859,4,1859,[ 11  12 216  96 427],618,3,7686,4.132258064516129,20.0,0.0
41860,4,1860,[ 64 313 483 318  11],618,5,7691,4.1327243417517465,80.0,20.0
41861,4,1861,[ 64 313 483 318  11],214,5,7696,4.133190118152524,80.0,20.0
41862,4,1862,[ 64 313 483 318  11],214,5,7701,4.1336553945249594,80.0,20.0
41863,4,1863,[174 182 175  12   4],405,3,7704,4.133047210300429,20.0,0.0
41864,4,1864,[180  12 588 748 276],437,4,7708,4.132975871313673,20.0,0.0
41865,4,1865,[ 64 313 483 318  11],214,5,7713,4.133440514469453,80.0,20.0
41866,4,1866,[ 82 153  11 125 288],262,1,7714,4.13176218532405,0.0,20.0
41867,4,1867,[ 64 313 483 318  11],618,5,7719,4.132226980728052,80.0,20.0
41868,4,1868,[182 288 183 181 168],297,3,7722,4.131621187800963,0.0,40.0
41869,4,1869,[ 64 313 483 318  11],618,5,7727,4.132085561497326,80.0,20.0
41870,4,1870,[385 175 181 403 286],43,4,7731,4.13201496525922,0.0,20.0
41871,4,1871,[ 64 313 483 318  11],618,5,7736,4.132478632478633,80.0,20.0
41872,4,1872,[289 235 183 357 515],416,3,7739,4.131873998932194,0.0,0.0
41873,4,1873,[286 125  98 508 333],345,2,7741,4.130736392742796,0.0,20.0
41874,4,1874,[ 64 313 483 318  11],618,5,7746,4.1312,80.0,20.0
41875,4,1875,[273 588 748  22 183],805,1,7747,4.12953091684435,0.0,0.0
41876,4,1876,[301   9  88 471 125],416,4,7751,4.129461907298881,0.0,0.0
41877,4,1877,[180 271  50 121 117],805,1,7752,4.127795527156549,0.0,20.0
41878,4,1878,[ 64 313 483 318  11],618,5,7757,4.128259712613092,80.0,20.0
41879,4,1879,[228 269 111 222  25],805,3,7760,4.127659574468085,0.0,0.0
41880,4,1880,[403  56 216 234 427],405,4,7764,4.127591706539075,0.0,0.0
41881,4,1881,[143   1 322 135  11],805,2,7766,4.126461211477152,0.0,0.0
41882,4,1882,[132 742  88  64 195],642,3,7769,4.125862984599044,20.0,0.0
41883,4,1883,[ 64 313 483 318  11],618,5,7774,4.126326963906582,80.0,20.0
41884,4,1884,[238 111 288 546 127],416,4,7778,4.126259946949602,0.0,20.0
41885,4,1885,[ 64 313 483 318  11],618,5,7783,4.126723223753976,80.0,20.0
41886,4,1886,[742 222 183 172 483],62,4,7787,4.126656067832538,20.0,0.0
41887,4,1887,[ 82 143 294 271 275],43,4,7791,4.126588983050848,0.0,0.0
41888,4,1888,[ 98 172 271 496 181],907,5,7796,4.127051349920593,0.0,40.0
41889,4,1889,[ 64 313 483 318  11],618,5,7801,4.127513227513227,80.0,20.0
41890,4,1890,[568  56 238  89 168],214,4,7805,4.127445795875198,0.0,0.0
41891,4,1891,[ 64 313 483 318  11],618,5,7810,4.127906976744186,80.0,20.0
41892,4,1892,[289 568 748  28 301],345,2,7812,4.126782884310618,0.0,0.0
41893,4,1893,[182  15 121 161 215],198,2,7814,4.125659978880676,0.0,0.0
41894,4,1894,[185 427 200 161   9],416,5,7819,4.126121372031662,0.0,0.0
41895,4,1895,[276 269 546 742 191],416,3,7822,4.125527426160337,0.0,0.0
41896,4,1896,[ 64 313 483 318  11],214,5,7827,4.125988402741171,80.0,20.0
41897,4,1897,[191  79 742 135 294],805,3,7830,4.125395152792413,0.0,0.0
41898,4,1898,[187 181 121 318 195],198,3,7833,4.124802527646129,20.0,20.0
41899,4,1899,[258 405 257 222 144],854,3,7836,4.12421052631579,0.0,0.0
41900,4,1900,[300 282 118 294 151],657,2,7838,4.123093108890058,0.0,0.0
41901,4,1901,[ 64 313 483 318  11],214,5,7843,4.1235541535226075,80.0,20.0
41902,4,1902,[ 64 313 483 318  11],214,5,7848,4.124014713610089,80.0,20.0
41903,4,1903,[ 64 313 483 318  11],214,5,7853,4.124474789915967,80.0,20.0
41904,4,1904,[ 64 313 483 318  11],618,5,7858,4.1249343832021,80.0,20.0
41905,4,1905,[423 300 678 235 405],416,3,7861,4.1243441762854145,0.0,0.0
41906,4,1906,[182 257 508 258 273],297,3,7864,4.123754588358678,0.0,0.0
41907,4,1907,[238 197 176 322 496],416,4,7868,4.123689727463312,0.0,0.0
41908,4,1908,[  7  98 588  97 117],297,5,7873,4.1241487689889995,0.0,20.0
41909,4,1909,[ 15 111 215 143 168],416,5,7878,4.124607329842932,0.0,0.0
41910,4,1910,[ 50 357 144 151 195],62,4,7882,4.124542124542124,0.0,20.0
41911,4,1911,[172 276 191 403  96],198,4,7886,4.124476987447698,0.0,0.0
41912,4,1912,[ 64 313 483 318  11],214,5,7891,4.124934657605855,80.0,20.0
41913,4,1913,[ 96 678 180 143 111],805,2,7893,4.123824451410658,0.0,0.0
41914,4,1914,[ 69 238 313  96  25],416,5,7898,4.124281984334203,20.0,20.0
41915,4,1915,[ 64 182 196 323 286],417,4,7902,4.124217118997913,20.0,0.0
41916,4,1916,[588 191 357  28 288],416,5,7907,4.124673969744392,0.0,20.0
41917,4,1917,[191 210  22   8   9],416,5,7912,4.125130344108446,0.0,0.0
41918,4,1918,[ 64 313 483 318  11],618,5,7917,4.12558624283481,80.0,20.0
41919,4,1919,[ 79 191 597 210 302],416,4,7921,4.125520833333334,0.0,0.0
41920,4,1920,[ 64 313 483 318  11],618,5,7926,4.125976054138469,80.0,20.0
41921,4,1921,[ 64 313 483 318  11],618,5,7931,4.126430801248699,80.0,20.0
41922,4,1922,[ 64 313 483 318  11],618,5,7936,4.126885075403016,80.0,20.0
41923,4,1923,[313  95 186 216  89],405,2,7938,4.125779625779626,20.0,20.0
41924,4,1924,[132 127  25 179  12],373,2,7940,4.124675324675325,20.0,0.0
41925,4,1925,[ 64 313 483 318  11],618,5,7945,4.125129802699896,80.0,20.0
41926,4,1926,[191   4 234 143 245],297,1,7946,4.123508043591074,0.0,0.0
41927,4,1927,[210 118  71 237 185],437,2,7948,4.122406639004149,0.0,0.0
41928,4,1928,[ 64 313 483 318  11],618,5,7953,4.122861586314152,80.0,20.0
41929,4,1929,[ 64 313 483 318  11],618,5,7958,4.1233160621761655,80.0,20.0
41930,4,1930,[183 475 273 546 176],805,3,7961,4.122734334541688,0.0,0.0
41931,4,1931,[ 64 313 483 318  11],618,5,7966,4.1231884057971016,80.0,20.0
41932,4,1932,[144  50 196 483 118],437,3,7969,4.122607346094155,20.0,20.0
41933,4,1933,[ 64 313 483 318  11],214,5,7974,4.12306101344364,80.0,20.0
41934,4,1934,[ 64 313 483 318  11],618,5,7979,4.123514211886305,80.0,20.0
41935,4,1935,[210 168 194 216 100],416,5,7984,4.12396694214876,0.0,0.0
41936,4,1936,[ 64 313 483 318  11],618,5,7989,4.1244192049561175,80.0,20.0
41937,4,1937,[ 64 313 483 318  11],618,5,7994,4.124871001031992,80.0,20.0
41938,4,1938,[ 64 313 483 318  11],618,5,7999,4.125322331098505,80.0,20.0
41939,4,1939,[ 64 313 483 318  11],214,5,8004,4.125773195876289,80.0,20.0
41940,4,1940,[ 64 313 483 318  11],214,5,8009,4.126223596084492,80.0,20.0
41941,4,1941,[ 25  15 302 275   9],854,2,8011,4.125128733264676,0.0,0.0
41942,4,1942,[ 95 302 300 144 210],751,4,8015,4.1250643335048895,0.0,0.0
41943,4,1943,[  4 222 748 173  56],654,5,8020,4.125514403292181,0.0,0.0
41944,4,1944,[ 64 313 483 318  11],214,5,8025,4.125964010282776,80.0,20.0
41945,4,1945,[748 197  25 195 228],297,1,8026,4.124357656731758,0.0,0.0
41946,4,1946,[ 64 475 176  50 273],417,3,8029,4.123780174627632,20.0,20.0
41947,4,1947,[196 238  28 185 111],618,3,8032,4.123203285420945,0.0,0.0
41948,4,1948,[655   1 132 216 273],416,5,8037,4.123653155464341,0.0,0.0
41949,4,1949,[269 237 181 423 238],43,4,8041,4.1235897435897435,0.0,20.0
41950,4,1950,[235  69 276  82 471],416,3,8044,4.123013839056894,0.0,0.0
41951,4,1951,[ 64 313 483 318  11],214,5,8049,4.123463114754099,80.0,20.0
41952,4,1952,[ 64 313 483 318  11],618,5,8054,4.123911930363543,80.0,20.0
41953,4,1953,[125 265 186   9 173],618,2,8056,4.122824974411464,0.0,0.0
41954,4,1954,[ 82 121 173 271  69],43,4,8060,4.122762148337596,0.0,0.0
41955,4,1955,[ 64 313 483 318  11],618,5,8065,4.12321063394683,80.0,20.0
41956,4,1956,[ 64 313 483 318  11],214,5,8070,4.123658661216147,80.0,20.0
41957,4,1957,[125 202 111 318 173],618,1,8071,4.1220633299284986,20.0,0.0
41958,4,1958,[ 64 313 483 318  11],618,5,8076,4.122511485451761,80.0,20.0
41959,4,1959,[ 64 313 483 318  11],618,5,8081,4.122959183673469,80.0,20.0
41960,4,1960,[215  22 111  98 237],618,4,8085,4.1228964813870475,0.0,20.0
41961,4,1961,[ 64 313 483 318  11],618,5,8090,4.123343527013252,80.0,20.0
41962,4,1962,[276   7 496 742 546],314,4,8094,4.123280692817117,0.0,0.0
41963,4,1963,[276 125 118 245 176],62,3,8097,4.122708757637475,0.0,0.0
41964,4,1964,[ 64 313 483 318  11],214,5,8102,4.123155216284987,80.0,20.0
41965,4,1965,[ 64 313 483 318  11],618,5,8107,4.123601220752797,80.0,20.0
41966,4,1966,[  7 301 237  50 151],297,4,8111,4.12353838332486,0.0,20.0
41967,4,1967,[ 64 313 483 318  11],618,5,8116,4.123983739837398,80.0,20.0
41968,4,1968,[ 64 313 483 318  11],214,5,8121,4.124428643981717,80.0,20.0
41969,4,1969,[ 28 288   1 385 588],588,4,8125,4.124365482233503,0.0,20.0
41970,4,1970,[ 64 313 483 318  11],618,5,8130,4.1248097412480975,80.0,20.0
41971,4,1971,[ 64 313 483 318  11],214,5,8135,4.12525354969574,80.0,20.0
41972,4,1972,[ 64 313 483 318  11],618,5,8140,4.1256969082615305,80.0,20.0
41973,4,1973,[ 64 313 483 318  11],618,5,8145,4.12613981762918,80.0,20.0
41974,4,1974,[168 111 273  56 271],854,4,8149,4.126075949367088,0.0,0.0
41975,4,1975,[ 64 313 483 318  11],214,5,8154,4.126518218623482,80.0,20.0
41976,4,1976,[ 64 313 483 318  11],618,5,8159,4.1269600404653515,80.0,20.0
41977,4,1977,[333 125  79 258 286],907,5,8164,4.127401415571284,0.0,0.0
41978,4,1978,[ 64 313 483 318  11],618,5,8169,4.127842344618494,80.0,20.0
41979,4,1979,[ 64 313 483 318  11],618,5,8174,4.1282828282828286,80.0,20.0
41980,4,1980,[ 64 313 483 318  11],618,5,8179,4.128722867238769,80.0,20.0
41981,4,1981,[ 64 313 483 318  11],618,5,8184,4.129162462159435,80.0,20.0
41982,4,1982,[ 64 313 483 318  11],618,5,8189,4.129601613716591,80.0,20.0
41983,4,1983,[234 210 235   8 153],805,2,8191,4.128528225806452,0.0,0.0
41984,4,1984,[258 191 153 132 222],62,5,8196,4.12896725440806,0.0,0.0
41985,4,1985,[  8  98  56 286 269],43,5,8201,4.1294058408862035,0.0,20.0
41986,4,1986,[195   1 483  82 328],62,3,8204,4.1288374433819826,20.0,0.0
41987,4,1987,[200 161  96 288 172],416,5,8209,4.129275653923541,0.0,20.0
41988,4,1988,[175  88  82 357 288],805,2,8211,4.128205128205129,0.0,20.0
41989,4,1989,[176  98 153  64 423],416,5,8216,4.128643216080402,20.0,20.0
41990,4,1990,[175 237 435 603 173],297,4,8220,4.128578603716726,0.0,0.0
41991,4,1991,[ 64 313 483 318  11],618,5,8225,4.129016064257028,80.0,20.0
41992,4,1992,[185 423 191 151 742],417,3,8228,4.128449573507275,0.0,0.0
41993,4,1993,[ 64 313 483 318  11],214,5,8233,4.12888665997994,80.0,20.0
41994,4,1994,[161 328  25  22 228],373,5,8238,4.129323308270677,0.0,0.0
41995,4,1995,[ 64 313 483 318  11],618,5,8243,4.1297595190380765,80.0,20.0
41996,4,1996,[ 64 313 483 318  11],618,5,8248,4.130195292939409,80.0,20.0
41997,4,1997,[ 64 313 483 318  11],618,5,8253,4.13063063063063,80.0,20.0
41998,4,1998,[ 64 313 483 318  11],618,5,8258,4.131065532766383,80.0,20.0
41999,4,1999,[235 357  69 181 286],416,4,8262,4.131,0.0,20.0
42000,4,2000,[294 111 405 302  50],416,5,8267,4.131434282858571,0.0,20.0
42001,4,2001,[ 82 196 328 301 515],416,5,8272,4.131868131868132,0.0,0.0
42002,4,2002,[ 64 313 483 318  11],214,5,8277,4.132301547678482,80.0,20.0
42003,4,2003,[118 135 151 197 204],805,3,8280,4.131736526946108,0.0,0.0
42004,4,2004,[357 210 216 179 196],416,4,8284,4.1316708229426435,0.0,0.0
42005,4,2005,[216 200  22 288  25],805,2,8286,4.130608175473579,0.0,20.0
42006,4,2006,[182 323  11 125 302],416,4,8290,4.130543099152964,0.0,0.0
42007,4,2007,[ 64 313 483 318  11],214,5,8295,4.13097609561753,80.0,20.0
42008,4,2008,[ 25 117 496 276 168],128,4,8299,4.130910900945744,0.0,0.0
42009,4,2009,[ 64 313 483 318  11],618,5,8304,4.13134328358209,80.0,20.0
42010,4,2010,[546  50 125 179  98],262,2,8306,4.130283441074092,0.0,40.0
42011,4,2011,[172 202 204 210  89],922,3,8309,4.129721669980119,0.0,0.0
42012,4,2012,[ 64 313 483 318  11],214,5,8314,4.130153999006458,80.0,20.0
42013,4,2013,[117 132 322  70 161],314,4,8318,4.130089374379344,0.0,0.0
42014,4,2014,[323  25 475   1 258],805,4,8322,4.130024813895782,0.0,0.0
42015,4,2015,[ 64 313 483 318  11],618,5,8327,4.130456349206349,80.0,20.0
42016,4,2016,[475 483  97 185  88],437,2,8329,4.129400099157164,20.0,0.0
42017,4,2017,[ 64 313 483 318  11],214,5,8334,4.129831516352825,80.0,20.0
42018,4,2018,[655   8 748 678 172],721,2,8336,4.128776622090144,0.0,0.0
42019,4,2019,[117 172 191 237 132],505,2,8338,4.127722772277227,0.0,0.0
42020,4,2020,[ 64 313 483 318  11],618,5,8343,4.128154379020287,80.0,20.0
42021,4,2021,[ 64 313 483 318  11],214,5,8348,4.128585558852621,80.0,20.0
42022,4,2022,[132 180 222 185 135],198,2,8350,4.127533366287691,0.0,0.0
42023,4,2023,[ 89 153 117 195 237],437,2,8352,4.126482213438735,0.0,0.0
42024,4,2024,[ 64 313 483 318  11],618,5,8357,4.126913580246914,80.0,20.0
42025,4,2025,[181 172  71 180 258],887,4,8361,4.12685093780849,0.0,20.0
42026,4,2026,[ 64 313 483 318  11],214,5,8366,4.127281697089295,80.0,20.0
42027,4,2027,[ 64 313 483 318  11],618,5,8371,4.127712031558185,80.0,20.0
42028,4,2028,[496  82 174 597 127],43,4,8375,4.127649088220799,0.0,0.0
42029,4,2029,[258  64 269 273 196],416,5,8380,4.12807881773399,20.0,0.0
42030,4,2030,[125  22 100 333 182],253,2,8382,4.127031019202363,0.0,0.0
42031,4,2031,[179 357 289 216 182],416,3,8385,4.126476377952756,0.0,0.0
42032,4,2032,[  9  11 195 185 173],854,4,8389,4.1264141662567635,0.0,0.0
42033,4,2033,[ 64 313 483 318  11],214,5,8394,4.126843657817109,80.0,20.0
42034,4,2034,[ 64 313 483 318  11],618,5,8399,4.127272727272727,80.0,20.0
42035,4,2035,[475   4 181 238 174],62,5,8404,4.12770137524558,0.0,20.0
42036,4,2036,[215 204 588 111 276],437,2,8406,4.126656848306333,0.0,0.0
42037,4,2037,[  7  11 185 143  97],230,4,8410,4.126594700686948,0.0,0.0
42038,4,2038,[357   7  22 222 204],297,4,8414,4.126532614026484,0.0,0.0
42039,4,2039,[273 508  70  22 181],297,5,8419,4.1269607843137255,0.0,20.0
42040,4,2040,[135 210 271  69 118],297,2,8421,4.125918667319941,0.0,0.0
42041,4,2041,[ 64 313 483 318  11],214,5,8426,4.1263467189030365,80.0,20.0
42042,4,2042,[ 64 313 483 318  11],214,5,8431,4.126774351443955,80.0,20.0
42043,4,2043,[ 64 313 483 318  11],618,5,8436,4.12720156555773,80.0,20.0
42044,4,2044,[ 64 313 483 318  11],618,5,8441,4.127628361858191,80.0,20.0
42045,4,2045,[ 64 313 483 318  11],214,5,8446,4.128054740957967,80.0,20.0
42046,4,2046,[ 64 313 483 318  11],618,5,8451,4.12848070346849,80.0,20.0
42047,4,2047,[265  64 174  25  70],417,2,8453,4.12744140625,20.0,0.0
42048,4,2048,[ 64 313 483 318  11],618,5,8458,4.127867252318204,80.0,20.0
42049,4,2049,[ 22 182 357  64 176],62,5,8463,4.128292682926829,20.0,0.0
42050,4,2050,[ 64 313 483 318  11],618,5,8468,4.128717698683569,80.0,20.0
42051,4,2051,[ 64 313 483 318  11],618,5,8473,4.129142300194932,80.0,20.0
42052,4,2052,[117 405 302 273 174],416,5,8478,4.129566488066245,0.0,0.0
42053,4,2053,[ 22 603  71 405 121],805,1,8479,4.128042843232716,0.0,0.0
42054,4,2054,[ 64 313 483 318  11],214,5,8484,4.128467153284672,80.0,20.0
42055,4,2055,[125  95 385   1 318],262,1,8485,4.126945525291829,20.0,0.0
42056,4,2056,[ 64 313 483 318  11],214,5,8490,4.1273699562469615,80.0,20.0
42057,4,2057,[ 64 313 483 318  11],214,5,8495,4.12779397473275,80.0,20.0
42058,4,2058,[ 64 313 483 318  11],618,5,8500,4.12821758135017,80.0,20.0
42059,4,2059,[288 323 132 161 301],416,4,8504,4.128155339805825,0.0,20.0
42060,4,2060,[ 64 313 483 318  11],618,5,8509,4.128578360019408,80.0,20.0
42061,4,2061,[ 64 313 483 318  11],618,5,8514,4.129000969932105,80.0,20.0
42062,4,2062,[ 64 313 483 318  11],618,5,8519,4.129423170140572,80.0,20.0
42063,4,2063,[216 300 603 204  56],751,4,8523,4.129360465116279,0.0,0.0
42064,4,2064,[286 588 117 194 175],373,2,8525,4.128329297820823,0.0,0.0
42065,4,2065,[  1  89 183 200 235],417,4,8529,4.1282671829622455,0.0,0.0
42066,4,2066,[ 64 313 483 318  11],618,5,8534,4.128688921141752,80.0,20.0
42067,4,2067,[ 64 313 483 318  11],618,5,8539,4.129110251450677,80.0,20.0
42068,4,2068,[ 12 289 269 238 301],345,4,8543,4.1290478492025136,20.0,0.0
42069,4,2069,[ 15 235 288 176   4],417,2,8545,4.128019323671498,0.0,20.0
42070,4,2070,[ 64 313 483 318  11],214,5,8550,4.128440366972477,80.0,20.0
42071,4,2071,[ 98 185 302 546 475],297,4,8554,4.128378378378378,0.0,20.0
42072,4,2072,[ 64 313 483 318  11],214,5,8559,4.128798842257598,80.0,20.0
42073,4,2073,[ 64 313 483 318  11],618,5,8564,4.129218900675024,80.0,20.0
42074,4,2074,[245  97 174  98 323],417,3,8567,4.128674698795181,0.0,20.0
42075,4,2075,[405 173  71   1  97],62,2,8569,4.127649325626204,0.0,0.0
42076,4,2076,[568 385 176 132 195],416,5,8574,4.128069330765527,0.0,0.0
42077,4,2077,[121 175  71 144 496],43,4,8578,4.128007699711261,0.0,0.0
42078,4,2078,[ 64 313 483 318  11],618,5,8583,4.128427128427129,80.0,20.0
42079,4,2079,[ 56 175 210 168   8],297,5,8588,4.128846153846154,0.0,0.0
42080,4,2080,[ 64 313 483 318  11],214,5,8593,4.129264776549736,80.0,20.0
42081,4,2081,[ 64 313 483 318  11],214,5,8598,4.129682997118156,80.0,20.0
42082,4,2082,[ 98 125 483 568 427],253,4,8602,4.129620739318291,20.0,20.0
42083,4,2083,[ 88 265 288 118 289],416,2,8604,4.128598848368522,0.0,20.0
42084,4,2084,[ 64 313 483 318  11],214,5,8609,4.129016786570744,80.0,20.0
42085,4,2085,[183 238 288   4 181],618,2,8611,4.127996164908916,0.0,40.0
42086,4,2086,[216 288  70 435 273],297,3,8614,4.127455678006708,0.0,20.0
42087,4,2087,[ 64 313 483 318  11],618,5,8619,4.127873563218391,80.0,20.0
42088,4,2088,[183 471  70 216 187],416,5,8624,4.128291048348492,0.0,0.0
42089,4,2089,[ 64 313 483 318  11],618,5,8629,4.128708133971291,80.0,20.0
42090,4,2090,[  7 423  82 210 211],43,5,8634,4.129124820659971,0.0,0.0
42091,4,2091,[322 210  88  79 403],805,2,8636,4.128107074569789,0.0,0.0
42092,4,2092,[ 64 313 483 318  11],618,5,8641,4.128523650262781,80.0,20.0
42093,4,2093,[ 64 313 483 318  11],214,5,8646,4.128939828080229,80.0,20.0
42094,4,2094,[194   9 222 127  12],854,4,8650,4.128878281622912,20.0,0.0
42095,4,2095,[ 64 313 483 318  11],618,5,8655,4.129293893129771,80.0,20.0
42096,4,2096,[ 89 168 186 172  98],437,2,8657,4.12827849308536,0.0,20.0
42097,4,2097,[127 179 151 191 215],373,3,8660,4.127740705433746,0.0,0.0
42098,4,2098,[ 96  97  70  95 333],416,4,8664,4.1276798475464505,0.0,0.0
42099,4,2099,[ 64 313 483 318  11],618,5,8669,4.128095238095238,80.0,20.0
42100,4,2100,[168 222 228 180 202],711,3,8672,4.127558305568777,0.0,0.0
42101,4,2101,[ 64 313 483 318  11],618,5,8677,4.127973358705995,80.0,20.0
42102,4,2102,[174 403 483 173   9],618,3,8680,4.127436994769377,20.0,0.0
42103,4,2103,[588 568  22 132 181],887,4,8684,4.1273764258555135,0.0,20.0
42104,4,2104,[ 64 313 483 318  11],618,5,8689,4.1277909738717335,80.0,20.0
42105,4,2105,[588 111 385 168  95],618,3,8692,4.127255460588794,0.0,0.0
42106,4,2106,[118 508 237 195 210],654,3,8695,4.12672045562411,0.0,0.0
42107,4,2107,[ 96  56  69 228 302],405,3,8698,4.126185958254269,0.0,0.0
42108,4,2108,[ 64 313 483 318  11],214,5,8703,4.126600284495021,80.0,20.0
42109,4,2109,[ 64 313 483 318  11],618,5,8708,4.127014218009479,80.0,20.0
42110,4,2110,[117 322 742  15 183],416,4,8712,4.126954050213169,0.0,0.0
42111,4,2111,[ 79 174 288 117  25],297,3,8715,4.126420454545454,0.0,20.0
42112,4,2112,[ 64 313 483 318  11],214,5,8720,4.126833885470894,80.0,20.0
42113,4,2113,[655 748 143  95 186],373,4,8724,4.126773888363292,0.0,0.0
42114,4,2114,[ 64 313 483 318  11],618,5,8729,4.127186761229314,80.0,20.0
42115,4,2115,[ 64 313 483 318  11],618,5,8734,4.1275992438563325,80.0,20.0
42116,4,2116,[655   1 161 132 258],345,3,8737,4.127066603684459,0.0,0.0
42117,4,2117,[275 195 228 117 271],297,2,8739,4.126062322946176,0.0,0.0
42118,4,2118,[ 95 117 222 237  71],764,5,8744,4.126474752241624,0.0,0.0
42119,4,2119,[ 64 313 483 318  11],214,5,8749,4.12688679245283,80.0,20.0
42120,4,2120,[286 228  98 603 234],297,3,8752,4.126355492692126,0.0,20.0
42121,4,2121,[ 64 313 483 318  11],618,5,8757,4.1267672007540055,80.0,20.0
42122,4,2122,[ 64 313 483 318  11],214,5,8762,4.127178520960904,80.0,20.0
42123,4,2123,[ 88 655  71 301 282],588,4,8766,4.127118644067797,0.0,0.0
42124,4,2124,[ 64 313 483 318  11],214,5,8771,4.127529411764706,80.0,20.0
42125,4,2125,[ 70 568 182 603 195],405,2,8773,4.126528692380057,0.0,0.0
42126,4,2126,[173 268 111 222 153],654,4,8777,4.126469205453691,0.0,0.0
42127,4,2127,[ 64 483 282 228 603],128,3,8780,4.12593984962406,40.0,0.0
42128,4,2128,[180 257   1 100 333],854,2,8782,4.124941286989197,0.0,0.0
42129,4,2129,[ 28 186 435 238   8],230,4,8786,4.124882629107981,0.0,0.0
42130,4,2130,[ 70 143 238 403 275],373,3,8789,4.124354763022056,0.0,0.0
42131,4,2131,[ 64 313 483 318  11],214,5,8794,4.124765478424015,80.0,20.0
42132,4,2132,[ 64 313 483 318  11],618,5,8799,4.125175808720113,80.0,20.0
42133,4,2133,[257 191 143 111  89],297,2,8801,4.124179943767572,0.0,0.0
42134,4,2134,[ 98  95 185 237 182],198,2,8803,4.123185011709602,0.0,20.0
42135,4,2135,[ 64 313 483 318  11],618,5,8808,4.123595505617978,80.0,20.0
42136,4,2136,[ 64 313 483 318  11],618,5,8813,4.1240056153486195,80.0,20.0
42137,4,2137,[ 64 313 483 318  11],618,5,8818,4.124415341440598,80.0,20.0
42138,4,2138,[185  98  22  70 288],297,4,8822,4.124357176250585,0.0,40.0
42139,4,2139,[183 237 475 318 258],198,4,8826,4.124299065420561,20.0,0.0
42140,4,2140,[ 64 313 483 318  11],214,5,8831,4.124708080336291,80.0,20.0
42141,4,2141,[ 12 313 405  11 403],345,4,8835,4.124649859943977,40.0,20.0
42142,4,2142,[257  97 175 174 323],43,3,8838,4.124125058329445,0.0,0.0
42143,4,2143,[222 121 100 215 172],62,4,8842,4.124067164179104,0.0,0.0
42144,4,2144,[405 234 127 323 211],417,3,8845,4.123543123543124,0.0,0.0
42145,4,2145,[176 318 211 302 100],416,5,8850,4.123951537744642,20.0,0.0
42146,4,2146,[ 64 313 483 318  11],618,5,8855,4.124359571495109,80.0,20.0
42147,4,2147,[ 64 313 483 318  11],618,5,8860,4.1247672253258845,80.0,20.0
42148,4,2148,[179 403 357  28 655],721,4,8864,4.124709167054444,0.0,0.0
42149,4,2149,[742 258 318 173  12],588,5,8869,4.1251162790697675,40.0,0.0
42150,4,2150,[  7 143 237 301  56],416,4,8873,4.125058112505811,0.0,0.0
42151,4,2151,[ 11 191  22 269  89],214,3,8876,4.12453531598513,0.0,0.0
42152,4,2152,[748 185  25  88  97],907,5,8881,4.124941941477009,0.0,0.0
42153,4,2153,[180 357 655  82  69],373,3,8884,4.124419684308264,0.0,0.0
42154,4,2154,[172 678 118 269  98],654,4,8888,4.124361948955917,0.0,20.0
42155,4,2155,[ 64 313 483 318  11],214,5,8893,4.124768089053803,80.0,20.0
42156,4,2156,[117 475 183 194 496],416,4,8897,4.124710245711636,0.0,0.0
42157,4,2157,[181 427  22 210 515],698,2,8899,4.123725671918443,0.0,20.0
42158,4,2158,[546 204 196   1  88],416,3,8902,4.123205187586846,0.0,0.0
42159,4,2159,[ 64 313 483 318  11],214,5,8907,4.123611111111111,80.0,20.0
42160,4,2160,[258 405  70 186 238],198,3,8910,4.123091161499306,0.0,0.0
42161,4,2161,[181  88 168 143 323],43,4,8914,4.123034227567068,0.0,20.0
42162,4,2162,[  1 275   4 100 211],416,5,8919,4.123439667128988,0.0,0.0
42163,4,2163,[ 64 313 483 318  11],214,5,8924,4.123844731977819,80.0,20.0
42164,4,2164,[ 64 313 483 318  11],618,5,8929,4.124249422632794,80.0,20.0
42165,4,2165,[ 98   8 204  82 405],62,3,8932,4.123730378578024,0.0,20.0
42166,4,2166,[ 64 313 483 318  11],214,5,8937,4.12413474850023,80.0,20.0
42167,4,2167,[ 64 313 483 318  11],618,5,8942,4.124538745387454,80.0,20.0
42168,4,2168,[172 182  50  82 427],198,4,8946,4.124481327800829,0.0,20.0
42169,4,2169,[ 64 313 483 318  11],618,5,8951,4.1248847926267285,80.0,20.0
42170,4,2170,[238 111   4 194 328],416,5,8956,4.1252878857669275,0.0,0.0
42171,4,2171,[173 153  70 678 215],416,4,8960,4.125230202578269,0.0,0.0
42172,4,2172,[196 258 546 496  69],43,5,8965,4.12563276576162,0.0,0.0
42173,4,2173,[  7 173 655 118 405],417,3,8968,4.125114995400184,0.0,0.0
42174,4,2174,[ 64 313 483 318  11],618,5,8973,4.125517241379311,80.0,20.0
42175,4,2175,[174 268 196  56 200],416,5,8978,4.125919117647059,0.0,0.0
42176,4,2176,[ 64 313 483 318  11],618,5,8983,4.126320624712908,80.0,20.0
42177,4,2177,[ 64 313 483 318  11],214,5,8988,4.126721763085399,80.0,20.0
42178,4,2178,[ 64 313 483 318  11],618,5,8993,4.127122533272143,80.0,20.0
42179,4,2179,[ 64 313 483 318  11],618,5,8998,4.127522935779816,80.0,20.0
42180,4,2180,[ 64 313 483 318  11],214,5,9003,4.127922971114168,80.0,20.0
42181,4,2181,[ 64 313 483 318  11],618,5,9008,4.128322639780018,80.0,20.0
42182,4,2182,[ 64 313 483 318  11],618,5,9013,4.128721942281264,80.0,20.0
42183,4,2183,[ 64 313 483 318  11],618,5,9018,4.1291208791208796,80.0,20.0
42184,4,2184,[210 118  82   9 168],43,5,9023,4.129519450800915,0.0,0.0
42185,4,2185,[ 64 313 483 318  11],618,5,9028,4.1299176578225065,80.0,20.0
42186,4,2186,[238 546  82  50 403],49,1,9029,4.128486511202561,0.0,20.0
42187,4,2187,[ 69 508  22 655 222],62,4,9033,4.128427787934187,0.0,0.0
42188,4,2188,[ 28  79  12 118 655],588,3,9036,4.127912288716309,20.0,0.0
42189,4,2189,[ 50  82  95  56 403],405,4,9040,4.127853881278539,0.0,20.0
42190,4,2190,[323 288 118 210  79],345,2,9042,4.1268827019625745,0.0,20.0
42191,4,2191,[ 64 313 483 318  11],214,5,9047,4.127281021897811,80.0,20.0
42192,4,2192,[153 191 300 333 568],416,5,9052,4.127678978568172,0.0,0.0
42193,4,2193,[127 742 161 182  96],505,2,9054,4.126709206927986,0.0,0.0
42194,4,2194,[ 64 313 483 318  11],618,5,9059,4.127107061503417,80.0,20.0
42195,4,2195,[597 216  82 568  70],642,3,9062,4.126593806921676,0.0,0.0
42196,4,2196,[ 56   9 151 288 185],601,2,9064,4.125625853436504,0.0,20.0
42197,4,2197,[ 64 313 483 318  11],618,5,9069,4.126023657870792,80.0,20.0
42198,4,2198,[275 403  89  64 288],62,4,9073,4.125966348340155,20.0,20.0
42199,4,2199,[ 64 313 483 318  11],618,5,9078,4.126363636363636,80.0,20.0
42200,4,2200,[173   1 286 655 597],62,1,9079,4.124943207632894,0.0,0.0
42201,4,2201,[ 64 313 483 318  11],618,5,9084,4.125340599455041,80.0,20.0
42202,4,2202,[132 385 143 222 228],198,1,9085,4.123921924648207,0.0,0.0
42203,4,2203,[ 64 313 483 318  11],618,5,9090,4.124319419237749,80.0,20.0
42204,4,2204,[ 22 174 238 546 121],262,2,9092,4.123356009070295,0.0,0.0
42205,4,2205,[ 64 313 483 318  11],214,5,9097,4.123753399818677,80.0,20.0
42206,4,2206,[100 111 210 181  25],417,0,9097,4.1218849116447664,0.0,20.0
42207,4,2207,[196 143 302 275  69],43,5,9102,4.122282608695652,0.0,0.0
42208,4,2208,[ 64 313 483 318  11],618,5,9107,4.122679945676777,80.0,20.0
42209,4,2209,[ 64 313 483 318  11],618,5,9112,4.123076923076923,80.0,20.0
42210,4,2210,[ 64 313 483 318  11],618,5,9117,4.123473541383989,80.0,20.0
42211,4,2211,[ 64 313 483 318  11],214,5,9122,4.123869801084991,80.0,20.0
42212,4,2212,[323 275   7 172 161],43,4,9126,4.123813827383642,0.0,0.0
42213,4,2213,[ 64 313 483 318  11],214,5,9131,4.124209575429088,80.0,20.0
42214,4,2214,[172 196  79 288 127],417,2,9133,4.123250564334086,0.0,20.0
42215,4,2215,[143  82 423 196 121],198,0,9133,4.121389891696751,0.0,0.0
42216,4,2216,[ 98 508  64  11 191],24,5,9138,4.121786197564276,20.0,20.0
42217,4,2217,[ 82  64 597  98  22],618,5,9143,4.122182146077547,20.0,20.0
42218,4,2218,[ 64 313 483 318  11],214,5,9148,4.122577737719694,80.0,20.0
42219,4,2219,[ 64 313 483 318  11],618,5,9153,4.122972972972973,80.0,20.0
42220,4,2220,[318 301 403 127  50],721,5,9158,4.123367852318776,20.0,20.0
42221,4,2221,[ 56  88  97 118 121],43,5,9163,4.123762376237623,0.0,0.0
42222,4,2222,[357 132 176 294 173],24,3,9166,4.123256860098965,0.0,0.0
42223,4,2223,[ 64 313 483 318  11],618,5,9171,4.123651079136691,80.0,20.0
42224,4,2224,[195   9 176 187 328],416,5,9176,4.124044943820225,0.0,0.0
42225,4,2225,[ 64 313 483 318  11],618,5,9181,4.124438454627134,80.0,20.0
42226,4,2226,[286 186 194 405   7],854,2,9183,4.12348450830714,0.0,0.0
42227,4,2227,[496  98  50 748 176],505,3,9186,4.122980251346499,0.0,40.0
42228,4,2228,[195  28 216 174 257],654,5,9191,4.123373710183939,0.0,0.0
42229,4,2229,[ 11 111 200  95  25],416,4,9195,4.123318385650224,0.0,0.0
42230,4,2230,[427 202 173  22  88],642,3,9198,4.122814881219184,0.0,0.0
42231,4,2231,[202 483  70 597  96],751,4,9202,4.122759856630824,20.0,0.0
42232,4,2232,[ 64 313 483 318  11],618,5,9207,4.123152709359606,80.0,20.0
42233,4,2233,[ 64 313 483 318  11],618,5,9212,4.12354521038496,80.0,20.0
42234,4,2234,[ 64 313 483 318  11],618,5,9217,4.123937360178971,80.0,20.0
42235,4,2235,[ 64 313 483 318  11],618,5,9222,4.124329159212881,80.0,20.0
42236,4,2236,[ 64 313 483 318  11],618,5,9227,4.1247206079570855,80.0,20.0
42237,4,2237,[ 64 313 483 318  11],214,5,9232,4.125111706881144,80.0,20.0
42238,4,2238,[121 288 135 151 161],805,2,9234,4.124162572577044,0.0,20.0
42239,4,2239,[ 64 313 483 318  11],214,5,9239,4.124553571428572,80.0,20.0
42240,4,2240,[ 64 313 483 318  11],214,5,9244,4.124944221329764,80.0,20.0
42241,4,2241,[ 64 313 483 318  11],618,5,9249,4.125334522747547,80.0,20.0
42242,4,2242,[ 64 313 483 318  11],618,5,9254,4.125724476148016,80.0,20.0
42243,4,2243,[151 275  79  12 423],854,5,9259,4.126114081996435,20.0,0.0
42244,4,2244,[ 95 475 216 135 258],711,5,9264,4.126503340757238,0.0,0.0
42245,4,2245,[333 197   1 471 300],721,4,9268,4.126447016918967,0.0,0.0
42246,4,2246,[204 182 228  50 258],505,0,9268,4.1246105919003115,0.0,20.0
42247,4,2247,[ 64 313 483 318  11],618,5,9273,4.125,80.0,20.0
42248,4,2248,[ 64 313 483 318  11],214,5,9278,4.1253890618052464,80.0,20.0
42249,4,2249,[173 228  89 153 211],417,4,9282,4.125333333333334,0.0,0.0
42250,4,2250,[ 64 313 483 318  11],214,5,9287,4.125721901377165,80.0,20.0
42251,4,2251,[ 64 313 483 318  11],618,5,9292,4.126110124333925,80.0,20.0
42252,4,2252,[ 64 313 483 318  11],618,5,9297,4.126498002663116,80.0,20.0
42253,4,2253,[ 79 322 202 186 496],128,3,9300,4.125998225377107,0.0,0.0
42254,4,2254,[117 313 496 385  98],416,5,9305,4.126385809312638,20.0,40.0
42255,4,2255,[191  25 172 100 173],417,2,9307,4.1254432624113475,0.0,0.0
42256,4,2256,[210 475 655   1 357],62,3,9310,4.124944616747896,0.0,0.0
42257,4,2257,[483 135 210  50 127],698,3,9313,4.12444641275465,20.0,20.0
42258,4,2258,[151 111   1 238 603],854,3,9316,4.123948649845064,0.0,0.0
42259,4,2259,[ 64 313 483 318  11],214,5,9321,4.124336283185841,80.0,20.0
42260,4,2260,[257 237 289  15 211],416,2,9323,4.123396727111897,0.0,0.0
42261,4,2261,[ 64 313 483 318  11],214,5,9328,4.123784261715296,80.0,20.0
42262,4,2262,[313 471 496 173 357],416,5,9333,4.12417145382236,20.0,20.0
42263,4,2263,[ 64 313 483 318  11],618,5,9338,4.124558303886926,80.0,20.0
42264,4,2264,[282  95 117 204 258],588,5,9343,4.124944812362031,0.0,0.0
42265,4,2265,[210  97 403 427 181],642,4,9347,4.124889673433363,0.0,20.0
42266,4,2266,[111  25  50  95 237],654,4,9351,4.1248345831495365,0.0,20.0
42267,4,2267,[ 64 313 483 318  11],618,5,9356,4.125220458553792,80.0,20.0
42268,4,2268,[ 64 313 483 318  11],618,5,9361,4.125605993829881,80.0,20.0
42269,4,2269,[ 64 313 483 318  11],618,5,9366,4.125991189427313,80.0,20.0
42270,4,2270,[ 64 313 483 318  11],618,5,9371,4.126376045794804,80.0,20.0
42271,4,2271,[655  28  22 288  56],618,4,9375,4.126320422535211,0.0,20.0
42272,4,2272,[204 118 161 195 273],618,2,9377,4.125384953805543,0.0,0.0
42273,4,2273,[127 405 318 483 471],854,4,9381,4.12532981530343,40.0,0.0
42274,4,2274,[237 204  79 174 301],437,4,9385,4.125274725274726,0.0,0.0
42275,4,2275,[ 64 313 483 318  11],618,5,9390,4.1256590509666085,80.0,20.0
42276,4,2276,[ 7  1 88 28 96],805,3,9393,4.125164690382082,0.0,0.0
42277,4,2277,[135 655 405 235 118],417,2,9395,4.124231782265145,0.0,0.0
42278,4,2278,[132 258 286 603 118],854,3,9398,4.123738481790259,0.0,0.0
42279,4,2279,[ 64 313 483 318  11],618,5,9403,4.124122807017544,80.0,20.0
42280,4,2280,[  4 323  28 301   9],345,3,9406,4.123629986847874,0.0,0.0
42281,4,2281,[286 678 323 111 143],416,3,9409,4.123137598597721,0.0,0.0
42282,4,2282,[301 182 185   4 294],297,2,9411,4.122207621550591,0.0,0.0
42283,4,2283,[ 64 313 483 318  11],618,5,9416,4.122591943957969,80.0,20.0
42284,4,2284,[ 64 313 483 318  11],214,5,9421,4.122975929978118,80.0,20.0
42285,4,2285,[202  95 282 333   1],416,4,9425,4.122922134733158,0.0,0.0
42286,4,2286,[ 89 427 153 179  12],373,4,9429,4.122868386532575,20.0,0.0
42287,4,2287,[678  96 273   8 289],416,3,9432,4.1223776223776225,0.0,0.0
42288,4,2288,[ 64 313 483 318  11],618,5,9437,4.1227610310179115,80.0,20.0
42289,4,2289,[ 71 275 204   1 423],588,3,9440,4.122270742358078,0.0,0.0
42290,4,2290,[ 64 313 483 318  11],214,5,9445,4.122653862941947,80.0,20.0
42291,4,2291,[  8 282 333 258 204],588,5,9450,4.12303664921466,0.0,0.0
42292,4,2292,[568  50  88 174  11],505,4,9454,4.122982991713912,0.0,20.0
42293,4,2293,[275 151  96 328 172],62,4,9458,4.122929380993897,0.0,0.0
42294,4,2294,[ 64 313 483 318  11],214,5,9463,4.1233115468409585,80.0,20.0
42295,4,2295,[ 64 313 483 318  11],214,5,9468,4.123693379790941,80.0,20.0
42296,4,2296,[118 483  69   8 173],62,4,9472,4.1236395298215065,20.0,0.0
42297,4,2297,[ 69 313 323 174 496],416,4,9476,4.123585726718886,20.0,20.0
42298,4,2298,[ 64 313 483 318  11],214,5,9481,4.12396694214876,80.0,20.0
42299,4,2299,[294 151 271 153 508],854,4,9485,4.123913043478261,0.0,0.0
42300,4,2300,[ 64 313 483 318  11],214,5,9490,4.124293785310734,80.0,20.0
42301,4,2301,[ 64 313 483 318  11],214,5,9495,4.124674196350999,80.0,20.0
42302,4,2302,[194  22 135 234 603],405,3,9498,4.124185844550587,0.0,0.0
42303,4,2303,[215  98 275  15 655],437,4,9502,4.124131944444445,0.0,20.0
42304,4,2304,[588 678 111 568 405],416,4,9506,4.12407809110629,0.0,0.0
42305,4,2305,[ 64 313 483 318  11],214,5,9511,4.124457935819601,80.0,20.0
42306,4,2306,[ 64 313 483 318  11],618,5,9516,4.12483745123537,80.0,20.0
42307,4,2307,[ 71 294 204 174  89],62,3,9519,4.124350086655113,0.0,0.0
42308,4,2308,[ 95  64  50 546  82],262,1,9520,4.122996968384582,20.0,20.0
42309,4,2309,[ 79 183 238   7  25],618,3,9523,4.122510822510822,0.0,0.0
42310,4,2310,[ 89 186 175  15 357],373,4,9527,4.122457810471658,0.0,0.0
42311,4,2311,[ 64 313 483 318  11],618,5,9532,4.122837370242214,80.0,20.0
42312,4,2312,[ 64 313 483 318  11],214,5,9537,4.123216601815823,80.0,20.0
42313,4,2313,[597  82 135 161 515],417,2,9539,4.122299049265341,0.0,0.0
42314,4,2314,[ 64 313 483 318  11],618,5,9544,4.122678185745141,80.0,20.0
42315,4,2315,[ 28  56 508  82 276],128,4,9548,4.122625215889465,0.0,0.0
42316,4,2316,[ 95   7 211  97  25],230,3,9551,4.122140699179974,0.0,0.0
42317,4,2317,[ 64 313 483 318  11],618,5,9556,4.122519413287317,80.0,20.0
42318,4,2318,[ 64 313 483 318  11],618,5,9561,4.1228978007761965,80.0,20.0
42319,4,2319,[ 69 222 111  56  97],679,3,9564,4.122413793103449,0.0,0.0
42320,4,2320,[ 64 313 483 318  11],618,5,9569,4.122791900043085,80.0,20.0
42321,4,2321,[ 25 197 328 180 121],128,3,9572,4.122308354866495,0.0,0.0
42322,4,2322,[ 82 655  89 427 276],922,2,9574,4.121394748170469,0.0,0.0
42323,4,2323,[ 64 313 483 318  11],214,5,9579,4.121772805507745,80.0,20.0
42324,4,2324,[ 64 313 483 318  11],214,5,9584,4.1221505376344085,80.0,20.0
42325,4,2325,[ 64 313 483 318  11],214,5,9589,4.122527944969906,80.0,20.0
42326,4,2326,[286 302  97 168 546],43,5,9594,4.122905027932961,0.0,0.0
42327,4,2327,[ 64 313 483 318  11],214,5,9599,4.123281786941581,80.0,20.0
42328,4,2328,[204 182 245 515  70],416,4,9603,4.123228853585229,0.0,0.0
42329,4,2329,[111 161 742 215  25],751,2,9605,4.122317596566524,0.0,0.0
42330,4,2330,[282  95 183 385 100],618,3,9608,4.121836121836122,0.0,0.0
42331,4,2331,[483  12 173  70 211],417,5,9613,4.12221269296741,40.0,0.0
42332,4,2332,[237 202  70 204 597],314,4,9617,4.122160308615516,0.0,0.0
42333,4,2333,[588 143 121 202 161],49,1,9618,4.120822622107969,0.0,0.0
42334,4,2334,[ 64 313 483 318  11],214,5,9623,4.12119914346895,80.0,20.0
42335,4,2335,[191 118 288 318 357],642,1,9624,4.11986301369863,20.0,20.0
42336,4,2336,[ 64 313 483 318  11],214,5,9629,4.120239623448866,80.0,20.0
42337,4,2337,[597 173 655 161 228],805,1,9630,4.118905047048759,0.0,0.0
42338,4,2338,[151 588 313 385 181],654,4,9634,4.118854211201368,20.0,40.0
42339,4,2339,[ 97 265 210   1  64],198,3,9637,4.118376068376068,20.0,0.0
42340,4,2340,[ 82 195   7 121 588],262,2,9639,4.117471166168304,0.0,0.0
42341,4,2341,[ 64 313 483 318  11],618,5,9644,4.117847993168232,80.0,20.0
42342,4,2342,[405 237 216 132 275],854,3,9647,4.117370892018779,0.0,0.0
42343,4,2343,[ 64 313 483 318  11],618,5,9652,4.117747440273037,80.0,20.0
42344,4,2344,[186 483 276 118  64],128,5,9657,4.118123667377398,40.0,0.0
42345,4,2345,[204 127 403 168 185],198,3,9660,4.117647058823529,0.0,0.0
42346,4,2346,[ 12 127 181 153 678],805,3,9663,4.117170856412441,20.0,20.0
42347,4,2347,[135   7  70 168 174],618,4,9667,4.117120954003407,0.0,0.0
42348,4,2348,[ 79  98 403 323 597],416,3,9670,4.116645381013197,0.0,20.0
42349,4,2349,[ 64 313 483 318  11],214,5,9675,4.117021276595745,80.0,20.0
42350,4,2350,[ 89 210 238 222 423],417,3,9678,4.116546150574224,0.0,0.0
42351,4,2351,[ 64 313 483 318  11],214,5,9683,4.116921768707483,80.0,20.0
42352,4,2352,[300 195 748 286  71],416,5,9688,4.11729706757331,0.0,0.0
42353,4,2353,[117 300 357 191 678],416,4,9692,4.117247238742566,0.0,0.0
42354,4,2354,[ 64 313 483 318  11],618,5,9697,4.117622080679405,80.0,20.0
42355,4,2355,[176 153 228 143  89],297,4,9701,4.117572156196944,0.0,0.0
42356,4,2356,[173 288 597 117 294],654,3,9704,4.117098005939754,0.0,20.0
42357,4,2357,[179 197 161 678 748],721,3,9707,4.116624257845632,0.0,0.0
42358,4,2358,[ 64 313 483 318  11],214,5,9712,4.116998728274693,80.0,20.0
42359,4,2359,[  1 168 235 135  11],297,3,9715,4.116525423728813,0.0,0.0
42360,4,2360,[ 64 313 483 318  11],618,5,9720,4.116899618805591,80.0,20.0
42361,4,2361,[234  69 111  15 302],416,5,9725,4.11727349703641,0.0,0.0
42362,4,2362,[100 191 323 180 269],805,4,9729,4.117223867964452,0.0,0.0
42363,4,2363,[ 64 313 483 318  11],618,5,9734,4.117597292724196,80.0,20.0
42364,4,2364,[144  98 195 385 403],417,4,9738,4.11754756871036,0.0,20.0
42365,4,2365,[ 64 313 483 318  11],214,5,9743,4.117920540997464,80.0,20.0
42366,4,2366,[ 64 313 483 318  11],214,5,9748,4.118293198141107,80.0,20.0
42367,4,2367,[ 64 313 483 318  11],214,5,9753,4.11866554054054,80.0,20.0
42368,4,2368,[ 64 313 483 318  11],618,5,9758,4.119037568594344,80.0,20.0
42369,4,2369,[181 588 282   8 127],416,5,9763,4.119409282700422,0.0,20.0
42370,4,2370,[ 64 313 483 318  11],618,5,9768,4.11978068325601,80.0,20.0
42371,4,2371,[ 64 313 483 318  11],214,5,9773,4.120151770657673,80.0,20.0
42372,4,2372,[ 64 313 483 318  11],618,5,9778,4.120522545301307,80.0,20.0
42373,4,2373,[ 64 313 483 318  11],618,5,9783,4.12089300758214,80.0,20.0
42374,4,2374,[185 234 301 196 286],416,5,9788,4.121263157894737,0.0,0.0
42375,4,2375,[ 64 313 483 318  11],618,5,9793,4.1216329966329965,80.0,20.0
42376,4,2376,[300 655 273 568 423],416,5,9798,4.1220025241901554,0.0,0.0
42377,4,2377,[357 185 245 597 180],417,3,9801,4.121530698065602,0.0,0.0
42378,4,2378,[ 64 313 483 318  11],214,5,9806,4.121899957965532,80.0,20.0
42379,4,2379,[117 318 286  69 237],223,4,9810,4.121848739495798,20.0,0.0
42380,4,2380,[174 273 357 268 265],417,2,9812,4.120957580848383,0.0,0.0
42381,4,2381,[ 64 313 483 318  11],214,5,9817,4.121326616288833,80.0,20.0
42382,4,2382,[ 64 313 483 318  11],214,5,9822,4.121695342005875,80.0,20.0
42383,4,2383,[496 655 132 273 234],417,3,9825,4.121224832214765,0.0,0.0
42384,4,2384,[ 64 313 483 318  11],618,5,9830,4.121593291404612,80.0,20.0
42385,4,2385,[273 475 176 168 597],62,4,9834,4.1215423302598495,0.0,0.0
42386,4,2386,[357 301 182 423 257],416,4,9838,4.1214914118139925,0.0,0.0
42387,4,2387,[111  25 117 475 588],588,3,9841,4.1210217755443885,0.0,0.0
42388,4,2388,[ 70 289 234 588  96],416,4,9845,4.120971117622436,0.0,0.0
42389,4,2389,[204 301  70 403 197],345,4,9849,4.1209205020920505,0.0,0.0
42390,4,2390,[ 64 313 483 318  11],214,5,9854,4.1212881639481385,80.0,20.0
42391,4,2391,[258  69 427  15 191],262,4,9858,4.12123745819398,0.0,0.0
42392,4,2392,[ 98 405 185 222 176],854,4,9862,4.12118679481822,0.0,20.0
42393,4,2393,[215 265  71 568  82],618,5,9867,4.12155388471178,0.0,0.0
42394,4,2394,[ 64 313 483 318  11],214,5,9872,4.121920668058455,80.0,20.0
42395,4,2395,[ 88 202 268  79 111],588,3,9875,4.121452420701169,0.0,0.0
42396,4,2396,[ 97 655  88 174 483],618,5,9880,4.121818940342094,20.0,0.0
42397,4,2397,[ 64 313 483 318  11],214,5,9885,4.122185154295246,80.0,20.0
42398,4,2398,[ 64 313 483 318  11],618,5,9890,4.122551062942893,80.0,20.0
42399,4,2399,[313 191 385 294 289],43,5,9895,4.122916666666667,20.0,20.0
42400,4,2400,[182 748 168 508  89],297,3,9898,4.122448979591836,0.0,0.0
42401,4,2401,[118 276 151 186 180],437,3,9901,4.121981681931723,0.0,0.0
42402,4,2402,[ 11 588 194  82 515],416,5,9906,4.122347066167291,0.0,0.0
42403,4,2403,[  4 286 269 191 151],854,3,9909,4.121880199667221,0.0,0.0
42404,4,2404,[385  11 181  50 172],805,2,9911,4.120997920997921,0.0,40.0
42405,4,2405,[211 322 742 333 121],416,4,9915,4.120947630922693,0.0,0.0
42406,4,2406,[385 257 742 135 183],417,2,9917,4.120066472787703,0.0,0.0
42407,4,2407,[ 64 313 483 318  11],618,5,9922,4.120431893687708,80.0,20.0
42408,4,2408,[ 64 313 483 318  11],214,5,9927,4.12079701120797,80.0,20.0
42409,4,2409,[186 742  50   8 318],642,4,9931,4.1207468879668046,20.0,20.0
42410,4,2410,[ 64 313 483 318  11],214,5,9936,4.121111571961841,80.0,20.0
42411,4,2411,[  4 202 172 216 118],805,1,9937,4.119817578772802,0.0,0.0
42412,4,2412,[125 655 588 748  98],416,5,9942,4.120182345627849,0.0,20.0
42413,4,2413,[185 181 153 200  98],96,5,9947,4.120546810273405,0.0,40.0
42414,4,2414,[ 64 313 483 318  11],214,5,9952,4.120910973084886,80.0,20.0
42415,4,2415,[423 111 127 258   7],854,4,9956,4.120860927152318,0.0,0.0
42416,4,2416,[357   7 568 322 323],417,1,9957,4.119569714522135,0.0,0.0
42417,4,2417,[151 215 238 245 286],297,2,9959,4.118693134822167,0.0,0.0
42418,4,2418,[ 64 313 483 318  11],214,5,9964,4.1190574617610585,80.0,20.0
42419,4,2419,[ 64 313 483 318  11],618,5,9969,4.119421487603306,80.0,20.0
42420,4,2420,[276  70 100 173 318],416,4,9973,4.119372160264353,20.0,0.0
42421,4,2421,[174 265 222  50 204],128,3,9976,4.1189099917423615,0.0,20.0
42422,4,2422,[ 64 313 483 318  11],214,5,9981,4.119273627734214,80.0,20.0
42423,4,2423,[269 238 210 405 215],751,3,9984,4.118811881188119,0.0,0.0
42424,4,2424,[172   8 222 121 228],921,3,9987,4.118350515463917,0.0,0.0
42425,4,2425,[ 95  64 191 496 100],416,4,9991,4.1183017312448476,20.0,0.0
42426,4,2426,[ 64 313 483 318  11],618,5,9996,4.118665018541409,80.0,20.0
42427,4,2427,[ 25 153 269 174 180],854,3,9999,4.11820428336079,0.0,0.0
42428,4,2428,[ 64 313 483 318  11],618,5,10004,4.118567311650885,80.0,20.0
42429,4,2429,[286   9 475  22 508],854,3,10007,4.118106995884774,0.0,0.0
42430,4,2430,[ 89  56   9 195 180],62,5,10012,4.118469765528589,0.0,0.0
42431,4,2431,[655  97 427  50  12],253,5,10017,4.118832236842105,20.0,20.0
42432,4,2432,[ 64 678   9 302 121],345,3,10020,4.118372379778052,20.0,0.0
42433,4,2433,[ 64 313 483 318  11],618,5,10025,4.11873459326212,80.0,20.0
42434,4,2434,[153 742 258 508 117],654,4,10029,4.118685831622177,0.0,0.0
42435,4,2435,[ 98  96 127  79  71],505,3,10032,4.1182266009852215,0.0,20.0
42436,4,2436,[151 144 276 173  25],43,5,10037,4.118588428395569,0.0,0.0
42437,4,2437,[ 64 313 483 318  11],618,5,10042,4.118949958982773,80.0,20.0
42438,4,2438,[195 135 153 258  95],698,1,10043,4.1176711767117675,0.0,0.0
42439,4,2439,[302 174 328 403 235],416,4,10047,4.117622950819672,0.0,0.0
42440,4,2440,[ 64 313 483 318  11],214,5,10052,4.117984432609586,80.0,20.0
42441,4,2441,[ 64 313 483 318  11],618,5,10057,4.118345618345618,80.0,20.0
42442,4,2442,[ 89  71 179 237 196],437,3,10060,4.117887842816209,0.0,0.0
42443,4,2443,[678 603 197 515 322],416,3,10063,4.117430441898527,0.0,0.0
42444,4,2444,[ 64 313 483 318  11],618,5,10068,4.117791411042945,80.0,20.0
42445,4,2445,[117 216 245 568 186],642,4,10072,4.117743254292723,0.0,0.0
42446,4,2446,[ 64 313 483 318  11],214,5,10077,4.118103800572129,80.0,20.0
42447,4,2447,[ 64 313 483 318  11],214,5,10082,4.118464052287582,80.0,20.0
42448,4,2448,[ 64 313 483 318  11],214,5,10087,4.118824009799918,80.0,20.0
42449,4,2449,[151  96 385  22 161],805,2,10089,4.117959183673469,0.0,0.0
42450,4,2450,[ 79 588  82 121 235],417,1,10090,4.116687066503468,0.0,0.0
42451,4,2451,[121 385 187 168 286],416,5,10095,4.117047308319739,0.0,0.0
42452,4,2452,[ 25  97 678 173 742],297,3,10098,4.116591928251121,0.0,0.0
42453,4,2453,[ 64 313 483 318  11],214,5,10103,4.116951915240424,80.0,20.0
42454,4,2454,[180 655 153  71 483],437,4,10107,4.116904276985744,20.0,0.0
42455,4,2455,[282 204 117 174  22],654,4,10111,4.11685667752443,0.0,0.0
42456,4,2456,[ 64 313 483 318  11],618,5,10116,4.117216117216117,80.0,20.0
42457,4,2457,[ 64 313 483 318  11],214,5,10121,4.117575264442636,80.0,20.0
42458,4,2458,[265  28 210  22   8],230,5,10126,4.117934119560797,0.0,0.0
42459,4,2459,[ 64 313 483 318  11],214,5,10131,4.118292682926829,80.0,20.0
42460,4,2460,[ 64 313 483 318  11],214,5,10136,4.118650954896384,80.0,20.0
42461,4,2461,[ 64 313 483 318  11],618,5,10141,4.1190089358245325,80.0,20.0
42462,4,2462,[132 195 435 588 144],230,3,10144,4.11855460820138,0.0,0.0
42463,4,2463,[588 182 294  25   4],297,2,10146,4.117694805194805,0.0,0.0
42464,4,2464,[ 64 313 483 318  11],618,5,10151,4.118052738336714,80.0,20.0
42465,4,2465,[ 64 313 483 318  11],618,5,10156,4.118410381184104,80.0,20.0
42466,4,2466,[ 64 313 483 318  11],618,5,10161,4.118767734089988,80.0,20.0
42467,4,2467,[ 64 313 483 318  11],618,5,10166,4.1191247974068075,80.0,20.0
42468,4,2468,[ 64 313 483 318  11],618,5,10171,4.119481571486432,80.0,20.0
42469,4,2469,[ 64 313 483 318  11],214,5,10176,4.119838056680162,80.0,20.0
42470,4,2470,[ 64 313 483 318  11],618,5,10181,4.120194253338729,80.0,20.0
42471,4,2471,[748 204 172  98 273],416,5,10186,4.1205501618122975,0.0,20.0
42472,4,2472,[183 238  95  69   8],230,3,10189,4.120097048119693,0.0,0.0
42473,4,2473,[ 64 313 483 318  11],618,5,10194,4.120452708164915,80.0,20.0
42474,4,2474,[ 64   1  56 222 172],417,3,10197,4.12,20.0,0.0
42475,4,2475,[ 50 168 273 228  70],62,3,10200,4.119547657512117,0.0,20.0
42476,4,2476,[216  25  96 597 235],417,0,10200,4.117884537747275,0.0,0.0
42477,4,2477,[294   9  98 173 181],601,3,10203,4.1174334140435835,0.0,40.0
42478,4,2478,[ 64 313 483 318  11],214,5,10208,4.117789431222267,80.0,20.0
42479,4,2479,[ 64 313 483 318  11],214,5,10213,4.118145161290323,80.0,20.0
42480,4,2480,[172 288 132 185 603],437,4,10217,4.118097541313986,0.0,20.0
42481,4,2481,[180  11 195 588 603],405,2,10219,4.117244157937147,0.0,0.0
42482,4,2482,[ 69 181  11 197 748],297,2,10221,4.1163914619412,0.0,20.0
42483,4,2483,[ 64 313 483 318  11],214,5,10226,4.116747181964573,80.0,20.0
42484,4,2484,[ 64 313 483 318  11],214,5,10231,4.117102615694165,80.0,20.0
42485,4,2485,[ 15 144 288 186 357],417,3,10234,4.116653258246179,0.0,20.0
42486,4,2486,[197 328 215 235 302],416,4,10238,4.116606353035786,0.0,0.0
42487,4,2487,[161 238  96 194  11],405,2,10240,4.115755627009646,0.0,0.0
42488,4,2488,[143 117 153 200 357],297,4,10244,4.115709120128566,0.0,0.0
42489,4,2489,[ 56 300 172 111 289],721,3,10247,4.115261044176707,0.0,0.0
42490,4,2490,[202 196 273 258  25],416,5,10252,4.11561621838619,0.0,0.0
42491,4,2491,[ 64 313 483 318  11],214,5,10257,4.115971107544142,80.0,20.0
42492,4,2492,[258   1 117 237  50],198,3,10260,4.115523465703971,0.0,20.0
42493,4,2493,[ 82 403 234 179 546],417,4,10264,4.115477145148356,0.0,0.0
42494,4,2494,[ 64 313 483 318  11],618,5,10269,4.115831663326653,80.0,20.0
42495,4,2495,[603 197 173 135 174],297,4,10273,4.115785256410256,0.0,0.0
42496,4,2496,[  1 245 135 483 423],62,2,10275,4.114937925510612,20.0,0.0
42497,4,2497,[323  95 597 269   4],805,2,10277,4.114091273018415,0.0,0.0
42498,4,2498,[ 64 313 483 318  11],214,5,10282,4.114445778311325,80.0,20.0
42499,4,2499,[403 100 117  88 125],345,3,10285,4.114,0.0,0.0
42500,4,2500,[318 222 174  15 121],601,3,10288,4.113554578168732,20.0,0.0
42501,4,2501,[357 183 238  28 282],297,4,10292,4.113509192645883,0.0,0.0
42502,4,2502,[ 64 313 483 318  11],618,5,10297,4.113863363963244,80.0,20.0
42503,4,2503,[ 64 313 483 318  11],214,5,10302,4.114217252396166,80.0,20.0
42504,4,2504,[245  56 655 182 183],62,3,10305,4.11377245508982,0.0,0.0
42505,4,2505,[333 269 183 153 328],416,5,10310,4.114126097366321,0.0,0.0
42506,4,2506,[196  98 313  11 302],416,5,10315,4.114479457518947,20.0,40.0
42507,4,2507,[176 204  15 496 202],437,4,10319,4.1144338118022326,0.0,0.0
42508,4,2508,[ 97 191 265 135 179],405,2,10321,4.113591072140295,0.0,0.0
42509,4,2509,[ 12 135 132  95   1],417,4,10325,4.113545816733068,20.0,0.0
42510,4,2510,[  1 245 276 423  28],416,3,10328,4.11310234966149,0.0,0.0
42511,4,2511,[ 64 313 483 318  11],618,5,10333,4.113455414012739,80.0,20.0
42512,4,2512,[427 748 111 235 176],416,4,10337,4.113410266613609,0.0,0.0
42513,4,2513,[ 64 313 483 318  11],618,5,10342,4.11376292760541,80.0,20.0
42514,4,2514,[ 64 313 483 318  11],618,5,10347,4.114115308151093,80.0,20.0
42515,4,2515,[ 22 471  28 153 282],416,5,10352,4.114467408585056,0.0,0.0
42516,4,2516,[ 64 313 483 318  11],618,5,10357,4.11481922924116,80.0,20.0
42517,4,2517,[ 64 313 483 318  11],214,5,10362,4.115170770452741,80.0,20.0
42518,4,2518,[ 28  95  11 423 405],223,2,10364,4.114331083763398,0.0,0.0
42519,4,2519,[ 64 313 483 318  11],618,5,10369,4.11468253968254,80.0,20.0
42520,4,2520,[179  64 174 483 245],62,4,10373,4.114637048790162,40.0,0.0
42521,4,2521,[175 195   4  71 258],805,1,10374,4.11340206185567,0.0,0.0
42522,4,2522,[ 64 313 483 318  11],214,5,10379,4.113753468093539,80.0,20.0
42523,4,2523,[ 64 313 483 318  11],618,5,10384,4.114104595879557,80.0,20.0
42524,4,2524,[403  79 655  28  71],416,5,10389,4.114455445544555,0.0,0.0
42525,4,2525,[288 385  56 748  25],654,3,10392,4.114014251781473,0.0,20.0
42526,4,2526,[ 64 313 483 318  11],214,5,10397,4.114364859517214,80.0,20.0
42527,4,2527,[210 318  98 196  69],437,3,10400,4.113924050632911,20.0,20.0
42528,4,2528,[ 64 313 483 318  11],618,5,10405,4.11427441676552,80.0,20.0
42529,4,2529,[200 100  69 187  98],198,4,10409,4.114229249011857,0.0,20.0
42530,4,2530,[ 64 313 483 318  11],214,5,10414,4.114579217700514,80.0,20.0
42531,4,2531,[176 427  79 183 234],416,5,10419,4.1149289099526065,0.0,0.0
42532,4,2532,[ 64 313 483 318  11],214,5,10424,4.115278326095539,80.0,20.0
42533,4,2533,[323 185  11 546  89],417,2,10426,4.114443567482241,0.0,0.0
42534,4,2534,[ 97  56 111 282 204],654,3,10429,4.1140039447731755,0.0,0.0
42535,4,2535,[ 88 187 125 202 427],618,3,10432,4.113564668769716,0.0,0.0
42536,4,2536,[ 64 313 483 318  11],214,5,10437,4.113914071738273,80.0,20.0
42537,4,2537,[ 64 313 483 318  11],214,5,10442,4.114263199369582,80.0,20.0
42538,4,2538,[222  70 496 273 132],417,2,10444,4.113430484442694,0.0,0.0
42539,4,2539,[ 64 313 483 318  11],618,5,10449,4.113779527559055,80.0,20.0
42540,4,2540,[282 174 111 238  11],342,2,10451,4.112947658402204,0.0,0.0
42541,4,2541,[176 185 121 100   7],618,5,10456,4.113296616837136,0.0,0.0
42542,4,2542,[678  15 172 258 210],416,4,10460,4.113252064490759,0.0,0.0
42543,4,2543,[ 56 258 245 748 168],416,4,10464,4.113207547169812,0.0,0.0
42544,4,2544,[ 64 313 483 318  11],214,5,10469,4.113555992141454,80.0,20.0
42545,4,2545,[588  50 385 175  97],405,1,10470,4.112333071484682,0.0,20.0
42546,4,2546,[191 318 118  12 597],618,4,10474,4.112288967412642,40.0,0.0
42547,4,2547,[385 179 187   8 475],416,3,10477,4.111852433281005,0.0,0.0
42548,4,2548,[ 64 313 483 318  11],618,5,10482,4.1122008630835625,80.0,20.0
42549,4,2549,[ 64 313 483 318  11],214,5,10487,4.112549019607843,80.0,20.0
42550,4,2550,[ 64 313 483 318  11],214,5,10492,4.112896903175225,80.0,20.0
42551,4,2551,[603 172 238 204 151],128,3,10495,4.112460815047022,0.0,0.0
42552,4,2552,[  7 174 568 238 117],416,5,10500,4.112808460634548,0.0,0.0
42553,4,2553,[183 748 313 245 185],416,4,10504,4.1127642913077525,20.0,20.0
42554,4,2554,[588  70 215 197  50],618,3,10507,4.112328767123287,0.0,20.0
42555,4,2555,[ 64 313 483 318  11],618,5,10512,4.112676056338028,80.0,20.0
42556,4,2556,[ 64 313 483 318  11],618,5,10517,4.113023073914744,80.0,20.0
42557,4,2557,[186 176 183 143 118],601,2,10519,4.1121970289288505,0.0,0.0
42558,4,2558,[ 22 427 286 143 202],711,5,10524,4.112543962485346,0.0,0.0
42559,4,2559,[ 64 313 483 318  11],618,5,10529,4.112890625,80.0,20.0
42560,4,2560,[603 168 294 588   1],297,3,10532,4.1124560718469345,0.0,0.0
42561,4,2561,[258  70  89 288 172],642,1,10533,4.111241217798595,0.0,20.0
42562,4,2562,[ 56 197  69 175 471],854,4,10537,4.111197815060476,0.0,0.0
42563,4,2563,[191 275 215 403 196],416,5,10542,4.111544461778471,0.0,0.0
42564,4,2564,[496 179 173 385 597],417,3,10545,4.111111111111111,0.0,0.0
42565,4,2565,[ 64 313 483 318  11],618,5,10550,4.111457521434139,80.0,20.0
42566,4,2566,[ 64 313 483 318  11],618,5,10555,4.111803661862096,80.0,20.0
42567,4,2567,[237 313 427  28 182],618,5,10560,4.11214953271028,20.0,20.0
42568,4,2568,[748 144 111 258   8],416,5,10565,4.112495134293499,0.0,0.0
42569,4,2569,[403 302 258 655  69],62,3,10568,4.112062256809338,0.0,0.0
42570,4,2570,[ 79  50  82  96 181],705,5,10573,4.112407623492804,0.0,40.0
42571,4,2571,[ 64 313 483 318  11],618,5,10578,4.112752721617419,80.0,20.0
42572,4,2572,[173 268  88  56 181],496,4,10582,4.112708900116595,0.0,20.0
42573,4,2573,[228 204  88 180 423],711,2,10584,4.111888111888112,0.0,0.0
42574,4,2574,[294 678 200 222  88],805,3,10587,4.111456310679611,0.0,0.0
42575,4,2575,[ 64 313 483 318  11],214,5,10592,4.111801242236025,80.0,20.0
42576,4,2576,[ 64 313 483 318  11],214,5,10597,4.112145906092356,80.0,20.0
42577,4,2577,[323 238  95 182  11],416,3,10600,4.1117145073700545,0.0,0.0
42578,4,2578,[211 173 118 195 194],297,2,10602,4.110895696006204,0.0,0.0
42579,4,2579,[238 423 496  70 405],230,4,10606,4.110852713178295,0.0,0.0
42580,4,2580,[568 185 176 427  22],230,4,10610,4.110809763657497,0.0,0.0
42581,4,2581,[322 238 597   9 588],805,1,10611,4.109604957397367,0.0,0.0
42582,4,2582,[  8 515 180 257 268],354,2,10613,4.10878823073945,0.0,0.0
42583,4,2583,[228  89  50 235 143],805,2,10615,4.1079721362229105,0.0,20.0
42584,4,2584,[211 301  22  70 183],416,5,10620,4.108317214700193,0.0,0.0
42585,4,2585,[ 64 313 483 318  11],214,5,10625,4.108662026295437,80.0,20.0
42586,4,2586,[265 185 228 151  89],297,2,10627,4.107846926942404,0.0,0.0
42587,4,2587,[181  82  88 288 161],416,4,10631,4.107805255023184,0.0,40.0
42588,4,2588,[ 79 174 197 118 385],805,2,10633,4.106991116261105,0.0,0.0
42589,4,2589,[181 215  69 333 385],416,5,10638,4.107335907335908,0.0,20.0
42590,4,2590,[ 64 313 483 318  11],214,5,10643,4.107680432265535,80.0,20.0
42591,4,2591,[173 328 546 191  64],62,4,10647,4.107638888888889,20.0,0.0
42592,4,2592,[ 64 313 483 318  11],214,5,10652,4.107983031237948,80.0,20.0
42593,4,2593,[210  98 603 235 568],805,2,10654,4.107170393215112,0.0,20.0
42594,4,2594,[ 64 313 483 318  11],214,5,10659,4.107514450867052,80.0,20.0
42595,4,2595,[196 271  82 235 118],62,3,10662,4.1070878274268106,0.0,0.0
42596,4,2596,[132  22 258 200 405],887,3,10665,4.106661532537544,0.0,0.0
42597,4,2597,[269  50 173  82 197],751,4,10669,4.106620477290223,0.0,20.0
42598,4,2598,[403  22 235 216   4],416,4,10673,4.106579453636014,0.0,0.0
42599,4,2599,[ 64 313 483 318  11],618,5,10678,4.106923076923077,80.0,20.0
42600,4,2600,[ 64 313 483 318  11],214,5,10683,4.107266435986159,80.0,20.0
42601,4,2601,[ 64 313 483 318  11],618,5,10688,4.1076095311299,80.0,20.0
42602,4,2602,[  9 187  88 483 471],618,3,10691,4.107184018440261,20.0,0.0
42603,4,2603,[271  56 588  70 153],43,4,10695,4.107142857142857,0.0,0.0
42604,4,2604,[ 64 313 483 318  11],618,5,10700,4.107485604606526,80.0,20.0
42605,4,2605,[200 176 161 117   7],805,3,10703,4.107060629316961,0.0,0.0
42606,4,2606,[ 64 313 483 318  11],214,5,10708,4.107403145377829,80.0,20.0
42607,4,2607,[ 69   8 427 588 216],711,4,10712,4.107361963190184,0.0,0.0
42608,4,2608,[ 82  97 174 144  70],654,4,10716,4.107320812571866,0.0,0.0
42609,4,2609,[ 64 313 483 318  11],618,5,10721,4.107662835249042,80.0,20.0
42610,4,2610,[195 127 286   7 151],417,4,10725,4.107621600919188,0.0,0.0
42611,4,2611,[144  56  15 125 121],854,1,10726,4.106431852986217,0.0,0.0
42612,4,2612,[168 195   7 173 151],618,2,10728,4.105625717566016,0.0,0.0
42613,4,2613,[ 64 313 483 318  11],214,5,10733,4.1059678653404745,80.0,20.0
42614,4,2614,[271  88 222 180 322],805,1,10734,4.104780114722753,0.0,0.0
42615,4,2615,[143 191 655 237 100],416,4,10738,4.1047400611620795,0.0,0.0
42616,4,2616,[ 64 313 483 318  11],214,5,10743,4.105082155139472,80.0,20.0
42617,4,2617,[  1 471  28  82 282],128,4,10747,4.105042016806722,0.0,0.0
42618,4,2618,[ 64 313 483 318  11],214,5,10752,4.105383734249713,80.0,20.0
42619,4,2619,[195 183  70  88  64],405,2,10754,4.104580152671756,20.0,0.0
42620,4,2620,[ 64 313 483 318  11],618,5,10759,4.104921785578024,80.0,20.0
42621,4,2621,[405 546 300 423  28],223,2,10761,4.104118993135011,0.0,0.0
42622,4,2622,[ 64 313 483 318  11],618,5,10766,4.104460541364849,80.0,20.0
42623,4,2623,[ 12 174  88  71 423],437,3,10769,4.104039634146342,20.0,0.0
42624,4,2624,[ 64 313 483 318  11],618,5,10774,4.104380952380953,80.0,20.0
42625,4,2625,[ 64 313 483 318  11],618,5,10779,4.104722010662605,80.0,20.0
42626,4,2626,[ 64 313 483 318  11],214,5,10784,4.105062809288161,80.0,20.0
42627,4,2627,[ 64 313 483 318  11],618,5,10789,4.1054033485540335,80.0,20.0
42628,4,2628,[211  70 588 135 100],297,5,10794,4.105743628756181,0.0,0.0
42629,4,2629,[ 28 286 215   7 143],297,4,10798,4.105703422053232,0.0,0.0
42630,4,2630,[ 64 313 483 318  11],618,5,10803,4.106043329532497,80.0,20.0
42631,4,2631,[357 228 197  50  89],373,4,10807,4.106003039513678,0.0,20.0
42632,4,2632,[183 427   8 423  64],230,4,10811,4.105962780098746,20.0,0.0
42633,4,2633,[ 82 568 151  64   8],618,3,10814,4.105542900531511,20.0,0.0
42634,4,2634,[ 64 313 483 318  11],618,5,10819,4.105882352941176,80.0,20.0
42635,4,2635,[ 64 313 483 318  11],214,5,10824,4.106221547799697,80.0,20.0
42636,4,2636,[ 64 313 483 318  11],618,5,10829,4.106560485400076,80.0,20.0
42637,4,2637,[ 64 313 483 318  11],214,5,10834,4.106899166034875,80.0,20.0
42638,4,2638,[ 64 313 483 318  11],214,5,10839,4.107237589996211,80.0,20.0
42639,4,2639,[ 64 313 483 318  11],618,5,10844,4.107575757575757,80.0,20.0
42640,4,2640,[471 210 588 258 403],416,5,10849,4.107913669064748,0.0,0.0
42641,4,2641,[ 64 313 483 318  11],618,5,10854,4.108251324753974,80.0,20.0
42642,4,2642,[ 64 313 483 318  11],214,5,10859,4.108588724933788,80.0,20.0
42643,4,2643,[ 64 313 483 318  11],214,5,10864,4.1089258698941,80.0,20.0
42644,4,2644,[ 64 313 483 318  11],618,5,10869,4.109262759924386,80.0,20.0
42645,4,2645,[ 64 313 483 318  11],214,5,10874,4.109599395313681,80.0,20.0
42646,4,2646,[194  95  64 403   9],416,4,10878,4.109557990177559,20.0,0.0
42647,4,2647,[237 257 328 288 385],416,3,10881,4.109138972809668,0.0,20.0
42648,4,2648,[286 195   8 144 257],854,1,10882,4.107965269913175,0.0,0.0
42649,4,2649,[ 64 313 483 318  11],618,5,10887,4.108301886792453,80.0,20.0
42650,4,2650,[ 64 313 483 318  11],618,5,10892,4.108638249717088,80.0,20.0
42651,4,2651,[ 64 313 483 318  11],618,5,10897,4.108974358974359,80.0,20.0
42652,4,2652,[ 64 313 483 318  11],214,5,10902,4.109310214851112,80.0,20.0
42653,4,2653,[ 64 313 483 318  11],214,5,10907,4.10964581763376,80.0,20.0
42654,4,2654,[ 64 313 483 318  11],214,5,10912,4.109981167608287,80.0,20.0
42655,4,2655,[ 64 313 483 318  11],214,5,10917,4.110316265060241,80.0,20.0
42656,4,2656,[186 275 268 118 588],588,3,10920,4.109898381633421,0.0,0.0
42657,4,2657,[273 180 181  98  89],417,3,10923,4.109480812641084,0.0,40.0
42658,4,2658,[ 64 313 483 318  11],214,5,10928,4.109815720195562,80.0,20.0
42659,4,2659,[ 64 313 483 318  11],618,5,10933,4.11015037593985,80.0,20.0
42660,4,2660,[ 69 742 423 182 202],128,3,10936,4.109733183013905,0.0,0.0
42661,4,2661,[ 64 313 483 318  11],618,5,10941,4.1100676183320815,80.0,20.0
42662,4,2662,[742 144 588 151 181],654,4,10945,4.110026286143447,0.0,20.0
42663,4,2663,[ 64 313 483 318  11],618,5,10950,4.11036036036036,80.0,20.0
42664,4,2664,[ 64 313 483 318  11],618,5,10955,4.110694183864916,80.0,20.0
42665,4,2665,[ 64 313 483 318  11],214,5,10960,4.111027756939235,80.0,20.0
42666,4,2666,[ 64 313 483 318  11],618,5,10965,4.111361079865017,80.0,20.0
42667,4,2667,[ 64 313 483 318  11],214,5,10970,4.111694152923538,80.0,20.0
42668,4,2668,[202  79 313 191 144],711,4,10974,4.111652304233796,20.0,20.0
42669,4,2669,[ 64 313 483 318  11],618,5,10979,4.111985018726592,80.0,20.0
42670,4,2670,[ 64 313 483 318  11],618,5,10984,4.112317484088356,80.0,20.0
42671,4,2671,[ 64 313 483 318  11],214,5,10989,4.112649700598802,80.0,20.0
42672,4,2672,[174 237 151  96 282],618,2,10991,4.111859334081556,0.0,0.0
42673,4,2673,[318   8 180  22 655],405,4,10995,4.111817501869858,20.0,0.0
42674,4,2674,[ 64 313 483 318  11],214,5,11000,4.11214953271028,80.0,20.0
42675,4,2675,[ 12 186  97  25 182],618,4,11004,4.112107623318385,20.0,0.0
42676,4,2676,[ 64 313 483 318  11],214,5,11009,4.1124392977213295,80.0,20.0
42677,4,2677,[ 64 313 483 318  11],214,5,11014,4.1127707244212095,80.0,20.0
42678,4,2678,[ 64 313 483 318  11],618,5,11019,4.113101903695409,80.0,20.0
42679,4,2679,[135 237 289 191 222],721,1,11020,4.111940298507463,0.0,0.0
42680,4,2680,[ 64 313 483 318  11],214,5,11025,4.1122715404699735,80.0,20.0
42681,4,2681,[328  88 151  50 132],373,4,11029,4.112229679343773,0.0,20.0
42682,4,2682,[143 269 268 286 168],416,5,11034,4.112560566530004,0.0,0.0
42683,4,2683,[ 64 313 483 318  11],214,5,11039,4.112891207153503,80.0,20.0
42684,4,2684,[ 64 313 483 318  11],618,5,11044,4.113221601489758,80.0,20.0
42685,4,2685,[ 64 313 483 318  11],618,5,11049,4.113551749813849,80.0,20.0
42686,4,2686,[ 64 313 483 318  11],618,5,11054,4.113881652400447,80.0,20.0
42687,4,2687,[185 125 204 117 471],416,5,11059,4.114211309523809,0.0,0.0
42688,4,2688,[ 15 471  89 294 423],854,2,11061,4.113425065079955,0.0,0.0
42689,4,2689,[ 71 403 265 546 211],416,4,11065,4.113382899628252,0.0,0.0
42690,4,2690,[143 179 174 237 183],437,4,11069,4.113340765514678,0.0,0.0
42691,4,2691,[ 22 237 172  15  56],721,3,11072,4.112927191679049,0.0,0.0
42692,4,2692,[ 56 111  22 179 182],62,4,11076,4.112885258076495,0.0,0.0
42693,4,2693,[294 187  69 143 235],887,4,11080,4.112843355605048,0.0,0.0
42694,4,2694,[  1 258 111  71 603],416,5,11085,4.11317254174397,0.0,0.0
42695,4,2695,[132 483 127 286   4],854,3,11088,4.112759643916914,20.0,0.0
42696,4,2696,[ 64 313 483 318  11],618,5,11093,4.113088616981831,80.0,20.0
42697,4,2697,[ 64 313 483 318  11],214,5,11098,4.1134173461823575,80.0,20.0
42698,4,2698,[234 118   9  64 496],416,4,11102,4.113375324194146,20.0,0.0
42699,4,2699,[273  56 405 200 515],417,3,11105,4.112962962962963,0.0,0.0
42700,4,2700,[268 294 174  70  56],49,1,11106,4.111810440577564,0.0,0.0
42701,4,2701,[172 111 597 211  28],43,4,11110,4.111769059955589,0.0,0.0
42702,4,2702,[ 64 313 483 318  11],214,5,11115,4.112097669256382,80.0,20.0
42703,4,2703,[ 56 357 237  82 276],198,2,11117,4.111316568047338,0.0,0.0
42704,4,2704,[ 64 313 483 318  11],214,5,11122,4.111645101663586,80.0,20.0
42705,4,2705,[ 64 313 483 318  11],214,5,11127,4.111973392461198,80.0,20.0
42706,4,2706,[216  50 475  11 471],854,3,11130,4.111562615441448,0.0,20.0
42707,4,2707,[ 71 196  79 161 135],198,1,11131,4.110413589364845,0.0,0.0
42708,4,2708,[ 64 313 483 318  11],618,5,11136,4.110741971207087,80.0,20.0
42709,4,2709,[ 64 313 483 318  11],618,5,11141,4.111070110701107,80.0,20.0
42710,4,2710,[ 64 313 483 318  11],214,5,11146,4.111398008115087,80.0,20.0
42711,4,2711,[ 64 313 483 318  11],618,5,11151,4.111725663716814,80.0,20.0
42712,4,2712,[181 222 276 748 294],708,3,11154,4.111315886472539,0.0,20.0
42713,4,2713,[289 216 151 265 172],416,3,11157,4.110906411201179,0.0,0.0
42714,4,2714,[ 96 195 185 357   8],416,5,11162,4.111233885819521,0.0,0.0
42715,4,2715,[ 64 313 483 318  11],618,5,11167,4.111561119293078,80.0,20.0
42716,4,2716,[ 64 313 483 318  11],214,5,11172,4.111888111888112,80.0,20.0
42717,4,2717,[ 64 313 483 318  11],214,5,11177,4.112214863870493,80.0,20.0
42718,4,2718,[289 143  64  82  69],416,4,11181,4.112173593232806,20.0,0.0
42719,4,2719,[ 64 313 483 318  11],618,5,11186,4.1125,80.0,20.0
42720,4,2720,[ 64 313 483 318  11],214,5,11191,4.1128261668504225,80.0,20.0
42721,4,2721,[ 64 313 483 318  11],214,5,11196,4.113152094048494,80.0,20.0
42722,4,2722,[ 64 313 483 318  11],618,5,11201,4.113477781858244,80.0,20.0
42723,4,2723,[  7 183 216 176 121],417,2,11203,4.1127019089574155,0.0,0.0
42724,4,2724,[ 64 313 483 318  11],214,5,11208,4.11302752293578,80.0,20.0
42725,4,2725,[ 64 313 483 318  11],618,5,11213,4.113352898019076,80.0,20.0
42726,4,2726,[ 64 313 483 318  11],618,5,11218,4.113678034470114,80.0,20.0
42727,4,2727,[301 196  96 174  12],416,5,11223,4.11400293255132,20.0,0.0
42728,4,2728,[175   8 216 471 322],721,5,11228,4.1143275925247345,0.0,0.0
42729,4,2729,[ 64 313 483 318  11],618,5,11233,4.114652014652014,80.0,20.0
42730,4,2730,[ 64 313 483 318  11],214,5,11238,4.114976199194435,80.0,20.0
42731,4,2731,[ 64 313 483 318  11],214,5,11243,4.115300146412884,80.0,20.0
42732,4,2732,[174 144 294 357  25],805,2,11245,4.114526161727039,0.0,0.0
42733,4,2733,[ 64 313 483 318  11],214,5,11250,4.114850036576445,80.0,20.0
42734,4,2734,[195 385 215  11 323],198,2,11252,4.114076782449726,0.0,0.0
42735,4,2735,[333  28 111 183 174],416,5,11257,4.114400584795321,0.0,0.0
42736,4,2736,[ 64 313 483 318  11],214,5,11262,4.114724150529777,80.0,20.0
42737,4,2737,[  1  22 288 144 216],805,1,11263,4.113586559532505,0.0,20.0
42738,4,2738,[328 286  88 210 238],416,4,11267,4.113545089448704,0.0,0.0
42739,4,2739,[210   7 301   8  95],43,5,11272,4.113868613138687,0.0,0.0
42740,4,2740,[ 64 313 483 318  11],618,5,11277,4.114191900766143,80.0,20.0
42741,4,2741,[ 64 313 483 318  11],214,5,11282,4.114514952589351,80.0,20.0
42742,4,2742,[423 269 168  82 475],805,3,11285,4.114108640174991,0.0,0.0
42743,4,2743,[ 64 313 483 318  11],214,5,11290,4.114431486880466,80.0,20.0
42744,4,2744,[161 191 144 132  11],618,5,11295,4.114754098360656,0.0,0.0
42745,4,2745,[ 64 313 483 318  11],214,5,11300,4.1150764748725415,80.0,20.0
42746,4,2746,[185  12  82 302 111],49,3,11303,4.1146705496905716,20.0,0.0
42747,4,2747,[100  95 603 568 172],416,4,11307,4.114628820960698,0.0,0.0
42748,4,2748,[515 333 471 211 258],416,5,11312,4.114950891233176,0.0,0.0
42749,4,2749,[ 64 313 483 318  11],618,5,11317,4.115272727272727,80.0,20.0
42750,4,2750,[475  64 210 323 286],417,3,11320,4.1148673209741915,20.0,0.0
42751,4,2751,[111 176  96  22 143],416,5,11325,4.115188953488372,0.0,0.0
42752,4,2752,[ 64 313 483 318  11],214,5,11330,4.115510352342898,80.0,20.0
42753,4,2753,[194 318  71  89 168],373,5,11335,4.115831517792302,20.0,0.0
42754,4,2754,[ 64 313 483 318  11],618,5,11340,4.116152450090744,80.0,20.0
42755,4,2755,[ 64 313 483 318  11],618,5,11345,4.116473149492017,80.0,20.0
42756,4,2756,[313  79 204 588 125],505,2,11347,4.115705476967719,20.0,20.0
42757,4,2757,[ 64 313 483 318  11],214,5,11352,4.1160261058738215,80.0,20.0
42758,4,2758,[ 64 313 483 318  11],214,5,11357,4.116346502355926,80.0,20.0
42759,4,2759,[ 64 313 483 318  11],618,5,11362,4.116666666666666,80.0,20.0
42760,4,2760,[ 64 313 483 318  11],214,5,11367,4.116986599058312,80.0,20.0
42761,4,2761,[ 64 313 483 318  11],214,5,11372,4.117306299782766,80.0,20.0
42762,4,2762,[ 98 300  69  96 282],12,5,11377,4.117625769091567,0.0,20.0
42763,4,2763,[182 210 202 127 197],618,2,11379,4.11685962373372,0.0,0.0
42764,4,2764,[ 88  98 294 234 196],416,4,11383,4.116817359855334,0.0,20.0
42765,4,2765,[257 135 174 127 483],417,2,11385,4.116052060737527,20.0,0.0
42766,4,2766,[ 64 313 483 318  11],618,5,11390,4.116371521503433,80.0,20.0
42767,4,2767,[294 678 215 588 403],345,1,11391,4.115245664739884,0.0,0.0
42768,4,2768,[ 64 313 483 318  11],214,5,11396,4.115565185987721,80.0,20.0
42769,4,2769,[ 64 313 483 318  11],618,5,11401,4.115884476534296,80.0,20.0
42770,4,2770,[ 64 313 483 318  11],618,5,11406,4.116203536629376,80.0,20.0
42771,4,2771,[ 64 313 483 318  11],214,5,11411,4.116522366522367,80.0,20.0
42772,4,2772,[132 210 194 471  97],921,1,11412,4.115398485394879,0.0,0.0
42773,4,2773,[210 174 211 183 288],405,3,11415,4.114996395097332,0.0,20.0
42774,4,2774,[ 64 313 483 318  11],214,5,11420,4.115315315315315,80.0,20.0
42775,4,2775,[245  97 276  50 273],62,3,11423,4.114913544668588,0.0,20.0
42776,4,2776,[181  88 127 151  95],805,1,11424,4.113791861721282,0.0,20.0
42777,4,2777,[318 117 238 187 313],618,4,11428,4.1137508999280055,40.0,20.0
42778,4,2778,[ 64 313 483 318  11],618,5,11433,4.114069809283915,80.0,20.0
42779,4,2779,[ 64 313 483 318  11],618,5,11438,4.1143884892086335,80.0,20.0
42780,4,2780,[ 64 313 483 318  11],618,5,11443,4.1147069399496585,80.0,20.0
42781,4,2781,[168  69 258 597 151],62,4,11447,4.114665708123652,0.0,0.0
42782,4,2782,[197 228  50 603  97],373,3,11450,4.114265181458857,0.0,20.0
42783,4,2783,[ 70 111   8 496 118],416,4,11454,4.114224137931035,0.0,0.0
42784,4,2784,[135 194 176 742 202],297,2,11456,4.113464991023339,0.0,0.0
42785,4,2785,[ 64 313 483 318  11],618,5,11461,4.1137832017229,80.0,20.0
42786,4,2786,[ 64 313 483 318  11],214,5,11466,4.1141011840688915,80.0,20.0
42787,4,2787,[515 235 471  70  98],297,3,11469,4.113701578192252,0.0,20.0
42788,4,2788,[ 64 313 483 318  11],214,5,11474,4.114019361778415,80.0,20.0
42789,4,2789,[185 234  50 210  88],618,4,11478,4.113978494623656,0.0,20.0
42790,4,2790,[  8 161 275 211  89],437,3,11481,4.1135793622357575,0.0,0.0
42791,4,2791,[ 64 313 483 318  11],618,5,11486,4.113896848137536,80.0,20.0
42792,4,2792,[ 64 313 483 318  11],214,5,11491,4.11421410669531,80.0,20.0
42793,4,2793,[427 181 197 238   4],198,4,11495,4.1141732283464565,0.0,20.0
42794,4,2794,[181 187 403 471 200],416,5,11500,4.114490161001789,0.0,20.0
42795,4,2795,[ 64 313 483 318  11],618,5,11505,4.114806866952789,80.0,20.0
42796,4,2796,[ 64 313 483 318  11],618,5,11510,4.115123346442617,80.0,20.0
42797,4,2797,[173 132 475 100  82],437,3,11513,4.114724803431022,0.0,0.0
42798,4,2798,[ 64 313 483 318  11],618,5,11518,4.115041086102179,80.0,20.0
42799,4,2799,[ 64 313 483 318  11],214,5,11523,4.1153571428571425,80.0,20.0
42800,4,2800,[210 568 111 269 143],805,1,11524,4.114244912531239,0.0,0.0
42801,4,2801,[179 216 215 196 515],416,4,11528,4.114204139900071,0.0,0.0
42802,4,2802,[144 179 475 288 238],62,3,11531,4.113806635747413,0.0,20.0
42803,4,2803,[135  28 568 257 216],642,3,11534,4.1134094151212555,0.0,0.0
42804,4,2804,[568  97 742 258 125],62,2,11536,4.112655971479501,0.0,0.0
42805,4,2805,[ 64 313 483 318  11],618,5,11541,4.112972202423379,80.0,20.0
42806,4,2806,[ 64 313 483 318  11],214,5,11546,4.1132882080513005,80.0,20.0
42807,4,2807,[ 64 313 483 318  11],214,5,11551,4.113603988603988,80.0,20.0
42808,4,2808,[ 64 313 483 318  11],214,5,11556,4.113919544321822,80.0,20.0
42809,4,2809,[153 174 294 238 603],416,5,11561,4.11423487544484,0.0,0.0
42810,4,2810,[118 222 322  82 357],805,2,11563,4.113482746353611,0.0,0.0
42811,4,2811,[  9 172 100  25 273],618,3,11566,4.113086770981508,0.0,0.0
42812,4,2812,[ 64 313 483 318  11],214,5,11571,4.11340206185567,80.0,20.0
42813,4,2813,[276 132 204   8 196],437,5,11576,4.113717128642501,0.0,0.0
42814,4,2814,[ 64 313 483 318  11],214,5,11581,4.114031971580817,80.0,20.0
42815,4,2815,[ 64 313 483 318  11],618,5,11586,4.114346590909091,80.0,20.0
42816,4,2816,[ 64 313 483 318  11],618,5,11591,4.114660986865459,80.0,20.0
42817,4,2817,[ 64 313 483 318  11],618,5,11596,4.114975159687722,80.0,20.0
42818,4,2818,[191 179 143 588 180],437,4,11600,4.114934373891451,0.0,0.0
42819,4,2819,[ 88   9 121 313 172],416,4,11604,4.114893617021276,20.0,20.0
42820,4,2820,[ 64 313 483 318  11],214,5,11609,4.11520737327189,80.0,20.0
42821,4,2821,[ 64 313 483 318  11],618,5,11614,4.115520907158044,80.0,20.0
42822,4,2822,[742 237 322  98 153],854,2,11616,4.114771519659937,0.0,20.0
42823,4,2823,[228  28   1 471 286],721,5,11621,4.115084985835694,0.0,0.0
42824,4,2824,[ 64 313 483 318  11],618,5,11626,4.115398230088496,80.0,20.0
42825,4,2825,[182  22   8  15 403],416,5,11631,4.115711252653928,0.0,0.0
42826,4,2826,[186 111 234  97 215],588,3,11634,4.1153165900247615,0.0,0.0
42827,4,2827,[588 222   9 111 597],887,3,11637,4.114922206506365,0.0,0.0
42828,4,2828,[197  95 357 121  71],805,2,11639,4.11417462000707,0.0,0.0
42829,4,2829,[202 144  97 546 275],416,4,11643,4.114134275618374,0.0,0.0
42830,4,2830,[183  96  95  25 132],416,4,11647,4.114093959731544,0.0,0.0
42831,4,2831,[ 64 313 483 318  11],618,5,11652,4.114406779661017,80.0,20.0
42832,4,2832,[ 64 313 483 318  11],618,5,11657,4.114719378750441,80.0,20.0
42833,4,2833,[288 121 273  25 275],618,2,11659,4.113973182780522,0.0,20.0
42834,4,2834,[ 64 313 483 318  11],214,5,11664,4.114285714285714,80.0,20.0
42835,4,2835,[210 161  70 118  71],416,4,11668,4.114245416078984,0.0,0.0
42836,4,2836,[ 64 313 483 318  11],618,5,11673,4.11455763130067,80.0,20.0
42837,4,2837,[ 64 313 483 318  11],214,5,11678,4.1148696264975335,80.0,20.0
42838,4,2838,[ 64 313 483 318  11],618,5,11683,4.1151814019020785,80.0,20.0
42839,4,2839,[405  97 357 176 222],62,3,11686,4.114788732394366,0.0,0.0
42840,4,2840,[ 64 313 483 318  11],214,5,11691,4.115100316789863,80.0,20.0
42841,4,2841,[174 179  89 117 200],805,3,11694,4.114707952146376,0.0,0.0
42842,4,2842,[ 64 313 483 318  11],214,5,11699,4.115019345761519,80.0,20.0
42843,4,2843,[ 64 313 483 318  11],214,5,11704,4.115330520393812,80.0,20.0
42844,4,2844,[151 588  69 191 265],437,2,11706,4.114586994727592,0.0,0.0
42845,4,2845,[183 258 276   1 161],198,3,11709,4.114195361911455,0.0,0.0
42846,4,2846,[265  12 144 257 271],297,1,11710,4.113101510361784,20.0,0.0
42847,4,2847,[ 64 313 483 318  11],618,5,11715,4.113412921348314,80.0,20.0
42848,4,2848,[318 471 300 258 323],43,3,11718,4.113022113022113,20.0,0.0
42849,4,2849,[ 64 313 483 318  11],214,5,11723,4.113333333333333,80.0,20.0
42850,4,2850,[268 135  12 245 323],417,3,11726,4.112942827078218,20.0,0.0
42851,4,2851,[181 215  98 257  88],711,3,11729,4.112552594670407,0.0,40.0
42852,4,2852,[ 64 313 483 318  11],618,5,11734,4.112863652295829,80.0,20.0
42853,4,2853,[257 678  97  98 300],654,4,11738,4.112824106517169,0.0,20.0
42854,4,2854,[216 191 144 282 271],854,2,11740,4.112084063047285,0.0,0.0
42855,4,2855,[ 56 127   4  28  79],416,5,11745,4.112394957983193,0.0,0.0
42856,4,2856,[ 64 313 483 318  11],618,5,11750,4.112705635281764,80.0,20.0
42857,4,2857,[215 216 181 200  79],437,4,11754,4.112666200139958,0.0,20.0
42858,4,2858,[132 204  79  70 313],416,5,11759,4.112976565232599,20.0,20.0
42859,4,2859,[237 168 182 183 191],416,4,11763,4.112937062937063,0.0,0.0
42860,4,2860,[ 64 313 483 318  11],214,5,11768,4.11324711639287,80.0,20.0
42861,4,2861,[ 64 313 483 318  11],214,5,11773,4.113556953179595,80.0,20.0
42862,4,2862,[ 64 313 483 318  11],618,5,11778,4.113866573524275,80.0,20.0
42863,4,2863,[210 302 234 215 603],297,3,11781,4.113477653631285,0.0,0.0
42864,4,2864,[161 300 211 151 257],43,5,11786,4.113787085514835,0.0,0.0
42865,4,2865,[204 144 132 143  95],698,1,11787,4.112700628053036,0.0,0.0
42866,4,2866,[ 64 313 483 318  11],214,5,11792,4.113010115102895,80.0,20.0
42867,4,2867,[175 183 515 168 216],405,0,11792,4.111576011157601,0.0,0.0
42868,4,2868,[143 173 185 125 200],618,3,11795,4.111188567445103,0.0,0.0
42869,4,2869,[ 64 313 483 318  11],214,5,11800,4.111498257839721,80.0,20.0
42870,4,2870,[403  82 328  88 286],373,2,11802,4.110762800417973,0.0,0.0
42871,4,2871,[ 64 313 483 318  11],618,5,11807,4.111072423398329,80.0,20.0
42872,4,2872,[ 64 313 483 318  11],214,5,11812,4.111381830838845,80.0,20.0
42873,4,2873,[176 191 323 427 215],198,4,11816,4.111343075852471,0.0,0.0
42874,4,2874,[  7 182 183 405  69],416,5,11821,4.111652173913043,0.0,0.0
42875,4,2875,[117 143 174  70 215],128,2,11823,4.1109179415855355,0.0,0.0
42876,4,2876,[ 64 313 483 318  11],214,5,11828,4.111226972540841,80.0,20.0
42877,4,2877,[ 64 313 483 318  11],618,5,11833,4.111535788742182,80.0,20.0
42878,4,2878,[294   1   4 183 211],417,4,11837,4.111497047585967,0.0,0.0
42879,4,2879,[187 282 118 117 127],416,4,11841,4.111458333333333,0.0,0.0
42880,4,2880,[ 64 313 483 318  11],214,5,11846,4.111766747657064,80.0,20.0
42881,4,2881,[  4 568  96   1 125],416,5,11851,4.11207494795281,0.0,0.0
42882,4,2882,[ 64 313 483 318  11],618,5,11856,4.112382934443288,80.0,20.0
42883,4,2883,[ 64 313 483 318  11],618,5,11861,4.112690707350901,80.0,20.0
42884,4,2884,[ 64 313 483 318  11],214,5,11866,4.112998266897747,80.0,20.0
42885,4,2885,[204  28 196 238 405],230,4,11870,4.112959112959113,0.0,0.0
42886,4,2886,[ 70 187  64 216   7],416,5,11875,4.113266366470384,20.0,0.0
42887,4,2887,[144 215 210 385 276],618,3,11878,4.112880886426593,0.0,0.0
42888,4,2888,[333 275 302 204 151],52,5,11883,4.11318795430945,0.0,0.0
42889,4,2889,[127 318 200 475   9],416,4,11887,4.113148788927336,20.0,0.0
42890,4,2890,[100 168 202 161  82],230,5,11892,4.11345555171221,0.0,0.0
42891,4,2891,[181 228 196 186 483],711,3,11895,4.113070539419087,20.0,20.0
42892,4,2892,[275 200  11 318  70],618,3,11898,4.112685793294158,20.0,0.0
42893,4,2893,[ 64 313 483 318  11],618,5,11903,4.112992398064962,80.0,20.0
42894,4,2894,[588   4  64 125  95],253,4,11907,4.112953367875647,20.0,0.0
42895,4,2895,[ 64 313 483 318  11],618,5,11912,4.113259668508287,80.0,20.0
42896,4,2896,[ 64 313 483 318  11],618,5,11917,4.113565757680359,80.0,20.0
42897,4,2897,[ 64 313 483 318  11],618,5,11922,4.113871635610766,80.0,20.0
42898,4,2898,[ 64 313 483 318  11],214,5,11927,4.11417730251811,80.0,20.0
42899,4,2899,[ 64 313 483 318  11],618,5,11932,4.11448275862069,80.0,20.0
42900,4,2900,[ 64 313 483 318  11],618,5,11937,4.114788004136504,80.0,20.0
42901,4,2901,[ 64 313 483 318  11],214,5,11942,4.115093039283253,80.0,20.0
42902,4,2902,[ 64 313 483 318  11],214,5,11947,4.115397864278333,80.0,20.0
42903,4,2903,[ 64 313 483 318  11],214,5,11952,4.115702479338843,80.0,20.0
42904,4,2904,[111 100 471 603 276],416,4,11956,4.11566265060241,0.0,0.0
42905,4,2905,[ 64 313 483 318  11],214,5,11961,4.115966964900206,80.0,20.0
42906,4,2906,[ 64 313 483 318  11],214,5,11966,4.116271069831441,80.0,20.0
42907,4,2907,[ 64 313 483 318  11],618,5,11971,4.116574965612105,80.0,20.0
42908,4,2908,[748 181 195 405 588],417,2,11973,4.11584737023032,0.0,20.0
42909,4,2909,[ 64 313 483 318  11],618,5,11978,4.1161512027491405,80.0,20.0
42910,4,2910,[ 64 313 483 318  11],618,5,11983,4.116454826520096,80.0,20.0
42911,4,2911,[202 471 118  88 172],416,3,11986,4.116071428571429,0.0,0.0
42912,4,2912,[ 50 176 181 238   7],805,4,11990,4.116031582560934,0.0,40.0
42913,4,2913,[273 288 496 405 546],417,0,11990,4.11461908030199,0.0,20.0
42914,4,2914,[ 64 313 483 318  11],214,5,11995,4.114922813036021,80.0,20.0
42915,4,2915,[286  11 204  12 496],416,5,12000,4.11522633744856,20.0,0.0
42916,4,2916,[ 11 216 176  89 202],405,2,12002,4.114501199862873,0.0,0.0
42917,4,2917,[ 64 313 483 318  11],618,5,12007,4.114804660726525,80.0,20.0
42918,4,2918,[ 25 237   8 238 748],654,4,12011,4.114765330592669,0.0,0.0
42919,4,2919,[ 64 313 483 318  11],618,5,12016,4.115068493150685,80.0,20.0
42920,4,2920,[161  70 181 143 132],618,4,12020,4.115029099623417,0.0,20.0
42921,4,2921,[ 64 313 483 318  11],618,5,12025,4.11533196440794,80.0,20.0
42922,4,2922,[ 64 313 483 318  11],618,5,12030,4.115634621963736,80.0,20.0
42923,4,2923,[ 15  22 181 475 204],416,4,12034,4.115595075239398,0.0,20.0
42924,4,2924,[168 195 471  25 144],618,2,12036,4.114871794871795,0.0,0.0
42925,4,2925,[ 64 313 483 318  11],214,5,12041,4.115174299384826,80.0,20.0
42926,4,2926,[ 64 313 483 318  11],214,5,12046,4.115476597198497,80.0,20.0
42927,4,2927,[197  28 210 294 403],416,5,12051,4.11577868852459,0.0,0.0
42928,4,2928,[ 64 313 483 318  11],618,5,12056,4.116080573574599,80.0,20.0
42929,4,2929,[ 64 313 483 318  11],214,5,12061,4.116382252559727,80.0,20.0
42930,4,2930,[  7  22 168 288 318],588,4,12065,4.116342545206415,20.0,20.0
42931,4,2931,[ 70 168 313 471 111],618,2,12067,4.115620736698499,20.0,20.0
42932,4,2932,[ 64 313 483 318  11],214,5,12072,4.115922263893625,80.0,20.0
42933,4,2933,[423 475   4 175 328],49,2,12074,4.1152010906612135,0.0,0.0
42934,4,2934,[ 22 180 118 471   4],854,1,12075,4.114139693356048,0.0,0.0
42935,4,2935,[ 64 313 483 318  11],618,5,12080,4.114441416893733,80.0,20.0
42936,4,2936,[ 12 385 271 678 174],805,2,12082,4.113721484508002,20.0,0.0
42937,4,2937,[  7  70 678 245 258],416,3,12085,4.113342409802587,0.0,0.0
42938,4,2938,[195 234 515 222 215],297,2,12087,4.112623341272542,0.0,0.0
42939,4,2939,[323 174 748 196 132],345,3,12090,4.112244897959184,0.0,0.0
42940,4,2940,[210 125 282  15 118],588,3,12093,4.11186671200272,0.0,0.0
42941,4,2941,[ 82 385 168   8 475],49,2,12095,4.111148878314072,0.0,0.0
42942,4,2942,[ 64 313 483 318  11],618,5,12100,4.111450900441726,80.0,20.0
42943,4,2943,[111 168  69 181 238],416,5,12105,4.111752717391305,0.0,20.0
42944,4,2944,[742 100 118 288  98],297,2,12107,4.111035653650255,0.0,40.0
42945,4,2945,[588 202 235 151 238],805,2,12109,4.110319076714188,0.0,0.0
42946,4,2946,[161 275  71 228 288],711,2,12111,4.1096029860875465,0.0,20.0
42947,4,2947,[185  25 275  98 183],297,5,12116,4.109905020352781,0.0,20.0
42948,4,2948,[268 301  50 471 333],416,5,12121,4.110206849779586,0.0,20.0
42949,4,2949,[ 64 313 483 318  11],214,5,12126,4.110508474576271,80.0,20.0
42950,4,2950,[313 268 151 471 328],416,4,12130,4.110471026770586,20.0,20.0
42951,4,2951,[ 64 313 483 318  11],214,5,12135,4.110772357723577,80.0,20.0
42952,4,2952,[276  88 173 121 174],416,3,12138,4.110396207246867,0.0,0.0
42953,4,2953,[ 64 313 483 318  11],618,5,12143,4.110697359512526,80.0,20.0
42954,4,2954,[ 64 313 483 318  11],618,5,12148,4.110998307952623,80.0,20.0
42955,4,2955,[ 64 313 483 318  11],214,5,12153,4.111299052774019,80.0,20.0
42956,4,2956,[ 64 313 483 318  11],618,5,12158,4.111599594183294,80.0,20.0
42957,4,2957,[ 64 313 483 318  11],214,5,12163,4.111899932386748,80.0,20.0
42958,4,2958,[ 64 313 483 318  11],214,5,12168,4.112200067590402,80.0,20.0
42959,4,2959,[ 64 313 483 318  11],214,5,12173,4.1125,80.0,20.0
42960,4,2960,[172  71  79 180 286],711,4,12177,4.112462006079028,0.0,0.0
42961,4,2961,[423 191 257 183  22],416,4,12181,4.112424037812289,0.0,0.0
42962,4,2962,[ 64 313 483 318  11],618,5,12186,4.112723590955113,80.0,20.0
42963,4,2963,[ 64 313 483 318  11],618,5,12191,4.113022941970311,80.0,20.0
42964,4,2964,[ 64 313 483 318  11],214,5,12196,4.113322091062394,80.0,20.0
42965,4,2965,[ 64 313 483 318  11],214,5,12201,4.113621038435603,80.0,20.0
42966,4,2966,[ 64 313 483 318  11],618,5,12206,4.113919784293899,80.0,20.0
42967,4,2967,[200 173 197 302  89],405,3,12209,4.113544474393531,0.0,0.0
42968,4,2968,[276  56 117 125 318],416,4,12213,4.113506231054227,20.0,0.0
42969,4,2969,[175  79 176 357 200],854,4,12217,4.1134680134680135,0.0,0.0
42970,4,2970,[269   1 195   7   4],805,3,12220,4.113093234601144,0.0,0.0
42971,4,2971,[ 64 313 483 318  11],618,5,12225,4.113391655450875,80.0,20.0
42972,4,2972,[ 64 313 483 318  11],618,5,12230,4.113689875546586,80.0,20.0
42973,4,2973,[ 64 313 483 318  11],618,5,12235,4.113987895090787,80.0,20.0
42974,4,2974,[ 79 318  64 300 153],43,5,12240,4.114285714285714,40.0,0.0
42975,4,2975,[215 302  82 588 300],751,4,12244,4.114247311827957,0.0,0.0
42976,4,2976,[200 273 181  89 185],417,2,12246,4.11353711790393,0.0,20.0
42977,4,2977,[423 294 475 286 748],417,5,12251,4.1138347884486235,0.0,0.0
42978,4,2978,[276  50 117  69  22],618,4,12255,4.113796576032225,0.0,20.0
42979,4,2979,[ 64 313 483 318  11],618,5,12260,4.114093959731544,80.0,20.0
42980,4,2980,[ 64 313 483 318  11],618,5,12265,4.114391143911439,80.0,20.0
42981,4,2981,[117 748 197 300 265],297,1,12266,4.113346747149564,0.0,0.0
42982,4,2982,[678 301   1  79 269],297,2,12268,4.112638283607107,0.0,0.0
42983,4,2983,[237 265 143 168  22],618,5,12273,4.112935656836461,0.0,0.0
42984,4,2984,[ 70  82 237 153 265],198,1,12274,4.111892797319933,0.0,0.0
42985,4,2985,[300  25  69 176 173],416,5,12279,4.11219022103148,0.0,0.0
42986,4,2986,[ 64 313 483 318  11],214,5,12284,4.11248744559759,80.0,20.0
42987,4,2987,[ 69  95 423 269 258],297,2,12286,4.111780455153949,0.0,0.0
42988,4,2988,[588 100  22   1 197],416,5,12291,4.112077617932419,0.0,0.0
42989,4,2989,[ 64 235 222 597  98],43,3,12294,4.1117056856187295,20.0,20.0
42990,4,2990,[ 97   8 135 161  25],618,3,12297,4.111334002006018,0.0,0.0
42991,4,2991,[ 64 313 483 318  11],214,5,12302,4.1116310160427805,80.0,20.0
42992,4,2992,[ 64 313 483 318  11],618,5,12307,4.111927831607083,80.0,20.0
42993,4,2993,[144 286 288 222 168],711,2,12309,4.11122244488978,0.0,20.0
42994,4,2994,[173  95 179 172   8],805,3,12312,4.11085141903172,0.0,0.0
42995,4,2995,[ 64 313 483 318  11],214,5,12317,4.111148197596796,80.0,20.0
42996,4,2996,[276 258 168   4  12],43,5,12322,4.111444778111445,20.0,0.0
42997,4,2997,[135 403  15 173 234],642,3,12325,4.111074049366244,0.0,0.0
42998,4,2998,[ 64 313 483 318  11],214,5,12330,4.11137045681894,80.0,20.0
42999,4,2999,[181  98 288 294 275],588,3,12333,4.111,0.0,60.0
43000,4,3000,[187 100 318 132 191],373,2,12335,4.11029656781073,20.0,0.0
43001,4,3001,[238 216  28 132 276],618,2,12337,4.109593604263824,0.0,0.0
43002,4,3002,[ 64 313 483 318  11],214,5,12342,4.1098901098901095,80.0,20.0
43003,4,3003,[ 64 313 483 318  11],214,5,12347,4.110186418109188,80.0,20.0
43004,4,3004,[ 64 313 483 318  11],618,5,12352,4.110482529118136,80.0,20.0
43005,4,3005,[ 64 313 483 318  11],618,5,12357,4.110778443113772,80.0,20.0
43006,4,3006,[183 238  95   1  89],198,4,12361,4.110741602926505,0.0,0.0
43007,4,3007,[191 176  64 168  95],416,4,12365,4.1107047872340425,20.0,0.0
43008,4,3008,[ 64 313 483 318  11],214,5,12370,4.1110003323363244,80.0,20.0
43009,4,3009,[286 151   7 176  97],62,3,12373,4.110631229235881,0.0,0.0
43010,4,3010,[  7  28 183  15 271],62,2,12375,4.109930255728994,0.0,0.0
43011,4,3011,[302 328 174 289 322],416,3,12378,4.109561752988048,0.0,0.0
43012,4,3012,[  1 333 245 678 302],345,1,12379,4.108529704613342,0.0,0.0
43013,4,3013,[ 64 313 483 318  11],214,5,12384,4.108825481088255,80.0,20.0
43014,4,3014,[ 64 313 483 318  11],618,5,12389,4.109121061359867,80.0,20.0
43015,4,3015,[ 95 100 121 237  28],230,5,12394,4.109416445623342,0.0,0.0
43016,4,3016,[ 64 313 483 318  11],214,5,12399,4.109711634073583,80.0,20.0
43017,4,3017,[742 276 118 173 282],764,1,12400,4.108681245858184,0.0,0.0
43018,4,3018,[197  79 286 235 678],345,2,12402,4.107982775753561,0.0,0.0
43019,4,3019,[ 64 313 483 318  11],214,5,12407,4.1082781456953645,80.0,20.0
43020,4,3020,[185 268 286 191  70],416,5,12412,4.108573320092685,0.0,0.0
43021,4,3021,[357 294 235 151 313],642,2,12414,4.107875579086698,20.0,20.0
43022,4,3022,[222 174   4 195  97],198,1,12415,4.106847502480979,0.0,0.0
43023,4,3023,[496 265 200 173 111],416,5,12420,4.107142857142857,0.0,0.0
43024,4,3024,[ 64 313 483 318  11],214,5,12425,4.107438016528926,80.0,20.0
43025,4,3025,[100 185   1 483 508],854,4,12429,4.107402511566424,20.0,0.0
43026,4,3026,[ 64 313 483 318  11],214,5,12434,4.107697390155269,80.0,20.0
43027,4,3027,[282 195 286 588 655],416,5,12439,4.107992073976222,0.0,0.0
43028,4,3028,[ 64 313 483 318  11],214,5,12444,4.108286563222186,80.0,20.0
43029,4,3029,[ 64 313 483 318  11],214,5,12449,4.1085808580858085,80.0,20.0
43030,4,3030,[173  88 216 210 423],373,4,12453,4.108545034642033,0.0,0.0
43031,4,3031,[228 151  82  69 238],198,3,12456,4.108179419525066,0.0,0.0
43032,4,3032,[118 471 191 200 161],618,3,12459,4.107814045499506,0.0,0.0
43033,4,3033,[301  28 302  95 127],416,4,12463,4.107778510217535,0.0,0.0
43034,4,3034,[ 64 313 483 318  11],214,5,12468,4.108072487644152,80.0,20.0
43035,4,3035,[268 515 597 151 323],417,3,12471,4.107707509881423,0.0,0.0
43036,4,3036,[ 22  64 237 153 313],642,4,12475,4.107672044781034,40.0,20.0
43037,4,3037,[294 546  70   1 508],654,3,12478,4.107307439104674,0.0,0.0
43038,4,3038,[ 64 313 483 318  11],618,5,12483,4.107601184600197,80.0,20.0
43039,4,3039,[ 64 313 483 318  11],214,5,12488,4.1078947368421055,80.0,20.0
43040,4,3040,[144 275 182 183 405],416,5,12493,4.1081880960210455,0.0,0.0
43041,4,3041,[357 132  56 210   9],62,5,12498,4.108481262327416,0.0,0.0
43042,4,3042,[ 64 313 483 318  11],618,5,12503,4.108774235951364,80.0,20.0
43043,4,3043,[ 64 313 483 318  11],618,5,12508,4.109067017082785,80.0,20.0
43044,4,3044,[ 64 313 483 318  11],618,5,12513,4.10935960591133,80.0,20.0
43045,4,3045,[ 64 313 483 318  11],214,5,12518,4.109652002626396,80.0,20.0
43046,4,3046,[174 181  56 301  98],49,2,12520,4.108959632425337,0.0,40.0
43047,4,3047,[ 64 313 483 318  11],618,5,12525,4.109251968503937,80.0,20.0
43048,4,3048,[ 64 313 483 318  11],618,5,12530,4.109544112823877,80.0,20.0
43049,4,3049,[ 64 313 483 318  11],618,5,12535,4.109836065573771,80.0,20.0
43050,4,3050,[ 64 313 483 318  11],214,5,12540,4.110127826941986,80.0,20.0
43051,4,3051,[ 64 313 483 318  11],214,5,12545,4.110419397116645,80.0,20.0
43052,4,3052,[ 28 288 282 216 196],297,3,12548,4.110055682934818,0.0,20.0
43053,4,3053,[216 118 135 318  15],198,3,12551,4.109692206941716,20.0,0.0
43054,4,3054,[ 64 313 483 318  11],618,5,12556,4.1099836333878885,80.0,20.0
43055,4,3055,[ 64 313 483 318  11],618,5,12561,4.110274869109948,80.0,20.0
43056,4,3056,[ 64 313 483 318  11],214,5,12566,4.11056591429506,80.0,20.0
43057,4,3057,[ 64 313 483 318  11],618,5,12571,4.110856769130151,80.0,20.0
43058,4,3058,[216 568 196  50 237],198,2,12573,4.110166721150703,0.0,20.0
43059,4,3059,[ 98  28  79 135 176],618,5,12578,4.110457516339869,0.0,20.0
43060,4,3060,[191 196 216 168 257],62,4,12582,4.110421430904933,0.0,0.0
43061,4,3061,[151 143 216  71 202],805,1,12583,4.109405617243632,0.0,0.0
43062,4,3062,[ 98 275   8  25 301],297,5,12588,4.109696376101861,0.0,20.0
43063,4,3063,[423  89 235 742 117],854,2,12590,4.109007832898173,0.0,0.0
43064,4,3064,[ 64 313 483 318  11],618,5,12595,4.109298531810767,80.0,20.0
43065,4,3065,[ 22 313  50 328 294],505,3,12598,4.108936725375082,20.0,40.0
43066,4,3066,[603 235 151 282 153],854,3,12601,4.10857515487447,0.0,0.0
43067,4,3067,[ 64 313 483 318  11],214,5,12606,4.108865710560626,80.0,20.0
43068,4,3068,[ 64 313 483 318  11],214,5,12611,4.109156076898012,80.0,20.0
43069,4,3069,[151 173  28 144 121],618,3,12614,4.108794788273616,0.0,0.0
43070,4,3070,[204 603 471 210 191],416,5,12619,4.109084988603061,0.0,0.0
43071,4,3071,[ 64 313 483 318  11],618,5,12624,4.109375,80.0,20.0
43072,4,3072,[275 568 168 257 269],711,3,12627,4.109013992840872,0.0,0.0
43073,4,3073,[132 588 258 228 235],887,3,12630,4.108653220559532,0.0,0.0
43074,4,3074,[197 143  15 125  88],345,4,12634,4.108617886178862,0.0,0.0
43075,4,3075,[282 322 237 175   4],854,1,12635,4.107607282184655,0.0,0.0
43076,4,3076,[ 64 313 483 318  11],618,5,12640,4.1078973025674355,80.0,20.0
43077,4,3077,[118 546 423 100 172],417,2,12642,4.107212475633529,0.0,0.0
43078,4,3078,[ 64 313 483 318  11],618,5,12647,4.107502435855797,80.0,20.0
43079,4,3079,[385  25 300 200 127],198,2,12649,4.1068181818181815,0.0,0.0
43080,4,3080,[496 288 405  12 588],417,1,12650,4.105809802012334,20.0,20.0
43081,4,3081,[423 168 257 273 588],416,4,12654,4.105775470473718,0.0,0.0
43082,4,3082,[202  22  64 597 117],618,4,12658,4.105741161206617,20.0,0.0
43083,4,3083,[301 235 294   4 515],416,4,12662,4.105706874189364,0.0,0.0
43084,4,3084,[ 88 179 117  71 275],416,3,12665,4.105348460291734,0.0,0.0
43085,4,3085,[475   7 121 168 111],854,3,12668,4.1049902786779,0.0,0.0
43086,4,3086,[496   8 403 216 588],618,3,12671,4.104632329122125,0.0,0.0
43087,4,3087,[100 183 181 151 186],618,4,12675,4.104598445595855,0.0,20.0
43088,4,3088,[257 235 234  97 273],417,2,12677,4.103917125283263,0.0,0.0
43089,4,3089,[ 12 357 405 216 125],416,5,12682,4.1042071197411,20.0,0.0
43090,4,3090,[ 64 313 483 318  11],214,5,12687,4.104496926560984,80.0,20.0
43091,4,3091,[ 64 313 483 318  11],618,5,12692,4.104786545924967,80.0,20.0
43092,4,3092,[475 515 173 235   8],297,4,12696,4.104752667313288,0.0,0.0
43093,4,3093,[ 64 313 483 318  11],618,5,12701,4.105042016806722,80.0,20.0
43094,4,3094,[ 64 313 483 318  11],214,5,12706,4.105331179321486,80.0,20.0
43095,4,3095,[ 64 313 483 318  11],618,5,12711,4.10562015503876,80.0,20.0
43096,4,3096,[ 64 313 483 318  11],618,5,12716,4.10590894413949,80.0,20.0
43097,4,3097,[235  50 655 200 127],417,3,12719,4.105551969012266,0.0,20.0
43098,4,3098,[ 64 313 483 318  11],618,5,12724,4.1058405937399165,80.0,20.0
43099,4,3099,[ 69 125 423 597 174],588,1,12725,4.104838709677419,0.0,0.0
43100,4,3100,[275 385   4 175 748],373,3,12728,4.104482425024186,0.0,0.0
43101,4,3101,[111   4 268 546  79],416,4,12732,4.104448742746615,0.0,0.0
43102,4,3102,[117 176  89  96 172],198,4,12736,4.104415082178537,0.0,0.0
43103,4,3103,[286 546   1 294  82],416,4,12740,4.104381443298969,0.0,0.0
43104,4,3104,[318 173  70 179 357],373,4,12744,4.104347826086957,20.0,0.0
43105,4,3105,[ 64 496 179 333 210],416,4,12748,4.104314230521571,20.0,0.0
43106,4,3106,[ 64 313 483 318  11],618,5,12753,4.104602510460251,80.0,20.0
43107,4,3107,[228 153 258 195 588],297,3,12756,4.104247104247104,0.0,0.0
43108,4,3108,[ 64 313 483 318  11],214,5,12761,4.10453522032808,80.0,20.0
43109,4,3109,[  8 238 234 200 204],618,2,12763,4.103858520900322,0.0,0.0
43110,4,3110,[ 64 313 483 318  11],618,5,12768,4.104146576663452,80.0,20.0
43111,4,3111,[ 64 313 483 318  11],214,5,12773,4.104434447300771,80.0,20.0
43112,4,3112,[ 64 313 483 318  11],618,5,12778,4.104722132990684,80.0,20.0
43113,4,3113,[427 179 210 655  82],373,3,12781,4.1043673731535,0.0,0.0
43114,4,3114,[ 64 313 483 318  11],214,5,12786,4.1046548956661315,80.0,20.0
43115,4,3115,[ 64 313 483 318  11],214,5,12791,4.104942233632863,80.0,20.0
43116,4,3116,[ 64 313 483 318  11],618,5,12796,4.105229387231312,80.0,20.0
43117,4,3117,[172 135 211 475 405],417,2,12798,4.104554201411161,0.0,0.0
43118,4,3118,[301 151 245  96 276],416,2,12800,4.103879448541199,0.0,0.0
43119,4,3119,[ 64 313 483 318  11],214,5,12805,4.104166666666667,80.0,20.0
43120,4,3120,[276 268 215  71 237],416,3,12808,4.103812880487023,0.0,0.0
43121,4,3121,[ 64 313 483 318  11],214,5,12813,4.104099935938501,80.0,20.0
43122,4,3122,[483 182 195  89 385],417,5,12818,4.104386807556836,20.0,0.0
43123,4,3123,[ 97 194 117 191 187],373,3,12821,4.104033290653009,0.0,0.0
43124,4,3124,[118 300 265  71 257],705,5,12826,4.10432,0.0,0.0
43125,4,3125,[ 98 151  71 322  12],416,3,12829,4.103966730646193,20.0,20.0
43126,4,3126,[ 64 313 483 318  11],214,5,12834,4.104253277902143,80.0,20.0
43127,4,3127,[ 64 313 483 318  11],618,5,12839,4.104539641943734,80.0,20.0
43128,4,3128,[ 64 313 483 318  11],214,5,12844,4.104825822946628,80.0,20.0
43129,4,3129,[ 64 313 483 318  11],214,5,12849,4.105111821086262,80.0,20.0
43130,4,3130,[742 179 173 174 176],62,4,12853,4.10507824976046,0.0,0.0
43131,4,3131,[265 475  95 423 655],588,2,12855,4.104406130268199,0.0,0.0
43132,4,3132,[333  97 216 179 268],416,4,12859,4.1043728056176185,0.0,0.0
43133,4,3133,[475  56 603 191 127],805,4,12863,4.104339502233567,0.0,0.0
43134,4,3134,[ 64 313 483 318  11],618,5,12868,4.104625199362041,80.0,20.0
43135,4,3135,[286 161  50 179 216],417,2,12870,4.103954081632653,0.0,20.0
43136,4,3136,[ 64 313 483 318  11],214,5,12875,4.104239719477207,80.0,20.0
43137,4,3137,[ 64 313 483 318  11],214,5,12880,4.104525175270873,80.0,20.0
43138,4,3138,[ 11  56 515 132 211],230,4,12884,4.104491876393756,0.0,0.0
43139,4,3139,[ 64 313 483 318  11],618,5,12889,4.104777070063694,80.0,20.0
43140,4,3140,[ 64 313 483 318  11],214,5,12894,4.105062082139446,80.0,20.0
43141,4,3141,[ 64 313 483 318  11],214,5,12899,4.105346912794398,80.0,20.0
43142,4,3142,[ 64 313 483 318  11],214,5,12904,4.105631562201718,80.0,20.0
43143,4,3143,[161 515 323 153  70],417,3,12907,4.105279898218829,0.0,0.0
43144,4,3144,[ 64 313 483 318  11],214,5,12912,4.105564387917329,80.0,20.0
43145,4,3145,[328 289 237 238  98],43,4,12916,4.10553083280356,0.0,20.0
43146,4,3146,[265 100 144 515  89],417,2,12918,4.104861773117254,0.0,0.0
43147,4,3147,[ 64 313 483 318  11],214,5,12923,4.105146124523507,80.0,20.0
43148,4,3148,[323 182 318 258 202],416,4,12927,4.105112734201334,20.0,0.0
43149,4,3149,[ 64 313 483 318  11],214,5,12932,4.105396825396825,80.0,20.0
43150,4,3150,[ 64 313 483 318  11],618,5,12937,4.1056807362741985,80.0,20.0
43151,4,3151,[ 64 313 483 318  11],214,5,12942,4.105964467005077,80.0,20.0
43152,4,3152,[ 64 313 483 318  11],214,5,12947,4.106248017760863,80.0,20.0
43153,4,3153,[ 64 313 483 318  11],214,5,12952,4.106531388712746,80.0,20.0
43154,4,3154,[ 64 313 483 318  11],214,5,12957,4.1068145800316955,80.0,20.0
43155,4,3155,[174 257 111 313 151],416,3,12960,4.106463878326996,20.0,20.0
43156,4,3156,[ 64 313 483 318  11],214,5,12965,4.106746911624961,80.0,20.0
43157,4,3157,[172 183 125  56 276],62,5,12970,4.107029765674477,0.0,0.0
43158,4,3158,[ 64 181   4  28 568],642,4,12974,4.106995884773663,20.0,20.0
43159,4,3159,[ 64 313 483 318  11],214,5,12979,4.107278481012658,80.0,20.0
43160,4,3160,[ 50 100 588  11 161],416,5,12984,4.107560898449858,0.0,20.0
43161,4,3161,[ 64 313 483 318  11],618,5,12989,4.107843137254902,80.0,20.0
43162,4,3162,[483 195 125 210 182],618,2,12991,4.107176730951628,20.0,0.0
43163,4,3163,[294 405 183 496 588],887,4,12995,4.107142857142857,0.0,0.0
43164,4,3164,[ 79 132  95 216 294],253,5,13000,4.107424960505529,0.0,0.0
43165,4,3165,[ 64 313 483 318  11],618,5,13005,4.107706885660139,80.0,20.0
43166,4,3166,[588 174 172 405  96],705,3,13008,4.107357120303126,0.0,0.0
43167,4,3167,[180  22  95 127 269],373,3,13011,4.107007575757576,0.0,0.0
43168,4,3168,[235 318 288 568 405],887,3,13014,4.106658251814452,20.0,20.0
43169,4,3169,[423 301 118 603 135],437,3,13017,4.106309148264984,0.0,0.0
43170,4,3170,[210 235 179 475 405],805,2,13019,4.1056449069694105,0.0,0.0
43171,4,3171,[ 64 313 483 318  11],214,5,13024,4.105926860025221,80.0,20.0
43172,4,3172,[222  15  69 168  22],588,3,13027,4.10557831705011,0.0,0.0
43173,4,3173,[ 64 313 483 318  11],618,5,13032,4.10586011342155,80.0,20.0
43174,4,3174,[ 64 313 483 318  11],214,5,13037,4.106141732283464,80.0,20.0
43175,4,3175,[318 216 238 100 235],43,3,13040,4.105793450881612,20.0,0.0
43176,4,3176,[ 64 313 483 318  11],618,5,13045,4.106074913440352,80.0,20.0
43177,4,3177,[ 64 313 483 318  11],214,5,13050,4.106356198867212,80.0,20.0
43178,4,3178,[181 269 302 742 194],416,5,13055,4.106637307329349,0.0,20.0
43179,4,3179,[173 742 191 210 168],805,3,13058,4.106289308176101,0.0,0.0
43180,4,3180,[ 64 313 483 318  11],618,5,13063,4.106570260924237,80.0,20.0
43181,4,3181,[588 111 195 273 183],618,3,13066,4.106222501571339,0.0,0.0
43182,4,3182,[ 64 313 483 318  11],618,5,13071,4.106503298774741,80.0,20.0
43183,4,3183,[483  98 196 151  79],354,1,13072,4.105527638190955,20.0,20.0
43184,4,3184,[  7  95  64   4 176],764,4,13076,4.105494505494505,20.0,0.0
43185,4,3185,[ 64 313 483 318  11],618,5,13081,4.105775266792216,80.0,20.0
43186,4,3186,[ 15 268 235   1 237],907,5,13086,4.106055851898337,0.0,0.0
43187,4,3187,[742 111  97 161 475],588,2,13088,4.105395232120451,0.0,0.0
43188,4,3188,[ 64 313 483 318  11],618,5,13093,4.1056757604264655,80.0,20.0
43189,4,3189,[ 64 313 483 318  11],214,5,13098,4.105956112852665,80.0,20.0
43190,4,3190,[210 127 196   1 176],417,4,13102,4.105922908179254,0.0,0.0
43191,4,3191,[ 64 313 483 318  11],214,5,13107,4.106203007518797,80.0,20.0
43192,4,3192,[ 64 313 483 318  11],618,5,13112,4.106482931412465,80.0,20.0
43193,4,3193,[ 64 313 483 318  11],214,5,13117,4.106762680025047,80.0,20.0
43194,4,3194,[111 118 423 471 322],416,3,13120,4.10641627543036,0.0,0.0
43195,4,3195,[183 228 195  97 118],297,2,13122,4.105757196495619,0.0,0.0
43196,4,3196,[ 64 313 483 318  11],618,5,13127,4.106036909602753,80.0,20.0
43197,4,3197,[234  69 588 196 216],230,5,13132,4.106316447779863,0.0,0.0
43198,4,3198,[173 238  79  69 288],618,2,13134,4.105658018130666,0.0,20.0
43199,4,3199,[ 97 144 117 215 269],297,3,13137,4.1053125,0.0,0.0
43200,4,3200,[568  69 273  79  89],417,1,13138,4.104342393002187,0.0,0.0
43201,4,3201,[ 64 313 483 318  11],618,5,13143,4.104622111180512,80.0,20.0
43202,4,3202,[ 89 121  96   9 271],62,4,13147,4.104589447393069,0.0,0.0
43203,4,3203,[ 64 313 483 318  11],214,5,13152,4.104868913857678,80.0,20.0
43204,4,3204,[ 64 313 483 318  11],618,5,13157,4.105148205928237,80.0,20.0
43205,4,3205,[ 64  96 328   4  97],62,3,13160,4.104803493449782,20.0,0.0
43206,4,3206,[204 385   7 186 173],618,3,13163,4.104458995946367,0.0,0.0
43207,4,3207,[ 64 313 483 318  11],618,5,13168,4.104738154613466,80.0,20.0
43208,4,3208,[ 56 172 176 196 318],416,5,13173,4.105017139295731,20.0,0.0
43209,4,3209,[300 385  28 168 483],751,4,13177,4.1049844236760125,20.0,0.0
43210,4,3210,[  8  50 271 275 204],62,3,13180,4.104640298972283,0.0,20.0
43211,4,3211,[ 11 228 273  22 403],805,1,13181,4.103673723536737,0.0,0.0
43212,4,3212,[ 64 313 483 318  11],214,5,13186,4.1039526921879865,80.0,20.0
43213,4,3213,[100 151  79 168 117],588,4,13190,4.10392034847542,0.0,0.0
43214,4,3214,[288 302 357 301 294],297,3,13193,4.10357698289269,0.0,20.0
43215,4,3215,[ 64 313 483 318  11],214,5,13198,4.1038557213930345,80.0,20.0
43216,4,3216,[ 64 313 483 318  11],618,5,13203,4.104134286602425,80.0,20.0
43217,4,3217,[ 95 135 195  79 655],618,3,13206,4.103791174642635,0.0,0.0
43218,4,3218,[515 195 318 216 187],416,5,13211,4.104069586828207,20.0,0.0
43219,4,3219,[200 282 475 265 257],270,4,13215,4.104037267080745,0.0,0.0
43220,4,3220,[200 174  22  82 496],618,5,13220,4.104315429990686,0.0,0.0
43221,4,3221,[181 385 286  88 195],373,3,13223,4.10397268777157,0.0,20.0
43222,4,3222,[ 64 313 483 318  11],618,5,13228,4.104250698107354,80.0,20.0
43223,4,3223,[176 313 185 132  56],416,5,13233,4.104528535980148,20.0,20.0
43224,4,3224,[ 64 313 483 318  11],214,5,13238,4.104806201550388,80.0,20.0
43225,4,3225,[568 238  95 588 195],805,1,13239,4.103843769373838,0.0,0.0
43226,4,3226,[144 117 186  64   7],417,3,13242,4.103501704369383,20.0,0.0
43227,4,3227,[151 313 200 282 204],345,4,13246,4.103469640644362,20.0,20.0
43228,4,3228,[ 64 313 483 318  11],618,5,13251,4.103747290182719,80.0,20.0
43229,4,3229,[ 70 234 151 496 228],417,3,13254,4.103405572755418,0.0,0.0
43230,4,3230,[ 64 313 483 318  11],214,5,13259,4.103683070256887,80.0,20.0
43231,4,3231,[471 318 597 288 182],416,4,13263,4.10365099009901,20.0,20.0
43232,4,3232,[496 234 100 215  71],437,3,13266,4.103309619548407,0.0,0.0
43233,4,3233,[197 238  25 515  11],297,4,13270,4.103277674706246,0.0,0.0
43234,4,3234,[ 64 313 483 318  11],214,5,13275,4.10355486862442,80.0,20.0
43235,4,3235,[ 64 313 483 318  11],214,5,13280,4.103831891223733,80.0,20.0
43236,4,3236,[202 276   4 282 143],12,5,13285,4.10410874266296,0.0,0.0
43237,4,3237,[ 97 144 275  82 200],711,3,13288,4.103767757875231,0.0,0.0
43238,4,3238,[ 64 313 483 318  11],618,5,13293,4.104044458166101,80.0,20.0
43239,4,3239,[197 508 181  79  70],354,2,13295,4.103395061728395,0.0,20.0
43240,4,3240,[ 64 313 483 318  11],214,5,13300,4.103671706263499,80.0,20.0
43241,4,3241,[423 237 405 186 135],854,3,13303,4.103331276989513,0.0,0.0
43242,4,3242,[ 98 174  64 216 238],62,5,13308,4.103607770582793,20.0,20.0
43243,4,3243,[  4 173  56 496 215],618,3,13311,4.103267570900123,0.0,0.0
43244,4,3244,[ 64 313 483 318  11],214,5,13316,4.1035439137134055,80.0,20.0
43245,4,3245,[ 64 313 483 318  11],618,5,13321,4.103820086260012,80.0,20.0
43246,4,3246,[265 175 385 228 187],198,1,13322,4.1028641823221434,0.0,0.0
43247,4,3247,[ 64 313 483 318  11],618,5,13327,4.10314039408867,80.0,20.0
43248,4,3248,[ 64 313 483 318  11],618,5,13332,4.103416435826408,80.0,20.0
43249,4,3249,[143  97 210 273 282],416,5,13337,4.103692307692308,0.0,0.0
43250,4,3250,[ 64 313 483 318  11],214,5,13342,4.1039680098431255,80.0,20.0
43251,4,3251,[ 64 313 483 318  11],214,5,13347,4.104243542435424,80.0,20.0
43252,4,3252,[151 742 403 333 186],588,4,13351,4.104211497079619,0.0,0.0
43253,4,3253,[ 64 313 483 318  11],214,5,13356,4.1044867854947755,80.0,20.0
43254,4,3254,[ 64 313 483 318  11],214,5,13361,4.104761904761904,80.0,20.0
43255,4,3255,[ 97 475 508  28  12],62,3,13364,4.104422604422604,20.0,0.0
43256,4,3256,[313 496 173 237  82],618,4,13368,4.104390543444888,20.0,20.0
43257,4,3257,[111 286 302 173 181],416,5,13373,4.104665438919582,0.0,20.0
43258,4,3258,[210 117  88  50 269],345,5,13378,4.104940165694998,0.0,20.0
43259,4,3259,[ 64 313 483 318  11],618,5,13383,4.10521472392638,80.0,20.0
43260,4,3260,[ 64 313 483 318  11],214,5,13388,4.105489113768782,80.0,20.0
43261,4,3261,[276 568 143 172 546],416,3,13391,4.105150214592275,0.0,0.0
43262,4,3262,[ 64 222 168 196 186],496,1,13392,4.104198590254367,20.0,0.0
43263,4,3263,[117 181 121 228 195],417,2,13394,4.103553921568627,0.0,20.0
43264,4,3264,[313  64 483 318  11],618,5,13399,4.103828483920368,80.0,20.0
43265,4,3265,[313  64 483 318  11],214,5,13404,4.104102878138396,80.0,20.0
43266,4,3266,[313  64 483 318  11],214,5,13409,4.104377104377105,80.0,20.0
43267,4,3267,[151  79  82 276 200],437,4,13413,4.104345165238678,0.0,0.0
43268,4,3268,[313  64 483 318  11],618,5,13418,4.1046191495870294,80.0,20.0
43269,4,3269,[313  64 483 318  11],214,5,13423,4.104892966360857,80.0,20.0
43270,4,3270,[313  64 483 318  11],618,5,13428,4.105166615713849,80.0,20.0
43271,4,3271,[313  64 483 318  11],214,5,13433,4.105440097799511,80.0,20.0
43272,4,3272,[313  64 483 318  11],618,5,13438,4.105713412771158,80.0,20.0
43273,4,3273,[655  28 276 144   8],416,4,13442,4.10568112400733,0.0,0.0
43274,4,3274,[568 202  82  64 508],128,4,13446,4.105648854961832,20.0,0.0
43275,4,3275,[313  64 483 318  11],214,5,13451,4.1059218559218555,80.0,20.0
43276,4,3276,[313  64 483 318  11],214,5,13456,4.106194690265487,80.0,20.0
43277,4,3277,[313  64 483 318  11],214,5,13461,4.106467358145211,80.0,20.0
43278,4,3278,[173 222  50 181 117],43,5,13466,4.106739859713327,0.0,40.0
43279,4,3279,[313  64 483 318  11],214,5,13471,4.107012195121952,80.0,20.0
43280,4,3280,[313  64 483 318  11],214,5,13476,4.107284364523012,80.0,20.0
43281,4,3281,[313  64 483 318  11],214,5,13481,4.107556368068251,80.0,20.0
43282,4,3282,[313  64 483 318  11],214,5,13486,4.10782820590923,80.0,20.0
43283,4,3283,[313  64 483 318  11],214,5,13491,4.10809987819732,80.0,20.0
43284,4,3284,[237   7 271  11 172],505,2,13493,4.107458143074582,0.0,0.0
43285,4,3285,[313  64 483 318  11],214,5,13498,4.1077297626293365,80.0,20.0
43286,4,3286,[222  11 276 265 183],922,3,13501,4.107392759355035,0.0,0.0
43287,4,3287,[588 475 196   1 174],416,4,13505,4.107360097323601,0.0,0.0
43288,4,3288,[153 204 168 186  96],373,5,13510,4.107631498935847,0.0,0.0
43289,4,3289,[313  64 483 318  11],214,5,13515,4.10790273556231,80.0,20.0
43290,4,3290,[176  11 427 423 181],618,5,13520,4.108173807353388,0.0,20.0
43291,4,3291,[179 127 111 183 268],416,4,13524,4.108140947752126,0.0,0.0
43292,4,3292,[176 515 144  56 200],416,5,13529,4.108411782569086,0.0,0.0
43293,4,3293,[313  64 483 318  11],618,5,13534,4.108682452944748,80.0,20.0
43294,4,3294,[423 111  79 268 603],297,2,13536,4.10804248861912,0.0,0.0
43295,4,3295,[294 265  69 228 204],505,1,13537,4.107099514563107,0.0,0.0
43296,4,3296,[181 179 269 435 173],373,4,13541,4.107067030633909,0.0,20.0
43297,4,3297,[135 568   4  15 196],618,3,13544,4.106731352334748,0.0,0.0
43298,4,3298,[313  64 483 318  11],618,5,13549,4.107002121855108,80.0,20.0
43299,4,3299,[313  64 483 318  11],618,5,13554,4.107272727272727,80.0,20.0
43300,4,3300,[ 89 228 483 286 181],711,4,13558,4.107240230233263,20.0,20.0
43301,4,3301,[313  64 483 318  11],618,5,13563,4.1075105996365835,80.0,20.0
43302,4,3302,[313  64 483 318  11],618,5,13568,4.107780805328489,80.0,20.0
43303,4,3303,[118 288 234 588  56],642,2,13570,4.107142857142857,0.0,20.0
43304,4,3304,[313  64 483 318  11],214,5,13575,4.107413010590015,80.0,20.0
43305,4,3305,[313  64 483 318  11],618,5,13580,4.10768300060496,80.0,20.0
43306,4,3306,[508  98 191 282   7],342,2,13582,4.1070456607196855,0.0,20.0
43307,4,3307,[282 196  69 117 172],618,4,13586,4.107013301088271,0.0,0.0
43308,4,3308,[ 98 294 117 179 323],805,3,13589,4.106678754910849,0.0,20.0
43309,4,3309,[182  89 196 118 173],198,3,13592,4.106344410876133,0.0,0.0
43310,4,3310,[313  64 483 318  11],214,5,13597,4.106614315916642,80.0,20.0
43311,4,3311,[  8 234 210 258 238],416,5,13602,4.106884057971015,0.0,0.0
43312,4,3312,[568 180 172  50  12],405,4,13606,4.106851795955327,20.0,20.0
43313,4,3313,[313  64 483 318  11],618,5,13611,4.1071213035606515,80.0,20.0
43314,4,3314,[313  64 483 318  11],214,5,13616,4.107390648567119,80.0,20.0
43315,4,3315,[144 176  69 427 423],230,4,13620,4.107358262967431,0.0,0.0
43316,4,3316,[313  64 483 318  11],214,5,13625,4.107627374133253,80.0,20.0
43317,4,3317,[313  64 483 318  11],618,5,13630,4.107896323086196,80.0,20.0
43318,4,3318,[300 546  28  56 333],416,4,13634,4.107863814401928,0.0,0.0
43319,4,3319,[423 322 168   4 483],417,3,13637,4.107530120481928,20.0,0.0
43320,4,3320,[313  64 483 318  11],618,5,13642,4.107798855766336,80.0,20.0
43321,4,3321,[313  64 483 318  11],214,5,13647,4.108067429259482,80.0,20.0
43322,4,3322,[258  89 475 183  79],198,4,13651,4.108034908215468,0.0,0.0
43323,4,3323,[ 97  56 182 173 471],297,3,13654,4.107701564380265,0.0,0.0
43324,4,3324,[515 181  69 195   4],417,2,13656,4.107067669172932,0.0,20.0
43325,4,3325,[ 64  28 174 216  71],416,5,13661,4.1073361395069155,20.0,0.0
43326,4,3326,[100 546 294  96 111],49,1,13662,4.106402164111812,0.0,0.0
43327,4,3327,[289 132 121 143 403],416,4,13666,4.1063701923076925,0.0,0.0
43328,4,3328,[ 15 179 181 191 118],128,4,13670,4.106338239711625,0.0,20.0
43329,4,3329,[ 69 323  15 678 153],416,3,13673,4.106006006006006,0.0,0.0
43330,4,3330,[313  64 483 318  11],618,5,13678,4.106274392074452,80.0,20.0
43331,4,3331,[ 11  96 483 179 125],417,4,13682,4.106242496998799,20.0,0.0
43332,4,3332,[313  64 483 318  11],214,5,13687,4.106510651065107,80.0,20.0
43333,4,3333,[313  64 483 318  11],618,5,13692,4.106778644271146,80.0,20.0
43334,4,3334,[ 56 286 742 238 197],297,3,13695,4.106446776611694,0.0,0.0
43335,4,3335,[ 50   1 245   7 475],416,3,13698,4.106115107913669,0.0,20.0
43336,4,3336,[ 56 176  70 183 435],437,1,13699,4.1051842972729995,0.0,0.0
43337,4,3337,[597  11 111 151  12],654,5,13704,4.105452366686639,20.0,0.0
43338,4,3338,[173 328 151  12 200],416,4,13708,4.105420784666068,20.0,0.0
43339,4,3339,[405  95  64  98 546],416,3,13711,4.105089820359281,20.0,20.0
43340,4,3340,[313  64 483 318  11],214,5,13716,4.105357677342113,80.0,20.0
43341,4,3341,[471 328 245 496 121],128,3,13719,4.1050269299820465,0.0,0.0
43342,4,3342,[313  64 483 318  11],214,5,13724,4.105294645527969,80.0,20.0
43343,4,3343,[313  64 483 318  11],618,5,13729,4.105562200956938,80.0,20.0
43344,4,3344,[313  64 483 318  11],618,5,13734,4.105829596412556,80.0,20.0
43345,4,3345,[ 98 300 294 179 245],128,3,13737,4.105499103407054,0.0,20.0
43346,4,3346,[313  64 483 318  11],618,5,13742,4.105766357932477,80.0,20.0
43347,4,3347,[282  97 173 183  95],416,4,13746,4.10573476702509,0.0,0.0
43348,4,3348,[182  69 127  97  22],505,2,13748,4.1051060017915795,0.0,0.0
43349,4,3349,[313  64 483 318  11],214,5,13753,4.105373134328358,80.0,20.0
43350,4,3350,[288 302 121 294 181],654,2,13755,4.1047448522829,0.0,40.0
43351,4,3351,[597 211  12  88 403],416,3,13758,4.104415274463007,20.0,0.0
43352,4,3352,[313  64 483 318  11],214,5,13763,4.104682373993438,80.0,20.0
43353,4,3353,[313  64 483 318  11],214,5,13768,4.10494931425164,80.0,20.0
43354,4,3354,[313  64 483 318  11],214,5,13773,4.10521609538003,80.0,20.0
43355,4,3355,[313  64 483 318  11],618,5,13778,4.105482717520858,80.0,20.0
43356,4,3356,[423 385 111 151  25],417,3,13781,4.105153410783438,0.0,0.0
43357,4,3357,[183 322  88 568 271],805,1,13782,4.104228707564026,0.0,0.0
43358,4,3358,[568 172  88 173 197],405,4,13786,4.104197677880322,0.0,0.0
43359,4,3359,[ 11 258 111  50 357],805,2,13788,4.103571428571429,0.0,20.0
43360,4,3360,[313  64 483 318  11],618,5,13793,4.1038381434097,80.0,20.0
43361,4,3361,[ 95 204 143 174 202],922,3,13796,4.10350981558596,0.0,0.0
43362,4,3362,[258 111  50  12 300],345,4,13800,4.103479036574487,20.0,20.0
43363,4,3363,[ 22  50 496 195 588],262,3,13803,4.103151010701546,0.0,20.0
43364,4,3364,[ 70 288 215 118 151],618,1,13804,4.10222882615156,0.0,20.0
43365,4,3365,[  7 546 678 357 117],416,3,13807,4.101901366607249,0.0,0.0
43366,4,3366,[275 215 597 655 172],416,4,13811,4.101871101871102,0.0,0.0
43367,4,3367,[313  64 483 318  11],618,5,13816,4.102137767220903,80.0,20.0
43368,4,3368,[313  64 483 318  11],618,5,13821,4.102404274265361,80.0,20.0
43369,4,3369,[313  64 483 318  11],214,5,13826,4.102670623145401,80.0,20.0
43370,4,3370,[313  64 483 318  11],618,5,13831,4.1029368140017795,80.0,20.0
43371,4,3371,[180  15  69 235 228],62,3,13834,4.102609727164888,0.0,0.0
43372,4,3372,[216 546 185 172 191],417,1,13835,4.101689890305366,0.0,0.0
43373,4,3373,[ 56  64 237 143 111],345,5,13840,4.1019561351511555,20.0,0.0
43374,4,3374,[313  64 483 318  11],214,5,13845,4.102222222222222,80.0,20.0
43375,4,3375,[313  64 483 318  11],214,5,13850,4.1024881516587675,80.0,20.0
43376,4,3376,[  4 471 313 286  88],416,4,13854,4.102457802783536,20.0,20.0
43377,4,3377,[508 132 273 118 471],854,3,13857,4.102131438721137,0.0,0.0
43378,4,3378,[313  64 483 318  11],618,5,13862,4.102397158922758,80.0,20.0
43379,4,3379,[313  64 483 318  11],618,5,13867,4.102662721893491,80.0,20.0
43380,4,3380,[748 118 135 257  15],642,3,13870,4.1023365868086366,0.0,0.0
43381,4,3381,[313  64 483 318  11],618,5,13875,4.102602010644589,80.0,20.0
43382,4,3382,[ 56 186 195  25   4],198,2,13877,4.101980490688738,0.0,0.0
43383,4,3383,[313  64 483 318  11],618,5,13882,4.1022458628841605,80.0,20.0
43384,4,3384,[313  64 483 318  11],618,5,13887,4.102511078286558,80.0,20.0
43385,4,3385,[117   9 496   1 143],43,5,13892,4.10277613703485,0.0,0.0
43386,4,3386,[ 70  95 216 125 204],314,3,13895,4.102450546206082,0.0,0.0
43387,4,3387,[748 179 483 237 100],751,3,13898,4.102125147579693,20.0,0.0
43388,4,3388,[210   1  69 153 496],642,4,13902,4.102095013278253,0.0,0.0
43389,4,3389,[168 423 143 597 475],805,2,13904,4.101474926253688,0.0,0.0
43390,4,3390,[  7 215  69 197 100],416,5,13909,4.101739899734592,0.0,0.0
43391,4,3391,[216 161 202  64  98],405,3,13912,4.101415094339623,20.0,20.0
43392,4,3392,[313  64 483 318  11],214,5,13917,4.101679929266136,80.0,20.0
43393,4,3393,[234 210  70 515 185],417,3,13920,4.101355332940483,0.0,0.0
43394,4,3394,[  8  11 121 235 151],854,3,13923,4.101030927835051,0.0,0.0
43395,4,3395,[313  64 483 318  11],618,5,13928,4.101295641931684,80.0,20.0
43396,4,3396,[313  64 483 318  11],618,5,13933,4.1015602001766265,80.0,20.0
43397,4,3397,[132  11   9 288   8],24,3,13936,4.101236021188934,0.0,20.0
43398,4,3398,[313  64 483 318  11],214,5,13941,4.101500441306267,80.0,20.0
43399,4,3399,[196 204 117 258  95],297,3,13944,4.101176470588236,0.0,0.0
43400,4,3400,[179 132  64   1 176],417,5,13949,4.101440752719788,20.0,0.0
43401,4,3401,[ 95 403 151 322 185],416,2,13951,4.100823045267489,0.0,0.0
43402,4,3402,[313  64 483 318  11],214,5,13956,4.101087275933001,80.0,20.0
43403,4,3403,[313  64 483 318  11],214,5,13961,4.101351351351352,80.0,20.0
43404,4,3404,[313  64 483 318  11],618,5,13966,4.101615271659324,80.0,20.0
43405,4,3405,[313  64 483 318  11],214,5,13971,4.101879036993541,80.0,20.0
43406,4,3406,[313  64 483 318  11],618,5,13976,4.102142647490461,80.0,20.0
43407,4,3407,[127 143 153 161  28],416,5,13981,4.102406103286385,0.0,0.0
43408,4,3408,[313  64 483 318  11],618,5,13986,4.102669404517454,80.0,20.0
43409,4,3409,[121 235 655 181  56],805,1,13987,4.101759530791789,0.0,20.0
43410,4,3410,[313  64 483 318  11],214,5,13992,4.102022867194371,80.0,20.0
43411,4,3411,[288  98 196 125   4],342,2,13994,4.101406799531067,0.0,40.0
43412,4,3412,[313  64 483 318  11],618,5,13999,4.101670084969236,80.0,20.0
43413,4,3413,[313  64 483 318  11],214,5,14004,4.101933216168717,80.0,20.0
43414,4,3414,[183 215 204 182 200],198,4,14008,4.10190336749634,0.0,0.0
43415,4,3415,[313  64 483 318  11],618,5,14013,4.102166276346604,80.0,20.0
43416,4,3416,[318 269 322 210 288],416,4,14017,4.1021363769388355,20.0,20.0
43417,4,3417,[313  64 483 318  11],618,5,14022,4.1023990637799885,80.0,20.0
43418,4,3418,[313  64 483 318  11],214,5,14027,4.102661596958175,80.0,20.0
43419,4,3419,[176 282  89  28 100],764,5,14032,4.102923976608187,0.0,0.0
43420,4,3420,[313  64 483 318  11],618,5,14037,4.103186202864659,80.0,20.0
43421,4,3421,[197 238 179 183 195],405,3,14040,4.102863822326125,0.0,0.0
43422,4,3422,[ 82  71  98 423 471],588,3,14043,4.102541630148992,0.0,20.0
43423,4,3423,[ 95 471 357 269 210],373,4,14047,4.102511682242991,0.0,0.0
43424,4,3424,[313  64 483 318  11],618,5,14052,4.102773722627737,80.0,20.0
43425,4,3425,[313  64 483 318  11],214,5,14057,4.103035610040864,80.0,20.0
43426,4,3426,[322 216  88 268  28],416,3,14060,4.102713743799241,0.0,0.0
43427,4,3427,[121 655 238   4 496],618,3,14063,4.102392065344224,0.0,0.0
43428,4,3428,[211   4  25 288 175],297,3,14066,4.10207057451152,0.0,20.0
43429,4,3429,[269 173   1 117 235],297,3,14069,4.1017492711370265,0.0,0.0
43430,4,3430,[ 12 118 588 174 121],618,4,14073,4.101719615272516,20.0,0.0
43431,4,3431,[286 273  28 597 176],764,4,14077,4.101689976689976,0.0,0.0
43432,4,3432,[288 275 180  11 235],854,4,14081,4.1016603553743085,0.0,20.0
43433,4,3433,[173 235 111 237 185],854,2,14083,4.101048340128131,0.0,0.0
43434,4,3434,[100   7 210 301  50],588,3,14086,4.100727802037846,0.0,20.0
43435,4,3435,[313  64 483 318  11],618,5,14091,4.100989522700815,80.0,20.0
43436,4,3436,[237  50 172 185 176],230,5,14096,4.101251091067792,0.0,20.0
43437,4,3437,[117  98 127  96 176],505,4,14100,4.101221640488657,0.0,20.0
43438,4,3438,[313  64 483 318  11],214,5,14105,4.101482989241059,80.0,20.0
43439,4,3439,[ 79 238 153 318 127],416,5,14110,4.101744186046512,20.0,0.0
43440,4,3440,[313  64 483 318  11],214,5,14115,4.102005231037489,80.0,20.0
43441,4,3441,[238 318 195 118  70],416,4,14119,4.101975595583963,20.0,0.0
43442,4,3442,[185  89 275  11 204],297,4,14123,4.101945977345339,0.0,0.0
43443,4,3443,[546   9 403  22 125],416,4,14127,4.101916376306621,0.0,0.0
43444,4,3444,[313  64 483 318  11],214,5,14132,4.102177068214804,80.0,20.0
43445,4,3445,[313  64 483 318  11],618,5,14137,4.102437608821822,80.0,20.0
43446,4,3446,[313  64 483 318  11],618,5,14142,4.102697998259356,80.0,20.0
43447,4,3447,[313  64 483 318  11],214,5,14147,4.102958236658933,80.0,20.0
43448,4,3448,[173 143  69 265 435],437,2,14149,4.102348506813569,0.0,0.0
43449,4,3449,[237 323 196 258 257],416,2,14151,4.101739130434782,0.0,0.0
43450,4,3450,[313  64 483 318  11],618,5,14156,4.1019994204578385,80.0,20.0
43451,4,3451,[191  79 655 588  56],417,3,14159,4.101680185399768,0.0,0.0
43452,4,3452,[313  64 483 318  11],214,5,14164,4.101940341731828,80.0,20.0
43453,4,3453,[313  64 483 318  11],618,5,14169,4.1022003474232775,80.0,20.0
43454,4,3454,[ 12 546  15 275 405],416,4,14173,4.102170767004342,20.0,0.0
43455,4,3455,[  8 127 228  28 268],721,5,14178,4.102430555555555,0.0,0.0
43456,4,3456,[ 22 427 111 181  98],711,4,14182,4.102400925658085,0.0,40.0
43457,4,3457,[288 197 655 496  25],618,2,14184,4.101792943898207,0.0,20.0
43458,4,3458,[313  64 483 318  11],618,5,14189,4.10205261636311,80.0,20.0
43459,4,3459,[313  64 483 318  11],618,5,14194,4.1023121387283235,80.0,20.0
43460,4,3460,[  4 276  97 168 204],654,3,14197,4.101993643455649,0.0,0.0
43461,4,3461,[313  64 483 318  11],214,5,14202,4.102253032928942,80.0,20.0
43462,4,3462,[313  64 483 318  11],618,5,14207,4.102512272596015,80.0,20.0
43463,4,3463,[ 56 508 191 175 275],854,5,14212,4.102771362586605,0.0,0.0
43464,4,3464,[313  64 483 318  11],214,5,14217,4.1030303030303035,80.0,20.0
43465,4,3465,[196 257 475 210 215],297,3,14220,4.102712060011541,0.0,0.0
43466,4,3466,[597 385 496 132 121],618,5,14225,4.102970868185752,0.0,0.0
43467,4,3467,[127   4 132 546 245],416,3,14228,4.102652825836217,0.0,0.0
43468,4,3468,[603 265   8  82 175],405,2,14230,4.102046699336984,0.0,0.0
43469,4,3469,[268  50 196 235  69],345,4,14234,4.102017291066282,0.0,20.0
43470,4,3470,[ 50 168   4 111 273],618,3,14237,4.101699798329012,0.0,20.0
43471,4,3471,[117  12 161 471 427],373,4,14241,4.101670506912442,20.0,0.0
43472,4,3472,[168  95  97  71 151],416,3,14244,4.101353296861503,0.0,0.0
43473,4,3473,[  1 678 181 121  69],654,4,14248,4.101324122049511,0.0,20.0
43474,4,3474,[313  64 483 318  11],618,5,14253,4.10158273381295,80.0,20.0
43475,4,3475,[313  64 483 318  11],618,5,14258,4.101841196777905,80.0,20.0
43476,4,3476,[161 294 151   7  95],505,1,14259,4.100949094046592,0.0,0.0
43477,4,3477,[313  64 483 318  11],618,5,14264,4.101207590569293,80.0,20.0
43478,4,3478,[ 98  97  71 237 121],618,5,14269,4.101465938488071,0.0,20.0
43479,4,3479,[313  64 483 318  11],214,5,14274,4.1017241379310345,80.0,20.0
43480,4,3480,[215   1 183  70 300],416,5,14279,4.101982189026142,0.0,0.0
43481,4,3481,[313  64 483 318  11],214,5,14284,4.102240091901206,80.0,20.0
43482,4,3482,[153 100 333 471 271],854,3,14287,4.101923629055412,0.0,0.0
43483,4,3483,[318 204   9 237 118],62,2,14289,4.101320321469575,20.0,0.0
43484,4,3484,[313  64 483 318  11],214,5,14294,4.101578192252511,80.0,20.0
43485,4,3485,[ 97 265 168 186 210],405,2,14296,4.100975329890993,0.0,0.0
43486,4,3486,[313  64 483 318  11],618,5,14301,4.101233151706338,80.0,20.0
43487,4,3487,[313  64 483 318  11],618,5,14306,4.1014908256880735,80.0,20.0
43488,4,3488,[313  64 483 318  11],618,5,14311,4.101748351963313,80.0,20.0
43489,4,3489,[ 11 269 118   7 191],805,3,14314,4.101432664756447,0.0,0.0
43490,4,3490,[211 385  96  89   7],417,3,14317,4.101117158407333,0.0,0.0
43491,4,3491,[ 11 294 151 118 748],805,1,14318,4.1002290950744555,0.0,0.0
43492,4,3492,[216 258 210  50 276],354,2,14320,4.099627827082737,0.0,20.0
43493,4,3493,[ 25 405 210   1  11],751,2,14322,4.099026903262736,0.0,0.0
43494,4,3494,[313  64 483 318  11],214,5,14327,4.09928469241774,80.0,20.0
43495,4,3495,[ 97 597 117 183 235],62,3,14330,4.098970251716247,0.0,0.0
43496,4,3496,[100 258 204 568 318],262,2,14332,4.098370031455533,20.0,0.0
43497,4,3497,[483  97 222  64 313],711,4,14336,4.098341909662665,60.0,20.0
43498,4,3498,[313  64 483 318  11],618,5,14341,4.098599599885682,80.0,20.0
43499,4,3499,[313  64 483 318  11],214,5,14346,4.098857142857143,80.0,20.0
43500,4,3500,[  9 258  50 195 211],698,2,14348,4.098257640674093,0.0,20.0
43501,4,3501,[313  64 483 318  11],618,5,14353,4.098515134209023,80.0,20.0
43502,4,3502,[313  64 483 318  11],214,5,14358,4.098772480730802,80.0,20.0
43503,4,3503,[655 161 603  69 143],416,5,14363,4.099029680365297,0.0,0.0
43504,4,3504,[313  64 483 318  11],618,5,14368,4.099286733238231,80.0,20.0
43505,4,3505,[313  64 483 318  11],618,5,14373,4.099543639475185,80.0,20.0
43506,4,3506,[191 127 655 318 603],373,4,14377,4.099515255203878,20.0,0.0
43507,4,3507,[313  64 483 318  11],214,5,14382,4.099771949828963,80.0,20.0
43508,4,3508,[300  95 121 294 200],416,4,14386,4.099743516671416,0.0,0.0
43509,4,3509,[273  50 179 515 546],416,3,14389,4.099430199430199,0.0,20.0
43510,4,3510,[313  64 483 318  11],618,5,14394,4.0996866989461695,80.0,20.0
43511,4,3511,[302 300 204 294 176],416,5,14399,4.0999430523918,0.0,0.0
43512,4,3512,[423 100   4 238 216],62,4,14403,4.099914602903501,0.0,0.0
43513,4,3513,[191 168 173   1 175],297,3,14406,4.099601593625498,0.0,0.0
43514,4,3514,[191 275 216 234 289],416,4,14410,4.099573257467994,0.0,0.0
43515,4,3515,[111  97 216 215 403],618,3,14413,4.099260523321957,0.0,0.0
43516,4,3516,[313  64 483 318  11],618,5,14418,4.0995166334944555,80.0,20.0
43517,4,3517,[313  64 483 318  11],618,5,14423,4.099772598067084,80.0,20.0
43518,4,3518,[  4  11  50 194  15],854,2,14425,4.099175902244956,0.0,20.0
43519,4,3519,[ 88 678  70 508 172],345,4,14429,4.099147727272728,0.0,0.0
43520,4,3520,[597 127 200   9 187],416,4,14433,4.099119568304459,0.0,0.0
43521,4,3521,[  4 357 288 238 183],297,3,14436,4.098807495741056,0.0,20.0
43522,4,3522,[173  71 191 100  82],805,3,14439,4.098495600340619,0.0,0.0
43523,4,3523,[118  79 235 322 210],416,2,14441,4.097900113507378,0.0,0.0
43524,4,3524,[313  64 483 318  11],618,5,14446,4.098156028368794,80.0,20.0
43525,4,3525,[172  50 282  71 118],618,3,14449,4.097844583096994,0.0,20.0
43526,4,3526,[313  64 483 318  11],618,5,14454,4.0981003685852,80.0,20.0
43527,4,3527,[313  64 483 318  11],214,5,14459,4.098356009070295,80.0,20.0
43528,4,3528,[427 191 111 288   9],416,5,14464,4.098611504675546,0.0,20.0
43529,4,3529,[313  64 483 318  11],618,5,14469,4.098866855524079,80.0,20.0
43530,4,3530,[ 71 234 301 183 215],416,5,14474,4.099122061738885,0.0,0.0
43531,4,3531,[161 403 603 238 173],805,4,14478,4.099093997734994,0.0,0.0
43532,4,3532,[313  64 483 318  11],214,5,14483,4.099348995188225,80.0,20.0
43533,4,3533,[294 151 286 588 237],43,5,14488,4.099603848330504,0.0,0.0
43534,4,3534,[  8 423  22 282 200],854,3,14491,4.0992927864215,0.0,0.0
43535,4,3535,[276 475 144 215  71],62,3,14494,4.098981900452489,0.0,0.0
43536,4,3536,[313  64 483 318  11],214,5,14499,4.099236641221374,80.0,20.0
43537,4,3537,[508 300  15  82 742],654,3,14502,4.098925946862634,0.0,0.0
43538,4,3538,[ 56 265 182 282 289],416,4,14506,4.098897993783555,0.0,0.0
43539,4,3539,[313  64 483 318  11],618,5,14511,4.099152542372881,80.0,20.0
43540,4,3540,[385 427 175 603 216],405,1,14512,4.098277322790172,0.0,0.0
43541,4,3541,[313  64 483 318  11],618,5,14517,4.098531902879729,80.0,20.0
43542,4,3542,[151 603 215 328 471],416,4,14521,4.0985040925769125,0.0,0.0
43543,4,3543,[153 179 125 427 385],373,3,14524,4.098194130925508,0.0,0.0
43544,4,3544,[496  88  97 385 195],416,4,14528,4.0981664315937945,0.0,0.0
43545,4,3545,[222 238 508  25  95],417,2,14530,4.0975747320924985,0.0,0.0
43546,4,3546,[313  64 483 318  11],214,5,14535,4.097829151395546,80.0,20.0
43547,4,3547,[275 289 294 588  64],764,4,14539,4.0978015783540025,20.0,0.0
43548,4,3548,[185 269 655 258 174],354,3,14542,4.097492251338405,0.0,0.0
43549,4,3549,[313  64 483 318  11],214,5,14547,4.09774647887324,80.0,20.0
43550,4,3550,[427 179 100 234 423],262,3,14550,4.097437341593917,0.0,0.0
43551,4,3551,[  9 175 222 183 204],805,3,14553,4.097128378378378,0.0,0.0
43552,4,3552,[301  95  50 269 175],43,4,14557,4.097101041373487,0.0,20.0
43553,4,3553,[568 385   8 211 258],43,5,14562,4.097355092853123,0.0,0.0
43554,4,3554,[597  82 742  88 496],588,4,14566,4.09732770745429,0.0,0.0
43555,4,3555,[269 318 238 603 100],416,5,14571,4.097581552305962,20.0,0.0
43556,4,3556,[313  64 483 318  11],214,5,14576,4.097835254427888,80.0,20.0
43557,4,3557,[313  64 483 318  11],618,5,14581,4.098088813940416,80.0,20.0
43558,4,3558,[313  64 483 318  11],214,5,14586,4.098342230963754,80.0,20.0
43559,4,3559,[515  64 211 144 200],417,4,14590,4.098314606741573,20.0,0.0
43560,4,3560,[588 118 222 282 151],654,3,14593,4.098006178039877,0.0,0.0
43561,4,3561,[258 182  15 144 496],416,5,14598,4.098259404828748,0.0,0.0
43562,4,3562,[ 64 405 427 216  11],198,4,14602,4.098231827111984,20.0,0.0
43563,4,3563,[313  64 483 318  11],618,5,14607,4.098484848484849,80.0,20.0
43564,4,3564,[742 200   7 117 195],854,2,14609,4.097896213183731,0.0,0.0
43565,4,3565,[313  64 483 318  11],618,5,14614,4.098149186763881,80.0,20.0
43566,4,3566,[313  64 483 318  11],214,5,14619,4.098402018502943,80.0,20.0
43567,4,3567,[313  64 483 318  11],214,5,14624,4.098654708520179,80.0,20.0
43568,4,3568,[174 191 515  97 118],417,4,14628,4.098627066405156,0.0,0.0
43569,4,3569,[161 655 588 127 202],416,5,14633,4.098879551820728,0.0,0.0
43570,4,3570,[597 185 235  96  71],805,2,14635,4.098291795015402,0.0,0.0
43571,4,3571,[ 70 300 302 210  56],297,4,14639,4.098264277715566,0.0,0.0
43572,4,3572,[313  64 483 318  11],214,5,14644,4.098516652672824,80.0,20.0
43573,4,3573,[195 742 135 300 269],297,2,14646,4.097929490766648,0.0,0.0
43574,4,3574,[ 56   4 588   8  71],405,3,14649,4.097622377622377,0.0,0.0
43575,4,3575,[ 15 318  25 237 191],52,5,14654,4.097874720357942,20.0,0.0
43576,4,3576,[313  64 483 318  11],214,5,14659,4.098126922001677,80.0,20.0
43577,4,3577,[385 191 655 471 174],618,4,14663,4.098099496925657,0.0,0.0
43578,4,3578,[ 96 161  15 125 385],417,3,14666,4.097792679519419,0.0,0.0
43579,4,3579,[301 151 258 125  56],588,4,14670,4.097765363128492,0.0,0.0
43580,4,3580,[268 161 294 302 328],49,1,14671,4.0969003071767665,0.0,0.0
43581,4,3581,[313  64 483 318  11],214,5,14676,4.097152428810721,80.0,20.0
43582,4,3582,[313  64 483 318  11],214,5,14681,4.0974044097125315,80.0,20.0
43583,4,3583,[237 568  12  96 125],416,4,14685,4.097377232142857,20.0,0.0
43584,4,3584,[313  64 483 318  11],214,5,14690,4.097629009762901,80.0,20.0
43585,4,3585,[313  64 483 318  11],618,5,14695,4.097880646960402,80.0,20.0
43586,4,3586,[ 56 268 127 245 742],416,4,14699,4.09785335935322,0.0,0.0
43587,4,3587,[ 64 215 200 204  56],618,4,14703,4.0978260869565215,20.0,0.0
43588,4,3588,[313  64 483 318  11],618,5,14708,4.0980774589022015,80.0,20.0
43589,4,3589,[313  64 483 318  11],618,5,14713,4.0983286908078,80.0,20.0
43590,4,3590,[508 222 238 143  22],654,4,14717,4.098301308827625,0.0,0.0
43591,4,3591,[385  56 588 121 423],49,2,14719,4.09771714922049,0.0,0.0
43592,4,3592,[151  15 125 301  25],588,4,14723,4.097689952685778,0.0,0.0
43593,4,3593,[172 282 175 125 173],721,4,14727,4.097662771285476,0.0,0.0
43594,4,3594,[313  64 483 318  11],618,5,14732,4.0979137691237835,80.0,20.0
43595,4,3595,[210 185  64 168 318],601,5,14737,4.0981646273637375,40.0,0.0
43596,4,3596,[357 597  50  89  11],854,4,14741,4.0981373366694465,0.0,20.0
43597,4,3597,[257 181 191 423   7],354,4,14745,4.09811006114508,0.0,20.0
43598,4,3598,[288 172 202 323  71],416,4,14749,4.098082800777994,0.0,20.0
43599,4,3599,[202   7 237 216 144],43,5,14754,4.098333333333334,0.0,0.0
43600,4,3600,[216 181 132 568  25],588,5,14759,4.0985837267425715,0.0,20.0
43601,4,3601,[269  11  22 173 144],654,5,14764,4.098833981121599,0.0,0.0
43602,4,3602,[313  64 483 318  11],618,5,14769,4.099084096586179,80.0,20.0
43603,4,3603,[313  64 483 318  11],214,5,14774,4.099334073251942,80.0,20.0
43604,4,3604,[313  64 483 318  11],618,5,14779,4.099583911234396,80.0,20.0
43605,4,3605,[313  64 483 318  11],618,5,14784,4.099833610648918,80.0,20.0
43606,4,3606,[211 271 196 301 216],297,4,14788,4.099805932908234,0.0,0.0
43607,4,3607,[ 70   7 288 423 216],417,2,14790,4.099223946784923,0.0,20.0
43608,4,3608,[313  64 483 318  11],214,5,14795,4.099473538376282,80.0,20.0
43609,4,3609,[173 294 174 471  69],854,2,14797,4.098891966759003,0.0,0.0
43610,4,3610,[313  64 483 318  11],214,5,14802,4.099141512046525,80.0,20.0
43611,4,3611,[211 276  70 322 385],416,3,14805,4.098837209302325,0.0,0.0
43612,4,3612,[313  64 483 318  11],618,5,14810,4.099086631608082,80.0,20.0
43613,4,3613,[313  64 483 318  11],214,5,14815,4.099335915882678,80.0,20.0
43614,4,3614,[  8  89   9  64 258],62,5,14820,4.0995850622406635,20.0,0.0
43615,4,3615,[313  64 483 318  11],618,5,14825,4.09983407079646,80.0,20.0
43616,4,3616,[313  64 483 318  11],214,5,14830,4.100082941664363,80.0,20.0
43617,4,3617,[313  64 483 318  11],214,5,14835,4.10033167495854,80.0,20.0
43618,4,3618,[313  64 483 318  11],214,5,14840,4.100580270793037,80.0,20.0
43619,4,3619,[313  64 483 318  11],618,5,14845,4.100828729281768,80.0,20.0
43620,4,3620,[118  70 174 742  22],654,4,14849,4.1008008837337755,0.0,0.0
43621,4,3621,[143  98 282  71 742],345,3,14852,4.100496963003866,0.0,20.0
43622,4,3622,[187 323 121   9 215],416,4,14856,4.100469224399669,0.0,0.0
43623,4,3623,[  9  56 161 742  25],314,3,14859,4.100165562913907,0.0,0.0
43624,4,3624,[185 742 235   4  56],416,4,14863,4.1001379310344825,0.0,0.0
43625,4,3625,[313  64 483 318  11],214,5,14868,4.100386100386101,80.0,20.0
43626,4,3626,[423 237  25 176 475],854,2,14870,4.09980700303281,0.0,0.0
43627,4,3627,[313  64 483 318  11],214,5,14875,4.100055126791621,80.0,20.0
43628,4,3628,[313  64 483 318  11],214,5,14880,4.100303113805456,80.0,20.0
43629,4,3629,[313  64 483 318  11],618,5,14885,4.1005509641873275,80.0,20.0
43630,4,3630,[313  64 483 318  11],618,5,14890,4.100798678050124,80.0,20.0
43631,4,3631,[117   9  56 258  22],62,5,14895,4.101046255506608,0.0,0.0
43632,4,3632,[313  64 483 318  11],618,5,14900,4.101293696669419,80.0,20.0
43633,4,3633,[  1  70 172 294 111],49,0,14900,4.100165107319758,0.0,0.0
43634,4,3634,[313  64 483 318  11],214,5,14905,4.100412654745529,80.0,20.0
43635,4,3635,[313  64 483 318  11],618,5,14910,4.100660066006601,80.0,20.0
43636,4,3636,[ 97 275  50 176 282],270,4,14914,4.100632389331867,0.0,20.0
43637,4,3637,[ 11 121 118 603 181],437,2,14916,4.100054975261132,0.0,20.0
43638,4,3638,[313  64 483 318  11],618,5,14921,4.100302280846386,80.0,20.0
43639,4,3639,[313  64 483 318  11],214,5,14926,4.10054945054945,80.0,20.0
43640,4,3640,[222 195 172 204  89],698,4,14930,4.100521834660808,0.0,0.0
43641,4,3641,[257   1 168 143 286],43,5,14935,4.100768808347062,0.0,0.0
43642,4,3642,[313  64 483 318  11],618,5,14940,4.101015646445237,80.0,20.0
43643,4,3643,[313  64 483 318  11],214,5,14945,4.1012623490669595,80.0,20.0
43644,4,3644,[313  64 483 318  11],618,5,14950,4.1015089163237315,80.0,20.0
43645,4,3645,[179 118  95   8 197],437,4,14954,4.101481075150851,0.0,0.0
43646,4,3646,[427 135 161  70 210],198,3,14957,4.101179051275021,0.0,0.0
43647,4,3647,[ 69  96 427 603  22],373,5,14962,4.1014254385964914,0.0,0.0
43648,4,3648,[161 405 172   7 273],417,0,14962,4.100301452452727,0.0,0.0
43649,4,3649,[117 143 222 216 268],297,5,14967,4.10054794520548,0.0,0.0
43650,4,3650,[313  64 483 318  11],214,5,14972,4.100794302930704,80.0,20.0
43651,4,3651,[ 22 135 172  97 144],62,3,14975,4.100492880613363,0.0,0.0
43652,4,3652,[313  64 483 318  11],214,5,14980,4.1007391185327124,80.0,20.0
43653,4,3653,[313  64 483 318  11],214,5,14985,4.100985221674877,80.0,20.0
43654,4,3654,[423 597 144 302  56],654,5,14990,4.101231190150479,0.0,0.0
43655,4,3655,[271 176 323 174   9],805,2,14992,4.100656455142232,0.0,0.0
43656,4,3656,[313  64 483 318  11],214,5,14997,4.10090237899918,80.0,20.0
43657,4,3657,[216 322 174   8 328],416,4,15001,4.100874794969929,0.0,0.0
43658,4,3658,[200 258  96 294 118],417,4,15005,4.100847226018038,0.0,0.0
43659,4,3659,[405 100 204 185 210],805,2,15007,4.100273224043716,0.0,0.0
43660,4,3660,[183 186 385  69  95],230,3,15010,4.099972685058727,0.0,0.0
43661,4,3661,[175 288 265 153 117],297,3,15013,4.099672310212998,0.0,20.0
43662,4,3662,[313  64 483 318  11],214,5,15018,4.0999180999181,80.0,20.0
43663,4,3663,[ 95 153 289 265  28],416,3,15021,4.099617903930131,0.0,0.0
43664,4,3664,[ 96 197 273  97 132],416,5,15026,4.0998635743519785,0.0,0.0
43665,4,3665,[238  96 333 268  97],416,5,15031,4.100109110747408,0.0,0.0
43666,4,3666,[313  64 483 318  11],214,5,15036,4.10035451322607,80.0,20.0
43667,4,3667,[588 211 258 175 357],698,2,15038,4.099781897491821,0.0,0.0
43668,4,3668,[245 273 191 135 222],297,3,15041,4.099482147724175,0.0,0.0
43669,4,3669,[ 56 268 678  50 265],297,3,15044,4.099182561307902,0.0,20.0
43670,4,3670,[216 275 322  15 191],854,2,15046,4.0986107327703625,0.0,0.0
43671,4,3671,[245   1 275 183 301],297,3,15049,4.098311546840959,0.0,0.0
43672,4,3672,[313  64 483 318  11],214,5,15054,4.098557037843724,80.0,20.0
43673,4,3673,[ 97  70 125 323  95],416,3,15057,4.098258029395754,0.0,0.0
43674,4,3674,[313  64 483 318  11],618,5,15062,4.098503401360544,80.0,20.0
43675,4,3675,[118 588 471 100 144],618,3,15065,4.098204570184984,0.0,0.0
43676,4,3676,[313  64 483 318  11],214,5,15070,4.098449823225455,80.0,20.0
43677,4,3677,[313  64 483 318  11],214,5,15075,4.0986949429037525,80.0,20.0
43678,4,3678,[ 56 143  50 204 187],198,3,15078,4.0983963033433,0.0,20.0
43679,4,3679,[313  64 483 318  11],214,5,15083,4.098641304347826,80.0,20.0
43680,4,3680,[313  64 483 318  11],214,5,15088,4.098886172235805,80.0,20.0
43681,4,3681,[313  64 483 318  11],618,5,15093,4.099130907115698,80.0,20.0
43682,4,3682,[265  70  82   7 111],416,5,15098,4.099375509095846,0.0,0.0
43683,4,3683,[313  64 483 318  11],214,5,15103,4.0996199782844736,80.0,20.0
43684,4,3684,[313  64 483 318  11],618,5,15108,4.099864314789688,80.0,20.0
43685,4,3685,[313  64 483 318  11],618,5,15113,4.1001085187194795,80.0,20.0
43686,4,3686,[183 568 603  64  56],416,5,15118,4.1003525901817195,20.0,0.0
43687,4,3687,[313  64 483 318  11],214,5,15123,4.100596529284165,80.0,20.0
43688,4,3688,[ 50 235 245 322 194],416,2,15125,4.10002710761724,0.0,20.0
43689,4,3689,[286 191 228   1 471],705,2,15127,4.099457994579946,0.0,0.0
43690,4,3690,[546 568  69 275 121],416,4,15131,4.099431048496342,0.0,0.0
43691,4,3691,[ 89 322 172  69 125],417,2,15133,4.098862405200434,0.0,0.0
43692,4,3692,[313  64 483 318  11],214,5,15138,4.09910641754671,80.0,20.0
43693,4,3693,[313  64 483 318  11],618,5,15143,4.099350297780184,80.0,20.0
43694,4,3694,[313  64 483 318  11],618,5,15148,4.099594046008119,80.0,20.0
43695,4,3695,[313  64 483 318  11],618,5,15153,4.099837662337662,80.0,20.0
43696,4,3696,[185 385   7 257  82],417,2,15155,4.099269678117392,0.0,0.0
43697,4,3697,[313  64 483 318  11],618,5,15160,4.099513250405625,80.0,20.0
43698,4,3698,[265 748 333   7 168],416,5,15165,4.099756690997567,0.0,0.0
43699,4,3699,[313  64 483 318  11],214,5,15170,4.1,80.0,20.0
43700,4,3700,[191 172 427  28 117],373,4,15174,4.099972980275601,0.0,0.0
43701,4,3701,[143  69 181 179  96],373,3,15177,4.09967585089141,0.0,20.0
43702,4,3702,[245  11 210  88 603],416,3,15180,4.099378881987578,0.0,0.0
43703,4,3703,[313  64 483 318  11],618,5,15185,4.099622030237581,80.0,20.0
43704,4,3704,[ 50 265  70 268 202],297,3,15188,4.099325236167341,0.0,20.0
43705,4,3705,[ 22 603 302 153 181],297,5,15193,4.099568267674042,0.0,20.0
43706,4,3706,[313  64 483 318  11],618,5,15198,4.099811168060426,80.0,20.0
43707,4,3707,[313  64 483 318  11],214,5,15203,4.100053937432579,80.0,20.0
43708,4,3708,[405 204  22 100 234],601,2,15205,4.099487732542464,0.0,0.0
43709,4,3709,[313  64 483 318  11],618,5,15210,4.099730458221024,80.0,20.0
43710,4,3710,[313  64 483 318  11],618,5,15215,4.099973053085422,80.0,20.0
43711,4,3711,[216 151 210  56 257],416,3,15218,4.099676724137931,0.0,0.0
43712,4,3712,[313  64 483 318  11],214,5,15223,4.09991920280097,80.0,20.0
43713,4,3713,[ 15   9 121  56 172],601,2,15225,4.099353796445881,0.0,0.0
43714,4,3714,[313  64 483 318  11],618,5,15230,4.099596231493943,80.0,20.0
43715,4,3715,[313  64 483 318  11],618,5,15235,4.09983853606028,80.0,20.0
43716,4,3716,[313  64 483 318  11],214,5,15240,4.100080710250202,80.0,20.0
43717,4,3717,[ 15 185  82 268 235],416,4,15244,4.100053792361485,0.0,0.0
43718,4,3718,[313  64 483 318  11],214,5,15249,4.100295778435063,80.0,20.0
43719,4,3719,[313  64 483 318  11],214,5,15254,4.100537634408602,80.0,20.0
43720,4,3720,[265   4  79 195  82],405,4,15258,4.100510615425961,0.0,0.0
43721,4,3721,[ 11 127  15 143 111],618,3,15261,4.100214938205266,0.0,0.0
43722,4,3722,[313  64 483 318  11],214,5,15266,4.100456621004566,80.0,20.0
43723,4,3723,[678 211 127 173 132],416,4,15270,4.100429645542428,0.0,0.0
43724,4,3724,[313  64 483 318  11],214,5,15275,4.100671140939597,80.0,20.0
43725,4,3725,[313  64 483 318  11],214,5,15280,4.100912506709608,80.0,20.0
43726,4,3726,[328  98 196 289 423],43,5,15285,4.101153742956802,0.0,20.0
43727,4,3727,[ 79 202  89 403 186],405,4,15289,4.10112660944206,0.0,0.0
43728,4,3728,[313  64 483 318  11],214,5,15294,4.1013676588897825,80.0,20.0
43729,4,3729,[313  64 483 318  11],618,5,15299,4.101608579088472,80.0,20.0
43730,4,3730,[471 508 161 117   1],345,2,15301,4.101045296167247,0.0,0.0
43731,4,3731,[144  82 216 423 568],711,1,15302,4.10021436227224,0.0,0.0
43732,4,3732,[313  64 483 318  11],618,5,15307,4.100455397803375,80.0,20.0
43733,4,3733,[313  64 483 318  11],214,5,15312,4.100696304231387,80.0,20.0
43734,4,3734,[191   4 742 185 234],805,3,15315,4.100401606425703,0.0,0.0
43735,4,3735,[237 135 117 282  25],297,4,15319,4.100374732334047,0.0,0.0
43736,4,3736,[313  64 483 318  11],214,5,15324,4.1006154669521,80.0,20.0
43737,4,3737,[210 211 182 179  96],405,1,15325,4.099785981808454,0.0,0.0
43738,4,3738,[313  64 483 318  11],214,5,15330,4.100026745119016,80.0,20.0
43739,4,3739,[301 204 202 245 182],297,1,15331,4.099197860962567,0.0,0.0
43740,4,3740,[313  64 483 318  11],214,5,15336,4.09943865276664,80.0,20.0
43741,4,3741,[301 216 222 172 322],721,5,15341,4.099679315873864,0.0,0.0
43742,4,3742,[151  22 271 357  96],854,3,15344,4.099385519636655,0.0,0.0
43743,4,3743,[161 200   7 403 210],618,4,15348,4.0993589743589745,0.0,0.0
43744,4,3744,[269  98  70 268 237],416,4,15352,4.099332443257677,0.0,20.0
43745,4,3745,[313  64 483 318  11],618,5,15357,4.099572877736252,80.0,20.0
43746,4,3746,[313  64 483 318  11],214,5,15362,4.099813183880437,80.0,20.0
43747,4,3747,[313  64 483 318  11],214,5,15367,4.100053361792956,80.0,20.0
43748,4,3748,[ 15 655 403 100 357],62,3,15370,4.099759935982929,0.0,0.0
43749,4,3749,[ 79 403 173 268 194],416,5,15375,4.1,0.0,0.0
43750,4,3750,[313  64 483 318  11],618,5,15380,4.100239936017062,80.0,20.0
43751,4,3751,[313  64 483 318  11],214,5,15385,4.100479744136461,80.0,20.0
43752,4,3752,[210  12 333   1  50],416,5,15390,4.100719424460432,20.0,20.0
43753,4,3753,[313  64 483 318  11],214,5,15395,4.100958977091103,80.0,20.0
43754,4,3754,[496 245 111 202 275],416,4,15399,4.100932090545939,0.0,0.0
43755,4,3755,[313  64 483 318  11],214,5,15404,4.101171458998935,80.0,20.0
43756,4,3756,[313  64 483 318  11],214,5,15409,4.101410700026617,80.0,20.0
43757,4,3757,[313  64 483 318  11],618,5,15414,4.101649813730708,80.0,20.0
43758,4,3758,[181 211  15 183 483],417,4,15418,4.101622772013833,20.0,20.0
43759,4,3759,[191 269 238 181 153],416,5,15423,4.1018617021276595,0.0,20.0
43760,4,3760,[313  64 483 318  11],618,5,15428,4.102100505184791,80.0,20.0
43761,4,3761,[313  64 483 318  11],618,5,15433,4.10233918128655,80.0,20.0
43762,4,3762,[237  69 168 300 143],198,2,15435,4.101780494286474,0.0,0.0
43763,4,3763,[179 655 191 151 238],437,5,15440,4.10201912858661,0.0,0.0
43764,4,3764,[313  64 483 318  11],618,5,15445,4.102257636122178,80.0,20.0
43765,4,3765,[496  88 216 196  64],314,3,15448,4.101964949548592,20.0,0.0
43766,4,3766,[268 588 257 195 302],416,4,15452,4.101937881603398,0.0,0.0
43767,4,3767,[313  64 483 318  11],214,5,15457,4.102176220806794,80.0,20.0
43768,4,3768,[118   9 276 289 174],764,3,15460,4.101883788803396,0.0,0.0
43769,4,3769,[313  64 483 318  11],214,5,15465,4.1021220159151195,80.0,20.0
43770,4,3770,[313  64 483 318  11],214,5,15470,4.102360116679926,80.0,20.0
43771,4,3771,[302 210   1  69 222],417,1,15471,4.1015376458112405,0.0,0.0
43772,4,3772,[191 100 161  25  70],198,1,15472,4.100715610919693,0.0,0.0
43773,4,3773,[313  64 483 318  11],214,5,15477,4.100953895071542,80.0,20.0
43774,4,3774,[173 546 210 257  11],43,5,15482,4.1011920529801325,0.0,0.0
43775,4,3775,[238 210 286  50 275],437,3,15485,4.100900423728813,0.0,20.0
43776,4,3776,[313  64 483 318  11],618,5,15490,4.101138469684935,80.0,20.0
43777,4,3777,[144 222 195 603  70],297,3,15493,4.10084700899947,0.0,0.0
43778,4,3778,[313  64 483 318  11],214,5,15498,4.101084943106642,80.0,20.0
43779,4,3779,[ 71 423 127 202 742],38,3,15501,4.10079365079365,0.0,0.0
43780,4,3780,[313  64 483 318  11],214,5,15506,4.10103147315525,80.0,20.0
43781,4,3781,[546 300 302 237 222],654,5,15511,4.101269169751454,0.0,0.0
43782,4,3782,[183 215 187 174 153],416,5,15516,4.101506740681998,0.0,0.0
43783,4,3783,[313  64 483 318  11],214,5,15521,4.101744186046512,80.0,20.0
43784,4,3784,[313  64 483 318  11],618,5,15526,4.101981505944518,80.0,20.0
43785,4,3785,[210 186  64 127 269],373,4,15530,4.101954569466455,20.0,0.0
43786,4,3786,[313  64 483 318  11],214,5,15535,4.102191708476367,80.0,20.0
43787,4,3787,[313  64 483 318  11],618,5,15540,4.102428722280887,80.0,20.0
43788,4,3788,[313  64 483 318  11],214,5,15545,4.10266561097915,80.0,20.0
43789,4,3789,[282 269 475  12 508],297,4,15549,4.102638522427441,20.0,0.0
43790,4,3790,[135 127 144 176  88],618,5,15554,4.102875230809813,0.0,0.0
43791,4,3791,[313  64 483 318  11],618,5,15559,4.103111814345992,80.0,20.0
43792,4,3792,[313  64 483 318  11],214,5,15564,4.1033482731347215,80.0,20.0
43793,4,3793,[204 121   4 185 172],618,3,15567,4.10305745914602,0.0,0.0
43794,4,3794,[313  64 483 318  11],618,5,15572,4.103293807641633,80.0,20.0
43795,4,3795,[273 333 173 655 175],253,2,15574,4.102739726027397,0.0,0.0
43796,4,3796,[294 301 678 210 191],345,3,15577,4.10244930208059,0.0,0.0
43797,4,3797,[313  64 483 318  11],618,5,15582,4.102685624012638,80.0,20.0
43798,4,3798,[282  50   1 111  11],416,5,15587,4.102921821531982,0.0,20.0
43799,4,3799,[313  64 483 318  11],214,5,15592,4.103157894736842,80.0,20.0
43800,4,3800,[313  64 483 318  11],618,5,15597,4.103393843725335,80.0,20.0
43801,4,3801,[313  64 483 318  11],618,5,15602,4.103629668595476,80.0,20.0
43802,4,3802,[313  64 483 318  11],214,5,15607,4.103865369445175,80.0,20.0
43803,4,3803,[313  56 197  69 151],345,5,15612,4.10410094637224,20.0,20.0
43804,4,3804,[174 234 161 742  12],805,2,15614,4.103547963206307,20.0,0.0
43805,4,3805,[313  64 483 318  11],618,5,15619,4.103783499737257,80.0,20.0
43806,4,3806,[385 748 118  89  97],417,5,15624,4.1040189125295505,0.0,0.0
43807,4,3807,[121  97 276 176  98],198,2,15626,4.103466386554622,0.0,20.0
43808,4,3808,[211 286 111 257 174],417,2,15628,4.102914150695721,0.0,0.0
43809,4,3809,[187 215 748 333 546],416,4,15632,4.102887139107612,0.0,0.0
43810,4,3810,[313  64 483 318  11],214,5,15637,4.103122540015744,80.0,20.0
43811,4,3811,[127  89 216 182 237],62,4,15641,4.103095487932844,0.0,0.0
43812,4,3812,[313  64 483 318  11],618,5,15646,4.103330710726462,80.0,20.0
43813,4,3813,[475 313  89  56 181],214,4,15650,4.103303618248558,20.0,40.0
43814,4,3814,[313  64 483 318  11],618,5,15655,4.10353866317169,80.0,20.0
43815,4,3815,[118   7 597 322 127],854,2,15657,4.102987421383648,0.0,0.0
43816,4,3816,[313  64 483 318  11],618,5,15662,4.103222425988997,80.0,20.0
43817,4,3817,[483 211 423 179  96],417,4,15666,4.103195390256679,20.0,0.0
43818,4,3818,[ 88 603 235 273 313],416,3,15669,4.102906520031421,20.0,20.0
43819,4,3819,[181 117 655 333  12],345,4,15673,4.102879581151832,20.0,20.0
43820,4,3820,[313  64 483 318  11],214,5,15678,4.1031143679665005,80.0,20.0
43821,4,3821,[313  64 483 318  11],618,5,15683,4.103349031920461,80.0,20.0
43822,4,3822,[182 183 173 153 742],416,5,15688,4.103583573110123,0.0,0.0
43823,4,3823,[313  64 483 318  11],618,5,15693,4.103817991631799,80.0,20.0
43824,4,3824,[ 98 302 117 172 196],416,5,15698,4.104052287581699,0.0,20.0
43825,4,3825,[ 25 153 117 181 172],654,3,15701,4.10376372190277,0.0,20.0
43826,4,3826,[313  64 483 318  11],618,5,15706,4.103997909589757,80.0,20.0
43827,4,3827,[313  64 483 318  11],214,5,15711,4.10423197492163,80.0,20.0
43828,4,3828,[313 181 216 172  50],711,5,15716,4.104465917994254,20.0,60.0
43829,4,3829,[313  64 483 318  11],214,5,15721,4.104699738903395,80.0,20.0
43830,4,3830,[313  64 483 318  11],214,5,15726,4.104933437744714,80.0,20.0
43831,4,3831,[ 64 301 121 151 294],43,5,15731,4.105167014613778,20.0,0.0
43832,4,3832,[  7 276   9 191  79],43,5,15736,4.105400469606053,0.0,0.0
43833,4,3833,[313  64 483 318  11],618,5,15741,4.105633802816901,80.0,20.0
43834,4,3834,[313  64 483 318  11],618,5,15746,4.105867014341591,80.0,20.0
43835,4,3835,[318 294 258 174 238],43,4,15750,4.105839416058394,20.0,0.0
43836,4,3836,[405 357 179 125 289],416,3,15753,4.1055512118842845,0.0,0.0
43837,4,3837,[313  64 483 318  11],618,5,15758,4.10578426263679,80.0,20.0
43838,4,3838,[313  64 483 318  11],618,5,15763,4.106017191977077,80.0,20.0
43839,4,3839,[196 173  64 276 179],214,4,15767,4.105989583333334,20.0,0.0
43840,4,3840,[117 603 173 153 210],297,5,15772,4.10622233793283,0.0,0.0
43841,4,3841,[313  64 483 318  11],214,5,15777,4.106454971369079,80.0,20.0
43842,4,3842,[313  64 483 318  11],214,5,15782,4.106687483736664,80.0,20.0
43843,4,3843,[288 196  70 301  12],297,4,15786,4.1066597294484914,20.0,20.0
43844,4,3844,[ 25 286 405  88 275],43,5,15791,4.1068920676202865,0.0,0.0
43845,4,3845,[496 276 286 200 202],416,4,15795,4.106864274570983,0.0,0.0
43846,4,3846,[313  64 483 318  11],214,5,15800,4.107096438783468,80.0,20.0
43847,4,3847,[ 71 125 276   8  28],223,3,15803,4.106808731808732,0.0,0.0
43848,4,3848,[ 25  70  64 655 237],198,2,15805,4.106261366588725,20.0,0.0
43849,4,3849,[597  97 496  79 313],43,4,15809,4.106233766233766,20.0,20.0
43850,4,3850,[313  64 483 318  11],618,5,15814,4.106465853025188,80.0,20.0
43851,4,3851,[313  64 483 318  11],214,5,15819,4.1066978193146415,80.0,20.0
43852,4,3852,[ 89 211 135 471 237],297,4,15823,4.106670127173631,0.0,0.0
43853,4,3853,[ 28 588 168 603 568],416,5,15828,4.106901920083031,0.0,0.0
43854,4,3854,[313  64 483 318  11],214,5,15833,4.107133592736705,80.0,20.0
43855,4,3855,[ 64 185  25 235 100],854,3,15836,4.106846473029045,20.0,0.0
43856,4,3856,[211 427 151 268 403],416,4,15840,4.106818771065595,0.0,0.0
43857,4,3857,[286 183 202 121 168],417,4,15844,4.106791083462934,0.0,0.0
43858,4,3858,[385 318  96  95  98],262,3,15847,4.106504275719098,20.0,20.0
43859,4,3859,[313  64 483 318  11],618,5,15852,4.106735751295337,80.0,20.0
43860,4,3860,[313  64 483 318  11],214,5,15857,4.106967106967107,80.0,20.0
43861,4,3861,[655  69 288   8 294],416,5,15862,4.107198342827551,0.0,20.0
43862,4,3862,[313  64 483 318  11],618,5,15867,4.107429458969713,80.0,20.0
43863,4,3863,[ 69 748  79 678  98],297,1,15868,4.106625258799172,0.0,20.0
43864,4,3864,[ 15 748 191  82 245],721,2,15870,4.106080206985769,0.0,0.0
43865,4,3865,[313  64 483 318  11],214,5,15875,4.106311433005691,80.0,20.0
43866,4,3866,[313  64 483 318  11],214,5,15880,4.106542539436256,80.0,20.0
43867,4,3867,[328 237 427 655  89],253,5,15885,4.106773526370217,0.0,0.0
43868,4,3868,[313  64 483 318  11],214,5,15890,4.107004393900232,80.0,20.0
43869,4,3869,[ 64 289 748 294 197],345,2,15892,4.106459948320413,20.0,0.0
43870,4,3870,[603 496  82  95 195],373,4,15896,4.10643244639628,0.0,0.0
43871,4,3871,[568 483 588 323 258],417,2,15898,4.105888429752066,20.0,0.0
43872,4,3872,[313  64 483 318  11],618,5,15903,4.106119287374129,80.0,20.0
43873,4,3873,[  1 288 194 323 210],921,2,15905,4.10557563242127,0.0,20.0
43874,4,3874,[153 318 273 286  71],416,5,15910,4.105806451612903,20.0,0.0
43875,4,3875,[313  64 483 318  11],214,5,15915,4.106037151702786,80.0,20.0
43876,4,3876,[ 22 257  82 172 222],654,5,15920,4.106267732783079,0.0,0.0
43877,4,3877,[ 15 222 742  97 183],417,3,15923,4.105982465188242,0.0,0.0
43878,4,3878,[168 144 151 288 125],854,3,15926,4.105697344676463,0.0,20.0
43879,4,3879,[313  64 483 318  11],618,5,15931,4.1059278350515465,80.0,20.0
43880,4,3880,[ 64 258 200  50  95],417,4,15935,4.105900541097656,20.0,20.0
43881,4,3881,[313  64 483 318  11],214,5,15940,4.1061308603812465,80.0,20.0
43882,4,3882,[216 117  88 181 222],588,4,15944,4.106103528199846,0.0,20.0
43883,4,3883,[423 143 322 588  95],805,0,15944,4.105046343975284,0.0,0.0
43884,4,3884,[215   1 435 294  56],297,1,15945,4.104247104247104,0.0,0.0
43885,4,3885,[313  64 483 318  11],214,5,15950,4.104477611940299,80.0,20.0
43886,4,3886,[313  64 483 318  11],618,5,15955,4.1047080010290715,80.0,20.0
43887,4,3887,[313  64 483 318  11],214,5,15960,4.104938271604938,80.0,20.0
43888,4,3888,[100 228 216 323  12],417,1,15961,4.104139881717665,20.0,0.0
43889,4,3889,[313  64 483 318  11],214,5,15966,4.104370179948586,80.0,20.0
43890,4,3890,[286 144  22  25 748],416,5,15971,4.104600359804677,0.0,0.0
43891,4,3891,[313  64 483 318  11],214,5,15976,4.104830421377184,80.0,20.0
43892,4,3892,[ 15 496  79  82 237],128,5,15981,4.105060364757256,0.0,0.0
43893,4,3893,[ 71 179 195  28 268],416,4,15985,4.105033384694401,0.0,0.0
43894,4,3894,[168  79  11 268 172],654,4,15989,4.105006418485237,0.0,0.0
43895,4,3895,[271 423  95 269 215],297,1,15990,4.104209445585216,0.0,0.0
43896,4,3896,[313  64 483 318  11],214,5,15995,4.104439312291507,80.0,20.0
43897,4,3897,[313  64 483 318  11],214,5,16000,4.104669061056952,80.0,20.0
43898,4,3898,[313  64 483 318  11],618,5,16005,4.1048986919723,80.0,20.0
43899,4,3899,[216 181  15  88 568],416,4,16009,4.104871794871795,0.0,20.0
43900,4,3900,[ 15 202 245 302  50],416,4,16013,4.1048449115611385,0.0,20.0
43901,4,3901,[313  64 483 318  11],214,5,16018,4.105074320861097,80.0,20.0
43902,4,3902,[313  64 483 318  11],214,5,16023,4.105303612605688,80.0,20.0
43903,4,3903,[313  64 483 318  11],618,5,16028,4.105532786885246,80.0,20.0
43904,4,3904,[313  64 483 318  11],618,5,16033,4.105761843790013,80.0,20.0
43905,4,3905,[313  64 483 318  11],618,5,16038,4.105990783410138,80.0,20.0
43906,4,3906,[313  71 196 546 181],43,5,16043,4.10621960583568,20.0,40.0
43907,4,3907,[211 318 588 597 568],43,4,16047,4.106192425793244,20.0,0.0
43908,4,3908,[ 95  28  22  97 427],705,3,16050,4.105909439754413,0.0,0.0
43909,4,3909,[ 28 182  15 135 197],342,2,16052,4.10537084398977,0.0,0.0
43910,4,3910,[275 257 211 127 181],43,5,16057,4.1055995908974685,0.0,20.0
43911,4,3911,[313  64 483 318  11],618,5,16062,4.105828220858895,80.0,20.0
43912,4,3912,[194 100  88 655 196],751,4,16066,4.105801175568617,0.0,0.0
43913,4,3913,[313  64 483 318  11],618,5,16071,4.1060296371997955,80.0,20.0
43914,4,3914,[313  64 483 318  11],618,5,16076,4.106257982120051,80.0,20.0
43915,4,3915,[ 69 153 132 176 275],854,4,16080,4.106230847803881,0.0,0.0
43916,4,3916,[204  15 175 216 144],342,4,16084,4.106203727342354,0.0,0.0
43917,4,3917,[300 276 118  11 286],416,3,16087,4.105921388463502,0.0,0.0
43918,4,3918,[313  64 483 318  11],618,5,16092,4.106149527940802,80.0,20.0
43919,4,3919,[238 197 182 748   4],416,5,16097,4.106377551020408,0.0,0.0
43920,4,3920,[313  64 483 318  11],214,5,16102,4.10660545779138,80.0,20.0
43921,4,3921,[313  64 483 318  11],214,5,16107,4.106833248342682,80.0,20.0
43922,4,3922,[475  97 257 403 302],417,3,16110,4.106551108845271,0.0,0.0
43923,4,3923,[204 302  28 245   7],297,3,16113,4.106269113149847,0.0,0.0
43924,4,3924,[328 202 588 210  79],505,3,16116,4.105987261146497,0.0,0.0
43925,4,3925,[313  64 483 318  11],618,5,16121,4.106214977075904,80.0,20.0
43926,4,3926,[742 161  70 176 179],416,4,16125,4.106187929717342,0.0,0.0
43927,4,3927,[313  64 483 318  11],618,5,16130,4.106415478615071,80.0,20.0
43928,4,3928,[313  64 483 318  11],618,5,16135,4.1066429116823615,80.0,20.0
43929,4,3929,[182 151 655 180  56],62,4,16139,4.106615776081425,0.0,0.0
43930,4,3930,[144 191 210 118  11],297,2,16141,4.106079877893666,0.0,0.0
43931,4,3931,[313  64 483 318  11],618,5,16146,4.106307222787385,80.0,20.0
43932,4,3932,[  1 245 603 235 234],297,1,16147,4.1055174167302315,0.0,0.0
43933,4,3933,[153 678 194 174 127],721,4,16151,4.105490594814438,0.0,0.0
43934,4,3934,[ 70 179 275  97 117],437,2,16153,4.104955527318933,0.0,0.0
43935,4,3935,[294 748 228  69 174],417,2,16155,4.104420731707317,0.0,0.0
43936,4,3936,[135  95 132  82 288],618,3,16158,4.104140208280416,0.0,20.0
43937,4,3937,[475  82 118 172 238],805,3,16161,4.1038598273235145,0.0,0.0
43938,4,3938,[313  64 483 318  11],618,5,16166,4.104087331810104,80.0,20.0
43939,4,3939,[313  64 483 318  11],618,5,16171,4.104314720812183,80.0,20.0
43940,4,3940,[313  64 483 318  11],214,5,16176,4.10454199441766,80.0,20.0
43941,4,3941,[313  64 483 318  11],618,5,16181,4.104769152714359,80.0,20.0
43942,4,3942,[313  64 483 318  11],214,5,16186,4.104996195790007,80.0,20.0
43943,4,3943,[  1 333 143 196 168],416,5,16191,4.105223123732252,0.0,0.0
43944,4,3944,[  1 288   9 132 294],345,2,16193,4.10468948035488,0.0,20.0
43945,4,3945,[  4 597   1 546 228],417,1,16194,4.103902686264572,0.0,0.0
43946,4,3946,[313  64 483 318  11],618,5,16199,4.104129718773752,80.0,20.0
43947,4,3947,[313  64 483 318  11],618,5,16204,4.10435663627153,80.0,20.0
43948,4,3948,[385  22 153 168 194],416,5,16209,4.104583438845277,0.0,0.0
43949,4,3949,[655 273 269 161 403],416,5,16214,4.1048101265822785,0.0,0.0
43950,4,3950,[313  64 483 318  11],618,5,16219,4.105036699569729,80.0,20.0
43951,4,3951,[  8  82 181 655 186],588,4,16223,4.1050101214574894,0.0,20.0
43952,4,3952,[313  64 483 318  11],214,5,16228,4.105236529218315,80.0,20.0
43953,4,3953,[210 273 127 235 288],417,1,16229,4.104451188669701,0.0,20.0
43954,4,3954,[ 69  64 323  88 204],416,3,16232,4.10417193426043,20.0,0.0
43955,4,3955,[313  64 483 318  11],618,5,16237,4.104398382204247,80.0,20.0
43956,4,3956,[313  64 483 318  11],618,5,16242,4.104624715693707,80.0,20.0
43957,4,3957,[357 508 483 655 175],342,3,16245,4.104345629105609,20.0,0.0
43958,4,3958,[191 568   8 143 318],711,4,16249,4.104319272543572,20.0,0.0
43959,4,3959,[313  64 483 318  11],214,5,16254,4.1045454545454545,80.0,20.0
43960,4,3960,[323 471 742  56 423],416,4,16258,4.104519060843222,0.0,0.0
43961,4,3961,[678 215 172 151 403],588,3,16261,4.104240282685512,0.0,0.0
43962,4,3962,[313  64 483 318  11],618,5,16266,4.10446631339894,80.0,20.0
43963,4,3963,[357  11 191 211 597],416,4,16270,4.10443995963673,0.0,0.0
43964,4,3964,[313  64 483 318  11],214,5,16275,4.1046658259773015,80.0,20.0
43965,4,3965,[313  64 483 318  11],214,5,16280,4.104891578416541,80.0,20.0
43966,4,3966,[313  64 483 318  11],618,5,16285,4.1051172170405845,80.0,20.0
43967,4,3967,[195 215  97 300 118],705,2,16287,4.104586693548387,0.0,0.0
43968,4,3968,[210 748 194 132   1],416,5,16292,4.104812295288486,0.0,0.0
43969,4,3969,[313  64 483 318  11],214,5,16297,4.105037783375315,80.0,20.0
43970,4,3970,[ 71 423 100 179 121],49,2,16299,4.104507680684966,0.0,0.0
43971,4,3971,[318 202 328 172 215],12,5,16304,4.104733131923465,20.0,0.0
43972,4,3972,[313  64 483 318  11],618,5,16309,4.104958469670274,80.0,20.0
43973,4,3973,[313  64 483 318  11],618,5,16314,4.105183694011072,80.0,20.0
43974,4,3974,[313  64 483 318  11],618,5,16319,4.105408805031447,80.0,20.0
43975,4,3975,[313  64 483 318  11],618,5,16324,4.105633802816901,80.0,20.0
43976,4,3976,[ 98  56 546 180 216],62,5,16329,4.105858687452854,0.0,20.0
43977,4,3977,[ 97  69 483 174 180],437,3,16332,4.105580693815988,20.0,0.0
43978,4,3978,[313  64 483 318  11],214,5,16337,4.105805478763508,80.0,20.0
43979,4,3979,[655 275 313 385  88],416,4,16341,4.105778894472362,20.0,20.0
43980,4,3980,[313  64 483 318  11],618,5,16346,4.106003516704345,80.0,20.0
43981,4,3981,[313  64 483 318  11],618,5,16351,4.106228026117529,80.0,20.0
43982,4,3982,[385 161 318 265 197],416,5,16356,4.106452422796886,20.0,0.0
43983,4,3983,[144   7  12  96  28],618,4,16360,4.106425702811245,20.0,0.0
43984,4,3984,[125 288 161 483 568],588,4,16364,4.1063989962358844,20.0,20.0
43985,4,3985,[ 89  79  69  11 268],297,3,16367,4.106121424987456,0.0,0.0
43986,4,3986,[313  64 483 318  11],214,5,16372,4.1063456232756455,80.0,20.0
43987,4,3987,[143   7  98 179 172],198,4,16376,4.106318956870612,0.0,20.0
43988,4,3988,[ 50  98 197   9  70],618,2,16378,4.105790925043871,0.0,40.0
43989,4,3989,[313  64 483 318  11],618,5,16383,4.106015037593985,80.0,20.0
43990,4,3990,[288 200   1 323 294],345,1,16384,4.105236782761213,0.0,20.0
43991,4,3991,[313  64 483 318  11],214,5,16389,4.1054609218436875,80.0,20.0
43992,4,3992,[313  64 483 318  11],214,5,16394,4.105684948660155,80.0,20.0
43993,4,3993,[313  64 483 318  11],214,5,16399,4.1059088632949425,80.0,20.0
43994,4,3994,[385  50  12 111 121],345,3,16402,4.105632040050063,20.0,20.0
43995,4,3995,[313  64 483 318  11],214,5,16407,4.1058558558558556,80.0,20.0
43996,4,3996,[313  64 483 318  11],618,5,16412,4.106079559669753,80.0,20.0
43997,4,3997,[313  64 483 318  11],618,5,16417,4.106303151575788,80.0,20.0
43998,4,3998,[194 182 234  22 143],297,2,16419,4.105776444111028,0.0,0.0
43999,4,3999,[313  64 483 318  11],214,5,16424,4.106,80.0,20.0
44000,4,4000,[200 161  12 182  88],405,1,16425,4.105223694076481,20.0,0.0
44001,4,4001,[195 144 127 172  50],62,4,16429,4.105197401299351,0.0,20.0
44002,4,4002,[313  64 483 318  11],214,5,16434,4.105420934299276,80.0,20.0
44003,4,4003,[289 323 508 238 117],345,3,16437,4.1051448551448555,0.0,0.0
44004,4,4004,[144 435 117 181 276],230,4,16441,4.105118601747815,0.0,20.0
44005,4,4005,[313  64 483 318  11],214,5,16446,4.105341987019471,80.0,20.0
44006,4,4006,[318   8  97  22  28],416,5,16451,4.105565260793611,20.0,0.0
44007,4,4007,[235 403 678 597 288],805,2,16453,4.1050399201596806,0.0,20.0
44008,4,4008,[313  64 483 318  11],618,5,16458,4.105263157894737,80.0,20.0
44009,4,4009,[301 172 405 275 258],416,5,16463,4.1054862842892765,0.0,0.0
44010,4,4010,[471  79 238 181 300],297,2,16465,4.104961356270257,0.0,20.0
44011,4,4011,[  9 121 302 204 742],416,5,16470,4.10518444666002,0.0,0.0
44012,4,4012,[125 475 144 238 174],417,3,16473,4.1049090456017945,0.0,0.0
44013,4,4013,[357 127 215 286 187],416,5,16478,4.105132037867464,0.0,0.0
44014,4,4014,[313  64 483 318  11],214,5,16483,4.105354919053549,80.0,20.0
44015,4,4015,[313  64 483 318  11],214,5,16488,4.105577689243028,80.0,20.0
44016,4,4016,[237  56 294 196 144],297,3,16491,4.105302464525765,0.0,0.0
44017,4,4017,[313  64 483 318  11],618,5,16496,4.1055251368840215,80.0,20.0
44018,4,4018,[313  64 483 318  11],618,5,16501,4.105747698432446,80.0,20.0
44019,4,4019,[222 204 180 161 678],805,2,16503,4.1052238805970145,0.0,0.0
44020,4,4020,[313  64 483 318  11],214,5,16508,4.105446406366576,80.0,20.0
44021,4,4021,[322 257   7 100  11],854,3,16511,4.105171556439582,0.0,0.0
44022,4,4022,[135 237  28 742  15],642,4,16515,4.105145413870246,0.0,0.0
44023,4,4023,[ 89 748   1 269 323],805,4,16519,4.105119284294235,0.0,0.0
44024,4,4024,[ 64 238 196  97 132],416,5,16524,4.105341614906832,20.0,0.0
44025,4,4025,[313  64 483 318  11],214,5,16529,4.105563835072032,80.0,20.0
44026,4,4026,[215  88 234   8  12],437,3,16532,4.105289297243606,20.0,0.0
44027,4,4027,[403 196  89 313 265],711,4,16536,4.105263157894737,20.0,20.0
44028,4,4028,[313  64 483 318  11],214,5,16541,4.105485232067511,80.0,20.0
44029,4,4029,[ 98  79 276 222 328],43,5,16546,4.105707196029777,0.0,20.0
44030,4,4030,[ 15 245 471 118  79],907,5,16551,4.1059290498635574,0.0,0.0
44031,4,4031,[313  64 483 318  11],618,5,16556,4.1061507936507935,80.0,20.0
44032,4,4032,[313  64 483 318  11],214,5,16561,4.106372427473345,80.0,20.0
44033,4,4033,[173  28   9  50 121],416,5,16566,4.106593951412989,0.0,20.0
44034,4,4034,[313  64 483 318  11],214,5,16571,4.106815365551425,80.0,20.0
44035,4,4035,[121 181 294 234 748],417,3,16574,4.106541129831516,0.0,20.0
44036,4,4036,[ 50  71 276  97 655],128,3,16577,4.106267029972752,0.0,20.0
44037,4,4037,[151 257  79 195 202],417,3,16580,4.105993065874195,0.0,0.0
44038,4,4038,[313  64 483 318  11],618,5,16585,4.106214409507304,80.0,20.0
44039,4,4039,[211  12 235 161 186],417,3,16588,4.105940594059406,20.0,0.0
44040,4,4040,[313  64 483 318  11],214,5,16593,4.106161841128434,80.0,20.0
44041,4,4041,[313  64 483 318  11],618,5,16598,4.1063829787234045,80.0,20.0
44042,4,4042,[204  12 603 405 117],805,2,16600,4.105861983675489,20.0,0.0
44043,4,4043,[216  71 294 173  50],642,4,16604,4.105835806132542,0.0,20.0
44044,4,4044,[195 117 100 179 111],437,2,16606,4.1053152039555005,0.0,0.0
44045,4,4045,[313  64 483 318  11],214,5,16611,4.1055363321799305,80.0,20.0
44046,4,4046,[313  64 483 318  11],618,5,16616,4.105757351124289,80.0,20.0
44047,4,4047,[313  64 483 318  11],214,5,16621,4.105978260869565,80.0,20.0
44048,4,4048,[195 173 742 204 515],416,5,16626,4.106199061496666,0.0,0.0
44049,4,4049,[323 174  79  25 655],345,3,16629,4.105925925925926,0.0,0.0
44050,4,4050,[215 275 385  98  25],43,5,16634,4.106146630461614,0.0,20.0
44051,4,4051,[313  64 483 318  11],214,5,16639,4.106367226061204,80.0,20.0
44052,4,4052,[194 258 268 175 135],721,3,16642,4.106094251171972,0.0,0.0
44053,4,4053,[275 195  56 228 235],297,2,16644,4.105574740996547,0.0,0.0
44054,4,4054,[168 121 211   4 588],416,5,16649,4.105795314426634,0.0,0.0
44055,4,4055,[228 655  88 405 276],128,3,16652,4.105522682445759,0.0,0.0
44056,4,4056,[144 191 265 237 276],416,3,16655,4.105250184865664,0.0,0.0
44057,4,4057,[ 98 135   7 125 174],854,3,16658,4.1049778215869885,0.0,20.0
44058,4,4058,[313  64 483 318  11],214,5,16663,4.1051983247105195,80.0,20.0
44059,4,4059,[ 28 153 118 180 197],437,3,16666,4.104926108374384,0.0,0.0
44060,4,4060,[ 82 269 496  28  69],43,5,16671,4.105146515636543,0.0,0.0
44061,4,4061,[282  64 216 197 238],345,4,16675,4.105120630231413,20.0,0.0
44062,4,4062,[597 173 678  69 258],654,5,16680,4.1053408811223235,0.0,0.0
44063,4,4063,[313  64 483 318  11],618,5,16685,4.105561023622047,80.0,20.0
44064,4,4064,[282 265 405 275  15],654,3,16688,4.105289052890529,0.0,0.0
44065,4,4065,[276 496 282 204  69],654,3,16691,4.105017215937039,0.0,0.0
44066,4,4066,[423 125 174 121 111],62,3,16694,4.1047455126628964,0.0,0.0
44067,4,4067,[313  64 483 318  11],618,5,16699,4.104965585054081,80.0,20.0
44068,4,4068,[313  64 483 318  11],618,5,16704,4.1051855492750065,80.0,20.0
44069,4,4069,[323  22 322  97 210],416,3,16707,4.104914004914005,0.0,0.0
44070,4,4070,[143  97 216 471 318],588,4,16711,4.104888233849177,20.0,0.0
44071,4,4071,[313  64 483 318  11],214,5,16716,4.105108055009823,80.0,20.0
44072,4,4072,[313  64 483 318  11],618,5,16721,4.105327768229806,80.0,20.0
44073,4,4073,[ 89 153 228   1 135],198,4,16725,4.105301914580265,0.0,0.0
44074,4,4074,[ 28  50 294 238 427],262,2,16727,4.10478527607362,0.0,20.0
44075,4,4075,[313  64 483 318  11],214,5,16732,4.105004906771344,80.0,20.0
44076,4,4076,[313  64 483 318  11],618,5,16737,4.105224429727741,80.0,20.0
44077,4,4077,[ 50 183  70 508 100],417,2,16739,4.104708190289357,0.0,20.0
44078,4,4078,[ 97 168 748 471 204],373,3,16742,4.104437362098554,0.0,0.0
44079,4,4079,[  8 597 300 301 215],416,4,16746,4.104411764705882,0.0,0.0
44080,4,4080,[135  64 168  96 403],405,3,16749,4.104141141876991,20.0,0.0
44081,4,4081,[168 258  50 183 197],805,4,16753,4.104115629593337,0.0,20.0
44082,4,4082,[200 172 153 269 191],262,1,16754,4.103355375949057,0.0,0.0
44083,4,4083,[313  64 483 318  11],618,5,16759,4.103574926542605,80.0,20.0
44084,4,4084,[313  64 483 318  11],618,5,16764,4.103794369645043,80.0,20.0
44085,4,4085,[313  64 483 318  11],214,5,16769,4.104013705335292,80.0,20.0
44086,4,4086,[496 405 268 117 173],314,4,16773,4.103988255444091,0.0,0.0
44087,4,4087,[313  64 483 318  11],618,5,16778,4.104207436399217,80.0,20.0
44088,4,4088,[313  64 483 318  11],618,5,16783,4.104426510149181,80.0,20.0
44089,4,4089,[313  64 483 318  11],214,5,16788,4.104645476772616,80.0,20.0
44090,4,4090,[313  64 483 318  11],618,5,16793,4.104864336348081,80.0,20.0
44091,4,4091,[ 25  28  69  12 118],588,3,16796,4.104594330400782,20.0,0.0
44092,4,4092,[313  64 483 318  11],214,5,16801,4.104813095528952,80.0,20.0
44093,4,4093,[313  64 483 318  11],618,5,16806,4.105031753786029,80.0,20.0
44094,4,4094,[313  64 483 318  11],214,5,16811,4.105250305250305,80.0,20.0
44095,4,4095,[423 111  96 238  28],618,2,16813,4.104736328125,0.0,0.0
44096,4,4096,[313  64 483 318  11],214,5,16818,4.1049548450085425,80.0,20.0
44097,4,4097,[144 176   7 168 153],416,5,16823,4.105173255246462,0.0,0.0
44098,4,4098,[313  64 483 318  11],214,5,16828,4.105391558916809,80.0,20.0
44099,4,4099,[313  64 483 318  11],214,5,16833,4.105609756097561,80.0,20.0
44100,4,4100,[313  64 483 318  11],214,5,16838,4.105827846866618,80.0,20.0
44101,4,4101,[313  64 483 318  11],214,5,16843,4.106045831301804,80.0,20.0
44102,4,4102,[313  64 483 318  11],618,5,16848,4.106263709480868,80.0,20.0
44103,4,4103,[313  64 483 318  11],214,5,16853,4.106481481481482,80.0,20.0
44104,4,4104,[100 168  15 546 179],416,3,16856,4.106211936662606,0.0,0.0
44105,4,4105,[271 100 289 273 151],854,4,16860,4.106186069167072,0.0,0.0
44106,4,4106,[127 132 121 180 174],214,5,16865,4.106403700998295,0.0,0.0
44107,4,4107,[  8 475 257 234 200],297,2,16867,4.105890944498539,0.0,0.0
44108,4,4108,[423 172   4 546 322],805,1,16868,4.1051350693599415,0.0,0.0
44109,4,4109,[313  64 483 318  11],618,5,16873,4.105352798053528,80.0,20.0
44110,4,4110,[  1  70  97 257 742],654,4,16877,4.105327171004622,0.0,0.0
44111,4,4111,[ 89 111 294 742 357],854,2,16879,4.104815175097277,0.0,0.0
44112,4,4112,[276 195 423  89 172],62,4,16883,4.104789691222952,0.0,0.0
44113,4,4113,[475  69 176 191  98],62,5,16888,4.105007292173068,0.0,20.0
44114,4,4114,[ 88 191 483 655 197],437,4,16892,4.10498177399757,20.0,0.0
44115,4,4115,[313  64 483 318  11],214,5,16897,4.105199222546162,80.0,20.0
44116,4,4116,[313  64 483 318  11],618,5,16902,4.1054165654602865,80.0,20.0
44117,4,4117,[265   1 144   7 234],618,5,16907,4.105633802816901,0.0,0.0
44118,4,4118,[  1  15 258   8 172],721,4,16911,4.105608157319738,0.0,0.0
44119,4,4119,[ 56 301 200 237 194],297,3,16914,4.105339805825243,0.0,0.0
44120,4,4120,[127  95  79  97 588],373,2,16916,4.104828925018199,0.0,0.0
44121,4,4121,[333 195 204  64 318],496,2,16918,4.104318292091218,40.0,0.0
44122,4,4122,[  1 423 588  98 323],620,5,16923,4.1045355323793355,0.0,20.0
44123,4,4123,[181 276 202  88 215],128,3,16926,4.104267701260912,0.0,20.0
44124,4,4124,[313 483  64 318  11],618,5,16931,4.104484848484849,80.0,20.0
44125,4,4125,[161  71 234 194 257],416,4,16935,4.104459524963645,0.0,0.0
44126,4,4126,[313 483  64 318  11],618,5,16940,4.104676520474921,80.0,20.0
44127,4,4127,[313 483  64 318  11],618,5,16945,4.104893410852713,80.0,20.0
44128,4,4128,[313 483  64 318  11],214,5,16950,4.105110196173408,80.0,20.0
44129,4,4129,[475 268 302  12  89],854,3,16953,4.104842615012107,20.0,0.0
44130,4,4130,[117 258  71 121 300],198,1,16954,4.104091019123699,0.0,0.0
44131,4,4131,[313 483  64 318  11],214,5,16959,4.104307841239109,80.0,20.0
44132,4,4132,[313 483  64 318  11],618,5,16964,4.104524558432131,80.0,20.0
44133,4,4133,[118 322 151 269 238],854,3,16967,4.104257377842283,0.0,0.0
44134,4,4134,[179 210  11 234 197],405,4,16971,4.104232164449819,0.0,0.0
44135,4,4135,[100 597 222 271   4],854,3,16974,4.103965183752417,0.0,0.0
44136,4,4136,[ 79 301 173   7 313],416,5,16979,4.1041817742325355,20.0,20.0
44137,4,4137,[313 483  64 318  11],618,5,16984,4.104398260029,80.0,20.0
44138,4,4138,[185 176  11  71 168],805,3,16987,4.104131432713216,0.0,0.0
44139,4,4139,[313 483  64 318  11],214,5,16992,4.104347826086957,80.0,20.0
44140,4,4140,[ 71 183  96 269 117],805,3,16995,4.104081139821299,0.0,0.0
44141,4,4141,[202  79  88   9 237],618,3,16998,4.103814582327378,0.0,0.0
44142,4,4142,[151 302 195   8  96],416,4,17002,4.103789524499155,0.0,0.0
44143,4,4143,[313 483  64 318  11],214,5,17007,4.1040057915057915,80.0,20.0
44144,4,4144,[313 483  64 318  11],618,5,17012,4.10422195416164,80.0,20.0
44145,4,4145,[313 483  64 318  11],214,5,17017,4.104438012542209,80.0,20.0
44146,4,4146,[313 483  64 318  11],618,5,17022,4.104653966722932,80.0,20.0
44147,4,4147,[216  11 118 125 153],854,2,17024,4.104146576663452,0.0,0.0
44148,4,4148,[313 483  64 318  11],214,5,17029,4.104362496987226,80.0,20.0
44149,4,4149,[143 183  69 471  22],618,4,17033,4.10433734939759,0.0,0.0
44150,4,4150,[313 483  64 318  11],214,5,17038,4.104553119730186,80.0,20.0
44151,4,4151,[748 235 603 655 117],805,1,17039,4.103805394990366,0.0,0.0
44152,4,4152,[313 483  64 318  11],214,5,17044,4.104021189501565,80.0,20.0
44153,4,4153,[313 483  64 318  11],214,5,17049,4.104236880115551,80.0,20.0
44154,4,4154,[132 237 508  25 655],345,4,17053,4.104211793020458,0.0,0.0
44155,4,4155,[313 483  64 318  11],214,5,17058,4.104427333974976,80.0,20.0
44156,4,4156,[313 483  64 318  11],214,5,17063,4.104642771229252,80.0,20.0
44157,4,4157,[313 483  64 318  11],214,5,17068,4.1048581048581045,80.0,20.0
44158,4,4158,[ 97   1 288 143 265],654,3,17071,4.104592450108199,0.0,20.0
44159,4,4159,[ 12 211 161 100 180],437,4,17075,4.1045673076923075,20.0,0.0
44160,4,4160,[228 405 322  11 323],805,1,17076,4.103821196827686,0.0,0.0
44161,4,4161,[237 257 301 168 144],751,4,17080,4.103796251802018,0.0,0.0
44162,4,4162,[173 161 496 210 135],373,4,17084,4.10377131876051,0.0,0.0
44163,4,4163,[273 118 202 182 515],417,4,17088,4.1037463976945245,0.0,0.0
44164,4,4164,[328 318 111 742 172],416,5,17093,4.103961584633853,20.0,0.0
44165,4,4165,[313 483  64 318  11],618,5,17098,4.1041766682669225,80.0,20.0
44166,4,4166,[313 483  64 318  11],618,5,17103,4.1043916486681065,80.0,20.0
44167,4,4167,[313 483  64 318  11],214,5,17108,4.104606525911708,80.0,20.0
44168,4,4168,[195  28  97 211 265],373,3,17111,4.104341568721516,0.0,0.0
44169,4,4169,[313 483  64 318  11],618,5,17116,4.104556354916067,80.0,20.0
44170,4,4170,[313 483  64 318  11],618,5,17121,4.104771038120355,80.0,20.0
44171,4,4171,[195 210 151 127 286],373,3,17124,4.10450623202301,0.0,0.0
44172,4,4172,[313 483  64 318  11],618,5,17129,4.104720824346993,80.0,20.0
44173,4,4173,[  4 471 181  70  22],618,2,17131,4.1042165788212746,0.0,20.0
44174,4,4174,[313 483  64 318  11],214,5,17136,4.104431137724551,80.0,20.0
44175,4,4175,[313 483  64 318  11],214,5,17141,4.104645593869732,80.0,20.0
44176,4,4176,[268 597 143 423 286],416,4,17145,4.104620541058176,0.0,0.0
44177,4,4177,[196 132  98 597 202],417,4,17149,4.104595500239349,0.0,20.0
44178,4,4178,[ 79 471 322 215 210],416,4,17153,4.104570471404642,0.0,0.0
44179,4,4179,[508  22 173  89 271],854,4,17157,4.1045454545454545,0.0,0.0
44180,4,4180,[313 483  64 318  11],214,5,17162,4.104759626883521,80.0,20.0
44181,4,4181,[313 483  64 318  11],618,5,17167,4.104973696795791,80.0,20.0
44182,4,4182,[132 210 403 588 127],416,5,17172,4.105187664355726,0.0,0.0
44183,4,4183,[313 483  64 318  11],618,5,17177,4.105401529636711,80.0,20.0
44184,4,4184,[313 483  64 318  11],618,5,17182,4.105615292712067,80.0,20.0
44185,4,4185,[210 202 211  12  97],43,5,17187,4.105828953655041,20.0,0.0
44186,4,4186,[195   8 111 153 121],62,4,17191,4.10580367805111,0.0,0.0
44187,4,4187,[313 483  64 318  11],214,5,17196,4.106017191977077,80.0,20.0
44188,4,4188,[ 11  56 238  50 273],416,5,17201,4.10623060396276,0.0,20.0
44189,4,4189,[313 483  64 318  11],618,5,17206,4.1064439140811455,80.0,20.0
44190,4,4190,[  8 655  28 168 222],887,3,17209,4.106179909329516,0.0,0.0
44191,4,4191,[282 508 273 173 235],297,3,17212,4.105916030534351,0.0,0.0
44192,4,4192,[143 742   8  79  88],907,4,17216,4.105890770331505,0.0,0.0
44193,4,4193,[269 161 546  95 328],416,3,17219,4.105627086313781,0.0,0.0
44194,4,4194,[313 483  64 318  11],618,5,17224,4.1058402860548275,80.0,20.0
44195,4,4195,[313 483  64 318  11],214,5,17229,4.106053384175405,80.0,20.0
44196,4,4196,[ 82 168 258 294 318],62,4,17233,4.106028115320467,20.0,0.0
44197,4,4197,[313 483  64 318  11],618,5,17238,4.106241067174845,80.0,20.0
44198,4,4198,[153 238 678 655 143],805,3,17241,4.105977613717552,0.0,0.0
44199,4,4199,[313 483  64 318  11],214,5,17246,4.106190476190476,80.0,20.0
44200,4,4200,[313 483  64 318  11],618,5,17251,4.106403237324447,80.0,20.0
44201,4,4201,[258 748 742 546 294],417,3,17254,4.106139933365064,0.0,0.0
44202,4,4202,[508 357 427 318 100],214,5,17259,4.106352605281941,20.0,0.0
44203,4,4203,[  7   8  11  95 204],49,1,17260,4.105613701236917,0.0,0.0
44204,4,4204,[313 483  64 318  11],214,5,17265,4.105826397146254,80.0,20.0
44205,4,4205,[100 172 322 483  50],679,3,17268,4.1055634807417976,20.0,20.0
44206,4,4206,[313 483  64 318  11],214,5,17273,4.1057760874732585,80.0,20.0
44207,4,4207,[313 483  64 318  11],214,5,17278,4.105988593155893,80.0,20.0
44208,4,4208,[588 180  22 405 257],887,5,17283,4.106200997861725,0.0,0.0
44209,4,4209,[313 483  64 318  11],214,5,17288,4.106413301662708,80.0,20.0
44210,4,4210,[655 202 196 195 185],417,4,17292,4.106388031346474,0.0,0.0
44211,4,4211,[ 96 175 143 197 385],405,2,17294,4.105887939221272,0.0,0.0
44212,4,4212,[313 483  64 318  11],214,5,17299,4.106100166152386,80.0,20.0
44213,4,4213,[215 180 603 588 111],128,3,17302,4.1058376839107735,0.0,0.0
44214,4,4214,[300 222  70  96 294],630,4,17306,4.105812574139977,0.0,0.0
44215,4,4215,[475 405 294 153 268],416,4,17310,4.105787476280835,0.0,0.0
44216,4,4216,[144 748 200 288  12],805,2,17312,4.105288119516244,20.0,20.0
44217,4,4217,[313 483  64 318  11],214,5,17317,4.105500237079185,80.0,20.0
44218,4,4218,[313 483  64 318  11],618,5,17322,4.105712254088647,80.0,20.0
44219,4,4219,[179 174  82 173  28],128,3,17325,4.105450236966824,0.0,0.0
44220,4,4220,[313 483  64 318  11],618,5,17330,4.105662165363658,80.0,20.0
44221,4,4221,[235 357  97 742  69],416,4,17334,4.105637138796779,0.0,0.0
44222,4,4222,[323   7 257 196   1],416,3,17337,4.105375325597916,0.0,0.0
44223,4,4223,[313 483  64 318  11],214,5,17342,4.105587121212121,80.0,20.0
44224,4,4224,[313 483  64 318  11],618,5,17347,4.105798816568047,80.0,20.0
44225,4,4225,[742  95   7 195 471],416,4,17351,4.105773781353526,0.0,0.0
44226,4,4226,[313 483  64 318  11],214,5,17356,4.105985332387036,80.0,20.0
44227,4,4227,[ 79 111  82 125  12],417,3,17359,4.105723746452223,20.0,0.0
44228,4,4228,[ 95   1 111 271 181],43,4,17363,4.10569874674864,0.0,20.0
44229,4,4229,[258 222  79 238  64],854,5,17368,4.105910165484634,20.0,0.0
44230,4,4230,[210  95 195 168  50],297,3,17371,4.105648782793666,0.0,20.0
44231,4,4231,[265 161 185 216 435],437,2,17373,4.105151228733459,0.0,0.0
44232,4,4232,[300 483 471 275 202],128,4,17377,4.105126387904559,20.0,0.0
44233,4,4233,[ 15 301 132 268 245],416,4,17381,4.105101558809636,0.0,0.0
44234,4,4234,[313 483  64 318  11],618,5,17386,4.105312868949232,80.0,20.0
44235,4,4235,[172  70 111 210 294],128,2,17388,4.104815864022663,0.0,0.0
44236,4,4236,[313 483  64 318  11],214,5,17393,4.105027141845645,80.0,20.0
44237,4,4237,[313 483  64 318  11],214,5,17398,4.105238319962246,80.0,20.0
44238,4,4238,[245 273 403 568  98],62,3,17401,4.104977589054022,0.0,20.0
44239,4,4239,[357  11  28 204 678],297,3,17404,4.104716981132076,0.0,0.0
44240,4,4240,[204   1 588 568 423],887,3,17407,4.1044564961094085,0.0,0.0
44241,4,4241,[ 70 403 294  95  15],416,4,17411,4.104431871758605,0.0,0.0
44242,4,4242,[ 25 748  56 568 235],345,2,17413,4.103935894414329,0.0,0.0
44243,4,4243,[179 153  89 168 546],417,4,17417,4.103911404335532,0.0,0.0
44244,4,4244,[ 71 282 427 125 185],416,5,17422,4.104122497055359,0.0,0.0
44245,4,4245,[313 483  64 318  11],618,5,17427,4.104333490343853,80.0,20.0
44246,4,4246,[313 483  64 318  11],618,5,17432,4.10454438427125,80.0,20.0
44247,4,4247,[194 265  79 357 168],373,5,17437,4.1047551789077215,0.0,0.0
44248,4,4248,[268 185 187 265 176],416,5,17442,4.10496587432337,0.0,0.0
44249,4,4249,[313 483  64 318  11],618,5,17447,4.105176470588235,80.0,20.0
44250,4,4250,[313 483  64 318  11],618,5,17452,4.105386967772289,80.0,20.0
44251,4,4251,[313 483  64 318  11],214,5,17457,4.105597365945437,80.0,20.0
44252,4,4252,[313 483  64 318  11],618,5,17462,4.1058076651775215,80.0,20.0
44253,4,4253,[187   4 282 678 276],416,3,17465,4.105547719793136,0.0,0.0
44254,4,4254,[121 179 222  64  22],601,4,17469,4.105522914218566,20.0,0.0
44255,4,4255,[385 597  97 117 742],416,4,17473,4.1054981203007515,0.0,0.0
44256,4,4256,[ 79  25  22  12 197],373,4,17477,4.105473338031477,20.0,0.0
44257,4,4257,[423 238 748 191 275],416,5,17482,4.105683419445749,0.0,0.0
44258,4,4258,[405 357 191  28 328],416,5,17487,4.105893402207091,0.0,0.0
44259,4,4259,[215 748 216 597 196],416,4,17491,4.105868544600939,0.0,0.0
44260,4,4260,[313 483  64 318  11],618,5,17496,4.10607838535555,80.0,20.0
44261,4,4261,[313 483  64 318  11],214,5,17501,4.106288127639606,80.0,20.0
44262,4,4262,[282   4  70 215 100],297,2,17503,4.105794041754633,0.0,0.0
44263,4,4263,[289 235 100  25 237],854,1,17504,4.105065666041276,0.0,0.0
44264,4,4264,[313 483  64 318  11],618,5,17509,4.1052754982415,80.0,20.0
44265,4,4265,[ 70 238 234 258 257],417,4,17513,4.105250820440694,0.0,0.0
44266,4,4266,[172 471  88 153 748],373,4,17517,4.105226154206703,0.0,0.0
44267,4,4267,[183 275   9 271 117],62,4,17521,4.105201499531397,0.0,0.0
44268,4,4268,[ 95 196  64 222 257],705,5,17526,4.105411103302881,20.0,0.0
44269,4,4269,[179 603 135 200 182],405,1,17527,4.104683840749415,0.0,0.0
44270,4,4270,[322 211 168 143  12],416,4,17531,4.104659330367595,20.0,0.0
44271,4,4271,[313 483  64 318  11],214,5,17536,4.104868913857678,80.0,20.0
44272,4,4272,[181 427  15 483  88],907,5,17541,4.105078399251112,20.0,20.0
44273,4,4273,[ 95 302 202 405 385],43,5,17546,4.105287786616753,0.0,0.0
44274,4,4274,[313 483  64 318  11],618,5,17551,4.105497076023392,80.0,20.0
44275,4,4275,[185 318 496 288 385],262,2,17553,4.105004677268475,20.0,20.0
44276,4,4276,[127 161 202  64 196],405,3,17556,4.104746317512275,20.0,0.0
44277,4,4277,[678 176 143 117 655],416,4,17560,4.104721832632071,0.0,0.0
44278,4,4278,[313 483  64 318  11],618,5,17565,4.104931058658565,80.0,20.0
44279,4,4279,[313 483  64 318  11],618,5,17570,4.105140186915888,80.0,20.0
44280,4,4280,[313 483  64 318  11],214,5,17575,4.105349217472553,80.0,20.0
44281,4,4281,[ 96 210  95 121 300],751,4,17579,4.105324614666044,0.0,0.0
44282,4,4282,[313 483  64 318  11],618,5,17584,4.105533504552883,80.0,20.0
44283,4,4283,[313 483  64 318  11],618,5,17589,4.105742296918767,80.0,20.0
44284,4,4284,[313 483  64 318  11],214,5,17594,4.105950991831972,80.0,20.0
44285,4,4285,[313 483  64 318  11],618,5,17599,4.1061595893607095,80.0,20.0
44286,4,4286,[313 483  64 318  11],618,5,17604,4.106368089573128,80.0,20.0
44287,4,4287,[186  22  89 357 216],642,2,17606,4.105876865671642,0.0,0.0
44288,4,4288,[313 483  64 318  11],214,5,17611,4.106085334576824,80.0,20.0
44289,4,4289,[ 25 257 204  12 143],342,3,17614,4.105827505827506,20.0,0.0
44290,4,4290,[ 82 318 195   8 215],405,5,17619,4.106035889070147,20.0,0.0
44291,4,4291,[238 200 322 237 127],854,3,17622,4.105778191985088,0.0,0.0
44292,4,4292,[ 11 496 132 135 180],437,4,17626,4.105753552294432,0.0,0.0
44293,4,4293,[294 143  22 257 546],297,2,17628,4.105263157894737,0.0,0.0
44294,4,4294,[313 483  64 318  11],618,5,17633,4.105471478463329,80.0,20.0
44295,4,4295,[742  98 173  71  96],62,4,17637,4.1054469273743015,0.0,20.0
44296,4,4296,[313 483  64 318  11],214,5,17642,4.105655108215034,80.0,20.0
44297,4,4297,[313 483  64 318  11],618,5,17647,4.105863192182411,80.0,20.0
44298,4,4298,[313 483  64 318  11],214,5,17652,4.106071179344034,80.0,20.0
44299,4,4299,[144 238 475 322 234],416,3,17655,4.105813953488372,0.0,0.0
44300,4,4300,[ 79 385 655 174 228],405,3,17658,4.105556847244827,0.0,0.0
44301,4,4301,[173 385 204 172 423],405,4,17662,4.105532310553231,0.0,0.0
44302,4,4302,[228   7 168 181 258],887,4,17666,4.105507785266093,0.0,20.0
44303,4,4303,[168 195 302   4 588],405,3,17669,4.1052509293680295,0.0,0.0
44304,4,4304,[357  12 172 202 175],373,3,17672,4.1049941927990705,20.0,0.0
44305,4,4305,[313 483  64 318  11],214,5,17677,4.105202043660009,80.0,20.0
44306,4,4306,[313 483  64 318  11],214,5,17682,4.105409798003251,80.0,20.0
44307,4,4307,[ 28  25 191 168 471],618,3,17685,4.105153203342619,0.0,0.0
44308,4,4308,[313 483  64 318  11],214,5,17690,4.105360872592248,80.0,20.0
44309,4,4309,[288 191 313 175 185],214,4,17694,4.105336426914153,20.0,40.0
44310,4,4310,[313 483  64 318  11],214,5,17699,4.1055439573184875,80.0,20.0
44311,4,4311,[313 483  64 318  11],618,5,17704,4.105751391465677,80.0,20.0
44312,4,4312,[185 222  56  64 403],198,3,17707,4.105495015070717,20.0,0.0
44313,4,4313,[179 176 427 496 301],416,4,17711,4.105470560964302,0.0,0.0
44314,4,4314,[273 200 742 237 294],764,2,17713,4.104982618771727,0.0,0.0
44315,4,4315,[  9 228 127 153 294],805,1,17714,4.1042632066728455,0.0,0.0
44316,4,4316,[655 194  28 100   7],416,5,17719,4.104470697243456,0.0,0.0
44317,4,4317,[173 282 186 175 273],854,3,17722,4.104214914312181,0.0,0.0
44318,4,4318,[118 143 161  50 132],128,4,17726,4.1041907849039125,0.0,20.0
44319,4,4319,[222 151 143 273  89],764,4,17730,4.104166666666667,0.0,0.0
44320,4,4320,[313 483  64 318  11],618,5,17735,4.104373987502893,80.0,20.0
44321,4,4321,[  1  69 286 237 568],345,3,17738,4.104118463674225,0.0,0.0
44322,4,4322,[496 151 210  89  22],642,3,17741,4.103863058061531,0.0,0.0
44323,4,4323,[195 180 222  25 132],887,3,17744,4.103607770582793,0.0,0.0
44324,4,4324,[ 56 100  79  25 257],854,3,17747,4.103352601156069,0.0,0.0
44325,4,4325,[313 483  64 318  11],618,5,17752,4.1035598705501615,80.0,20.0
44326,4,4326,[ 98 228 235 183 515],417,3,17755,4.103304830136353,0.0,20.0
44327,4,4327,[ 25 475 276 132 286],416,3,17758,4.1030499075785585,0.0,0.0
44328,4,4328,[313 483  64 318  11],214,5,17763,4.1032571032571035,80.0,20.0
44329,4,4329,[313 483  64 318  11],618,5,17768,4.103464203233257,80.0,20.0
44330,4,4330,[ 79 237  56  97 313],588,3,17771,4.103209420457169,20.0,20.0
44331,4,4331,[144 257 237  28 245],62,0,17771,4.102262234533702,0.0,0.0
44332,4,4332,[173 294 385 196 118],43,5,17776,4.102469420724671,0.0,0.0
44333,4,4333,[204 174 258 597 235],416,3,17779,4.10221504383941,0.0,0.0
44334,4,4334,[313 483  64 318  11],618,5,17784,4.1024221453287195,80.0,20.0
44335,4,4335,[ 79 176 204  28 183],437,2,17786,4.101937269372693,0.0,0.0
44336,4,4336,[135 196  28 210  82],230,4,17790,4.101913765275536,0.0,0.0
44337,4,4337,[313 483  64 318  11],214,5,17795,4.102120792992162,80.0,20.0
44338,4,4338,[179 475 269 405 237],416,2,17797,4.101636321733118,0.0,0.0
44339,4,4339,[568  79 234 302 405],417,1,17798,4.1009216589861754,0.0,0.0
44340,4,4340,[313 483  64 318  11],214,5,17803,4.10112877217231,80.0,20.0
44341,4,4341,[ 28  79 471 196 181],43,4,17807,4.1011054813450025,0.0,20.0
44342,4,4342,[ 98 597 655 294 238],805,2,17809,4.100621690075984,0.0,20.0
44343,4,4343,[179 174 144  25 168],416,4,17813,4.100598526703499,0.0,0.0
44344,4,4344,[313 483  64 318  11],618,5,17818,4.100805523590334,80.0,20.0
44345,4,4345,[546  95 200 475   8],805,2,17820,4.100322135296825,0.0,0.0
44346,4,4346,[748  50   8 475  98],437,4,17824,4.100299056820796,0.0,40.0
44347,4,4347,[313 483  64 318  11],618,5,17829,4.100505979760809,80.0,20.0
44348,4,4348,[ 64  11  79 185 238],416,5,17834,4.100712807541964,20.0,0.0
44349,4,4349,[265  95 268  11 196],416,4,17838,4.100689655172414,0.0,0.0
44350,4,4350,[313 483  64 318  11],214,5,17843,4.100896345667663,80.0,20.0
44351,4,4351,[ 69 427 173 268 180],214,3,17846,4.100643382352941,0.0,0.0
44352,4,4352,[313 483  64 318  11],214,5,17851,4.100849988513668,80.0,20.0
44353,4,4353,[313 483  64 318  11],214,5,17856,4.101056499770326,80.0,20.0
44354,4,4354,[313 483  64 318  11],618,5,17861,4.101262916188289,80.0,20.0
44355,4,4355,[313 483  64 318  11],618,5,17866,4.101469237832874,80.0,20.0
44356,4,4356,[175   8 603  22 195],214,4,17870,4.10144594904751,0.0,0.0
44357,4,4357,[153 210   4 568 288],417,1,17871,4.100734281780634,0.0,20.0
44358,4,4358,[313 483  64 318  11],214,5,17876,4.100940582702455,80.0,20.0
44359,4,4359,[313 483  64 318  11],214,5,17881,4.1011467889908255,80.0,20.0
44360,4,4360,[313 483  64 318  11],214,5,17886,4.101352900710846,80.0,20.0
44361,4,4361,[288  69 276 125  25],314,3,17889,4.101100412654746,0.0,20.0
44362,4,4362,[313 483  64 318  11],618,5,17894,4.101306440522576,80.0,20.0
44363,4,4363,[ 69 268  22 216 173],314,3,17897,4.101054078826764,0.0,0.0
44364,4,4364,[313 483  64 318  11],618,5,17902,4.101260022909507,80.0,20.0
44365,4,4365,[300 322 597  69 288],416,3,17905,4.101007787448466,0.0,20.0
44366,4,4366,[405 187  22 181 275],416,5,17910,4.101213647813144,0.0,20.0
44367,4,4367,[313 483  64 318  11],214,5,17915,4.101419413919414,80.0,20.0
44368,4,4368,[427  71 403  98 588],922,4,17919,4.101396200503547,0.0,20.0
44369,4,4369,[313 483  64 318  11],214,5,17924,4.101601830663616,80.0,20.0
44370,4,4370,[313 483  64 318  11],618,5,17929,4.101807366735301,80.0,20.0
44371,4,4371,[313 483  64 318  11],214,5,17934,4.102012808783166,80.0,20.0
44372,4,4372,[ 98 215 294  50 328],43,5,17939,4.102218156871713,0.0,40.0
44373,4,4373,[ 70 210 168 568 153],751,4,17943,4.102194787379973,0.0,0.0
44374,4,4374,[172   8  97  11 403],405,4,17947,4.102171428571428,0.0,0.0
44375,4,4375,[182  22 183 100 258],297,4,17951,4.102148080438757,0.0,0.0
44376,4,4376,[276   8 181  98 655],618,3,17954,4.1018962759881195,0.0,40.0
44377,4,4377,[313 483  64 318  11],618,5,17959,4.1021014161717675,80.0,20.0
44378,4,4378,[496  98 276  69 235],43,4,17963,4.102078100022836,0.0,20.0
44379,4,4379,[191 179 210  50 237],262,2,17965,4.101598173515982,0.0,20.0
44380,4,4380,[191  98 118 210  71],128,5,17970,4.101803241269117,0.0,20.0
44381,4,4381,[ 88 588 181 655  28],416,4,17974,4.101780009128252,0.0,20.0
44382,4,4382,[313 483  64 318  11],618,5,17979,4.101984941820671,80.0,20.0
44383,4,4383,[161  88 275  69 181],437,2,17981,4.101505474452555,0.0,20.0
44384,4,4384,[313 483  64 318  11],214,5,17986,4.1017103762827825,80.0,20.0
44385,4,4385,[196 483 300 204 111],128,4,17990,4.101687186502508,20.0,0.0
44386,4,4386,[313 483  64 318  11],618,5,17995,4.101891953498974,80.0,20.0
44387,4,4387,[200 597 328 294 271],854,2,17997,4.101412944393801,0.0,0.0
44388,4,4388,[313 483  64 318  11],214,5,18002,4.101617680565049,80.0,20.0
44389,4,4389,[403 211  98 176 179],405,2,18004,4.101138952164009,0.0,20.0
44390,4,4390,[313 483  64 318  11],214,5,18009,4.101343657481212,80.0,20.0
44391,4,4391,[174 197 475   1 471],854,2,18011,4.100865209471767,0.0,0.0
44392,4,4392,[313 483  64 318  11],214,5,18016,4.101069883906215,80.0,20.0
44393,4,4393,[313 483  64 318  11],214,5,18021,4.101274465179791,80.0,20.0
44394,4,4394,[313 483  64 318  11],618,5,18026,4.101478953356087,80.0,20.0
44395,4,4395,[313 483  64 318  11],618,5,18031,4.101683348498635,80.0,20.0
44396,4,4396,[313 483  64 318  11],214,5,18036,4.101887650670912,80.0,20.0
44397,4,4397,[ 97 135 265 423  28],230,4,18040,4.101864483856298,0.0,0.0
44398,4,4398,[313 483  64 318  11],618,5,18045,4.102068651966356,80.0,20.0
44399,4,4399,[117 742 597 276 195],654,4,18049,4.102045454545454,0.0,0.0
44400,4,4400,[323 748  96 153 258],805,3,18052,4.101795046580323,0.0,0.0
44401,4,4401,[313 483  64 318  11],214,5,18057,4.101999091322126,80.0,20.0
44402,4,4402,[173 121 204 144 302],62,2,18059,4.101521689756984,0.0,0.0
44403,4,4403,[ 11 313   7 385 300],43,5,18064,4.10172570390554,20.0,20.0
44404,4,4404,[313 483  64 318  11],618,5,18069,4.101929625425653,80.0,20.0
44405,4,4405,[ 97  96 200 180  89],417,4,18073,4.1019064911484335,0.0,0.0
44406,4,4406,[313 483  64 318  11],214,5,18078,4.10211027910143,80.0,20.0
44407,4,4407,[  8  56 597  70   1],642,4,18082,4.102087114337568,0.0,0.0
44408,4,4408,[294   1 328 546  15],708,1,18083,4.101383533681107,0.0,0.0
44409,4,4409,[313 483  64 318  11],214,5,18088,4.101587301587301,80.0,20.0
44410,4,4410,[496 568 234 191 403],417,3,18091,4.101337565177964,0.0,0.0
44411,4,4411,[313 483  64 318  11],618,5,18096,4.1015412511332725,80.0,20.0
44412,4,4412,[181 196 174 215 210],921,5,18101,4.101744844776796,0.0,20.0
44413,4,4413,[288 222 151 276 257],203,4,18105,4.101721794290893,0.0,20.0
44414,4,4414,[313 483  64 318  11],214,5,18110,4.101925254813137,80.0,20.0
44415,4,4415,[191 111  79 423 151],416,4,18114,4.101902173913044,0.0,0.0
44416,4,4416,[ 97 185 186 568 237],230,4,18118,4.101879103463889,0.0,0.0
44417,4,4417,[313 483  64 318  11],214,5,18123,4.1020823902218195,80.0,20.0
44418,4,4418,[276  28 210 475 172],416,3,18126,4.10183299389002,0.0,0.0
44419,4,4419,[313 483  64 318  11],214,5,18131,4.102036199095022,80.0,20.0
44420,4,4420,[313 483  64 318  11],214,5,18136,4.102239312372767,80.0,20.0
44421,4,4421,[313 483  64 318  11],214,5,18141,4.102442333785618,80.0,20.0
44422,4,4422,[143 100 245 181 269],416,4,18145,4.102419172507348,0.0,20.0
44423,4,4423,[655  95 423 568  69],417,3,18148,4.102169981916817,0.0,0.0
44424,4,4424,[151 125 172 210 302],62,4,18152,4.102146892655367,0.0,0.0
44425,4,4425,[313 483  64 318  11],618,5,18157,4.102349751468594,80.0,20.0
44426,4,4426,[269 385 111 161 197],805,2,18159,4.101874858820872,0.0,0.0
44427,4,4427,[471 423  79 222 286],705,3,18162,4.1016260162601625,0.0,0.0
44428,4,4428,[313 483  64 318  11],214,5,18167,4.10182885527207,80.0,20.0
44429,4,4429,[471 275 173 204  70],618,0,18167,4.100902934537246,0.0,0.0
44430,4,4430,[194 185 172   4 195],416,5,18172,4.101105845181674,0.0,0.0
44431,4,4431,[313 483  64 318  11],214,5,18177,4.1013086642599275,80.0,20.0
44432,4,4432,[237 258 742  88 294],588,4,18181,4.101285810963231,0.0,0.0
44433,4,4433,[313 483  64 318  11],618,5,18186,4.10148849797023,80.0,20.0
44434,4,4434,[313 483  64 318  11],618,5,18191,4.101691093573844,80.0,20.0
44435,4,4435,[176 257 118 294 100],62,2,18193,4.1012173128945,0.0,0.0
44436,4,4436,[588 301 127 182 202],416,5,18198,4.101419878296146,0.0,0.0
44437,4,4437,[125  96 121 678 127],159,4,18202,4.1013970256872465,0.0,0.0
44438,4,4438,[  1   8 153 275 100],930,1,18203,4.10069835548547,0.0,0.0
44439,4,4439,[265 144 271 423 300],297,0,18203,4.099774774774775,0.0,0.0
44440,4,4440,[313 483  64 318  11],618,5,18208,4.099977482548976,80.0,20.0
44441,4,4441,[ 25  88 196 117 132],345,4,18212,4.09995497523638,0.0,0.0
44442,4,4442,[313 483  64 318  11],618,5,18217,4.100157551204141,80.0,20.0
44443,4,4443,[328 742 323  11 294],416,4,18221,4.10013501350135,0.0,0.0
44444,4,4444,[168 423 185   7 318],416,5,18226,4.100337457817773,20.0,0.0
44445,4,4445,[211 172 173 117 603],437,4,18230,4.100314889788574,0.0,0.0
44446,4,4446,[111 496 118 176  11],416,4,18234,4.100292331909152,0.0,0.0
44447,4,4447,[313 483  64 318  11],618,5,18239,4.100494604316546,80.0,20.0
44448,4,4448,[204  15 288  28  12],437,3,18242,4.1002472465722635,20.0,20.0
44449,4,4449,[313 483  64 318  11],618,5,18247,4.100449438202247,80.0,20.0
44450,4,4450,[200 179 655 515  82],405,2,18249,4.09997753313862,0.0,0.0
44451,4,4451,[121 742 235 546 597],62,3,18252,4.099730458221024,0.0,0.0
44452,4,4452,[313 483  64 318  11],618,5,18257,4.099932629687851,80.0,20.0
44453,4,4453,[313 483  64 318  11],214,5,18262,4.100134710372699,80.0,20.0
44454,4,4454,[ 11 405 546 238  50],43,4,18266,4.100112233445567,0.0,20.0
44455,4,4455,[313 483  64 318  11],214,5,18271,4.100314183123878,80.0,20.0
44456,4,4456,[313 483  64 318  11],214,5,18276,4.100516042180839,80.0,20.0
44457,4,4457,[313 483  64 318  11],214,5,18281,4.100717810677434,80.0,20.0
44458,4,4458,[313 483  64 318  11],618,5,18286,4.100919488674591,80.0,20.0
44459,4,4459,[313 483  64 318  11],214,5,18291,4.101121076233184,80.0,20.0
44460,4,4460,[385 202  69 132 153],642,2,18293,4.100650078457745,0.0,0.0
44461,4,4461,[313 483  64 318  11],618,5,18298,4.1008516360376515,80.0,20.0
44462,4,4462,[313 483  64 318  11],214,5,18303,4.101053103293749,80.0,20.0
44463,4,4463,[313 483  64 318  11],214,5,18308,4.101254480286738,80.0,20.0
44464,4,4464,[127 191 234 143 588],416,5,18313,4.101455767077268,0.0,0.0
44465,4,4465,[  4 180 357  71 215],62,4,18317,4.101433049708912,0.0,0.0
44466,4,4466,[313 483  64 318  11],618,5,18322,4.101634206402507,80.0,20.0
44467,4,4467,[288  88 313 318 357],416,4,18326,4.101611459265891,40.0,40.0
44468,4,4468,[202 200 471 100 125],618,2,18328,4.1011411948981875,0.0,0.0
44469,4,4469,[385 286 678 282 318],345,1,18329,4.100447427293065,20.0,0.0
44470,4,4470,[173 132 118 237 211],416,3,18332,4.100201297248938,0.0,0.0
44471,4,4471,[313 483  64 318  11],214,5,18337,4.100402504472272,80.0,20.0
44472,4,4472,[313 483  64 318  11],214,5,18342,4.100603621730382,80.0,20.0
44473,4,4473,[313  56 588 161 200],345,3,18345,4.100357621814931,20.0,20.0
44474,4,4474,[313 483  64 318  11],214,5,18350,4.100558659217877,80.0,20.0
44475,4,4475,[302   9 238 273 197],854,4,18354,4.100536193029491,0.0,0.0
44476,4,4476,[182 196  96 173  50],96,4,18358,4.100513736877374,0.0,20.0
44477,4,4477,[313 483  64 318  11],618,5,18363,4.100714604734256,80.0,20.0
44478,4,4478,[313 483  64 318  11],618,5,18368,4.100915382897968,80.0,20.0
44479,4,4479,[196 603 175 235 294],805,2,18370,4.100446428571429,0.0,0.0
44480,4,4480,[313 483  64 318  11],618,5,18375,4.100647176969426,80.0,20.0
44481,4,4481,[195  97  70 117 186],417,5,18380,4.100847835787595,0.0,0.0
44482,4,4482,[328   1 496 322 176],416,4,18384,4.100825340173991,0.0,0.0
44483,4,4483,[313 483  64 318  11],214,5,18389,4.101025869759144,80.0,20.0
44484,4,4484,[313 483  64 318  11],214,5,18394,4.101226309921962,80.0,20.0
44485,4,4485,[313 483  64 318  11],214,5,18399,4.101426660722247,80.0,20.0
44486,4,4486,[313 483  64 318  11],618,5,18404,4.101626922219746,80.0,20.0
44487,4,4487,[ 71 496 174 333   1],416,5,18409,4.101827094474153,0.0,0.0
44488,4,4488,[313 483  64 318  11],618,5,18414,4.102027177545111,80.0,20.0
44489,4,4489,[173  96   8 333 183],416,5,18419,4.1022271714922045,0.0,0.0
44490,4,4490,[588 234 118 202 161],588,3,18422,4.101981741260299,0.0,0.0
44491,4,4491,[ 82 132  71  89 286],437,1,18423,4.101291184327693,0.0,0.0
44492,4,4492,[ 82 143 742 318 161],588,5,18428,4.101491208546628,20.0,0.0
44493,4,4493,[313 483  64 318  11],214,5,18433,4.101691143747218,80.0,20.0
44494,4,4494,[357 603  22 323 475],416,3,18436,4.101446051167964,0.0,0.0
44495,4,4495,[ 70   8 111 182 174],62,3,18439,4.1012010676156585,0.0,0.0
44496,4,4496,[ 98 385 215  56 294],922,2,18441,4.100733822548365,0.0,20.0
44497,4,4497,[655 174 216  98 275],62,4,18445,4.100711427301023,0.0,20.0
44498,4,4498,[132 265 174  50  88],128,3,18448,4.100466770393421,0.0,20.0
44499,4,4499,[143  28   1  12 508],314,4,18452,4.100444444444444,20.0,0.0
44500,4,4500,[357 174 403   4  69],198,4,18456,4.100422128415907,0.0,0.0
44501,4,4501,[313 483  64 318  11],214,5,18461,4.100621945801866,80.0,20.0
44502,4,4502,[288   1 269 174 185],416,5,18466,4.1008216744392625,0.0,20.0
44503,4,4503,[313 483  64 318  11],214,5,18471,4.101021314387212,80.0,20.0
44504,4,4504,[313 483  64 318  11],618,5,18476,4.101220865704772,80.0,20.0
44505,4,4505,[655 118 276  11  88],416,2,18478,4.10075454948957,0.0,0.0
44506,4,4506,[313 483  64 318  11],214,5,18483,4.10095407144442,80.0,20.0
44507,4,4507,[245 678 294 216  71],416,3,18486,4.100709849157054,0.0,0.0
44508,4,4508,[302 294  15  82 135],62,2,18488,4.100243956531382,0.0,0.0
44509,4,4509,[182  82  71  79  97],128,4,18492,4.1002217294900225,0.0,0.0
44510,4,4510,[176 405 197 175 597],854,3,18495,4.099977831966305,0.0,0.0
44511,4,4511,[ 96 300  12 173 655],416,5,18500,4.100177304964539,20.0,0.0
44512,4,4512,[ 12 197  28 546 135],297,3,18503,4.09993352537115,20.0,0.0
44513,4,4513,[313 483  64 318  11],618,5,18508,4.100132919805051,80.0,20.0
44514,4,4514,[323 403 603 301 237],416,3,18511,4.099889258028793,0.0,0.0
44515,4,4515,[313 483  64 318  11],618,5,18516,4.100088573959256,80.0,20.0
44516,4,4516,[313 483  64 318  11],618,5,18521,4.100287801638255,80.0,20.0
44517,4,4517,[ 15  12 186 235 181],43,3,18524,4.100044267374945,20.0,20.0
44518,4,4518,[ 96 265 118 302 288],416,4,18528,4.100022128789555,0.0,20.0
44519,4,4519,[748 204 655 121 153],416,5,18533,4.100221238938053,0.0,0.0
44520,4,4520,[313 483  64 318  11],618,5,18538,4.100420261004203,80.0,20.0
44521,4,4521,[121 111 385 200 546],262,1,18539,4.099734630694383,0.0,0.0
44522,4,4522,[313 483  64 318  11],618,5,18544,4.099933672341367,80.0,20.0
44523,4,4523,[313 483  64 318  11],214,5,18549,4.100132625994695,80.0,20.0
44524,4,4524,[313 483  64 318  11],214,5,18554,4.100331491712708,80.0,20.0
44525,4,4525,[ 64 238 258 475 161],416,4,18558,4.100309323906319,20.0,0.0
44526,4,4526,[313 483  64 318  11],618,5,18563,4.100508062734703,80.0,20.0
44527,4,4527,[288 515 313  64 276],416,4,18567,4.100485865724382,40.0,40.0
44528,4,4528,[313 483  64 318  11],214,5,18572,4.100684477809671,80.0,20.0
44529,4,4529,[385 125 111 300 216],416,5,18577,4.100883002207506,0.0,0.0
44530,4,4530,[111 288  50 202  98],416,5,18582,4.101081438975943,0.0,60.0
44531,4,4531,[313 483  64 318  11],214,5,18587,4.101279788172992,80.0,20.0
44532,4,4532,[313 483  64 318  11],214,5,18592,4.101478049856607,80.0,20.0
44533,4,4533,[175 238  98  95 655],805,3,18595,4.101235112483458,0.0,20.0
44534,4,4534,[313 483  64 318  11],618,5,18600,4.1014332965821385,80.0,20.0
44535,4,4535,[216  15 195 215  88],373,5,18605,4.10163139329806,0.0,0.0
44536,4,4536,[313 483  64 318  11],214,5,18610,4.101829402689002,80.0,20.0
44537,4,4537,[313 483  64 318  11],618,5,18615,4.102027324812693,80.0,20.0
44538,4,4538,[313 483  64 318  11],214,5,18620,4.102225159726812,80.0,20.0
44539,4,4539,[313 483  64 318  11],214,5,18625,4.102422907488987,80.0,20.0
44540,4,4540,[100  79 475 117 172],198,2,18627,4.101959920722308,0.0,0.0
44541,4,4541,[313 483  64 318  11],618,5,18632,4.1021576398062525,80.0,20.0
44542,4,4542,[403 301 328 161 427],416,5,18637,4.102355271846798,0.0,0.0
44543,4,4543,[ 11   1 143 216 546],297,3,18640,4.102112676056338,0.0,0.0
44544,4,4544,[597 268   7  15 568],417,2,18642,4.101650165016502,0.0,0.0
44545,4,4545,[313 483  64 318  11],618,5,18647,4.101847778266608,80.0,20.0
44546,4,4546,[289 508 222 322 111],708,4,18651,4.1018253793710135,0.0,0.0
44547,4,4547,[313 483  64 318  11],618,5,18656,4.102022867194371,80.0,20.0
44548,4,4548,[237 204 318 568  22],642,4,18660,4.1020004396570675,20.0,0.0
44549,4,4549,[275 191 185 200 597],416,4,18664,4.101978021978022,0.0,0.0
44550,4,4550,[313 483  64 318  11],618,5,18669,4.102175346077785,80.0,20.0
44551,4,4551,[313 483  64 318  11],618,5,18674,4.102372583479789,80.0,20.0
44552,4,4552,[313 483  64 318  11],618,5,18679,4.102569734241159,80.0,20.0
44553,4,4553,[313 483  64 318  11],214,5,18684,4.102766798418973,80.0,20.0
44554,4,4554,[313 483  64 318  11],214,5,18689,4.102963776070252,80.0,20.0
44555,4,4555,[144 483 238 127  50],62,4,18693,4.102941176470588,20.0,20.0
44556,4,4556,[196 302  22 153 276],416,4,18697,4.102918586789555,0.0,0.0
44557,4,4557,[322 385 111 144 235],416,3,18700,4.102676612549364,0.0,0.0
44558,4,4558,[194 235 257  11 151],854,2,18702,4.102215398113621,0.0,0.0
44559,4,4559,[313 483  64 318  11],214,5,18707,4.1024122807017545,80.0,20.0
44560,4,4560,[748 313 132 237 174],416,4,18711,4.10238982679237,20.0,20.0
44561,4,4561,[313 483  64 318  11],214,5,18716,4.102586584831214,80.0,20.0
44562,4,4562,[186 143 405 127 475],601,3,18719,4.102344948498795,0.0,0.0
44563,4,4563,[313 483  64 318  11],214,5,18724,4.102541630148992,80.0,20.0
44564,4,4564,[313 483  64 318  11],214,5,18729,4.102738225629792,80.0,20.0
44565,4,4565,[ 95 257  50 655  70],751,4,18733,4.102715724923346,0.0,20.0
44566,4,4566,[313 483  64 318  11],618,5,18738,4.102912196190059,80.0,20.0
44567,4,4567,[289 191 202 405  95],764,4,18742,4.102889667250438,0.0,0.0
44568,4,4568,[313 483  64 318  11],618,5,18747,4.103086014445174,80.0,20.0
44569,4,4569,[508 135 174 173   9],854,4,18751,4.103063457330416,0.0,0.0
44570,4,4570,[117 322 286  70  98],416,4,18755,4.103040910085321,0.0,20.0
44571,4,4571,[313 483  64 318  11],214,5,18760,4.103237095363079,80.0,20.0
44572,4,4572,[313 483  64 318  11],214,5,18765,4.103433194839274,80.0,20.0
44573,4,4573,[273 245  82  12   9],62,4,18769,4.103410581547879,20.0,0.0
44574,4,4574,[313 483  64 318  11],214,5,18774,4.1036065573770495,80.0,20.0
44575,4,4575,[313 483  64 318  11],618,5,18779,4.1038024475524475,80.0,20.0
44576,4,4576,[111  25   4 328 301],416,5,18784,4.103998252130216,0.0,0.0
44577,4,4577,[313 483  64 318  11],214,5,18789,4.104193971166448,80.0,20.0
44578,4,4578,[237 471 269 197 588],416,4,18793,4.1041712164228,0.0,0.0
44579,4,4579,[313 483  64 318  11],618,5,18798,4.104366812227075,80.0,20.0
44580,4,4580,[313 483  64 318  11],618,5,18803,4.104562322636979,80.0,20.0
44581,4,4581,[179  71 275 191 655],416,4,18807,4.104539502400699,0.0,0.0
44582,4,4582,[ 98 222 238 175  50],805,5,18812,4.104734889810168,0.0,40.0
44583,4,4583,[313 483  64 318  11],618,5,18817,4.104930191972077,80.0,20.0
44584,4,4584,[234 132 288  89 216],417,3,18820,4.104689203925846,0.0,20.0
44585,4,4585,[195 748 161  22 294],805,0,18820,4.103794156127344,0.0,0.0
44586,4,4586,[ 28 313 174 186 302],405,5,18825,4.103989535644212,20.0,20.0
44587,4,4587,[ 71 168   8   7  25],805,3,18828,4.103748910200523,0.0,0.0
44588,4,4588,[238  70 186  11 385],618,3,18831,4.10350838962737,0.0,0.0
44589,4,4589,[313 483  64 318  11],618,5,18836,4.103703703703704,80.0,20.0
44590,4,4590,[174 237  56 111 328],721,3,18839,4.10346329775648,0.0,0.0
44591,4,4591,[313 483  64 318  11],618,5,18844,4.103658536585366,80.0,20.0
44592,4,4592,[313 483  64 318  11],618,5,18849,4.103853690398433,80.0,20.0
44593,4,4593,[313 483  64 318  11],214,5,18854,4.104048759251198,80.0,20.0
44594,4,4594,[313 483  64 318  11],618,5,18859,4.104243743199129,80.0,20.0
44595,4,4595,[313 483  64 318  11],214,5,18864,4.10443864229765,80.0,20.0
44596,4,4596,[ 15  25 191 655 423],618,3,18867,4.104198390254513,0.0,0.0
44597,4,4597,[471 127  82 597  28],618,4,18871,4.104175728577642,0.0,0.0
44598,4,4598,[313 483  64 318  11],214,5,18876,4.104370515329419,80.0,20.0
44599,4,4599,[313 483  64 318  11],618,5,18881,4.104565217391304,80.0,20.0
44600,4,4600,[483  11 196 195 181],417,4,18885,4.104542490762878,20.0,20.0
44601,4,4601,[313 483  64 318  11],618,5,18890,4.104737070838766,80.0,20.0
44602,4,4602,[313 483  64 318  11],214,5,18895,4.104931566369759,80.0,20.0
44603,4,4603,[385 238   8 496 181],654,4,18899,4.10490877497828,0.0,20.0
44604,4,4604,[313 483  64 318  11],618,5,18904,4.105103148751358,80.0,20.0
44605,4,4605,[313 483  64 318  11],618,5,18909,4.105297438124186,80.0,20.0
44606,4,4606,[313 483  64 318  11],618,5,18914,4.105491643151725,80.0,20.0
44607,4,4607,[603 268 151 176   4],854,2,18916,4.105034722222222,0.0,0.0
44608,4,4608,[117 172 568 588  15],417,2,18918,4.104577999566066,0.0,0.0
44609,4,4609,[313 483  64 318  11],618,5,18923,4.104772234273319,80.0,20.0
44610,4,4610,[313 483  64 318  11],214,5,18928,4.104966384732162,80.0,20.0
44611,4,4611,[202 265 211 127 322],417,3,18931,4.104726799653079,0.0,0.0
44612,4,4612,[328  15 215  71 111],43,5,18936,4.104920875785822,0.0,0.0
44613,4,4613,[678 245 475 197 216],416,2,18938,4.104464672735154,0.0,0.0
44614,4,4614,[  9 273  82   4  71],416,5,18943,4.1046587215601305,0.0,0.0
44615,4,4615,[313 483  64 318  11],214,5,18948,4.104852686308492,80.0,20.0
44616,4,4616,[313 483  64 318  11],214,5,18953,4.105046567034871,80.0,20.0
44617,4,4617,[313 483  64 318  11],618,5,18958,4.10524036379385,80.0,20.0
44618,4,4618,[180 403  56  64 121],198,3,18961,4.105001082485386,20.0,0.0
44619,4,4619,[143 196 151 357 483],601,2,18963,4.1045454545454545,20.0,0.0
44620,4,4620,[182 117 204 215 135],437,2,18965,4.104090023804371,0.0,0.0
44621,4,4621,[127 186 273  96 235],417,2,18967,4.103634790134141,0.0,0.0
44622,4,4622,[313 483  64 318  11],214,5,18972,4.103828682673589,80.0,20.0
44623,4,4623,[ 50  82 235 121 258],262,1,18973,4.103157439446367,0.0,20.0
44624,4,4624,[313 483  64 318  11],618,5,18978,4.1033513513513515,80.0,20.0
44625,4,4625,[313 483  64 318  11],618,5,18983,4.103545179420665,80.0,20.0
44626,4,4626,[234 288 185  96 357],417,2,18985,4.103090555435488,0.0,20.0
44627,4,4627,[222  95 588  22  79],705,4,18989,4.103068280034572,0.0,0.0
44628,4,4628,[ 96 151 125 294 268],854,1,18990,4.102397926117952,0.0,0.0
44629,4,4629,[182 234 258 471 238],297,2,18992,4.101943844492441,0.0,0.0
44630,4,4630,[313 483  64 318  11],214,5,18997,4.102137767220903,80.0,20.0
44631,4,4631,[313 483  64 318  11],214,5,19002,4.102331606217617,80.0,20.0
44632,4,4632,[313 483  64 318  11],618,5,19007,4.102525361536801,80.0,20.0
44633,4,4633,[313 483  64 318  11],214,5,19012,4.102719033232629,80.0,20.0
44634,4,4634,[ 69  22 173 222 357],601,4,19016,4.10269687162891,0.0,0.0
44635,4,4635,[313 483  64 318  11],618,5,19021,4.102890422778257,80.0,20.0
44636,4,4636,[313 483  64 318  11],618,5,19026,4.10308389044641,80.0,20.0
44637,4,4637,[132 257 127   7 121],62,4,19030,4.103061664510565,0.0,0.0
44638,4,4638,[125 180 211  69 174],373,4,19034,4.10303944815693,0.0,0.0
44639,4,4639,[313 483  64 318  11],618,5,19039,4.10323275862069,80.0,20.0
44640,4,4640,[313 483  64 318  11],618,5,19044,4.103425985778927,80.0,20.0
44641,4,4641,[204 185 269 143   1],297,3,19047,4.1031882809133995,0.0,0.0
44642,4,4642,[313 483  64 318  11],618,5,19052,4.103381434417402,80.0,20.0
44643,4,4643,[313 483  64 318  11],214,5,19057,4.103574504737296,80.0,20.0
44644,4,4644,[ 25 195 228  69 403],198,2,19059,4.103121636167923,0.0,0.0
44645,4,4645,[  9 153 276 496 179],601,5,19064,4.103314679294017,0.0,0.0
44646,4,4646,[215 180  97 427 176],198,3,19067,4.103077254142457,0.0,0.0
44647,4,4647,[313 483  64 318  11],618,5,19072,4.103270223752151,80.0,20.0
44648,4,4648,[ 11 748 215  28 234],416,5,19077,4.103463110346311,0.0,0.0
44649,4,4649,[100 313  56 161 678],416,4,19081,4.103440860215054,20.0,20.0
44650,4,4650,[313 483  64 318  11],618,5,19086,4.103633627176952,80.0,20.0
44651,4,4651,[234  95  70  28 143],642,3,19089,4.103396388650043,0.0,0.0
44652,4,4652,[132 172 185  50 125],230,5,19094,4.103589082312487,0.0,20.0
44653,4,4653,[313 483  64 318  11],214,5,19099,4.103781693167168,80.0,20.0
44654,4,4654,[216  11 234 182 187],198,4,19103,4.103759398496241,0.0,0.0
44655,4,4655,[196  97 655 174 197],721,4,19107,4.103737113402062,0.0,0.0
44656,4,4656,[ 28 588  11 132 161],437,1,19108,4.103070646338844,0.0,0.0
44657,4,4657,[313 483  64 318  11],214,5,19113,4.103263203091456,80.0,20.0
44658,4,4658,[288 313  15  95  28],654,3,19116,4.103026400515132,20.0,40.0
44659,4,4659,[313 483  64 318  11],618,5,19121,4.103218884120172,80.0,20.0
44660,4,4660,[313 483  64 318  11],618,5,19126,4.103411285131946,80.0,20.0
44661,4,4661,[  8 288 202 200  11],297,2,19128,4.102960102960103,0.0,20.0
44662,4,4662,[ 28 125 568 210  70],618,2,19130,4.102509114304096,0.0,0.0
44663,4,4663,[215 275 265 483 168],618,4,19134,4.102487135506004,20.0,0.0
44664,4,4664,[302 180  56 276  22],62,4,19138,4.102465166130761,0.0,0.0
44665,4,4665,[313 483  64 318  11],214,5,19143,4.102657522503215,80.0,20.0
44666,4,4666,[313 483  64 318  11],214,5,19148,4.102849796443111,80.0,20.0
44667,4,4667,[ 50 204 228 475 245],62,2,19150,4.102399314481577,0.0,20.0
44668,4,4668,[313 483  64 318  11],214,5,19155,4.102591561362176,80.0,20.0
44669,4,4669,[173  71  95 168 204],43,5,19160,4.102783725910064,0.0,0.0
44670,4,4670,[294 568 186  95 168],588,5,19165,4.102975808178121,0.0,0.0
44671,4,4671,[179  69 210 186 187],198,5,19170,4.103167808219178,0.0,0.0
44672,4,4672,[322 197   8 300 135],721,4,19174,4.103145730793923,0.0,0.0
44673,4,4673,[185 423  50  25  22],416,5,19179,4.103337612323491,0.0,20.0
44674,4,4674,[313 483  64 318  11],618,5,19184,4.103529411764706,80.0,20.0
44675,4,4675,[313 483  64 318  11],618,5,19189,4.103721129170231,80.0,20.0
44676,4,4676,[313 483  64 318  11],618,5,19194,4.103912764592688,80.0,20.0
44677,4,4677,[423  88 211 144  79],416,4,19198,4.103890551517742,0.0,0.0
44678,4,4678,[515 210 200 603 143],297,4,19202,4.103868347937594,0.0,0.0
44679,4,4679,[ 15 111 176 237 603],854,1,19203,4.103205128205128,0.0,0.0
44680,4,4680,[313 483  64 318  11],618,5,19208,4.103396710104678,80.0,20.0
44681,4,4681,[289 234 211 181 238],416,4,19212,4.103374626228107,0.0,20.0
44682,4,4682,[ 70 132 187 216 301],416,5,19217,4.103566090113175,0.0,0.0
44683,4,4683,[313 483  64 318  11],618,5,19222,4.103757472245944,80.0,20.0
44684,4,4684,[313 483  64 318  11],214,5,19227,4.103948772678762,80.0,20.0
44685,4,4685,[144 151 546 588 403],43,5,19232,4.104139991463935,0.0,0.0
44686,4,4686,[204 234 200  64 181],618,4,19236,4.1041177725624065,20.0,20.0
44687,4,4687,[588   8 288  71 228],887,5,19241,4.104308873720137,0.0,20.0
44688,4,4688,[313 483  64 318  11],618,5,19246,4.104499893367456,80.0,20.0
44689,4,4689,[313 483  64 318  11],214,5,19251,4.104690831556503,80.0,20.0
44690,4,4690,[234 153  15 117  97],416,5,19256,4.104881688339373,0.0,0.0
44691,4,4691,[313 483  64 318  11],214,5,19261,4.105072463768116,80.0,20.0
44692,4,4692,[313 483  64 318  11],214,5,19266,4.105263157894737,80.0,20.0
44693,4,4693,[313 483  64 318  11],214,5,19271,4.105453770771197,80.0,20.0
44694,4,4694,[121  71 333  56 176],416,5,19276,4.105644302449415,0.0,0.0
44695,4,4695,[515 125 282 173  71],416,5,19281,4.10583475298126,0.0,0.0
44696,4,4696,[ 50 185 496 173 216],214,4,19285,4.105812220566319,0.0,20.0
44697,4,4697,[546  22 423 204 748],297,1,19286,4.105151128139634,0.0,0.0
44698,4,4698,[313 483  64 318  11],618,5,19291,4.105341562034475,80.0,20.0
44699,4,4699,[117 655  70 100 237],345,5,19296,4.105531914893617,0.0,0.0
44700,4,4700,[313 483  64 318  11],214,5,19301,4.105722186768773,80.0,20.0
44701,4,4701,[313 483  64 318  11],214,5,19306,4.105912377711612,80.0,20.0
44702,4,4702,[313 483  64 318  11],618,5,19311,4.106102487773762,80.0,20.0
44703,4,4703,[313 483  64 318  11],214,5,19316,4.1062925170068025,80.0,20.0
44704,4,4704,[313 483  64 318  11],214,5,19321,4.106482465462274,80.0,20.0
44705,4,4705,[313 483  64 318  11],618,5,19326,4.10667233319167,80.0,20.0
44706,4,4706,[168 182  95  97  82],198,2,19328,4.106224771616741,0.0,0.0
44707,4,4707,[200 215 268 216  15],416,5,19333,4.10641461342396,0.0,0.0
44708,4,4708,[ 25 238 191 174 153],43,4,19337,4.10639201528987,0.0,0.0
44709,4,4709,[483 185 273 313 210],618,4,19341,4.106369426751592,40.0,20.0
44710,4,4710,[313 483  64 318  11],214,5,19346,4.106559116960305,80.0,20.0
44711,4,4711,[135  79 323 748  95],805,3,19349,4.106324278438031,0.0,0.0
44712,4,4712,[318  82 174  56  96],405,4,19353,4.106301718650541,20.0,0.0
44713,4,4713,[313 483  64 318  11],214,5,19358,4.106491302503182,80.0,20.0
44714,4,4714,[ 95 121 183 168 135],805,3,19361,4.106256627783669,0.0,0.0
44715,4,4715,[313 483  64 318  11],618,5,19366,4.106446140797286,80.0,20.0
44716,4,4716,[313 483  64 318  11],214,5,19371,4.106635573457706,80.0,20.0
44717,4,4717,[313 483  64 318  11],618,5,19376,4.106824925816023,80.0,20.0
44718,4,4718,[200 135 132   4 742],417,2,19378,4.106378470014834,0.0,0.0
44719,4,4719,[313 483  64 318  11],618,5,19383,4.10656779661017,80.0,20.0
44720,4,4720,[568 678 322 125 153],416,3,19386,4.106333403939844,0.0,0.0
44721,4,4721,[269 235  12  89 100],297,4,19390,4.106310885218128,20.0,0.0
44722,4,4722,[313 483  64 318  11],214,5,19395,4.106500105864916,80.0,20.0
44723,4,4723,[  8 228 222   1 143],805,2,19397,4.106054191363252,0.0,0.0
44724,4,4724,[313 483  64 318  11],618,5,19402,4.106243386243386,80.0,20.0
44725,4,4725,[196 427 194 471 187],416,5,19407,4.106432501057977,0.0,0.0
44726,4,4726,[313 483  64 318  11],618,5,19412,4.106621535857838,80.0,20.0
44727,4,4727,[655 265 405 111 186],417,2,19414,4.106175972927242,0.0,0.0
44728,4,4728,[313 483  64 318  11],618,5,19419,4.106364982025799,80.0,20.0
44729,4,4729,[313 483  64 318  11],618,5,19424,4.106553911205074,80.0,20.0
44730,4,4730,[313 483  64 318  11],214,5,19429,4.106742760515747,80.0,20.0
44731,4,4731,[313 483  64 318  11],618,5,19434,4.1069315300084535,80.0,20.0
44732,4,4732,[313 483  64 318  11],618,5,19439,4.107120219733784,80.0,20.0
44733,4,4733,[288  98 546 268 100],654,2,19441,4.10667511618082,0.0,40.0
44734,4,4734,[313 483  64 318  11],618,5,19446,4.106863780359029,80.0,20.0
44735,4,4735,[237 191  12  89  95],437,4,19450,4.106841216216216,20.0,0.0
44736,4,4736,[268   1  69 182 678],297,1,19451,4.106185349377243,0.0,0.0
44737,4,4737,[313 483  64 318  11],618,5,19456,4.106373997467286,80.0,20.0
44738,4,4738,[313 483  64 318  11],214,5,19461,4.106562565942182,80.0,20.0
44739,4,4739,[151 245 289 191  95],416,1,19462,4.105907172995781,0.0,0.0
44740,4,4740,[234 323 300 181 125],345,2,19464,4.105462982493145,0.0,20.0
44741,4,4741,[597  69 210 125 655],618,3,19467,4.10522986081822,0.0,0.0
44742,4,4742,[313 483  64 318  11],618,5,19472,4.105418511490618,80.0,20.0
44743,4,4743,[313 483  64 318  11],618,5,19477,4.105607082630692,80.0,20.0
44744,4,4744,[508 185 265 121 405],417,0,19477,4.104741833508957,0.0,0.0
44745,4,4745,[196 215  71 313 127],43,5,19482,4.104930467762326,20.0,20.0
44746,4,4746,[182 173 238  64 508],214,5,19487,4.105119022540552,20.0,0.0
44747,4,4747,[546 237 294 257 143],654,4,19491,4.105096882898063,0.0,0.0
44748,4,4748,[ 69  22 144 496  71],654,4,19495,4.10507475257949,0.0,0.0
44749,4,4749,[ 50 313  69  89 568],405,4,19499,4.105052631578947,20.0,40.0
44750,4,4750,[237   4 127  22 568],253,5,19504,4.105241001894338,0.0,0.0
44751,4,4751,[ 25 257 269 427  69],711,3,19507,4.105008417508418,0.0,0.0
44752,4,4752,[313 483  64 318  11],618,5,19512,4.105196717862403,80.0,20.0
44753,4,4753,[216 181  64 403 257],642,4,19516,4.1051745898191,20.0,20.0
44754,4,4754,[313 483  64 318  11],214,5,19521,4.1053627760252365,80.0,20.0
44755,4,4755,[471 216 100  79  50],297,3,19524,4.1051303616484445,0.0,20.0
44756,4,4756,[313 483  64 318  11],214,5,19529,4.105318478032373,80.0,20.0
44757,4,4757,[258 185 195 172 300],416,5,19534,4.105506515342581,0.0,0.0
44758,4,4758,[483 328 286 174  12],854,2,19536,4.1050640890943475,40.0,0.0
44759,4,4759,[313 483  64 318  11],214,5,19541,4.105252100840336,80.0,20.0
44760,4,4760,[195  50 210 508 273],62,5,19546,4.105440033606385,0.0,20.0
44761,4,4761,[313 483  64 318  11],214,5,19551,4.105627887442251,80.0,20.0
44762,4,4762,[313 483  64 318  11],214,5,19556,4.1058156623976485,80.0,20.0
44763,4,4763,[313 483  64 318  11],214,5,19561,4.10600335852225,80.0,20.0
44764,4,4764,[144   4  95 174 423],43,5,19566,4.106190975865688,0.0,0.0
44765,4,4765,[313 483  64 318  11],214,5,19571,4.106378514477549,80.0,20.0
44766,4,4766,[211 423 132  56 179],437,5,19576,4.106565974407384,0.0,0.0
44767,4,4767,[313 483  64 318  11],618,5,19581,4.106753355704698,80.0,20.0
44768,4,4768,[ 15  56  95 172   8],642,5,19586,4.106940658418956,0.0,0.0
44769,4,4769,[313 483  64 318  11],618,5,19591,4.10712788259958,80.0,20.0
44770,4,4770,[313 483  64 318  11],214,5,19596,4.107315028295955,80.0,20.0
44771,4,4771,[313 483  64 318  11],214,5,19601,4.107502095557418,80.0,20.0
44772,4,4772,[144 258 238 237 423],654,5,19606,4.107689084433271,0.0,0.0
44773,4,4773,[313 483  64 318  11],618,5,19611,4.107875994972769,80.0,20.0
44774,4,4774,[597 269 275  11 153],43,4,19615,4.107853403141362,0.0,0.0
44775,4,4775,[313 483  64 318  11],214,5,19620,4.108040201005025,80.0,20.0
44776,4,4776,[ 98 117  88 197 423],437,3,19623,4.107808247854302,0.0,20.0
44777,4,4777,[313 483  64 318  11],214,5,19628,4.107994976977815,80.0,20.0
44778,4,4778,[ 95 222 403 144 100],43,5,19633,4.10818162795564,0.0,0.0
44779,4,4779,[174 182   1 185  95],230,4,19637,4.1081589958158995,0.0,0.0
44780,4,4780,[742 183 508 185 211],417,2,19639,4.107718050617025,0.0,0.0
44781,4,4781,[288 121  64 125 742],345,2,19641,4.107277289836889,20.0,20.0
44782,4,4782,[313 483  64 318  11],618,5,19646,4.107463934768973,80.0,20.0
44783,4,4783,[313 483  64 318  11],618,5,19651,4.107650501672241,80.0,20.0
44784,4,4784,[742 151  25 186  82],43,4,19655,4.107628004179729,0.0,0.0
44785,4,4785,[313 483  64 318  11],214,5,19660,4.107814458838278,80.0,20.0
44786,4,4786,[313 483  64 318  11],618,5,19665,4.108000835596407,80.0,20.0
44787,4,4787,[313 483  64 318  11],618,5,19670,4.108187134502924,80.0,20.0
44788,4,4788,[175 276 187 300   7],198,2,19672,4.107746920025058,0.0,0.0
44789,4,4789,[313 483  64 318  11],618,5,19677,4.107933194154488,80.0,20.0
44790,4,4790,[313 483  64 318  11],618,5,19682,4.108119390523899,80.0,20.0
44791,4,4791,[313 483  64 318  11],214,5,19687,4.10830550918197,80.0,20.0
44792,4,4792,[313 483  64 318  11],214,5,19692,4.108491550177342,80.0,20.0
44793,4,4793,[173 143 211 234 423],405,4,19696,4.108468919482687,0.0,0.0
44794,4,4794,[313 483  64 318  11],618,5,19701,4.1086548488008345,80.0,20.0
44795,4,4795,[403 161 125  28 288],618,3,19704,4.108423686405338,0.0,20.0
44796,4,4796,[238  79 508 302 204],297,3,19707,4.108192620387742,0.0,0.0
44797,4,4797,[313 483  64 318  11],618,5,19712,4.108378491037932,80.0,20.0
44798,4,4798,[313 483  64 318  11],214,5,19717,4.1085642842258805,80.0,20.0
44799,4,4799,[172  98 143  82 183],805,3,19720,4.108333333333333,0.0,20.0
44800,4,4800,[313 483  64 318  11],618,5,19725,4.108519058529473,80.0,20.0
44801,4,4801,[181 222 174 135 196],297,5,19730,4.108704706372345,0.0,20.0
44802,4,4802,[313 483  64 318  11],214,5,19735,4.108890276910264,80.0,20.0
44803,4,4803,[655 195 181 313 742],416,5,19740,4.109075770191507,20.0,40.0
44804,4,4804,[ 79 237  96 202 271],907,5,19745,4.109261186264308,0.0,0.0
44805,4,4805,[427 597  98  95 179],416,2,19747,4.108822305451519,0.0,20.0
44806,4,4806,[ 97 135 173  70 294],417,4,19751,4.10879966715207,0.0,0.0
44807,4,4807,[313 237 153  88 403],43,5,19756,4.108985024958403,20.0,20.0
44808,4,4808,[313 483  64 318  11],214,5,19761,4.109170305676856,80.0,20.0
44809,4,4809,[234 357  64 187 132],405,5,19766,4.10935550935551,20.0,0.0
44810,4,4810,[276  88 385 294 423],416,3,19769,4.109124922053627,0.0,0.0
44811,4,4811,[228   8 435  88 179],405,1,19770,4.1084788029925186,0.0,0.0
44812,4,4812,[313 483  64 318  11],214,5,19775,4.108664034905464,80.0,20.0
44813,4,4813,[423 237 191 289 678],416,2,19777,4.108226007478189,0.0,0.0
44814,4,4814,[ 69 216 174 245 508],128,3,19780,4.107995846313603,0.0,0.0
44815,4,4815,[185 179   9 182 515],416,4,19784,4.107973421926911,0.0,0.0
44816,4,4816,[313 483  64 318  11],214,5,19789,4.108158604940835,80.0,20.0
44817,4,4817,[313 483  64 318  11],214,5,19794,4.108343711083437,80.0,20.0
44818,4,4818,[222 318  98 132 121],734,3,19797,4.108113716538701,20.0,20.0
44819,4,4819,[313 483  64 318  11],618,5,19802,4.108298755186722,80.0,20.0
44820,4,4820,[161 132 313 215 568],345,4,19806,4.108276291225887,20.0,20.0
44821,4,4821,[173 117 132 385 151],642,3,19809,4.108046453753629,0.0,0.0
44822,4,4822,[313 483  64 318  11],214,5,19814,4.108231391250259,80.0,20.0
44823,4,4823,[313 483  64 318  11],214,5,19819,4.108416252072969,80.0,20.0
44824,4,4824,[313 483  64 318  11],618,5,19824,4.10860103626943,80.0,20.0
44825,4,4825,[197 194 288  69 238],297,1,19825,4.107956900124327,0.0,20.0
44826,4,4826,[313 483  64 318  11],214,5,19830,4.108141702921069,80.0,20.0
44827,4,4827,[313 483  64 318  11],618,5,19835,4.108326429163214,80.0,20.0
44828,4,4828,[423 268  70 132 111],417,4,19839,4.108303996686685,0.0,0.0
44829,4,4829,[  1  50 117 568 168],654,5,19844,4.108488612836439,0.0,20.0
44830,4,4830,[181 238  95 185  25],711,5,19849,4.108673152556406,0.0,20.0
44831,4,4831,[ 15 197 237 111  89],437,3,19852,4.108443708609271,0.0,0.0
44832,4,4832,[ 50 282 588  89  95],705,3,19855,4.108214359611008,0.0,20.0
44833,4,4833,[215 182 237 161 357],198,3,19858,4.1079851055026895,0.0,0.0
44834,4,4834,[100 153 301 403 183],416,5,19863,4.1081695966907965,0.0,0.0
44835,4,4835,[318  22 328 237 269],416,4,19867,4.108147229114971,20.0,0.0
44836,4,4836,[ 88 117 202 151 196],416,3,19870,4.107918131072979,0.0,0.0
44837,4,4837,[234  69  95 546 179],417,3,19873,4.107689127738735,0.0,0.0
44838,4,4838,[216 288   9 258   7],62,4,19877,4.107666873320934,0.0,20.0
44839,4,4839,[168 273  82  12  98],416,5,19882,4.107851239669421,20.0,20.0
44840,4,4840,[245  56   4 228 125],62,3,19885,4.107622392067754,0.0,0.0
44841,4,4841,[183 234 181 228 258],297,3,19888,4.107393638992152,0.0,20.0
44842,4,4842,[313 483  64 318  11],618,5,19893,4.107577947553169,80.0,20.0
44843,4,4843,[313 483  64 318  11],618,5,19898,4.107762180016516,80.0,20.0
44844,4,4844,[568 301 286 385 172],345,3,19901,4.107533539731683,0.0,0.0
44845,4,4845,[313 483  64 318  11],214,5,19906,4.107717705323979,80.0,20.0
44846,4,4846,[265  22 245 423 135],297,2,19908,4.107282855374458,0.0,0.0
44847,4,4847,[ 98 173 603 496  79],128,5,19913,4.10746699669967,0.0,20.0
44848,4,4848,[313 483  64 318  11],618,5,19918,4.1076510620746545,80.0,20.0
44849,4,4849,[313 483  64 318  11],214,5,19923,4.107835051546392,80.0,20.0
44850,4,4850,[313 483  64 318  11],214,5,19928,4.108018965161822,80.0,20.0
44851,4,4851,[313 483  64 318  11],214,5,19933,4.108202802967848,80.0,20.0
44852,4,4852,[  9 268  56 202  71],416,5,19938,4.108386565011333,0.0,0.0
44853,4,4853,[748 179 174 176 568],416,4,19942,4.108364235681912,0.0,0.0
44854,4,4854,[ 88   9 143  64  15],314,5,19947,4.108547888774459,20.0,0.0
44855,4,4855,[111 194  28 132  97],416,5,19952,4.108731466227348,0.0,0.0
44856,4,4856,[125 318 405 181  82],887,5,19957,4.108914968087297,20.0,20.0
44857,4,4857,[313 483  64 318  11],618,5,19962,4.109098394400988,80.0,20.0
44858,4,4858,[313 483  64 318  11],214,5,19967,4.109281745215065,80.0,20.0
44859,4,4859,[313 483  64 318  11],618,5,19972,4.109465020576132,80.0,20.0
44860,4,4860,[313 483  64 318  11],618,5,19977,4.109648220530755,80.0,20.0
44861,4,4861,[ 15 176 508 357 132],601,3,19980,4.109419991772933,0.0,0.0
44862,4,4862,[742 144 174 288   8],297,2,19982,4.1089862224964016,0.0,20.0
44863,4,4863,[515  97 273  12 300],297,4,19986,4.1089638157894735,20.0,0.0
44864,4,4864,[288 125   7  71  96],416,5,19991,4.109146968139774,0.0,20.0
44865,4,4865,[275 179 403   4 435],373,3,19994,4.1089190300041105,0.0,0.0
44866,4,4866,[313 483  64 318  11],214,5,19999,4.109102116293404,80.0,20.0
44867,4,4867,[ 89 187 135 228  56],405,3,20002,4.108874281018899,0.0,0.0
44868,4,4868,[ 71 191 237  98 172],416,4,20006,4.108851920312179,0.0,20.0
44869,4,4869,[195 174 282   7  89],297,3,20009,4.108624229979466,0.0,0.0
44870,4,4870,[ 71 176  12 678 197],805,4,20013,4.108601929788544,20.0,0.0
44871,4,4871,[313 483  64 318  11],214,5,20018,4.108784893267652,80.0,20.0
44872,4,4872,[313 483  64 318  11],618,5,20023,4.1089677816540116,80.0,20.0
44873,4,4873,[ 56 318 427  64  15],262,4,20027,4.108945424702503,40.0,0.0
44874,4,4874,[313 483  64 318  11],618,5,20032,4.109128205128205,80.0,20.0
44875,4,4875,[  8 117  50  95 405],654,5,20037,4.109310910582445,0.0,20.0
44876,4,4876,[ 98 196  22 197 568],618,4,20041,4.109288497026861,0.0,20.0
44877,4,4877,[313 483  64 318  11],214,5,20046,4.109471094710947,80.0,20.0
44878,4,4878,[161   4 313  79 403],43,5,20051,4.109653617544579,20.0,20.0
44879,4,4879,[ 15 210   1 496 151],128,4,20055,4.109631147540983,0.0,0.0
44880,4,4880,[ 97 204 182 403 357],405,3,20058,4.10940381069453,0.0,0.0
44881,4,4881,[313 483  64 318  11],618,5,20063,4.1095862351495285,80.0,20.0
44882,4,4882,[257  79  70 323 515],416,3,20066,4.1093590006143765,0.0,0.0
44883,4,4883,[313 483  64 318  11],618,5,20071,4.1095413595413595,80.0,20.0
44884,4,4884,[313 483  64 318  11],214,5,20076,4.109723643807574,80.0,20.0
44885,4,4885,[313 483  64 318  11],618,5,20081,4.109905853458862,80.0,20.0
44886,4,4886,[313 483  64 318  11],618,5,20086,4.110087988541027,80.0,20.0
44887,4,4887,[313 483  64 318  11],618,5,20091,4.110270049099836,80.0,20.0
44888,4,4888,[313 483  64 318  11],214,5,20096,4.1104520351810185,80.0,20.0
44889,4,4889,[273  25 204 194 328],416,5,20101,4.110633946830266,0.0,0.0
44890,4,4890,[313 483  64 318  11],214,5,20106,4.110815784093233,80.0,20.0
44891,4,4891,[313 483  64 318  11],618,5,20111,4.110997547015535,80.0,20.0
44892,4,4892,[313 483  64 318  11],214,5,20116,4.111179235642755,80.0,20.0
44893,4,4893,[313 483  64 318  11],618,5,20121,4.111360850020433,80.0,20.0
44894,4,4894,[216  97  95 197   4],405,2,20123,4.110929519918284,0.0,0.0
44895,4,4895,[313 483  64 318  11],618,5,20128,4.111111111111111,80.0,20.0
44896,4,4896,[313 483  64 318  11],214,5,20133,4.111292628139678,80.0,20.0
44897,4,4897,[210 515 173 132 603],416,5,20138,4.1114740710494075,0.0,0.0
44898,4,4898,[  4   9 191   8 742],805,1,20139,4.110838946723821,0.0,0.0
44899,4,4899,[186 222 405 215 196],43,4,20143,4.110816326530612,0.0,0.0
44900,4,4900,[313 483  64 318  11],618,5,20148,4.110997755560089,80.0,20.0
44901,4,4901,[313 483  64 318  11],618,5,20153,4.111179110567115,80.0,20.0
44902,4,4902,[313 483  64 318  11],618,5,20158,4.111360391596982,80.0,20.0
44903,4,4903,[313 483  64 318  11],214,5,20163,4.111541598694943,80.0,20.0
44904,4,4904,[288 121 144 185 588],711,2,20165,4.111111111111111,0.0,20.0
44905,4,4905,[127 179  70  64 405],62,3,20168,4.110884631064003,20.0,0.0
44906,4,4906,[286  56 655 181 228],417,3,20171,4.110658243325861,0.0,20.0
44907,4,4907,[313 483  64 318  11],618,5,20176,4.110839445802771,80.0,20.0
44908,4,4908,[300 111 265  11  28],416,5,20181,4.1110205744550825,0.0,0.0
44909,4,4909,[ 28 588 282  79 197],345,2,20183,4.110590631364562,0.0,0.0
44910,4,4910,[313 483  64 318  11],214,5,20188,4.110771736917124,80.0,20.0
44911,4,4911,[294 405 333 210 173],345,3,20191,4.110545602605863,0.0,0.0
44912,4,4912,[313 483  64 318  11],214,5,20196,4.110726643598616,80.0,20.0
44913,4,4913,[286 276  15 742   1],764,3,20199,4.11050061050061,0.0,0.0
44914,4,4914,[313 483  64 318  11],618,5,20204,4.110681586978637,80.0,20.0
44915,4,4915,[313 483  64 318  11],618,5,20209,4.110862489829129,80.0,20.0
44916,4,4916,[313 483  64 318  11],618,5,20214,4.111043319097011,80.0,20.0
44917,4,4917,[179 423 238 216 273],416,4,20218,4.111020740138268,0.0,0.0
44918,4,4918,[  4 515 197 132  96],405,3,20221,4.110794877007522,0.0,0.0
44919,4,4919,[328 655 132 181 186],373,4,20225,4.110772357723577,0.0,20.0
44920,4,4920,[ 71 127 257 176 405],601,1,20226,4.110140215403374,0.0,0.0
44921,4,4921,[313 483  64 318  11],618,5,20231,4.110321007720438,80.0,20.0
44922,4,4922,[313 483  64 318  11],214,5,20236,4.110501726589478,80.0,20.0
44923,4,4923,[313 483  64 318  11],618,5,20241,4.11068237205524,80.0,20.0
44924,4,4924,[ 56 161  69 423 181],721,4,20245,4.110659898477158,0.0,20.0
44925,4,4925,[176  70 237 195 405],230,4,20249,4.110637434023548,0.0,0.0
44926,4,4926,[313 483  64 318  11],214,5,20254,4.110817941952506,80.0,20.0
44927,4,4927,[ 11  95 302  12 301],416,4,20258,4.110795454545454,20.0,0.0
44928,4,4928,[313 483  64 318  11],618,5,20263,4.11097585717184,80.0,20.0
44929,4,4929,[313 483  64 318  11],618,5,20268,4.111156186612576,80.0,20.0
44930,4,4930,[313 483  64 318  11],214,5,20273,4.111336442912188,80.0,20.0
44931,4,4931,[ 25 196 258 238 268],345,4,20277,4.111313868613139,0.0,0.0
44932,4,4932,[265 168  95 111 151],711,3,20280,4.111088587066694,0.0,0.0
44933,4,4933,[403 127   4 496 172],373,3,20283,4.1108633968382655,0.0,0.0
44934,4,4934,[313 483  64 318  11],618,5,20288,4.111043566362715,80.0,20.0
44935,4,4935,[313 483  64 318  11],214,5,20293,4.111223662884927,80.0,20.0
44936,4,4936,[313 483  64 318  11],214,5,20298,4.11140368644926,80.0,20.0
44937,4,4937,[ 79 405 200 161 196],198,1,20299,4.110773592547591,0.0,0.0
44938,4,4938,[289 405 153 200 496],416,4,20303,4.11075116420328,0.0,0.0
44939,4,4939,[288 357 195  82  96],417,3,20306,4.110526315789474,0.0,20.0
44940,4,4940,[313 483  64 318  11],618,5,20311,4.11070633475005,80.0,20.0
44941,4,4941,[187 235  82 275  22],416,4,20315,4.110683933630109,0.0,0.0
44942,4,4942,[313 483  64 318  11],214,5,20320,4.1108638478656685,80.0,20.0
44943,4,4943,[515 210 258 100   9],698,2,20322,4.110436893203883,0.0,0.0
44944,4,4944,[313 483  64 318  11],214,5,20327,4.11061678463094,80.0,20.0
44945,4,4945,[313 483  64 318  11],214,5,20332,4.11079660331581,80.0,20.0
44946,4,4946,[151 121 258 183  15],601,2,20334,4.110369921164342,0.0,0.0
44947,4,4947,[  8 508 179 172 597],62,4,20338,4.11034761519806,0.0,0.0
44948,4,4948,[ 64 196 222  25 385],43,5,20343,4.1105273792685395,20.0,0.0
44949,4,4949,[181   8 318 234 118],618,3,20346,4.11030303030303,20.0,20.0
44950,4,4950,[588  95 423 475 197],711,4,20350,4.110280751363361,0.0,0.0
44951,4,4951,[ 15 111 271  11 185],854,3,20353,4.110056542810986,0.0,0.0
44952,4,4952,[597 117 588 265 427],416,4,20357,4.110034322632748,0.0,0.0
44953,4,4953,[313 483  64 318  11],214,5,20362,4.110213968510295,80.0,20.0
44954,4,4954,[  7 204 328 423 300],43,5,20367,4.110393541876892,0.0,0.0
44955,4,4955,[313 483  64 318  11],618,5,20372,4.110573042776433,80.0,20.0
44956,4,4956,[313 483  64 318  11],618,5,20377,4.110752471252773,80.0,20.0
44957,4,4957,[204 301 135 215 111],297,2,20379,4.110326744655103,0.0,0.0
44958,4,4958,[313 483  64 318  11],214,5,20384,4.110506150433555,80.0,20.0
44959,4,4959,[748 186 322 268 403],417,4,20388,4.110483870967742,0.0,0.0
44960,4,4960,[235 195 183  28 204],416,4,20392,4.110461600483774,0.0,0.0
44961,4,4961,[313 483  64 318  11],214,5,20397,4.110640870616687,80.0,20.0
44962,4,4962,[313 483  64 318  11],214,5,20402,4.110820068506952,80.0,20.0
44963,4,4963,[313 483  64 318  11],618,5,20407,4.110999194198227,80.0,20.0
44964,4,4964,[234 191 153 294 655],805,3,20410,4.110775427995971,0.0,0.0
44965,4,4965,[313 483  64 318  11],214,5,20415,4.110954490535643,80.0,20.0
44966,4,4966,[313 483  64 318  11],618,5,20420,4.1111334809744315,80.0,20.0
44967,4,4967,[313 117 471 496 235],907,5,20425,4.111312399355878,20.0,20.0
44968,4,4968,[313 483  64 318  11],618,5,20430,4.111491245723486,80.0,20.0
44969,4,4969,[313 483  64 318  11],214,5,20435,4.111670020120724,80.0,20.0
44970,4,4970,[313 483  64 318  11],214,5,20440,4.111848722591028,80.0,20.0
44971,4,4971,[265 403 237 174 273],618,5,20445,4.112027353177796,0.0,0.0
44972,4,4972,[313 483  64 318  11],214,5,20450,4.112205911924391,80.0,20.0
44973,4,4973,[  9 125  50 385 276],618,2,20452,4.11178126256534,0.0,20.0
44974,4,4974,[568 196 153 118 111],805,1,20453,4.111155778894473,0.0,0.0
44975,4,4975,[ 71   1 125 328 568],416,5,20458,4.111334405144695,0.0,0.0
44976,4,4976,[313 483  64 318  11],214,5,20463,4.111512959614226,80.0,20.0
44977,4,4977,[235  15 234 496  88],642,3,20466,4.111289674568099,0.0,0.0
44978,4,4978,[313 483  64 318  11],214,5,20471,4.111468166298454,80.0,20.0
44979,4,4979,[313 483  64 318  11],618,5,20476,4.1116465863453815,80.0,20.0
44980,4,4980,[313 483  64 318  11],214,5,20481,4.1118249347520575,80.0,20.0
44981,4,4981,[313 483  64 318  11],214,5,20486,4.112003211561622,80.0,20.0
44982,4,4982,[313 483  64 318  11],214,5,20491,4.112181416817179,80.0,20.0
44983,4,4983,[ 96 172 181 191  56],416,5,20496,4.112359550561798,0.0,20.0
44984,4,4984,[313 483  64 318  11],618,5,20501,4.112537612838516,80.0,20.0
44985,4,4985,[313 483  64 318  11],214,5,20506,4.112715603690333,80.0,20.0
44986,4,4986,[313 483  64 318  11],214,5,20511,4.112893523160216,80.0,20.0
44987,4,4987,[ 82 195 194  28 117],373,3,20514,4.112670408981556,0.0,0.0
44988,4,4988,[151 238 153 475 276],437,4,20518,4.112647825215474,0.0,0.0
44989,4,4989,[211  88  64 173  71],405,2,20520,4.112224448897796,20.0,0.0
44990,4,4990,[678 235  22 245 568],416,2,20522,4.111801242236025,0.0,0.0
44991,4,4991,[288 174 323 258  15],417,2,20524,4.111378205128205,0.0,20.0
44992,4,4992,[313 483  64 318  11],618,5,20529,4.11155617865011,80.0,20.0
44993,4,4993,[313 483  64 318  11],214,5,20534,4.111734080897077,80.0,20.0
44994,4,4994,[143 176 427 237  98],198,3,20537,4.1115115115115115,0.0,20.0
44995,4,4995,[258  50 210 204 168],654,5,20542,4.111689351481185,0.0,20.0
44996,4,4996,[313 483  64 318  11],618,5,20547,4.111867120272163,80.0,20.0
44997,4,4997,[245 322 144  56 403],416,3,20550,4.111644657863145,0.0,0.0
44998,4,4998,[313 483  64 318  11],214,5,20555,4.111822364472895,80.0,20.0
44999,4,4999,[678 222  28  79 172],805,4,20559,4.1118,0.0,0.0
45000,4,5000,[313 483  64 318  11],214,5,20564,4.1119776044791045,80.0,20.0
45001,4,5001,[173  69 143 748 135],437,4,20568,4.1119552179128345,0.0,0.0
45002,4,5002,[ 96 273 237 121 117],253,4,20572,4.111932840295823,0.0,0.0
45003,4,5003,[294  50 111 228 235],887,4,20576,4.111910471622702,0.0,20.0
45004,4,5004,[313 483  64 318  11],214,5,20581,4.112087912087912,80.0,20.0
45005,4,5005,[313 483  64 318  11],214,5,20586,4.112265281662006,80.0,20.0
45006,4,5006,[313 483  64 318  11],618,5,20591,4.112442580387458,80.0,20.0
45007,4,5007,[202 748 302 185 176],416,5,20596,4.112619808306709,0.0,0.0
45008,4,5008,[ 15 655 603 194 191],373,5,20601,4.112796965462168,0.0,0.0
45009,4,5009,[313 483  64 318  11],214,5,20606,4.112974051896208,80.0,20.0
45010,4,5010,[313 483  64 318  11],618,5,20611,4.113151067651168,80.0,20.0
45011,4,5011,[423  12 197 300 202],416,5,20616,4.113328012769354,20.0,0.0
45012,4,5012,[313 483  64 318  11],618,5,20621,4.113504887293038,80.0,20.0
45013,4,5013,[403 568 179 111 161],417,2,20623,4.113083366573594,0.0,0.0
45014,4,5014,[313 483  64 318  11],214,5,20628,4.113260219341974,80.0,20.0
45015,4,5015,[313 483  64 318  11],214,5,20633,4.113437001594896,80.0,20.0
45016,4,5016,[216 286 742 508 161],417,1,20634,4.112816424157863,0.0,0.0
45017,4,5017,[313 483  64 318  11],618,5,20639,4.112993224392188,80.0,20.0
45018,4,5018,[313 483  64 318  11],618,5,20644,4.113169954174138,80.0,20.0
45019,4,5019,[313 483  64 318  11],618,5,20649,4.113346613545817,80.0,20.0
45020,4,5020,[313 483  64 318  11],214,5,20654,4.113523202549293,80.0,20.0
45021,4,5021,[204 191 117  22 216],297,3,20657,4.113301473516527,0.0,0.0
45022,4,5022,[313 483  64 318  11],618,5,20662,4.113478001194506,80.0,20.0
45023,4,5023,[515 286 603 200 678],416,4,20666,4.113455414012739,0.0,0.0
45024,4,5024,[237 568  22 275 172],416,4,20670,4.113432835820896,0.0,0.0
45025,4,5025,[313 483  64 318  11],618,5,20675,4.1136092319936335,80.0,20.0
45026,4,5026,[313 483  64 318  11],214,5,20680,4.113785557986871,80.0,20.0
45027,4,5027,[313 483  64 318  11],214,5,20685,4.113961813842482,80.0,20.0
45028,4,5028,[ 95 318  96 276 289],416,2,20687,4.113541459534699,20.0,0.0
45029,4,5029,[313 483  64 318  11],214,5,20692,4.113717693836978,80.0,20.0
45030,4,5030,[151  70 357  96 175],198,3,20695,4.113496322798649,0.0,0.0
45031,4,5031,[313 483  64 318  11],618,5,20700,4.113672496025437,80.0,20.0
45032,4,5032,[313 483  64 318  11],214,5,20705,4.113848599244983,80.0,20.0
45033,4,5033,[313 483  64 318  11],618,5,20710,4.114024632499007,80.0,20.0
45034,4,5034,[313 483  64 318  11],214,5,20715,4.114200595829196,80.0,20.0
45035,4,5035,[313 483  64 318  11],618,5,20720,4.114376489277205,80.0,20.0
45036,4,5036,[313 483  64 318  11],214,5,20725,4.114552312884654,80.0,20.0
45037,4,5037,[597 245 172 125 405],417,2,20727,4.114132592298531,0.0,0.0
45038,4,5038,[313 483  64 318  11],214,5,20732,4.114308394522722,80.0,20.0
45039,4,5039,[313 483  64 318  11],214,5,20737,4.114484126984127,80.0,20.0
45040,4,5040,[276 183 196 210 121],618,3,20740,4.114263043047014,0.0,0.0
45041,4,5041,[ 70 237  71  69  98],230,5,20745,4.114438714795716,0.0,20.0
45042,4,5042,[313 483  64 318  11],214,5,20750,4.114614316874876,80.0,20.0
45043,4,5043,[313 483  64 318  11],618,5,20755,4.114789849325931,80.0,20.0
45044,4,5044,[313 483  64 318  11],214,5,20760,4.114965312190288,80.0,20.0
45045,4,5045,[423 153 286 302 100],416,5,20765,4.115140705509314,0.0,0.0
45046,4,5046,[313 483  64 318  11],214,5,20770,4.115316029324351,80.0,20.0
45047,4,5047,[313 483  64 318  11],214,5,20775,4.115491283676704,80.0,20.0
45048,4,5048,[313 483  64 318  11],214,5,20780,4.115666468607645,80.0,20.0
45049,4,5049,[181 216 125 234 161],588,4,20784,4.115643564356436,0.0,20.0
45050,4,5050,[ 79  70  95   1 546],297,1,20785,4.115026727380717,0.0,0.0
45051,4,5051,[313 483  64 318  11],214,5,20790,4.11520190023753,80.0,20.0
45052,4,5052,[  1   8  28 275 121],618,3,20793,4.114981199287552,0.0,0.0
45053,4,5053,[313 483  64 318  11],618,5,20798,4.115156311832212,80.0,20.0
45054,4,5054,[ 28 118 168 191 245],297,2,20800,4.114737883283877,0.0,0.0
45055,4,5055,[185 194 211 273  69],297,3,20803,4.1145174050632916,0.0,0.0
45056,4,5056,[313 483  64 318  11],618,5,20808,4.114692505438007,80.0,20.0
45057,4,5057,[234 127 475  56 118],805,3,20811,4.1144721233689205,0.0,0.0
45058,4,5058,[  7 153  95 289 496],342,4,20815,4.114449495947816,0.0,0.0
45059,4,5059,[176 185  96 257 222],601,2,20817,4.11403162055336,0.0,0.0
45060,4,5060,[313 483  64 318  11],214,5,20822,4.114206678522031,80.0,20.0
45061,4,5061,[180 258 151 183 197],805,3,20825,4.113986566574477,0.0,0.0
45062,4,5062,[ 70 483 144 273 196],62,3,20828,4.11376654157614,20.0,0.0
45063,4,5063,[ 11 276  96 143 197],416,4,20832,4.113744075829384,0.0,0.0
45064,4,5064,[313 483  64 318  11],214,5,20837,4.113919052319842,80.0,20.0
45065,4,5065,[313 483  64 318  11],618,5,20842,4.114093959731544,80.0,20.0
45066,4,5066,[195 173 228 153 204],805,2,20844,4.113676731793961,0.0,0.0
45067,4,5067,[301 588  89 202  70],437,1,20845,4.113062352012628,0.0,0.0
45068,4,5068,[313 483  64 318  11],214,5,20850,4.113237324916157,80.0,20.0
45069,4,5069,[313 483  64 318  11],618,5,20855,4.113412228796844,80.0,20.0
45070,4,5070,[151 132 427 186 496],128,3,20858,4.113192664168803,0.0,0.0
45071,4,5071,[313 483  64 318  11],618,5,20863,4.113367507886435,80.0,20.0
45072,4,5072,[313 483  64 318  11],618,5,20868,4.113542282672975,80.0,20.0
45073,4,5073,[313 483  64 318  11],618,5,20873,4.113716988569176,80.0,20.0
45074,4,5074,[313 483  64 318  11],214,5,20878,4.113891625615763,80.0,20.0
45075,4,5075,[313 483  64 318  11],618,5,20883,4.114066193853428,80.0,20.0
45076,4,5076,[ 96 185  64 357 546],416,4,20887,4.114043726610203,20.0,0.0
45077,4,5077,[  8   4  82 228 173],805,1,20888,4.113430484442694,0.0,0.0
45078,4,5078,[195 275  98  28  82],437,2,20890,4.113014372908053,0.0,20.0
45079,4,5079,[269 195 196 153 288],805,2,20892,4.11259842519685,0.0,20.0
45080,4,5080,[313 483  64 318  11],618,5,20897,4.112773076166109,80.0,20.0
45081,4,5081,[210 302 286 174 288],297,4,20901,4.1127508854781585,0.0,20.0
45082,4,5082,[313 483  64 318  11],214,5,20906,4.1129254377336215,80.0,20.0
45083,4,5083,[385  25 275 194 191],416,5,20911,4.113099921321794,0.0,0.0
45084,4,5084,[ 11 118  70  71 181],43,5,20916,4.113274336283186,0.0,20.0
45085,4,5085,[313 483  64 318  11],618,5,20921,4.1134486826582775,80.0,20.0
45086,4,5086,[313 483  64 318  11],618,5,20926,4.113622960487517,80.0,20.0
45087,4,5087,[603 273  56 655 271],805,2,20928,4.113207547169812,0.0,0.0
45088,4,5088,[313 483  64 318  11],214,5,20933,4.113381803890745,80.0,20.0
45089,4,5089,[202 174 127 302 182],416,5,20938,4.113555992141454,0.0,0.0
45090,4,5090,[135 210 174  12 215],437,3,20941,4.1133372618346105,20.0,0.0
45091,4,5091,[313 483  64 318  11],214,5,20946,4.113511390416339,80.0,20.0
45092,4,5092,[313 483  64 318  11],214,5,20951,4.113685450618496,80.0,20.0
45093,4,5093,[313 483  64 318  11],618,5,20956,4.113859442481351,80.0,20.0
45094,4,5094,[180 121  28 191  71],128,5,20961,4.114033366045143,0.0,0.0
45095,4,5095,[313 483  64 318  11],618,5,20966,4.114207221350078,80.0,20.0
45096,4,5096,[202 117 121 313  15],642,4,20970,4.114184814596822,20.0,20.0
45097,4,5097,[121 151 405 300 313],872,4,20974,4.114162416633974,20.0,20.0
45098,4,5098,[215 475 144 238  71],416,4,20978,4.114140027456364,0.0,0.0
45099,4,5099,[ 70 200  15  56  11],198,3,20981,4.113921568627451,0.0,0.0
45100,4,5100,[313 483  64 318  11],214,5,20986,4.114095275436189,80.0,20.0
45101,4,5101,[313 483  64 318  11],214,5,20991,4.114268914151313,80.0,20.0
45102,4,5102,[313 483  64 318  11],214,5,20996,4.114442484812855,80.0,20.0
45103,4,5103,[313 483  64 318  11],618,5,21001,4.114615987460815,80.0,20.0
45104,4,5104,[144 568 183 127 302],417,2,21003,4.114201762977473,0.0,0.0
45105,4,5105,[191 268   1   7 748],416,5,21008,4.114375244810027,0.0,0.0
45106,4,5106,[385 151 475 678 515],416,2,21010,4.1139612296847465,0.0,0.0
45107,4,5107,[  4  79 234 216  22],416,5,21015,4.114134690681285,0.0,0.0
45108,4,5108,[313 483  64 318  11],618,5,21020,4.114308083773732,80.0,20.0
45109,4,5109,[294  56 238  50 289],345,3,21023,4.114090019569471,0.0,20.0
45110,4,5110,[ 98 179 237 257 196],62,3,21026,4.113872040696537,0.0,20.0
45111,4,5111,[143 216 173 237 568],751,3,21029,4.113654147104851,0.0,0.0
45112,4,5112,[153   9 333  64 288],416,5,21034,4.11382749853315,20.0,20.0
45113,4,5113,[313 483  64 318  11],214,5,21039,4.114000782166602,80.0,20.0
45114,4,5114,[235 176 496  12 183],417,3,21042,4.1137829912023465,20.0,0.0
45115,4,5115,[313 483  64 318  11],214,5,21047,4.113956215793589,80.0,20.0
45116,4,5116,[313 483  64 318  11],214,5,21052,4.1141293726793045,80.0,20.0
45117,4,5117,[222  28 268 475 132],588,3,21055,4.1139116842516605,0.0,0.0
45118,4,5118,[357 144  96  89 135],805,4,21059,4.1138894315295955,0.0,0.0
45119,4,5119,[179 238 269 748 385],373,3,21062,4.113671875,0.0,0.0
45120,4,5120,[222 385 185 174 588],417,1,21063,4.113063854715876,0.0,0.0
45121,4,5121,[ 69 111 269 175 268],854,3,21066,4.112846544318626,0.0,0.0
45122,4,5122,[313 483  64 318  11],214,5,21071,4.1130197150107355,80.0,20.0
45123,4,5123,[265 211 300 258  69],297,2,21073,4.112607338017174,0.0,0.0
45124,4,5124,[313 483  64 318  11],618,5,21078,4.112780487804878,80.0,20.0
45125,4,5125,[245 288 265 174  50],416,4,21082,4.112758486149044,0.0,40.0
45126,4,5126,[313 483  64 318  11],214,5,21087,4.112931538911644,80.0,20.0
45127,4,5127,[111 181 180 588 286],711,4,21091,4.112909516380655,0.0,20.0
45128,4,5128,[588 237  50 273  98],764,3,21094,4.112692532657438,0.0,40.0
45129,4,5129,[ 50   4  11 173  82],654,5,21099,4.112865497076023,0.0,20.0
45130,4,5130,[ 22 211 100  95 185],230,5,21104,4.113038394075229,0.0,0.0
45131,4,5131,[475  98  50 118 286],417,4,21108,4.113016367887763,0.0,40.0
45132,4,5132,[313 483  64 318  11],214,5,21113,4.113189168127801,80.0,20.0
45133,4,5133,[234 258 210  69 268],588,4,21117,4.113167121153097,0.0,0.0
45134,4,5134,[237 385 294 258 168],654,4,21121,4.113145082765336,0.0,0.0
45135,4,5135,[313 483  64 318  11],618,5,21126,4.113317757009346,80.0,20.0
45136,4,5136,[313 483  64 318  11],214,5,21131,4.113490364025696,80.0,20.0
45137,4,5137,[603 183 288  25 385],805,3,21134,4.1132736473335925,0.0,20.0
45138,4,5138,[176 273 191 603 216],854,3,21137,4.11305701498346,0.0,0.0
45139,4,5139,[508  28 216 202 423],128,4,21141,4.1130350194552525,0.0,0.0
45140,4,5140,[111 173   9 496 328],314,4,21145,4.113013032483953,0.0,0.0
45141,4,5141,[ 98  79 333  88  71],416,4,21149,4.112991054064566,0.0,20.0
45142,4,5142,[  1 357 655 173 403],417,5,21154,4.113163523235466,0.0,0.0
45143,4,5143,[197  69 175 228  11],405,3,21157,4.112947122861586,0.0,0.0
45144,4,5144,[313 483  64 318  11],618,5,21162,4.113119533527697,80.0,20.0
45145,4,5145,[357  98 210 403  69],198,5,21167,4.113291877186164,0.0,20.0
45146,4,5146,[268 181 294  28 286],588,5,21172,4.113464153876044,0.0,20.0
45147,4,5147,[313 483  64 318  11],618,5,21177,4.113636363636363,80.0,20.0
45148,4,5148,[ 12 176  98  56 678],416,4,21181,4.113614294037677,20.0,20.0
45149,4,5149,[144 496 186  95 238],437,3,21184,4.113398058252427,0.0,0.0
45150,4,5150,[313 483  64 318  11],618,5,21189,4.113570180547467,80.0,20.0
45151,4,5151,[313 483  64 318  11],214,5,21194,4.113742236024844,80.0,20.0
45152,4,5152,[333 187  71   1  82],416,5,21199,4.113914224723462,0.0,0.0
45153,4,5153,[313 483  64 318  11],214,5,21204,4.1140861466821885,80.0,20.0
45154,4,5154,[168   4 183 127  11],198,4,21208,4.114064015518914,0.0,0.0
45155,4,5155,[357 258 237 151 597],854,3,21211,4.113847944142746,0.0,0.0
45156,4,5156,[313 483  64 318  11],618,5,21216,4.114019778941245,80.0,20.0
45157,4,5157,[655  28  88 238  11],416,4,21220,4.113997673516867,0.0,0.0
45158,4,5158,[ 12 191 238   1 197],345,4,21224,4.113975576662144,20.0,0.0
45159,4,5159,[313 483  64 318  11],214,5,21229,4.114147286821705,80.0,20.0
45160,4,5160,[313 483  64 318  11],618,5,21234,4.114318930439837,80.0,20.0
45161,4,5161,[200 273 282 245  50],416,4,21238,4.114296784192174,0.0,20.0
45162,4,5162,[313 483  64 318  11],214,5,21243,4.114468332364904,80.0,20.0
45163,4,5163,[125 427 294 200 568],416,5,21248,4.114639814097599,0.0,0.0
45164,4,5164,[313 483  64 318  11],214,5,21253,4.114811229428848,80.0,20.0
45165,4,5165,[471  50  95 265 655],705,4,21257,4.1147890050329075,0.0,20.0
45166,4,5166,[313 483  64 318  11],618,5,21262,4.114960325140314,80.0,20.0
45167,4,5167,[313 483  64 318  11],618,5,21267,4.115131578947368,80.0,20.0
45168,4,5168,[153 200  95   8 183],805,3,21270,4.114915844457342,0.0,0.0
45169,4,5169,[ 25 265 195 423 655],417,3,21273,4.114700193423598,0.0,0.0
45170,4,5170,[313 483  64 318  11],214,5,21278,4.11487139818217,80.0,20.0
45171,4,5171,[143   8  25 275  71],618,2,21280,4.11446249033256,0.0,0.0
45172,4,5172,[215 234 202 286 318],345,3,21283,4.114247052000773,20.0,0.0
45173,4,5173,[313 483  64 318  11],618,5,21288,4.114418245071511,80.0,20.0
45174,4,5174,[313 483  64 318  11],618,5,21293,4.114589371980676,80.0,20.0
45175,4,5175,[313 483  64 318  11],618,5,21298,4.114760432766615,80.0,20.0
45176,4,5176,[151 302 132  88 237],345,5,21303,4.114931427467646,0.0,0.0
45177,4,5177,[313 483  64 318  11],214,5,21308,4.115102356122055,80.0,20.0
45178,4,5178,[  9   4  95 294  28],43,5,21313,4.115273218768102,0.0,0.0
45179,4,5179,[210 385  97 100 294],654,2,21315,4.114864864864865,0.0,0.0
45180,4,5180,[286  71 496 153 127],416,5,21320,4.115035707392395,0.0,0.0
45181,4,5181,[313 483  64 318  11],214,5,21325,4.115206483983018,80.0,20.0
45182,4,5182,[313 185   7 318 132],618,5,21330,4.115377194674899,40.0,20.0
45183,4,5183,[265 302 288 294  69],297,1,21331,4.114776234567901,0.0,20.0
45184,4,5184,[313 483  64 318  11],214,5,21336,4.114946962391514,80.0,20.0
45185,4,5185,[313 483  64 318  11],618,5,21341,4.115117624373313,80.0,20.0
45186,4,5186,[202 210 118 318 179],437,3,21344,4.114902641218431,20.0,0.0
45187,4,5187,[215 357 234 265 183],416,5,21349,4.115073245952197,0.0,0.0
45188,4,5188,[237 144   4  15 302],654,4,21353,4.115051069570245,0.0,0.0
45189,4,5189,[265  71 237 655  56],922,3,21356,4.114836223506744,0.0,0.0
45190,4,5190,[405 288  11 195 257],416,4,21360,4.114814101329224,0.0,20.0
45191,4,5191,[288   7 265 286 568],417,1,21361,4.114214175654854,0.0,20.0
45192,4,5192,[151  88  70 568  64],642,3,21364,4.113999614866166,20.0,0.0
45193,4,5193,[313 483  64 318  11],618,5,21369,4.114170196380439,80.0,20.0
45194,4,5194,[135   1 742 195 202],230,3,21372,4.11395572666025,0.0,0.0
45195,4,5195,[127 357  89 117 294],854,3,21375,4.1137413394919164,0.0,0.0
45196,4,5196,[144 174 210 143 191],416,5,21380,4.113911872233981,0.0,0.0
45197,4,5197,[313 483  64 318  11],214,5,21385,4.114082339361293,80.0,20.0
45198,4,5198,[211  98  96 288 196],417,3,21388,4.1138680515483745,0.0,40.0
45199,4,5199,[313 483  64 318  11],618,5,21393,4.1140384615384615,80.0,20.0
45200,4,5200,[ 71 276 204 151 302],416,3,21396,4.1138242645645064,0.0,0.0
45201,4,5201,[196 300  97  89 258],198,2,21398,4.113417916186083,0.0,0.0
45202,4,5202,[313 483  64 318  11],214,5,21403,4.11358831443398,80.0,20.0
45203,4,5203,[294  79 603 405 257],921,2,21405,4.113182167563413,0.0,0.0
45204,4,5204,[313 483  64 318  11],214,5,21410,4.113352545629203,80.0,20.0
45205,4,5205,[405 187 176  96   1],416,5,21415,4.113522858240492,0.0,0.0
45206,4,5206,[313 483  64 318  11],214,5,21420,4.113693105434991,80.0,20.0
45207,4,5207,[216  12 180   8 210],405,3,21423,4.113479262672811,20.0,0.0
45208,4,5208,[ 89   8 181  95 168],642,4,21427,4.113457477442887,0.0,20.0
45209,4,5209,[  7 237  79 508 294],24,4,21431,4.113435700575816,0.0,0.0
45210,4,5210,[313 483  64 318  11],618,5,21436,4.113605833813088,80.0,20.0
45211,4,5211,[202  88 294 568 238],712,4,21440,4.113584036838066,0.0,0.0
45212,4,5212,[228 423 265 237 245],128,3,21443,4.113370420103587,0.0,0.0
45213,4,5213,[313 483  64 318  11],618,5,21448,4.113540467970847,80.0,20.0
45214,4,5214,[313 483  64 318  11],214,5,21453,4.113710450623202,80.0,20.0
45215,4,5215,[ 11 168 475 117 222],198,3,21456,4.113496932515337,0.0,0.0
45216,4,5216,[313 483  64 318  11],618,5,21461,4.11366685834771,80.0,20.0
45217,4,5217,[313 483  64 318  11],618,5,21466,4.113836719049444,80.0,20.0
45218,4,5218,[  9 322 423 742 197],416,4,21470,4.11381490707032,0.0,0.0
45219,4,5219,[ 56 132 289  25 121],416,4,21474,4.113793103448276,0.0,0.0
45220,4,5220,[ 98 245 182 121 257],417,3,21477,4.113579773989657,0.0,20.0
45221,4,5221,[313 483  64 318  11],214,5,21482,4.113749521256223,80.0,20.0
45222,4,5222,[313 483  64 318  11],618,5,21487,4.1139192035228795,80.0,20.0
45223,4,5223,[313 483  64 318  11],618,5,21492,4.114088820826953,80.0,20.0
45224,4,5224,[313 483  64 318  11],618,5,21497,4.114258373205741,80.0,20.0
45225,4,5225,[313 483  64 318  11],214,5,21502,4.114427860696518,80.0,20.0
45226,4,5226,[ 12 471 258  25 117],854,2,21504,4.114023340348192,20.0,0.0
45227,4,5227,[ 82 323  98 143 276],198,1,21505,4.113427697016068,0.0,20.0
45228,4,5228,[273 200 742  88 111],416,4,21509,4.11340600497227,0.0,0.0
45229,4,5229,[222 211 118 210 151],297,3,21512,4.1131931166347995,0.0,0.0
45230,4,5230,[161  28  88   1 228],128,4,21516,4.113171477728923,0.0,0.0
45231,4,5231,[182 174 257 288  12],416,4,21520,4.113149847094801,20.0,20.0
45232,4,5232,[ 96 475 483 405 222],62,4,21524,4.1131282247276895,20.0,0.0
45233,4,5233,[273 508  89 185 742],417,1,21525,4.112533435231181,0.0,0.0
45234,4,5234,[276 125 275 271   7],62,4,21529,4.11251193887297,0.0,0.0
45235,4,5235,[313 483  64 318  11],618,5,21534,4.112681436210848,80.0,20.0
45236,4,5236,[313 483  64 318  11],214,5,21539,4.112850868818025,80.0,20.0
45237,4,5237,[313 483  64 318  11],214,5,21544,4.113020236731577,80.0,20.0
45238,4,5238,[181  79 168 228  70],128,3,21547,4.112807787745753,0.0,20.0
45239,4,5239,[200  69 238 423 275],416,5,21552,4.112977099236641,0.0,0.0
45240,4,5240,[313 483  64 318  11],618,5,21557,4.113146346117153,80.0,20.0
45241,4,5241,[151 471 588  71 276],416,3,21560,4.112933994658527,0.0,0.0
45242,4,5242,[100 180 357 385   1],417,4,21564,4.112912454701506,0.0,0.0
45243,4,5243,[222 176 508 286 238],417,3,21567,4.112700228832952,0.0,0.0
45244,4,5244,[  1 200 271 405 546],805,2,21569,4.112297426120114,0.0,0.0
45245,4,5245,[313 483  64 318  11],618,5,21574,4.112466641250476,80.0,20.0
45246,4,5246,[313 483  64 318  11],618,5,21579,4.1126357918810745,80.0,20.0
45247,4,5247,[135 276 172 210 742],230,4,21583,4.112614329268292,0.0,0.0
45248,4,5248,[282 234  56 118 546],416,3,21586,4.112402362354734,0.0,0.0
45249,4,5249,[176 282 288 237 200],270,3,21589,4.112190476190476,0.0,20.0
45250,4,5250,[196 269 275  97 234],297,4,21593,4.112169110645591,0.0,0.0
45251,4,5251,[323 282 118 176 100],764,3,21596,4.111957349581112,0.0,0.0
45252,4,5252,[313 483  64 318  11],214,5,21601,4.112126403959642,80.0,20.0
45253,4,5253,[313 483  64 318  11],214,5,21606,4.1122953939855345,80.0,20.0
45254,4,5254,[  4  79 268 172  96],416,5,21611,4.112464319695528,0.0,0.0
45255,4,5255,[191 111  89 268 257],417,3,21614,4.1122526636225265,0.0,0.0
45256,4,5256,[286 135 211   7 228],417,2,21616,4.1118508655126496,0.0,0.0
45257,4,5257,[313 483  64 318  11],618,5,21621,4.112019779383796,80.0,20.0
45258,4,5258,[313 483  64 318  11],214,5,21626,4.112188629016924,80.0,20.0
45259,4,5259,[313 483  64 318  11],618,5,21631,4.112357414448669,80.0,20.0
45260,4,5260,[222 603 597 235  79],854,3,21634,4.112145979851739,0.0,0.0
45261,4,5261,[161 204 185 222 655],805,2,21636,4.111744583808438,0.0,0.0
45262,4,5262,[313 483  64 318  11],214,5,21641,4.111913357400722,80.0,20.0
45263,4,5263,[313 483  64 318  11],618,5,21646,4.112082066869301,80.0,20.0
45264,4,5264,[215 181 173  69 216],128,4,21650,4.112060778727446,0.0,20.0
45265,4,5265,[496 269 403 313 323],43,4,21654,4.112039498670717,20.0,20.0
45266,4,5266,[257 265 286 237  56],297,3,21657,4.111828365293336,0.0,0.0
45267,4,5267,[210 183 271  98 117],62,4,21661,4.111807137433561,0.0,20.0
45268,4,5268,[313 483  64 318  11],214,5,21666,4.111975706965269,80.0,20.0
45269,4,5269,[235 302 173  96 288],62,3,21669,4.1117647058823525,0.0,20.0
45270,4,5270,[313 483  64 318  11],214,5,21674,4.111933219502941,80.0,20.0
45271,4,5271,[276 588 153 176 603],416,4,21678,4.1119119878603945,0.0,0.0
45272,4,5272,[168  95  71 100 181],437,3,21681,4.111701118907643,0.0,20.0
45273,4,5273,[180 215 286 603 197],373,2,21683,4.111300720515738,0.0,0.0
45274,4,5274,[313 483  64 318  11],214,5,21688,4.111469194312797,80.0,20.0
45275,4,5275,[271 427 161 216 385],922,1,21689,4.1108794541319185,0.0,0.0
45276,4,5276,[265   7 286 234 302],297,3,21692,4.110668940685996,0.0,0.0
45277,4,5277,[313 483  64 318  11],214,5,21697,4.110837438423645,80.0,20.0
45278,4,5278,[238 655 568 161 127],805,1,21698,4.110248153059292,0.0,0.0
45279,4,5279,[  9 125 748 196 475],416,4,21702,4.110227272727273,0.0,0.0
45280,4,5280,[153  50 196 211 258],297,5,21707,4.110395758379095,0.0,20.0
45281,4,5281,[313 483  64 318  11],214,5,21712,4.11056418023476,80.0,20.0
45282,4,5282,[313 483  64 318  11],618,5,21717,4.1107325383304945,80.0,20.0
45283,4,5283,[313 483  64 318  11],214,5,21722,4.110900832702498,80.0,20.0
45284,4,5284,[313 483  64 318  11],214,5,21727,4.111069063386944,80.0,20.0
45285,4,5285,[ 25 111 173 238  71],654,3,21730,4.110858872493378,0.0,0.0
45286,4,5286,[286  11 195 588 179],417,4,21734,4.11083790429355,0.0,0.0
45287,4,5287,[313 483  64 318  11],618,5,21739,4.111006051437216,80.0,20.0
45288,4,5288,[286   8  98 194 271],297,3,21742,4.110795991680847,0.0,20.0
45289,4,5289,[313 483  64 318  11],214,5,21747,4.110964083175803,80.0,20.0
45290,4,5290,[313 483  64 318  11],618,5,21752,4.111132111132111,80.0,20.0
45291,4,5291,[313 483  64 318  11],214,5,21757,4.11130007558579,80.0,20.0
45292,4,5292,[496  82 135 318 216],711,4,21761,4.11127904779898,20.0,0.0
45293,4,5293,[181 294 172  11 143],922,5,21766,4.11144692104269,0.0,20.0
45294,4,5294,[ 96 258 328 132 405],416,5,21771,4.111614730878187,0.0,0.0
45295,4,5295,[237 132 234 238  98],437,5,21776,4.111782477341389,0.0,20.0
45296,4,5296,[216   4 222 100  64],764,4,21780,4.111761374362847,20.0,0.0
45297,4,5297,[153   8  88 210  12],805,2,21782,4.111362778406946,20.0,0.0
45298,4,5298,[313 483  64 318  11],214,5,21787,4.111530477448575,80.0,20.0
45299,4,5299,[313 483  64 318  11],214,5,21792,4.111698113207547,80.0,20.0
45300,4,5300,[313 483  64 318  11],214,5,21797,4.111865685719676,80.0,20.0
45301,4,5301,[200  25 173 174 403],417,3,21800,4.111655978875896,0.0,0.0
45302,4,5302,[313 483  64 318  11],214,5,21805,4.111823496134264,80.0,20.0
45303,4,5303,[313 483  64 318  11],618,5,21810,4.111990950226244,80.0,20.0
45304,4,5304,[ 97 300 118  28 222],705,4,21814,4.111969839773798,0.0,0.0
45305,4,5305,[435  79 183 176  11],505,2,21816,4.111571805503204,0.0,0.0
45306,4,5306,[313 483  64 318  11],618,5,21821,4.111739212361033,80.0,20.0
45307,4,5307,[238 318 288 135 127],62,4,21825,4.111718161266014,20.0,20.0
45308,4,5308,[265   9 385 132   1],618,4,21829,4.111697118101337,0.0,0.0
45309,4,5309,[ 15 216 118 245 235],417,3,21832,4.111487758945386,0.0,0.0
45310,4,5310,[ 22  56 121 385 678],805,2,21834,4.111090190171343,0.0,0.0
45311,4,5311,[313 483  64 318  11],618,5,21839,4.111257530120482,80.0,20.0
45312,4,5312,[313 483  64 318  11],214,5,21844,4.111424807076981,80.0,20.0
45313,4,5313,[172   1  98 195 483],618,4,21848,4.111403838916071,20.0,20.0
45314,4,5314,[588  82 195 125 210],642,4,21852,4.111382878645343,0.0,0.0
45315,4,5315,[  8 117 237 194 268],854,1,21853,4.110797592174567,0.0,0.0
45316,4,5316,[200  97 172  25 161],711,5,21858,4.110964829791236,0.0,0.0
45317,4,5317,[313 483  64 318  11],618,5,21863,4.1111320045129744,80.0,20.0
45318,4,5318,[313 483  64 318  11],618,5,21868,4.111299116375259,80.0,20.0
45319,4,5319,[427   9 471 143 195],618,2,21870,4.110902255639098,0.0,0.0
45320,4,5320,[475 435 210  71 161],437,0,21870,4.110129674873144,0.0,0.0
45321,4,5321,[313 483  64 318  11],214,5,21875,4.110296880871853,80.0,20.0
45322,4,5322,[238 153 286 234  56],437,4,21879,4.110276160060116,0.0,0.0
45323,4,5323,[228 475   1 210 174],62,3,21882,4.1100676183320815,0.0,0.0
45324,4,5324,[ 82 191  95 288  28],416,4,21886,4.110046948356808,0.0,20.0
45325,4,5325,[132 151 117 385   4],416,4,21890,4.110026286143447,0.0,0.0
45326,4,5326,[313 483  64 318  11],214,5,21895,4.110193354608597,80.0,20.0
45327,4,5327,[202   9 215 173 238],345,4,21899,4.110172672672673,0.0,0.0
45328,4,5328,[313 483  64 318  11],214,5,21904,4.11033965096641,80.0,20.0
45329,4,5329,[313 483  64 318  11],214,5,21909,4.110506566604127,80.0,20.0
45330,4,5330,[313 483  64 318  11],214,5,21914,4.110673419621084,80.0,20.0
45331,4,5331,[313 483  64 318  11],618,5,21919,4.110840210052513,80.0,20.0
45332,4,5332,[313 483  64 318  11],618,5,21924,4.111006937933621,80.0,20.0
45333,4,5333,[202 118 294  28 125],642,3,21927,4.110798650168729,0.0,0.0
45334,4,5334,[313 483  64 318  11],214,5,21932,4.110965323336457,80.0,20.0
45335,4,5335,[132 275  71  69 405],62,4,21936,4.110944527736132,0.0,0.0
45336,4,5336,[313 483  64 318  11],618,5,21941,4.111111111111111,80.0,20.0
45337,4,5337,[313 483  64 318  11],618,5,21946,4.111277632071937,80.0,20.0
45338,4,5338,[313 483  64 318  11],618,5,21951,4.111444090653681,80.0,20.0
45339,4,5339,[  1  82 121  11  50],654,5,21956,4.111610486891386,0.0,20.0
45340,4,5340,[313 483  64 318  11],618,5,21961,4.111776820820071,80.0,20.0
45341,4,5341,[568 174 603 222 151],805,3,21964,4.111568700861101,0.0,0.0
45342,4,5342,[196 273 475 301 228],297,4,21968,4.111547819577017,0.0,0.0
45343,4,5343,[161 588 210 273 181],417,0,21968,4.110778443113772,0.0,20.0
45344,4,5344,[216 121 127 196 288],417,2,21970,4.110383536014967,0.0,20.0
45345,4,5345,[117 273 151  82   4],618,3,21973,4.110175832398054,0.0,0.0
45346,4,5346,[153 403  70 191 186],43,4,21977,4.110155227230223,0.0,0.0
45347,4,5347,[313 483  64 318  11],618,5,21982,4.1103216155572175,80.0,20.0
45348,4,5348,[313 483  64 318  11],214,5,21987,4.11048794167134,80.0,20.0
45349,4,5349,[313 483  64 318  11],618,5,21992,4.110654205607477,80.0,20.0
45350,4,5350,[258 100 289 269 161],345,3,21995,4.1104466454868245,0.0,0.0
45351,4,5351,[313 483  64 318  11],618,5,22000,4.110612855007473,80.0,20.0
45352,4,5352,[176  95 202 238 603],405,2,22002,4.110218569026714,0.0,0.0
45353,4,5353,[318 215 117 588  88],345,4,22006,4.110197982816586,20.0,0.0
45354,4,5354,[151  82 172 568 216],618,3,22009,4.109990662931839,0.0,0.0
45355,4,5355,[ 95   1 234 196  22],297,2,22011,4.109596713965646,0.0,0.0
45356,4,5356,[238 275 655 197  95],373,4,22015,4.10957625536681,0.0,0.0
45357,4,5357,[111 323 258 301   9],416,4,22019,4.1095558044046285,0.0,0.0
45358,4,5358,[132 197 179 276 237],198,3,22022,4.1093487590968465,0.0,0.0
45359,4,5359,[427 282 276  56 235],416,3,22025,4.1091417910447765,0.0,0.0
45360,4,5360,[313 483  64 318  11],618,5,22030,4.109307964931916,80.0,20.0
45361,4,5361,[181  28 195 183 117],230,3,22033,4.109101081685938,0.0,20.0
45362,4,5362,[111 508 748   8  97],654,3,22036,4.10889427559202,0.0,0.0
45363,4,5363,[322 161 172  11 385],417,2,22038,4.108501118568233,0.0,0.0
45364,4,5364,[313 483  64 318  11],618,5,22043,4.1086672879776325,80.0,20.0
45365,4,5365,[202 286  96 191 216],417,3,22046,4.108460678345136,0.0,0.0
45366,4,5366,[168 258 176 222 194],297,4,22050,4.1084404695360535,0.0,0.0
45367,4,5367,[357  70 235 313  71],416,4,22054,4.108420268256334,20.0,20.0
45368,4,5368,[268 181 475 121  98],588,3,22057,4.108213820078227,0.0,40.0
45369,4,5369,[313 483  64 318  11],214,5,22062,4.108379888268156,80.0,20.0
45370,4,5370,[313 483  64 318  11],214,5,22067,4.108545894619252,80.0,20.0
45371,4,5371,[111 118 172 210  70],43,5,22072,4.108711839166046,0.0,0.0
45372,4,5372,[313 483  64 318  11],618,5,22077,4.108877721943049,80.0,20.0
45373,4,5373,[168 288 204 237  70],642,3,22080,4.108671380721995,0.0,20.0
45374,4,5374,[ 97 301 216 183 245],416,4,22084,4.108651162790697,0.0,0.0
45375,4,5375,[313 483  64 318  11],618,5,22089,4.108816964285714,80.0,20.0
45376,4,5376,[313 483  64 318  11],618,5,22094,4.108982704110098,80.0,20.0
45377,4,5377,[313 483  64 318  11],214,5,22099,4.109148382298252,80.0,20.0
45378,4,5378,[546 144 196 181 153],417,2,22101,4.108756274400446,0.0,20.0
45379,4,5379,[117 268   1  28 508],297,4,22105,4.108736059479554,0.0,0.0
45380,4,5380,[427 121  28 200 117],416,5,22110,4.108901691135476,0.0,0.0
45381,4,5381,[301 194  79 405 238],751,3,22113,4.108695652173913,0.0,0.0
45382,4,5382,[ 25 210 385 186 211],417,3,22116,4.108489689764072,0.0,0.0
45383,4,5383,[ 96 234  15 185 235],262,1,22117,4.107912332838039,0.0,0.0
45384,4,5384,[313 483  64 318  11],618,5,22122,4.108077994428969,80.0,20.0
45385,4,5385,[313 483  64 318  11],618,5,22127,4.108243594504271,80.0,20.0
45386,4,5386,[313 483  64 318  11],618,5,22132,4.108409133098199,80.0,20.0
45387,4,5387,[234 483 174 200   1],417,4,22136,4.108389012620639,20.0,0.0
45388,4,5388,[216 117 180 195 202],805,0,22136,4.1076266468732605,0.0,0.0
45389,4,5389,[197 427   7 194 289],342,3,22139,4.107421150278293,0.0,0.0
45390,4,5390,[ 28 257 111  89   8],342,1,22140,4.106844741235392,0.0,0.0
45391,4,5391,[313 483  64 318  11],618,5,22145,4.107010385756676,80.0,20.0
45392,4,5392,[111 235   7 185   8],49,2,22147,4.1066196921935845,0.0,0.0
45393,4,5393,[313 483  64 318  11],618,5,22152,4.10678531701891,80.0,20.0
45394,4,5394,[172 258 117 286  69],43,5,22157,4.106950880444856,0.0,0.0
45395,4,5395,[ 50 151  11  56 161],922,3,22160,4.106745737583395,0.0,20.0
45396,4,5396,[313 483  64 318  11],618,5,22165,4.106911246989068,80.0,20.0
45397,4,5397,[313 483  64 318  11],618,5,22170,4.107076695072249,80.0,20.0
45398,4,5398,[313 483  64 318  11],214,5,22175,4.107242081867012,80.0,20.0
45399,4,5399,[313 483  64 318  11],618,5,22180,4.107407407407408,80.0,20.0
45400,4,5400,[181 143 471 748 475],416,4,22184,4.107387520829476,0.0,20.0
45401,4,5401,[313 483  64 318  11],214,5,22189,4.10755275823769,80.0,20.0
45402,4,5402,[313 483  64 318  11],214,5,22194,4.107717934480844,80.0,20.0
45403,4,5403,[  1 100 322 125  25],854,1,22195,4.107142857142857,0.0,0.0
45404,4,5404,[313 483  64 318  11],214,5,22200,4.107308048103608,80.0,20.0
45405,4,5405,[313 483  64 318  11],214,5,22205,4.107473177950426,80.0,20.0
45406,4,5406,[313 483  64 318  11],618,5,22210,4.107638246717219,80.0,20.0
45407,4,5407,[603 204 179 276 174],128,3,22213,4.107433431952662,0.0,0.0
45408,4,5408,[210 168 185 143 588],618,4,22217,4.107413569975966,0.0,0.0
45409,4,5409,[313 483  64 318  11],214,5,22222,4.107578558225509,80.0,20.0
45410,4,5410,[143   9 235 228  71],887,3,22225,4.1073738680465715,0.0,0.0
45411,4,5411,[286 196 127 187 179],416,4,22229,4.1073540280857355,0.0,0.0
45412,4,5412,[257 568  28 318 215],62,1,22230,4.106779974136338,20.0,0.0
45413,4,5413,[313 483  64 318  11],214,5,22235,4.106944957517547,80.0,20.0
45414,4,5414,[313 483  64 318  11],618,5,22240,4.107109879963065,80.0,20.0
45415,4,5415,[153 176 568 328 318],62,3,22243,4.106905465288035,20.0,0.0
45416,4,5416,[313 483  64 318  11],618,5,22248,4.107070334133284,80.0,20.0
45417,4,5417,[313 483  64 318  11],618,5,22253,4.107235142118863,80.0,20.0
45418,4,5418,[313 483  64 318  11],618,5,22258,4.107399889278464,80.0,20.0
45419,4,5419,[313 483  64 318  11],214,5,22263,4.107564575645757,80.0,20.0
45420,4,5420,[194 117 597 235  56],854,1,22264,4.106991330012913,0.0,0.0
45421,4,5421,[ 82  64  69 168 216],128,5,22269,4.107156030984877,20.0,0.0
45422,4,5422,[174  79 258  50  25],354,3,22272,4.106951871657754,0.0,20.0
45423,4,5423,[ 70 196  69 179 132],128,2,22274,4.106563421828908,0.0,0.0
45424,4,5424,[  9 742 276  98   7],24,5,22279,4.106728110599079,0.0,20.0
45425,4,5425,[100 288 127 173   7],24,4,22283,4.106708440840398,0.0,20.0
45426,4,5426,[313 483  64 318  11],214,5,22288,4.106873042196425,80.0,20.0
45427,4,5427,[313 483  64 318  11],618,5,22293,4.107037582903463,80.0,20.0
45428,4,5428,[313 483  64 318  11],214,5,22298,4.107202062995027,80.0,20.0
45429,4,5429,[313 483  64 318  11],214,5,22303,4.107366482504604,80.0,20.0
45430,4,5430,[313 483  64 318  11],214,5,22308,4.10753084146566,80.0,20.0
45431,4,5431,[313 483  64 318  11],214,5,22313,4.107695139911635,80.0,20.0
45432,4,5432,[742  89   9 597 135],805,2,22315,4.107307196760537,0.0,0.0
45433,4,5433,[237 179 168 173 216],198,4,22319,4.107287449392713,0.0,0.0
45434,4,5434,[313 483  64 318  11],618,5,22324,4.1074517019319225,80.0,20.0
45435,4,5435,[403 196 179 200 172],417,4,22328,4.107431935246505,0.0,0.0
45436,4,5436,[265 187 471 238  88],416,4,22332,4.107412175832261,0.0,0.0
45437,4,5437,[427 195 275 265 144],373,4,22336,4.107392423685178,0.0,0.0
45438,4,5438,[313 483  64 318  11],214,5,22341,4.107556536127965,80.0,20.0
45439,4,5439,[313 483  64 318  11],618,5,22346,4.107720588235294,80.0,20.0
45440,4,5440,[313 483  64 318  11],214,5,22351,4.107884580040434,80.0,20.0
45441,4,5441,[405  69 111  56 423],62,2,22353,4.107497243660419,0.0,0.0
45442,4,5442,[275  97 174 276 173],354,2,22355,4.107110049604997,0.0,0.0
45443,4,5443,[153 118 515  50 568],416,4,22359,4.107090374724467,0.0,20.0
45444,4,5444,[ 71 181  95 174 546],43,5,22364,4.107254361799816,0.0,20.0
45445,4,5445,[191  64 204 187 182],198,4,22368,4.1072346676459786,20.0,0.0
45446,4,5446,[ 64 265 117 183 496],618,5,22373,4.107398568019093,20.0,0.0
45447,4,5447,[313 483  64 318  11],214,5,22378,4.107562408223201,80.0,20.0
45448,4,5448,[313 483  64 318  11],618,5,22383,4.10772618829143,80.0,20.0
45449,4,5449,[313 483  64 318  11],214,5,22388,4.1078899082568805,80.0,20.0
45450,4,5450,[313 483  64 318  11],618,5,22393,4.1080535681526325,80.0,20.0
45451,4,5451,[313 483  64 318  11],214,5,22398,4.1082171680117385,80.0,20.0
45452,4,5452,[191   7  64 182  15],198,4,22402,4.108197322574729,20.0,0.0
45453,4,5453,[313 483  64 318  11],214,5,22407,4.108360836083609,80.0,20.0
45454,4,5454,[322 288 183 117 238],416,4,22411,4.108340971585701,0.0,20.0
45455,4,5455,[313 483  64 318  11],618,5,22416,4.108504398826979,80.0,20.0
45456,4,5456,[  7 427 385 265 318],618,5,22421,4.108667766171889,20.0,0.0
45457,4,5457,[100 185 238 204 215],198,2,22423,4.108281421766215,0.0,0.0
45458,4,5458,[143 286 118 179 180],437,3,22426,4.108078402637846,0.0,0.0
45459,4,5459,[265 121  96 300 210],705,5,22431,4.108241758241758,0.0,0.0
45460,4,5460,[313 483  64 318  11],214,5,22436,4.108405054019411,80.0,20.0
45461,4,5461,[313 483  64 318  11],214,5,22441,4.108568290003662,80.0,20.0
45462,4,5462,[328 588 144 202   4],373,2,22443,4.108182317408017,0.0,0.0
45463,4,5463,[313 483  64 318  11],214,5,22448,4.108345534407028,80.0,20.0
45464,4,5464,[313 483  64 318  11],618,5,22453,4.108508691674291,80.0,20.0
45465,4,5465,[313 483  64 318  11],214,5,22458,4.108671789242591,80.0,20.0
45466,4,5466,[215 228 161   1 275],128,3,22461,4.10846899579294,0.0,0.0
45467,4,5467,[405 168 515 144 258],416,5,22466,4.1086320409656185,0.0,0.0
45468,4,5468,[313 483  64 318  11],618,5,22471,4.108795026513073,80.0,20.0
45469,4,5469,[313 483  64 318  11],618,5,22476,4.108957952468007,80.0,20.0
45470,4,5470,[  8   4 187 245 194],416,4,22480,4.108938036921952,0.0,0.0
45471,4,5471,[313 483  64 318  11],618,5,22485,4.109100877192983,80.0,20.0
45472,4,5472,[235 186 302 151  11],854,2,22487,4.108715512515988,0.0,0.0
45473,4,5473,[ 97 300  88 172 202],12,5,22492,4.108878333942273,0.0,0.0
45474,4,5474,[176 117 143 204 175],805,2,22494,4.108493150684931,0.0,0.0
45475,4,5475,[313 483  64 318  11],618,5,22499,4.1086559532505476,80.0,20.0
45476,4,5476,[423 289 237  97 257],416,2,22501,4.1082709512506845,0.0,0.0
45477,4,5477,[273 144  28 588 275],297,4,22505,4.1082511865644395,0.0,0.0
45478,4,5478,[ 71 100   1  25 265],230,4,22509,4.1082314290929,0.0,0.0
45479,4,5479,[313 483  64 318  11],618,5,22514,4.108394160583941,80.0,20.0
45480,4,5480,[385 289 282 276 125],416,3,22517,4.108191935778143,0.0,0.0
45481,4,5481,[508 275 135 475 153],297,5,22522,4.108354615103977,0.0,0.0
45482,4,5482,[313 483  64 318  11],618,5,22527,4.108517235090279,80.0,20.0
45483,4,5483,[195  97  96  88 111],416,4,22531,4.108497447118891,0.0,0.0
45484,4,5484,[313 483  64 318  11],214,5,22536,4.10865998176846,80.0,20.0
45485,4,5485,[313 483  64 318  11],214,5,22541,4.108822457163689,80.0,20.0
45486,4,5486,[313 483  64 318  11],618,5,22546,4.108984873336978,80.0,20.0
45487,4,5487,[313 483  64 318  11],214,5,22551,4.1091472303206995,80.0,20.0
45488,4,5488,[385 204 216  79 475],416,4,22555,4.1091273456002915,0.0,0.0
45489,4,5489,[313 483  64 318  11],618,5,22560,4.109289617486339,80.0,20.0
45490,4,5490,[  1  82  97  69 186],43,4,22564,4.109269714077581,0.0,0.0
45491,4,5491,[234 357 222 238 121],417,3,22567,4.109067734887108,0.0,0.0
45492,4,5492,[ 69 173 176 127 322],854,3,22570,4.108865829237211,0.0,0.0
45493,4,5493,[183 313  15 118 185],618,3,22573,4.108663997087732,20.0,20.0
45494,4,5494,[313 483  64 318  11],214,5,22578,4.108826205641492,80.0,20.0
45495,4,5495,[313 483  64 318  11],214,5,22583,4.108988355167394,80.0,20.0
45496,4,5496,[313 483  64 318  11],214,5,22588,4.1091504456976535,80.0,20.0
45497,4,5497,[313 483  64 318  11],214,5,22593,4.10931247726446,80.0,20.0
45498,4,5498,[  9 185 276 215   8],618,2,22595,4.108928896162939,0.0,0.0
45499,4,5499,[313 483  64 318  11],214,5,22600,4.109090909090909,80.0,20.0
45500,4,5500,[313 483  64 318  11],214,5,22605,4.109252863115797,80.0,20.0
45501,4,5501,[196 210 100  98 151],354,1,22606,4.108687749909124,0.0,20.0
45502,4,5502,[ 15 275 194 289 118],416,3,22609,4.108486280210794,0.0,0.0
45503,4,5503,[483 186 288 202 173],417,4,22613,4.108466569767442,20.0,20.0
45504,4,5504,[ 96 333 168 100  64],416,5,22618,4.108628519527702,20.0,0.0
45505,4,5505,[496  50 196 174 286],354,3,22621,4.108427170359608,0.0,20.0
45506,4,5506,[313 483  64 318  11],618,5,22626,4.1085890684583255,80.0,20.0
45507,4,5507,[322 742 300 186 173],128,3,22629,4.10838779956427,0.0,0.0
45508,4,5508,[313 483  64 318  11],214,5,22634,4.1085496460337625,80.0,20.0
45509,4,5509,[313 483  64 318  11],618,5,22639,4.108711433756806,80.0,20.0
45510,4,5510,[175 269 195 161  96],373,4,22643,4.108691707494103,0.0,0.0
45511,4,5511,[144   7  82 403 174],417,2,22645,4.108309143686502,0.0,0.0
45512,4,5512,[ 12 300 151 258  50],654,5,22650,4.108470886994377,20.0,20.0
45513,4,5513,[313 483  64 318  11],214,5,22655,4.108632571635836,80.0,20.0
45514,4,5514,[ 25 234 216 333 200],416,5,22660,4.108794197642792,0.0,0.0
45515,4,5515,[313 483  64 318  11],618,5,22665,4.108955765047136,80.0,20.0
45516,4,5516,[313 483  64 318  11],214,5,22670,4.109117273880733,80.0,20.0
45517,4,5517,[257  22  95 173 204],297,2,22672,4.108735048930772,0.0,0.0
45518,4,5518,[132  15 179 678 276],416,2,22674,4.108352962493205,0.0,0.0
45519,4,5519,[  1 118 257 423  95],642,3,22677,4.1081521739130435,0.0,0.0
45520,4,5520,[423 508 238 194 288],854,4,22681,4.108132584676689,0.0,20.0
45521,4,5521,[313 173 238 200 132],405,4,22685,4.108113002535314,20.0,20.0
45522,4,5522,[258 100   8 196  79],43,5,22690,4.108274488502626,0.0,0.0
45523,4,5523,[313 483  64 318  11],214,5,22695,4.108435916002897,80.0,20.0
45524,4,5524,[313 483  64 318  11],214,5,22700,4.108597285067873,80.0,20.0
45525,4,5525,[313 483  64 318  11],618,5,22705,4.10875859572928,80.0,20.0
45526,4,5526,[313 483  64 318  11],214,5,22710,4.108919848018817,80.0,20.0
45527,4,5527,[546 174 211 301  56],43,5,22715,4.109081041968162,0.0,0.0
45528,4,5528,[313 483  64 318  11],214,5,22720,4.109242177608971,80.0,20.0
45529,4,5529,[268 173 197 111   1],345,4,22724,4.109222423146473,0.0,0.0
45530,4,5530,[151 748 742 121  15],708,2,22726,4.108841077562828,0.0,0.0
45531,4,5531,[ 12  71 151 257 597],62,3,22729,4.1086406362979035,20.0,0.0
45532,4,5532,[313 483  64 318  11],214,5,22734,4.108801735044279,80.0,20.0
45533,4,5533,[313 483  64 318  11],618,5,22739,4.108962775569209,80.0,20.0
45534,4,5534,[568 313   9 143 100],618,4,22743,4.108943089430895,20.0,20.0
45535,4,5535,[313 483  64 318  11],214,5,22748,4.109104046242774,80.0,20.0
45536,4,5536,[313 483  64 318  11],618,5,22753,4.10926494491602,80.0,20.0
45537,4,5537,[328 294 302  22 245],404,4,22757,4.109245214879017,0.0,0.0
45538,4,5538,[313 483  64 318  11],618,5,22762,4.109406029969309,80.0,20.0
45539,4,5539,[176 175 427   9 257],698,1,22763,4.10884476534296,0.0,0.0
45540,4,5540,[313 483  64 318  11],214,5,22768,4.109005594658004,80.0,20.0
45541,4,5541,[423 245  98 269 257],297,2,22770,4.1086250451100685,0.0,20.0
45542,4,5542,[273  28 132 200 215],618,5,22775,4.108785856034638,0.0,0.0
45543,4,5543,[268 318   9 258  79],354,2,22777,4.108405483405483,20.0,0.0
45544,4,5544,[313 483  64 318  11],618,5,22782,4.1085662759242565,80.0,20.0
45545,4,5545,[132 151 475 423 286],588,3,22785,4.1083663901911285,0.0,0.0
45546,4,5546,[313 483  64 318  11],214,5,22790,4.108527131782946,80.0,20.0
45547,4,5547,[195 294 180 175 271],805,1,22791,4.107966834895458,0.0,0.0
45548,4,5548,[313 483  64 318  11],214,5,22796,4.108127590556857,80.0,20.0
45549,4,5549,[144  69 196 496   8],618,4,22800,4.108108108108108,0.0,0.0
45550,4,5550,[496 181 273 276   8],416,4,22804,4.108088632678797,0.0,20.0
45551,4,5551,[ 50 151 195   1 302],854,2,22806,4.107708933717579,0.0,20.0
45552,4,5552,[313 483  64 318  11],618,5,22811,4.107869620025212,80.0,20.0
45553,4,5553,[313 483  64 318  11],214,5,22816,4.108030248469571,80.0,20.0
45554,4,5554,[313 483  64 318  11],618,5,22821,4.1081908190819085,80.0,20.0
45555,4,5555,[ 50  12 271 196 144],62,3,22824,4.107991360691145,20.0,20.0
45556,4,5556,[200 678 282  56  79],416,4,22828,4.107971927298903,0.0,0.0
45557,4,5557,[313 483  64 318  11],618,5,22833,4.108132421734437,80.0,20.0
45558,4,5558,[313 483  64 318  11],214,5,22838,4.108292858427775,80.0,20.0
45559,4,5559,[216 100 496  89 328],373,4,22842,4.108273381294964,0.0,0.0
45560,4,5560,[313 483  64 318  11],214,5,22847,4.108433734939759,80.0,20.0
45561,4,5561,[ 79 357 258 475  95],198,3,22850,4.108234448040274,0.0,0.0
45562,4,5562,[ 89   7 403 228  50],62,4,22854,4.108214991910839,0.0,20.0
45563,4,5563,[313 483  64 318  11],214,5,22859,4.108375269590223,80.0,20.0
45564,4,5564,[313 483  64 318  11],214,5,22864,4.108535489667565,80.0,20.0
45565,4,5565,[313 483  64 318  11],214,5,22869,4.108695652173913,80.0,20.0
45566,4,5566,[200   4 282 132  97],618,3,22872,4.108496497215736,0.0,0.0
45567,4,5567,[588 748 173 275 265],437,3,22875,4.108297413793103,0.0,0.0
45568,4,5568,[313 483  64 318  11],214,5,22880,4.108457532770695,80.0,20.0
45569,4,5569,[313 483  64 318  11],214,5,22885,4.108617594254937,80.0,20.0
45570,4,5570,[313 483  64 318  11],618,5,22890,4.108777598276791,80.0,20.0
45571,4,5571,[273   4 181 187  88],618,4,22894,4.10875807609476,0.0,20.0
45572,4,5572,[313 483  64 318  11],214,5,22899,4.108917997487888,80.0,20.0
45573,4,5573,[182  70  95 210 196],297,3,22902,4.108719052744887,0.0,0.0
45574,4,5574,[313 483  64 318  11],618,5,22907,4.108878923766816,80.0,20.0
45575,4,5575,[176 258 515 195  50],698,4,22911,4.108859397417503,0.0,20.0
45576,4,5576,[655 568 515 100 323],416,4,22915,4.108839878070647,0.0,0.0
45577,4,5577,[179 258 118  79 185],416,3,22918,4.108641089996414,0.0,0.0
45578,4,5578,[603 153  22   4 245],416,4,22922,4.1086216167772,0.0,0.0
45579,4,5579,[313 483  64 318  11],618,5,22927,4.108781362007169,80.0,20.0
45580,4,5580,[202 121  96 182 238],618,2,22929,4.108403511915427,0.0,0.0
45581,4,5581,[  7  95  22 215 191],416,4,22933,4.108384091723397,0.0,0.0
45582,4,5582,[  4 173 125 333 288],345,2,22935,4.108006448146158,0.0,20.0
45583,4,5583,[215 678 197 269 237],297,2,22937,4.10762893982808,0.0,0.0
45584,4,5584,[313 483  64 318  11],214,5,22942,4.107788719785138,80.0,20.0
45585,4,5585,[313 483  64 318  11],214,5,22947,4.107948442534909,80.0,20.0
45586,4,5586,[313 483  64 318  11],214,5,22952,4.108108108108108,80.0,20.0
45587,4,5587,[588  71 318 235 385],345,1,22953,4.107551896921976,20.0,0.0
45588,4,5588,[300 118 257  25  95],416,2,22955,4.107174807657899,0.0,0.0
45589,4,5589,[313 483  64 318  11],214,5,22960,4.107334525939177,80.0,20.0
45590,4,5590,[313 483  64 318  11],214,5,22965,4.107494187086389,80.0,20.0
45591,4,5591,[313 483  64 318  11],618,5,22970,4.107653791130186,80.0,20.0
45592,4,5592,[151 181 215 423 194],416,4,22974,4.107634543178974,0.0,20.0
45593,4,5593,[ 79 286 655 496 588],373,3,22977,4.107436539149088,0.0,0.0
45594,4,5594,[313 483  64 318  11],618,5,22982,4.107596067917783,80.0,20.0
45595,4,5595,[ 95 597  50  15 496],642,5,22987,4.107755539671194,0.0,20.0
45596,4,5596,[ 50 117 153 568 546],416,4,22991,4.107736287296766,0.0,20.0
45597,4,5597,[313 483  64 318  11],618,5,22996,4.10789567702751,80.0,20.0
45598,4,5598,[313 483  64 318  11],618,5,23001,4.1080550098231825,80.0,20.0
45599,4,5599,[313 483  64 318  11],618,5,23006,4.108214285714285,80.0,20.0
45600,4,5600,[282 496 742  56  50],128,2,23008,4.10783788609177,0.0,20.0
45601,4,5601,[288 172 204 235 202],887,4,23012,4.1078186362013565,0.0,20.0
45602,4,5602,[496 202 546 118 222],43,5,23017,4.10797786899875,0.0,0.0
45603,4,5603,[ 97 210 196 275 323],921,3,23020,4.107780157030692,0.0,0.0
45604,4,5604,[313 483  64 318  11],618,5,23025,4.107939339875111,80.0,20.0
45605,4,5605,[423 204 216 173 186],373,4,23029,4.107920085622547,0.0,0.0
45606,4,5606,[200   4 588 117   8],49,1,23030,4.107365792759051,0.0,0.0
45607,4,5607,[597 117  28 515 300],416,4,23034,4.10734664764622,0.0,0.0
45608,4,5608,[ 69 318 385  89 603],405,2,23036,4.106970939561419,20.0,0.0
45609,4,5609,[294 195 234 405 323],417,3,23039,4.106773618538324,0.0,0.0
45610,4,5610,[313 483  64 318  11],214,5,23044,4.106932810550704,80.0,20.0
45611,4,5611,[234 435  11 183  22],297,3,23047,4.106735566642908,0.0,0.0
45612,4,5612,[313 483  64 318  11],618,5,23052,4.106894708711919,80.0,20.0
45613,4,5613,[168 127  50 194  98],416,5,23057,4.107053794086213,0.0,40.0
45614,4,5614,[313 483  64 318  11],618,5,23062,4.107212822796082,80.0,20.0
45615,4,5615,[313 483  64 318  11],214,5,23067,4.107371794871795,80.0,20.0
45616,4,5616,[  7 161 288 186 403],618,4,23071,4.10735267936621,0.0,20.0
45617,4,5617,[237 191 216 111 288],345,4,23075,4.107333570665717,0.0,20.0
45618,4,5618,[313 483  64 318  11],214,5,23080,4.10749243637658,80.0,20.0
45619,4,5619,[176 125 180  64  89],62,5,23085,4.107651245551601,20.0,0.0
45620,4,5620,[238 237 172 275 423],416,4,23089,4.107632093933463,0.0,0.0
45621,4,5621,[234 475 288  96 210],601,2,23091,4.107257203842049,0.0,20.0
45622,4,5622,[678  82  25 405 288],921,1,23092,4.106704606082163,0.0,20.0
45623,4,5623,[313 483  64 318  11],618,5,23097,4.106863442389758,80.0,20.0
45624,4,5624,[313 483  64 318  11],214,5,23102,4.107022222222223,80.0,20.0
45625,4,5625,[282 275 181 427  95],618,2,23104,4.1066477070742975,0.0,20.0
45626,4,5626,[143 168 210 194 435],297,3,23107,4.106451039630354,0.0,0.0
45627,4,5627,[ 12 215  50 286 151],43,5,23112,4.106609808102346,20.0,20.0
45628,4,5628,[423 742 546  71 258],654,4,23116,4.10659086871558,0.0,0.0
45629,4,5629,[ 64 211 118 385 132],416,4,23120,4.106571936056838,20.0,0.0
45630,4,5630,[222   4 271 748 117],297,2,23122,4.106197833422128,0.0,0.0
45631,4,5631,[  8  56 258  25 515],416,5,23127,4.106356534090909,0.0,0.0
45632,4,5632,[471 185   8 181 273],618,3,23130,4.106160127818214,0.0,20.0
45633,4,5633,[515 237 508 288 215],297,3,23133,4.105963791267306,0.0,20.0
45634,4,5634,[ 64 173 151 318 161],618,3,23136,4.105767524401065,40.0,0.0
45635,4,5635,[161 175 191 210 181],43,4,23140,4.105748757984386,0.0,20.0
45636,4,5636,[313 483  64 318  11],214,5,23145,4.105907397551889,80.0,20.0
45637,4,5637,[ 88 405 496 301 678],416,3,23148,4.105711245122384,0.0,0.0
45638,4,5638,[313 483  64 318  11],214,5,23153,4.105869835077141,80.0,20.0
45639,4,5639,[  8 289 322 172 323],416,2,23155,4.1054964539007095,0.0,0.0
45640,4,5640,[268 678  95 202 496],416,3,23158,4.105300478638539,0.0,0.0
45641,4,5641,[313 483  64 318  11],214,5,23163,4.10545905707196,80.0,20.0
45642,4,5642,[176 135 216  69 117],297,4,23167,4.105440368598264,0.0,0.0
45643,4,5643,[475 202 182   7 100],417,3,23170,4.1052445074415305,0.0,0.0
45644,4,5644,[132 176  22 515 204],416,5,23175,4.105403011514615,0.0,0.0
45645,4,5645,[182  88 191 276 496],618,4,23179,4.105384342897627,0.0,0.0
45646,4,5646,[118 475 435 100 234],297,2,23181,4.105011510536568,0.0,0.0
45647,4,5647,[180  88 174 475   8],805,1,23182,4.104461756373937,0.0,0.0
45648,4,5648,[313 483  64 318  11],214,5,23187,4.104620286776421,80.0,20.0
45649,4,5649,[313 483  64 318  11],618,5,23192,4.104778761061947,80.0,20.0
45650,4,5650,[313 483  64 318  11],618,5,23197,4.1049371792603075,80.0,20.0
45651,4,5651,[132 286 302 176 288],416,5,23202,4.1050955414012735,0.0,20.0
45652,4,5652,[174 153 118 204 144],654,4,23206,4.10507695029188,0.0,0.0
45653,4,5653,[271 121 143 357 179],805,2,23208,4.104704633887513,0.0,0.0
45654,4,5654,[313 483  64 318  11],214,5,23213,4.104862953138815,80.0,20.0
45655,4,5655,[313 483  64 318  11],618,5,23218,4.105021216407355,80.0,20.0
45656,4,5656,[313 483  64 318  11],214,5,23223,4.105179423722821,80.0,20.0
45657,4,5657,[313 483  64 318  11],214,5,23228,4.1053375751148815,80.0,20.0
45658,4,5658,[234  89 143  69 196],405,3,23231,4.105142251281145,0.0,0.0
45659,4,5659,[ 71 328  11 588 111],314,5,23236,4.10530035335689,0.0,0.0
45660,4,5660,[132 196 385 173 204],405,3,23239,4.105105105105105,0.0,0.0
45661,4,5661,[ 50  95 168 174 427],541,5,23244,4.105263157894737,0.0,20.0
45662,4,5662,[313 483  64 318  11],214,5,23249,4.105421154864913,80.0,20.0
45663,4,5663,[313 483  64 318  11],618,5,23254,4.105579096045198,80.0,20.0
45664,4,5664,[568 181 210 300   7],43,5,23259,4.105736981465137,0.0,20.0
45665,4,5665,[313 483  64 318  11],214,5,23264,4.105894811154253,80.0,20.0
45666,4,5666,[ 12 276 423 588 183],437,3,23267,4.105699664725605,20.0,0.0
45667,4,5667,[ 71  88 568 289 597],588,4,23271,4.1056810162314745,0.0,0.0
45668,4,5668,[323 302 181   1 161],751,2,23273,4.105309578408891,0.0,20.0
45669,4,5669,[235 181 234 237 151],297,2,23275,4.104938271604938,0.0,20.0
45670,4,5670,[313 483  64 318  11],618,5,23280,4.105096102980074,80.0,20.0
45671,4,5671,[313 483  64 318  11],618,5,23285,4.105253878702397,80.0,20.0
45672,4,5672,[405 183  69 111 202],416,5,23290,4.105411598801339,0.0,0.0
45673,4,5673,[603 271 275  98 322],854,4,23294,4.105393020796616,0.0,20.0
45674,4,5674,[  1 288   8  97 678],921,1,23295,4.104845814977973,0.0,20.0
45675,4,5675,[237 183  98 471 202],505,2,23297,4.1044749823819595,0.0,20.0
45676,4,5676,[313 483  64 318  11],214,5,23302,4.104632728553813,80.0,20.0
45677,4,5677,[185 405  22  56 496],230,4,23306,4.104614300810145,0.0,0.0
45678,4,5678,[385 234 172 185   1],198,2,23308,4.10424370487762,0.0,0.0
45679,4,5679,[313 483  64 318  11],214,5,23313,4.104401408450705,80.0,20.0
45680,4,5680,[333 238 471 172 210],345,3,23316,4.104207005808837,0.0,0.0
45681,4,5681,[313 483  64 318  11],214,5,23321,4.104364660330869,80.0,20.0
45682,4,5682,[405  82 125 471 313],416,5,23326,4.104522259370051,20.0,20.0
45683,4,5683,[ 56  50 111 121 182],416,5,23331,4.104679802955665,0.0,20.0
45684,4,5684,[222 185 191 111 271],805,3,23334,4.104485488126649,0.0,0.0
45685,4,5685,[  8 275  22 132  70],711,5,23339,4.104642982764685,0.0,0.0
45686,4,5686,[313 483  64 318  11],214,5,23344,4.104800422015122,80.0,20.0
45687,4,5687,[322 182  70 186  79],417,3,23347,4.104606188466948,0.0,0.0
45688,4,5688,[313 483  64 318  11],214,5,23352,4.104763578836351,80.0,20.0
45689,4,5689,[313 483  64 318  11],618,5,23357,4.104920913884007,80.0,20.0
45690,4,5690,[313 483  64 318  11],618,5,23362,4.10507819363908,80.0,20.0
45691,4,5691,[301 196 483 172 100],751,5,23367,4.10523541813071,20.0,0.0
45692,4,5692,[ 22 195 258 181 222],698,2,23369,4.10486562445108,0.0,20.0
45693,4,5693,[546 111  70 181 301],43,5,23374,4.105022831050229,0.0,20.0
45694,4,5694,[300 111 508 117 276],708,4,23378,4.105004389815628,0.0,0.0
45695,4,5695,[313 483  64 318  11],214,5,23383,4.105161516853933,80.0,20.0
45696,4,5696,[294 117  70 202  50],43,5,23388,4.105318588730911,0.0,20.0
45697,4,5697,[313 483  64 318  11],618,5,23393,4.105475605475606,80.0,20.0
45698,4,5698,[655 200 132  98 294],417,5,23398,4.105632567117038,0.0,20.0
45699,4,5699,[313 483  64 318  11],618,5,23403,4.105789473684211,80.0,20.0
45700,4,5700,[515  88 215 144 276],416,3,23406,4.105595509559726,0.0,0.0
45701,4,5701,[183 200  95  82 427],253,4,23410,4.105576990529639,0.0,0.0
45702,4,5702,[313 483  64 318  11],214,5,23415,4.105733824302998,80.0,20.0
45703,4,5703,[313 483  64 318  11],214,5,23420,4.105890603085554,80.0,20.0
45704,4,5704,[ 22 322 357 111 271],854,2,23422,4.105521472392638,0.0,0.0
45705,4,5705,[405 289 195 427 655],416,4,23426,4.105502979320014,0.0,0.0
45706,4,5706,[313 483  64 318  11],618,5,23431,4.105659716138076,80.0,20.0
45707,4,5707,[118  96 135  28 357],642,2,23433,4.105290819901892,0.0,0.0
45708,4,5708,[111 216 172 258 168],416,5,23438,4.105447538973551,0.0,0.0
45709,4,5709,[196  95 405 483 568],751,3,23441,4.105253940455341,20.0,0.0
45710,4,5710,[216 385 132 183  69],416,5,23446,4.105410611101384,0.0,0.0
45711,4,5711,[187 294 174 318   7],416,5,23451,4.105567226890757,20.0,0.0
45712,4,5712,[313 197 125 655  56],618,3,23454,4.105373709084544,20.0,20.0
45713,4,5713,[197 153 173 603 195],854,4,23458,4.105355267763388,0.0,0.0
45714,4,5714,[313 483  64 318  11],214,5,23463,4.105511811023622,80.0,20.0
45715,4,5715,[313 483  64 318  11],618,5,23468,4.105668299510147,80.0,20.0
45716,4,5716,[313 483  64 318  11],618,5,23473,4.105824733251706,80.0,20.0
45717,4,5717,[135 245 385 496  22],642,4,23477,4.10580622595313,0.0,0.0
45718,4,5718,[ 50 179  97  95  82],437,3,23480,4.105612869382759,0.0,20.0
45719,4,5719,[ 22 273 333 182 678],416,4,23484,4.105594405594406,0.0,0.0
45720,4,5720,[234  88 181 117 245],642,4,23488,4.105575948260793,0.0,20.0
45721,4,5721,[ 28 294 111 475 588],805,1,23489,4.105033205173016,0.0,0.0
45722,4,5722,[313 483  64 318  11],214,5,23494,4.105189585881531,80.0,20.0
45723,4,5723,[313 483  64 318  11],618,5,23499,4.105345911949685,80.0,20.0
45724,4,5724,[117 228 496 245 185],417,2,23501,4.104978165938864,0.0,0.0
45725,4,5725,[515 228 153  69  95],230,4,23505,4.104959832343695,0.0,0.0
45726,4,5726,[313 483  64 318  11],618,5,23510,4.105116116640475,80.0,20.0
45727,4,5727,[313 483  64 318  11],618,5,23515,4.105272346368715,80.0,20.0
45728,4,5728,[168  89  25 215  50],751,4,23519,4.105253971024611,0.0,20.0
45729,4,5729,[313 483  64 318  11],618,5,23524,4.105410122164049,80.0,20.0
45730,4,5730,[187 111 127 195 100],887,3,23527,4.1052172395742454,0.0,0.0
45731,4,5731,[313 483  64 318  11],618,5,23532,4.105373342637823,80.0,20.0
45732,4,5732,[313 483  64 318  11],618,5,23537,4.105529391243677,80.0,20.0
45733,4,5733,[ 64 385  89  96  15],198,3,23540,4.105336588768748,20.0,0.0
45734,4,5734,[313 483  64 318  11],214,5,23545,4.105492589363557,80.0,20.0
45735,4,5735,[286 405 276 168 423],62,2,23547,4.1051255230125525,0.0,0.0
45736,4,5736,[313 483  64 318  11],618,5,23552,4.105281506013596,80.0,20.0
45737,4,5737,[313 483  64 318  11],214,5,23557,4.105437434646218,80.0,20.0
45738,4,5738,[313 483  64 318  11],618,5,23562,4.10559330893884,80.0,20.0
45739,4,5739,[313 483  64 318  11],214,5,23567,4.105749128919861,80.0,20.0
45740,4,5740,[313 483  64 318  11],214,5,23572,4.105904894617662,80.0,20.0
45741,4,5741,[161 215 174 216  98],437,3,23575,4.105712295367468,0.0,20.0
45742,4,5742,[313 483  64 318  11],214,5,23580,4.1058680132335015,80.0,20.0
45743,4,5743,[313 483  64 318  11],214,5,23585,4.1060236768802225,80.0,20.0
45744,4,5744,[313 483  64 318  11],214,5,23590,4.106179286335944,80.0,20.0
45745,4,5745,[603 182 237 273  70],297,4,23594,4.106160807518274,0.0,0.0
45746,4,5746,[286  88  56 423 172],43,5,23599,4.1063163389594575,0.0,0.0
45747,4,5747,[483 132   1 268 568],588,5,23604,4.106471816283925,20.0,0.0
45748,4,5748,[313 483  64 318  11],618,5,23609,4.106627239519916,80.0,20.0
45749,4,5749,[ 70 174 118 234 132],198,2,23611,4.106260869565217,0.0,0.0
45750,4,5750,[313 483  64 318  11],618,5,23616,4.10641627543036,80.0,20.0
45751,4,5751,[313 483  64 318  11],618,5,23621,4.106571627260084,80.0,20.0
45752,4,5752,[313 483  64 318  11],618,5,23626,4.106726925082565,80.0,20.0
45753,4,5753,[748   1  82 143  96],642,5,23631,4.1068821689259645,0.0,0.0
45754,4,5754,[322 258 357 483  97],417,4,23635,4.106863596872285,20.0,0.0
45755,4,5755,[313 483  64 318  11],214,5,23640,4.107018763029882,80.0,20.0
45756,4,5756,[313 483  64 318  11],618,5,23645,4.107173875282265,80.0,20.0
45757,4,5757,[323 196 127 257 143],43,4,23649,4.107155262243834,0.0,0.0
45758,4,5758,[313 483  64 318  11],214,5,23654,4.10731029692655,80.0,20.0
45759,4,5759,[385 216  69  25 597],654,4,23658,4.107291666666667,0.0,0.0
45760,4,5760,[313 483  64 318  11],214,5,23663,4.107446623850026,80.0,20.0
45761,4,5761,[313 483  64 318  11],618,5,23668,4.107601527247484,80.0,20.0
45762,4,5762,[151 655 168  71 161],588,4,23672,4.10758285615131,0.0,0.0
45763,4,5763,[ 88  50 176 132 191],437,3,23675,4.107390700902151,0.0,20.0
45764,4,5764,[313 483  64 318  11],618,5,23680,4.1075455333911535,80.0,20.0
45765,4,5765,[  1 300 323 200 202],345,1,23681,4.107006590357266,0.0,0.0
45766,4,5766,[313 483  64 318  11],618,5,23686,4.107161435755159,80.0,20.0
45767,4,5767,[313 483  64 318  11],618,5,23691,4.107316227461858,80.0,20.0
45768,4,5768,[313 483  64 318  11],618,5,23696,4.107470965505287,80.0,20.0
45769,4,5769,[313 483  64 318  11],214,5,23701,4.107625649913345,80.0,20.0
45770,4,5770,[197 204 215  70 282],721,4,23705,4.107607000519841,0.0,0.0
45771,4,5771,[258 228 568 127 202],922,3,23708,4.1074151074151075,0.0,0.0
45772,4,5772,[313 483  64 318  11],214,5,23713,4.107569721115538,80.0,20.0
45773,4,5773,[313 483  64 318  11],618,5,23718,4.107724281260825,80.0,20.0
45774,4,5774,[313 483  64 318  11],618,5,23723,4.1078787878787875,80.0,20.0
45775,4,5775,[215  97 237 288 423],416,4,23727,4.107860110803324,0.0,20.0
45776,4,5776,[313 483  64 318  11],214,5,23732,4.108014540418902,80.0,20.0
45777,4,5777,[655 286 275 288  96],416,5,23737,4.108168916580132,0.0,20.0
45778,4,5778,[313 483  64 318  11],618,5,23742,4.10832323931476,80.0,20.0
45779,4,5779,[211 181  95   8 100],437,5,23747,4.108477508650519,0.0,20.0
45780,4,5780,[357  12 127 435 210],405,4,23751,4.10845874416191,20.0,0.0
45781,4,5781,[313 483  64 318  11],618,5,23756,4.108612936700104,80.0,20.0
45782,4,5782,[172 258 385 328 176],505,3,23759,4.108421234653294,0.0,0.0
45783,4,5783,[313 483  64 318  11],214,5,23764,4.108575380359612,80.0,20.0
45784,4,5784,[168 182 289 202 117],49,2,23766,4.108210890233362,0.0,0.0
45785,4,5785,[135  96 191 183 168],618,4,23770,4.108192188040097,0.0,0.0
45786,4,5786,[313 483  64 318  11],214,5,23775,4.108346293416278,80.0,20.0
45787,4,5787,[117 427 597 210 405],642,3,23778,4.108154803040774,0.0,0.0
45788,4,5788,[313 483  64 318  11],214,5,23783,4.108308861634134,80.0,20.0
45789,4,5789,[183 275  15 655  88],416,4,23787,4.1082901554404145,0.0,0.0
45790,4,5790,[313 483  64 318  11],618,5,23792,4.108444137454671,80.0,20.0
45791,4,5791,[200 508 100 173 118],297,3,23795,4.108252762430939,0.0,0.0
45792,4,5792,[313 483  64 318  11],214,5,23800,4.10840669773865,80.0,20.0
45793,4,5793,[ 11  97   1  22 173],505,3,23803,4.108215395236451,0.0,0.0
45794,4,5794,[269 118 475 185 151],416,2,23805,4.1078515962036235,0.0,0.0
45795,4,5795,[313 483  64 318  11],618,5,23810,4.108005521048999,80.0,20.0
45796,4,5796,[228  12   1 546 100],805,3,23813,4.107814386751768,20.0,0.0
45797,4,5797,[174 276 655 204  28],128,3,23816,4.1076233183856505,0.0,0.0
45798,4,5798,[313 483  64 318  11],214,5,23821,4.107777202966028,80.0,20.0
45799,4,5799,[313 483  64 318  11],618,5,23826,4.107931034482759,80.0,20.0
45800,4,5800,[195 403 423 144  69],705,1,23827,4.107395276676435,0.0,0.0
45801,4,5801,[405 245 125 143 546],416,3,23830,4.1072044122716305,0.0,0.0
45802,4,5802,[313 483  64 318  11],214,5,23835,4.107358262967431,80.0,20.0
45803,4,5803,[313 483  64 318  11],618,5,23840,4.107512060647829,80.0,20.0
45804,4,5804,[111   9 176 294 603],854,2,23842,4.107149009474591,0.0,0.0
45805,4,5805,[313 483  64 318  11],618,5,23847,4.107302790217017,80.0,20.0
45806,4,5806,[168 603 588 121 257],698,2,23849,4.106939900120544,0.0,0.0
45807,4,5807,[245 423 742 234  64],417,4,23853,4.106921487603306,20.0,0.0
45808,4,5808,[179 161  28 175 144],373,1,23854,4.106386641418489,0.0,0.0
45809,4,5809,[313 483  64 318  11],214,5,23859,4.106540447504303,80.0,20.0
45810,4,5810,[313 483  64 318  11],618,5,23864,4.106694200653932,80.0,20.0
45811,4,5811,[313 483  64 318  11],214,5,23869,4.1068479008947,80.0,20.0
45812,4,5812,[ 88 435   7  97 195],505,2,23871,4.106485463616033,0.0,0.0
45813,4,5813,[ 50 196 742 568 588],417,1,23872,4.105951152390781,0.0,20.0
45814,4,5814,[ 82  98 435 176  70],230,5,23877,4.106104901117798,0.0,20.0
45815,4,5815,[313 483  64 318  11],214,5,23882,4.106258596973865,80.0,20.0
45816,4,5816,[313 483  64 318  11],618,5,23887,4.1064122399862475,80.0,20.0
45817,4,5817,[313 483  64 318  11],214,5,23892,4.106565830182193,80.0,20.0
45818,4,5818,[ 82 202 655 144 301],751,4,23896,4.106547516755456,0.0,0.0
45819,4,5819,[313 483  64 318  11],618,5,23901,4.106701030927835,80.0,20.0
45820,4,5820,[313 483  64 318  11],618,5,23906,4.106854492355265,80.0,20.0
45821,4,5821,[313 483  64 318  11],214,5,23911,4.107007901064926,80.0,20.0
45822,4,5822,[313 483  64 318  11],214,5,23916,4.107161257083978,80.0,20.0
45823,4,5823,[313 483  64 318  11],618,5,23921,4.10731456043956,80.0,20.0
45824,4,5824,[313 483  64 318  11],618,5,23926,4.1074678111587986,80.0,20.0
45825,4,5825,[313 483  64 318  11],618,5,23931,4.1076210092687955,80.0,20.0
45826,4,5826,[237   8   4 191 186],618,3,23934,4.10743092500429,0.0,0.0
45827,4,5827,[313 483  64 318  11],618,5,23939,4.107584076870282,80.0,20.0
45828,4,5828,[313 483  64 318  11],214,5,23944,4.107737176188025,80.0,20.0
45829,4,5829,[742 168 483 181 202],588,4,23948,4.107718696397941,20.0,20.0
45830,4,5830,[313 483  64 318  11],214,5,23953,4.107871720116618,80.0,20.0
45831,4,5831,[313 483  64 318  11],214,5,23958,4.1080246913580245,80.0,20.0
45832,4,5832,[313 483  64 318  11],214,5,23963,4.108177610149151,80.0,20.0
45833,4,5833,[ 97 204 265 471 475],588,3,23966,4.107987658553308,0.0,0.0
45834,4,5834,[313 483  64 318  11],618,5,23971,4.108140531276778,80.0,20.0
45835,4,5835,[234 597 172  70 294],642,3,23974,4.107950651130912,0.0,0.0
45836,4,5836,[161  79 175 153 228],373,4,23978,4.107932156929929,0.0,0.0
45837,4,5837,[186 117 258  69 111],417,3,23981,4.1077423775265505,0.0,0.0
45838,4,5838,[  1 204 405  98 273],62,2,23983,4.107381400924816,0.0,20.0
45839,4,5839,[194  11 174 180  25],854,2,23985,4.107020547945205,0.0,0.0
45840,4,5840,[313 483  64 318  11],214,5,23990,4.107173429207328,80.0,20.0
45841,4,5841,[275 132 286 181 153],62,4,23994,4.107155083875385,0.0,20.0
45842,4,5842,[313 483  64 318  11],214,5,23999,4.107307889782646,80.0,20.0
45843,4,5843,[313 483  64 318  11],214,5,24004,4.107460643394935,80.0,20.0
45844,4,5844,[ 89 179 245 117  82],62,4,24008,4.107442258340462,0.0,0.0
45845,4,5845,[174 318 234 483 276],618,4,24012,4.107423879575778,40.0,0.0
45846,4,5846,[568   1 118 423 187],887,3,24015,4.1072344792201125,0.0,0.0
45847,4,5847,[313 483  64 318  11],618,5,24020,4.107387140902873,80.0,20.0
45848,4,5848,[313 483  64 318  11],618,5,24025,4.1075397503846816,80.0,20.0
45849,4,5849,[151  11   8 216   4],654,5,24030,4.107692307692307,0.0,0.0
45850,4,5850,[275 483  79 357 282],854,4,24034,4.107673901897112,20.0,0.0
45851,4,5851,[182 153  25 265 204],230,3,24037,4.1074846206425155,0.0,0.0
45852,4,5852,[276 269 318 100 210],43,5,24042,4.1076371091747825,20.0,0.0
45853,4,5853,[ 12 179 357  96 568],373,4,24046,4.107618722241202,20.0,0.0
45854,4,5854,[313 483  64 318  11],618,5,24051,4.107771135781383,80.0,20.0
45855,4,5855,[301 117 235  69 288],416,4,24055,4.107752732240437,0.0,20.0
45856,4,5856,[313 483  64 318  11],618,5,24060,4.107905070855387,80.0,20.0
45857,4,5857,[313 483  64 318  11],214,5,24065,4.1080573574598835,80.0,20.0
45858,4,5858,[174 125  98 153 276],630,1,24066,4.10752688172043,0.0,20.0
45859,4,5859,[195 191  69 655 216],618,3,24069,4.107337883959044,0.0,0.0
45860,4,5860,[ 96 143 237  98 235],416,3,24072,4.107148950691008,0.0,20.0
45861,4,5861,[313 483  64 318  11],618,5,24077,4.107301262367793,80.0,20.0
45862,4,5862,[313 483  64 318  11],618,5,24082,4.107453522087669,80.0,20.0
45863,4,5863,[183 172 132 195 202],618,3,24085,4.107264665757162,0.0,0.0
45864,4,5864,[313 483  64 318  11],618,5,24090,4.107416879795396,80.0,20.0
45865,4,5865,[313 483  64 318  11],618,5,24095,4.107569041936584,80.0,20.0
45866,4,5866,[313 483  64 318  11],618,5,24100,4.107721152207261,80.0,20.0
45867,4,5867,[313 483  64 318  11],214,5,24105,4.107873210633946,80.0,20.0
45868,4,5868,[597  98  11 181  71],416,4,24109,4.107854830465156,0.0,40.0
45869,4,5869,[289 328  97 302  69],43,5,24114,4.108006814310051,0.0,0.0
45870,4,5870,[ 28 496 176  88 179],416,3,24117,4.1078180889116,0.0,0.0
45871,4,5871,[313 483  64 318  11],214,5,24122,4.107970027247957,80.0,20.0
45872,4,5872,[313 483  64 318  11],214,5,24127,4.108121913843011,80.0,20.0
45873,4,5873,[ 12 302 235 245 204],416,3,24130,4.107933265236636,20.0,0.0
45874,4,5874,[202  69 294 235 194],416,4,24134,4.107914893617021,0.0,0.0
45875,4,5875,[313 483  64 318  11],214,5,24139,4.108066712049013,80.0,20.0
45876,4,5876,[313 483  64 318  11],214,5,24144,4.108218478815722,80.0,20.0
45877,4,5877,[546  50 265 100 301],555,3,24147,4.108029942157196,0.0,20.0
45878,4,5878,[ 82 127 173  25  28],43,5,24152,4.108181663548223,0.0,0.0
45879,4,5879,[313 483  64 318  11],618,5,24157,4.108333333333333,80.0,20.0
45880,4,5880,[568  82 603 183 323],805,3,24160,4.108144873320864,0.0,0.0
45881,4,5881,[313 483  64 318  11],214,5,24165,4.108296497789867,80.0,20.0
45882,4,5882,[ 96 111  71 385 180],805,1,24166,4.107768145503995,0.0,0.0
45883,4,5883,[313 483  64 318  11],618,5,24171,4.107919782460911,80.0,20.0
45884,4,5884,[313 483  64 318  11],618,5,24176,4.108071367884452,80.0,20.0
45885,4,5885,[313 483  64 318  11],618,5,24181,4.108222901800883,80.0,20.0
45886,4,5886,[313 483  64 318  11],618,5,24186,4.108374384236453,80.0,20.0
45887,4,5887,[ 71  96 257 172 135],62,4,24190,4.108355978260869,0.0,0.0
45888,4,5888,[403 238 180 181 357],417,4,24194,4.108337578536254,0.0,20.0
45889,4,5889,[313 483  64 318  11],618,5,24199,4.10848896434635,80.0,20.0
45890,4,5890,[237 204   1 121 405],198,1,24200,4.107961296893566,0.0,0.0
45891,4,5891,[265 183 588 125  97],505,3,24203,4.107773251866938,0.0,0.0
45892,4,5892,[ 79  12 175  88 202],43,4,24207,4.107754963516036,20.0,0.0
45893,4,5893,[313 483  64 318  11],618,5,24212,4.107906345436037,80.0,20.0
45894,4,5894,[127 151 111 258 117],43,5,24217,4.108057675996608,0.0,0.0
45895,4,5895,[313 483  64 318  11],618,5,24222,4.108208955223881,80.0,20.0
45896,4,5896,[313 483  64 318  11],214,5,24227,4.108360183143971,80.0,20.0
45897,4,5897,[ 25 269 111 222 385],654,4,24231,4.108341810783316,0.0,0.0
45898,4,5898,[196 597  97 181 238],43,3,24234,4.108153924393965,0.0,20.0
45899,4,5899,[175 194 195 288 403],405,3,24237,4.107966101694915,0.0,20.0
45900,4,5900,[597 269 742 568 300],751,1,24238,4.107439417047958,0.0,0.0
45901,4,5901,[286  12 471 100  11],345,3,24241,4.107251779057947,20.0,0.0
45902,4,5902,[313 483  64 318  11],214,5,24246,4.1074030154158905,80.0,20.0
45903,4,5903,[196 161 282 496 597],618,4,24250,4.107384823848238,0.0,0.0
45904,4,5904,[385 168 215 173  96],751,5,24255,4.1075359864521594,0.0,0.0
45905,4,5905,[313 483  64 318  11],214,5,24260,4.1076870978665765,80.0,20.0
45906,4,5906,[313 483  64 318  11],618,5,24265,4.107838158117488,80.0,20.0
45907,4,5907,[ 22 508  25 183 151],297,4,24269,4.10781990521327,0.0,0.0
45908,4,5908,[313 483  64 318  11],214,5,24274,4.107970891859875,80.0,20.0
45909,4,5909,[313 483  64 318  11],214,5,24279,4.108121827411168,80.0,20.0
45910,4,5910,[313 483  64 318  11],618,5,24284,4.108272711893081,80.0,20.0
45911,4,5911,[313 483  64 318  11],214,5,24289,4.108423545331529,80.0,20.0
45912,4,5912,[313 483  64 318  11],214,5,24294,4.10857432775241,80.0,20.0
45913,4,5913,[ 71  70 322 204 385],416,4,24298,4.108555968887386,0.0,0.0
45914,4,5914,[313 483  64 318  11],618,5,24303,4.108706677937447,80.0,20.0
45915,4,5915,[748 187 269 194 568],373,4,24307,4.10868830290737,0.0,0.0
45916,4,5916,[ 69 216  56  89 100],198,4,24311,4.10866993408822,0.0,0.0
45917,4,5917,[257  50 508 194 483],854,3,24314,4.108482595471443,20.0,20.0
45918,4,5918,[268 258 427 286 678],416,4,24318,4.1084642676127725,0.0,0.0
45919,4,5919,[403 515 143 289 385],416,4,24322,4.108445945945946,0.0,0.0
45920,4,5920,[313 483  64 318  11],618,5,24327,4.108596520857963,80.0,20.0
45921,4,5921,[172 276 427 471 118],128,4,24331,4.108578183046268,0.0,0.0
45922,4,5922,[313 483  64 318  11],214,5,24336,4.108728684788114,80.0,20.0
45923,4,5923,[ 95 125 132  12  82],416,4,24340,4.108710330857528,20.0,0.0
45924,4,5924,[313 483  64 318  11],214,5,24345,4.108860759493671,80.0,20.0
45925,4,5925,[ 79 235 238 302 273],417,1,24346,4.1083361457981775,0.0,0.0
45926,4,5926,[318 357 216 181  22],721,5,24351,4.1084865868061415,20.0,20.0
45927,4,5927,[173  12 288 185 403],805,4,24355,4.108468286099865,20.0,20.0
45928,4,5928,[678  98  79  22 275],588,2,24357,4.108112666554225,0.0,20.0
45929,4,5929,[182 568 385 323 546],417,2,24359,4.1077571669477235,0.0,0.0
45930,4,5930,[597   8 276 269 258],43,4,24363,4.107738998482549,0.0,0.0
45931,4,5931,[313 483  64 318  11],214,5,24368,4.107889413351315,80.0,20.0
45932,4,5932,[313 483  64 318  11],618,5,24373,4.10803977751559,80.0,20.0
45933,4,5933,[546 117 258 276  69],274,4,24377,4.108021570610044,0.0,0.0
45934,4,5934,[200 183 204 515 357],297,3,24380,4.1078348778433025,0.0,0.0
45935,4,5935,[313 483  64 318  11],214,5,24385,4.107985175202156,80.0,20.0
45936,4,5936,[655 125 294 258 196],721,1,24386,4.107461680983662,0.0,0.0
45937,4,5937,[186 197 357 471 423],373,2,24388,4.107106769956214,0.0,0.0
45938,4,5938,[237 132 216 135 204],642,2,24390,4.10675197844755,0.0,0.0
45939,4,5939,[313 483  64 318  11],214,5,24395,4.106902356902357,80.0,20.0
45940,4,5940,[313 483  64 318  11],618,5,24400,4.10705268473321,80.0,20.0
45941,4,5941,[313 483  64 318  11],618,5,24405,4.107202961965668,80.0,20.0
45942,4,5942,[210 323 172 161 271],805,2,24407,4.106848393067474,0.0,0.0
45943,4,5943,[ 56 228 515 258 603],297,4,24411,4.106830417227457,0.0,0.0
45944,4,5944,[143 403 186 288 222],711,2,24413,4.106476030277544,0.0,20.0
45945,4,5945,[313 483  64 318  11],618,5,24418,4.106626303397242,80.0,20.0
45946,4,5946,[ 70 210  82 202  11],230,5,24423,4.106776525979486,0.0,0.0
45947,4,5947,[655 286 118 508  50],62,2,24425,4.106422326832549,0.0,20.0
45948,4,5948,[118 286 234 179  89],417,5,24430,4.1065725331988565,0.0,0.0
45949,4,5949,[196  69  25 215 515],416,5,24435,4.10672268907563,0.0,0.0
45950,4,5950,[313 483  64 318  11],214,5,24440,4.106872794488321,80.0,20.0
45951,4,5951,[313 483  64 318  11],214,5,24445,4.107022849462366,80.0,20.0
45952,4,5952,[313 483  64 318  11],214,5,24450,4.107172854023181,80.0,20.0
45953,4,5953,[301 258  15 237 153],416,4,24454,4.107154853879745,0.0,0.0
45954,4,5954,[313 483  64 318  11],214,5,24459,4.107304785894207,80.0,20.0
45955,4,5955,[318  95 258  69 215],588,4,24463,4.107286769644056,20.0,0.0
45956,4,5956,[ 95  11 238  98 174],618,3,24466,4.107100889709585,0.0,20.0
45957,4,5957,[238 174 179 515 318],416,4,24470,4.10708291372944,20.0,0.0
45958,4,5958,[313 483  64 318  11],214,5,24475,4.107232757174023,80.0,20.0
45959,4,5959,[179  11  96 276 588],416,3,24478,4.107046979865772,0.0,0.0
45960,4,5960,[313 483  64 318  11],618,5,24483,4.107196779063916,80.0,20.0
45961,4,5961,[313 483  64 318  11],618,5,24488,4.107346528010734,80.0,20.0
45962,4,5962,[313 483  64 318  11],214,5,24493,4.107496226731511,80.0,20.0
45963,4,5963,[121 268  70   7  50],49,1,24494,4.106975184439973,0.0,20.0
45964,4,5964,[313 483  64 318  11],618,5,24499,4.107124895222129,80.0,20.0
45965,4,5965,[313 483  64 318  11],618,5,24504,4.107274555816292,80.0,20.0
45966,4,5966,[313 483  64 318  11],618,5,24509,4.107424166247696,80.0,20.0
45967,4,5967,[313 483  64 318  11],214,5,24514,4.107573726541555,80.0,20.0
45968,4,5968,[172 546  98  22 151],62,5,24519,4.10772323672307,0.0,20.0
45969,4,5969,[237 588  11 132 176],505,4,24523,4.107705192629815,0.0,0.0
45970,4,5970,[258 187  70   4 185],198,2,24525,4.107352202311171,0.0,0.0
45971,4,5971,[313 483  64 318  11],618,5,24530,4.107501674480911,80.0,20.0
45972,4,5972,[313 483  64 318  11],618,5,24535,4.107651096601373,80.0,20.0
45973,4,5973,[328 603 143 471  95],373,3,24538,4.107465684633412,0.0,0.0
45974,4,5974,[313 483  64 318  11],214,5,24543,4.107615062761506,80.0,20.0
45975,4,5975,[215  69 568  82 196],198,2,24545,4.107262382864793,0.0,0.0
45976,4,5976,[143  64 235 117   1],930,1,24546,4.106742512966371,20.0,0.0
45977,4,5977,[313 483  64 318  11],214,5,24551,4.10689193710271,80.0,20.0
45978,4,5978,[ 22 288 603  11 179],805,2,24553,4.10653955510955,0.0,20.0
45979,4,5979,[655 328 117 183 258],62,3,24556,4.1063545150501675,0.0,0.0
45980,4,5980,[313 483  64 318  11],618,5,24561,4.106503929108845,80.0,20.0
45981,4,5981,[121 742 125 475 168],588,3,24564,4.106318956870612,0.0,0.0
45982,4,5982,[313 483  64 318  11],214,5,24569,4.106468326926291,80.0,20.0
45983,4,5983,[313 483  64 318  11],618,5,24574,4.106617647058823,80.0,20.0
45984,4,5984,[313 483  64 318  11],618,5,24579,4.106766917293233,80.0,20.0
45985,4,5985,[568  69 471 678  71],588,3,24582,4.106582024724357,0.0,0.0
45986,4,5986,[238 423 237 191 568],416,4,24586,4.106564222482044,0.0,0.0
45987,4,5987,[196 258 294 172 475],601,3,24589,4.106379425517702,0.0,0.0
45988,4,5988,[235 238 286 111 161],417,2,24591,4.106027717482051,0.0,0.0
45989,4,5989,[423   1 357 179 546],417,4,24595,4.106010016694491,0.0,0.0
45990,4,5990,[313 483  64 318  11],618,5,24600,4.106159238858288,80.0,20.0
45991,4,5991,[275 235  79  97 288],297,2,24602,4.105807743658211,0.0,20.0
45992,4,5992,[313 483  64 318  11],214,5,24607,4.105956949774737,80.0,20.0
45993,4,5993,[313 483  64 318  11],618,5,24612,4.106106106106106,80.0,20.0
45994,4,5994,[301 282 117 568 294],345,3,24615,4.105921601334446,0.0,0.0
45995,4,5995,[313 483  64 318  11],618,5,24620,4.106070713809206,80.0,20.0
45996,4,5996,[180 475 127 204 118],805,1,24621,4.105552776388194,0.0,0.0
45997,4,5997,[127 269 202 385 289],416,4,24625,4.105535178392798,0.0,0.0
45998,4,5998,[313 483  64 318  11],618,5,24630,4.105684280713453,80.0,20.0
45999,4,5999,[313 483  64 318  11],618,5,24635,4.105833333333333,80.0,20.0
46000,4,6000,[313 483  64 318  11],214,5,24640,4.105982336277287,80.0,20.0
46001,4,6001,[275  88 191 238 258],711,5,24645,4.106131289570143,0.0,0.0
46002,4,6002,[313 483  64 318  11],214,5,24650,4.106280193236715,80.0,20.0
46003,4,6003,[ 96 125 153 172 174],373,5,24655,4.106429047301798,0.0,0.0
46004,4,6004,[ 22   8 475 176  64],601,3,24658,4.10624479600333,20.0,0.0
46005,4,6005,[313 483  64 318  11],618,5,24663,4.106393606393606,80.0,20.0
46006,4,6006,[  8 144 357  82  71],416,5,24668,4.106542367238222,0.0,0.0
46007,4,6007,[313 483  64 318  11],618,5,24673,4.1066910785619175,80.0,20.0
46008,4,6008,[313 483  64 318  11],618,5,24678,4.1068397403894155,80.0,20.0
46009,4,6009,[ 56 655 118 111 202],751,2,24680,4.10648918469218,0.0,0.0
46010,4,6010,[313 483  64 318  11],214,5,24685,4.10663783064382,80.0,20.0
46011,4,6011,[328 100 588 235 187],416,4,24689,4.106620093147039,0.0,0.0
46012,4,6012,[ 50 273 235  97  25],297,4,24693,4.106602361549975,0.0,20.0
46013,4,6013,[237  56   4 196  69],297,3,24696,4.1064183571666115,0.0,0.0
46014,4,6014,[269 294  12 546 328],43,5,24701,4.106566916043225,20.0,0.0
46015,4,6015,[313 483  64 318  11],214,5,24706,4.106715425531915,80.0,20.0
46016,4,6016,[603 194   4  89 117],297,3,24709,4.10653149410005,0.0,0.0
46017,4,6017,[313 483  64 318  11],618,5,24714,4.106679960119641,80.0,20.0
46018,4,6018,[313 483  64 318  11],214,5,24719,4.106828376806779,80.0,20.0
46019,4,6019,[427 125 100 237 127],618,4,24723,4.106810631229236,0.0,0.0
46020,4,6020,[273 313  28 238 118],416,4,24727,4.106792891546255,20.0,20.0
46021,4,6021,[143  97   8 258  96],907,4,24731,4.106775157754899,0.0,0.0
46022,4,6022,[313 483  64 318  11],618,5,24736,4.106923460069733,80.0,20.0
46023,4,6023,[313 483  64 318  11],214,5,24741,4.10707171314741,80.0,20.0
46024,4,6024,[313 483  64 318  11],214,5,24746,4.107219917012448,80.0,20.0
46025,4,6025,[313 483  64 318  11],214,5,24751,4.107368071689346,80.0,20.0
46026,4,6026,[235 222   7  70 176],62,4,24755,4.107350257176041,0.0,0.0
46027,4,6027,[313 483  64 318  11],214,5,24760,4.107498341074983,80.0,20.0
46028,4,6028,[313 483  64 318  11],214,5,24765,4.107646375850058,80.0,20.0
46029,4,6029,[ 96 313 100   1  95],49,1,24766,4.107131011608623,20.0,20.0
46030,4,6030,[151 257  64 271  98],43,4,24770,4.1071132482175425,20.0,20.0
46031,4,6031,[118 435 508 748 471],297,1,24771,4.1065981432360745,0.0,0.0
46032,4,6032,[603 427 144 655 748],373,4,24775,4.10658047405934,0.0,0.0
46033,4,6033,[183 546 288 151 258],805,2,24777,4.1062313556513095,0.0,20.0
46034,4,6034,[313 483  64 318  11],618,5,24782,4.106379453189726,80.0,20.0
46035,4,6035,[144  28 176   7 168],416,5,24787,4.106527501656727,0.0,0.0
46036,4,6036,[313 483  64 318  11],618,5,24792,4.106675501076694,80.0,20.0
46037,4,6037,[215 228 180 258 182],198,3,24795,4.1064922159655515,0.0,0.0
46038,4,6038,[313 483  64 318  11],618,5,24800,4.106640172213942,80.0,20.0
46039,4,6039,[313 483  64 318  11],214,5,24805,4.106788079470198,80.0,20.0
46040,4,6040,[313 483  64 318  11],618,5,24810,4.106935937758649,80.0,20.0
46041,4,6041,[185  69 172 153 179],437,4,24814,4.1069182389937104,0.0,0.0
46042,4,6042,[385 118 222 151 168],654,4,24818,4.106900546086381,0.0,0.0
46043,4,6043,[168 588  96 294  71],712,4,24822,4.106882859033752,0.0,0.0
46044,4,6044,[245 144 181 301 257],416,3,24825,4.106699751861042,0.0,20.0
46045,4,6045,[313 483  64 318  11],618,5,24830,4.106847502480979,80.0,20.0
46046,4,6046,[313 483  64 318  11],618,5,24835,4.106995204233504,80.0,20.0
46047,4,6047,[288 185 179 323 508],417,1,24836,4.106481481481482,0.0,20.0
46048,4,6048,[515 216 191  64 475],417,4,24840,4.106463878326996,20.0,0.0
46049,4,6049,[313 483  64 318  11],214,5,24845,4.106611570247934,80.0,20.0
46050,4,6050,[161 194 655 300 210],416,5,24850,4.106759213353165,0.0,0.0
46051,4,6051,[ 88 117 111  15  25],314,4,24854,4.106741573033708,0.0,0.0
46052,4,6052,[ 28  70 117 385 588],618,4,24858,4.1067239385428715,0.0,0.0
46053,4,6053,[197 603 143 318 328],416,5,24863,4.106871489924017,20.0,0.0
46054,4,6054,[313 483  64 318  11],214,5,24868,4.1070189925681255,80.0,20.0
46055,4,6055,[118 568  79 195 515],417,3,24871,4.106836195508587,0.0,0.0
46056,4,6056,[200 161 257 173  95],711,3,24874,4.10665345880799,0.0,0.0
46057,4,6057,[288 176 215 125  22],62,3,24877,4.106470782436448,0.0,20.0
46058,4,6058,[313 483  64 318  11],214,5,24882,4.106618253837267,80.0,20.0
46059,4,6059,[313 483  64 318  11],618,5,24887,4.106765676567656,80.0,20.0
46060,4,6060,[302 245 257  15 678],416,2,24889,4.106418082824616,0.0,0.0
46061,4,6061,[678  88  71  11 234],345,3,24892,4.106235565819861,0.0,0.0
46062,4,6062,[313 483  64 318  11],618,5,24897,4.1063829787234045,80.0,20.0
46063,4,6063,[313 483  64 318  11],214,5,24902,4.106530343007916,80.0,20.0
46064,4,6064,[313 483  64 318  11],618,5,24907,4.1066776586974445,80.0,20.0
46065,4,6065,[313 483  64 318  11],618,5,24912,4.106824925816023,80.0,20.0
46066,4,6066,[121   9  82  22  50],62,5,24917,4.106972144387671,0.0,20.0
46067,4,6067,[313 483  64 318  11],618,5,24922,4.107119314436388,80.0,20.0
46068,4,6068,[235 132 194 276 144],416,3,24925,4.10693689240402,0.0,0.0
46069,4,6069,[313 483  64 318  11],618,5,24930,4.107084019769357,80.0,20.0
46070,4,6070,[ 89 597 742 202   7],751,1,24931,4.106572228627903,0.0,0.0
46071,4,6071,[195 276 385  64 216],618,2,24933,4.1062252964426875,20.0,0.0
46072,4,6072,[313 483  64 318  11],214,5,24938,4.106372468302322,80.0,20.0
46073,4,6073,[313 483  64 318  11],214,5,24943,4.106519591702338,80.0,20.0
46074,4,6074,[204 275 385 427 187],416,5,24948,4.1066666666666665,0.0,0.0
46075,4,6075,[313 483  64 318  11],214,5,24953,4.106813693219223,80.0,20.0
46076,4,6076,[ 11 153 132 748 197],416,5,24958,4.106960671383907,0.0,0.0
46077,4,6077,[ 69 286 216  79 175],854,3,24961,4.106778545574202,0.0,0.0
46078,4,6078,[313 483  64 318  11],618,5,24966,4.106925481164665,80.0,20.0
46079,4,6079,[313 483  64 318  11],618,5,24971,4.107072368421052,80.0,20.0
46080,4,6080,[385   8  95 427  79],416,4,24975,4.107054760730143,0.0,0.0
46081,4,6081,[313 483  64 318  11],618,5,24980,4.107201578428149,80.0,20.0
46082,4,6082,[427  25  69 288 200],887,3,24983,4.107019562715765,0.0,20.0
46083,4,6083,[313 483  64 318  11],214,5,24988,4.107166337935569,80.0,20.0
46084,4,6084,[125 286   9 151  82],416,4,24992,4.1071487263763355,0.0,0.0
46085,4,6085,[313 483  64 318  11],618,5,24997,4.1072954321393365,80.0,20.0
46086,4,6086,[265 742 333 196  98],416,5,25002,4.107442089699359,0.0,20.0
46087,4,6087,[403 127 183 143  56],416,5,25007,4.107588699080158,0.0,0.0
46088,4,6088,[313 483  64 318  11],214,5,25012,4.107735260305469,80.0,20.0
46089,4,6089,[183 195 125 258  70],62,4,25016,4.107717569786535,0.0,0.0
46090,4,6090,[300  12 405 111 173],416,5,25021,4.107864061730422,20.0,0.0
46091,4,6091,[313 483  64 318  11],618,5,25026,4.10801050558109,80.0,20.0
46092,4,6092,[168 210 216 282 318],253,4,25030,4.107992778598391,20.0,0.0
46093,4,6093,[215 132 144 161  95],373,3,25033,4.107810961601575,0.0,0.0
46094,4,6094,[313 483  64 318  11],618,5,25038,4.107957342083675,80.0,20.0
46095,4,6095,[238  71 300 276 294],654,2,25040,4.107611548556431,0.0,0.0
46096,4,6096,[357  25 174  12 118],630,2,25042,4.107265868459899,20.0,0.0
46097,4,6097,[742   1   4 194 100],416,5,25047,4.1074122663168255,0.0,0.0
46098,4,6098,[172 423 222 181 588],705,2,25049,4.107066732251189,0.0,20.0
46099,4,6099,[313 483  64 318  11],214,5,25054,4.1072131147540984,80.0,20.0
46100,4,6100,[ 11 546 288 435 265],297,1,25055,4.106703819046058,0.0,20.0
46101,4,6101,[182 185  97  28 161],618,5,25060,4.106850213044903,0.0,0.0
46102,4,6102,[313 483  64 318  11],214,5,25065,4.1069965590693105,80.0,20.0
46103,4,6103,[313 483  64 318  11],618,5,25070,4.107142857142857,80.0,20.0
46104,4,6104,[181 151 117 276 185],214,3,25073,4.106961506961507,0.0,20.0
46105,4,6105,[313 483  64 318  11],618,5,25078,4.107107762856207,80.0,20.0
46106,4,6106,[313 483  64 318  11],618,5,25083,4.10725397085312,80.0,20.0
46107,4,6107,[313 483  64 318  11],618,5,25088,4.107400130975769,80.0,20.0
46108,4,6108,[ 71 204  69 168 471],588,4,25092,4.10738255033557,0.0,0.0
46109,4,6109,[748 742 508 143 181],297,3,25095,4.1072013093289685,0.0,20.0
46110,4,6110,[ 50 121 151 265  88],416,3,25098,4.107020127638684,0.0,20.0
46111,4,6111,[161 197 153 204 216],751,3,25101,4.106839005235602,0.0,0.0
46112,4,6112,[313 483  64 318  11],214,5,25106,4.106985113692131,80.0,20.0
46113,4,6113,[313 483  64 318  11],618,5,25111,4.107131174353942,80.0,20.0
46114,4,6114,[143 289 195 597 357],416,3,25114,4.1069501226492235,0.0,0.0
46115,4,6115,[313 483  64 318  11],214,5,25119,4.107096141268803,80.0,20.0
46116,4,6116,[313 483  64 318  11],214,5,25124,4.107242112146477,80.0,20.0
46117,4,6117,[257 144 258 546 471],416,3,25127,4.107061131088591,0.0,0.0
46118,4,6118,[294 111  25  11 151],345,3,25130,4.106880209184507,0.0,0.0
46119,4,6119,[313 483  64 318  11],618,5,25135,4.10702614379085,80.0,20.0
46120,4,6120,[313 483  64 318  11],214,5,25140,4.107172030713936,80.0,20.0
46121,4,6121,[313 483  64 318  11],618,5,25145,4.107317869977131,80.0,20.0
46122,4,6122,[ 12 237  97 144 385],588,1,25146,4.106810387065164,20.0,0.0
46123,4,6123,[313 483  64 318  11],214,5,25151,4.106956237753103,80.0,20.0
46124,4,6124,[313 483  64 318  11],618,5,25156,4.107102040816327,80.0,20.0
46125,4,6125,[655 121 172 216  50],751,4,25160,4.107084557623245,0.0,20.0
46126,4,6126,[313 483  64 318  11],618,5,25165,4.107230292149502,80.0,20.0
46127,4,6127,[313 483  64 318  11],618,5,25170,4.1073759791122715,80.0,20.0
46128,4,6128,[121  98 161   4 174],198,2,25172,4.107032142274433,0.0,20.0
46129,4,6129,[174  56 597 385 301],588,3,25175,4.1068515497553015,0.0,0.0
46130,4,6130,[313 483  64 318  11],618,5,25180,4.106997227206002,80.0,20.0
46131,4,6131,[313 483  64 318  11],618,5,25185,4.107142857142857,80.0,20.0
46132,4,6132,[ 69  11 257 423 100],854,4,25189,4.107125387249307,0.0,0.0
46133,4,6133,[ 56 238 196 257 385],654,5,25194,4.107270948809912,0.0,0.0
46134,4,6134,[ 71 275  96   9 215],416,5,25199,4.107416462917685,0.0,0.0
46135,4,6135,[ 98 211  69   4 268],416,5,25204,4.107561929595828,0.0,20.0
46136,4,6136,[168 132 268 471 742],128,2,25206,4.1072185106729675,0.0,0.0
46137,4,6137,[313 483  64 318  11],214,5,25211,4.107363962202672,80.0,20.0
46138,4,6138,[168 238 121   4 265],618,3,25214,4.1071835803876855,0.0,0.0
46139,4,6139,[313 483  64 318  11],618,5,25219,4.107328990228013,80.0,20.0
46140,4,6140,[ 70 125 181 403 175],721,3,25222,4.107148672854584,0.0,20.0
46141,4,6141,[313 483  64 318  11],214,5,25227,4.107294041028981,80.0,20.0
46142,4,6142,[313 483  64 318  11],214,5,25232,4.107439361875305,80.0,20.0
46143,4,6143,[125 294  28 742  11],345,2,25234,4.107096354166667,0.0,0.0
46144,4,6144,[215 423 269 100 202],43,5,25239,4.107241659886086,0.0,0.0
46145,4,6145,[183 427 181 200  25],618,4,25243,4.107224210868858,0.0,20.0
46146,4,6146,[313 483  64 318  11],214,5,25248,4.107369448511469,80.0,20.0
46147,4,6147,[313 483  64 318  11],214,5,25253,4.107514638906961,80.0,20.0
46148,4,6148,[313 483  64 318  11],214,5,25258,4.107659782078387,80.0,20.0
46149,4,6149,[288 265 172  69 127],922,2,25260,4.107317073170732,0.0,20.0
46150,4,6150,[313 483  64 318  11],214,5,25265,4.107462201268087,80.0,20.0
46151,4,6151,[313 483  64 318  11],214,5,25270,4.107607282184655,80.0,20.0
46152,4,6152,[313 483  64 318  11],214,5,25275,4.107752315943443,80.0,20.0
46153,4,6153,[135  25 173  22 143],373,3,25278,4.107572310692233,0.0,0.0
46154,4,6154,[117 276  11 265 200],437,2,25280,4.107229894394801,0.0,0.0
46155,4,6155,[301 196  71 117  79],437,2,25282,4.10688758934373,0.0,0.0
46156,4,6156,[313 483  64 318  11],618,5,25287,4.107032645769043,80.0,20.0
46157,4,6157,[211 258 210  98 238],297,5,25292,4.107177655082819,0.0,20.0
46158,4,6158,[588 127 216 423   4],805,0,25292,4.1065107972073385,0.0,0.0
46159,4,6159,[ 22 483 153  64 204],601,4,25296,4.106493506493506,40.0,0.0
46160,4,6160,[313 483  64 318  11],618,5,25301,4.1066385327057295,80.0,20.0
46161,4,6161,[313 483  64 318  11],618,5,25306,4.106783511846803,80.0,20.0
46162,4,6162,[313 483  64 318  11],214,5,25311,4.10692844393964,80.0,20.0
46163,4,6163,[313 483  64 318  11],618,5,25316,4.107073329007139,80.0,20.0
46164,4,6164,[313 483  64 318  11],618,5,25321,4.1072181670721815,80.0,20.0
46165,4,6165,[210  97 196 195 238],712,3,25324,4.107038598767434,0.0,0.0
46166,4,6166,[313 483  64 318  11],618,5,25329,4.107183395492136,80.0,20.0
46167,4,6167,[153 168 588 183 135],437,2,25331,4.106841763942931,0.0,0.0
46168,4,6168,[313 483  64 318  11],618,5,25336,4.106986545631383,80.0,20.0
46169,4,6169,[313 483  64 318  11],618,5,25341,4.107131280388979,80.0,20.0
46170,4,6170,[603 216   8 234 269],297,4,25345,4.107113919948144,0.0,0.0
46171,4,6171,[  8 286  98 216 237],342,4,25349,4.107096565132858,0.0,20.0
46172,4,6172,[173 322  64 423 357],721,5,25354,4.107241211728495,20.0,0.0
46173,4,6173,[197 202 185 215 216],405,4,25358,4.10722384191772,0.0,0.0
46174,4,6174,[313 483  64 318  11],618,5,25363,4.107368421052632,80.0,20.0
46175,4,6175,[423 515 748 176 294],297,2,25365,4.107027202072539,0.0,0.0
46176,4,6176,[ 96 405  25 168 403],805,4,25369,4.107009875344018,0.0,0.0
46177,4,6177,[313 483  64 318  11],214,5,25374,4.107154418905795,80.0,20.0
46178,4,6178,[265 204 302 515 423],405,3,25377,4.106975238711765,0.0,0.0
46179,4,6179,[588  95  28 195 181],297,3,25380,4.106796116504855,0.0,20.0
46180,4,6180,[313 483  64 318  11],618,5,25385,4.106940624494419,80.0,20.0
46181,4,6181,[313 483  64 318  11],214,5,25390,4.1070850857327725,80.0,20.0
46182,4,6182,[313 483  64 318  11],618,5,25395,4.1072295002426005,80.0,20.0
46183,4,6183,[125  12  96 300  82],416,5,25400,4.1073738680465715,20.0,0.0
46184,4,6184,[313 483  64 318  11],618,5,25405,4.10751818916734,80.0,20.0
46185,4,6185,[294 300 151  70 275],297,2,25407,4.10717749757517,0.0,0.0
46186,4,6186,[313 483  64 318  11],214,5,25412,4.107321803782124,80.0,20.0
46187,4,6187,[313 483  64 318  11],618,5,25417,4.107466063348416,80.0,20.0
46188,4,6188,[313 483  64 318  11],618,5,25422,4.107610276296655,80.0,20.0
46189,4,6189,[313 483  64 318  11],214,5,25427,4.107754442649434,80.0,20.0
46190,4,6190,[121 181 117 423 173],654,4,25431,4.107737037635277,0.0,20.0
46191,4,6191,[313 483  64 318  11],214,5,25436,4.107881136950905,80.0,20.0
46192,4,6192,[  4 176 121 357 202],416,5,25441,4.10802518973034,0.0,0.0
46193,4,6193,[118 357 174 427 508],601,4,25445,4.108007749434937,0.0,0.0
46194,4,6194,[275  70  69 276 328],62,3,25448,4.107828894269573,0.0,0.0
46195,4,6195,[181 135 168 216 268],214,1,25449,4.107327307940607,0.0,20.0
46196,4,6196,[151 302  11 100 257],854,3,25452,4.107148620300145,0.0,0.0
46197,4,6197,[ 56 273 268 357 237],297,5,25457,4.1072926750564696,0.0,0.0
46198,4,6198,[313 483  64 318  11],618,5,25462,4.107436683336022,80.0,20.0
46199,4,6199,[748  89  71 173 655],373,5,25467,4.10758064516129,0.0,0.0
46200,4,6200,[ 95 186   7  70 175],43,3,25470,4.1074020319303335,0.0,0.0
46201,4,6201,[313 483  64 318  11],618,5,25475,4.1075459529184135,80.0,20.0
46202,4,6202,[313 483  64 318  11],214,5,25480,4.1076898275028215,80.0,20.0
46203,4,6203,[200 275  98  56  70],416,5,25485,4.1078336557059965,0.0,20.0
46204,4,6204,[118 257 125 405 180],62,2,25487,4.107493956486704,0.0,0.0
46205,4,6205,[191 265 268  28 215],416,5,25492,4.107637769900097,0.0,0.0
46206,4,6206,[328 302   1 403  56],416,5,25497,4.107781536974384,0.0,0.0
46207,4,6207,[313 483  64 318  11],618,5,25502,4.107925257731959,80.0,20.0
46208,4,6208,[196 168 127 546 197],416,4,25506,4.107907875664358,0.0,0.0
46209,4,6209,[313 483  64 318  11],214,5,25511,4.10805152979066,80.0,20.0
46210,4,6210,[ 50 121 322 181 111],805,1,25512,4.1075511189824505,0.0,40.0
46211,4,6211,[273  28 568 151  79],805,2,25514,4.1072118480360595,0.0,0.0
46212,4,6212,[ 79  98 268 211 172],417,3,25517,4.107033639143731,0.0,20.0
46213,4,6213,[313 483  64 318  11],618,5,25522,4.107177341486965,80.0,20.0
46214,4,6214,[ 96 258 300   1 175],49,1,25523,4.106677393403057,0.0,0.0
46215,4,6215,[313 483  64 318  11],618,5,25528,4.106821106821107,80.0,20.0
46216,4,6216,[313 483  64 318  11],214,5,25533,4.106964774006756,80.0,20.0
46217,4,6217,[132 234 173 496 475],601,4,25537,4.10694757156642,0.0,0.0
46218,4,6218,[313 483  64 318  11],618,5,25542,4.107091172214182,80.0,20.0
46219,4,6219,[322  64 215 202  95],416,3,25545,4.106913183279743,20.0,0.0
46220,4,6220,[313 483  64 318  11],214,5,25550,4.107056743288861,80.0,20.0
46221,4,6221,[313 483  64 318  11],214,5,25555,4.107200257152041,80.0,20.0
46222,4,6222,[313 483  64 318  11],214,5,25560,4.107343724891531,80.0,20.0
46223,4,6223,[313 483  64 318  11],214,5,25565,4.107487146529563,80.0,20.0
46224,4,6224,[313 483  64 318  11],214,5,25570,4.107630522088353,80.0,20.0
46225,4,6225,[161 403 257 172 588],711,4,25574,4.107613234821716,0.0,0.0
46226,4,6226,[427 742 143 405 603],416,5,25579,4.107756544082223,0.0,0.0
46227,4,6227,[ 82   1 100 168  25],198,2,25581,4.107418111753372,0.0,0.0
46228,4,6228,[ 56 210   8 282 273],253,3,25584,4.107240327500401,0.0,0.0
46229,4,6229,[333 276   1 742 748],416,4,25588,4.107223113964687,0.0,0.0
46230,4,6230,[313 483  64 318  11],214,5,25593,4.107366393837265,80.0,20.0
46231,4,6231,[ 64 357 132  71 588],405,3,25596,4.107188703465982,20.0,0.0
46232,4,6232,[ 28 132 210 215 176],618,4,25600,4.107171506497673,0.0,0.0
46233,4,6233,[180 294 385  71 187],887,5,25605,4.107314725697786,0.0,0.0
46234,4,6234,[313 483  64 318  11],618,5,25610,4.107457898957498,80.0,20.0
46235,4,6235,[ 79 118 323 181 228],805,2,25612,4.107119948685055,0.0,20.0
46236,4,6236,[191 471 132 151  79],618,3,25615,4.106942440275773,0.0,0.0
46237,4,6237,[313 483  64 318  11],618,5,25620,4.107085604360372,80.0,20.0
46238,4,6238,[313 483  64 318  11],618,5,25625,4.107228722551691,80.0,20.0
46239,4,6239,[ 22 475 153 132 597],416,3,25628,4.107051282051282,0.0,0.0
46240,4,6240,[313 483  64 318  11],214,5,25633,4.107194359878225,80.0,20.0
46241,4,6241,[182 191 194 471 328],416,5,25638,4.1073373918615825,0.0,0.0
46242,4,6242,[313 483  64 318  11],618,5,25643,4.107480378023387,80.0,20.0
46243,4,6243,[313 483  64 318  11],214,5,25648,4.1076233183856505,80.0,20.0
46244,4,6244,[  9 385 276 168  64],416,4,25652,4.107606084867895,20.0,0.0
46245,4,6245,[313 483  64 318  11],618,5,25657,4.107748959333974,80.0,20.0
46246,4,6246,[  8 568 294 475 174],62,3,25660,4.107571634384504,0.0,0.0
46247,4,6247,[182 276 176 748 153],416,4,25664,4.1075544174135725,0.0,0.0
46248,4,6248,[678 286 245 471 117],416,3,25667,4.1073771803488555,0.0,0.0
46249,4,6249,[313 483  64 318  11],214,5,25672,4.10752,80.0,20.0
46250,4,6250,[313 483  64 318  11],618,5,25677,4.107662773956167,80.0,20.0
46251,4,6251,[204 181 127 202 111],805,0,25677,4.107005758157389,0.0,20.0
46252,4,6252,[313 483  64 318  11],618,5,25682,4.10714856868703,80.0,20.0
46253,4,6253,[121 151 568 153 403],416,4,25686,4.107131435881036,0.0,0.0
46254,4,6254,[197   1 288 471 204],345,2,25688,4.1067945643485215,0.0,20.0
46255,4,6255,[289  97 161 678 125],721,2,25690,4.106457800511509,0.0,0.0
46256,4,6256,[313 483  64 318  11],618,5,25695,4.106600607319802,80.0,20.0
46257,4,6257,[ 88 168 174 603 172],373,5,25700,4.106743368488335,0.0,0.0
46258,4,6258,[258 144 222 471   4],854,2,25702,4.106406774245087,0.0,0.0
46259,4,6259,[313 483  64 318  11],214,5,25707,4.106549520766773,80.0,20.0
46260,4,6260,[175 172 181 117 271],43,3,25710,4.106372783900335,0.0,20.0
46261,4,6261,[313 483  64 318  11],618,5,25715,4.106515490258703,80.0,20.0
46262,4,6262,[313 483  64 318  11],214,5,25720,4.106658151045825,80.0,20.0
46263,4,6263,[313 483  64 318  11],618,5,25725,4.106800766283525,80.0,20.0
46264,4,6264,[313 483  64 318  11],214,5,25730,4.106943335993615,80.0,20.0
46265,4,6265,[ 15   4 322 204   7],416,4,25734,4.1069262687519945,0.0,0.0
46266,4,6266,[322 546 269 302 294],416,3,25737,4.106749640976544,0.0,0.0
46267,4,6267,[313 483  64 318  11],214,5,25742,4.106892150606254,80.0,20.0
46268,4,6268,[313 483  64 318  11],214,5,25747,4.107034614771096,80.0,20.0
46269,4,6269,[313 483  64 318  11],618,5,25752,4.107177033492823,80.0,20.0
46270,4,6270,[313 483  64 318  11],214,5,25757,4.107319406793175,80.0,20.0
46271,4,6271,[216 222 174 276 405],198,2,25759,4.106983418367347,0.0,0.0
46272,4,6272,[174 210 546  70 508],297,4,25763,4.106966363781285,0.0,0.0
46273,4,6273,[  7 172 185  50  69],417,0,25763,4.10631176283073,0.0,20.0
46274,4,6274,[313 483  64 318  11],214,5,25768,4.106454183266933,80.0,20.0
46275,4,6275,[181 197  71 678  50],805,3,25771,4.10627788400255,0.0,40.0
46276,4,6276,[313 483  64 318  11],214,5,25776,4.106420264457544,80.0,20.0
46277,4,6277,[313 483  64 318  11],214,5,25781,4.106562599553998,80.0,20.0
46278,4,6278,[ 28 237  50 196  82],751,4,25785,4.106545628284759,0.0,20.0
46279,4,6279,[313 483  64 318  11],214,5,25790,4.106687898089172,80.0,20.0
46280,4,6280,[313 483  64 318  11],214,5,25795,4.106830122591944,80.0,20.0
46281,4,6281,[313 483  64 318  11],618,5,25800,4.106972301814709,80.0,20.0
46282,4,6282,[313 483  64 318  11],214,5,25805,4.107114435779087,80.0,20.0
46283,4,6283,[313 483  64 318  11],214,5,25810,4.107256524506684,80.0,20.0
46284,4,6284,[483 265 423 191 568],618,5,25815,4.107398568019093,20.0,0.0
46285,4,6285,[748 181  69  12 202],437,4,25819,4.107381482659879,20.0,20.0
46286,4,6286,[135 302 357 176 197],854,3,25822,4.107205344361381,0.0,0.0
46287,4,6287,[313 483  64 318  11],618,5,25827,4.107347328244275,80.0,20.0
46288,4,6288,[423 181 144  89 204],805,1,25828,4.106853235808555,0.0,20.0
46289,4,6289,[313 483  64 318  11],214,5,25833,4.106995230524642,80.0,20.0
46290,4,6290,[313 483  64 318  11],618,5,25838,4.107137180098554,80.0,20.0
46291,4,6291,[257 385 268 288 197],416,4,25842,4.107120152574698,0.0,20.0
46292,4,6292,[186 216  97  96 153],230,4,25846,4.107103130462418,0.0,0.0
46293,4,6293,[313 483  64 318  11],618,5,25851,4.107244995233556,80.0,20.0
46294,4,6294,[185 597 173  12 180],417,3,25854,4.107069102462272,20.0,0.0
46295,4,6295,[313 483  64 318  11],214,5,25859,4.107210927573062,80.0,20.0
46296,4,6296,[313 483  64 318  11],214,5,25864,4.107352707638558,80.0,20.0
46297,4,6297,[ 70 118 318 202 174],618,2,25866,4.1070181009844395,20.0,0.0
46298,4,6298,[268 211 187 603 197],416,5,25871,4.1071598666455,0.0,0.0
46299,4,6299,[313 483  64 318  11],618,5,25876,4.1073015873015875,80.0,20.0
46300,4,6300,[288 181  88 117 151],642,3,25879,4.1071258530392,0.0,40.0
46301,4,6301,[313 483  64 318  11],618,5,25884,4.107267534116153,80.0,20.0
46302,4,6302,[161 168 180 597  12],417,3,25887,4.107091861018563,20.0,0.0
46303,4,6303,[313 483  64 318  11],214,5,25892,4.107233502538071,80.0,20.0
46304,4,6304,[313 483  64 318  11],214,5,25897,4.107375099127676,80.0,20.0
46305,4,6305,[313 483  64 318  11],618,5,25902,4.107516650808754,80.0,20.0
46306,4,6306,[132 185 289  64 313],416,4,25906,4.107499603615031,40.0,20.0
46307,4,6307,[742   1  97 655  82],417,4,25910,4.107482561826252,0.0,0.0
46308,4,6308,[ 64 173 196   1 288],721,4,25914,4.1074655254398476,20.0,20.0
46309,4,6309,[313 483  64 318  11],214,5,25919,4.107606973058637,80.0,20.0
46310,4,6310,[257 195 144  56  82],417,3,25922,4.107431468863888,0.0,0.0
46311,4,6311,[ 97 200 186  82 210],198,3,25925,4.107256020278834,0.0,0.0
46312,4,6312,[313 483  64 318  11],214,5,25930,4.107397433866624,80.0,20.0
46313,4,6313,[313 483  64 318  11],214,5,25935,4.107538802660754,80.0,20.0
46314,4,6314,[313 483  64 318  11],618,5,25940,4.107680126682502,80.0,20.0
46315,4,6315,[286  56 568 678 161],588,4,25944,4.107663077897404,0.0,0.0
46316,4,6316,[313 483  64 318  11],618,5,25949,4.107804337501979,80.0,20.0
46317,4,6317,[117  56 475 318  88],588,4,25953,4.107787274453941,20.0,0.0
46318,4,6318,[313 483  64 318  11],214,5,25958,4.1079284696945715,80.0,20.0
46319,4,6319,[204 100   8  88 235],416,3,25961,4.107753164556962,0.0,0.0
46320,4,6320,[313 483  64 318  11],214,5,25966,4.107894320518906,80.0,20.0
46321,4,6321,[238 328 471   4   7],416,5,25971,4.108035431825372,0.0,0.0
46322,4,6322,[313 483  64 318  11],214,5,25976,4.108176498497548,80.0,20.0
46323,4,6323,[313 483  64 318  11],214,5,25981,4.10831752055661,80.0,20.0
46324,4,6324,[313 483  64 318  11],618,5,25986,4.108458498023715,80.0,20.0
46325,4,6325,[151 125  96 258 588],887,4,25990,4.108441353145747,0.0,0.0
46326,4,6326,[258  64 196 175 357],198,3,25993,4.10826616089774,20.0,0.0
46327,4,6327,[313 483  64 318  11],214,5,25998,4.1084070796460175,80.0,20.0
46328,4,6328,[ 11  70   9 117  71],630,2,26000,4.108073945331016,0.0,0.0
46329,4,6329,[173  96 111 282 427],907,5,26005,4.108214849921011,0.0,0.0
46330,4,6330,[496  82  71 135  97],373,2,26007,4.10788185120834,0.0,0.0
46331,4,6331,[313 483  64 318  11],214,5,26012,4.108022741629817,80.0,20.0
46332,4,6332,[313 483  64 318  11],618,5,26017,4.1081635875572395,80.0,20.0
46333,4,6333,[237 405 135 288 117],854,3,26020,4.1079886327754975,0.0,20.0
46334,4,6334,[ 25  15 132 222 194],854,2,26022,4.107655880031571,0.0,0.0
46335,4,6335,[313 483  64 318  11],618,5,26027,4.107796717171717,80.0,20.0
46336,4,6336,[257  98   8 258   1],62,3,26030,4.107621903108726,0.0,20.0
46337,4,6337,[313 483  64 318  11],214,5,26035,4.107762701167561,80.0,20.0
46338,4,6338,[313 483  64 318  11],618,5,26040,4.107903454803597,80.0,20.0
46339,4,6339,[ 64   8 100 172 176],62,5,26045,4.108044164037855,20.0,0.0
46340,4,6340,[313 483  64 318  11],214,5,26050,4.108184828891342,80.0,20.0
46341,4,6341,[313 483  64 318  11],214,5,26055,4.108325449385052,80.0,20.0
46342,4,6342,[313 483  64 318  11],214,5,26060,4.108466025539966,80.0,20.0
46343,4,6343,[313 483  64 318  11],214,5,26065,4.108606557377049,80.0,20.0
46344,4,6344,[ 50 202 313 216 496],416,5,26070,4.108747044917258,20.0,40.0
46345,4,6345,[313 483  64 318  11],214,5,26075,4.108887488181532,80.0,20.0
46346,4,6346,[181  70  89 100  98],198,3,26078,4.108712777690247,0.0,40.0
46347,4,6347,[313 483  64 318  11],618,5,26083,4.1088531821046,80.0,20.0
46348,4,6348,[ 28 183 195 313 181],405,4,26087,4.1088360371712085,20.0,40.0
46349,4,6349,[313 483  64 318  11],214,5,26092,4.1089763779527555,80.0,20.0
46350,4,6350,[313 483  64 318  11],618,5,26097,4.109116674539442,80.0,20.0
46351,4,6351,[245 222 195 286 515],297,3,26100,4.108942065491184,0.0,0.0
46352,4,6352,[187  82 496 288  64],618,4,26104,4.108924917361876,20.0,20.0
46353,4,6353,[196 496 202 175 168],43,4,26108,4.108907774630154,0.0,0.0
46354,4,6354,[748 435  12 173  22],297,3,26111,4.108733280881196,20.0,0.0
46355,4,6355,[313 483  64 318  11],214,5,26116,4.108873505349276,80.0,20.0
46356,4,6356,[268 265  50 323 215],416,4,26120,4.108856378795029,0.0,20.0
46357,4,6357,[313 483  64 318  11],618,5,26125,4.108996539792387,80.0,20.0
46358,4,6358,[228 276 186  70  79],230,4,26129,4.108979399276616,0.0,0.0
46359,4,6359,[328 194  98 235   8],416,4,26133,4.108962264150944,0.0,20.0
46360,4,6360,[748  97 210 238  50],198,3,26136,4.108787926426663,0.0,20.0
46361,4,6361,[313 483  64 318  11],214,5,26141,4.10892801005973,80.0,20.0
46362,4,6362,[ 71  12  95 234 100],588,4,26145,4.108910891089109,20.0,0.0
46363,4,6363,[483 300 118 181 588],751,3,26148,4.1087366436203645,20.0,20.0
46364,4,6364,[405  71   1 161 546],416,4,26152,4.108719560094266,0.0,0.0
46365,4,6365,[289  50 294 125 678],416,3,26155,4.108545397423814,0.0,20.0
46366,4,6366,[  7 257 127 125 597],630,2,26157,4.108214229621486,0.0,0.0
46367,4,6367,[423 168 385  64 228],198,2,26159,4.107883165829146,20.0,0.0
46368,4,6368,[ 15 127  95 282 276],618,1,26160,4.107395195478097,0.0,0.0
46369,4,6369,[ 11 235  98 318 403],345,3,26163,4.107221350078493,20.0,20.0
46370,4,6370,[313 483  64 318  11],214,5,26168,4.107361481714016,80.0,20.0
46371,4,6371,[313 483  64 318  11],618,5,26173,4.107501569365976,80.0,20.0
46372,4,6372,[597 174 313 143 100],618,5,26178,4.107641613055076,20.0,20.0
46373,4,6373,[313 483  64 318  11],618,5,26183,4.107781612802008,80.0,20.0
46374,4,6374,[179 185 275 286 180],437,4,26187,4.107764705882353,0.0,0.0
46375,4,6375,[187  96 318   8 100],96,5,26192,4.107904642409034,20.0,0.0
46376,4,6376,[508 180 144 125   7],854,3,26195,4.1077309079504465,0.0,0.0
46377,4,6377,[313 483  64 318  11],214,5,26200,4.107870805895265,80.0,20.0
46378,4,6378,[313 483  64 318  11],214,5,26205,4.108010659978053,80.0,20.0
46379,4,6379,[197 597 182 258 234],416,4,26209,4.107993730407523,0.0,0.0
46380,4,6380,[168 151 195  11 322],417,4,26213,4.107976806143237,0.0,0.0
46381,4,6381,[245 204 153 172 210],416,4,26217,4.107959887182702,0.0,0.0
46382,4,6382,[313 483  64 318  11],618,5,26222,4.108099639667868,80.0,20.0
46383,4,6383,[117  79 302  25 202],417,2,26224,4.1077694235588975,0.0,0.0
46384,4,6384,[  4 183 483 121 196],618,4,26228,4.107752545027408,20.0,0.0
46385,4,6385,[313 483  64 318  11],214,5,26233,4.107892264328218,80.0,20.0
46386,4,6386,[276 161  12 333  98],416,4,26237,4.107875371849069,20.0,20.0
46387,4,6387,[313 483  64 318  11],214,5,26242,4.108015028177833,80.0,20.0
46388,4,6388,[313 483  64 318  11],618,5,26247,4.108154640788856,80.0,20.0
46389,4,6389,[313 483  64 318  11],618,5,26252,4.1082942097026605,80.0,20.0
46390,4,6390,[313 483  64 318  11],214,5,26257,4.108433734939759,80.0,20.0
46391,4,6391,[313 483  64 318  11],214,5,26262,4.108573216520651,80.0,20.0
46392,4,6392,[313 483  64 318  11],214,5,26267,4.108712654465822,80.0,20.0
46393,4,6393,[151 196  71  98 405],62,4,26271,4.108695652173913,0.0,20.0
46394,4,6394,[313 483  64 318  11],618,5,26276,4.108835027365129,80.0,20.0
46395,4,6395,[175   1  50 603 125],854,3,26279,4.108661663539713,0.0,20.0
46396,4,6396,[313 483  64 318  11],618,5,26284,4.1088010004689695,80.0,20.0
46397,4,6397,[313 483  64 318  11],618,5,26289,4.108940293841825,80.0,20.0
46398,4,6398,[313 483  64 318  11],214,5,26294,4.1090795436787,80.0,20.0
46399,4,6399,[195 153 187 238  50],198,4,26298,4.1090625,0.0,20.0
46400,4,6400,[313 483  64 318  11],618,5,26303,4.10920168723637,80.0,20.0
46401,4,6401,[  8 748  71 268 197],416,5,26308,4.109340830990315,0.0,0.0
46402,4,6402,[313 483  64 318  11],618,5,26313,4.109479931282212,80.0,20.0
46403,4,6403,[194 235 328 333 475],416,3,26316,4.109306683322923,0.0,0.0
46404,4,6404,[  4 191   1 294 245],416,4,26320,4.109289617486339,0.0,0.0
46405,4,6405,[313 483  64 318  11],618,5,26325,4.109428660630659,80.0,20.0
46406,4,6406,[313 483  64 318  11],618,5,26330,4.109567660371469,80.0,20.0
46407,4,6407,[313 483  64 318  11],618,5,26335,4.109706616729088,80.0,20.0
46408,4,6408,[121  15 496 597 202],43,4,26339,4.109689499141832,0.0,0.0
46409,4,6409,[151 191 385 228 403],417,4,26343,4.109672386895475,0.0,0.0
46410,4,6410,[132 603 245 181 742],128,2,26345,4.109343316175323,0.0,20.0
46411,4,6411,[ 12  71 245  50 204],62,3,26348,4.109170305676856,20.0,20.0
46412,4,6412,[313 483  64 318  11],618,5,26353,4.109309215655699,80.0,20.0
46413,4,6413,[286   8  22  97 132],588,4,26357,4.1092921733707515,0.0,0.0
46414,4,6414,[313 483  64 318  11],214,5,26362,4.109431021044427,80.0,20.0
46415,4,6415,[313 483  64 318  11],214,5,26367,4.109569825436409,80.0,20.0
46416,4,6416,[423 117 603 118  82],128,5,26372,4.109708586566931,0.0,0.0
46417,4,6417,[313 483  64 318  11],214,5,26377,4.109847304456217,80.0,20.0
46418,4,6418,[269 318 288 182 568],416,5,26382,4.109985979124474,20.0,20.0
46419,4,6419,[313 483  64 318  11],618,5,26387,4.1101246105919005,80.0,20.0
46420,4,6420,[286  64 153 318 748],679,4,26391,4.110107459897212,40.0,0.0
46421,4,6421,[313 483  64 318  11],618,5,26396,4.11024602927437,80.0,20.0
46422,4,6422,[313 483  64 318  11],214,5,26401,4.110384555503659,80.0,20.0
46423,4,6423,[313 483  64 318  11],214,5,26406,4.110523038605231,80.0,20.0
46424,4,6424,[135 265 275 180 117],373,3,26409,4.110350194552529,0.0,0.0
46425,4,6425,[ 56   8 328 318 174],854,3,26412,4.110177404295051,20.0,0.0
46426,4,6426,[313 483  64 318  11],214,5,26417,4.110315854986775,80.0,20.0
46427,4,6427,[313 483  64 318  11],618,5,26422,4.11045426260112,80.0,20.0
46428,4,6428,[313 483  64 318  11],618,5,26427,4.11059262715819,80.0,20.0
46429,4,6429,[ 82  69 174  79 204],588,3,26430,4.110419906687403,0.0,0.0
46430,4,6430,[748 168 125  70  71],373,5,26435,4.110558233556212,0.0,0.0
46431,4,6431,[313 483  64 318  11],214,5,26440,4.1106965174129355,80.0,20.0
46432,4,6432,[186 597 121 210  70],618,3,26443,4.110523861339966,0.0,0.0
46433,4,6433,[121 204 385 234 258],642,3,26446,4.110351258936897,0.0,0.0
46434,4,6434,[235 210 273 300 294],297,2,26448,4.11002331002331,0.0,0.0
46435,4,6435,[179  70 603 294  79],416,4,26452,4.110006215040398,0.0,0.0
46436,4,6436,[313 483  64 318  11],214,5,26457,4.110144477240951,80.0,20.0
46437,4,6437,[313 483  64 318  11],214,5,26462,4.110282696489593,80.0,20.0
46438,4,6438,[475 288 173 118  25],805,3,26465,4.110110265569188,0.0,20.0
46439,4,6439,[200  82 357  97 323],416,4,26469,4.110093167701863,0.0,0.0
46440,4,6440,[313 483  64 318  11],214,5,26474,4.110231330538737,80.0,20.0
46441,4,6441,[257 471 182 273 173],416,4,26478,4.110214219186588,0.0,0.0
46442,4,6442,[313 483  64 318  11],618,5,26483,4.110352320347664,80.0,20.0
46443,4,6443,[313 483  64 318  11],618,5,26488,4.110490378646803,80.0,20.0
46444,4,6444,[313 483  64 318  11],618,5,26493,4.110628394103957,80.0,20.0
46445,4,6445,[313 483  64 318  11],214,5,26498,4.110766366739063,80.0,20.0
46446,4,6446,[313 483  64 318  11],214,5,26503,4.110904296572049,80.0,20.0
46447,4,6447,[187  25  82 143   4],373,2,26505,4.110576923076923,0.0,0.0
46448,4,6448,[210 357 300 423  28],297,3,26508,4.1104047139091335,0.0,0.0
46449,4,6449,[313 483  64 318  11],214,5,26513,4.1105426356589145,80.0,20.0
46450,4,6450,[302 197 268 288   1],297,2,26515,4.1102154704696945,0.0,20.0
46451,4,6451,[273 322  50 288  56],417,1,26516,4.1097334159950405,0.0,40.0
46452,4,6452,[ 69  56 423 117 496],437,3,26519,4.1095614442894774,0.0,0.0
46453,4,6453,[313 483  64 318  11],214,5,26524,4.109699411217849,80.0,20.0
46454,4,6454,[202  70 196 151  82],437,3,26527,4.109527498063517,0.0,0.0
46455,4,6455,[313 483  64 318  11],214,5,26532,4.109665427509293,80.0,20.0
46456,4,6456,[313 483  64 318  11],618,5,26537,4.109803314232615,80.0,20.0
46457,4,6457,[313 483  64 318  11],214,5,26542,4.10994115825333,80.0,20.0
46458,4,6458,[318   4 143 121 197],416,5,26547,4.110078959591268,20.0,0.0
46459,4,6459,[655 423  12 228  82],405,4,26551,4.110061919504644,20.0,0.0
46460,4,6460,[313 483  64 318  11],618,5,26556,4.110199659495434,80.0,20.0
46461,4,6461,[471 202 294 211 742],297,1,26557,4.109718353450944,0.0,0.0
46462,4,6462,[ 79 144 196 182  71],416,5,26562,4.109856103976481,0.0,0.0
46463,4,6463,[655 275 168 204  95],588,3,26565,4.109684405940594,0.0,0.0
46464,4,6464,[235 195 172  89 111],417,2,26567,4.109358081979892,0.0,0.0
46465,4,6465,[742   4 423 257 121],417,1,26568,4.108877203835447,0.0,0.0
46466,4,6466,[313 483  64 318  11],214,5,26573,4.109014999226844,80.0,20.0
46467,4,6467,[313 483  64 318  11],618,5,26578,4.109152752009895,80.0,20.0
46468,4,6468,[100 237 742  97 275],24,5,26583,4.109290462204359,0.0,0.0
46469,4,6469,[313 483  64 318  11],214,5,26588,4.109428129829984,80.0,20.0
46470,4,6470,[313 483  64 318  11],214,5,26593,4.109565754906506,80.0,20.0
46471,4,6471,[237 286 748 197  71],437,3,26596,4.1093943139678615,0.0,0.0
46472,4,6472,[313 483  64 318  11],618,5,26601,4.109531901745713,80.0,20.0
46473,4,6473,[313 483  64 318  11],618,5,26606,4.109669447018844,80.0,20.0
46474,4,6474,[265 179 742 276 151],416,2,26608,4.10934362934363,0.0,0.0
46475,4,6475,[313 483  64 318  11],214,5,26613,4.109481161210624,80.0,20.0
46476,4,6476,[174 183 275 237 588],297,5,26618,4.109618650609851,0.0,0.0
46477,4,6477,[435  82  98 161 216],405,2,26620,4.109292991664094,0.0,20.0
46478,4,6478,[313 483  64 318  11],618,5,26625,4.1094304676647635,80.0,20.0
46479,4,6479,[ 22 282 195 385 200],618,3,26628,4.109259259259259,0.0,0.0
46480,4,6480,[153 483 273 423 211],417,4,26632,4.109242400864064,20.0,0.0
46481,4,6481,[313 483  64 318  11],214,5,26637,4.109379821042888,80.0,20.0
46482,4,6482,[357 655 191 144 288],342,4,26641,4.1093629492518895,0.0,20.0
46483,4,6483,[313 483  64 318  11],214,5,26646,4.109500308451573,80.0,20.0
46484,4,6484,[313 483  64 318  11],618,5,26651,4.109637625289129,80.0,20.0
46485,4,6485,[194 475 235  50 313],416,3,26654,4.109466543324083,20.0,40.0
46486,4,6486,[313 483  64 318  11],214,5,26659,4.109603823030676,80.0,20.0
46487,4,6487,[ 15  28 245 143  88],642,5,26664,4.1097410604192355,0.0,0.0
46488,4,6488,[313 483  64 318  11],214,5,26669,4.109878255509323,80.0,20.0
46489,4,6489,[210 435 211 195 132],698,3,26672,4.109707241910631,0.0,0.0
46490,4,6490,[313 483  64 318  11],618,5,26677,4.1098443999383765,80.0,20.0
46491,4,6491,[313 483  64 318  11],618,5,26682,4.109981515711645,80.0,20.0
46492,4,6492,[313 483  64 318  11],214,5,26687,4.110118589249962,80.0,20.0
46493,4,6493,[597 186 655 195 403],618,4,26691,4.110101632275947,0.0,0.0
46494,4,6494,[742 748 313 117 300],654,5,26696,4.110238645111624,20.0,20.0
46495,4,6495,[ 95  22 508 588   9],314,4,26700,4.110221674876847,0.0,0.0
46496,4,6496,[313 483  64 318  11],214,5,26705,4.110358627058642,80.0,20.0
46497,4,6497,[313 483  64 318  11],214,5,26710,4.110495537088335,80.0,20.0
46498,4,6498,[ 88 222  98 423 496],128,4,26714,4.110478535159255,0.0,20.0
46499,4,6499,[313 483  64 318  11],214,5,26719,4.110615384615385,80.0,20.0
46500,4,6500,[216 322 111 300 742],223,3,26722,4.11044454699277,0.0,0.0
46501,4,6501,[313 483  64 318  11],214,5,26727,4.110581359581667,80.0,20.0
46502,4,6502,[313 483  64 318  11],214,5,26732,4.110718130093803,80.0,20.0
46503,4,6503,[172 235 168 258  25],805,3,26735,4.110547355473555,0.0,0.0
46504,4,6504,[313 483  64 318  11],214,5,26740,4.1106840891621825,80.0,20.0
46505,4,6505,[313 483  64 318  11],214,5,26745,4.110820780817707,80.0,20.0
46506,4,6506,[117 168 748 603 237],437,3,26748,4.110650069156293,0.0,0.0
46507,4,6507,[313 483  64 318  11],214,5,26753,4.110786724031961,80.0,20.0
46508,4,6508,[210  98 183  96 132],416,5,26758,4.1109233369181135,0.0,20.0
46509,4,6509,[ 79 275  69 300  70],654,5,26763,4.111059907834101,0.0,0.0
46510,4,6510,[ 95 161 216 168 153],43,5,26768,4.111196436799263,0.0,0.0
46511,4,6511,[313 483  64 318  11],618,5,26773,4.111332923832924,80.0,20.0
46512,4,6512,[204 191 483 258 427],601,4,26777,4.111315829878704,20.0,0.0
46513,4,6513,[313 483  64 318  11],214,5,26782,4.111452256677924,80.0,20.0
46514,4,6514,[273 144  97 174 302],417,1,26783,4.110974673829624,0.0,0.0
46515,4,6515,[313 483  64 318  11],214,5,26788,4.111111111111111,80.0,20.0
46516,4,6516,[180 269   7 183  12],805,4,26792,4.111094061684824,20.0,0.0
46517,4,6517,[313 483  64 318  11],618,5,26797,4.1112304387849035,80.0,20.0
46518,4,6518,[ 28 195  96 172 385],618,3,26800,4.111059978524313,0.0,0.0
46519,4,6519,[313 483  64 318  11],214,5,26805,4.111196319018405,80.0,20.0
46520,4,6520,[313 483  64 318  11],214,5,26810,4.1113326176966725,80.0,20.0
46521,4,6521,[313 483  64 318  11],214,5,26815,4.1114688745783505,80.0,20.0
46522,4,6522,[172   1 153 186 200],417,4,26819,4.111451785988042,0.0,0.0
46523,4,6523,[ 70  12 423 496 597],43,4,26823,4.111434702636419,20.0,0.0
46524,4,6524,[313 483  64 318  11],214,5,26828,4.111570881226053,80.0,20.0
46525,4,6525,[202  96 168 655 186],405,3,26831,4.111400551639595,0.0,0.0
46526,4,6526,[313 483  64 318  11],618,5,26836,4.111536693733721,80.0,20.0
46527,4,6527,[269 111 100 168 405],416,5,26841,4.111672794117647,0.0,0.0
46528,4,6528,[471 144 210   1  88],43,4,26845,4.111655689998468,0.0,0.0
46529,4,6529,[313 483  64 318  11],214,5,26850,4.111791730474732,80.0,20.0
46530,4,6530,[187 210 216   4  69],373,4,26854,4.11177461338233,0.0,0.0
46531,4,6531,[210 135 597 323 117],417,1,26855,4.111298224127373,0.0,0.0
46532,4,6532,[ 64 302 191 294 194],854,2,26857,4.110975049747436,20.0,0.0
46533,4,6533,[313 483  64 318  11],618,5,26862,4.111111111111111,80.0,20.0
46534,4,6534,[228 234 588 216 508],417,1,26863,4.1106350420811015,0.0,0.0
46535,4,6535,[313 483  64 318  11],618,5,26868,4.110771113831089,80.0,20.0
46536,4,6536,[181  15 655 294 300],128,4,26872,4.1107541685788584,0.0,20.0
46537,4,6537,[ 95 216  71 302 748],654,4,26876,4.1107372285102475,0.0,0.0
46538,4,6538,[313 483  64 318  11],618,5,26881,4.11087322220523,80.0,20.0
46539,4,6539,[546 748 655 286 257],417,3,26884,4.110703363914373,0.0,0.0
46540,4,6540,[313 483  64 318  11],618,5,26889,4.1108393212047085,80.0,20.0
46541,4,6541,[313 483  64 318  11],214,5,26894,4.110975236930602,80.0,20.0
46542,4,6542,[313 483  64 318  11],618,5,26899,4.111111111111111,80.0,20.0
46543,4,6543,[ 28 118 302  97 153],416,4,26903,4.11109413202934,0.0,0.0
46544,4,6544,[313 483  64 318  11],618,5,26908,4.111229946524064,80.0,20.0
46545,4,6545,[176   7 357 234  50],416,5,26913,4.1113657195233735,0.0,20.0
46546,4,6546,[127  64 265 186 215],373,4,26917,4.1113487093325185,20.0,0.0
46547,4,6547,[403  56 117 288 271],62,3,26920,4.111178985949908,0.0,20.0
46548,4,6548,[ 69 403 238 117 196],43,4,26924,4.111162009467094,0.0,0.0
46549,4,6549,[385 302 268 185 323],417,2,26926,4.110839694656488,0.0,0.0
46550,4,6550,[202 195 196  22 144],230,3,26929,4.110670126698214,0.0,0.0
46551,4,6551,[328 286 289 313 161],43,5,26934,4.11080586080586,20.0,20.0
46552,4,6552,[275 117 268 483 588],128,4,26938,4.11078895162521,20.0,0.0
46553,4,6553,[597 168 143 182 215],618,5,26943,4.110924626182484,0.0,0.0
46554,4,6554,[427 322 603  95 289],416,2,26945,4.110602593440122,0.0,0.0
46555,4,6555,[151 275 222 588 546],297,3,26948,4.110433190970103,0.0,0.0
46556,4,6556,[ 50 748 546 127   7],416,4,26952,4.110416348940064,0.0,20.0
46557,4,6557,[313 483  64 318  11],214,5,26957,4.110551997560232,80.0,20.0
46558,4,6558,[151 121 742 228 210],417,1,26958,4.110077755755451,0.0,0.0
46559,4,6559,[546   1  71 742 294],223,4,26962,4.110060975609756,0.0,0.0
46560,4,6560,[ 56  28 289 125 204],588,3,26965,4.109891784788904,0.0,0.0
46561,4,6561,[183 475  69 234 191],437,2,26967,4.109570252971655,0.0,0.0
46562,4,6562,[313 483  64 318  11],618,5,26972,4.109705927167454,80.0,20.0
46563,4,6563,[385 568 111 678 100],416,4,26976,4.109689213893967,0.0,0.0
46564,4,6564,[313 483  64 318  11],214,5,26981,4.10982482863671,80.0,20.0
46565,4,6565,[385  22 151   1 168],588,4,26985,4.109808102345416,0.0,0.0
46566,4,6566,[423 269 216 174 132],854,3,26988,4.109639104613979,0.0,0.0
46567,4,6567,[333 475 234  50 195],416,4,26992,4.109622411693057,0.0,20.0
46568,4,6568,[471 318 125 237  50],854,2,26994,4.109301263510428,20.0,20.0
46569,4,6569,[161 238 234 172 195],198,2,26996,4.1089802130898025,0.0,0.0
46570,4,6570,[313 483  64 318  11],214,5,27001,4.109115811900776,80.0,20.0
46571,4,6571,[313 483  64 318  11],618,5,27006,4.1092513694461354,80.0,20.0
46572,4,6572,[196 322  88 427 588],416,3,27009,4.109082610680055,0.0,0.0
46573,4,6573,[313 483  64 318  11],214,5,27014,4.1092181320352905,80.0,20.0
46574,4,6574,[357   9 405 135  82],601,3,27017,4.109049429657794,0.0,0.0
46575,4,6575,[313 483  64 318  11],214,5,27022,4.109184914841849,80.0,20.0
46576,4,6576,[121 118 597 187   4],416,3,27025,4.109016268815569,0.0,0.0
46577,4,6577,[153 179 546 385 211],416,3,27028,4.108847674065065,0.0,0.0
46578,4,6578,[313 483  64 318  11],618,5,27033,4.108983128134975,80.0,20.0
46579,4,6579,[181 172 423 195  28],62,3,27036,4.108814589665654,0.0,20.0
46580,4,6580,[313 483  64 318  11],618,5,27041,4.108950007597629,80.0,20.0
46581,4,6581,[ 95 302  97 215 195],405,3,27044,4.108781525372227,0.0,0.0
46582,4,6582,[237 282 471 151 187],416,3,27047,4.10861309433389,0.0,0.0
46583,4,6583,[215 655  95 257   8],705,2,27049,4.108292831105711,0.0,0.0
46584,4,6584,[313 483  64 318  11],618,5,27054,4.108428246013667,80.0,20.0
46585,4,6585,[168 318  88 100 483],354,3,27057,4.108259945338597,40.0,0.0
46586,4,6586,[  7 216 222 273 597],854,3,27060,4.108091695764385,0.0,0.0
46587,4,6587,[313 483  64 318  11],214,5,27065,4.108227079538555,80.0,20.0
46588,4,6588,[238 301 181 289 271],43,3,27068,4.1080588860221585,0.0,20.0
46589,4,6589,[186 183 117  64 118],417,5,27073,4.1081942336874055,20.0,0.0
46590,4,6590,[423   8   1 271 194],297,1,27074,4.107722652101351,0.0,0.0
46591,4,6591,[588   8  56 333 204],588,5,27079,4.107858009708738,0.0,0.0
46592,4,6592,[313 483  64 318  11],618,5,27084,4.107993326255119,80.0,20.0
46593,4,6593,[313 483  64 318  11],214,5,27089,4.108128601759175,80.0,20.0
46594,4,6594,[313 483  64 318  11],618,5,27094,4.108263836239575,80.0,20.0
46595,4,6595,[313 483  64 318  11],618,5,27099,4.108399029714978,80.0,20.0
46596,4,6596,[313 333  88  15 118],907,5,27104,4.108534182204032,20.0,20.0
46597,4,6597,[313 483  64 318  11],618,5,27109,4.108669293725371,80.0,20.0
46598,4,6598,[655  22  96 191 185],405,4,27113,4.108652826185786,0.0,0.0
46599,4,6599,[151 268 313 100 144],654,3,27116,4.108484848484848,20.0,20.0
46600,4,6600,[313 483  64 318  11],618,5,27121,4.108619906074837,80.0,20.0
46601,4,6601,[121 153 216 258 173],805,2,27123,4.108300514995456,0.0,0.0
46602,4,6602,[313 483  64 318  11],618,5,27128,4.108435559594124,80.0,20.0
46603,4,6603,[313 483  64 318  11],618,5,27133,4.108570563294973,80.0,20.0
46604,4,6604,[313 483  64 318  11],214,5,27138,4.108705526116578,80.0,20.0
46605,4,6605,[313 483  64 318  11],214,5,27143,4.108840448077506,80.0,20.0
46606,4,6606,[ 97 257 423 174 151],654,4,27147,4.108823974572423,0.0,0.0
46607,4,6607,[174 603  69 238 288],297,3,27150,4.108656174334141,0.0,20.0
46608,4,6608,[313 483  64 318  11],618,5,27155,4.108791042517779,80.0,20.0
46609,4,6609,[313  88 288 655 185],405,4,27159,4.108774583963691,20.0,40.0
46610,4,6610,[202 588 179  12 174],405,3,27162,4.108606867342308,20.0,0.0
46611,4,6611,[313 483  64 318  11],618,5,27167,4.108741681790684,80.0,20.0
46612,4,6612,[313 483  64 318  11],618,5,27172,4.108876455466505,80.0,20.0
46613,4,6613,[313 483  64 318  11],214,5,27177,4.109011188388267,80.0,20.0
46614,4,6614,[288 423 168 186  28],642,3,27180,4.108843537414966,0.0,20.0
46615,4,6615,[313 483  64 318  11],214,5,27185,4.108978234582829,80.0,20.0
46616,4,6616,[313 483  64 318  11],214,5,27190,4.109112891038235,80.0,20.0
46617,4,6617,[313 483  64 318  11],618,5,27195,4.109247506799638,80.0,20.0
46618,4,6618,[313 483  64 318  11],618,5,27200,4.109382081885482,80.0,20.0
46619,4,6619,[313 483  64 318  11],214,5,27205,4.109516616314199,80.0,20.0
46620,4,6620,[211 118 238 271  12],297,3,27208,4.109349040930373,20.0,0.0
46621,4,6621,[588  79 197 328 568],416,5,27213,4.109483539716098,0.0,0.0
46622,4,6622,[202  82 200 546 357],417,4,27217,4.10946700890835,0.0,0.0
46623,4,6623,[403 202 173  88  69],618,3,27220,4.109299516908212,0.0,0.0
46624,4,6624,[313 483  64 318  11],618,5,27225,4.109433962264151,80.0,20.0
46625,4,6625,[313 483  64 318  11],618,5,27230,4.109568367038937,80.0,20.0
46626,4,6626,[313 483  64 318  11],618,5,27235,4.109702731250943,80.0,20.0
46627,4,6627,[313 483  64 318  11],618,5,27240,4.109837054918527,80.0,20.0
46628,4,6628,[313 483  64 318  11],618,5,27245,4.109971338060039,80.0,20.0
46629,4,6629,[313 483  64 318  11],214,5,27250,4.110105580693816,80.0,20.0
46630,4,6630,[678 286  71 111 151],345,2,27252,4.10978736238878,0.0,0.0
46631,4,6631,[132 215 204 172  79],373,4,27256,4.109770808202653,0.0,0.0
46632,4,6632,[313 483  64 318  11],214,5,27261,4.109905020352781,80.0,20.0
46633,4,6633,[313 483  64 318  11],214,5,27266,4.110039192041001,80.0,20.0
46634,4,6634,[313 483  64 318  11],214,5,27271,4.110173323285607,80.0,20.0
46635,4,6635,[143 403  82  97 216],618,4,27275,4.110156720916215,0.0,0.0
46636,4,6636,[313 483  64 318  11],214,5,27280,4.110290794033449,80.0,20.0
46637,4,6637,[313 483  64 318  11],214,5,27285,4.110424826755047,80.0,20.0
46638,4,6638,[313 483  64 318  11],618,5,27290,4.110558819099262,80.0,20.0
46639,4,6639,[168 200 222 742 121],805,3,27293,4.1103915662650605,0.0,0.0
46640,4,6640,[ 56   1 216 258 151],854,3,27296,4.110224363800633,0.0,0.0
46641,4,6641,[313 483  64 318  11],214,5,27301,4.11035832580548,80.0,20.0
46642,4,6642,[313 483  64 318  11],618,5,27306,4.110492247478549,80.0,20.0
46643,4,6643,[313 483  64 318  11],618,5,27311,4.1106261288380495,80.0,20.0
46644,4,6644,[173 181 195 288 655],405,5,27316,4.110759969902182,0.0,40.0
46645,4,6645,[127 475 546  56 191],805,3,27319,4.110592837797172,0.0,0.0
46646,4,6646,[175 288  28  79 172],805,3,27322,4.110425755980142,0.0,20.0
46647,4,6647,[ 56  71 202 182 195],405,3,27325,4.1102587244284,0.0,0.0
46648,4,6648,[313 483  64 318  11],618,5,27330,4.110392540231614,80.0,20.0
46649,4,6649,[174   1 186  11 265],230,5,27335,4.110526315789474,0.0,0.0
46650,4,6650,[ 69  96 173 357 118],601,2,27337,4.110208991129154,0.0,0.0
46651,4,6651,[ 88 423 117  25  12],43,5,27342,4.110342754058929,20.0,0.0
46652,4,6652,[ 28 111 121  95 202],618,2,27344,4.110025552382384,0.0,0.0
46653,4,6653,[ 25 202 268   4 175],297,3,27347,4.1098587315900215,0.0,0.0
46654,4,6654,[313 483  64 318  11],214,5,27352,4.109992486851991,80.0,20.0
46655,4,6655,[191 132  82 385 265],417,4,27356,4.109975961538462,0.0,0.0
46656,4,6656,[ 79 568  50 200 294],345,4,27360,4.109959441189725,0.0,20.0
46657,4,6657,[181 385 423  69 174],705,3,27363,4.109792730549715,0.0,20.0
46658,4,6658,[313 483  64 318  11],214,5,27368,4.109926415377684,80.0,20.0
46659,4,6659,[483 323 603 300 174],751,3,27371,4.1097597597597595,20.0,0.0
46660,4,6660,[200 127 153 568 257],922,2,27373,4.1094430265725865,0.0,0.0
46661,4,6661,[313 483  64 318  11],618,5,27378,4.109576703692585,80.0,20.0
46662,4,6662,[ 69 135 127 195  50],601,3,27381,4.109410175596578,0.0,20.0
46663,4,6663,[313 483  64 318  11],618,5,27386,4.109543817527011,80.0,20.0
46664,4,6664,[182 222 204 183 111],297,2,27388,4.109227306826707,0.0,0.0
46665,4,6665,[100 117  12 238  15],62,4,27392,4.109210921092109,20.0,0.0
46666,4,6666,[313 483  64 318  11],618,5,27397,4.1093445327733615,80.0,20.0
46667,4,6667,[313 483  64 318  11],618,5,27402,4.109478104379124,80.0,20.0
46668,4,6668,[265 323 318 427  88],416,3,27405,4.109311740890688,20.0,0.0
46669,4,6669,[ 56 176 153 328 174],62,4,27409,4.109295352323838,0.0,0.0
46670,4,6670,[318 294  79 427 276],416,4,27413,4.109278968670364,20.0,0.0
46671,4,6671,[275  79 323 301 597],43,3,27416,4.109112709832134,0.0,0.0
46672,4,6672,[313 483  64 318  11],618,5,27421,4.10924621609471,80.0,20.0
46673,4,6673,[313 483  64 318  11],214,5,27426,4.109379682349416,80.0,20.0
46674,4,6674,[215 135 603  79  64],373,4,27430,4.10936329588015,20.0,0.0
46675,4,6675,[202 176 161 204 183],618,3,27433,4.109197124026363,0.0,0.0
46676,4,6676,[313 483  64 318  11],618,5,27438,4.109330537666617,80.0,20.0
46677,4,6677,[313 483  64 318  11],214,5,27443,4.109463911350704,80.0,20.0
46678,4,6678,[  8 151 204 568  28],62,2,27445,4.109148076059291,0.0,0.0
46679,4,6679,[273  11 195 204 258],805,0,27445,4.108532934131737,0.0,0.0
46680,4,6680,[ 50 273 202   9 597],618,3,27448,4.108367010926508,0.0,20.0
46681,4,6681,[313 483  64 318  11],618,5,27453,4.108500448967375,80.0,20.0
46682,4,6682,[588  79 151 471 182],618,3,27456,4.108334580278318,0.0,0.0
46683,4,6683,[313 483  64 318  11],214,5,27461,4.108467983243567,80.0,20.0
46684,4,6684,[313 483  64 318  11],214,5,27466,4.108601346297681,80.0,20.0
46685,4,6685,[313 483  64 318  11],214,5,27471,4.1087346694585705,80.0,20.0
46686,4,6686,[ 79 215 603 318 234],405,4,27475,4.108718408852998,20.0,0.0
46687,4,6687,[313 483  64 318  11],214,5,27480,4.108851674641149,80.0,20.0
46688,4,6688,[313 483  64 318  11],214,5,27485,4.108984900583047,80.0,20.0
46689,4,6689,[313 483  64 318  11],214,5,27490,4.109118086696562,80.0,20.0
46690,4,6690,[333 210 515   8 173],416,5,27495,4.109251232999552,0.0,0.0
46691,4,6691,[235 286 423 181 313],416,4,27499,4.109234907352062,20.0,40.0
46692,4,6692,[313 483  64 318  11],618,5,27504,4.109367996414164,80.0,20.0
46693,4,6693,[313 483  64 318  11],214,5,27509,4.1095010457125785,80.0,20.0
46694,4,6694,[588 496 127  89 427],253,5,27514,4.109634055265123,0.0,0.0
46695,4,6695,[100 197 275   1  25],297,3,27517,4.109468339307049,0.0,0.0
46696,4,6696,[313 483  64 318  11],214,5,27522,4.109601314021203,80.0,20.0
46697,4,6697,[238 215 186  64  28],373,4,27526,4.109584950731562,20.0,0.0
46698,4,6698,[313 483  64 318  11],214,5,27531,4.109717868338558,80.0,20.0
46699,4,6699,[313 483  64 318  11],214,5,27536,4.109850746268656,80.0,20.0
46700,4,6700,[313 483  64 318  11],618,5,27541,4.109983584539621,80.0,20.0
46701,4,6701,[313 483  64 318  11],214,5,27546,4.110116383169204,80.0,20.0
46702,4,6702,[546 215 357 182 423],416,4,27550,4.11009995524392,0.0,0.0
46703,4,6703,[313 483  64 318  11],618,5,27555,4.110232696897374,80.0,20.0
46704,4,6704,[  1  70 237 748 323],751,1,27556,4.109768829231917,0.0,0.0
46705,4,6705,[588 275  22  12  71],654,4,27560,4.10975246048315,20.0,0.0
46706,4,6706,[313 483  64 318  11],618,5,27565,4.1098851945728345,80.0,20.0
46707,4,6707,[313 483  64 318  11],618,5,27570,4.110017889087657,80.0,20.0
46708,4,6708,[  4 603 210 515  96],405,2,27572,4.109703383514682,0.0,0.0
46709,4,6709,[742 174 603 265 187],416,5,27577,4.109836065573771,0.0,0.0
46710,4,6710,[318 127 216 238 282],618,2,27579,4.10952168082253,20.0,0.0
46711,4,6711,[313 483  64 318  11],214,5,27584,4.109654350417164,80.0,20.0
46712,4,6712,[313 483  64 318  11],618,5,27589,4.109786980485625,80.0,20.0
46713,4,6713,[483 204 179 273 216],62,4,27593,4.109770628537385,20.0,0.0
46714,4,6714,[385  95 168 204 202],416,4,27597,4.109754281459419,0.0,0.0
46715,4,6715,[275 117 151  70  71],373,5,27602,4.1098868374032165,0.0,0.0
46716,4,6716,[271 132 127   1 125],854,3,27605,4.109721601905613,0.0,0.0
46717,4,6717,[173 174  69 181 180],214,3,27608,4.109556415599881,0.0,20.0
46718,4,6718,[118  71 174  98 182],437,2,27610,4.109242446792678,0.0,20.0
46719,4,6719,[313 483  64 318  11],618,5,27615,4.109375,80.0,20.0
46720,4,6720,[313 168 655 200  12],416,5,27620,4.109507513762833,40.0,20.0
46721,4,6721,[313 483  64 318  11],214,5,27625,4.10963998809878,80.0,20.0
46722,4,6722,[313 483  64 318  11],618,5,27630,4.109772423025435,80.0,20.0
46723,4,6723,[313 483  64 318  11],214,5,27635,4.109904818560381,80.0,20.0
46724,4,6724,[313 483  64 318  11],618,5,27640,4.11003717472119,80.0,20.0
46725,4,6725,[313 483  64 318  11],214,5,27645,4.110169491525424,80.0,20.0
46726,4,6726,[313 483  64 318  11],214,5,27650,4.1103017689906345,80.0,20.0
46727,4,6727,[313 483  64 318  11],214,5,27655,4.110434007134364,80.0,20.0
46728,4,6728,[100 202 471  50  88],43,4,27659,4.110417595482241,0.0,20.0
46729,4,6729,[ 82 172 185 265 216],711,3,27662,4.110252600297176,0.0,0.0
46730,4,6730,[313 483  64 318  11],618,5,27667,4.11038478680731,80.0,20.0
46731,4,6731,[313 483  64 318  11],618,5,27672,4.110516934046346,80.0,20.0
46732,4,6732,[313 483  64 318  11],618,5,27677,4.110649042031784,80.0,20.0
46733,4,6733,[200 294 333 215  96],416,5,27682,4.110781110781111,0.0,0.0
46734,4,6734,[143 322 174 235 117],416,3,27685,4.1106161841128435,0.0,0.0
46735,4,6735,[216 603 238 333 258],416,5,27690,4.110748218527316,0.0,0.0
46736,4,6736,[153 302 191 196 286],721,3,27693,4.110583345702835,0.0,0.0
46737,4,6737,[ 96 174   8 471 186],854,1,27694,4.1101216978331845,0.0,0.0
46738,4,6738,[313 483  64 318  11],618,5,27699,4.1102537468467135,80.0,20.0
46739,4,6739,[313 483  64 318  11],214,5,27704,4.110385756676558,80.0,20.0
46740,4,6740,[245  28 143 173   4],416,4,27708,4.110369381397419,0.0,0.0
46741,4,6741,[174 168  97  28 357],230,5,27713,4.1105013349154556,0.0,0.0
46742,4,6742,[313 483  64 318  11],214,5,27718,4.1106332492955655,80.0,20.0
46743,4,6743,[ 64  97 238  15 742],62,2,27720,4.110320284697509,20.0,0.0
46744,4,6744,[235 132   8 194   7],854,3,27723,4.110155670867309,0.0,0.0
46745,4,6745,[  9 234 195   8 191],618,2,27725,4.1098428698488,0.0,0.0
46746,4,6746,[313 483  64 318  11],618,5,27730,4.1099748036164225,80.0,20.0
46747,4,6747,[313 483  64 318  11],214,5,27735,4.110106698280972,80.0,20.0
46748,4,6748,[313 483  64 318  11],214,5,27740,4.110238553859831,80.0,20.0
46749,4,6749,[204  56  64  22 568],618,4,27744,4.110222222222222,20.0,0.0
46750,4,6750,[228 173 276 179   4],198,2,27746,4.1099096430158495,0.0,0.0
46751,4,6751,[301  88   1 144   7],588,3,27749,4.109745260663507,0.0,0.0
46752,4,6752,[289 588 186  69 403],588,2,27751,4.109432844661632,0.0,0.0
46753,4,6753,[300   9 405 508 322],708,3,27754,4.1092685815812855,0.0,0.0
46754,4,6754,[ 11 127 546   1 496],43,5,27759,4.10940044411547,0.0,0.0
46755,4,6755,[515 496 357 183   9],698,2,27761,4.1090882178804025,0.0,0.0
46756,4,6756,[ 82 210  71 302 204],405,4,27765,4.109072073405358,0.0,0.0
46757,4,6757,[301  50 143 403 202],49,0,27765,4.108464042616158,0.0,20.0
46758,4,6758,[328 196 742 237 597],314,4,27769,4.108447995265572,0.0,0.0
46759,4,6759,[302 111 405 216 238],751,2,27771,4.108136094674556,0.0,0.0
46760,4,6760,[210  64   1 748  28],345,2,27773,4.1078242863481735,20.0,0.0
46761,4,6761,[313 483  64 318  11],618,5,27778,4.107956225968648,80.0,20.0
46762,4,6762,[568  25 202 269 196],711,4,27782,4.107940263196806,0.0,0.0
46763,4,6763,[313 483  64 318  11],214,5,27787,4.108072146658782,80.0,20.0
46764,4,6764,[313 483  64 318  11],618,5,27792,4.108203991130821,80.0,20.0
46765,4,6765,[313 483  64 318  11],214,5,27797,4.10833579663021,80.0,20.0
46766,4,6766,[237  70  28   4  69],416,4,27801,4.108319787202601,0.0,0.0
46767,4,6767,[313 483  64 318  11],214,5,27806,4.108451536643026,80.0,20.0
46768,4,6768,[313 483  64 318  11],214,5,27811,4.108583247156153,80.0,20.0
46769,4,6769,[125  22 195   1 153],416,5,27816,4.108714918759232,0.0,0.0
46770,4,6770,[313 483  64 318  11],214,5,27821,4.108846551469503,80.0,20.0
46771,4,6771,[ 12  25 273 258 289],416,4,27825,4.1088304784406375,20.0,0.0
46772,4,6772,[313 483  64 318  11],618,5,27830,4.108962055219253,80.0,20.0
46773,4,6773,[ 70  98 196 197 655],437,4,27834,4.108945969884854,0.0,20.0
46774,4,6774,[313 483  64 318  11],618,5,27839,4.109077490774908,80.0,20.0
46775,4,6775,[313 483  64 318  11],214,5,27844,4.1092089728453365,80.0,20.0
46776,4,6776,[181   1 153 197  22],805,3,27847,4.10904530028036,0.0,20.0
46777,4,6777,[ 98 234 655 748 269],345,4,27851,4.109029212156979,0.0,20.0
46778,4,6778,[173 313  25 195 546],416,4,27855,4.109013128780056,20.0,20.0
46779,4,6779,[313 483  64 318  11],214,5,27860,4.109144542772861,80.0,20.0
46780,4,6780,[313 483  64 318  11],618,5,27865,4.109275918006194,80.0,20.0
46781,4,6781,[313 483  64 318  11],214,5,27870,4.1094072544971985,80.0,20.0
46782,4,6782,[238 168 216  98 603],416,5,27875,4.10953855226301,0.0,20.0
46783,4,6783,[ 50  70 588 288 318],618,3,27878,4.109375,20.0,40.0
46784,4,6784,[269 288 168 302  70],416,5,27883,4.109506263817244,0.0,20.0
46785,4,6785,[ 22 603 185 161 597],416,4,27887,4.109490126731506,0.0,0.0
46786,4,6786,[313 483  64 318  11],214,5,27892,4.109621334904966,80.0,20.0
46787,4,6787,[313 483  64 318  11],618,5,27897,4.109752504419564,80.0,20.0
46788,4,6788,[182 235 496 245   1],417,3,27900,4.109589041095891,0.0,0.0
46789,4,6789,[313 483  64 318  11],618,5,27905,4.109720176730486,80.0,20.0
46790,4,6790,[273 269 176 202 143],805,2,27907,4.109409512590193,0.0,0.0
46791,4,6791,[313 483  64 318  11],618,5,27912,4.109540636042403,80.0,20.0
46792,4,6792,[265 180  56 403 196],198,2,27914,4.109230089798322,0.0,0.0
46793,4,6793,[ 82 385 161 191  88],43,5,27919,4.109361201059759,0.0,0.0
46794,4,6794,[187 125 211   7 302],416,5,27924,4.109492273730685,0.0,0.0
46795,4,6795,[135 275 237 125 121],618,3,27927,4.109329017068864,0.0,0.0
46796,4,6796,[197 403 405 271 597],805,2,27929,4.109018684713845,0.0,0.0
46797,4,6797,[301 117 161 176 235],416,4,27933,4.109002647837599,0.0,0.0
46798,4,6798,[153 742  56 200 333],854,3,27936,4.108839535225768,0.0,0.0
46799,4,6799,[313 483  64 318  11],214,5,27941,4.1089705882352945,80.0,20.0
46800,4,6800,[313 483  64 318  11],214,5,27946,4.1091016027054845,80.0,20.0
46801,4,6801,[ 64 132   1 151  12],416,4,27950,4.109085563069685,40.0,0.0
46802,4,6802,[ 71 496 385  98 678],588,1,27951,4.108628546229604,0.0,20.0
46803,4,6803,[111 117 678 235 301],297,2,27953,4.1083186360964135,0.0,0.0
46804,4,6804,[301 143 471 176 210],297,4,27957,4.108302718589273,0.0,0.0
46805,4,6805,[313 269 496 144 742],416,5,27962,4.108433734939759,20.0,20.0
46806,4,6806,[200  98 197 496 151],618,3,27965,4.108270897605406,0.0,20.0
46807,4,6807,[313 483  64 318  11],214,5,27970,4.1084018801410105,80.0,20.0
46808,4,6808,[100 176 185 475 385],198,2,27972,4.1080922308709065,0.0,0.0
46809,4,6809,[204 597  88 216 318],416,3,27975,4.107929515418502,20.0,0.0
46810,4,6810,[161  15  79 496 603],416,5,27980,4.108060490383203,0.0,0.0
46811,4,6811,[313 483  64 318  11],214,5,27985,4.108191426893717,80.0,20.0
46812,4,6812,[302 603 211  12 471],297,4,27989,4.108175546748862,20.0,0.0
46813,4,6813,[313 483  64 318  11],618,5,27994,4.1083064279424715,80.0,20.0
46814,4,6814,[ 97 176 202 471 100],618,3,27997,4.108143800440206,0.0,0.0
46815,4,6815,[313 483  64 318  11],618,5,28002,4.108274647887324,80.0,20.0
46816,4,6816,[313 483  64 318  11],214,5,28007,4.108405456945871,80.0,20.0
46817,4,6817,[313 483  64 318  11],214,5,28012,4.108536227632737,80.0,20.0
46818,4,6818,[211  11 210 301 111],416,5,28017,4.108666959964804,0.0,0.0
46819,4,6819,[ 56   8 143   7 265],297,4,28021,4.108651026392962,0.0,0.0
46820,4,6820,[ 79 185 238 237  64],618,4,28025,4.108635097493036,20.0,0.0
46821,4,6821,[173 333  28 194 289],416,4,28029,4.108619173262973,0.0,0.0
46822,4,6822,[174 333 275 385 588],416,5,28034,4.108749816796131,0.0,0.0
46823,4,6823,[313 483  64 318  11],618,5,28039,4.108880422039859,80.0,20.0
46824,4,6824,[313 483  64 318  11],214,5,28044,4.109010989010989,80.0,20.0
46825,4,6825,[ 95 168 151 143   8],711,5,28049,4.10914151772634,0.0,0.0
46826,4,6826,[313 483  64 318  11],618,5,28054,4.1092720082027245,80.0,20.0
46827,4,6827,[313 483  64 318  11],618,5,28059,4.109402460456942,80.0,20.0
46828,4,6828,[313 483  64 318  11],618,5,28064,4.109532874505784,80.0,20.0
46829,4,6829,[ 15 194 301 183 597],416,4,28068,4.109516837481698,0.0,0.0
46830,4,6830,[313 483  64 318  11],214,5,28073,4.109647196603718,80.0,20.0
46831,4,6831,[  1 357 210 117 322],805,2,28075,4.109338407494145,0.0,0.0
46832,4,6832,[588 204  28 118 173],541,5,28080,4.109468754573394,0.0,0.0
46833,4,6833,[508  11   7 405 265],417,1,28081,4.109013754755634,0.0,0.0
46834,4,6834,[546   7 588 273 127],417,1,28082,4.108558888076079,0.0,0.0
46835,4,6835,[237 168 151  96 127],618,3,28085,4.108396723229959,0.0,0.0
46836,4,6836,[655  28 210 215  82],128,3,28088,4.108234605821266,0.0,0.0
46837,4,6837,[258 257 151 237 181],642,3,28091,4.10807253582919,0.0,20.0
46838,4,6838,[313 483  64 318  11],618,5,28096,4.1082029536481945,80.0,20.0
46839,4,6839,[211 194 175 546 168],297,3,28099,4.1080409356725145,0.0,0.0
46840,4,6840,[194 200 191 196 215],416,5,28104,4.108171319982459,0.0,0.0
46841,4,6841,[313 483  64 318  11],618,5,28109,4.10830166617948,80.0,20.0
46842,4,6842,[313 483  64 318  11],214,5,28114,4.108431974280286,80.0,20.0
46843,4,6843,[313 483  64 318  11],618,5,28119,4.108562244301578,80.0,20.0
46844,4,6844,[117 748  97 323  98],198,1,28120,4.108108108108108,0.0,20.0
46845,4,6845,[333 282 173 197   1],854,2,28122,4.107800175284837,0.0,0.0
46846,4,6846,[313 483  64 318  11],214,5,28127,4.10793048050241,80.0,20.0
46847,4,6847,[313 483  64 318  11],618,5,28132,4.108060747663552,80.0,20.0
46848,4,6848,[269  12  56 121 257],214,3,28135,4.107898963352314,20.0,0.0
46849,4,6849,[313 483  64 318  11],214,5,28140,4.108029197080292,80.0,20.0
46850,4,6850,[197 515 235 182 196],297,2,28142,4.107721500510874,0.0,0.0
46851,4,6851,[313 483  64 318  11],214,5,28147,4.107851722124927,80.0,20.0
46852,4,6852,[275  79 268 197 238],297,3,28150,4.107690062746243,0.0,0.0
46853,4,6853,[271 238 144 289 385],43,3,28153,4.107528450539831,0.0,0.0
46854,4,6854,[200 174 118 286 182],417,4,28157,4.107512764405543,0.0,0.0
46855,4,6855,[323 313 742 181 237],43,4,28161,4.107497082847141,20.0,40.0
46856,4,6856,[276 191 100   7 176],24,5,28166,4.107627242234213,0.0,0.0
46857,4,6857,[313 483  64 318  11],214,5,28171,4.107757363662875,80.0,20.0
46858,4,6858,[313 483  64 318  11],618,5,28176,4.10788744714973,80.0,20.0
46859,4,6859,[313 483  64 318  11],214,5,28181,4.108017492711371,80.0,20.0
46860,4,6860,[173  50 265 195 211],373,5,28186,4.108147500364378,0.0,20.0
46861,4,6861,[288 143 174 483 125],618,3,28189,4.107986009909648,20.0,20.0
46862,4,6862,[180 191  22 323 288],805,2,28191,4.107678857642431,0.0,20.0
46863,4,6863,[258 215 216 196 191],721,3,28194,4.1075174825174825,0.0,0.0
46864,4,6864,[313 483  64 318  11],618,5,28199,4.107647487254188,80.0,20.0
46865,4,6865,[313 483  64 318  11],618,5,28204,4.107777454121759,80.0,20.0
46866,4,6866,[313 483  64 318  11],618,5,28209,4.107907383136741,80.0,20.0
46867,4,6867,[313 483  64 318  11],214,5,28214,4.108037274315667,80.0,20.0
46868,4,6868,[ 98  56 235   9 191],805,3,28217,4.10787596447809,0.0,20.0
46869,4,6869,[ 25 135 568 204 471],618,2,28219,4.107569141193595,0.0,0.0
46870,4,6870,[313 483  64 318  11],618,5,28224,4.107699024887207,80.0,20.0
46871,4,6871,[313 483  64 318  11],618,5,28229,4.107828870779977,80.0,20.0
46872,4,6872,[302 191 176 301  88],416,4,28233,4.107813182016587,0.0,0.0
46873,4,6873,[313 483  64 318  11],214,5,28238,4.107942973523421,80.0,20.0
46874,4,6874,[313 483  64 318  11],214,5,28243,4.108072727272727,80.0,20.0
46875,4,6875,[313 483  64 318  11],214,5,28248,4.108202443280978,80.0,20.0
46876,4,6876,[313 483  64 318  11],618,5,28253,4.108332121564636,80.0,20.0
46877,4,6877,[313 483  64 318  11],214,5,28258,4.108461762140157,80.0,20.0
46878,4,6878,[313 483  64 318  11],214,5,28263,4.108591365023986,80.0,20.0
46879,4,6879,[313 483  64 318  11],214,5,28268,4.1087209302325585,80.0,20.0
46880,4,6880,[313 483  64 318  11],214,5,28273,4.1088504577822995,80.0,20.0
46881,4,6881,[313 483  64 318  11],618,5,28278,4.108979947689625,80.0,20.0
46882,4,6882,[118 268 323 234 121],416,3,28281,4.108818828998983,0.0,0.0
46883,4,6883,[313 483  64 318  11],214,5,28286,4.108948285880302,80.0,20.0
46884,4,6884,[313 483  64 318  11],618,5,28291,4.109077705156136,80.0,20.0
46885,4,6885,[265  25 237 111  96],416,4,28295,4.109061864652919,0.0,0.0
46886,4,6886,[185   8  79 273   9],416,5,28300,4.109191229853347,0.0,0.0
46887,4,6887,[313 483  64 318  11],214,5,28305,4.109320557491289,80.0,20.0
46888,4,6888,[313 483  64 318  11],618,5,28310,4.109449847583104,80.0,20.0
46889,4,6889,[313 483  64 318  11],618,5,28315,4.109579100145138,80.0,20.0
46890,4,6890,[313 483  64 318  11],214,5,28320,4.109708315193731,80.0,20.0
46891,4,6891,[678 172 144 132  69],588,2,28322,4.1094022054556,0.0,0.0
46892,4,6892,[313 483  64 318  11],618,5,28327,4.109531408675468,80.0,20.0
46893,4,6893,[ 15 357 222 302 111],417,2,28329,4.109225413402959,0.0,0.0
46894,4,6894,[423 144 172  50 204],62,2,28331,4.10891950688905,0.0,20.0
46895,4,6895,[313 483  64 318  11],214,5,28336,4.109048723897912,80.0,20.0
46896,4,6896,[748  64 313 196 197],345,4,28340,4.109032912860664,40.0,20.0
46897,4,6897,[ 69 185 302 318 496],214,4,28344,4.109017106407655,20.0,0.0
46898,4,6898,[313 483  64 318  11],214,5,28349,4.109146253080157,80.0,20.0
46899,4,6899,[496 237 151 143 257],642,4,28353,4.1091304347826085,0.0,0.0
46900,4,6900,[179 132 288 125 210],416,4,28357,4.10911462106941,0.0,20.0
46901,4,6901,[508 496 210  28 151],654,4,28361,4.109098811938568,0.0,0.0
46902,4,6902,[603  50 174 181 100],698,2,28363,4.108793278284804,0.0,40.0
46903,4,6903,[135 318 288 197 173],721,3,28366,4.1086326767091546,20.0,20.0
46904,4,6904,[125 588 210  70 127],417,3,28369,4.108472121650977,0.0,0.0
46905,4,6905,[313 483  64 318  11],618,5,28374,4.108601216333623,80.0,20.0
46906,4,6906,[313 483  64 318  11],214,5,28379,4.108730273635443,80.0,20.0
46907,4,6907,[  8 175 475 405 200],854,5,28384,4.108859293572669,0.0,0.0
46908,4,6908,[313 276 132 323  69],921,3,28387,4.108698798668404,20.0,20.0
46909,4,6909,[313 483  64 318  11],618,5,28392,4.108827785817655,80.0,20.0
46910,4,6910,[181 302 403 211  70],43,5,28397,4.108956735638837,0.0,20.0
46911,4,6911,[313 483  64 318  11],618,5,28402,4.109085648148148,80.0,20.0
46912,4,6912,[245 289 282  50 181],416,3,28405,4.108925213366121,0.0,40.0
46913,4,6913,[313 483  64 318  11],618,5,28410,4.109054093144345,80.0,20.0
46914,4,6914,[313 483  64 318  11],214,5,28415,4.109182935647144,80.0,20.0
46915,4,6915,[ 79 318  64 176 151],24,5,28420,4.109311740890688,40.0,0.0
46916,4,6916,[121  97 276 655 195],198,1,28421,4.108862223507301,0.0,0.0
46917,4,6917,[153   1 174  79 313],751,3,28424,4.108701936976004,20.0,20.0
46918,4,6918,[245 748 269 288 194],721,2,28426,4.108397167220697,0.0,20.0
46919,4,6919,[127 271 471 237 597],854,2,28428,4.1080924855491325,0.0,0.0
46920,4,6920,[191  96 301 181 121],416,5,28433,4.108221355295478,0.0,20.0
46921,4,6921,[483  64 313 318  11],214,5,28438,4.108350187806992,80.0,20.0
46922,4,6922,[483  64 313 318  11],214,5,28443,4.108478983099812,80.0,20.0
46923,4,6923,[483  64 313 318  11],618,5,28448,4.108607741190063,80.0,20.0
46924,4,6924,[483  64 313 318  11],618,5,28453,4.108736462093863,80.0,20.0
46925,4,6925,[471  25  15 294 216],128,4,28457,4.108720762344788,0.0,0.0
46926,4,6926,[ 56 173 742 216 328],62,3,28460,4.108560704489678,0.0,0.0
46927,4,6927,[423 153 187 245 300],416,4,28464,4.108545034642033,0.0,0.0
46928,4,6928,[742 182 655  12 748],416,5,28469,4.1086736902871985,20.0,0.0
46929,4,6929,[ 64 471 268  28 238],128,4,28473,4.108658008658009,20.0,0.0
46930,4,6930,[423 357 385 276  56],416,4,28477,4.108642331553888,0.0,0.0
46931,4,6931,[483  64 313 318  11],214,5,28482,4.108770917484131,80.0,20.0
46932,4,6932,[ 28 271   7 179 191],62,3,28485,4.108610990913025,0.0,0.0
46933,4,6933,[204 403  50 161 151],49,1,28486,4.108162676665705,0.0,20.0
46934,4,6934,[ 25 173 427 181 151],128,3,28489,4.1080028839221345,0.0,20.0
46935,4,6935,[ 96 403 289 100  15],416,4,28493,4.107987312572088,0.0,0.0
46936,4,6936,[202 117 403 196 245],416,4,28497,4.107971745711403,0.0,0.0
46937,4,6937,[475 318 127 546 655],62,4,28501,4.107956183338138,20.0,0.0
46938,4,6938,[ 11 181 385 117  96],751,4,28505,4.107940625450353,0.0,20.0
46939,4,6939,[405 286 202 211 271],43,4,28509,4.107925072046109,0.0,0.0
46940,4,6940,[288  22 196  95  82],711,3,28512,4.107765451664025,0.0,20.0
46941,4,6941,[483  64 313 318  11],618,5,28517,4.1078939786804956,80.0,20.0
46942,4,6942,[191  89 483 427 568],214,5,28522,4.108022468673484,20.0,0.0
46943,4,6943,[ 88  79 182 322  22],416,3,28525,4.107862903225806,0.0,0.0
46944,4,6944,[197 282 215 172 313],416,5,28530,4.107991360691145,20.0,20.0
46945,4,6945,[588 235 257 234 143],297,2,28532,4.107687877915347,0.0,0.0
46946,4,6946,[483  64 313 318  11],214,5,28537,4.1078163235929175,80.0,20.0
46947,4,6947,[294 258 194 289 328],416,4,28541,4.107800805987335,0.0,0.0
46948,4,6948,[483  64 313 318  11],214,5,28546,4.107929198445819,80.0,20.0
46949,4,6949,[222 181 427  82  25],711,3,28549,4.107769784172662,0.0,20.0
46950,4,6950,[483  64 313 318  11],618,5,28554,4.10789814415192,80.0,20.0
46951,4,6951,[483  64 313 318  11],214,5,28559,4.108026467203683,80.0,20.0
46952,4,6952,[  8 121  82 100 185],601,2,28561,4.107723284912987,0.0,0.0
46953,4,6953,[483  64 313 318  11],618,5,28566,4.1078515962036235,80.0,20.0
46954,4,6954,[161 235 546 237   4],43,4,28570,4.1078360891445005,0.0,0.0
46955,4,6955,[132 187 435 210 161],505,2,28572,4.107533064979873,0.0,0.0
46956,4,6956,[471 151 237 268 508],128,3,28575,4.1073738680465715,0.0,0.0
46957,4,6957,[483  64 313 318  11],618,5,28580,4.107502155791894,80.0,20.0
46958,4,6958,[294 403  28  50 172],721,4,28584,4.107486707860325,0.0,20.0
46959,4,6959,[ 79 179 153 286 172],437,4,28588,4.107471264367816,0.0,0.0
46960,4,6960,[182  96   7 423 121],230,2,28590,4.107168510271513,0.0,0.0
46961,4,6961,[483  64 313 318  11],618,5,28595,4.107296753806377,80.0,20.0
46962,4,6962,[185 151  50 257 597],417,1,28596,4.106850495476088,0.0,20.0
46963,4,6963,[ 95 161 475 195 210],198,2,28598,4.106547960941987,0.0,0.0
46964,4,6964,[173 655 405 144  69],417,2,28600,4.106245513280689,0.0,0.0
46965,4,6965,[483 294 195 323 228],417,3,28603,4.106086706861901,20.0,0.0
46966,4,6966,[210 483 496 183 144],417,2,28605,4.10578441222908,20.0,0.0
46967,4,6967,[ 79 471 245 195 117],505,3,28608,4.105625717566016,0.0,0.0
46968,4,6968,[483  64 313 318  11],214,5,28613,4.105754053666236,80.0,20.0
46969,4,6969,[483  64 313 318  11],214,5,28618,4.105882352941176,80.0,20.0
46970,4,6970,[508 100   8 405 210],601,3,28621,4.105723712523311,0.0,0.0
46971,4,6971,[117 748 496  50 211],417,3,28624,4.1055651176133106,0.0,20.0
46972,4,6972,[204 153 210 323 200],416,4,28628,4.1055499784884555,0.0,0.0
46973,4,6973,[300 210 294 143   1],43,5,28633,4.105678233438486,0.0,0.0
46974,4,6974,[186 202   1 423  25],128,3,28636,4.105519713261649,0.0,0.0
46975,4,6975,[323 269  97 427  15],416,4,28640,4.105504587155964,0.0,0.0
46976,4,6976,[  1 175 204 515 588],297,3,28643,4.105346137308299,0.0,0.0
46977,4,6977,[483  64 313 318  11],618,5,28648,4.105474347950702,80.0,20.0
46978,4,6978,[173 127  25   1   7],805,4,28652,4.105459234847399,0.0,0.0
46979,4,6979,[403 153  56 196 257],43,5,28657,4.105587392550143,0.0,0.0
46980,4,6980,[483  64 313 318  11],618,5,28662,4.105715513536743,80.0,20.0
46981,4,6981,[132 202 111 215 318],618,3,28665,4.105557146949298,20.0,0.0
46982,4,6982,[  7 655 471 228  25],887,2,28667,4.105255620793355,0.0,0.0
46983,4,6983,[385 179 202  11 655],751,3,28670,4.105097365406643,0.0,0.0
46984,4,6984,[483  64 313 318  11],618,5,28675,4.105225483178239,80.0,20.0
46985,4,6985,[300 191 202 678 597],416,3,28678,4.105067277411967,0.0,0.0
46986,4,6986,[ 82 515 235  71 173],416,4,28682,4.105052239874052,0.0,0.0
46987,4,6987,[483  64 313 318  11],618,5,28687,4.105180309101317,80.0,20.0
46988,4,6988,[508 238 289 196  50],345,4,28691,4.105165259693805,0.0,20.0
46989,4,6989,[483  64 313 318  11],618,5,28696,4.105293276108727,80.0,20.0
46990,4,6990,[483  64 313 318  11],214,5,28701,4.105421255900444,80.0,20.0
46991,4,6991,[483  64 313 318  11],214,5,28706,4.105549199084668,80.0,20.0
46992,4,6992,[357 475  64 508 111],62,4,28710,4.1055341055341055,20.0,0.0
46993,4,6993,[195 302   7 187 276],416,4,28714,4.105519016299685,0.0,0.0
46994,4,6994,[ 79 385 748  69 143],416,5,28719,4.1056468906361685,0.0,0.0
46995,4,6995,[151 127 228 191  64],62,4,28723,4.105631789594054,20.0,0.0
46996,4,6996,[483  64 313 318  11],214,5,28728,4.105759611261969,80.0,20.0
46997,4,6997,[168 318 210 187 179],416,4,28732,4.105744498428122,20.0,0.0
46998,4,6998,[483  64 313 318  11],618,5,28737,4.105872267466781,80.0,20.0
46999,4,6999,[ 25 151 678 125 235],416,2,28739,4.105571428571428,0.0,0.0
47000,4,7000,[ 12 215 125 313 132],416,5,28744,4.105699185830596,40.0,20.0
47001,4,7001,[597  12 210 202  79],43,4,28748,4.105684090259926,20.0,0.0
47002,4,7002,[210 196 323  88 568],805,1,28749,4.105240611166643,0.0,0.0
47003,4,7003,[742 294  15 328 546],43,5,28754,4.105368360936608,0.0,0.0
47004,4,7004,[483  64 313 318  11],214,5,28759,4.105496074232691,80.0,20.0
47005,4,7005,[182 271  64 173 288],62,3,28762,4.105338281473023,20.0,20.0
47006,4,7006,[483  64 313 318  11],618,5,28767,4.10546596260882,80.0,20.0
47007,4,7007,[483  64 313 318  11],214,5,28772,4.105593607305936,80.0,20.0
47008,4,7008,[258 423 161 322 294],721,3,28775,4.105435868169496,0.0,0.0
47009,4,7009,[483  64 313 318  11],214,5,28780,4.1055634807417976,80.0,20.0
47010,4,7010,[483  64 313 318  11],618,5,28785,4.105691056910569,80.0,20.0
47011,4,7011,[275 176 403  79 202],618,3,28788,4.105533371363377,0.0,0.0
47012,4,7012,[483  64 313 318  11],214,5,28793,4.1056609154427495,80.0,20.0
47013,4,7013,[180 328 186 748 143],373,3,28796,4.105503279155974,0.0,0.0
47014,4,7014,[483  64 313 318  11],618,5,28801,4.105630791161796,80.0,20.0
47015,4,7015,[483  64 313 318  11],618,5,28806,4.1057582668187,80.0,20.0
47016,4,7016,[216  11  71 168  98],437,2,28808,4.105458173008408,0.0,20.0
47017,4,7017,[483  64 313 318  11],618,5,28813,4.1055856369336,80.0,20.0
47018,4,7018,[385 496 748 151 216],373,4,28817,4.1055705941017235,0.0,0.0
47019,4,7019,[483  64 313 318  11],214,5,28822,4.105698005698006,80.0,20.0
47020,4,7020,[294   8  50  64 153],854,4,28826,4.1056829511465605,20.0,20.0
47021,4,7021,[483  64 313 318  11],618,5,28831,4.1058103104528625,80.0,20.0
47022,4,7022,[ 11  64 196 508 174],214,5,28836,4.105937633489962,20.0,0.0
47023,4,7023,[483  64 313 318  11],618,5,28841,4.106064920273348,80.0,20.0
47024,4,7024,[483  64 313 318  11],214,5,28846,4.106192170818505,80.0,20.0
47025,4,7025,[483  64 313 318  11],214,5,28851,4.106319385140905,80.0,20.0
47026,4,7026,[ 11  25 318   9 132],314,4,28855,4.106304255016365,20.0,0.0
47027,4,7027,[483  64 313 318  11],214,5,28860,4.106431417188389,80.0,20.0
47028,4,7028,[483  64 313 318  11],214,5,28865,4.106558543178261,80.0,20.0
47029,4,7029,[ 56  11 185 427 132],416,5,28870,4.1066856330014225,0.0,0.0
47030,4,7030,[483 294  96 151 121],62,4,28874,4.1066704593941115,20.0,0.0
47031,4,7031,[475 172 318 210 257],601,4,28878,4.106655290102389,20.0,0.0
47032,4,7032,[117  69 100 300 265],198,1,28879,4.106213564623916,0.0,0.0
47033,4,7033,[228 204  64   8 176],62,3,28882,4.106056297981234,20.0,0.0
47034,4,7034,[ 12   1 176 568 273],416,5,28887,4.106183368869936,20.0,0.0
47035,4,7035,[294  11 405 568 471],345,3,28890,4.106026151222285,0.0,0.0
47036,4,7036,[483  64 313 318  11],618,5,28895,4.106153190279949,80.0,20.0
47037,4,7037,[ 95 318 202 235 151],642,1,28896,4.105711849957374,20.0,0.0
47038,4,7038,[ 22  11  69  15 742],314,5,28901,4.105838897570678,0.0,0.0
47039,4,7039,[483  64 313 318  11],618,5,28906,4.1059659090909095,80.0,20.0
47040,4,7040,[323 265  56  70 268],417,3,28909,4.105808833972447,0.0,0.0
47041,4,7041,[483  64 313 318  11],214,5,28914,4.1059358136892925,80.0,20.0
47042,4,7042,[483  64 313 318  11],214,5,28919,4.106062757347721,80.0,20.0
47043,4,7043,[403   8 118  69 235],416,3,28922,4.105905735377626,0.0,0.0
47044,4,7044,[483  64 313 318  11],618,5,28927,4.106032647267566,80.0,20.0
47045,4,7045,[ 15 127  64  98 228],601,3,28930,4.105875674141357,20.0,20.0
47046,4,7046,[483  64 313 318  11],214,5,28935,4.106002554278416,80.0,20.0
47047,4,7047,[117 742 546  82   8],654,5,28940,4.106129398410896,0.0,0.0
47048,4,7048,[268 328 237 318   4],416,4,28944,4.106114342459923,20.0,0.0
47049,4,7049,[  8 302 286 216  11],416,5,28949,4.106241134751773,0.0,0.0
47050,4,7050,[153 300 471  22 423],721,5,28954,4.106367891079279,0.0,0.0
47051,4,7051,[ 69 173 143 151  25],654,4,28958,4.106352807714123,0.0,0.0
47052,4,7052,[ 56  22 301 268   7],416,5,28963,4.1064795122642845,0.0,0.0
47053,4,7053,[483  64 313 318  11],618,5,28968,4.106606180890275,80.0,20.0
47054,4,7054,[127   8  89 176 271],62,4,28972,4.106591070163005,0.0,0.0
47055,4,7055,[132  79 216 215 588],128,3,28975,4.106434240362812,0.0,0.0
47056,4,7056,[483  64 313 318  11],214,5,28980,4.106560861555902,80.0,20.0
47057,4,7057,[216 748 132  96 318],198,4,28984,4.106545763672428,20.0,0.0
47058,4,7058,[168 322 185 323  56],417,2,28986,4.106247343816404,0.0,0.0
47059,4,7059,[483  64 313 318  11],618,5,28991,4.106373937677054,80.0,20.0
47060,4,7060,[ 98 196  50 127  11],198,4,28995,4.106358872680923,0.0,40.0
47061,4,7061,[483  64 313 318  11],214,5,29000,4.10648541489663,80.0,20.0
47062,4,7062,[483  64 313 318  11],618,5,29005,4.106611921279909,80.0,20.0
47063,4,7063,[ 50 288  69 191   1],854,4,29009,4.106596828992073,0.0,40.0
47064,4,7064,[483  64 313 318  11],214,5,29014,4.106723283793348,80.0,20.0
47065,4,7065,[483  64 313 318  11],214,5,29019,4.106849702802151,80.0,20.0
47066,4,7066,[483  64 313 318  11],618,5,29024,4.1069760860336775,80.0,20.0
47067,4,7067,[216 195 153 222   1],417,3,29027,4.106819468024901,0.0,0.0
47068,4,7068,[483  64 313 318  11],618,5,29032,4.106945819776489,80.0,20.0
47069,4,7069,[196  98  22   7 117],805,2,29034,4.1066478076379065,0.0,20.0
47070,4,7070,[196 179 117  28 161],373,3,29037,4.106491302503182,0.0,0.0
47071,4,7071,[483  64 313 318  11],618,5,29042,4.106617647058823,80.0,20.0
47072,4,7072,[483  64 313 318  11],618,5,29047,4.10674395588859,80.0,20.0
47073,4,7073,[471 202 313 258  98],505,3,29050,4.106587503534068,20.0,40.0
47074,4,7074,[111  88 186 196 210],128,4,29054,4.106572438162544,0.0,0.0
47075,4,7075,[228 191  97 216  56],297,3,29057,4.106416054267948,0.0,0.0
47076,4,7076,[483  64 313 318  11],618,5,29062,4.106542320192172,80.0,20.0
47077,4,7077,[483  64 313 318  11],618,5,29067,4.106668550437977,80.0,20.0
47078,4,7078,[483  64 313 318  11],214,5,29072,4.106794745020483,80.0,20.0
47079,4,7079,[655 175 186  89 176],405,2,29074,4.106497175141243,0.0,0.0
47080,4,7080,[ 50 238  96 273 194],416,5,29079,4.106623358282729,0.0,20.0
47081,4,7081,[173 118 258 423 496],417,4,29083,4.106608302739339,0.0,0.0
47082,4,7082,[ 15 216 202 182 180],128,4,29087,4.106593251447127,0.0,0.0
47083,4,7083,[ 64 300 276 328 471],416,4,29091,4.1065782044042916,20.0,0.0
47084,4,7084,[ 22 238 427 196 176],618,4,29095,4.106563161609033,0.0,0.0
47085,4,7085,[265  97 135 234 300],198,1,29096,4.106124753034152,0.0,0.0
47086,4,7086,[196  97  50 302 403],721,4,29100,4.106109778467617,0.0,20.0
47087,4,7087,[  4 269  56 204 655],416,5,29105,4.106235891647856,0.0,0.0
47088,4,7088,[483  64 313 318  11],618,5,29110,4.106361969248131,80.0,20.0
47089,4,7089,[275  25 176 273  12],854,3,29113,4.10620592383639,20.0,0.0
47090,4,7090,[515 238 405 597 210],416,4,29117,4.10619094626992,0.0,0.0
47091,4,7091,[483  64 313 318  11],214,5,29122,4.106316976875353,80.0,20.0
47092,4,7092,[405 181 100 172  82],62,4,29126,4.10630198787537,0.0,20.0
47093,4,7093,[483  64 313 318  11],618,5,29131,4.106427967296307,80.0,20.0
47094,4,7094,[ 70  88 161 588   1],128,4,29135,4.106412966878083,0.0,0.0
47095,4,7095,[588 301 179 313 269],751,4,29139,4.106397970687711,20.0,20.0
47096,4,7096,[191 483 597  97 742],62,2,29141,4.106101169508243,20.0,0.0
47097,4,7097,[483  64 313 318  11],618,5,29146,4.106227106227106,80.0,20.0
47098,4,7098,[118  79  82  88 475],588,3,29149,4.106071277644738,0.0,0.0
47099,4,7099,[191 168 258 603  89],854,5,29154,4.106197183098591,0.0,0.0
47100,4,7100,[483  64 313 318  11],214,5,29159,4.106323053091114,80.0,20.0
47101,4,7101,[ 22 748  89 238 257],297,3,29162,4.10616727682343,0.0,0.0
47102,4,7102,[ 28 357  11 265  56],416,5,29167,4.106293115584964,0.0,0.0
47103,4,7103,[483  64 313 318  11],618,5,29172,4.106418918918919,80.0,20.0
47104,4,7104,[483  64 313 318  11],618,5,29177,4.1065446868402535,80.0,20.0
47105,4,7105,[483  64 313 318  11],618,5,29182,4.106670419363918,80.0,20.0
47106,4,7106,[483  64 313 318  11],618,5,29187,4.106796116504855,80.0,20.0
47107,4,7107,[269 191 215 275  95],416,4,29191,4.106781091727631,0.0,0.0
47108,4,7108,[ 89 237 234   1 427],642,2,29193,4.1064847376564915,0.0,0.0
47109,4,7109,[588 655 195 118 168],416,4,29197,4.106469760900141,0.0,0.0
47110,4,7110,[483  64 313 318  11],618,5,29202,4.106595415553368,80.0,20.0
47111,4,7111,[118 127 515 288 405],416,4,29206,4.106580427446569,0.0,20.0
47112,4,7112,[483  64 313 318  11],214,5,29211,4.10670603121046,80.0,20.0
47113,4,7113,[597 385 144 655 183],805,1,29212,4.106269328085466,0.0,0.0
47114,4,7114,[ 71  69 318  15  70],373,5,29217,4.106394940267042,20.0,0.0
47115,4,7115,[273 286  79 423 161],417,2,29219,4.106098931984261,0.0,0.0
47116,4,7116,[483  64 313 318  11],214,5,29224,4.106224532808768,80.0,20.0
47117,4,7117,[ 69 173   7 168  95],297,3,29227,4.106069120539478,0.0,0.0
47118,4,7118,[195 275 187 471  96],416,5,29232,4.106194690265487,0.0,0.0
47119,4,7119,[483  64 313 318  11],618,5,29237,4.106320224719101,80.0,20.0
47120,4,7120,[ 69  70 245   4 258],417,3,29240,4.106164864485325,0.0,0.0
47121,4,7121,[483  64 313 318  11],214,5,29245,4.106290367874193,80.0,20.0
47122,4,7122,[121 235 191 135 385],417,2,29247,4.10599466516917,0.0,0.0
47123,4,7123,[483  64 313 318  11],618,5,29252,4.106120157215048,80.0,20.0
47124,4,7124,[483  64 313 318  11],214,5,29257,4.106245614035088,80.0,20.0
47125,4,7125,[483  64 313 318  11],214,5,29262,4.10637103564412,80.0,20.0
47126,4,7126,[ 70  71 294  28  15],416,5,29267,4.106496422056966,0.0,0.0
47127,4,7127,[483  64 313 318  11],214,5,29272,4.10662177328844,80.0,20.0
47128,4,7128,[423 257 258 181  69],642,3,29275,4.106466545097489,0.0,20.0
47129,4,7129,[483  64 313 318  11],618,5,29280,4.106591865357644,80.0,20.0
47130,4,7130,[357 275 176 117 100],297,5,29285,4.1067171504697795,0.0,0.0
47131,4,7131,[483  64 313 318  11],214,5,29290,4.106842400448682,80.0,20.0
47132,4,7132,[483  64 313 318  11],618,5,29295,4.106967615309126,80.0,20.0
47133,4,7133,[172  88 496  56 294],416,4,29299,4.10695262125035,0.0,0.0
47134,4,7134,[405  82 132 234  71],230,5,29304,4.107077785564121,0.0,0.0
47135,4,7135,[ 98 237 151 268  28],297,4,29308,4.107062780269058,0.0,20.0
47136,4,7136,[483  64 313 318  11],618,5,29313,4.10718789407314,80.0,20.0
47137,4,7137,[483  64 313 318  11],214,5,29318,4.107312972821519,80.0,20.0
47138,4,7138,[483  64 313 318  11],618,5,29323,4.107438016528926,80.0,20.0
47139,4,7139,[435 471 172 216 144],373,3,29326,4.107282913165266,0.0,0.0
47140,4,7140,[483  64 313 318  11],214,5,29331,4.107407926060776,80.0,20.0
47141,4,7141,[215 294 237 117 471],416,4,29335,4.107392887146458,0.0,0.0
47142,4,7142,[483  64 313 318  11],618,5,29340,4.107517849643007,80.0,20.0
47143,4,7143,[483  64 313 318  11],214,5,29345,4.107642777155655,80.0,20.0
47144,4,7144,[ 56 135  98  12  50],854,5,29350,4.10776766969909,20.0,40.0
47145,4,7145,[385 117 318 237 151],416,3,29353,4.1076126504338095,20.0,0.0
47146,4,7146,[483  64 313 318  11],214,5,29358,4.107737512242899,80.0,20.0
47147,4,7147,[313 132 191  71 289],416,4,29362,4.107722439843313,20.0,20.0
47148,4,7148,[185  11 143  28 238],416,5,29367,4.107847251363827,0.0,0.0
47149,4,7149,[202  95  88 191 143],373,3,29370,4.107692307692307,0.0,0.0
47150,4,7150,[423  25  96 215 151],198,3,29373,4.107537407355615,0.0,0.0
47151,4,7151,[191 151 282 515 172],416,4,29377,4.107522371364653,0.0,0.0
47152,4,7152,[483  64 313 318  11],618,5,29382,4.1076471410596955,80.0,20.0
47153,4,7153,[ 70 546 216   7  71],630,2,29384,4.1073525300531175,0.0,0.0
47154,4,7154,[483  64 313 318  11],214,5,29389,4.107477288609364,80.0,20.0
47155,4,7155,[475 269 588 211   7],297,5,29394,4.107602012297373,0.0,0.0
47156,4,7156,[ 95 265 385 196 183],405,0,29394,4.107028084392902,0.0,0.0
47157,4,7157,[ 88   8 197 222 135],805,3,29397,4.106873428331936,0.0,0.0
47158,4,7158,[483  64 313 318  11],618,5,29402,4.106998184103925,80.0,20.0
47159,4,7159,[483  64 313 318  11],618,5,29407,4.107122905027933,80.0,20.0
47160,4,7160,[483  64 313 318  11],214,5,29412,4.107247591118559,80.0,20.0
47161,4,7161,[143 496 117  22 118],588,3,29415,4.107092990784697,0.0,0.0
47162,4,7162,[748   1 403 228  25],805,3,29418,4.1069384336171995,0.0,0.0
47163,4,7163,[483  64 313 318  11],214,5,29423,4.1070630932439975,80.0,20.0
47164,4,7164,[ 28 191  64 385 135],373,2,29425,4.106769016050245,20.0,0.0
47165,4,7165,[483  64 313 318  11],618,5,29430,4.1068936645269325,80.0,20.0
47166,4,7166,[318  97 286   1 655],705,2,29432,4.106599693037533,20.0,0.0
47167,4,7167,[204 200 655 175 475],198,3,29435,4.1064453125,0.0,0.0
47168,4,7168,[ 97 176 215  71  88],618,5,29440,4.106569953968475,0.0,0.0
47169,4,7169,[403 568 183 143 111],805,2,29442,4.106276150627615,0.0,0.0
47170,4,7170,[210  95 301 186 238],437,2,29444,4.105982429228838,0.0,0.0
47171,4,7171,[483  64 313 318  11],618,5,29449,4.106107083100948,80.0,20.0
47172,4,7172,[483  64 313 318  11],618,5,29454,4.106231702216646,80.0,20.0
47173,4,7173,[  8  98 234 300  15],416,5,29459,4.106356286590466,0.0,20.0
47174,4,7174,[ 22 471 603 385  96],416,5,29464,4.106480836236933,0.0,0.0
47175,4,7175,[144  96 117 176 181],62,4,29468,4.1064659977703455,0.0,20.0
47176,4,7176,[483  64 313 318  11],618,5,29473,4.106590497422322,80.0,20.0
47177,4,7177,[483  64 313 318  11],214,5,29478,4.106714962385065,80.0,20.0
47178,4,7178,[318  64 118 269 289],854,3,29481,4.106560802340159,40.0,0.0
47179,4,7179,[273 168 185 742 289],854,3,29484,4.106406685236768,0.0,0.0
47180,4,7180,[161 185 187 273 742],416,5,29489,4.106531123798914,0.0,0.0
47181,4,7181,[117 197 215 603 187],416,5,29494,4.106655527708159,0.0,0.0
47182,4,7182,[483  64 313 318  11],214,5,29499,4.106779896978978,80.0,20.0
47183,4,7183,[496   1 172 273 118],618,4,29503,4.106765033407572,0.0,0.0
47184,4,7184,[483  64 313 318  11],214,5,29508,4.106889352818372,80.0,20.0
47185,4,7185,[185 245 288 286 282],907,5,29513,4.1070136376287225,0.0,20.0
47186,4,7186,[385 195 168 257 237],416,3,29516,4.1068596076248784,0.0,0.0
47187,4,7187,[483  64 313 318  11],214,5,29521,4.10698386199221,80.0,20.0
47188,4,7188,[318 301 168 197 215],711,4,29525,4.106968980386702,20.0,0.0
47189,4,7189,[483  64 313 318  11],618,5,29530,4.107093184979138,80.0,20.0
47190,4,7190,[483  64 313 318  11],618,5,29535,4.107217355027117,80.0,20.0
47191,4,7191,[483  64 313 318  11],618,5,29540,4.10734149054505,80.0,20.0
47192,4,7192,[ 70 182  95 282 403],618,2,29542,4.107048519393855,0.0,0.0
47193,4,7193,[483  64 313 318  11],618,5,29547,4.107172643869892,80.0,20.0
47194,4,7194,[238  12 546 568 183],416,4,29551,4.107157748436414,20.0,0.0
47195,4,7195,[483  64 313 318  11],214,5,29556,4.10728182323513,80.0,20.0
47196,4,7196,[483  64 313 318  11],618,5,29561,4.107405863554258,80.0,20.0
47197,4,7197,[483  64 313 318  11],618,5,29566,4.107529869408169,80.0,20.0
47198,4,7198,[143 135 191 182 301],437,3,29569,4.10737602444784,0.0,0.0
47199,4,7199,[ 98  64 318 210 276],618,3,29572,4.107222222222222,40.0,20.0
47200,4,7200,[483  64 313 318  11],214,5,29577,4.107346201916401,80.0,20.0
47201,4,7201,[483  64 313 318  11],214,5,29582,4.107470147181338,80.0,20.0
47202,4,7202,[385 678 161 273 191],416,4,29586,4.107455226988755,0.0,0.0
47203,4,7203,[483  64 313 318  11],618,5,29591,4.1075791227096055,80.0,20.0
47204,4,7204,[275   4 282 678 385],654,4,29595,4.107564191533657,0.0,0.0
47205,4,7205,[742 215 471 282 288],297,0,29595,4.106994171523731,0.0,20.0
47206,4,7206,[195 135 405 180 423],854,4,29599,4.106979325655613,0.0,0.0
47207,4,7207,[215 318  95 405 132],314,5,29604,4.107103218645949,20.0,0.0
47208,4,7208,[483  64 313 318  11],618,5,29609,4.107227077264531,80.0,20.0
47209,4,7209,[197 258  64 185 748],416,5,29614,4.107350901525659,20.0,0.0
47210,4,7210,[288 100 210 427  82],262,1,29615,4.1069199833587575,0.0,20.0
47211,4,7211,[483  64 313 318  11],214,5,29620,4.107043815862451,80.0,20.0
47212,4,7212,[215 174 276 265 196],416,4,29624,4.107028975460973,0.0,0.0
47213,4,7213,[235 300 151 403 268],49,1,29625,4.1065982811200445,0.0,0.0
47214,4,7214,[483  64 313 318  11],618,5,29630,4.106722106722107,80.0,20.0
47215,4,7215,[483  64 313 318  11],618,5,29635,4.106845898004434,80.0,20.0
47216,4,7216,[ 25  11 210  97 100],43,5,29640,4.106969654981294,0.0,0.0
47217,4,7217,[483  64 313 318  11],214,5,29645,4.107093377666944,80.0,20.0
47218,4,7218,[302  96 117 357   9],62,4,29649,4.107078542734451,0.0,0.0
47219,4,7219,[483  64 313 318  11],618,5,29654,4.107202216066482,80.0,20.0
47220,4,7220,[237 185 405   7 508],854,4,29658,4.107187370170337,0.0,0.0
47221,4,7221,[655 181 183 235 403],416,4,29662,4.1071725283854885,0.0,20.0
47222,4,7222,[132 151  15 496 273],764,4,29666,4.107157690710231,0.0,0.0
47223,4,7223,[ 25  71 568 185 118],618,3,29669,4.107004429678848,0.0,0.0
47224,4,7224,[483  64 313 318  11],618,5,29674,4.107128027681661,80.0,20.0
47225,4,7225,[483  64 313 318  11],214,5,29679,4.107251591475229,80.0,20.0
47226,4,7226,[175  79 174 151 144],373,3,29682,4.107098381070984,0.0,0.0
47227,4,7227,[ 71  98 405 508  22],62,4,29686,4.1070835639180965,0.0,20.0
47228,4,7228,[173 183 202 655 333],253,4,29690,4.107068750864573,0.0,0.0
47229,4,7229,[483  64 313 318  11],618,5,29695,4.107192254495159,80.0,20.0
47230,4,7230,[191   4  50 471 151],297,1,29696,4.1067625501313785,0.0,20.0
47231,4,7231,[483  64 313 318  11],214,5,29701,4.106886061946903,80.0,20.0
47232,4,7232,[151   8 174 210 265],588,4,29705,4.106871284390985,0.0,0.0
47233,4,7233,[483  64 313 318  11],214,5,29710,4.106994747027923,80.0,20.0
47234,4,7234,[483  64 313 318  11],214,5,29715,4.107118175535591,80.0,20.0
47235,4,7235,[483  64 313 318  11],618,5,29720,4.107241569928137,80.0,20.0
47236,4,7236,[153  15 742 234 515],416,5,29725,4.107364930219704,0.0,0.0
47237,4,7237,[483  64 313 318  11],618,5,29730,4.107488256424427,80.0,20.0
47238,4,7238,[483  64 313 318  11],618,5,29735,4.107611548556431,80.0,20.0
47239,4,7239,[483  64 313 318  11],214,5,29740,4.107734806629834,80.0,20.0
47240,4,7240,[678 183 257 100 151],297,2,29742,4.107443723242646,0.0,0.0
47241,4,7241,[483  64 313 318  11],618,5,29747,4.107566970450152,80.0,20.0
47242,4,7242,[  1 742 196  89   7],417,3,29750,4.107414054949606,0.0,0.0
47243,4,7243,[ 88 238 187 202 496],373,3,29753,4.107261181667587,0.0,0.0
47244,4,7244,[655 257 588 483 234],417,3,29756,4.1071083505866115,20.0,0.0
47245,4,7245,[323 125 357 222  95],417,3,29759,4.106955561689208,0.0,0.0
47246,4,7246,[483  64 313 318  11],618,5,29764,4.107078791223954,80.0,20.0
47247,4,7247,[ 79  56 228 132 211],417,3,29767,4.106926048565121,0.0,0.0
47248,4,7248,[483  64 313 318  11],214,5,29772,4.107049248172162,80.0,20.0
47249,4,7249,[ 98 294  56 318 742],253,4,29776,4.10703448275862,20.0,20.0
47250,4,7250,[185 234  95  70 179],417,4,29780,4.1070197214177355,0.0,0.0
47251,4,7251,[483  64 313 318  11],618,5,29785,4.107142857142857,80.0,20.0
47252,4,7252,[258   1 210  98 588],887,3,29788,4.1069902109471945,0.0,20.0
47253,4,7253,[483  64 313 318  11],618,5,29793,4.107113316790736,80.0,20.0
47254,4,7254,[483  64 313 318  11],618,5,29798,4.10723638869745,80.0,20.0
47255,4,7255,[181 748 597  89 161],805,1,29799,4.10680815876516,0.0,20.0
47256,4,7256,[483  64 313 318  11],214,5,29804,4.106931238803914,80.0,20.0
47257,4,7257,[ 89 508 471  98 603],297,4,29808,4.106916505924497,0.0,20.0
47258,4,7258,[483  64 313 318  11],214,5,29813,4.107039537126326,80.0,20.0
47259,4,7259,[483  64 313 318  11],214,5,29818,4.107162534435262,80.0,20.0
47260,4,7260,[483  64 313 318  11],214,5,29823,4.107285497865308,80.0,20.0
47261,4,7261,[483  64 313 318  11],618,5,29828,4.10740842743046,80.0,20.0
47262,4,7262,[483  64 313 318  11],618,5,29833,4.107531323144706,80.0,20.0
47263,4,7263,[151 181 546 100 127],805,2,29835,4.107241189427313,0.0,20.0
47264,4,7264,[194  69   9 132 318],854,4,29839,4.1072264280798345,20.0,0.0
47265,4,7265,[483  64 313 318  11],618,5,29844,4.107349298100743,80.0,20.0
47266,4,7266,[ 82   1  79  22 181],805,2,29846,4.107059309206,0.0,20.0
47267,4,7267,[127 117 328 276  69],43,5,29851,4.107182168409466,0.0,0.0
47268,4,7268,[483  64 313 318  11],214,5,29856,4.107304993809327,80.0,20.0
47269,4,7269,[483  64 313 318  11],214,5,29861,4.1074277854195325,80.0,20.0
47270,4,7270,[258 357 235 405 143],805,1,29862,4.107000412597992,0.0,0.0
47271,4,7271,[187 185 313 238 357],416,5,29867,4.107123212321232,20.0,20.0
47272,4,7272,[588 235 161  70 111],49,1,29868,4.106695998900041,0.0,0.0
47273,4,7273,[483  64 313 318  11],214,5,29873,4.106818806708826,80.0,20.0
47274,4,7274,[483  64 313 318  11],214,5,29878,4.106941580756014,80.0,20.0
47275,4,7275,[197 276 403 118 187],198,3,29881,4.106789444749863,0.0,0.0
47276,4,7276,[  7  50 144 286 282],588,3,29884,4.106637350556548,0.0,20.0
47277,4,7277,[483  64 313 318  11],214,5,29889,4.106760098928277,80.0,20.0
47278,4,7278,[483  64 313 318  11],214,5,29894,4.106882813573293,80.0,20.0
47279,4,7279,[483  64 313 318  11],214,5,29899,4.107005494505494,80.0,20.0
47280,4,7280,[483  64 313 318  11],618,5,29904,4.107128141738772,80.0,20.0
47281,4,7281,[132 748 121  11 435],437,2,29906,4.106838780554793,0.0,0.0
47282,4,7282,[483  64 313 318  11],618,5,29911,4.10696141699849,80.0,20.0
47283,4,7283,[328 258 496 427 423],416,5,29916,4.107084019769357,0.0,0.0
47284,4,7284,[268 211  50 357 180],875,5,29921,4.1072065888812626,0.0,20.0
47285,4,7285,[ 28 200 748 385 515],416,5,29926,4.107329124348065,0.0,0.0
47286,4,7286,[483  64 313 318  11],214,5,29931,4.1074516261836145,80.0,20.0
47287,4,7287,[323  79 403   1 173],805,5,29936,4.107574094401756,0.0,0.0
47288,4,7288,[183 475  12 742 211],297,4,29940,4.107559335985732,20.0,0.0
47289,4,7289,[318 118 200  25 132],887,3,29943,4.107407407407408,20.0,0.0
47290,4,7290,[144 151 187 186 168],618,4,29947,4.107392675901797,0.0,0.0
47291,4,7291,[117 174 496  97  71],416,5,29952,4.107515085024684,0.0,0.0
47292,4,7292,[237 423  56 294  97],128,3,29955,4.107363225010284,0.0,0.0
47293,4,7293,[483  64 313 318  11],214,5,29960,4.107485604606526,80.0,20.0
47294,4,7294,[483  64 313 318  11],618,5,29965,4.107607950651131,80.0,20.0
47295,4,7295,[483  64 313 318  11],214,5,29970,4.107730263157895,80.0,20.0
47296,4,7296,[ 79 121  25 118  82],751,4,29974,4.107715499520351,0.0,0.0
47297,4,7297,[483  64 313 318  11],214,5,29979,4.107837763770896,80.0,20.0
47298,4,7298,[748 286 222 275   4],297,3,29982,4.107685984381422,0.0,0.0
47299,4,7299,[483  64 313 318  11],618,5,29987,4.107808219178082,80.0,20.0
47300,4,7300,[288 678 234 300 117],297,1,29988,4.10738255033557,0.0,20.0
47301,4,7301,[483  64 313 318  11],618,5,29993,4.10750479320734,80.0,20.0
47302,4,7302,[117 546 161  50 289],43,5,29998,4.107627002601671,0.0,20.0
47303,4,7303,[173 597 405 318 678],654,5,30003,4.107749178532311,20.0,0.0
47304,4,7304,[289  15 132 174 257],416,3,30006,4.107597535934292,0.0,0.0
47305,4,7305,[117 118 483 655 748],437,3,30009,4.10744593484807,20.0,0.0
47306,4,7306,[323 318 153  71 357],416,4,30013,4.107431230327084,20.0,0.0
47307,4,7307,[483  64 313 318  11],214,5,30018,4.107553366174056,80.0,20.0
47308,4,7308,[483  64 313 318  11],214,5,30023,4.107675468600355,80.0,20.0
47309,4,7309,[483  64 313 318  11],618,5,30028,4.107797537619699,80.0,20.0
47310,4,7310,[191 265  25  50 403],416,5,30033,4.107919573245794,0.0,20.0
47311,4,7311,[483  64 313 318  11],618,5,30038,4.108041575492341,80.0,20.0
47312,4,7312,[294  69 546 328   1],62,2,30040,4.10775331601258,0.0,0.0
47313,4,7313,[191 748  11 323 313],345,3,30043,4.107601859447635,20.0,20.0
47314,4,7314,[ 98 288 168 289 237],854,3,30046,4.1074504442925495,0.0,40.0
47315,4,7315,[483  64 313 318  11],214,5,30051,4.107572443958447,80.0,20.0
47316,4,7316,[483  64 313 318  11],214,5,30056,4.107694410277436,80.0,20.0
47317,4,7317,[483  64 313 318  11],618,5,30061,4.1078163432631865,80.0,20.0
47318,4,7318,[302 323 385 182  98],417,3,30064,4.107664981554858,0.0,20.0
47319,4,7319,[  4 210 568  50 153],253,4,30068,4.107650273224044,0.0,20.0
47320,4,7320,[568  96 132 748 318],642,3,30071,4.107498975549788,20.0,0.0
47321,4,7321,[483  64 313 318  11],214,5,30076,4.1076208686151325,80.0,20.0
47322,4,7322,[302  15 475 173 191],416,4,30080,4.107606172333743,0.0,0.0
47323,4,7323,[ 22 235 191 322 215],416,3,30083,4.107454942654288,0.0,0.0
47324,4,7324,[151 168 748 127 655],417,5,30088,4.1075767918088735,0.0,0.0
47325,4,7325,[483  64 313 318  11],618,5,30093,4.107698607698608,80.0,20.0
47326,4,7326,[100 508 237 173 132],62,4,30097,4.107683908830354,0.0,0.0
47327,4,7327,[483  64 313 318  11],214,5,30102,4.107805676855895,80.0,20.0
47328,4,7328,[  4 237  25 508 185],854,2,30104,4.107518078864784,0.0,0.0
47329,4,7329,[117   9 322 153 405],805,1,30105,4.107094133697135,0.0,0.0
47330,4,7330,[483  64 313 318  11],214,5,30110,4.1072159323421085,80.0,20.0
47331,4,7331,[483  64 313 318  11],214,5,30115,4.10733769776323,80.0,20.0
47332,4,7332,[216 117 588 300 328],128,4,30119,4.107323060139097,0.0,0.0
47333,4,7333,[172 173 275 153 175],43,4,30123,4.107308426506681,0.0,0.0
47334,4,7334,[483  64 313 318  11],214,5,30128,4.107430129516019,80.0,20.0
47335,4,7335,[483  64 313 318  11],618,5,30133,4.107551799345693,80.0,20.0
47336,4,7336,[195 427 515 191 194],405,3,30136,4.107400845032029,0.0,0.0
47337,4,7337,[333 258  70 117 405],345,4,30140,4.107386208776234,0.0,0.0
47338,4,7338,[ 79 168  70   7 313],618,4,30144,4.1073715765090615,20.0,20.0
47339,4,7339,[483  64 313 318  11],618,5,30149,4.107493188010899,80.0,20.0
47340,4,7340,[483  64 313 318  11],214,5,30154,4.107614766380602,80.0,20.0
47341,4,7341,[195   8 135 111   1],618,2,30156,4.107327703622991,0.0,0.0
47342,4,7342,[194 202 161 174   7],416,5,30161,4.107449271414953,0.0,0.0
47343,4,7343,[483  64 313 318  11],618,5,30166,4.107570806100218,80.0,20.0
47344,4,7344,[483  64 313 318  11],618,5,30171,4.107692307692307,80.0,20.0
47345,4,7345,[483  64 313 318  11],214,5,30176,4.107813776204737,80.0,20.0
47346,4,7346,[483  64 313 318  11],214,5,30181,4.107935211651014,80.0,20.0
47347,4,7347,[483  64 313 318  11],618,5,30186,4.108056614044638,80.0,20.0
47348,4,7348,[483  64 313 318  11],214,5,30191,4.108177983399102,80.0,20.0
47349,4,7349,[483  64 313 318  11],618,5,30196,4.108299319727891,80.0,20.0
47350,4,7350,[183  98 173  79 135],618,4,30200,4.108284587131003,0.0,20.0
47351,4,7351,[143 603 427 222 483],698,2,30202,4.107997823721436,20.0,0.0
47352,4,7352,[ 64 483 313 318  11],618,5,30207,4.10811913504692,80.0,20.0
47353,4,7353,[ 64 483 313 318  11],618,5,30212,4.108240413380473,80.0,20.0
47354,4,7354,[121   9 204 423 111],314,5,30217,4.1083616587355545,0.0,0.0
47355,4,7355,[ 64 483 313 318  11],214,5,30222,4.108482871125612,80.0,20.0
47356,4,7356,[ 64 483 313 318  11],618,5,30227,4.108604050564089,80.0,20.0
47357,4,7357,[ 64 483 313 318  11],618,5,30232,4.10872519706442,80.0,20.0
47358,4,7358,[127 234 323 151 215],198,3,30235,4.108574534583504,0.0,0.0
47359,4,7359,[153 172 222 121  25],698,2,30237,4.108288043478261,0.0,0.0
47360,4,7360,[ 64 483 313 318  11],214,5,30242,4.108409183534846,80.0,20.0
47361,4,7361,[100 222 179 228 144],417,1,30243,4.107986960065199,0.0,0.0
47362,4,7362,[ 64 483 313 318  11],214,5,30248,4.108108108108108,80.0,20.0
47363,4,7363,[ 64 483 313 318  11],214,5,30253,4.108229223248235,80.0,20.0
47364,4,7364,[ 64 483 313 318  11],214,5,30258,4.108350305498981,80.0,20.0
47365,4,7365,[ 50 195 333 269 200],854,3,30261,4.108199837089329,0.0,20.0
47366,4,7366,[174 186  96 234  15],198,3,30264,4.108049409528981,0.0,0.0
47367,4,7367,[269 273  50 597 100],854,4,30268,4.108034744842563,0.0,20.0
47368,4,7368,[ 64 483 313 318  11],618,5,30273,4.108155787759533,80.0,20.0
47369,4,7369,[ 25  28 211 301 196],416,5,30278,4.108276797829037,0.0,0.0
47370,4,7370,[ 64 483 313 318  11],214,5,30283,4.108397775064442,80.0,20.0
47371,4,7371,[ 64 483 313 318  11],618,5,30288,4.10851871947911,80.0,20.0
47372,4,7372,[ 64 483 313 318  11],214,5,30293,4.108639631086397,80.0,20.0
47373,4,7373,[202 288 151  15 211],437,4,30297,4.108624898291294,0.0,20.0
47374,4,7374,[ 64 483 313 318  11],214,5,30302,4.108745762711864,80.0,20.0
47375,4,7375,[742  70  50  71 237],416,4,30306,4.108731019522777,0.0,20.0
47376,4,7376,[ 71  64 300 237 197],345,3,30309,4.108580723871492,20.0,0.0
47377,4,7377,[ 64 483 313 318  11],618,5,30314,4.108701545134183,80.0,20.0
47378,4,7378,[ 64 483 313 318  11],618,5,30319,4.108822333649546,80.0,20.0
47379,4,7379,[174 118 216 127 111],417,2,30321,4.1085365853658535,0.0,0.0
47380,4,7380,[ 64 483 313 318  11],618,5,30326,4.108657363500881,80.0,20.0
47381,4,7381,[100 257 268 153  56],297,4,30330,4.108642644269845,0.0,0.0
47382,4,7382,[ 64 483 313 318  11],618,5,30335,4.108763375321685,80.0,20.0
47383,4,7383,[ 98 228 176 195 196],198,2,30337,4.108477789815818,0.0,20.0
47384,4,7384,[ 64 483 313 318  11],618,5,30342,4.108598510494245,80.0,20.0
47385,4,7385,[ 64 483 313 318  11],214,5,30347,4.108719198483618,80.0,20.0
47386,4,7386,[238  71 568 228 405],230,2,30349,4.108433734939759,0.0,0.0
47387,4,7387,[ 64 423   4 748  70],198,1,30350,4.108012994044397,20.0,0.0
47388,4,7388,[ 79 135 174 185 245],297,3,30353,4.107863039653539,0.0,0.0
47389,4,7389,[ 64 483 313 318  11],618,5,30358,4.107983761840325,80.0,20.0
47390,4,7390,[475 151 742 289 100],416,2,30360,4.107698552293329,0.0,0.0
47391,4,7391,[ 64 483 313 318  11],214,5,30365,4.107819264069264,80.0,20.0
47392,4,7392,[282 204   8 742 151],314,5,30370,4.107939943189503,0.0,0.0
47393,4,7393,[ 64 483 313 318  11],214,5,30375,4.108060589667298,80.0,20.0
47394,4,7394,[ 64 483 313 318  11],214,5,30380,4.10818120351589,80.0,20.0
47395,4,7395,[  1 322 258  69  50],416,4,30384,4.108166576527853,0.0,20.0
47396,4,7396,[  9 174 168 173 568],805,2,30386,4.107881573610923,0.0,0.0
47397,4,7397,[181  25 187 168  12],416,5,30391,4.108002162746688,20.0,20.0
47398,4,7398,[ 64 483 313 318  11],214,5,30396,4.10812271928639,80.0,20.0
47399,4,7399,[161 471 655 111 197],416,5,30401,4.108243243243243,0.0,0.0
47400,4,7400,[258  25 496 118 357],416,4,30405,4.108228617754357,0.0,0.0
47401,4,7401,[ 64 483 313 318  11],214,5,30410,4.108349094839233,80.0,20.0
47402,4,7402,[ 64 483 313 318  11],618,5,30415,4.108469539375928,80.0,20.0
47403,4,7403,[144 294 195 204  97],230,3,30418,4.108319827120475,0.0,0.0
47404,4,7404,[ 64 483 313 318  11],618,5,30423,4.108440243079,80.0,20.0
47405,4,7405,[ 64 483 313 318  11],214,5,30428,4.108560626519038,80.0,20.0
47406,4,7406,[ 64 483 313 318  11],214,5,30433,4.10868097745376,80.0,20.0
47407,4,7407,[187  11   7 245 435],505,2,30435,4.108396328293736,0.0,0.0
47408,4,7408,[ 64 483 313 318  11],214,5,30440,4.108516668916183,80.0,20.0
47409,4,7409,[603 471 222 174 475],297,4,30444,4.108502024291498,0.0,0.0
47410,4,7410,[475 194 168 603 269],854,4,30448,4.108487383618945,0.0,0.0
47411,4,7411,[245 179  50 117  69],417,3,30451,4.108337830545062,0.0,20.0
47412,4,7412,[  9 144 597 238  50],805,2,30453,4.108053419668151,0.0,20.0
47413,4,7413,[268   9 222 322 742],708,1,30454,4.107634205557054,0.0,0.0
47414,4,7414,[234 210 546  56 385],416,4,30458,4.107619689817937,0.0,0.0
47415,4,7415,[ 64 483 313 318  11],214,5,30463,4.107740021574973,80.0,20.0
47416,4,7416,[ 22 216  96 748 185],416,5,30468,4.107860320884455,0.0,0.0
47417,4,7417,[ 64 483 313 318  11],214,5,30473,4.107980587759504,80.0,20.0
47418,4,7418,[ 64 483 313 318  11],618,5,30478,4.1081008222132365,80.0,20.0
47419,4,7419,[ 64 483 313 318  11],618,5,30483,4.10822102425876,80.0,20.0
47420,4,7420,[121  98 176  69 235],416,4,30487,4.1082064411804335,0.0,20.0
47421,4,7421,[ 50 475 168 269  12],416,4,30491,4.108191862031798,20.0,20.0
47422,4,7422,[294 195 125 174  64],601,2,30493,4.107907853967399,20.0,0.0
47423,4,7423,[ 64 483 313 318  11],618,5,30498,4.108028017241379,80.0,20.0
47424,4,7424,[ 64 483 313 318  11],618,5,30503,4.108148148148148,80.0,20.0
47425,4,7425,[ 64 483 313 318  11],214,5,30508,4.108268246700781,80.0,20.0
47426,4,7426,[ 64 483 313 318  11],214,5,30513,4.108388312912346,80.0,20.0
47427,4,7427,[471  70 191 175 204],297,2,30515,4.108104469574583,0.0,0.0
47428,4,7428,[ 12 216 357  15 175],342,3,30518,4.107955310270562,20.0,0.0
47429,4,7429,[ 64 483 313 318  11],618,5,30523,4.1080753701211306,80.0,20.0
47430,4,7430,[ 64 483 313 318  11],618,5,30528,4.1081953976584575,80.0,20.0
47431,4,7431,[191 172 269 385 100],416,5,30533,4.1083153928955864,0.0,0.0
47432,4,7432,[ 64 483 313 318  11],214,5,30538,4.108435355845554,80.0,20.0
47433,4,7433,[  7  97  50 289 405],416,4,30542,4.108420769437719,0.0,20.0
47434,4,7434,[258 216 173 191 322],721,3,30545,4.108271687962341,0.0,0.0
47435,4,7435,[195 276  56 275 423],62,4,30549,4.108257127487897,0.0,0.0
47436,4,7436,[ 64 483 313 318  11],618,5,30554,4.108377033750168,80.0,20.0
47437,4,7437,[ 64 483 313 318  11],214,5,30559,4.108496907770906,80.0,20.0
47438,4,7438,[655 197  56  11 151],805,3,30562,4.108347896222611,0.0,0.0
47439,4,7439,[ 64 483 313 318  11],214,5,30567,4.108467741935484,80.0,20.0
47440,4,7440,[  7 301  22  25 265],588,4,30571,4.108453164897191,0.0,0.0
47441,4,7441,[  8 200 179 210 195],416,4,30575,4.108438591776404,0.0,0.0
47442,4,7442,[161 127 357  96 216],416,5,30580,4.108558376998522,0.0,0.0
47443,4,7443,[ 64 483 313 318  11],618,5,30585,4.108678130037614,80.0,20.0
47444,4,7444,[181 265  97 483 185],711,4,30589,4.108663532572196,20.0,20.0
47445,4,7445,[125 216 200  96 568],262,1,30590,4.108246038141284,0.0,0.0
47446,4,7446,[ 64 483 313 318  11],618,5,30595,4.108365784879817,80.0,20.0
47447,4,7447,[423 508 268 273  79],854,4,30599,4.108351235230934,0.0,0.0
47448,4,7448,[ 64 483 313 318  11],618,5,30604,4.108470935696067,80.0,20.0
47449,4,7449,[172 215 200 286 568],345,4,30608,4.1084563758389265,0.0,0.0
47450,4,7450,[258 215  11  82 202],416,5,30613,4.1085760300630785,0.0,0.0
47451,4,7451,[181 211 302 179 153],416,4,30617,4.108561460010735,0.0,20.0
47452,4,7452,[678 151 183  79 144],297,1,30618,4.1081443713940695,0.0,0.0
47453,4,7453,[282 475 121  89 603],854,3,30621,4.107995707002951,0.0,0.0
47454,4,7454,[ 64 483 313 318  11],618,5,30626,4.1081153588195845,80.0,20.0
47455,4,7455,[ 64 483 313 318  11],214,5,30631,4.108234978540772,80.0,20.0
47456,4,7456,[276 215 742 318 328],62,2,30633,4.107952259621832,20.0,0.0
47457,4,7457,[ 64 483 313 318  11],618,5,30638,4.108071869133816,80.0,20.0
47458,4,7458,[ 64 483 313 318  11],618,5,30643,4.108191446574608,80.0,20.0
47459,4,7459,[ 64 483 313 318  11],618,5,30648,4.108310991957104,80.0,20.0
47460,4,7460,[275 423 121  22 273],62,4,30652,4.108296475003351,0.0,0.0
47461,4,7461,[ 64 483 313 318  11],214,5,30657,4.108415974269633,80.0,20.0
47462,4,7462,[ 64 483 313 318  11],618,5,30662,4.1085354415114566,80.0,20.0
47463,4,7463,[ 15  71 546 269   1],262,1,30663,4.108118971061093,0.0,0.0
47464,4,7464,[ 64 483 313 318  11],214,5,30668,4.108238446081715,80.0,20.0
47465,4,7465,[185 288 588 294 168],805,2,30670,4.107956067506027,0.0,20.0
47466,4,7466,[ 64 483 313 318  11],618,5,30675,4.108075532342306,80.0,20.0
47467,4,7467,[182 125 183 215 173],62,4,30679,4.108061060524906,0.0,0.0
47468,4,7468,[228 180 117 475 176],417,4,30683,4.108046592582675,0.0,0.0
47469,4,7469,[ 64 483 313 318  11],214,5,30688,4.108165997322624,80.0,20.0
47470,4,7470,[282 269  50 151 301],297,3,30691,4.108017668317494,0.0,20.0
47471,4,7471,[ 64 483 313 318  11],618,5,30696,4.10813704496788,80.0,20.0
47472,4,7472,[ 64 483 313 318  11],214,5,30701,4.108256389669477,80.0,20.0
47473,4,7473,[ 64 483 313 318  11],618,5,30706,4.108375702435108,80.0,20.0
47474,4,7474,[210  97 185 245 258],297,4,30710,4.108361204013378,0.0,0.0
47475,4,7475,[ 64 483 313 318  11],214,5,30715,4.108480470840021,80.0,20.0
47476,4,7476,[183 100 496 132 195],175,2,30717,4.108198475324328,0.0,0.0
47477,4,7477,[ 64 483 313 318  11],214,5,30722,4.108317732013908,80.0,20.0
47478,4,7478,[ 64 483 313 318  11],618,5,30727,4.108436956812408,80.0,20.0
47479,4,7479,[172 427 588 496 127],416,5,30732,4.10855614973262,0.0,0.0
47480,4,7480,[118 289 127 191  50],43,5,30737,4.108675310787328,0.0,20.0
47481,4,7481,[ 15 121  96  97  95],253,5,30742,4.108794439989308,0.0,0.0
47482,4,7482,[117 258 235 597 125],854,1,30743,4.108378992382734,0.0,0.0
47483,4,7483,[268  98 196 100 202],416,5,30748,4.108498129342598,0.0,20.0
47484,4,7484,[ 64 483 313 318  11],214,5,30753,4.108617234468938,80.0,20.0
47485,4,7485,[ 64 483 313 318  11],618,5,30758,4.108736307774512,80.0,20.0
47486,4,7486,[ 64 483 313 318  11],214,5,30763,4.108855349272072,80.0,20.0
47487,4,7487,[ 64 483 313 318  11],214,5,30768,4.108974358974359,80.0,20.0
47488,4,7488,[ 64 483 313 318  11],618,5,30773,4.109093336894111,80.0,20.0
47489,4,7489,[222 132   1 275 483],62,4,30777,4.109078771695594,20.0,0.0
47490,4,7490,[ 82 200  69 269   8],711,3,30780,4.1089307168602325,0.0,0.0
47491,4,7491,[202 168  25  95 294],43,5,30785,4.109049652963161,0.0,0.0
47492,4,7492,[ 64 483 313 318  11],618,5,30790,4.1091685573201655,80.0,20.0
47493,4,7493,[ 82  97 187 237 257],416,3,30793,4.109020549773152,0.0,0.0
47494,4,7494,[151 117 588 135 405],642,2,30795,4.108739159439627,0.0,0.0
47495,4,7495,[ 71 216 483  50 151],128,4,30799,4.108724653148346,20.0,20.0
47496,4,7496,[ 70 385 144 161  25],373,3,30802,4.108576764038949,0.0,0.0
47497,4,7497,[194 289   4 597  70],416,3,30805,4.108428914377167,0.0,0.0
47498,4,7498,[179 245 313  82 172],416,3,30808,4.10828110414722,20.0,20.0
47499,4,7499,[ 95 196 568 182 185],405,2,30810,4.108,0.0,0.0
47500,4,7500,[ 64 483 313 318  11],618,5,30815,4.10811891747767,80.0,20.0
47501,4,7501,[ 64 483 313 318  11],618,5,30820,4.108237803252466,80.0,20.0
47502,4,7502,[ 64 483 313 318  11],618,5,30825,4.108356657337065,80.0,20.0
47503,4,7503,[ 64 483 313 318  11],618,5,30830,4.108475479744136,80.0,20.0
47504,4,7504,[ 64 483 313 318  11],618,5,30835,4.108594270486343,80.0,20.0
47505,4,7505,[ 97 216 423 191 172],642,3,30838,4.108446576072476,0.0,0.0
47506,4,7506,[204 257 181 135  50],642,4,30842,4.108432130011988,0.0,40.0
47507,4,7507,[ 64 483 313 318  11],214,5,30847,4.108550879062333,80.0,20.0
47508,4,7508,[ 64 483 313 318  11],618,5,30852,4.108669596484219,80.0,20.0
47509,4,7509,[204 269  50 216 238],751,4,30856,4.108655126498003,0.0,20.0
47510,4,7510,[151 111 121 288 228],417,1,30857,4.10824124617228,0.0,20.0
47511,4,7511,[238  96 276 597 546],62,4,30861,4.108226837060703,0.0,0.0
47512,4,7512,[ 64 483 313 318  11],618,5,30866,4.108345534407028,80.0,20.0
47513,4,7513,[ 64 483 313 318  11],618,5,30871,4.108464200159702,80.0,20.0
47514,4,7514,[ 64 483 313 318  11],618,5,30876,4.1085828343313375,80.0,20.0
47515,4,7515,[ 64 483 313 318  11],618,5,30881,4.10870143693454,80.0,20.0
47516,4,7516,[ 64 483 313 318  11],214,5,30886,4.108820007981907,80.0,20.0
47517,4,7517,[ 82   1  50  70 257],43,5,30891,4.108938547486034,0.0,20.0
47518,4,7518,[ 82  25 125 197 403],416,5,30896,4.109057055459503,0.0,0.0
47519,4,7519,[ 64 483 313 318  11],214,5,30901,4.109175531914894,80.0,20.0
47520,4,7520,[ 64 483 313 318  11],618,5,30906,4.1092939768647785,80.0,20.0
47521,4,7521,[ 64 483 313 318  11],618,5,30911,4.109412390321723,80.0,20.0
47522,4,7522,[ 64 483 313 318  11],214,5,30916,4.109530772298285,80.0,20.0
47523,4,7523,[405 132 176 471 185],416,5,30921,4.109649122807017,0.0,0.0
47524,4,7524,[200 275 151 143 176],437,4,30925,4.1096345514950166,0.0,0.0
47525,4,7525,[742 121 282  28 568],416,5,30930,4.109752856763221,0.0,0.0
47526,4,7526,[282 117 161 508  11],314,4,30934,4.1097382755413845,0.0,0.0
47527,4,7527,[ 64 483 313 318  11],214,5,30939,4.109856535600425,80.0,20.0
47528,4,7528,[ 64 483 313 318  11],214,5,30944,4.10997476424492,80.0,20.0
47529,4,7529,[385 186  64 508 268],417,4,30948,4.10996015936255,20.0,0.0
47530,4,7530,[ 64 483 313 318  11],618,5,30953,4.1100783428495555,80.0,20.0
47531,4,7531,[405   4 302 742 179],417,1,30954,4.109665427509293,0.0,0.0
47532,4,7532,[182 215 186 181  70],405,3,30957,4.109518120270809,0.0,20.0
47533,4,7533,[ 15 210 257  97 546],417,2,30959,4.109238120520308,0.0,0.0
47534,4,7534,[ 56  64  12 258 268],345,5,30964,4.109356337093564,40.0,0.0
47535,4,7535,[603 435 132  69 179],373,3,30967,4.109209129511678,0.0,0.0
47536,4,7536,[742  70  50 288 655],417,2,30969,4.108929282207775,0.0,40.0
47537,4,7537,[ 64 483 313 318  11],214,5,30974,4.109047492703635,80.0,20.0
47538,4,7538,[ 64 483 313 318  11],618,5,30979,4.109165671839767,80.0,20.0
47539,4,7539,[ 64 483 313 318  11],214,5,30984,4.109283819628647,80.0,20.0
47540,4,7540,[ 64 483 313 318  11],214,5,30989,4.109401936082747,80.0,20.0
47541,4,7541,[ 64 483 313 318  11],618,5,30994,4.109520021214532,80.0,20.0
47542,4,7542,[ 64 483 313 318  11],214,5,30999,4.109638075036457,80.0,20.0
47543,4,7543,[ 64 483 313 318  11],618,5,31004,4.109756097560975,80.0,20.0
47544,4,7544,[276 117 245 176 496],416,3,31007,4.10960901259112,0.0,0.0
47545,4,7545,[ 64 483 313 318  11],618,5,31012,4.109727007686192,80.0,20.0
47546,4,7546,[ 64 483 313 318  11],618,5,31017,4.109844971511859,80.0,20.0
47547,4,7547,[ 64 483 313 318  11],618,5,31022,4.109962904080551,80.0,20.0
47548,4,7548,[ 64 483 313 318  11],618,5,31027,4.11008080540469,80.0,20.0
47549,4,7549,[125 235 288  82 588],642,3,31030,4.109933774834437,0.0,20.0
47550,4,7550,[ 64 483 313 318  11],214,5,31035,4.11005164878824,80.0,20.0
47551,4,7551,[ 50 328  98 132 118],62,3,31038,4.109904661016949,0.0,40.0
47552,4,7552,[ 64 483 313 318  11],214,5,31043,4.110022507612869,80.0,20.0
47553,4,7553,[258  95 144  25 228],417,2,31045,4.10974318241991,0.0,0.0
47554,4,7554,[ 64 483 313 318  11],214,5,31050,4.1098610191925875,80.0,20.0
47555,4,7555,[ 64 483 313 318  11],214,5,31055,4.1099788247750135,80.0,20.0
47556,4,7556,[180 286 168  70  69],373,3,31058,4.109831943893079,0.0,0.0
47557,4,7557,[ 88 144 182 269 168],416,4,31062,4.1098174120137605,0.0,0.0
47558,4,7558,[ 64 483 313 318  11],618,5,31067,4.109935176610663,80.0,20.0
47559,4,7559,[  8 204 186  12 182],618,3,31070,4.10978835978836,20.0,0.0
47560,4,7560,[318 181 200  95 237],262,1,31071,4.1093770665255915,20.0,20.0
47561,4,7561,[588 196 111 286 269],297,4,31075,4.109362602486115,0.0,0.0
47562,4,7562,[ 12 222  98 172 289],588,2,31077,4.109083696945657,20.0,20.0
47563,4,7563,[ 64 483 313 318  11],214,5,31082,4.109201480698044,80.0,20.0
47564,4,7564,[ 64 483 313 318  11],214,5,31087,4.109319233311302,80.0,20.0
47565,4,7565,[ 64 483 313 318  11],214,5,31092,4.109436954797779,80.0,20.0
47566,4,7566,[235 268 258 132 405],417,3,31095,4.109290339632615,0.0,0.0
47567,4,7567,[475 174 258  25   1],805,3,31098,4.109143763213531,0.0,0.0
47568,4,7568,[471 111 151 210 300],297,1,31099,4.108732989826926,0.0,0.0
47569,4,7569,[ 64 483 313 318  11],618,5,31104,4.10885072655218,80.0,20.0
47570,4,7570,[ 64 483 313 318  11],214,5,31109,4.1089684321754065,80.0,20.0
47571,4,7571,[ 64 483 313 318  11],618,5,31114,4.1090861067089275,80.0,20.0
47572,4,7572,[237 282  25 215 742],297,2,31116,4.108807605968573,0.0,0.0
47573,4,7573,[ 95  71 427 238 385],198,2,31118,4.108529178769475,0.0,0.0
47574,4,7574,[200 238 181 216 174],437,5,31123,4.1086468646864684,0.0,20.0
47575,4,7575,[118 323 125 357 191],416,3,31126,4.108500527983105,0.0,0.0
47576,4,7576,[318 181 275 471 172],618,3,31129,4.108354229906295,20.0,20.0
47577,4,7577,[ 64 483 313 318  11],618,5,31134,4.108471892319874,80.0,20.0
47578,4,7578,[ 64 483 313 318  11],618,5,31139,4.108589523683864,80.0,20.0
47579,4,7579,[ 64 483 313 318  11],214,5,31144,4.108707124010554,80.0,20.0
47580,4,7580,[143 403  71 546   1],49,0,31144,4.108165149716396,0.0,0.0
47581,4,7581,[ 64 483 313 318  11],618,5,31149,4.108282774993405,80.0,20.0
47582,4,7582,[ 79 196 276 176  50],416,4,31153,4.108268495318476,0.0,20.0
47583,4,7583,[  9 181  82 127 282],416,5,31158,4.108386075949367,0.0,20.0
47584,4,7584,[276  50 258 181  97],416,4,31162,4.108371786420567,0.0,40.0
47585,4,7585,[ 64 483 313 318  11],214,5,31167,4.108489322436067,80.0,20.0
47586,4,7586,[100 135 597 271 357],62,3,31170,4.108343218663503,0.0,0.0
47587,4,7587,[742 196 357  79  25],805,3,31173,4.108197153400106,0.0,0.0
47588,4,7588,[ 64 483 313 318  11],214,5,31178,4.108314665963895,80.0,20.0
47589,4,7589,[132  11 318 423 211],437,4,31182,4.108300395256917,20.0,0.0
47590,4,7590,[ 64 483 313 318  11],214,5,31187,4.108417863259123,80.0,20.0
47591,4,7591,[  4 202 385 258  64],345,3,31190,4.10827186512118,20.0,0.0
47592,4,7592,[ 64 483 313 318  11],618,5,31195,4.108389305939681,80.0,20.0
47593,4,7593,[ 82 172 210  64 182],417,3,31198,4.1082433500131685,20.0,0.0
47594,4,7594,[282 135 200 183 748],297,2,31200,4.107965766951942,0.0,0.0
47595,4,7595,[ 69 288 475 180 181],62,4,31204,4.107951553449184,0.0,40.0
47596,4,7596,[ 64 483 313 318  11],214,5,31209,4.108068974595235,80.0,20.0
47597,4,7597,[ 64 483 313 318  11],214,5,31214,4.108186364832851,80.0,20.0
47598,4,7598,[288 216 179 245 289],721,2,31216,4.107908935386235,0.0,20.0
47599,4,7599,[ 64 483 313 318  11],618,5,31221,4.108026315789473,80.0,20.0
47600,4,7600,[ 28 202 678  25 323],416,3,31224,4.107880542033943,0.0,0.0
47601,4,7601,[ 64 483 313 318  11],618,5,31229,4.107997895290713,80.0,20.0
47602,4,7602,[276 118 300  12 289],416,2,31231,4.10772063659082,20.0,0.0
47603,4,7603,[234  96  25 187  69],416,5,31236,4.107837980010521,0.0,0.0
47604,4,7604,[  9 237 196 195 215],618,3,31239,4.107692307692307,0.0,0.0
47605,4,7605,[318 118 475  88 313],588,3,31242,4.107546673678675,40.0,20.0
47606,4,7606,[ 64 483 313 318  11],214,5,31247,4.107663993690022,80.0,20.0
47607,4,7607,[ 64 483 313 318  11],618,5,31252,4.107781282860147,80.0,20.0
47608,4,7608,[748 182 202 200 508],297,1,31253,4.107372847943225,0.0,0.0
47609,4,7609,[ 64 483 313 318  11],618,5,31258,4.107490144546649,80.0,20.0
47610,4,7610,[ 64 483 313 318  11],214,5,31263,4.107607410327158,80.0,20.0
47611,4,7611,[ 64 483 313 318  11],214,5,31268,4.1077246452969,80.0,20.0
47612,4,7612,[483 174 151 132 568],62,4,31272,4.10771049520557,20.0,0.0
47613,4,7613,[588   7 176   1 185],805,4,31276,4.107696348831101,0.0,0.0
47614,4,7614,[ 64 483 313 318  11],214,5,31281,4.107813525935653,80.0,20.0
47615,4,7615,[153 179 176 235 568],62,4,31285,4.107799369747899,0.0,0.0
47616,4,7616,[ 64 483 313 318  11],214,5,31290,4.107916502560063,80.0,20.0
47617,4,7617,[ 64 483 313 318  11],214,5,31295,4.108033604620635,80.0,20.0
47618,4,7618,[ 64 483 313 318  11],618,5,31300,4.108150675941725,80.0,20.0
47619,4,7619,[ 64 483 313 318  11],618,5,31305,4.108267716535433,80.0,20.0
47620,4,7620,[ 64 483 313 318  11],618,5,31310,4.108384726413856,80.0,20.0
47621,4,7621,[ 64 483 313 318  11],214,5,31315,4.1085017055890845,80.0,20.0
47622,4,7622,[187 655 435  79 228],373,4,31319,4.108487472123835,0.0,0.0
47623,4,7623,[ 71 125 172  89   9],62,5,31324,4.1086044071353625,0.0,0.0
47624,4,7624,[ 64 483 313 318  11],214,5,31329,4.10872131147541,80.0,20.0
47625,4,7625,[ 64 483 313 318  11],214,5,31334,4.108838185156045,80.0,20.0
47626,4,7626,[268  11 508 183 174],417,3,31337,4.108692801888029,0.0,0.0
47627,4,7627,[191 210 405 100 215],62,3,31340,4.108547456738332,0.0,0.0
47628,4,7628,[ 64 483 313 318  11],214,5,31345,4.108664307248657,80.0,20.0
47629,4,7629,[ 64 483 313 318  11],214,5,31350,4.108781127129751,80.0,20.0
47630,4,7630,[ 64 483 313 318  11],214,5,31355,4.108897916393658,80.0,20.0
47631,4,7631,[ 64 483 313 318  11],214,5,31360,4.109014675052411,80.0,20.0
47632,4,7632,[ 64 483 313 318  11],618,5,31365,4.10913140311804,80.0,20.0
47633,4,7633,[655 748 588 471  82],373,2,31367,4.108855121823422,0.0,0.0
47634,4,7634,[ 64 483 313 318  11],214,5,31372,4.108971840209561,80.0,20.0
47635,4,7635,[286 127  64 117 471],416,5,31377,4.109088528025144,20.0,0.0
47636,4,7636,[121  95 496 222 313],654,5,31382,4.109205185282179,20.0,20.0
47637,4,7637,[121 271 269 196 211],43,4,31386,4.109190887666928,0.0,0.0
47638,4,7638,[ 64 483 313 318  11],618,5,31391,4.109307500981804,80.0,20.0
47639,4,7639,[ 64 483 313 318  11],214,5,31396,4.109424083769634,80.0,20.0
47640,4,7640,[ 64 483 313 318  11],214,5,31401,4.109540636042403,80.0,20.0
47641,4,7641,[ 64 483 313 318  11],214,5,31406,4.109657157812091,80.0,20.0
47642,4,7642,[ 64 483 313 318  11],214,5,31411,4.1097736490906716,80.0,20.0
47643,4,7643,[ 64 483 313 318  11],618,5,31416,4.1098901098901095,80.0,20.0
47644,4,7644,[ 64 483 313 318  11],618,5,31421,4.1100065402223676,80.0,20.0
47645,4,7645,[496 228  71 196 423],373,4,31425,4.109992152759613,0.0,0.0
47646,4,7646,[196 427   1 423 185],416,5,31430,4.110108539296456,0.0,0.0
47647,4,7647,[173 151 135 405 257],642,2,31432,4.109832635983263,0.0,0.0
47648,4,7648,[ 64 483 313 318  11],618,5,31437,4.109949012942868,80.0,20.0
47649,4,7649,[ 64 483 313 318  11],618,5,31442,4.110065359477124,80.0,20.0
47650,4,7650,[275  50 117 180 435],373,4,31446,4.110050973728924,0.0,20.0
47651,4,7651,[ 64 483 313 318  11],618,5,31451,4.110167276529012,80.0,20.0
47652,4,7652,[ 64 483 313 318  11],618,5,31456,4.110283548935058,80.0,20.0
47653,4,7653,[ 69 181 174 238 153],417,2,31458,4.110007839038412,0.0,20.0
47654,4,7654,[ 64 483 313 318  11],618,5,31463,4.110124101894187,80.0,20.0
47655,4,7655,[ 64 483 313 318  11],214,5,31468,4.110240334378266,80.0,20.0
47656,4,7656,[ 64 483 313 318  11],618,5,31473,4.110356536502547,80.0,20.0
47657,4,7657,[118 196  28 471 197],618,2,31475,4.110080961086446,0.0,0.0
47658,4,7658,[185  25 173 168 257],416,4,31479,4.110066588327458,0.0,0.0
47659,4,7659,[238 269 471  71 403],345,2,31481,4.1097911227154045,0.0,0.0
47660,4,7660,[ 22 144 357 322 245],416,3,31484,4.109646260279337,0.0,0.0
47661,4,7661,[ 95 237 179 269 268],416,2,31486,4.109370921430436,0.0,0.0
47662,4,7662,[603   8 216 286 588],416,5,31491,4.1094871460263604,0.0,0.0
47663,4,7663,[ 64 483 313 318  11],618,5,31496,4.109603340292275,80.0,20.0
47664,4,7664,[ 64 483 313 318  11],214,5,31501,4.1097195042400525,80.0,20.0
47665,4,7665,[ 64 483 313 318  11],214,5,31506,4.109835637881555,80.0,20.0
47666,4,7666,[117 588 135 176 180],437,2,31508,4.109560453893309,0.0,0.0
47667,4,7667,[ 64 483 313 318  11],214,5,31513,4.109676577986437,80.0,20.0
47668,4,7668,[323  70  50  97 318],721,3,31516,4.109531881601252,20.0,20.0
47669,4,7669,[ 64 483 313 318  11],214,5,31521,4.109647979139504,80.0,20.0
47670,4,7670,[ 64 483 313 318  11],618,5,31526,4.109764046408552,80.0,20.0
47671,4,7671,[185  11 235   7  95],805,2,31528,4.109489051094891,0.0,0.0
47672,4,7672,[100 568 195 216 179],373,3,31531,4.109344454580999,0.0,0.0
47673,4,7673,[117 515 202 222  69],417,3,31534,4.10919989575189,0.0,0.0
47674,4,7674,[ 95 385 195 117 322],416,3,31537,4.109055374592834,0.0,0.0
47675,4,7675,[ 64 483 313 318  12],214,5,31542,4.109171443460135,100.0,20.0
47676,4,7676,[174 132 204 143 173],601,3,31545,4.109026963657679,0.0,0.0
47677,4,7677,[ 50 144 276 257 174],416,3,31548,4.108882521489972,0.0,20.0
47678,4,7678,[333 568 265 282 475],416,4,31552,4.1088683422320615,0.0,0.0
47679,4,7679,[238 322 546  88 603],416,2,31554,4.10859375,0.0,0.0
47680,4,7680,[153 143 597 183 546],416,3,31557,4.108449420648353,0.0,0.0
47681,4,7681,[185 276  25 197 313],416,4,31561,4.108435303306431,20.0,20.0
47682,4,7682,[302 289 588  15 153],43,5,31566,4.108551347130027,0.0,0.0
47683,4,7683,[153 237 302  95 597],416,2,31568,4.108276939094222,0.0,0.0
47684,4,7684,[196 238 151  50 475],417,4,31572,4.108262849707222,0.0,20.0
47685,4,7685,[ 69 238  98  97 180],198,3,31575,4.108118657298985,0.0,20.0
47686,4,7686,[ 64 183 196 496 405],417,3,31578,4.107974502406661,20.0,0.0
47687,4,7687,[100 271  95 196  98],297,3,31581,4.107830385015609,0.0,20.0
47688,4,7688,[ 69 258 546 100  70],62,4,31585,4.107816361035245,0.0,0.0
47689,4,7689,[186 127 357 144 475],417,4,31589,4.107802340702211,0.0,0.0
47690,4,7690,[471 300 238 127 322],416,4,31593,4.1077883240150825,0.0,0.0
47691,4,7691,[357 127   7 546 323],417,2,31595,4.1075143005720225,0.0,0.0
47692,4,7692,[ 64 483 313 318  12],618,5,31600,4.107630313271805,100.0,20.0
47693,4,7693,[294 257 276 204 151],43,5,31605,4.107746295814921,0.0,0.0
47694,4,7694,[ 64 483 313 318  12],214,5,31610,4.1078622482131255,100.0,20.0
47695,4,7695,[403  97 100 471 173],373,1,31611,4.10745841995842,0.0,0.0
47696,4,7696,[ 88 678  82 172 121],541,2,31613,4.107184617383396,0.0,0.0
47697,4,7697,[ 64 483 313 318  12],214,5,31618,4.107300597557807,100.0,20.0
47698,4,7698,[ 64 483 313 318  12],618,5,31623,4.107416547603585,100.0,20.0
47699,4,7699,[173 288 268  12 318],314,4,31627,4.107402597402597,40.0,20.0
47700,4,7700,[ 64 483 313 318  12],618,5,31632,4.107518504090378,100.0,20.0
47701,4,7701,[ 64 483 313 318  12],214,5,31637,4.107634380680342,100.0,20.0
47702,4,7702,[ 89 568 357 210 132],417,3,31640,4.107490588082565,0.0,0.0
47703,4,7703,[ 64 483 313 318  12],214,5,31645,4.107606438213915,100.0,20.0
47704,4,7704,[ 64 483 313 318  12],618,5,31650,4.107722258273848,100.0,20.0
47705,4,7705,[ 64 483 313 318  12],618,5,31655,4.107838048274072,100.0,20.0
47706,4,7706,[385 183 322 273  15],417,3,31658,4.10769430387959,0.0,0.0
47707,4,7707,[ 64 483 313 318  12],214,5,31663,4.107810067462377,100.0,20.0
47708,4,7708,[117 483 127 100 125],62,5,31668,4.107925801011804,20.0,0.0
47709,4,7709,[ 64 483 313 318  12],618,5,31673,4.108041504539559,100.0,20.0
47710,4,7710,[282 471 268  97 143],907,5,31678,4.10815717805732,0.0,0.0
47711,4,7711,[183 322 121 222 271],805,2,31680,4.1078838174273855,0.0,0.0
47712,4,7712,[ 79 678 216 144   7],416,4,31684,4.107869830156878,0.0,0.0
47713,4,7713,[405 186 185 258   4],854,3,31687,4.107726212081929,0.0,0.0
47714,4,7714,[265  70 143  11  69],405,3,31690,4.1075826312378485,0.0,0.0
47715,4,7715,[ 64 483 313 318  12],618,5,31695,4.1076982892690515,100.0,20.0
47716,4,7716,[ 64 483 313 318  12],618,5,31700,4.107813917325386,100.0,20.0
47717,4,7717,[294 215   9 182  56],416,5,31705,4.107929515418502,0.0,0.0
47718,4,7718,[313 181 161   8 302],49,1,31706,4.10752688172043,20.0,40.0
47719,4,7719,[508 322 197 172 258],128,2,31708,4.107253886010363,0.0,0.0
47720,4,7720,[ 79 655 742 282  97],416,5,31713,4.10736951172128,0.0,0.0
47721,4,7721,[ 64 483 313 318  12],618,5,31718,4.1074851074851075,100.0,20.0
47722,4,7722,[597  98 179 322 269],805,3,31721,4.107341706590703,0.0,20.0
47723,4,7723,[168 496  56 475  22],416,4,31725,4.107327809425168,0.0,0.0
47724,4,7724,[ 64 483 313 318  12],618,5,31730,4.107443365695793,100.0,20.0
47725,4,7725,[  1 222 269 175 294],854,3,31733,4.107300025886617,0.0,0.0
47726,4,7726,[ 79 275 288  97  12],588,3,31736,4.107156723178465,20.0,20.0
47727,4,7727,[ 64 483 313 318  12],214,5,31741,4.107272256728779,100.0,20.0
47728,4,7728,[ 64 483 313 318  12],214,5,31746,4.107387760382974,100.0,20.0
47729,4,7729,[ 12 318 132  64  82],601,3,31749,4.1072445019404915,60.0,0.0
47730,4,7730,[ 64 483 313 318  11],214,5,31754,4.107359979304101,80.0,20.0
47731,4,7731,[ 71 423 237 588 742],128,4,31758,4.107346094154164,0.0,0.0
47732,4,7732,[ 64 483 313 318  11],214,5,31763,4.10746152851416,80.0,20.0
47733,4,7733,[ 64 483 313 318  11],618,5,31768,4.107576933023015,80.0,20.0
47734,4,7734,[235 195 211 471 215],297,1,31769,4.107175177763413,0.0,0.0
47735,4,7735,[ 64 483 313 318  11],618,5,31774,4.107290589451913,80.0,20.0
47736,4,7736,[ 79 568 111 132 328],416,5,31779,4.107405971306708,0.0,0.0
47737,4,7737,[125 483 191 132  96],62,5,31784,4.107521323339364,20.0,0.0
47738,4,7738,[181 211 191 185 655],354,2,31786,4.107248998578628,0.0,20.0
47739,4,7739,[403 118 597 100 322],416,2,31788,4.1069767441860465,0.0,0.0
47740,4,7740,[ 64 483 313 318  11],618,5,31793,4.1070921069629245,80.0,20.0
47741,4,7741,[ 64 483 313 318  11],214,5,31798,4.1072074399380005,80.0,20.0
47742,4,7742,[ 64 483 313 318  11],214,5,31803,4.107322743122821,80.0,20.0
47743,4,7743,[ 64 483 313 318  11],214,5,31808,4.107438016528926,80.0,20.0
47744,4,7744,[ 64 483 313 318  11],214,5,31813,4.10755326016785,80.0,20.0
47745,4,7745,[258 405 475 597 181],805,1,31814,4.107152078492125,0.0,20.0
47746,4,7746,[ 64 483 313 318  11],618,5,31819,4.107267329288757,80.0,20.0
47747,4,7747,[ 64 483 313 318  11],618,5,31824,4.10738255033557,80.0,20.0
47748,4,7748,[  8 405 132 357 328],416,5,31829,4.107497741644083,0.0,0.0
47749,4,7749,[ 28 121 111   1 427],416,5,31834,4.107612903225807,0.0,0.0
47750,4,7750,[423 132 172 174 268],417,3,31837,4.107470003870469,0.0,0.0
47751,4,7751,[202 385 215 216 132],373,2,31839,4.107198142414861,0.0,0.0
47752,4,7752,[ 64 483 313 318  11],618,5,31844,4.1073132980781635,80.0,20.0
47753,4,7753,[ 64 483 313 318  11],618,5,31849,4.107428424039205,80.0,20.0
47754,4,7754,[204 191 175 475 257],342,4,31853,4.107414571244359,0.0,0.0
47755,4,7755,[196 265 127  95 111],417,3,31856,4.107271789582259,0.0,0.0
47756,4,7756,[234   7 185 172 748],805,4,31860,4.10725796055176,0.0,0.0
47757,4,7757,[471 174 237 234 268],588,3,31863,4.107115235885537,0.0,0.0
47758,4,7758,[ 64 483 313 318  11],618,5,31868,4.107230313184688,80.0,20.0
47759,4,7759,[271 257 173 294 475],297,2,31870,4.106958762886598,0.0,0.0
47760,4,7760,[  8 423 216 258  79],297,3,31873,4.10681613194176,0.0,0.0
47761,4,7761,[ 64 483 313 318  11],214,5,31878,4.106931203298119,80.0,20.0
47762,4,7762,[269 118  28 176 568],805,2,31880,4.106659796470437,0.0,0.0
47763,4,7763,[318 588 173 186  79],618,4,31884,4.106646058732612,20.0,0.0
47764,4,7764,[ 64 483 313 318  11],214,5,31889,4.1067611075338055,80.0,20.0
47765,4,7765,[ 64 483 313 318  11],618,5,31894,4.106876126706155,80.0,20.0
47766,4,7766,[546 127 588 179  82],805,1,31895,4.106476116904854,0.0,0.0
47767,4,7767,[196  70 282 568  71],314,3,31898,4.1063336766220395,0.0,0.0
47768,4,7768,[ 64 483 313 318  11],618,5,31903,4.10644870639722,80.0,20.0
47769,4,7769,[ 69 357 174 195  82],405,5,31908,4.106563706563707,0.0,0.0
47770,4,7770,[ 64 483 313 318  11],214,5,31913,4.10667867713293,80.0,20.0
47771,4,7771,[ 64 483 313 318  11],618,5,31918,4.106793618116315,80.0,20.0
47772,4,7772,[ 64 483 313 318  11],214,5,31923,4.106908529525279,80.0,20.0
47773,4,7773,[ 98 117  97  79 313],505,4,31927,4.1068947774633395,20.0,40.0
47774,4,7774,[ 64 483 313 318  11],618,5,31932,4.1070096463022505,80.0,20.0
47775,4,7775,[ 64 483 313 318  11],618,5,31937,4.1071244855967075,80.0,20.0
47776,4,7776,[  7 237 245 475 257],297,3,31940,4.106982126784107,0.0,0.0
47777,4,7777,[269 508 302 515 288],297,4,31944,4.1069683723322195,0.0,20.0
47778,4,7778,[118 257 276 275  22],62,3,31947,4.10682607018897,0.0,0.0
47779,4,7779,[245 423   1 211 117],417,5,31952,4.10694087403599,0.0,0.0
47780,4,7780,[117  11 238  56 508],24,5,31957,4.107055648374245,0.0,0.0
47781,4,7781,[ 64 483 313 318  11],214,5,31962,4.107170393215112,80.0,20.0
47782,4,7782,[ 64 483 313 318  11],618,5,31967,4.10728510856996,80.0,20.0
47783,4,7783,[185  11 268 357 328],416,5,31972,4.107399794450155,0.0,0.0
47784,4,7784,[132  64 427  25 176],198,4,31976,4.107385998715478,20.0,0.0
47785,4,7785,[257  96 183  69 153],62,4,31980,4.1073722065245315,0.0,0.0
47786,4,7786,[132 496 423 475 403],588,1,31981,4.106973160395531,0.0,0.0
47787,4,7787,[ 64 483 313 318  11],618,5,31986,4.1070878274268106,80.0,20.0
47788,4,7788,[ 64 483 313 318  11],214,5,31991,4.1072024650147645,80.0,20.0
47789,4,7789,[678 508 245 333 742],345,2,31993,4.106931964056483,0.0,0.0
47790,4,7790,[ 64 483 313 318  11],214,5,31998,4.107046592221795,80.0,20.0
47791,4,7791,[151 179 328 508 204],62,3,32001,4.106904517453799,0.0,0.0
47792,4,7792,[ 64 483 313 318  11],618,5,32006,4.107019119722828,80.0,20.0
47793,4,7793,[ 95 235 228 403 405],417,2,32008,4.106748781113677,0.0,0.0
47794,4,7794,[ 71  11 187  98 210],198,4,32012,4.106735086593971,0.0,20.0
47795,4,7795,[ 64 483 313 318  11],214,5,32017,4.106849666495639,80.0,20.0
47796,4,7796,[ 64 483 313 318  11],618,5,32022,4.106964217006541,80.0,20.0
47797,4,7797,[ 64 483 313 318  11],618,5,32027,4.107078738137984,80.0,20.0
47798,4,7798,[ 64 483 313 318  11],214,5,32032,4.107193229901269,80.0,20.0
47799,4,7799,[ 64 483 313 318  11],214,5,32037,4.1073076923076925,80.0,20.0
47800,4,7800,[111 125 222  69   7],588,0,32037,4.106781181899756,0.0,0.0
47801,4,7801,[ 64 483 313 318  11],618,5,32042,4.106895667777493,80.0,20.0
47802,4,7802,[ 64 483 313 318  11],618,5,32047,4.107010124311162,80.0,20.0
47803,4,7803,[ 64 483 313 318  11],618,5,32052,4.107124551512045,80.0,20.0
47804,4,7804,[ 82  95 204  22 423],373,3,32055,4.10698270339526,0.0,0.0
47805,4,7805,[  1  98 288 121  11],345,2,32057,4.106712785037151,0.0,40.0
47806,4,7806,[294 135 222  96   9],854,3,32060,4.106571026002306,0.0,0.0
47807,4,7807,[127 483 597 185 357],854,4,32064,4.10655737704918,20.0,0.0
47808,4,7808,[742 323 127 588 196],417,2,32066,4.10628761685235,0.0,0.0
47809,4,7809,[302 328  50 471 191],416,5,32071,4.1064020486555695,0.0,20.0
47810,4,7810,[ 96 117 403 182 186],618,4,32075,4.106388426577903,0.0,0.0
47811,4,7811,[ 64 483 313 318  11],214,5,32080,4.106502816180235,80.0,20.0
47812,4,7812,[568 132 655 174 496],262,2,32082,4.106233201075131,0.0,0.0
47813,4,7813,[ 71   1 216 234 238],262,2,32084,4.105963654978244,0.0,0.0
47814,4,7814,[181  79 427 273  95],618,4,32088,4.105950095969289,0.0,20.0
47815,4,7815,[174  69  95 403 216],642,4,32092,4.105936540429887,0.0,0.0
47816,4,7816,[168 215 191  97 265],618,5,32097,4.1060509146731485,0.0,0.0
47817,4,7817,[ 64 483 313 318  11],618,5,32102,4.106165259657201,80.0,20.0
47818,4,7818,[211 194 186 187 179],405,2,32104,4.10589589461568,0.0,0.0
47819,4,7819,[385 546 322 216 238],416,3,32107,4.105754475703325,0.0,0.0
47820,4,7820,[276 143  22 173 655],618,3,32110,4.105613092954865,0.0,0.0
47821,4,7821,[ 64 483 313 318  11],214,5,32115,4.1057274354385065,80.0,20.0
47822,4,7822,[ 64 483 313 318  11],214,5,32120,4.105841748689761,80.0,20.0
47823,4,7823,[ 64 483 313 318  11],214,5,32125,4.105956032719837,80.0,20.0
47824,4,7824,[ 64 483 313 318  11],214,5,32130,4.106070287539936,80.0,20.0
47825,4,7825,[ 64 483 313 318  11],214,5,32135,4.106184513161257,80.0,20.0
47826,4,7826,[ 64 483 313 318  11],618,5,32140,4.106298709594991,80.0,20.0
47827,4,7827,[286 121  50  79 403],345,2,32142,4.1060296371997955,0.0,20.0
47828,4,7828,[121 191  97  98 174],62,4,32146,4.106016094009452,0.0,20.0
47829,4,7829,[ 64 483 313 318  11],214,5,32151,4.106130268199234,80.0,20.0
47830,4,7830,[144  71 222   8 172],62,4,32155,4.106116715617418,0.0,0.0
47831,4,7831,[173  69 405 678 172],921,4,32159,4.106103166496425,0.0,0.0
47832,4,7832,[ 64 483 313 318  11],618,5,32164,4.106217285841951,80.0,20.0
47833,4,7833,[ 64 483 313 318  11],214,5,32169,4.1063313760531015,80.0,20.0
47834,4,7834,[ 64 483 313 318  11],214,5,32174,4.1064454371410335,80.0,20.0
47835,4,7835,[ 69  15 135 182 357],198,4,32178,4.106431852986217,0.0,0.0
47836,4,7836,[483  50 257  11  15],854,3,32181,4.106290672451193,20.0,20.0
47837,4,7837,[405  15 191  82 117],705,3,32184,4.106149527940802,0.0,0.0
47838,4,7838,[496  71 276 121  95],654,3,32187,4.106008419441255,0.0,0.0
47839,4,7839,[ 69 483 313 655 121],588,3,32190,4.105867346938775,40.0,20.0
47840,4,7840,[ 64 483 313 318  11],618,5,32195,4.10598137992603,80.0,20.0
47841,4,7841,[ 64 483 313 318  11],618,5,32200,4.106095383830655,80.0,20.0
47842,4,7842,[ 64 483 313 318  11],214,5,32205,4.106209358663777,80.0,20.0
47843,4,7843,[  8 174   1 597 153],62,3,32208,4.106068332483427,0.0,0.0
47844,4,7844,[ 64 483 313 318  11],214,5,32213,4.106182281708095,80.0,20.0
47845,4,7845,[568 204 235 655   8],416,4,32217,4.106168748406832,0.0,0.0
47846,4,7846,[ 64 483 313 318  11],214,5,32222,4.106282655792023,80.0,20.0
47847,4,7847,[118 200 302 289  79],345,3,32225,4.106141692150866,0.0,0.0
47848,4,7848,[ 64 483 313 318  11],214,5,32230,4.106255573958466,80.0,20.0
47849,4,7849,[275 191  64 125   1],262,3,32233,4.106114649681529,20.0,0.0
47850,4,7850,[ 64 483 313 318  11],618,5,32238,4.106228505922813,80.0,20.0
47851,4,7851,[176 603   8 294 269],875,3,32241,4.1060876209882835,0.0,0.0
47852,4,7852,[ 64 483 313 318  11],618,5,32246,4.1062014516745196,80.0,20.0
47853,4,7853,[132  25 282 258 215],416,5,32251,4.106315253374077,0.0,0.0
47854,4,7854,[273 183 678 748 202],805,2,32253,4.10604710375557,0.0,0.0
47855,4,7855,[655 215  70 132  89],373,4,32257,4.106033604887983,0.0,0.0
47856,4,7856,[237  22 215 568  71],588,4,32261,4.106020109456535,0.0,0.0
47857,4,7857,[ 64 483 313 318  11],214,5,32266,4.106133876304403,80.0,20.0
47858,4,7858,[ 64 483 313 318  11],214,5,32271,4.10624761420028,80.0,20.0
47859,4,7859,[  9  22  82 568  50],62,4,32275,4.106234096692112,0.0,20.0
47860,4,7860,[ 64 483 313 318  11],618,5,32280,4.1063477929016665,80.0,20.0
47861,4,7861,[403 183 196 211  95],416,4,32284,4.1063342660900535,0.0,0.0
47862,4,7862,[ 64 483 313 318  11],214,5,32289,4.106447920640977,80.0,20.0
47863,4,7863,[ 64 483 313 318  11],618,5,32294,4.106561546286877,80.0,20.0
47864,4,7864,[ 64 483 313 318  11],214,5,32299,4.106675143038779,80.0,20.0
47865,4,7865,[ 64 483 313 318  11],618,5,32304,4.106788710907704,80.0,20.0
47866,4,7866,[215 237  56 182 603],297,3,32307,4.106648023388839,0.0,0.0
47867,4,7867,[ 64 483 313 318  11],214,5,32312,4.106761565836299,80.0,20.0
47868,4,7868,[ 64 483 313 318  11],618,5,32317,4.106875079425594,80.0,20.0
47869,4,7869,[ 64 483 313 318  11],214,5,32322,4.106988564167725,80.0,20.0
47870,4,7870,[ 64 483 313 318  11],618,5,32327,4.107102020073688,80.0,20.0
47871,4,7871,[ 64 483 313 318  11],618,5,32332,4.107215447154472,80.0,20.0
47872,4,7872,[  8 357  50 194 268],721,5,32337,4.107328845421059,0.0,20.0
47873,4,7873,[385   4 197 655 234],618,3,32340,4.1071882143764284,0.0,0.0
47874,4,7874,[ 15 302   4 197 357],854,2,32342,4.106920634920635,0.0,0.0
47875,4,7875,[135 655 258  56  95],417,4,32346,4.106907059421026,0.0,0.0
47876,4,7876,[ 64 483 313 318  11],214,5,32351,4.107020439253523,80.0,20.0
47877,4,7877,[273 742 216 333 282],416,5,32356,4.1071337903021075,0.0,0.0
47878,4,7878,[173 186 196   4  12],618,3,32359,4.106993273258028,20.0,0.0
47879,4,7879,[ 64 483 313 318  11],618,5,32364,4.107106598984772,80.0,20.0
47880,4,7880,[ 97  64  56  89 515],417,5,32369,4.107219895952291,20.0,0.0
47881,4,7881,[333 173 179 302 546],416,3,32372,4.107079421466633,0.0,0.0
47882,4,7882,[ 64 483 313 318  11],618,5,32377,4.10719269313713,80.0,20.0
47883,4,7883,[121 275  69   4 282],854,2,32379,4.106925418569254,0.0,0.0
47884,4,7884,[475  88  82 173 435],437,1,32380,4.106531388712746,0.0,0.0
47885,4,7885,[182 185 195   7 172],214,4,32384,4.106517879786964,0.0,0.0
47886,4,7886,[ 64 483 313 318  11],214,5,32389,4.106631165208571,80.0,20.0
47887,4,7887,[ 64 483 313 318  11],214,5,32394,4.1067444219066935,80.0,20.0
47888,4,7888,[174 111  79 748 173],416,5,32399,4.106857649892255,0.0,0.0
47889,4,7889,[ 64 483 313 318  11],214,5,32404,4.1069708491761725,80.0,20.0
47890,4,7890,[151 471 175  50 174],922,3,32407,4.106830566468128,0.0,20.0
47891,4,7891,[168 186 294 135 289],854,2,32409,4.106563608717689,0.0,0.0
47892,4,7892,[ 64 483 313 318  11],214,5,32414,4.106676802229824,80.0,20.0
47893,4,7893,[423  11 118  79 100],854,4,32418,4.1066632885736,0.0,0.0
47894,4,7894,[ 69 328  56 471 168],854,3,32421,4.106523115896136,0.0,0.0
47895,4,7895,[286  11 742 475 508],297,4,32425,4.106509625126646,0.0,0.0
47896,4,7896,[191 210 127  95  88],505,3,32428,4.1063695074078765,0.0,0.0
47897,4,7897,[435 294 237 111 135],721,2,32430,4.106102810838187,0.0,0.0
47898,4,7898,[288 183 282 194 228],297,1,32431,4.105709583491581,0.0,20.0
47899,4,7899,[ 64 483 313 318  11],618,5,32436,4.105822784810127,80.0,20.0
47900,4,7900,[282 211 195  98 111],297,2,32438,4.10555625870143,0.0,20.0
47901,4,7901,[ 64 483 313 318  11],214,5,32443,4.105669450771956,80.0,20.0
47902,4,7902,[125 144 275 276 183],618,2,32445,4.105403011514615,0.0,0.0
47903,4,7903,[215 181 597 678 202],588,3,32448,4.105263157894737,0.0,20.0
47904,4,7904,[237 153 748 273 282],297,3,32451,4.105123339658444,0.0,0.0
47905,4,7905,[ 15  88 173 273 153],416,4,32455,4.105110043005312,0.0,0.0
47906,4,7906,[ 64 483 313 318  11],618,5,32460,4.105223219931706,80.0,20.0
47907,4,7907,[ 64 483 313 318  11],618,5,32465,4.105336368234699,80.0,20.0
47908,4,7908,[ 64 483 313 318  11],618,5,32470,4.105449487925148,80.0,20.0
47909,4,7909,[ 64 483 313 318  11],618,5,32475,4.105562579013906,80.0,20.0
47910,4,7910,[204 132 195 328   7],62,3,32478,4.105422828972317,0.0,0.0
47911,4,7911,[  7 151 200 161 257],416,3,32481,4.105283114256825,0.0,0.0
47912,4,7912,[ 64 483 313 318  11],214,5,32486,4.105396183495514,80.0,20.0
47913,4,7913,[ 64 508 288 151 328],854,4,32490,4.10538286580743,20.0,20.0
47914,4,7914,[173 234 144   8 597],588,4,32494,4.105369551484523,0.0,0.0
47915,4,7915,[ 64 483 313 318  11],214,5,32499,4.105482566953007,80.0,20.0
47916,4,7916,[ 64 483 313 318  11],618,5,32504,4.1055955538714155,80.0,20.0
47917,4,7917,[257 211 181 322  97],417,2,32506,4.105329628694115,0.0,20.0
47918,4,7918,[ 64 483 313 318  11],214,5,32511,4.105442606389696,80.0,20.0
47919,4,7919,[288 197 588  56 286],297,3,32514,4.1053030303030305,0.0,20.0
47920,4,7920,[ 64 483 313 318  11],214,5,32519,4.105415982830451,80.0,20.0
47921,4,7921,[181 313 300  64 385],416,5,32524,4.105528906841706,40.0,40.0
47922,4,7922,[125  15   1 588 237],618,3,32527,4.105389372712357,0.0,0.0
47923,4,7923,[ 64 483 313 318  11],618,5,32532,4.1055022715800105,80.0,20.0
47924,4,7924,[288   9 182 211 185],416,5,32537,4.105615141955836,0.0,20.0
47925,4,7925,[ 98  25 300 302 237],297,4,32541,4.10560181680545,0.0,20.0
47926,4,7926,[275 238 174  70  56],43,4,32545,4.10558849501703,0.0,0.0
47927,4,7927,[ 64 483 313 318  11],618,5,32550,4.105701311806256,80.0,20.0
47928,4,7928,[ 64 483 313 318  11],618,5,32555,4.105814100138732,80.0,20.0
47929,4,7929,[ 64 483 313 318  11],214,5,32560,4.105926860025221,80.0,20.0
47930,4,7930,[ 64 483 313 318  11],214,5,32565,4.106039591476485,80.0,20.0
47931,4,7931,[ 64 483 313 318  11],618,5,32570,4.106152294503278,80.0,20.0
47932,4,7932,[ 64 483 313 318  11],214,5,32575,4.106264969116349,80.0,20.0
47933,4,7933,[ 11 173 210 176 183],922,2,32577,4.105999495840686,0.0,0.0
47934,4,7934,[ 64 483 313 318  11],214,5,32582,4.106112161310649,80.0,20.0
47935,4,7935,[ 64 483 313 318  11],618,5,32587,4.106224798387097,80.0,20.0
47936,4,7936,[ 64 483 313 318  11],214,5,32592,4.106337407080761,80.0,20.0
47937,4,7937,[153 176 183 288 196],62,4,32596,4.106324011085916,0.0,20.0
47938,4,7938,[ 64 483 313 318  11],618,5,32601,4.106436578914221,80.0,20.0
47939,4,7939,[ 64 483 313 318  11],214,5,32606,4.1065491183879095,80.0,20.0
47940,4,7940,[ 64 483 313 318  11],214,5,32611,4.106661629517693,80.0,20.0
47941,4,7941,[ 64 483 313 318  11],214,5,32616,4.1067741123142785,80.0,20.0
47942,4,7942,[ 12 175 302 211 597],43,3,32619,4.106634772755886,20.0,0.0
47943,4,7943,[183 202 597 385 273],417,3,32622,4.106495468277946,0.0,0.0
47944,4,7944,[ 15 385 678 235 302],345,2,32624,4.106230333543109,0.0,0.0
47945,4,7945,[588   1 302 655 258],417,3,32627,4.1060911150264285,0.0,0.0
47946,4,7946,[ 64 483 313 318  11],214,5,32632,4.10620359884233,80.0,20.0
47947,4,7947,[ 64 483 313 318  11],618,5,32637,4.106316054353297,80.0,20.0
47948,4,7948,[ 70 234   7  64  56],198,3,32640,4.106176877594666,20.0,0.0
47949,4,7949,[257 301 282 655 258],416,4,32644,4.1061635220125785,0.0,0.0
47950,4,7950,[ 64 483 313 318  11],214,5,32649,4.106275940133316,80.0,20.0
47951,4,7951,[423  97 151 228 300],505,3,32652,4.1061368209255535,0.0,0.0
47952,4,7952,[ 64 483 313 318  11],214,5,32657,4.106249214133031,80.0,20.0
47953,4,7953,[288 302 215  12 257],62,1,32658,4.105858687452854,20.0,20.0
47954,4,7954,[ 64 483 313 318  11],214,5,32663,4.105971087366436,80.0,20.0
47955,4,7955,[ 64 483 313 318  11],214,5,32668,4.106083459024635,80.0,20.0
47956,4,7956,[ 64 483 313 318  11],214,5,32673,4.106195802438105,80.0,20.0
47957,4,7957,[191 111 318 471 172],43,4,32677,4.106182457903996,20.0,0.0
47958,4,7958,[ 64 483 313 318  11],618,5,32682,4.106294760648322,80.0,20.0
47959,4,7959,[ 64 483 313 318  11],618,5,32687,4.106407035175879,80.0,20.0
47960,4,7960,[ 64 483 313 318  11],618,5,32692,4.1065192814973,80.0,20.0
47961,4,7961,[216   7 273 245  56],62,4,32696,4.106505903039437,0.0,0.0
47962,4,7962,[ 64 483 313 318  11],214,5,32701,4.106618108752983,80.0,20.0
47963,4,7963,[357 222 183 211 176],297,5,32706,4.106730286288298,0.0,0.0
47964,4,7964,[ 64 483 313 318  11],214,5,32711,4.106842435655995,80.0,20.0
47965,4,7965,[405  98 151 174 597],764,5,32716,4.106954556866683,0.0,20.0
47966,4,7966,[ 64 483 313 318  11],618,5,32721,4.107066649930966,80.0,20.0
47967,4,7967,[ 64 483 313 318  11],214,5,32726,4.107178714859438,80.0,20.0
47968,4,7968,[ 64 483 313 318  11],214,5,32731,4.107290751662693,80.0,20.0
47969,4,7969,[ 64 483 313 318  11],214,5,32736,4.1074027603513175,80.0,20.0
47970,4,7970,[ 64 483 313 318  11],618,5,32741,4.107514740935892,80.0,20.0
47971,4,7971,[ 64 483 313 318  11],618,5,32746,4.107626693426995,80.0,20.0
47972,4,7972,[ 64 483 313 318  11],214,5,32751,4.107738617835194,80.0,20.0
47973,4,7973,[ 64 483 313 318  11],214,5,32756,4.107850514171056,80.0,20.0
47974,4,7974,[322 172 273  28   4],416,4,32760,4.107836990595612,0.0,0.0
47975,4,7975,[ 71   7  98 195 132],416,5,32765,4.107948846539619,0.0,20.0
47976,4,7976,[483   1 508  82 328],62,3,32768,4.1078099536166475,20.0,0.0
47977,4,7977,[286 194  98 603  25],854,2,32770,4.10754575081474,0.0,20.0
47978,4,7978,[238  28 181 257 313],654,4,32774,4.107532272214563,20.0,40.0
47979,4,7979,[ 64 483 313 318  11],214,5,32779,4.1076441102756895,80.0,20.0
47980,4,7980,[ 64 483 313 318  11],618,5,32784,4.107755920310738,80.0,20.0
47981,4,7981,[ 64 483 313 318  11],618,5,32789,4.1078677023302435,80.0,20.0
47982,4,7982,[ 64 483 313 318  11],618,5,32794,4.107979456344733,80.0,20.0
47983,4,7983,[ 64 483 313 318  11],618,5,32799,4.1080911823647295,80.0,20.0
47984,4,7984,[202  56 313 268 269],345,4,32803,4.108077645585473,20.0,20.0
47985,4,7985,[ 64 483 313 318  11],618,5,32808,4.108189331329827,80.0,20.0
47986,4,7986,[405 111  69 215   1],416,5,32813,4.108300989107299,0.0,0.0
47987,4,7987,[ 64 483 313 318  11],618,5,32818,4.1084126189283925,80.0,20.0
47988,4,7988,[ 97  98 742 597 300],654,4,32822,4.108399048691951,0.0,20.0
47989,4,7989,[ 64 483 313 318  11],618,5,32827,4.108510638297872,80.0,20.0
47990,4,7990,[ 64 483 313 318  11],618,5,32832,4.108622199974972,80.0,20.0
47991,4,7991,[301   8 302 194 127],721,4,32836,4.108608608608608,0.0,0.0
47992,4,7992,[ 64 483 313 318  11],618,5,32841,4.108720130113849,80.0,20.0
47993,4,7993,[191 195 168 423 176],297,2,32843,4.108456342256693,0.0,0.0
47994,4,7994,[ 64 483 313 318  11],618,5,32848,4.108567854909318,80.0,20.0
47995,4,7995,[ 64 483 313 318  11],618,5,32853,4.108679339669835,80.0,20.0
47996,4,7996,[286 328 216 111   8],721,5,32858,4.108790796548706,0.0,0.0
47997,4,7997,[ 64 483 313 318  11],214,5,32863,4.108902225556389,80.0,20.0
47998,4,7998,[603 121 275 273 216],416,5,32868,4.109013626703338,0.0,0.0
47999,4,7999,[ 64 483 313 318  11],214,5,32873,4.109125,80.0,20.0
48000,4,8000,[ 64 483 313 318  11],618,5,32878,4.109236345456818,80.0,20.0
48001,4,8001,[ 50 211 174  79 238],437,5,32883,4.109347663084229,0.0,20.0
48002,4,8002,[ 64 483 313 318  11],214,5,32888,4.109458952892665,80.0,20.0
48003,4,8003,[597 172 496 173 568],43,4,32892,4.10944527736132,0.0,0.0
48004,4,8004,[678 144 181 282  15],416,4,32896,4.109431605246721,0.0,20.0
48005,4,8005,[ 95   8 475  56 185],49,3,32899,4.109293030227329,0.0,0.0
48006,4,8006,[ 64 483 313 318  11],214,5,32904,4.109404271262645,80.0,20.0
48007,4,8007,[ 64 483 313 318  11],214,5,32909,4.109515484515485,80.0,20.0
48008,4,8008,[508 333 238  50 168],854,4,32913,4.109501810463229,0.0,20.0
48009,4,8009,[ 96 191 179   9 121],62,5,32918,4.109612983770287,0.0,0.0
48010,4,8010,[ 64 483 313 318  11],618,5,32923,4.109724129322182,80.0,20.0
48011,4,8011,[ 64 483 313 318  11],214,5,32928,4.109835247129306,80.0,20.0
48012,4,8012,[ 64 483 313 318  11],214,5,32933,4.109946337202047,80.0,20.0
48013,4,8013,[ 64 483 313 318  11],618,5,32938,4.1100573995507865,80.0,20.0
48014,4,8014,[180 222 257 235   1],62,3,32941,4.10991890205864,0.0,0.0
48015,4,8015,[357 742 215 301 151],416,4,32945,4.109905189620759,0.0,0.0
48016,4,8016,[125 182 483 546 357],62,5,32950,4.1100162155419735,20.0,0.0
48017,4,8017,[496 300   9 588 143],43,5,32955,4.11012721376902,0.0,0.0
48018,4,8018,[ 64 483 313 318  11],618,5,32960,4.110238184312259,80.0,20.0
48019,4,8019,[ 64 483 313 318  11],214,5,32965,4.110349127182045,80.0,20.0
48020,4,8020,[ 64 483 313 318  11],618,5,32970,4.11046004238873,80.0,20.0
48021,4,8021,[265 238 405 237  98],416,4,32974,4.110446272749938,0.0,20.0
48022,4,8022,[ 64 483 313 318  11],214,5,32979,4.110557148198928,80.0,20.0
48023,4,8023,[  9 275 185 289  12],416,4,32983,4.110543369890329,20.0,0.0
48024,4,8024,[ 79  25  71 215 496],373,5,32988,4.110654205607477,0.0,0.0
48025,4,8025,[ 64 483 313 318  11],618,5,32993,4.110765013705457,80.0,20.0
48026,4,8026,[168 216 187 185 183],198,4,32997,4.110751214650555,0.0,0.0
48027,4,8027,[ 64 483 313 318  11],214,5,33002,4.1108619830592925,80.0,20.0
48028,4,8028,[ 64 483 313 318  11],618,5,33007,4.11097272387595,80.0,20.0
48029,4,8029,[ 64 483 313 318  11],214,5,33012,4.1110834371108345,80.0,20.0
48030,4,8030,[ 64 483 313 318  11],618,5,33017,4.11119412277425,80.0,20.0
48031,4,8031,[568 403  64  11 603],405,4,33021,4.111180278884462,20.0,0.0
48032,4,8032,[ 64 483 313 318  11],214,5,33026,4.111290924934645,80.0,20.0
48033,4,8033,[748  96 294   1  89],642,4,33030,4.111277072442121,0.0,0.0
48034,4,8034,[ 64 483 313 318  11],214,5,33035,4.111387678904792,80.0,20.0
48035,4,8035,[ 64 483 313 318  11],618,5,33040,4.111498257839721,80.0,20.0
48036,4,8036,[423 161 132 125 318],618,4,33044,4.111484384720667,20.0,0.0
48037,4,8037,[ 64 483 313 318  11],214,5,33049,4.1115949241104754,80.0,20.0
48038,4,8038,[174 196 483 132 215],437,4,33053,4.111581042418211,20.0,0.0
48039,4,8039,[ 95  69 385 588 195],654,5,33058,4.111691542288558,0.0,0.0
48040,4,8040,[111 385 182  50   8],618,3,33061,4.111553289391867,0.0,20.0
48041,4,8041,[238 288  95 111   9],416,4,33065,4.1115394180552105,0.0,20.0
48042,4,8042,[ 64 483 313 318  11],214,5,33070,4.111649881884869,80.0,20.0
48043,4,8043,[742 515 161  22 204],416,5,33075,4.111760318249627,0.0,0.0
48044,4,8044,[238 328 125 174   9],416,5,33080,4.111870727159727,0.0,0.0
48045,4,8045,[ 64 483 313 318  11],618,5,33085,4.111981108625404,80.0,20.0
48046,4,8046,[127  12 323 186 268],417,4,33089,4.111967192742637,20.0,0.0
48047,4,8047,[143 202 546 273 185],416,4,33093,4.111953280318091,0.0,0.0
48048,4,8048,[ 64 483 313 318  11],214,5,33098,4.112063610386383,80.0,20.0
48049,4,8049,[ 64 483 313 318  11],618,5,33103,4.1121739130434785,80.0,20.0
48050,4,8050,[ 64 483 313 318  11],214,5,33108,4.11228418829959,80.0,20.0
48051,4,8051,[ 71 187 181 258 185],875,4,33112,4.112270243417784,0.0,20.0
48052,4,8052,[222 168  79 405 546],654,5,33117,4.112380479324475,0.0,0.0
48053,4,8053,[196 194 211 322  69],416,4,33121,4.112366525949839,0.0,0.0
48054,4,8054,[ 15 483 181 111 202],618,2,33123,4.112104283054004,20.0,20.0
48055,4,8055,[269  96 176 568 322],416,4,33127,4.112090367428004,0.0,0.0
48056,4,8056,[185  70 210 117 100],416,5,33132,4.112200570932108,0.0,0.0
48057,4,8057,[187  22 435 181 385],505,2,33134,4.111938446264582,0.0,20.0
48058,4,8058,[265  79 135   8 294],297,2,33136,4.111676386648467,0.0,0.0
48059,4,8059,[ 97 117 323 200  22],416,4,33140,4.11166253101737,0.0,0.0
48060,4,8060,[ 64 483 313 318  11],214,5,33145,4.111772732911549,80.0,20.0
48061,4,8061,[ 64 483 313 318  11],618,5,33150,4.1118829074671295,80.0,20.0
48062,4,8062,[ 64 483 313 318  11],214,5,33155,4.111993054694283,80.0,20.0
48063,4,8063,[ 64 483 313 318  11],618,5,33160,4.112103174603175,80.0,20.0
48064,4,8064,[405 289 173 742   1],764,3,33163,4.111965282083075,0.0,0.0
48065,4,8065,[121  96 496 265  64],618,4,33167,4.111951400942226,20.0,0.0
48066,4,8066,[174 117 228 265  96],505,4,33171,4.111937523242841,0.0,0.0
48067,4,8067,[588 385 153 204 151],416,4,33175,4.111923648983639,0.0,0.0
48068,4,8068,[ 64 483 313 318  11],214,5,33180,4.112033709257653,80.0,20.0
48069,4,8069,[ 64 483 313 318  11],214,5,33185,4.112143742255267,80.0,20.0
48070,4,8070,[257 222 173 118 405],62,2,33187,4.111882046834345,0.0,0.0
48071,4,8071,[ 64 483 313 318  11],618,5,33192,4.11199207135778,80.0,20.0
48072,4,8072,[ 64 483 313 318  11],618,5,33197,4.112102068623808,80.0,20.0
48073,4,8073,[ 25 423 118  28 357],416,4,33201,4.112088184295269,0.0,0.0
48074,4,8074,[235 168 271 385 273],805,1,33202,4.111702786377709,0.0,0.0
48075,4,8075,[ 50   7 179 357 496],416,4,33206,4.111688954928182,0.0,20.0
48076,4,8076,[322  22 427  15  96],416,4,33210,4.111675126903553,0.0,0.0
48077,4,8077,[ 64 483 313 318  11],618,5,33215,4.111785095320624,80.0,20.0
48078,4,8078,[423 282 121   4 405],654,4,33219,4.111771258819161,0.0,0.0
48079,4,8079,[ 64 483 313 318  11],618,5,33224,4.1118811881188115,80.0,20.0
48080,4,8080,[174 318 186 117 265],618,5,33229,4.111991090211608,20.0,0.0
48081,4,8081,[ 64 483 313 318  11],618,5,33234,4.112100965107647,80.0,20.0
48082,4,8082,[ 64 483 313 318  11],214,5,33239,4.112210812817024,80.0,20.0
48083,4,8083,[427 174  70 182 483],618,4,33243,4.112196932211776,20.0,0.0
48084,4,8084,[ 97 161 265  95 180],405,0,33243,4.111688311688312,0.0,0.0
48085,4,8085,[ 64 483 313 318  11],618,5,33248,4.111798169675983,80.0,20.0
48086,4,8086,[ 64 483 313 318  11],214,5,33253,4.111908000494621,80.0,20.0
48087,4,8087,[ 12 173 191 742 194],297,2,33255,4.111646884272997,20.0,0.0
48088,4,8088,[117 318 127 323  56],43,4,33259,4.11163308196316,20.0,0.0
48089,4,8089,[237 301 121  50 588],345,3,33262,4.111495673671199,0.0,20.0
48090,4,8090,[742 475 257 216 183],62,3,33265,4.111358299344952,0.0,0.0
48091,4,8091,[588 200 597  97  64],417,3,33268,4.111220958971824,20.0,0.0
48092,4,8092,[ 64 483 313 318  11],214,5,33273,4.111330779686148,80.0,20.0
48093,4,8093,[ 64 483 313 318  11],618,5,33278,4.111440573264146,80.0,20.0
48094,4,8094,[ 64 483 313 318  11],214,5,33283,4.111550339715874,80.0,20.0
48095,4,8095,[483 238 210 245 196],128,4,33287,4.111536561264822,20.0,0.0
48096,4,8096,[ 69 423   1  22 132],588,3,33290,4.111399283685316,0.0,0.0
48097,4,8097,[294  95 234 153  97],416,4,33294,4.111385527290689,0.0,0.0
48098,4,8098,[405 385  69  15  11],345,4,33298,4.111371774293122,0.0,0.0
48099,4,8099,[151  98 121 210 275],128,4,33302,4.111358024691358,0.0,20.0
48100,4,8100,[ 82 300 111  98 268],654,4,33306,4.111344278484138,0.0,20.0
48101,4,8101,[ 64 483 313 318  11],214,5,33311,4.1114539619846955,80.0,20.0
48102,4,8102,[117  82 222   7   1],43,5,33316,4.111563618412934,0.0,0.0
48103,4,8103,[508 405 204 202 174],345,4,33320,4.111549851924975,0.0,0.0
48104,4,8104,[496  79  82 357 135],373,3,33323,4.111412708204812,0.0,0.0
48105,4,8105,[288   4 322 328 117],416,4,33327,4.11139896373057,0.0,20.0
48106,4,8106,[ 64 483 313 318  11],618,5,33332,4.111508572838288,80.0,20.0
48107,4,8107,[ 64 483 313 318  11],618,5,33337,4.111618154908732,80.0,20.0
48108,4,8108,[191 143 186 195 100],437,3,33340,4.1114810704155875,0.0,0.0
48109,4,8109,[204 748  97 258 144],297,2,33342,4.1112207151664615,0.0,0.0
48110,4,8110,[ 64 483 313 318  11],214,5,33347,4.111330292195784,80.0,20.0
48111,4,8111,[ 64 483 313 318  11],618,5,33352,4.111439842209073,80.0,20.0
48112,4,8112,[ 64 483 313 318  11],214,5,33357,4.1115493652163195,80.0,20.0
48113,4,8113,[ 64 483 313 318  11],618,5,33362,4.111658861227508,80.0,20.0
48114,4,8114,[ 64 483 313 318  11],618,5,33367,4.111768330252619,80.0,20.0
48115,4,8115,[ 64 483 313 318  11],214,5,33372,4.111877772301626,80.0,20.0
48116,4,8116,[ 64 483 313 318  11],618,5,33377,4.111987187384502,80.0,20.0
48117,4,8117,[ 28  22   8 323 125],223,2,33379,4.111727026361173,0.0,0.0
48118,4,8118,[ 15 288  89  71  88],642,3,33382,4.111590097302623,0.0,20.0
48119,4,8119,[ 64 483 313 318  11],214,5,33387,4.1116995073891625,80.0,20.0
48120,4,8120,[ 64 483 313 318  11],618,5,33392,4.111808890530723,80.0,20.0
48121,4,8121,[ 64 483 313 318  11],618,5,33397,4.111918246737257,80.0,20.0
48122,4,8122,[ 64 483 313 318  11],618,5,33402,4.112027576018712,80.0,20.0
48123,4,8123,[403 172 289  69 153],721,4,33406,4.112013786312161,0.0,0.0
48124,4,8124,[180 118 100  98  82],805,2,33408,4.111753846153846,0.0,20.0
48125,4,8125,[403 655 153 100 111],416,5,33413,4.111863155303962,0.0,0.0
48126,4,8126,[268 294 515 323 197],416,4,33417,4.111849390919159,0.0,0.0
48127,4,8127,[ 64 483 313 318  11],214,5,33422,4.111958661417323,80.0,20.0
48128,4,8128,[ 64 483 313 318  11],618,5,33427,4.1120679050313695,80.0,20.0
48129,4,8129,[ 64 483 313 318  11],214,5,33432,4.112177121771218,80.0,20.0
48130,4,8130,[ 64 483 313 318  11],214,5,33437,4.112286311646784,80.0,20.0
48131,4,8131,[ 64 483 313 318  11],214,5,33442,4.112395474667978,80.0,20.0
48132,4,8132,[127   4 100   1 323],198,2,33444,4.112135743268166,0.0,0.0
48133,4,8133,[151 282 268 301 121],416,4,33448,4.112121957216622,0.0,0.0
48134,4,8134,[ 64 483 313 318  11],618,5,33453,4.112231100184388,80.0,20.0
48135,4,8135,[185 210 276 121 186],618,3,33456,4.112094395280236,0.0,0.0
48136,4,8136,[ 64 483 313 318  11],214,5,33461,4.112203514808898,80.0,20.0
48137,4,8137,[ 64 483 313 318  11],618,5,33466,4.112312607520275,80.0,20.0
48138,4,8138,[471 385 125 202 423],416,5,33471,4.112421673424254,0.0,0.0
48139,4,8139,[100   1 200 118 286],854,2,33473,4.1121621621621625,0.0,0.0
48140,4,8140,[ 64 483 313 318  11],214,5,33478,4.112271219751873,80.0,20.0
48141,4,8141,[ 64 483 313 318  11],618,5,33483,4.11238025055269,80.0,20.0
48142,4,8142,[ 64 483 313 318  11],214,5,33488,4.112489254574482,80.0,20.0
48143,4,8143,[ 82 302 269 144 118],416,4,33492,4.112475442043222,0.0,0.0
48144,4,8144,[ 64 483 313 318  11],214,5,33497,4.112584407612032,80.0,20.0
48145,4,8145,[ 64 483 313 318  11],618,5,33502,4.112693346427695,80.0,20.0
48146,4,8146,[ 64 483 313 318  11],618,5,33507,4.112802258500062,80.0,20.0
48147,4,8147,[ 64 483 313 318  11],618,5,33512,4.1129111438389785,80.0,20.0
48148,4,8148,[ 64 483 313 318  11],214,5,33517,4.113020002454289,80.0,20.0
48149,4,8149,[ 64 483 313 318  11],214,5,33522,4.1131288343558285,80.0,20.0
48150,4,8150,[ 64 483 313 318  11],214,5,33527,4.113237639553429,80.0,20.0
48151,4,8151,[ 64 483 313 318  11],618,5,33532,4.113346418056919,80.0,20.0
48152,4,8152,[ 64 483 313 318  11],618,5,33537,4.1134551698761195,80.0,20.0
48153,4,8153,[216 125 235 742 403],417,2,33539,4.113195977434388,0.0,0.0
48154,4,8154,[ 64 483 313 318  11],214,5,33544,4.113304721030043,80.0,20.0
48155,4,8155,[174 282 185 151 313],618,3,33547,4.113168219715547,20.0,20.0
48156,4,8156,[ 28  89 215 174   4],405,4,33551,4.113154345960525,0.0,0.0
48157,4,8157,[ 64 483 313 318  11],618,5,33556,4.113263054670262,80.0,20.0
48158,4,8158,[ 64 483 313 318  11],214,5,33561,4.113371736732443,80.0,20.0
48159,4,8159,[187 144 118 234 182],618,4,33565,4.113357843137255,0.0,0.0
48160,4,8160,[144 238  50 185 176],618,4,33569,4.113343952946943,0.0,20.0
48161,4,8161,[ 64 483 313 318  11],618,5,33574,4.113452585150698,80.0,20.0
48162,4,8162,[ 64 483 313 318  11],214,5,33579,4.113561190738699,80.0,20.0
48163,4,8163,[ 64 483 313 318  11],618,5,33584,4.113669769720725,80.0,20.0
48164,4,8164,[118 144  22 125   7],854,1,33585,4.11328842620943,0.0,0.0
48165,4,8165,[333 183 144  70  12],416,5,33590,4.11339701200098,20.0,0.0
48166,4,8166,[ 64 483 313 318  11],618,5,33595,4.113505571201175,80.0,20.0
48167,4,8167,[180  97  89 197 195],437,2,33597,4.113246816846229,0.0,0.0
48168,4,8168,[ 64 483 313 318  11],618,5,33602,4.113355367854083,80.0,20.0
48169,4,8169,[403  89 121 143 100],805,3,33605,4.113219094247246,0.0,0.0
48170,4,8170,[ 64 483 313 318  11],618,5,33610,4.1133276220780814,80.0,20.0
48171,4,8171,[496 186 117 151  69],373,5,33615,4.113436123348017,0.0,0.0
48172,4,8172,[175 258   8 194 405],854,4,33619,4.113422243974061,0.0,0.0
48173,4,8173,[ 98 117   1 200 197],297,2,33621,4.1131636897479815,0.0,20.0
48174,4,8174,[ 64 483 313 318  11],618,5,33626,4.113272171253823,80.0,20.0
48175,4,8175,[ 64 483 313 318  11],214,5,33631,4.113380626223092,80.0,20.0
48176,4,8176,[603 173 300 275 151],128,4,33635,4.113366760425584,0.0,0.0
48177,4,8177,[ 64 483 313 318  11],618,5,33640,4.113475177304965,80.0,20.0
48178,4,8178,[ 64 483 313 318  11],214,5,33645,4.1135835676733095,80.0,20.0
48179,4,8179,[238 179 475 127  82],198,4,33649,4.1135696821515895,0.0,0.0
48180,4,8180,[ 64 483 313 318  11],618,5,33654,4.113678034470114,80.0,20.0
48181,4,8181,[ 64 483 313 318  11],618,5,33659,4.113786360303104,80.0,20.0
48182,4,8182,[288  98 181 144 237],618,4,33663,4.11377245508982,0.0,60.0
48183,4,8183,[ 11 286  71 403 475],416,4,33667,4.113758553274682,0.0,0.0
48184,4,8184,[ 64 483 313 318  11],214,5,33672,4.1138668295662795,80.0,20.0
48185,4,8185,[111 288 273 546 216],416,4,33676,4.113852919618862,0.0,20.0
48186,4,8186,[ 64 483 313 318  11],214,5,33681,4.113961157933309,80.0,20.0
48187,4,8187,[228  70 168 427   7],230,3,33684,4.113825109916951,0.0,0.0
48188,4,8188,[191  50 195 210  70],262,2,33686,4.11356698009525,0.0,20.0
48189,4,8189,[318 186 185   7  25],618,4,33690,4.113553113553113,20.0,0.0
48190,4,8190,[301 546 195 172 111],416,4,33694,4.113539250396777,0.0,0.0
48191,4,8191,[ 64 483 313 318  11],618,5,33699,4.1136474609375,80.0,20.0
48192,4,8192,[282 132 185 135   1],854,3,33702,4.113511534236544,0.0,0.0
48193,4,8193,[ 64 483 313 318  11],618,5,33707,4.11361972174762,80.0,20.0
48194,4,8194,[ 28  50 194 588 191],405,3,33710,4.113483831604637,0.0,20.0
48195,4,8195,[ 64 483 313 318  11],618,5,33715,4.113591996095656,80.0,20.0
48196,4,8196,[127 385 204   4  98],43,5,33720,4.113700134195438,0.0,20.0
48197,4,8197,[153 427  97 301 515],416,5,33725,4.113808245913638,0.0,0.0
48198,4,8198,[216 323 174  89 357],417,2,33727,4.113550432979632,0.0,0.0
48199,4,8199,[  9  56 100 471 237],618,3,33730,4.113414634146341,0.0,0.0
48200,4,8200,[125 294   8 288  82],642,4,33734,4.113400804779905,0.0,20.0
48201,4,8201,[ 64 483 313 318  11],618,5,33739,4.1135089002682275,80.0,20.0
48202,4,8202,[ 64 483 313 318  11],618,5,33744,4.113616969401439,80.0,20.0
48203,4,8203,[ 64 483 313 318  11],618,5,33749,4.113725012189176,80.0,20.0
48204,4,8204,[176 546 286 302  56],417,3,33752,4.113589274832419,0.0,0.0
48205,4,8205,[288   8 118 135  12],854,4,33756,4.113575432610285,20.0,20.0
48206,4,8206,[ 56 182 117 215 322],128,2,33758,4.11331789935421,0.0,0.0
48207,4,8207,[385 196 117 405  79],654,5,33763,4.113425925925926,0.0,0.0
48208,4,8208,[ 64 483 313 318  11],618,5,33768,4.113533926178585,80.0,20.0
48209,4,8209,[588 294 546 300 237],416,3,33771,4.113398294762485,0.0,0.0
48210,4,8210,[125  15 333 322 302],416,4,33775,4.113384484228474,0.0,0.0
48211,4,8211,[173  22 151  15 276],764,3,33778,4.113248904042864,0.0,0.0
48212,4,8212,[ 64 483 313 318  11],214,5,33783,4.113356873249726,80.0,20.0
48213,4,8213,[269 423  12 121   7],416,5,33788,4.113464816167519,20.0,0.0
48214,4,8214,[ 64 483 313 318  11],618,5,33793,4.113572732805843,80.0,20.0
48215,4,8215,[197 323  50  64 151],416,3,33796,4.113437195715677,20.0,20.0
48216,4,8216,[323 185 127  25 427],416,4,33800,4.113423390531825,0.0,0.0
48217,4,8217,[ 64 483 313 318  11],214,5,33805,4.11353127281577,80.0,20.0
48218,4,8218,[ 64 483 313 318  11],618,5,33810,4.113639128847792,80.0,20.0
48219,4,8219,[ 64 483 313 318  11],618,5,33815,4.11374695863747,80.0,20.0
48220,4,8220,[ 64 483 313 318  11],618,5,33820,4.11385476219438,80.0,20.0
48221,4,8221,[ 64 483 313 318  11],214,5,33825,4.113962539528095,80.0,20.0
48222,4,8222,[ 64 483 313 318  11],618,5,33830,4.114070290648182,80.0,20.0
48223,4,8223,[202 546 258 423 176],417,4,33834,4.114056420233463,0.0,0.0
48224,4,8224,[  4 405 215  98 748],654,5,33839,4.114164133738602,0.0,20.0
48225,4,8225,[ 64 483 313 318  11],214,5,33844,4.1142718210551905,80.0,20.0
48226,4,8226,[222 678  28 357 202],297,3,33847,4.114136380211499,0.0,0.0
48227,4,8227,[318 204  28 100 313],618,4,33851,4.114122508507535,40.0,20.0
48228,4,8228,[185  50 294  79  12],417,2,33853,4.113865597277919,20.0,20.0
48229,4,8229,[176   8 748 182 286],437,2,33855,4.113608748481166,0.0,0.0
48230,4,8230,[588 196 194   4 179],416,4,33859,4.113594945936096,0.0,0.0
48231,4,8231,[ 64 483 313 318  11],618,5,33864,4.113702623906706,80.0,20.0
48232,4,8232,[405 282 172 568  79],705,4,33868,4.1136888133122795,0.0,0.0
48233,4,8233,[286 282 215 597 210],416,4,33872,4.113675006072383,0.0,0.0
48234,4,8234,[174 258 302 238 185],416,5,33877,4.11378263509411,0.0,0.0
48235,4,8235,[ 64 483 313 318  11],618,5,33882,4.113890237979602,80.0,20.0
48236,4,8236,[ 28  64   4 275  95],43,5,33887,4.113997814738376,20.0,0.0
48237,4,8237,[597 403  70 271   1],62,1,33888,4.113619810633649,0.0,0.0
48238,4,8238,[ 64 483 313 318  11],618,5,33893,4.113727394101226,80.0,20.0
48239,4,8239,[ 64 483 313 318  11],214,5,33898,4.113834951456311,80.0,20.0
48240,4,8240,[294 174 100 235  97],62,3,33901,4.113699793714355,0.0,0.0
48241,4,8241,[ 64 483 313 318  11],618,5,33906,4.113807328318369,80.0,20.0
48242,4,8242,[294 168 181 385 143],698,2,33908,4.113550891665656,0.0,20.0
48243,4,8243,[423 176 322 210  11],417,3,33911,4.113415817564289,0.0,0.0
48244,4,8244,[182  70   1 202 385],230,3,33914,4.113280776228017,0.0,0.0
48245,4,8245,[546 286  89  70 302],417,3,33917,4.113145767644919,0.0,0.0
48246,4,8246,[ 69 118  64 238  96],618,2,33919,4.112889535588699,20.0,0.0
48247,4,8247,[403 181 153   8 288],642,3,33922,4.112754607177497,0.0,40.0
48248,4,8248,[ 64 483 313 318  11],618,5,33927,4.112862165110923,80.0,20.0
48249,4,8249,[100 216 385 288 588],417,1,33928,4.112484848484849,0.0,20.0
48250,4,8250,[174 173  98  50  69],417,2,33930,4.112228820749,0.0,40.0
48251,4,8251,[234 282 174 655 172],345,4,33934,4.112215220552593,0.0,0.0
48252,4,8252,[ 64 483 313 318  11],618,5,33939,4.112322791712105,80.0,20.0
48253,4,8253,[294 588 179 174 234],417,3,33942,4.112188030046038,0.0,0.0
48254,4,8254,[ 64 483 313 318  11],214,5,33947,4.112295578437311,80.0,20.0
48255,4,8255,[168  28 475 127 323],805,3,33950,4.1121608527131785,0.0,0.0
48256,4,8256,[111 151 268 273   1],417,3,33953,4.112026159622139,0.0,0.0
48257,4,8257,[ 64 483 313 318  11],618,5,33958,4.112133688544442,80.0,20.0
48258,4,8258,[132 180  71 151 294],24,3,33961,4.111999031359729,0.0,0.0
48259,4,8259,[ 64 483 313 318  11],618,5,33966,4.112106537530266,80.0,20.0
48260,4,8260,[121 181 172  50 185],437,4,33970,4.112092966953154,0.0,40.0
48261,4,8261,[ 25 216  15 475 191],198,3,33973,4.1119583635923505,0.0,0.0
48262,4,8262,[322 194 235   9 427],416,3,33976,4.111823792811328,0.0,0.0
48263,4,8263,[ 64 357 132 179 328],373,3,33979,4.111689254598257,20.0,0.0
48264,4,8264,[ 64 483 313 318  11],214,5,33984,4.1117967332123415,80.0,20.0
48265,4,8265,[ 64 483 313 318  11],214,5,33989,4.111904185821437,80.0,20.0
48266,4,8266,[ 64 483 313 318  11],618,5,33994,4.112011612434983,80.0,20.0
48267,4,8267,[588  69 202 143  64],314,5,33999,4.11211901306241,20.0,0.0
48268,4,8268,[ 82 172  95 175 215],373,3,34002,4.111984520498247,0.0,0.0
48269,4,8269,[318  64 237 132 185],416,4,34006,4.111970979443773,40.0,0.0
48270,4,8270,[  4 268  69 257 300],297,1,34007,4.111594728569702,0.0,0.0
48271,4,8271,[ 64 483 313 318  11],618,5,34012,4.111702127659575,80.0,20.0
48272,4,8272,[ 64 483 313 318  11],618,5,34017,4.1118095007856885,80.0,20.0
48273,4,8273,[182 135  89 423 515],417,4,34021,4.111795987430505,0.0,0.0
48274,4,8274,[ 64 483 313 318  11],214,5,34026,4.1119033232628395,80.0,20.0
48275,4,8275,[ 11 176 245 289  88],416,2,34028,4.11164813919768,0.0,0.0
48276,4,8276,[318 111 182 204 405],62,2,34030,4.111393016793524,20.0,0.0
48277,4,8277,[  4 385 202 111 588],618,2,34032,4.111137956028026,0.0,0.0
48278,4,8278,[286 483 216 318 186],588,5,34037,4.11124531948303,40.0,0.0
48279,4,8279,[ 22 111   1  82 318],705,5,34042,4.111352657004831,20.0,0.0
48280,4,8280,[125 238  70 100 597],417,3,34045,4.111218451877792,0.0,0.0
48281,4,8281,[ 64 483 313 318  11],618,5,34050,4.111325766723014,80.0,20.0
48282,4,8282,[ 64 483 313 318  11],214,5,34055,4.111433055656163,80.0,20.0
48283,4,8283,[276 238   8 655  79],354,2,34057,4.1111781747947855,0.0,0.0
48284,4,8284,[742  69 257 289 195],854,1,34058,4.1108026554013275,0.0,0.0
48285,4,8285,[ 64 483 313 318  11],618,5,34063,4.110909968621772,80.0,20.0
48286,4,8286,[ 64 483 313 318  11],618,5,34068,4.111017255943043,80.0,20.0
48287,4,8287,[ 64 483 313 318  11],214,5,34073,4.111124517374518,80.0,20.0
48288,4,8288,[ 64 483 313 318  11],214,5,34078,4.111231752925564,80.0,20.0
48289,4,8289,[ 64 483 313 318  11],618,5,34083,4.111338962605549,80.0,20.0
48290,4,8290,[ 64 483 313 318  11],618,5,34088,4.111446146423833,80.0,20.0
48291,4,8291,[ 64 483 313 318  11],618,5,34093,4.111553304389774,80.0,20.0
48292,4,8292,[ 64 483 313 318  11],214,5,34098,4.111660436512722,80.0,20.0
48293,4,8293,[475 143 121 180  50],437,3,34101,4.111526404629853,0.0,20.0
48294,4,8294,[196  71 403  98 289],345,2,34103,4.111271850512357,0.0,20.0
48295,4,8295,[288 515 603  97 597],416,4,34107,4.11125843780135,0.0,20.0
48296,4,8296,[ 64 483 313 318  11],214,5,34112,4.111365553814632,80.0,20.0
48297,4,8297,[ 64 483 313 318  11],618,5,34117,4.111472644010605,80.0,20.0
48298,4,8298,[135  12 143 282  95],618,3,34120,4.111338715507893,20.0,0.0
48299,4,8299,[216 173   1 286 328],416,5,34125,4.11144578313253,0.0,0.0
48300,4,8300,[ 64 483 313 318  11],618,5,34130,4.111552824960848,80.0,20.0
48301,4,8301,[ 28  56 118   1  25],128,3,34133,4.111418935196339,0.0,0.0
48302,4,8302,[ 64 483 313 318  11],214,5,34138,4.111525954474287,80.0,20.0
48303,4,8303,[111 135  50 423 318],618,4,34142,4.1115125240847785,20.0,20.0
48304,4,8304,[ 64 483 313 318  11],214,5,34147,4.111619506321493,80.0,20.0
48305,4,8305,[168 183 588 117 111],417,3,34150,4.111485673007465,0.0,0.0
48306,4,8306,[ 64 483 313 318  11],214,5,34155,4.111592632719393,80.0,20.0
48307,4,8307,[275 181 597  88 405],416,3,34158,4.111458834857968,0.0,20.0
48308,4,8308,[ 64 483 313 318  11],618,5,34163,4.111565772054399,80.0,20.0
48309,4,8309,[655 245 204  64  69],62,2,34165,4.111311672683514,20.0,0.0
48310,4,8310,[ 64 483 313 318  11],214,5,34170,4.111418601852966,80.0,20.0
48311,4,8311,[ 64 483 313 318  11],618,5,34175,4.111525505293551,80.0,20.0
48312,4,8312,[ 64 483 313 318  11],214,5,34180,4.111632383014555,80.0,20.0
48313,4,8313,[ 64 483 313 318  11],214,5,34185,4.111739235025259,80.0,20.0
48314,4,8314,[111 357  12 173 475],805,4,34189,4.111725796752856,20.0,0.0
48315,4,8315,[405 288 655 568 588],887,3,34192,4.1115921115921115,0.0,20.0
48316,4,8316,[ 64 483 313 318  11],618,5,34197,4.111698929902609,80.0,20.0
48317,4,8317,[ 64 483 313 318  11],618,5,34202,4.111805722529454,80.0,20.0
48318,4,8318,[182  79  89 211  82],437,2,34204,4.11155186921505,0.0,0.0
48319,4,8319,[204 202  71 161 588],922,3,34207,4.111418269230769,0.0,0.0
48320,4,8320,[ 64 483 313 318  11],618,5,34212,4.111525057084485,80.0,20.0
48321,4,8321,[ 22 161  88 202   1],588,4,34216,4.111511655851959,0.0,0.0
48322,4,8322,[ 69  56 588 100 257],601,1,34217,4.111137810885498,0.0,0.0
48323,4,8323,[ 50 121 216 117  98],588,4,34221,4.111124459394522,0.0,40.0
48324,4,8324,[ 64 483 313 318  11],214,5,34226,4.111231231231232,80.0,20.0
48325,4,8325,[655 496 179 475  15],417,4,34230,4.11121787172712,0.0,0.0
48326,4,8326,[405 174 403 257 271],43,4,34234,4.111204515431728,0.0,0.0
48327,4,8327,[ 64 483 313 318  11],618,5,34239,4.111311239193084,80.0,20.0
48328,4,8328,[ 64 238 151 603 121],416,4,34243,4.111297874894945,20.0,0.0
48329,4,8329,[ 64 483 313 318  11],214,5,34248,4.11140456182473,80.0,20.0
48330,4,8330,[215 151 748 187 143],198,3,34251,4.111271155923658,0.0,0.0
48331,4,8331,[ 64 483 313 318  11],214,5,34256,4.111377820451272,80.0,20.0
48332,4,8332,[ 64 483 313 318  11],618,5,34261,4.111484459378375,80.0,20.0
48333,4,8333,[187 265  95 183 748],416,4,34265,4.111471082313415,0.0,0.0
48334,4,8334,[385 144 172  28 202],230,3,34268,4.111337732453509,0.0,0.0
48335,4,8335,[197 318 238 357  25],373,4,34272,4.111324376199616,20.0,0.0
48336,4,8336,[111  50 742  15  28],734,4,34276,4.111311023149814,0.0,20.0
48337,4,8337,[ 64 483 313 318  11],214,5,34281,4.111417606140561,80.0,20.0
48338,4,8338,[216 238  96 597  88],805,2,34283,4.111164408202423,0.0,0.0
48339,4,8339,[153 176  95 118 191],297,2,34285,4.110911270983213,0.0,0.0
48340,4,8340,[ 64 483 313 318  11],214,5,34290,4.11101786356552,80.0,20.0
48341,4,8341,[313   9  82 195 273],416,5,34295,4.111124430592184,20.0,20.0
48342,4,8342,[ 22  95   8 174  15],705,3,34298,4.1109912501498265,0.0,0.0
48343,4,8343,[427 483 151 508 228],601,4,34302,4.11097794822627,20.0,0.0
48344,4,8344,[ 64 483 313 318  11],618,5,34307,4.111084481725584,80.0,20.0
48345,4,8345,[ 64 483 313 318  11],618,5,34312,4.111190989695663,80.0,20.0
48346,4,8346,[ 64 483 313 318  11],214,5,34317,4.111297472145681,80.0,20.0
48347,4,8347,[ 82 179 180 172 273],417,3,34320,4.111164350742693,0.0,0.0
48348,4,8348,[211 275 179 238  11],416,4,34324,4.111151036052222,0.0,0.0
48349,4,8349,[ 64 483 313 318  11],618,5,34329,4.11125748502994,80.0,20.0
48350,4,8350,[ 64 483 313 318  11],214,5,34334,4.11136390851395,80.0,20.0
48351,4,8351,[235 294 288 742 258],854,2,34336,4.111111111111111,0.0,20.0
48352,4,8352,[ 64 483 313 318  11],214,5,34341,4.1112175266371365,80.0,20.0
48353,4,8353,[210 301  25 181 300],297,4,34345,4.111204213550395,0.0,20.0
48354,4,8354,[ 64 483 313 318  11],618,5,34350,4.111310592459605,80.0,20.0
48355,4,8355,[ 64 483 313 318  11],618,5,34355,4.111416945907132,80.0,20.0
48356,4,8356,[ 98 176  82 318 328],416,5,34360,4.111523273902118,20.0,20.0
48357,4,8357,[ 71 172 202   8 483],618,3,34363,4.111390284757119,20.0,0.0
48358,4,8358,[ 64 483 313 318  11],214,5,34368,4.111496590501256,80.0,20.0
48359,4,8359,[322 127 603  82 275],416,4,34372,4.111483253588517,0.0,0.0
48360,4,8360,[ 15 322 423 475  56],854,3,34375,4.111350316947734,0.0,0.0
48361,4,8361,[174 179  71 328  28],416,4,34379,4.111337000717532,0.0,0.0
48362,4,8362,[125  82 276  96 181],618,2,34381,4.111084539041014,0.0,20.0
48363,4,8363,[ 64 483 313 318  11],214,5,34386,4.111190817790531,80.0,20.0
48364,4,8364,[222 302  50 191 168],417,2,34388,4.110938433950986,0.0,20.0
48365,4,8365,[ 64 483 313 318  11],214,5,34393,4.111044704757351,80.0,20.0
48366,4,8366,[ 64 483 313 318  11],618,5,34398,4.111150950161348,80.0,20.0
48367,4,8367,[216 302 405   9 276],416,4,34402,4.111137667304015,0.0,0.0
48368,4,8368,[ 64 483 313 318  11],214,5,34407,4.111243876209822,80.0,20.0
48369,4,8369,[187 176 197  50 144],618,4,34411,4.111230585424134,0.0,20.0
48370,4,8370,[568  56 125 161 288],417,2,34413,4.110978377732648,0.0,20.0
48371,4,8371,[238 385 197 211  96],416,5,34418,4.111084567606307,0.0,0.0
48372,4,8372,[ 64 483 313 318  11],214,5,34423,4.111190732115132,80.0,20.0
48373,4,8373,[ 64 483 313 318  11],618,5,34428,4.111296871268211,80.0,20.0
48374,4,8374,[ 64 483 313 318  11],214,5,34433,4.111402985074627,80.0,20.0
48375,4,8375,[ 28 216 258   7 268],416,5,34438,4.111509073543457,0.0,0.0
48376,4,8376,[ 64 483 313 318  11],214,5,34443,4.111615136683777,80.0,20.0
48377,4,8377,[215 275 318 183 323],416,4,34447,4.111601814275484,20.0,0.0
48378,4,8378,[ 69 111 318 678   1],345,3,34450,4.111469149063134,20.0,0.0
48379,4,8379,[742  71   4  89 385],642,3,34453,4.111336515513126,0.0,0.0
48380,4,8380,[ 64 483 313 318  11],618,5,34458,4.111442548621882,80.0,20.0
48381,4,8381,[ 64 483 313 318  11],214,5,34463,4.111548556430447,80.0,20.0
48382,4,8382,[235 127 168 427 405],887,3,34466,4.111415960873196,0.0,0.0
48383,4,8383,[748 313 427  50 111],907,5,34471,4.111521946564886,20.0,40.0
48384,4,8384,[ 64 483 313 318  11],214,5,34476,4.111627906976744,80.0,20.0
48385,4,8385,[323 294 322 546  22],805,1,34477,4.111256856665872,0.0,0.0
48386,4,8386,[546  11 385 153 257],654,5,34482,4.111362823417193,0.0,0.0
48387,4,8387,[265  82 196 202 186],437,2,34484,4.111111111111111,0.0,0.0
48388,4,8388,[273 294 216  12  96],253,4,34488,4.111097866253427,20.0,0.0
48389,4,8389,[ 64 483 313 318  11],618,5,34493,4.111203814064362,80.0,20.0
48390,4,8390,[ 64 483 313 318  11],214,5,34498,4.111309736622572,80.0,20.0
48391,4,8391,[357 211 475  79 427],416,4,34502,4.111296472831268,0.0,0.0
48392,4,8392,[ 96 568 508 294  97],417,2,34504,4.111044918384368,0.0,0.0
48393,4,8393,[ 64 483 313 318  11],618,5,34509,4.111150822015725,80.0,20.0
48394,4,8394,[ 64 483 313 318  11],618,5,34514,4.111256700416915,80.0,20.0
48395,4,8395,[  4 405 238  22 294],416,5,34519,4.111362553596951,0.0,0.0
48396,4,8396,[328 210 423   8 678],416,4,34523,4.1113492914136005,0.0,0.0
48397,4,8397,[655 121  50 204 568],711,2,34525,4.111097880447725,0.0,20.0
48398,4,8398,[ 64 483 313 318  11],214,5,34530,4.111203714727944,80.0,20.0
48399,4,8399,[185 191 197 216 175],854,4,34534,4.111190476190476,0.0,0.0
48400,4,8400,[ 64 483 313 318  11],618,5,34539,4.111296274253065,80.0,20.0
48401,4,8401,[258  97  12 471  56],588,4,34543,4.1112830278505115,20.0,0.0
48402,4,8402,[ 64 483 313 318  11],618,5,34548,4.1113887897179575,80.0,20.0
48403,4,8403,[ 22 435  50 161 174],505,2,34550,4.11113755354593,0.0,20.0
48404,4,8404,[ 64 483 313 318  11],214,5,34555,4.111243307555027,80.0,20.0
48405,4,8405,[269 245 588  22   4],416,4,34559,4.111230073756841,0.0,0.0
48406,4,8406,[ 12 191 216 496 135],417,2,34561,4.110978946116331,20.0,0.0
48407,4,8407,[200 427 475 216 187],198,5,34566,4.111084681255947,0.0,0.0
48408,4,8408,[ 64 483 313 318  11],618,5,34571,4.111190391247473,80.0,20.0
48409,4,8409,[194   8 322 269 423],416,4,34575,4.111177170035671,0.0,0.0
48410,4,8410,[ 95 204 196 216  71],43,5,34580,4.1112828438949,0.0,0.0
48411,4,8411,[313 269 235 143 268],345,4,34584,4.111269614835948,20.0,20.0
48412,4,8412,[ 22  98  28 271 161],805,1,34585,4.110899797931772,0.0,20.0
48413,4,8413,[ 64 483 313 318  11],618,5,34590,4.111005467078678,80.0,20.0
48414,4,8414,[ 64 483 313 318  11],214,5,34595,4.111111111111111,80.0,20.0
48415,4,8415,[ 64 483 313 318  11],214,5,34600,4.111216730038023,80.0,20.0
48416,4,8416,[  9  79  28 181  97],416,5,34605,4.111322323868362,0.0,20.0
48417,4,8417,[294  71 228 357 265],230,4,34609,4.111309099548587,0.0,0.0
48418,4,8418,[403 204 496  79 655],588,2,34611,4.111058320465614,0.0,0.0
48419,4,8419,[ 64 483 313 318  11],618,5,34616,4.111163895486936,80.0,20.0
48420,4,8420,[ 50 174 427  22  69],214,2,34618,4.110913193207457,0.0,20.0
48421,4,8421,[ 64 483 313 318  11],214,5,34623,4.111018760389456,80.0,20.0
48422,4,8422,[ 28 181 187 678  25],416,4,34627,4.111005579959635,0.0,20.0
48423,4,8423,[ 64 483 313 318  11],214,5,34632,4.111111111111111,80.0,20.0
48424,4,8424,[234 357 323   7 191],417,3,34635,4.110979228486647,0.0,0.0
48425,4,8425,[ 64 483 313 318  11],214,5,34640,4.111084737716592,80.0,20.0
48426,4,8426,[496 423 172 588  50],417,1,34641,4.110715557137771,0.0,20.0
48427,4,8427,[ 64 483 313 318  11],618,5,34646,4.110821072615092,80.0,20.0
48428,4,8428,[161 597 132 294 286],417,3,34649,4.110689286985408,0.0,0.0
48429,4,8429,[ 64 483 313 318  11],618,5,34654,4.11079478054567,80.0,20.0
48430,4,8430,[ 95 191 301 483  70],711,5,34659,4.110900249080773,20.0,0.0
48431,4,8431,[597 568 173 181  96],805,2,34661,4.110649905123339,0.0,20.0
48432,4,8432,[ 64 483 313 318  11],214,5,34666,4.110755365824736,80.0,20.0
48433,4,8433,[  7  50  56 588 132],230,3,34669,4.110623666113351,0.0,20.0
48434,4,8434,[ 64 483 313 318  11],214,5,34674,4.110729104919976,80.0,20.0
48435,4,8435,[ 64 483 313 318  11],214,5,34679,4.110834518729256,80.0,20.0
48436,4,8436,[ 64 483 313 318  11],214,5,34684,4.110939907550077,80.0,20.0
48437,4,8437,[ 64 483 313 318  11],214,5,34689,4.111045271391325,80.0,20.0
48438,4,8438,[132 204  71 185 197],198,2,34691,4.110795117904965,0.0,0.0
48439,4,8439,[ 64 483 313 318  11],214,5,34696,4.11090047393365,80.0,20.0
48440,4,8440,[294 276 117 127 546],62,4,34700,4.110887335623741,0.0,0.0
48441,4,8441,[151 333 405 323 294],416,3,34703,4.110755745084103,0.0,0.0
48442,4,8442,[ 64 483 313 318  11],214,5,34708,4.110861068340637,80.0,20.0
48443,4,8443,[210  64 204 197 289],416,4,34712,4.11084793936523,20.0,0.0
48444,4,8444,[ 22 168 678 496 200],416,4,34716,4.110834813499112,0.0,0.0
48445,4,8445,[508 257  95 118 182],297,1,34717,4.110466493014445,0.0,0.0
48446,4,8446,[ 95 215 172  88  56],43,5,34722,4.11057180063928,0.0,0.0
48447,4,8447,[238 174 258 117 496],128,3,34725,4.110440340909091,0.0,0.0
48448,4,8448,[286 405 313  79  50],43,5,34730,4.110545626701385,20.0,40.0
48449,4,8449,[117  56 182 742   7],417,3,34733,4.110414201183432,0.0,0.0
48450,4,8450,[655 202  64  79 588],253,5,34738,4.110519465152053,20.0,0.0
48451,4,8451,[294 403 471 423 515],416,5,34743,4.110624704212021,0.0,0.0
48452,4,8452,[ 64 483 313 318  11],214,5,34748,4.110729918372176,80.0,20.0
48453,4,8453,[ 64 483 313 318  11],214,5,34753,4.110835107641353,80.0,20.0
48454,4,8454,[204 222 172 127 151],198,3,34756,4.11070372560615,0.0,0.0
48455,4,8455,[273 100 202 276  22],416,4,34760,4.110690633869442,0.0,0.0
48456,4,8456,[ 64 483 313 318  11],214,5,34765,4.110795790469433,80.0,20.0
48457,4,8457,[  1 546  89 475 144],417,3,34768,4.11066445968314,0.0,0.0
48458,4,8458,[ 64 483 313 318  11],214,5,34773,4.110769594514718,80.0,20.0
48459,4,8459,[ 64 483 313 318  11],618,5,34778,4.110874704491726,80.0,20.0
48460,4,8460,[273 161 202  97  70],417,3,34781,4.110743410944333,0.0,0.0
48461,4,8461,[121 588  15 568 234],618,4,34785,4.11073032380052,0.0,0.0
48462,4,8462,[181 175 288  64 282],721,4,34789,4.110717239749498,20.0,40.0
48463,4,8463,[ 64 483 313 318  11],214,5,34794,4.110822306238186,80.0,20.0
48464,4,8464,[288  82 182  11 111],417,3,34797,4.110691080921441,0.0,20.0
48465,4,8465,[ 64 483 313 318  11],214,5,34802,4.110796125679188,80.0,20.0
48466,4,8466,[194 318 328 276 257],416,3,34805,4.1106649344514,20.0,0.0
48467,4,8467,[276 603 508 435  89],354,3,34808,4.110533774208786,0.0,0.0
48468,4,8468,[ 64 483 313 318  11],214,5,34813,4.110638800330618,80.0,20.0
48469,4,8469,[ 64 483 313 318  11],618,5,34818,4.110743801652893,80.0,20.0
48470,4,8470,[742 175 132  56  15],253,3,34821,4.110612678550348,0.0,0.0
48471,4,8471,[ 64 483 313 318  11],214,5,34826,4.110717658168083,80.0,20.0
48472,4,8472,[ 64 483 313 318  11],618,5,34831,4.110822613006019,80.0,20.0
48473,4,8473,[197  69 238 496  98],711,4,34835,4.110809535048383,0.0,20.0
48474,4,8474,[125 268 301 100 237],416,4,34839,4.110796460176991,0.0,0.0
48475,4,8475,[655 185 257 216 132],711,4,34843,4.11078338839075,0.0,0.0
48476,4,8476,[210 603 222 143 483],698,3,34846,4.11065235342692,20.0,0.0
48477,4,8477,[ 64 235 153 475 194],416,3,34849,4.110521349374853,20.0,0.0
48478,4,8478,[197 333 195 300 257],416,4,34853,4.110508314659747,0.0,0.0
48479,4,8479,[ 64 483 313 318  11],214,5,34858,4.1106132075471695,80.0,20.0
48480,4,8480,[ 64 483 313 318  11],618,5,34863,4.11071807569862,80.0,20.0
48481,4,8481,[ 64 483 313 318  11],618,5,34868,4.110822919122849,80.0,20.0
48482,4,8482,[ 64 483 313 318  11],214,5,34873,4.110927737828598,80.0,20.0
48483,4,8483,[ 97 195   8 328  11],416,5,34878,4.111032531824611,0.0,0.0
48484,4,8484,[125  64 179 258 117],62,5,34883,4.111137301119623,20.0,0.0
48485,4,8485,[216   1  97 204 182],297,2,34885,4.110888522271978,0.0,0.0
48486,4,8486,[301 289 185 275 273],416,4,34889,4.1108754565806525,0.0,0.0
48487,4,8487,[132 475 117 568   7],62,4,34893,4.110862393967955,0.0,0.0
48488,4,8488,[  8 195 144  88 196],618,3,34896,4.110731534927553,0.0,0.0
48489,4,8489,[ 71  50 546 153 237],416,3,34899,4.110600706713781,0.0,20.0
48490,4,8490,[ 98 237 546 322  56],416,2,34901,4.110352137557414,0.0,20.0
48491,4,8491,[174 176 238 435 318],437,3,34904,4.1102213848327835,20.0,0.0
48492,4,8492,[168 748 216 475 153],198,4,34908,4.110208406923348,0.0,0.0
48493,4,8493,[196 546 181 678  69],297,2,34910,4.109959971744761,0.0,20.0
48494,4,8494,[ 69 300 237 742 174],630,3,34913,4.109829311359623,0.0,0.0
48495,4,8495,[216 603 235 202 546],416,3,34916,4.1096986817325805,0.0,0.0
48496,4,8496,[ 64 483 313 318  11],618,5,34921,4.109803460044722,80.0,20.0
48497,4,8497,[  7  15 187 515 678],416,4,34925,4.1097905389503415,0.0,0.0
48498,4,8498,[ 64 483 313 318  11],214,5,34930,4.109895281797859,80.0,20.0
48499,4,8499,[ 64 483 313 318  11],618,5,34935,4.11,80.0,20.0
48500,4,8500,[ 64 483 313 318  11],214,5,34940,4.110104693565463,80.0,20.0
48501,4,8501,[282 748 385 655 245],416,4,34944,4.110091743119266,0.0,0.0
48502,4,8502,[117 191  56 301 313],43,5,34949,4.11019640127014,20.0,20.0
48503,4,8503,[ 64 483 313 318  11],214,5,34954,4.11030103480715,80.0,20.0
48504,4,8504,[ 64 483 313 318  11],618,5,34959,4.110405643738977,80.0,20.0
48505,4,8505,[211 191 118 288  56],437,3,34962,4.110275099929462,0.0,20.0
48506,4,8506,[ 64 483 313 318  11],618,5,34967,4.110379687316327,80.0,20.0
48507,4,8507,[121 125   1 187 427],416,5,34972,4.110484250117536,0.0,0.0
48508,4,8508,[ 64 483 313 318  11],214,5,34977,4.110588788341756,80.0,20.0
48509,4,8509,[ 64 483 313 318  11],618,5,34982,4.1106933019976495,80.0,20.0
48510,4,8510,[ 64 483 313 318  11],618,5,34987,4.110797791093878,80.0,20.0
48511,4,8511,[181  12 748 435 191],437,4,34991,4.11078477443609,20.0,20.0
48512,4,8512,[ 64 483 313 318  11],214,5,34996,4.110889228239164,80.0,20.0
48513,4,8513,[ 64 483 313 318  11],214,5,35001,4.1109936575052854,80.0,20.0
48514,4,8514,[ 15 210 471 191 174],43,4,35005,4.110980622431004,0.0,0.0
48515,4,8515,[ 64 483 313 318  11],214,5,35010,4.111085016439643,80.0,20.0
48516,4,8516,[268  15 161 318  56],314,4,35014,4.1110719736996595,20.0,0.0
48517,4,8517,[ 64 483 313 318  11],618,5,35019,4.111176332472412,80.0,20.0
48518,4,8518,[ 11  98 313 302 423],416,5,35024,4.111280666744923,20.0,40.0
48519,4,8519,[ 64 483 313 318  11],214,5,35029,4.111384976525821,80.0,20.0
48520,4,8520,[ 64 483 313 318  11],618,5,35034,4.1114892618237295,80.0,20.0
48521,4,8521,[357 245  97 597 423],62,1,35035,4.111124149260737,0.0,0.0
48522,4,8522,[655 183 127  28 202],405,4,35039,4.111111111111111,0.0,0.0
48523,4,8523,[172  50  96   1 289],887,5,35044,4.111215391834819,0.0,20.0
48524,4,8524,[ 64 483 313 318  11],214,5,35049,4.111319648093842,80.0,20.0
48525,4,8525,[597   8 144 172 234],588,4,35053,4.111306591602158,0.0,0.0
48526,4,8526,[ 64 483 313 318  11],618,5,35058,4.11141081271256,80.0,20.0
48527,4,8527,[ 64 483 313 318  11],618,5,35063,4.111515009380863,80.0,20.0
48528,4,8528,[ 64 483 313 318  11],618,5,35068,4.111619181615664,80.0,20.0
48529,4,8529,[ 64 483 313 318  11],618,5,35073,4.111723329425557,80.0,20.0
48530,4,8530,[ 70 117 268 282 405],654,3,35076,4.111593013714687,0.0,0.0
48531,4,8531,[144 423 118 132 302],854,2,35078,4.111345522737928,0.0,0.0
48532,4,8532,[ 64 483 313 318  11],214,5,35083,4.111449666002578,80.0,20.0
48533,4,8533,[ 96 403 172 238  11],416,5,35088,4.111553784860558,0.0,0.0
48534,4,8534,[ 64 483 313 318  11],214,5,35093,4.111657879320445,80.0,20.0
48535,4,8535,[ 64 483 313 318  11],618,5,35098,4.111761949390815,80.0,20.0
48536,4,8536,[508  56 237 742  69],654,4,35102,4.111748857912616,0.0,0.0
48537,4,8537,[132 655 301 144 238],711,4,35106,4.111735769501054,0.0,0.0
48538,4,8538,[ 64 483 313 318  11],214,5,35111,4.111839793886872,80.0,20.0
48539,4,8539,[ 64 483 313 318  11],618,5,35116,4.111943793911007,80.0,20.0
48540,4,8540,[ 64 483 313 318  11],214,5,35121,4.112047769582016,80.0,20.0
48541,4,8541,[273 216 268 211 323],417,2,35123,4.11180051510185,0.0,0.0
48542,4,8542,[197 405   4 238 475],854,4,35127,4.111787428303875,0.0,0.0
48543,4,8543,[216 117 318 238  71],24,5,35132,4.11189138576779,20.0,0.0
48544,4,8544,[588  70 132 185  95],416,4,35136,4.111878291398479,0.0,0.0
48545,4,8545,[210 288 597 117 143],642,4,35140,4.111865200093611,0.0,20.0
48546,4,8546,[ 64 483 313 318  11],214,5,35145,4.111969111969112,80.0,20.0
48547,4,8547,[ 64 483 313 318  11],214,5,35150,4.112072999532054,80.0,20.0
48548,4,8548,[ 64 483 313 318  11],618,5,35155,4.11217686279097,80.0,20.0
48549,4,8549,[204 118   7 294 202],297,1,35156,4.111812865497076,0.0,0.0
48550,4,8550,[ 64 483 313 318  11],618,5,35161,4.111916734884809,80.0,20.0
48551,4,8551,[ 64 483 313 318  11],214,5,35166,4.112020579981291,80.0,20.0
48552,4,8552,[300 271 403 546 496],43,4,35170,4.112007482754589,0.0,0.0
48553,4,8553,[471  25 204 603 202],416,5,35175,4.112111292962357,0.0,0.0
48554,4,8554,[588 182 568 143 204],230,3,35178,4.1119812974868495,0.0,0.0
48555,4,8555,[ 64 483 313 318  11],214,5,35183,4.112085086489014,80.0,20.0
48556,4,8556,[ 64 483 313 318  11],214,5,35188,4.112188851232909,80.0,20.0
48557,4,8557,[ 88 132 118 423 168],618,4,35192,4.112175741995793,0.0,0.0
48558,4,8558,[568 215  15 168  82],43,5,35197,4.112279471900923,0.0,0.0
48559,4,8559,[ 64 483 313 318  11],618,5,35202,4.112383177570093,80.0,20.0
48560,4,8560,[ 64 483 313 318  11],214,5,35207,4.112486859011797,80.0,20.0
48561,4,8561,[117 168   4  69 173],297,3,35210,4.112356925951881,0.0,0.0
48562,4,8562,[ 64 483 313 318  11],618,5,35215,4.112460586243139,80.0,20.0
48563,4,8563,[ 64 483 313 318  11],214,5,35220,4.112564222326016,80.0,20.0
48564,4,8564,[210 269 286 204  50],345,4,35224,4.112551079976649,0.0,20.0
48565,4,8565,[357 172 289 202 182],416,4,35228,4.112537940695774,0.0,0.0
48566,4,8566,[ 88  70  82 302 234],416,4,35232,4.112524804482316,0.0,0.0
48567,4,8567,[496  11 678 215 168],416,4,35236,4.1125116713352,0.0,0.0
48568,4,8568,[125 568 204 187 181],887,4,35240,4.1124985412533555,0.0,20.0
48569,4,8569,[  9 228 195 288 423],62,2,35242,4.112252042007001,0.0,20.0
48570,4,8570,[ 64 483 313 318  11],618,5,35247,4.112355617780889,80.0,20.0
48571,4,8571,[ 82 161 215 173 143],373,3,35250,4.112225851609892,0.0,0.0
48572,4,8572,[ 28  69 655 173 186],373,4,35254,4.112212760993818,0.0,0.0
48573,4,8573,[ 64 483 313 318  11],214,5,35259,4.112316305108467,80.0,20.0
48574,4,8574,[275   7 173 257 176],297,4,35263,4.112303206997084,0.0,0.0
48575,4,8575,[181 588 187 151 127],373,2,35265,4.112056902985074,0.0,20.0
48576,4,8576,[357 678 187 597 268],416,3,35268,4.111927247289262,0.0,0.0
48577,4,8577,[161 151 216 153 100],416,4,35272,4.111914199114013,0.0,0.0
48578,4,8578,[ 56 195 179 655 197],405,4,35276,4.11190115398065,0.0,0.0
48579,4,8579,[328 603 191 204 357],373,5,35281,4.112004662004662,0.0,0.0
48580,4,8580,[288 322   1 328  28],223,3,35284,4.111875072835334,0.0,20.0
48581,4,8581,[210 275 748 588 435],297,3,35287,4.111745513866231,0.0,0.0
48582,4,8582,[127 216 180  95 403],198,3,35290,4.111615985086799,0.0,0.0
48583,4,8583,[191 215  95 173 435],297,1,35291,4.111253494874185,0.0,0.0
48584,4,8584,[228 111  22 603 174],805,1,35292,4.110891089108911,0.0,0.0
48585,4,8585,[181 161 385 117  56],751,4,35296,4.110878173771256,0.0,20.0
48586,4,8586,[161 238   9 496 276],43,4,35300,4.110865261441714,0.0,0.0
48587,4,8587,[302 238 197 405 135],854,4,35304,4.110852352119236,0.0,0.0
48588,4,8588,[ 64 483 313 318  11],214,5,35309,4.11095587379206,80.0,20.0
48589,4,8589,[174 132 655 385 191],618,5,35314,4.111059371362049,0.0,0.0
48590,4,8590,[ 64 483 313 318  11],214,5,35319,4.1111628448376205,80.0,20.0
48591,4,8591,[ 64 483 313 318  11],618,5,35324,4.111266294227188,80.0,20.0
48592,4,8592,[ 64 483 313 318  11],214,5,35329,4.11136971953916,80.0,20.0
48593,4,8593,[ 64 483 313 318  11],214,5,35334,4.111473120781941,80.0,20.0
48594,4,8594,[ 64 483 313 318  11],618,5,35339,4.111576497963933,80.0,20.0
48595,4,8595,[185 183 216  71 210],230,4,35343,4.111563517915309,0.0,0.0
48596,4,8596,[127  98 161 238  64],405,4,35347,4.1115505408863555,20.0,20.0
48597,4,8597,[508  89 186 655 153],417,4,35351,4.1115375668760175,0.0,0.0
48598,4,8598,[ 64 483 313 318  11],618,5,35356,4.111640888475404,80.0,20.0
48599,4,8599,[ 64 483 313 318  11],618,5,35361,4.111744186046511,80.0,20.0
48600,4,8600,[ 69 328 385 742 211],43,5,35366,4.111847459597721,0.0,0.0
48601,4,8601,[ 64 483 313 318  11],214,5,35371,4.11195070913741,80.0,20.0
48602,4,8602,[176   4   7 118 546],62,4,35375,4.111937696152505,0.0,0.0
48603,4,8603,[ 64 483 313 318  11],618,5,35380,4.112040911204091,80.0,20.0
48604,4,8604,[168 161  15 125 100],417,3,35383,4.111911679256246,0.0,0.0
48605,4,8605,[161  71 237  28 471],128,5,35388,4.112014873344179,0.0,0.0
48606,4,8606,[318 181 202 153  50],373,4,35392,4.1120018589520155,20.0,40.0
48607,4,8607,[ 64 483 313 318  11],214,5,35397,4.112105018587361,80.0,20.0
48608,4,8608,[182  98 173 385 151],417,5,35402,4.112208154257173,0.0,20.0
48609,4,8609,[ 64 483 313 318  11],618,5,35407,4.112311265969803,80.0,20.0
48610,4,8610,[180  98 111 742 143],805,1,35408,4.111949831610731,0.0,20.0
48611,4,8611,[ 64 483 313 318  11],618,5,35413,4.112052949372968,80.0,20.0
48612,4,8612,[258 328 144 318 117],43,5,35418,4.1121560431905255,20.0,0.0
48613,4,8613,[  8 288  15 237  56],62,2,35420,4.111910842814024,0.0,20.0
48614,4,8614,[ 64 483 313 318  11],214,5,35425,4.112013929193267,80.0,20.0
48615,4,8615,[  1 173 180 423 210],417,4,35429,4.112000928505107,0.0,0.0
48616,4,8616,[496 132 215 210 117],588,4,35433,4.111987930834397,0.0,0.0
48617,4,8617,[423 282 196 742  70],297,2,35435,4.111742863773498,0.0,0.0
48618,4,8618,[ 64   8  96 471 268],854,2,35437,4.111497853579301,20.0,0.0
48619,4,8619,[ 64 483 313 318  11],214,5,35442,4.111600928074246,80.0,20.0
48620,4,8620,[ 64 483 313 318  11],618,5,35447,4.111703978656768,80.0,20.0
48621,4,8621,[182 135 121 181 172],230,3,35450,4.11157504059383,0.0,20.0
48622,4,8622,[ 64 483 313 318  11],618,5,35455,4.111678070277166,80.0,20.0
48623,4,8623,[ 64 483 313 318  11],618,5,35460,4.111781076066791,80.0,20.0
48624,4,8624,[176  22  25 678  28],416,4,35464,4.111768115942029,0.0,0.0
48625,4,8625,[ 64 483 313 318  11],618,5,35469,4.111871087410155,80.0,20.0
48626,4,8626,[111 483  25 144 282],618,2,35471,4.111626289556045,20.0,0.0
48627,4,8627,[322 200 195 427 100],416,4,35475,4.111613351877608,0.0,0.0
48628,4,8628,[ 64 483 313 318  11],618,5,35480,4.111716305481516,80.0,20.0
48629,4,8629,[ 71   8 174  98 258],62,5,35485,4.111819235225956,0.0,20.0
48630,4,8630,[302 245  56 385  69],416,4,35489,4.111806279689492,0.0,0.0
48631,4,8631,[ 64 483 313 318  11],214,5,35494,4.111909175162187,80.0,20.0
48632,4,8632,[ 64 483 313 318  11],214,5,35499,4.112012046797173,80.0,20.0
48633,4,8633,[ 64 483 313 318  11],214,5,35504,4.112114894602733,80.0,20.0
48634,4,8634,[258 151 328 302 172],49,2,35506,4.111870295309786,0.0,0.0
48635,4,8635,[ 64 483 313 318  11],214,5,35511,4.1119731357109774,80.0,20.0
48636,4,8636,[181 132 427  97 475],198,4,35515,4.111960171355795,0.0,20.0
48637,4,8637,[ 64 483 313 318  11],214,5,35520,4.112062977541098,80.0,20.0
48638,4,8638,[ 64 483 313 318  11],618,5,35525,4.112165759925917,80.0,20.0
48639,4,8639,[ 64 483 313 318  11],618,5,35530,4.112268518518518,80.0,20.0
48640,4,8640,[ 82  70 282 268 301],721,4,35534,4.112255525980789,0.0,0.0
48641,4,8641,[235 151 257  56   1],922,3,35537,4.112126822494793,0.0,0.0
48642,4,8642,[ 89 174 300 313 118],751,1,35538,4.111766747657064,20.0,20.0
48643,4,8643,[ 25 175  71 318 127],198,2,35540,4.111522443313281,20.0,0.0
48644,4,8644,[ 64 483 313 318  11],214,5,35545,4.111625216888375,80.0,20.0
48645,4,8645,[ 98 179 235  71 181],62,5,35550,4.111727966689799,0.0,40.0
48646,4,8646,[435 174  79 161 195],505,1,35551,4.111368104544929,0.0,0.0
48647,4,8647,[269 175  98  64   4],854,4,35555,4.111355226641998,20.0,20.0
48648,4,8648,[132 302 174 200 597],417,2,35557,4.111111111111111,0.0,0.0
48649,4,8649,[ 64 483 313 318  11],214,5,35562,4.11121387283237,80.0,20.0
48650,4,8650,[117 202 187  25 328],416,5,35567,4.11131661079644,0.0,0.0
48651,4,8651,[238  79 176  95 210],198,3,35570,4.111188164586223,0.0,0.0
48652,4,8652,[ 64 483 313 318  11],618,5,35575,4.111290881775107,80.0,20.0
48653,4,8653,[588 125 132 655 144],416,5,35580,4.111393575225329,0.0,0.0
48654,4,8654,[276  79 271 143  69],43,4,35584,4.111380704794916,0.0,0.0
48655,4,8655,[ 64 483 313 318  11],214,5,35589,4.11148336414048,80.0,20.0
48656,4,8656,[173  12 238  69 288],297,3,35592,4.111354972854338,20.0,20.0
48657,4,8657,[ 64 483 313 318  11],214,5,35597,4.111457611457611,80.0,20.0
48658,4,8658,[161  50 202 405 265],230,5,35602,4.111560226354082,0.0,20.0
48659,4,8659,[ 64 483 313 318  11],214,5,35607,4.111662817551963,80.0,20.0
48660,4,8660,[ 64 483 313 318  11],214,5,35612,4.111765385059462,80.0,20.0
48661,4,8661,[ 64 483 313 318  11],618,5,35617,4.111867928884784,80.0,20.0
48662,4,8662,[196  22 125  97 403],373,3,35620,4.111739582130902,0.0,0.0
48663,4,8663,[ 64 483 313 318  11],214,5,35625,4.1118421052631575,80.0,20.0
48664,4,8664,[ 64 483 313 318  11],214,5,35630,4.111944604731679,80.0,20.0
48665,4,8665,[275 191  98 603 508],354,3,35633,4.111816293561043,0.0,20.0
48666,4,8666,[ 70 423 176 202 143],405,3,35636,4.111688011999538,0.0,0.0
48667,4,8667,[ 64 483 313 318  11],214,5,35641,4.111790493770189,80.0,20.0
48668,4,8668,[ 64 483 313 318  11],214,5,35646,4.111892951897566,80.0,20.0
48669,4,8669,[ 64 483 313 318  11],214,5,35651,4.11199538638985,80.0,20.0
48670,4,8670,[301 245  12 194 268],416,4,35655,4.11198247030331,20.0,0.0
48671,4,8671,[ 64 483 313 318  11],214,5,35660,4.112084870848708,80.0,20.0
48672,4,8672,[100 427 197  50 546],416,4,35664,4.112071947423037,0.0,20.0
48673,4,8673,[ 64 483 313 318  11],214,5,35669,4.112174314041964,80.0,20.0
48674,4,8674,[ 64 483 313 318  11],214,5,35674,4.1122766570605185,80.0,20.0
48675,4,8675,[181 161 182 174 222],417,1,35675,4.111917934532042,0.0,20.0
48676,4,8676,[237 301 276  11  79],43,5,35680,4.112020283508125,0.0,0.0
48677,4,8677,[ 71 210  50   7 168],230,4,35684,4.112007374971191,0.0,20.0
48678,4,8678,[ 64 483 313 318  11],618,5,35689,4.112109690056458,80.0,20.0
48679,4,8679,[328 742 153 302 568],43,5,35694,4.11221198156682,0.0,0.0
48680,4,8680,[ 64 483 313 318  11],214,5,35699,4.112314249510425,80.0,20.0
48681,4,8681,[161  96  15 204 322],416,4,35703,4.112301313061507,0.0,0.0
48682,4,8682,[121 286 125  71 568],62,3,35706,4.112173212023494,0.0,0.0
48683,4,8683,[ 64 483 313 318  11],214,5,35711,4.112275449101796,80.0,20.0
48684,4,8684,[215  12 211 403 568],43,5,35716,4.11237766263673,20.0,0.0
48685,4,8685,[238 323 153   1 271],43,2,35718,4.112134469260879,0.0,0.0
48686,4,8686,[ 69 183 210 475 186],417,3,35721,4.112006446414182,0.0,0.0
48687,4,8687,[ 64 483 313 318  11],618,5,35726,4.112108655616943,80.0,20.0
48688,4,8688,[ 64 483 313 318  11],214,5,35731,4.11221084129359,80.0,20.0
48689,4,8689,[ 64 483 313 318  11],618,5,35736,4.112313003452244,80.0,20.0
48690,4,8690,[403 294 216 117 313],588,4,35740,4.112300080543091,20.0,20.0
48691,4,8691,[269 196 210 508 215],654,4,35744,4.112287160607455,0.0,0.0
48692,4,8692,[ 64 483 313 318  11],618,5,35749,4.112389278730013,80.0,20.0
48693,4,8693,[ 64 483 313 318  11],618,5,35754,4.112491373360939,80.0,20.0
48694,4,8694,[ 69 216  97  50 173],588,3,35757,4.112363427257044,0.0,20.0
48695,4,8695,[ 64 483 313 318  11],214,5,35762,4.112465501379945,80.0,20.0
48696,4,8696,[ 64 483 313 318  11],618,5,35767,4.112567552029436,80.0,20.0
48697,4,8697,[ 64 483 313 318  11],214,5,35772,4.1126695792136125,80.0,20.0
48698,4,8698,[385 121 153 300 357],698,3,35775,4.112541671456489,0.0,0.0
48699,4,8699,[196  88  50 153  95],373,5,35780,4.11264367816092,0.0,20.0
48700,4,8700,[282 265  22 118 191],618,3,35783,4.11251580278129,0.0,0.0
48701,4,8701,[333 175 286 197 191],721,3,35786,4.112387956791542,0.0,0.0
48702,4,8702,[ 22 568 302 215  69],654,5,35791,4.112489945995634,0.0,0.0
48703,4,8703,[ 64 483 313 318  11],214,5,35796,4.112591911764706,80.0,20.0
48704,4,8704,[ 64 483 313 318  11],618,5,35801,4.112693854106835,80.0,20.0
48705,4,8705,[187 568 603 200  79],416,5,35806,4.112795773030094,0.0,0.0
48706,4,8706,[228 196 132  97   8],405,2,35808,4.112553118180774,0.0,0.0
48707,4,8707,[195 100  70  96  97],618,2,35810,4.11231051906293,0.0,0.0
48708,4,8708,[200 328 568 183 678],416,4,35814,4.112297623148467,0.0,0.0
48709,4,8709,[546  22 471 195 597],705,3,35817,4.112169919632606,0.0,0.0
48710,4,8710,[ 64 483 313 318  11],214,5,35822,4.112271840202044,80.0,20.0
48711,4,8711,[  7 301 265 176  96],416,5,35827,4.112373737373737,0.0,0.0
48712,4,8712,[546 258  22  50 323],805,2,35829,4.11213129806037,0.0,20.0
48713,4,8713,[ 64 483 313 318  11],214,5,35834,4.112233187973376,80.0,20.0
48714,4,8714,[ 64 483 313 318  11],214,5,35839,4.112335054503729,80.0,20.0
48715,4,8715,[ 64 483 313 318  11],618,5,35844,4.112436897659477,80.0,20.0
48716,4,8716,[ 64 483 313 318  11],618,5,35849,4.112538717448664,80.0,20.0
48717,4,8717,[179 153 288 181 568],262,1,35850,4.112181693048864,0.0,40.0
48718,4,8718,[742 144   4 135 405],417,0,35850,4.111710058492946,0.0,0.0
48719,4,8719,[127  56 187  98  71],887,3,35853,4.111582568807339,0.0,20.0
48720,4,8720,[ 64 483 313 318  11],214,5,35858,4.1116844398578145,80.0,20.0
48721,4,8721,[191 204 132 655 302],416,5,35863,4.111786287548727,0.0,0.0
48722,4,8722,[ 64 483 313 318  11],214,5,35868,4.111888111888112,80.0,20.0
48723,4,8723,[185 288 186 161 179],405,3,35871,4.111760660247593,0.0,20.0
48724,4,8724,[ 64 483 313 318  11],214,5,35876,4.111862464183381,80.0,20.0
48725,4,8725,[655 143 161 181 568],128,4,35880,4.111849644739858,0.0,20.0
48726,4,8726,[ 64 483 313 318  11],618,5,35885,4.11195141514839,80.0,20.0
48727,4,8727,[ 15 183 121 117 289],416,4,35889,4.111938588450962,0.0,0.0
48728,4,8728,[603 238 194   8  56],405,3,35892,4.111811204032535,0.0,0.0
48729,4,8729,[289 678  88  70   7],416,2,35894,4.1115693012600225,0.0,0.0
48730,4,8730,[ 64 483 313 318  11],618,5,35899,4.111671057152674,80.0,20.0
48731,4,8731,[237 515 427 265 182],230,4,35903,4.111658268437929,0.0,0.0
48732,4,8732,[ 64 483 313 318  11],618,5,35908,4.111759990839345,80.0,20.0
48733,4,8733,[204 187 655 180 423],373,2,35910,4.111518204717197,0.0,0.0
48734,4,8734,[ 64 483 313 318  11],618,5,35915,4.111619919862622,80.0,20.0
48735,4,8735,[174  56 117  88 275],128,3,35918,4.111492673992674,0.0,0.0
48736,4,8736,[ 64 483 313 318  11],214,5,35923,4.111594368776468,80.0,20.0
48737,4,8737,[ 64 483 313 318  11],618,5,35928,4.111696040283817,80.0,20.0
48738,4,8738,[ 64 483 313 318  11],618,5,35933,4.1117976885227145,80.0,20.0
48739,4,8739,[273  97 742   8 210],253,4,35937,4.111784897025172,0.0,0.0
48740,4,8740,[ 64 483 313 318  11],618,5,35942,4.11188651184075,80.0,20.0
48741,4,8741,[748 151 125 496 385],642,4,35946,4.111873713109128,0.0,0.0
48742,4,8742,[ 64 483 313 318  11],618,5,35951,4.111975294521331,80.0,20.0
48743,4,8743,[357   1 174 153 176],698,3,35954,4.111848124428179,0.0,0.0
48744,4,8744,[ 12 121 168 172 257],214,2,35956,4.111606632361349,20.0,0.0
48745,4,8745,[ 64 483 313 318  11],214,5,35961,4.111708209467185,80.0,20.0
48746,4,8746,[ 64 483 313 318  11],214,5,35966,4.111809763347433,80.0,20.0
48747,4,8747,[183   7 191 273  25],618,4,35970,4.111796982167353,0.0,0.0
48748,4,8748,[180 204 175 475 258],805,2,35972,4.111555606355012,0.0,0.0
48749,4,8749,[ 64 483 313 318  11],214,5,35977,4.111657142857143,80.0,20.0
48750,4,8750,[161 357 546 427 288],416,4,35981,4.111644383499029,0.0,20.0
48751,4,8751,[405  95 118 127 216],43,5,35986,4.111745886654479,0.0,0.0
48752,4,8752,[ 64 483 313 318  11],214,5,35991,4.11184736661716,80.0,20.0
48753,4,8753,[ 64 483 313 318  11],618,5,35996,4.11194882339502,80.0,20.0
48754,4,8754,[275 118  88 191 588],416,3,35999,4.111821816105083,0.0,0.0
48755,4,8755,[ 95 282 181 194 125],416,4,36003,4.11180904522613,0.0,20.0
48756,4,8756,[ 64 483 313 318  11],618,5,36008,4.111910471622702,80.0,20.0
48757,4,8757,[328 153 204  97 258],721,4,36012,4.111897693537338,0.0,0.0
48758,4,8758,[ 88 161 181 385 186],618,5,36017,4.111999086653728,0.0,20.0
48759,4,8759,[ 64 483 313 318  11],618,5,36022,4.112100456621005,80.0,20.0
48760,4,8760,[ 64 483 313 318  11],214,5,36027,4.112201803447095,80.0,20.0
48761,4,8761,[ 64 483 313 318  11],618,5,36032,4.112303127139922,80.0,20.0
48762,4,8762,[ 64 483 313 318  11],214,5,36037,4.112404427707406,80.0,20.0
48763,4,8763,[ 64 483 313 318  11],618,5,36042,4.112505705157463,80.0,20.0
48764,4,8764,[294 127 405 181 597],887,4,36046,4.1124928693667995,0.0,20.0
48765,4,8765,[ 64 483 313 318  11],214,5,36051,4.1125941136208075,80.0,20.0
48766,4,8766,[228 423 385 174 748],198,1,36052,4.112239078362039,0.0,0.0
48767,4,8767,[258  69 238 144 597],417,2,36054,4.111998175182482,0.0,0.0
48768,4,8768,[187 286  11 194 322],416,4,36058,4.111985403124644,0.0,0.0
48769,4,8769,[288 273 185 286  97],417,2,36060,4.111744583808438,0.0,20.0
48770,4,8770,[ 12 121 194 597 742],854,1,36061,4.111389807319576,20.0,0.0
48771,4,8771,[273 132 496 173  97],618,4,36065,4.111377108983128,0.0,0.0
48772,4,8772,[ 64 483 313 318  11],214,5,36070,4.111478399635245,80.0,20.0
48773,4,8773,[176  97 268 273 127],417,4,36074,4.111465694096193,0.0,0.0
48774,4,8774,[ 64 483 313 318  11],618,5,36079,4.111566951566951,80.0,20.0
48775,4,8775,[118 748 546 597 742],417,2,36081,4.111326344576117,0.0,0.0
48776,4,8776,[ 64 483 313 318  11],214,5,36086,4.111427594850176,80.0,20.0
48777,4,8777,[ 64 483 313 318  11],214,5,36091,4.111528822055138,80.0,20.0
48778,4,8778,[471  82 234 186  79],618,4,36095,4.111516118008885,0.0,0.0
48779,4,8779,[  7 300 237 742 275],24,5,36100,4.111617312072893,0.0,0.0
48780,4,8780,[ 64 483 313 318  11],618,5,36105,4.111718483088486,80.0,20.0
48781,4,8781,[282 238 194 174 151],297,2,36107,4.111478023229333,0.0,0.0
48782,4,8782,[ 70 222 180 100 168],198,1,36108,4.111123761812593,0.0,0.0
48783,4,8783,[191 172 151 282 405],128,2,36110,4.110883424408015,0.0,0.0
48784,4,8784,[588 268 328 546 181],49,1,36111,4.110529311326124,0.0,20.0
48785,4,8785,[405  88  11 678  64],416,3,36114,4.110402913726383,20.0,0.0
48786,4,8786,[ 64 483 313 318  11],618,5,36119,4.110504153863662,80.0,20.0
48787,4,8787,[ 64 483 313 318  11],618,5,36124,4.110605370960401,80.0,20.0
48788,4,8788,[ 64 483 313 318  11],618,5,36129,4.110706565024462,80.0,20.0
48789,4,8789,[  1 174 271  50 100],297,3,36132,4.110580204778157,0.0,20.0
48790,4,8790,[ 64 483 313 318  11],618,5,36137,4.110681378682743,80.0,20.0
48791,4,8791,[269 215   1 117 238],345,4,36141,4.110668789808917,0.0,0.0
48792,4,8792,[ 64 483 313 318  11],618,5,36146,4.110769930626635,80.0,20.0
48793,4,8793,[ 70 357 183 173 385],405,2,36148,4.110529906754605,0.0,0.0
48794,4,8794,[423 508 286 204  79],297,2,36150,4.110289937464469,0.0,0.0
48795,4,8795,[ 64 483 313 318  11],214,5,36155,4.110391086857662,80.0,20.0
48796,4,8796,[118  11 161   4 175],805,1,36156,4.110037512788451,0.0,0.0
48797,4,8797,[215  11 197  12 204],297,2,36158,4.1097976812912025,20.0,0.0
48798,4,8798,[  4 210 678 168 181],805,2,36160,4.109557904307308,0.0,20.0
48799,4,8799,[ 64 483 313 318  11],214,5,36165,4.109659090909091,80.0,20.0
48800,4,8800,[ 95 427 153  97 143],198,2,36167,4.109419384160891,0.0,0.0
48801,4,8801,[132 181 182  79 423],417,3,36170,4.109293342422177,0.0,20.0
48802,4,8802,[ 64 483 313 318  11],618,5,36175,4.109394524593888,80.0,20.0
48803,4,8803,[ 64 483 313 318  11],618,5,36180,4.1094956837801,80.0,20.0
48804,4,8804,[ 79 655 183 135 168],437,3,36183,4.109369676320273,0.0,0.0
48805,4,8805,[182   4 127 185 238],618,3,36186,4.109243697478991,0.0,0.0
48806,4,8806,[200 257 286  70 168],297,3,36189,4.109117747246509,0.0,0.0
48807,4,8807,[ 50 471 238 301 273],416,5,36194,4.10921889191644,0.0,20.0
48808,4,8808,[ 64 483 313 318  11],618,5,36199,4.1093200136224315,80.0,20.0
48809,4,8809,[ 64 483 313 318  11],214,5,36204,4.109421112372305,80.0,20.0
48810,4,8810,[222  98 597 180 125],854,3,36207,4.1092951991828395,0.0,20.0
48811,4,8811,[ 12  64 568 655 238],417,4,36211,4.109282796187018,40.0,0.0
48812,4,8812,[174 275 144 179 273],62,4,36215,4.1092703960059005,0.0,0.0
48813,4,8813,[ 11  28 175  95 748],297,3,36218,4.109144542772861,0.0,0.0
48814,4,8814,[294  50  79 238 357],230,4,36222,4.109132161089053,0.0,20.0
48815,4,8815,[ 95 515  82 568 168],416,4,36226,4.109119782214156,0.0,0.0
48816,4,8816,[423 144 588 132 222],588,2,36228,4.108880571623001,0.0,0.0
48817,4,8817,[ 64 483 313 318  11],618,5,36233,4.108981628487185,80.0,20.0
48818,4,8818,[151  95   8 176  56],437,4,36237,4.108969270892391,0.0,0.0
48819,4,8819,[269 271 258 742 289],854,3,36240,4.108843537414966,0.0,0.0
48820,4,8820,[ 96  79 132 197 174],416,5,36245,4.108944564108378,0.0,0.0
48821,4,8821,[211 423 144 238 268],297,3,36248,4.108818861936069,0.0,0.0
48822,4,8822,[135 211 475 195 238],417,4,36252,4.108806528391703,0.0,0.0
48823,4,8823,[ 64 483 313 318  11],214,5,36257,4.108907524932004,80.0,20.0
48824,4,8824,[318  79 288   9 187],416,5,36262,4.109008498583569,20.0,20.0
48825,4,8825,[328 475 197  56  12],854,4,36266,4.108996147745298,20.0,0.0
48826,4,8826,[ 95 678 168 175 144],805,3,36269,4.108870510932366,0.0,0.0
48827,4,8827,[ 64 483 313 318  11],618,5,36274,4.108971454463072,80.0,20.0
48828,4,8828,[ 64 483 313 318  11],214,5,36279,4.109072375127421,80.0,20.0
48829,4,8829,[153 143 118 300 174],198,2,36281,4.108833522083805,0.0,0.0
48830,4,8830,[ 64 483 313 318  11],618,5,36286,4.108934435511267,80.0,20.0
48831,4,8831,[222 235  95 185 273],417,1,36287,4.1085824275362315,0.0,0.0
48832,4,8832,[ 64 483 313 318  11],214,5,36292,4.108683346541379,80.0,20.0
48833,4,8833,[282 238 117  70 186],128,3,36295,4.108557844690966,0.0,0.0
48834,4,8834,[ 64 483 313 318  11],618,5,36300,4.108658743633277,80.0,20.0
48835,4,8835,[597  71 269 179 546],805,2,36302,4.108420099592576,0.0,0.0
48836,4,8836,[234   4 289   7 132],416,4,36306,4.10840783071178,0.0,0.0
48837,4,8837,[475 268 153  96 216],854,2,36308,4.1081692690653995,0.0,0.0
48838,4,8838,[ 15  28 237 216 318],618,3,36311,4.108043896368367,20.0,0.0
48839,4,8839,[ 64 483 313 318  11],214,5,36316,4.10814479638009,80.0,20.0
48840,4,8840,[117 435 385 228  50],230,3,36319,4.108019454812804,0.0,20.0
48841,4,8841,[ 64 483 313 318  11],214,5,36324,4.10812033476589,80.0,20.0
48842,4,8842,[ 64 483 313 318  11],618,5,36329,4.1082211919032,80.0,20.0
48843,4,8843,[ 64 483 313 318  11],618,5,36334,4.108322026232474,80.0,20.0
48844,4,8844,[ 70  15 655  88  96],618,2,36336,4.108083663086489,0.0,0.0
48845,4,8845,[143   7 403 475 181],49,2,36338,4.10784535383224,0.0,20.0
48846,4,8846,[ 64 483 313 318  11],214,5,36343,4.107946196450774,80.0,20.0
48847,4,8847,[ 64 483 313 318  11],618,5,36348,4.108047016274864,80.0,20.0
48848,4,8848,[ 11   8 546 568  22],314,5,36353,4.108147813312239,0.0,0.0
48849,4,8849,[ 64 483 313 318  11],214,5,36358,4.108248587570621,80.0,20.0
48850,4,8850,[121 174 515 435 186],230,5,36363,4.1083493390577335,0.0,0.0
48851,4,8851,[180 121 257 222 423],887,3,36366,4.108224130140082,0.0,0.0
48852,4,8852,[ 64 483 313 318  11],618,5,36371,4.108324861628827,80.0,20.0
48853,4,8853,[ 64 483 313 318  11],214,5,36376,4.108425570363678,80.0,20.0
48854,4,8854,[ 64 483 313 318  11],618,5,36381,4.108526256352343,80.0,20.0
48855,4,8855,[271 195 135 216 237],62,3,36384,4.10840108401084,0.0,0.0
48856,4,8856,[ 15 161 286 185  11],437,2,36386,4.108163034887659,0.0,0.0
48857,4,8857,[187  82 127 176 182],618,5,36391,4.10826371641454,0.0,0.0
48858,4,8858,[121   1 182 181 423],416,5,36396,4.108364375211649,0.0,20.0
48859,4,8859,[ 69 742 294   9 121],416,5,36401,4.108465011286682,0.0,0.0
48860,4,8860,[ 64 483 313 318  11],618,5,36406,4.108565624647331,80.0,20.0
48861,4,8861,[ 64 483 313 318  11],214,5,36411,4.1086662153012865,80.0,20.0
48862,4,8862,[257 286 322 127 173],854,2,36413,4.108428297416225,0.0,0.0
48863,4,8863,[ 22 257 515 289  69],416,3,36416,4.108303249097473,0.0,0.0
48864,4,8864,[ 64 483 313 318  11],618,5,36421,4.108403835307389,80.0,20.0
48865,4,8865,[196   8 289 282 204],342,2,36423,4.108166027520866,0.0,0.0
48866,4,8866,[ 71 258  82 568 238],654,4,36427,4.108153828803428,0.0,0.0
48867,4,8867,[216 200  82  97 238],437,3,36430,4.108028867839423,0.0,0.0
48868,4,8868,[173 186 222 132 258],198,4,36434,4.108016687337918,0.0,0.0
48869,4,8869,[202 323 313 151 471],416,3,36437,4.107891770011274,20.0,20.0
48870,4,8870,[ 64 483 313 318  11],618,5,36442,4.1079923345733285,80.0,20.0
48871,4,8871,[ 64 483 313 318  11],214,5,36447,4.108092876465284,80.0,20.0
48872,4,8872,[ 64 483 313 318  11],214,5,36452,4.108193395694805,80.0,20.0
48873,4,8873,[161 191 322 258 515],417,3,36455,4.108068514762227,0.0,0.0
48874,4,8874,[ 64 483 313 318  11],618,5,36460,4.108169014084507,80.0,20.0
48875,4,8875,[ 64 483 313 318  11],618,5,36465,4.108269490761605,80.0,20.0
48876,4,8876,[328 216 200   9   1],416,5,36470,4.108369944801171,0.0,0.0
48877,4,8877,[ 64 483 313 318  11],214,5,36475,4.1084703762108585,80.0,20.0
48878,4,8878,[168 179 216 269 174],373,4,36479,4.1084581597026695,0.0,0.0
48879,4,8879,[301 515  25 508 678],297,4,36483,4.108445945945946,0.0,0.0
48880,4,8880,[ 64 483 313 318  11],214,5,36488,4.108546334872199,80.0,20.0
48881,4,8881,[357 268 125 546 181],417,3,36491,4.10842152668318,0.0,20.0
48882,4,8882,[ 88 655 328 204 301],416,4,36495,4.108409321175278,0.0,0.0
48883,4,8883,[234  69 173 183 121],198,3,36498,4.108284556506078,0.0,0.0
48884,4,8884,[655 546 385   8 176],805,1,36499,4.10793472144063,0.0,0.0
48885,4,8885,[ 64 483 313 318  11],618,5,36504,4.108035111411208,80.0,20.0
48886,4,8886,[175  88 328 151 215],43,4,36508,4.108022954877912,0.0,0.0
48887,4,8887,[ 64 483 313 318  11],214,5,36513,4.108123312331233,80.0,20.0
48888,4,8888,[144 153 515 117 204],297,3,36516,4.107998650016874,0.0,0.0
48889,4,8889,[403  56 161  11 276],618,4,36520,4.107986501687289,0.0,0.0
48890,4,8890,[282  50 174 215 238],618,3,36523,4.107861882802834,0.0,20.0
48891,4,8891,[216 215 546 268 195],416,4,36527,4.107849752586595,0.0,0.0
48892,4,8892,[ 64 483 313 318  11],618,5,36532,4.107950073091195,80.0,20.0
48893,4,8893,[118 237 235   7 222],854,2,36534,4.107713064987632,0.0,0.0
48894,4,8894,[288  98 151 276   1],618,2,36536,4.107476110174256,0.0,40.0
48895,4,8895,[215 144   7 176 268],297,3,36539,4.107351618705036,0.0,0.0
48896,4,8896,[235 117  11 333  97],416,4,36543,4.1073395526582,0.0,0.0
48897,4,8897,[ 25 301 182 185 235],49,1,36544,4.106990334906721,0.0,0.0
48898,4,8898,[ 64 483 313 318  11],618,5,36549,4.107090684346556,80.0,20.0
48899,4,8899,[143 118 191 546 323],805,2,36551,4.1068539325842695,0.0,0.0
48900,4,8900,[168 195 288  12 135],417,3,36554,4.106729580945961,20.0,20.0
48901,4,8901,[475 237 216 655 118],416,2,36556,4.106492922938665,0.0,0.0
48902,4,8902,[ 64 483 313 318  11],214,5,36561,4.106593283162979,80.0,20.0
48903,4,8903,[ 64 483 313 318  11],214,5,36566,4.106693620844564,80.0,20.0
48904,4,8904,[ 69 588 222  25 265],417,0,36566,4.106232453677709,0.0,0.0
48905,4,8905,[333 678 286  15 182],416,4,36570,4.1062205254884345,0.0,0.0
48906,4,8906,[ 64 483 313 318  11],214,5,36575,4.106320871224879,80.0,20.0
48907,4,8907,[ 64 483 313 318  11],618,5,36580,4.106421194431971,80.0,20.0
48908,4,8908,[ 64 483 313 318  11],618,5,36585,4.106521495117297,80.0,20.0
48909,4,8909,[ 64 483 313 318  11],214,5,36590,4.10662177328844,80.0,20.0
48910,4,8910,[ 64 483 313 318  11],618,5,36595,4.106722028952979,80.0,20.0
48911,4,8911,[185 143 168 222 258],711,4,36599,4.106710053859964,0.0,0.0
48912,4,8912,[ 64 483 313 318  11],214,5,36604,4.106810277123303,80.0,20.0
48913,4,8913,[ 64 483 313 318  11],618,5,36609,4.106910477899933,80.0,20.0
48914,4,8914,[ 64 483 313 318  11],618,5,36614,4.10701065619742,80.0,20.0
48915,4,8915,[200 237 508 678 121],345,3,36617,4.106886496186631,0.0,0.0
48916,4,8916,[ 98 186 174 161 211],43,4,36621,4.106874509364136,0.0,20.0
48917,4,8917,[ 64 483 313 318  11],214,5,36626,4.106974657995067,80.0,20.0
48918,4,8918,[ 97  71 183 515 286],416,5,36631,4.107074784168629,0.0,0.0
48919,4,8919,[ 64 483 313 318  11],214,5,36636,4.107174887892377,80.0,20.0
48920,4,8920,[588   8 204  64 183],405,3,36639,4.107050779060644,20.0,0.0
48921,4,8921,[  7 258  95 328 265],416,4,36643,4.107038780542479,0.0,0.0
48922,4,8922,[ 64 483 313 318  11],214,5,36648,4.1071388546452985,80.0,20.0
48923,4,8923,[ 64 483 313 318  11],618,5,36653,4.107238906320036,80.0,20.0
48924,4,8924,[ 64 483 313 318  11],214,5,36658,4.10733893557423,80.0,20.0
48925,4,8925,[294 435 204 238  79],230,4,36662,4.107326910150123,0.0,0.0
48926,4,8926,[ 64 483 313 318  11],618,5,36667,4.107426907135656,80.0,20.0
48927,4,8927,[ 64 483 313 318  11],214,5,36672,4.10752688172043,80.0,20.0
48928,4,8928,[ 70 144 176 237  56],416,4,36676,4.107514839287714,0.0,0.0
48929,4,8929,[ 64 483 313 318  11],214,5,36681,4.107614781634938,80.0,20.0
48930,4,8930,[588 222 245 423 176],417,3,36684,4.1074907625125965,0.0,0.0
48931,4,8931,[ 64 483 313 318  11],618,5,36689,4.107590685176892,80.0,20.0
48932,4,8932,[496  28 655 258 196],128,3,36692,4.107466696518527,0.0,0.0
48933,4,8933,[ 97 483 191 187  96],618,4,36696,4.107454667562123,20.0,0.0
48934,4,8934,[ 64 483 313 318  11],214,5,36701,4.107554560716284,80.0,20.0
48935,4,8935,[ 64 483 313 318  11],214,5,36706,4.107654431512981,80.0,20.0
48936,4,8936,[ 64 483 313 318  11],618,5,36711,4.107754279959718,80.0,20.0
48937,4,8937,[195 121 172 748 237],416,4,36715,4.107742224211233,0.0,0.0
48938,4,8938,[ 64 483 313 318  11],214,5,36720,4.1078420404967,80.0,20.0
48939,4,8939,[ 64 483 313 318  11],214,5,36725,4.107941834451902,80.0,20.0
48940,4,8940,[161 237 403  50 385],588,2,36727,4.10770607314618,0.0,20.0
48941,4,8941,[ 64 483 313 318  11],618,5,36732,4.1078058599865805,80.0,20.0
48942,4,8942,[ 82  98  56 187  28],887,4,36736,4.107793805210779,0.0,20.0
48943,4,8943,[427  97 318 183   8],405,3,36739,4.107669946332737,20.0,0.0
48944,4,8944,[237 176  28  98 276],62,3,36742,4.107546115148128,0.0,20.0
48945,4,8945,[ 70 168 238 301 200],711,5,36747,4.107645875251509,0.0,0.0
48946,4,8946,[210  95 174 191   1],805,2,36749,4.1074103051302115,0.0,0.0
48947,4,8947,[235 269 175 385 151],43,3,36752,4.107286544479213,0.0,0.0
48948,4,8948,[318 300  96 173 151],198,4,36756,4.107274555816292,20.0,0.0
48949,4,8949,[ 64 483 313 318  11],618,5,36761,4.107374301675978,80.0,20.0
48950,4,8950,[ 64 483 313 318  11],618,5,36766,4.1074740252485755,80.0,20.0
48951,4,8951,[435 161 197 100  28],437,2,36768,4.107238605898123,0.0,0.0
48952,4,8952,[ 64 483 313 318  11],214,5,36773,4.10733832235005,80.0,20.0
48953,4,8953,[117 269 496 100  15],416,5,36778,4.107438016528926,0.0,0.0
48954,4,8954,[275  28 268 197 265],128,4,36782,4.107426018983808,0.0,0.0
48955,4,8955,[ 64 483 313 318  11],618,5,36787,4.107525681107638,80.0,20.0
48956,4,8956,[294 144 216 183 275],62,3,36790,4.1074020319303335,0.0,0.0
48957,4,8957,[118 204 186 135 195],642,2,36792,4.107166778298727,0.0,0.0
48958,4,8958,[238 216  98 182  79],96,5,36797,4.107266435986159,0.0,20.0
48959,4,8959,[258 195 271 276 153],62,4,36801,4.107254464285714,0.0,0.0
48960,4,8960,[ 69 161 111 318 202],345,3,36804,4.107130900569133,20.0,0.0
48961,4,8961,[546 301 118   9 588],159,2,36806,4.106895782191475,0.0,0.0
48962,4,8962,[237 265  96 742 168],230,4,36810,4.1068838558518355,0.0,0.0
48963,4,8963,[118 143 234 471 172],618,3,36813,4.106760374832664,0.0,0.0
48964,4,8964,[ 25  97 475 228 161],711,4,36817,4.1067484662576685,0.0,0.0
48965,4,8965,[ 28 168 276 175 211],43,4,36821,4.106736560339058,0.0,0.0
48966,4,8966,[568 748 186 179 117],417,4,36825,4.1067246570759455,0.0,0.0
48967,4,8967,[172 234 161 237 100],437,4,36829,4.10671275646744,0.0,0.0
48968,4,8968,[ 64 483 313 318  11],214,5,36834,4.106812353662615,80.0,20.0
48969,4,8969,[237  98  15 286   8],437,4,36838,4.1068004459308804,0.0,20.0
48970,4,8970,[ 64 483 313 318  11],214,5,36843,4.1069000111470295,80.0,20.0
48971,4,8971,[ 64 483 313 318  11],214,5,36848,4.1069995541685245,80.0,20.0
48972,4,8972,[ 79   8  96 496 273],253,4,36852,4.1069876295553325,0.0,0.0
48973,4,8973,[ 64 483 313 318  11],214,5,36857,4.107087140628482,80.0,20.0
48974,4,8974,[ 64 483 313 318  11],618,5,36862,4.1071866295264625,80.0,20.0
48975,4,8975,[ 64 483 313 318  11],618,5,36867,4.107286096256685,80.0,20.0
48976,4,8976,[210 195 475 197 235],297,2,36869,4.107051353458839,0.0,0.0
48977,4,8977,[ 64 483 313 318  11],214,5,36874,4.107150813098686,80.0,20.0
48978,4,8978,[222 742 153  97 168],253,3,36877,4.10702750863125,0.0,0.0
48979,4,8979,[ 64 483 313 318  11],214,5,36882,4.107126948775056,80.0,20.0
48980,4,8980,[ 64 483 313 318  11],214,5,36887,4.107226366774301,80.0,20.0
48981,4,8981,[ 50 100 168  95  22],253,4,36891,4.1072144288577155,0.0,20.0
48982,4,8982,[405 183  70 179 597],62,2,36893,4.106979850829345,0.0,0.0
48983,4,8983,[ 64 483 313 318  11],214,5,36898,4.107079252003562,80.0,20.0
48984,4,8984,[ 64 483 313 318  11],214,5,36903,4.107178631051753,80.0,20.0
48985,4,8985,[ 64 483 313 318  11],214,5,36908,4.107277987981305,80.0,20.0
48986,4,8986,[ 64 483 313 318  11],618,5,36913,4.107377322799599,80.0,20.0
48987,4,8987,[ 64 483 313 318  11],214,5,36918,4.107476635514018,80.0,20.0
48988,4,8988,[183 276  98 168 174],618,4,36922,4.107464679052175,0.0,20.0
48989,4,8989,[ 82 301 179 174  98],751,5,36927,4.107563959955506,0.0,20.0
48990,4,8990,[ 95 197 597 125  25],618,1,36928,4.107218329440552,0.0,0.0
48991,4,8991,[ 64 483 313 318  11],214,5,36933,4.107317615658363,80.0,20.0
48992,4,8992,[ 71 238  12 294 323],805,3,36936,4.107194484599133,20.0,0.0
48993,4,8993,[ 64 483 313 318  11],618,5,36941,4.107293751389816,80.0,20.0
48994,4,8994,[  4 168 318 186 183],618,4,36945,4.10728182323513,20.0,0.0
48995,4,8995,[ 64 483 313 318  11],214,5,36950,4.1073810582481105,80.0,20.0
48996,4,8996,[ 79 180 111 132 742],854,3,36953,4.107257974880516,0.0,0.0
48997,4,8997,[ 70 423  50 742 179],416,4,36957,4.107246054678818,0.0,20.0
48998,4,8998,[427 168  15 187  12],618,4,36961,4.107234137126348,20.0,0.0
48999,4,8999,[183 275  50 300 172],416,5,36966,4.107333333333333,0.0,20.0
49000,4,9000,[282 515 546 301 185],297,3,36969,4.107210309965559,0.0,0.0
49001,4,9001,[471  15 301  97 151],416,4,36973,4.107198400355476,0.0,0.0
49002,4,9002,[ 64 483 313 318  11],618,5,36978,4.107297567477508,80.0,20.0
49003,4,9003,[ 64 483 313 318  11],618,5,36983,4.10739671257219,80.0,20.0
49004,4,9004,[ 64 483 313 318  11],618,5,36988,4.107495835646863,80.0,20.0
49005,4,9005,[161 181  88 173 202],711,4,36992,4.107483899622474,0.0,20.0
49006,4,9006,[ 64 483 313 318  11],618,5,36997,4.1075829910069945,80.0,20.0
49007,4,9007,[ 64 483 313 318  11],618,5,37002,4.107682060390764,80.0,20.0
49008,4,9008,[ 64 483 313 318  11],618,5,37007,4.107781107781108,80.0,20.0
49009,4,9009,[ 64 483 313 318  11],214,5,37012,4.10788013318535,80.0,20.0
49010,4,9010,[258 204  11 237 173],416,4,37016,4.1078681611363885,0.0,0.0
49011,4,9011,[ 64 483 313 318  11],214,5,37021,4.107967154904571,80.0,20.0
49012,4,9012,[ 64 483 313 318  11],618,5,37026,4.108066126705869,80.0,20.0
49013,4,9013,[427  88  70 234 176],618,4,37030,4.108054138007544,0.0,0.0
49014,4,9014,[ 64 483 313 318  11],618,5,37035,4.108153078202995,80.0,20.0
49015,4,9015,[ 64 483 313 318  11],618,5,37040,4.108251996450754,80.0,20.0
49016,4,9016,[ 64 483 313 318  11],214,5,37045,4.108350892758123,80.0,20.0
49017,4,9017,[125  89  69  71 186],373,5,37050,4.108449767132402,0.0,0.0
49018,4,9018,[ 71 187 215 210 515],416,5,37055,4.108548619580885,0.0,0.0
49019,4,9019,[127  96 265 655  56],198,4,37059,4.1085365853658535,0.0,0.0
49020,4,9020,[  4 173 237 568  69],198,2,37061,4.108302848908103,0.0,0.0
49021,4,9021,[ 64 483 313 318  11],618,5,37066,4.108401684770561,80.0,20.0
49022,4,9022,[ 64 483 313 318  11],214,5,37071,4.108500498725479,80.0,20.0
49023,4,9023,[ 22  98 294  96 174],854,1,37072,4.108156028368795,0.0,20.0
49024,4,9024,[ 64 483 313 318  11],214,5,37077,4.108254847645429,80.0,20.0
49025,4,9025,[181 237 302 210 179],751,4,37081,4.108242853977399,0.0,20.0
49026,4,9026,[235 748 210 175  56],297,3,37084,4.108120084191869,0.0,0.0
49027,4,9027,[172 125   7 496  50],262,2,37086,4.10788657509969,0.0,20.0
49028,4,9028,[ 64 483 313 318  11],618,5,37091,4.107985380440802,80.0,20.0
49029,4,9029,[ 64 483 313 318  11],214,5,37096,4.108084163898117,80.0,20.0
49030,4,9030,[ 12  22 202 301 289],588,3,37099,4.107961466061345,20.0,0.0
49031,4,9031,[ 64 483 313 318  11],214,5,37104,4.108060230292294,80.0,20.0
49032,4,9032,[ 69 100  28 496 265],437,2,37106,4.107826857079597,0.0,0.0
49033,4,9033,[127 588 151 216 143],416,4,37110,4.107814921408014,0.0,0.0
49034,4,9034,[ 64 483 313 318  11],618,5,37115,4.107913669064748,80.0,20.0
49035,4,9035,[  4  50  12 237 186],854,2,37117,4.1076803895528995,20.0,20.0
49036,4,9036,[ 64 483 313 318  11],214,5,37122,4.107779130242337,80.0,20.0
49037,4,9037,[ 64 483 313 318  11],618,5,37127,4.107877849081655,80.0,20.0
49038,4,9038,[ 50  22 289 172  70],721,3,37130,4.107755282664011,0.0,20.0
49039,4,9039,[ 64 483 313 318  11],618,5,37135,4.107853982300885,80.0,20.0
49040,4,9040,[ 64 483 313 318  11],618,5,37140,4.107952660103971,80.0,20.0
49041,4,9041,[268 182 258 195 475],297,3,37143,4.1078301260783014,0.0,0.0
49042,4,9042,[ 64 483 313 318  11],618,5,37148,4.1079287846953445,80.0,20.0
49043,4,9043,[ 64 483 313 318  11],214,5,37153,4.1080274214949135,80.0,20.0
49044,4,9044,[210 568 132 269 196],345,5,37158,4.108126036484245,0.0,0.0
49045,4,9045,[194 175 588 111 204],297,2,37160,4.107892991377405,0.0,0.0
49046,4,9046,[ 25 216 125   4   8],618,0,37160,4.107438930032055,0.0,0.0
49047,4,9047,[ 64 483 313 318  11],618,5,37165,4.1075375773651635,80.0,20.0
49048,4,9048,[568 143 197 427 144],416,5,37170,4.107636202895348,0.0,0.0
49049,4,9049,[ 64 483 313 318  11],214,5,37175,4.107734806629834,80.0,20.0
49050,4,9050,[ 64 483 313 318  11],618,5,37180,4.107833388575848,80.0,20.0
49051,4,9051,[196 275 235 515  28],416,4,37184,4.107821475916924,0.0,0.0
49052,4,9052,[ 11  70 597 216 427],416,4,37188,4.10780956588976,0.0,0.0
49053,4,9053,[ 64 483 313 318  11],618,5,37193,4.1079081069140715,80.0,20.0
49054,4,9054,[ 64 483 313 318  11],214,5,37198,4.108006626173385,80.0,20.0
49055,4,9055,[117 273 174 238 121],62,5,37203,4.108105123674911,0.0,0.0
49056,4,9056,[182   4 195 118 191],62,4,37207,4.108093187589709,0.0,0.0
49057,4,9057,[318  98 216 202 265],711,4,37211,4.108081254139987,20.0,20.0
49058,4,9058,[ 64 483 313 318  11],214,5,37216,4.108179710784855,80.0,20.0
49059,4,9059,[ 64 483 313 318  11],618,5,37221,4.1082781456953645,80.0,20.0
49060,4,9060,[ 69  28 127 100 195],62,4,37225,4.10826619578413,0.0,0.0
49061,4,9061,[118 200 276 172 427],416,3,37228,4.10814389759435,0.0,0.0
49062,4,9062,[ 64 483 313 318  11],618,5,37233,4.10824230387289,80.0,20.0
49063,4,9063,[294   8 173 508 143],297,4,37237,4.108230361871138,0.0,0.0
49064,4,9064,[ 64 483 313 318  11],618,5,37242,4.108328736900165,80.0,20.0
49065,4,9065,[ 64 483 313 318  11],618,5,37247,4.108427090227223,80.0,20.0
49066,4,9066,[ 64 483 313 318  11],618,5,37252,4.108525421859491,80.0,20.0
49067,4,9067,[ 70 168 588 180 211],437,2,37254,4.10829289810322,0.0,0.0
49068,4,9068,[186 174   7 276 294],43,4,37258,4.1082809571066266,0.0,0.0
49069,4,9069,[ 15   7 333 100 117],416,5,37263,4.108379272326351,0.0,0.0
49070,4,9070,[135 161   7 111 168],805,3,37266,4.108257083011796,0.0,0.0
49071,4,9071,[  1 300 294 144  69],416,5,37271,4.108355379188713,0.0,0.0
49072,4,9072,[ 64 483 313 318  11],214,5,37276,4.108453653697785,80.0,20.0
49073,4,9073,[ 98 403 215 294 172],922,3,37279,4.108331496583646,0.0,20.0
49074,4,9074,[185  11 173  12  79],805,4,37283,4.10831955922865,20.0,0.0
49075,4,9075,[ 64 483 313 318  11],618,5,37288,4.108417805200529,80.0,20.0
49076,4,9076,[ 64 483 313 318  11],214,5,37293,4.108516029525173,80.0,20.0
49077,4,9077,[328 118  11 288 289],416,3,37296,4.108393919365499,0.0,20.0
49078,4,9078,[180 196  69 405 151],128,4,37300,4.1083819803943165,0.0,0.0
49079,4,9079,[ 22 191  88 471 215],618,4,37304,4.108370044052863,0.0,0.0
49080,4,9080,[ 64 483 313 318  11],214,5,37309,4.108468230371105,80.0,20.0
49081,4,9081,[ 64 483 313 318  11],618,5,37314,4.108566395067166,80.0,20.0
49082,4,9082,[153 100 168  11 181],437,3,37317,4.108444346581526,0.0,20.0
49083,4,9083,[ 64 483 313 318  11],214,5,37322,4.108542492294143,80.0,20.0
49084,4,9084,[ 64 483 313 318  11],618,5,37327,4.108640616400661,80.0,20.0
49085,4,9085,[257  97 269 211 471],297,3,37330,4.1085186000440235,0.0,0.0
49086,4,9086,[ 82 275   4 172  96],618,2,37332,4.108286563222186,0.0,0.0
49087,4,9087,[ 64 483 313 318  11],618,5,37337,4.108384683098592,80.0,20.0
49088,4,9088,[172  79   4 111 191],43,5,37342,4.10848278138409,0.0,0.0
49089,4,9089,[ 64 483 313 318  11],618,5,37347,4.1085808580858085,80.0,20.0
49090,4,9090,[237 385  22  50 210],505,3,37350,4.1084589154108455,0.0,20.0
49091,4,9091,[ 95 135 496  15 194],373,4,37354,4.108446986361637,0.0,0.0
49092,4,9092,[216 742  28 135   1],805,2,37356,4.108215110524579,0.0,0.0
49093,4,9093,[318 385 546  71 273],416,4,37360,4.108203210908291,20.0,0.0
49094,4,9094,[ 64 483 313 318  11],214,5,37365,4.108301264431006,80.0,20.0
49095,4,9095,[ 64 483 313 318  11],618,5,37370,4.108399296394019,80.0,20.0
49096,4,9096,[168 238 234 210  95],437,3,37373,4.108277454105749,0.0,0.0
49097,4,9097,[ 64 483 313 318  11],618,5,37378,4.108375467135634,80.0,20.0
49098,4,9098,[ 64 483 313 318  11],214,5,37383,4.108473458621827,80.0,20.0
49099,4,9099,[655  88 245 197 302],345,4,37387,4.108461538461539,0.0,0.0
49100,4,9100,[ 64 483 313 318  11],214,5,37392,4.108559498956159,80.0,20.0
49101,4,9101,[ 64 483 313 318  11],618,5,37397,4.10865743792573,80.0,20.0
49102,4,9102,[202  56 100 161 143],345,3,37400,4.108535647588707,0.0,0.0
49103,4,9103,[301 294  50 289 144],588,3,37403,4.10841388400703,0.0,20.0
49104,4,9104,[ 64 483 313 318  11],618,5,37408,4.108511806699616,80.0,20.0
49105,4,9105,[194 265 161 176  88],416,4,37412,4.108499890182298,0.0,0.0
49106,4,9106,[ 64 483 313 318  11],214,5,37417,4.108597781925991,80.0,20.0
49107,4,9107,[265  96 475 179 132],198,4,37421,4.108585858585859,0.0,0.0
49108,4,9108,[215 318 322 100  28],679,2,37423,4.1083543747941595,20.0,0.0
49109,4,9109,[286 180 258 216 127],854,3,37426,4.108232711306257,0.0,0.0
49110,4,9110,[ 12   8 405  11 121],805,1,37427,4.107891559653167,20.0,0.0
49111,4,9111,[483 228 313  25 288],711,3,37430,4.107769973661107,40.0,40.0
49112,4,9112,[ 64 483 313 318  11],214,5,37435,4.107867881049051,80.0,20.0
49113,4,9113,[ 64 483 313 318  11],214,5,37440,4.107965766951942,80.0,20.0
49114,4,9114,[173 121 748 174  50],198,3,37443,4.107844212835984,0.0,20.0
49115,4,9115,[ 64 483 313 318  11],214,5,37448,4.107942079859588,80.0,20.0
49116,4,9116,[403 678 269 174 385],416,4,37452,4.107930240210596,0.0,0.0
49117,4,9117,[181  15 118 216  82],618,2,37454,4.107699056810704,0.0,20.0
49118,4,9118,[ 64 483 313 318  11],618,5,37459,4.107796907555653,80.0,20.0
49119,4,9119,[  4 238 135 385 216],417,2,37461,4.107565789473684,0.0,0.0
49120,4,9120,[ 64 483 313 318  11],214,5,37466,4.107663633373534,80.0,20.0
49121,4,9121,[ 64 483 313 318  11],214,5,37471,4.107761455821092,80.0,20.0
49122,4,9122,[ 64 483 313 318  11],618,5,37476,4.107859256823414,80.0,20.0
49123,4,9123,[ 64 483 313 318  11],214,5,37481,4.10795703638755,80.0,20.0
49124,4,9124,[483 100 288 144 121],854,3,37484,4.107835616438356,20.0,20.0
49125,4,9125,[ 95 202 748 111 183],416,4,37488,4.107823800131492,0.0,0.0
49126,4,9126,[ 64 483 313 318  11],618,5,37493,4.10792155144078,80.0,20.0
49127,4,9127,[180 403 194 655 215],405,3,37496,4.107800175284837,0.0,0.0
49128,4,9128,[ 64 483 313 318  11],618,5,37501,4.107897907766459,80.0,20.0
49129,4,9129,[427 483 182 508 282],128,4,37505,4.1078860898138005,20.0,0.0
49130,4,9130,[ 64 483 313 318  11],214,5,37510,4.107983791479575,80.0,20.0
49131,4,9131,[ 64 483 313 318  11],214,5,37515,4.108081471747701,80.0,20.0
49132,4,9132,[ 64 483 313 318  11],214,5,37520,4.108179130625206,80.0,20.0
49133,4,9133,[568 135 176  70  11],618,4,37524,4.108167287059339,0.0,0.0
49134,4,9134,[ 64 483 313 318  11],214,5,37529,4.108264915161467,80.0,20.0
49135,4,9135,[ 64 483 313 318  11],618,5,37534,4.108362521891419,80.0,20.0
49136,4,9136,[ 64 483 313 318  11],214,5,37539,4.108460107256211,80.0,20.0
49137,4,9137,[276 118 597 237 288],525,3,37542,4.108338804990151,0.0,20.0
49138,4,9138,[ 64 483 313 318  11],618,5,37547,4.108436371594267,80.0,20.0
49139,4,9139,[ 64 483 313 318  11],214,5,37552,4.108533916849015,80.0,20.0
49140,4,9140,[ 64 483 313 318  11],618,5,37557,4.108631440761405,80.0,20.0
49141,4,9141,[211  22 191 174 385],405,3,37560,4.108510172828702,0.0,0.0
49142,4,9142,[ 64 483 313 318  11],214,5,37565,4.108607678005031,80.0,20.0
49143,4,9143,[ 64 483 313 318  11],214,5,37570,4.108705161854768,80.0,20.0
49144,4,9144,[ 64 483 313 318  11],214,5,37575,4.10880262438491,80.0,20.0
49145,4,9145,[257 282 475  15 471],52,4,37579,4.108790728187186,0.0,0.0
49146,4,9146,[ 64 483 313 318  11],618,5,37584,4.1088881600524765,80.0,20.0
49147,4,9147,[ 70 258 268  97  95],416,4,37588,4.108876257105378,0.0,0.0
49148,4,9148,[234 182 144 655  70],437,2,37590,4.108645753634277,0.0,0.0
49149,4,9149,[ 56 275 121 294 357],854,3,37593,4.108524590163935,0.0,0.0
49150,4,9150,[268 202 111   1  98],416,5,37598,4.108622008523659,0.0,20.0
49151,4,9151,[ 64 483 313 318  11],214,5,37603,4.108719405594406,80.0,20.0
49152,4,9152,[204 385 597 121 294],588,4,37607,4.108707527586583,0.0,0.0
49153,4,9153,[ 64 483 313 318  11],618,5,37612,4.108804894035394,80.0,20.0
49154,4,9154,[ 64 483 313 318  11],618,5,37617,4.108902239213545,80.0,20.0
49155,4,9155,[ 64 483 313 318  11],214,5,37622,4.108999563128004,80.0,20.0
49156,4,9156,[ 64 483 313 318  11],618,5,37627,4.109096865785737,80.0,20.0
49157,4,9157,[210  97 300  69 144],297,2,37629,4.108866564752129,0.0,0.0
49158,4,9158,[182 568 496 288  64],618,4,37633,4.108854678458347,20.0,20.0
49159,4,9159,[273 237 258 333 245],416,3,37636,4.108733624454149,0.0,0.0
49160,4,9160,[ 64 483 313 318  11],618,5,37641,4.108830913655715,80.0,20.0
49161,4,9161,[202  79 194 237 196],921,3,37644,4.108709888670596,0.0,0.0
49162,4,9162,[245  69 100 288 273],62,3,37647,4.108588890101495,0.0,20.0
49163,4,9163,[216   9 282 257 151],854,2,37649,4.108358795285901,0.0,0.0
49164,4,9164,[273 151 127 427 333],416,4,37653,4.10834697217676,0.0,0.0
49165,4,9165,[ 64 483 313 318  11],214,5,37658,4.108444250490945,80.0,20.0
49166,4,9166,[282 237 174 176 191],618,4,37662,4.108432420639249,0.0,0.0
49167,4,9167,[ 97   8   9 132 275],62,4,37666,4.108420593368237,0.0,0.0
49168,4,9168,[ 64 483 313 318  11],618,5,37671,4.108517831824626,80.0,20.0
49169,4,9169,[ 64 483 313 318  11],618,5,37676,4.108615049073064,80.0,20.0
49170,4,9170,[168 294 427 179  98],601,3,37679,4.108494166394069,0.0,20.0
49171,4,9171,[568  28  97 496 742],128,3,37682,4.108373310074139,0.0,0.0
49172,4,9172,[195  56 173  82 276],62,5,37687,4.108470511283113,0.0,0.0
49173,4,9173,[ 12 655   4 215 111],618,3,37690,4.108349683889252,20.0,0.0
49174,4,9174,[ 64 483 313 318  11],618,5,37695,4.108446866485013,80.0,20.0
49175,4,9175,[ 64 483 313 318  11],214,5,37700,4.1085440278988665,80.0,20.0
49176,4,9176,[ 64 483 313 318  11],214,5,37705,4.108641168137735,80.0,20.0
49177,4,9177,[153 168 475 121 216],62,5,37710,4.108738287208542,0.0,0.0
49178,4,9178,[111 496 121 143 204],437,3,37713,4.108617496459309,0.0,0.0
49179,4,9179,[ 64 483 313 318  11],618,5,37718,4.108714596949891,80.0,20.0
49180,4,9180,[151 271 294 237 288],203,2,37720,4.108484914497332,0.0,20.0
49181,4,9181,[ 64 483 313 318  11],214,5,37725,4.108582008277064,80.0,20.0
49182,4,9182,[ 64 483 313 318  11],214,5,37730,4.1086790809103775,80.0,20.0
49183,4,9183,[ 64 483 313 318  11],214,5,37735,4.108776132404182,80.0,20.0
49184,4,9184,[275 181 496  95 127],416,4,37739,4.108764289602613,0.0,20.0
49185,4,9185,[403 423  82 302 200],49,1,37740,4.10842586544742,0.0,0.0
49186,4,9186,[ 64 483 313 318  11],618,5,37745,4.108522912811582,80.0,20.0
49187,4,9187,[181 323 100  50 151],620,4,37749,4.108511101436656,0.0,40.0
49188,4,9188,[196 173 257  96 603],751,5,37754,4.1086081184024374,0.0,0.0
49189,4,9189,[172  96   4  97  89],405,2,37756,4.108378672470076,0.0,0.0
49190,4,9190,[ 96 183 269  56 288],416,5,37761,4.108475682733109,0.0,20.0
49191,4,9191,[172 118 742 322 211],416,3,37764,4.108355091383812,0.0,0.0
49192,4,9192,[333 568 237  82 423],588,3,37767,4.108234526269988,0.0,0.0
49193,4,9193,[ 56 174 173 191 235],922,2,37769,4.108005220796171,0.0,0.0
49194,4,9194,[ 64 483 313 318  11],214,5,37774,4.108102229472539,80.0,20.0
49195,4,9195,[ 64 483 313 318  11],618,5,37779,4.108199217050892,80.0,20.0
49196,4,9196,[ 64 483 313 318  11],214,5,37784,4.10829618353811,80.0,20.0
49197,4,9197,[ 15 143 313 423 168],654,4,37788,4.1082844096542726,20.0,20.0
49198,4,9198,[179  12  82 245 125],62,4,37792,4.108272638330253,20.0,0.0
49199,4,9199,[288   1 191 100 597],416,4,37796,4.108260869565218,0.0,20.0
49200,4,9200,[ 64 483 313 318  11],214,5,37801,4.108357787197043,80.0,20.0
49201,4,9201,[ 64 483 313 318  11],618,5,37806,4.108454683764399,80.0,20.0
49202,4,9202,[483 273  79 238 135],618,4,37810,4.108442899054656,20.0,0.0
49203,4,9203,[ 64 483 313 318  11],618,5,37815,4.108539765319426,80.0,20.0
49204,4,9204,[ 64 483 313 318  11],618,5,37820,4.108636610537752,80.0,20.0
49205,4,9205,[282 237 273 182 475],297,3,37823,4.1085161850966765,0.0,0.0
49206,4,9206,[210  28 174 475 121],416,4,37827,4.108504398826979,0.0,0.0
49207,4,9207,[ 64 483 313 318  11],214,5,37832,4.108601216333623,80.0,20.0
49208,4,9208,[ 64 483 313 318  11],618,5,37837,4.108698012813552,80.0,20.0
49209,4,9209,[288 191  28 153   4],297,2,37839,4.108469055374592,0.0,20.0
49210,4,9210,[197 235 323   4  69],416,3,37842,4.108348713494735,0.0,0.0
49211,4,9211,[265  64 275 191 222],128,4,37846,4.108336951801998,20.0,0.0
49212,4,9212,[ 64 483 313 318  11],618,5,37851,4.108433734939759,80.0,20.0
49213,4,9213,[ 64 483 313 318  11],618,5,37856,4.108530497069677,80.0,20.0
49214,4,9214,[210   9 151  98  69],345,5,37861,4.108627238198589,0.0,20.0
49215,4,9215,[ 64 483 313 318  11],214,5,37866,4.108723958333333,80.0,20.0
49216,4,9216,[ 69  96 127 333  12],416,5,37871,4.108820657480742,20.0,0.0
49217,4,9217,[174 323  69 151 294],416,3,37874,4.108700368843567,0.0,0.0
49218,4,9218,[ 64 483 313 318  11],214,5,37879,4.108797049571537,80.0,20.0
49219,4,9219,[ 64 483 313 318  11],214,5,37884,4.108893709327549,80.0,20.0
49220,4,9220,[179  56 655 405  82],262,3,37887,4.108773451903264,0.0,0.0
49221,4,9221,[496 144 742 186  79],588,3,37890,4.108653220559532,0.0,0.0
49222,4,9222,[ 97 179 318 174 288],437,3,37893,4.108533015287867,20.0,20.0
49223,4,9223,[  1  97 603  70  69],128,3,37896,4.108412836079792,0.0,0.0
49224,4,9224,[ 64 483 313 318  11],214,5,37901,4.108509485094851,80.0,20.0
49225,4,9225,[357 200  22 323 588],805,3,37904,4.108389334489487,0.0,0.0
49226,4,9226,[174  70  11  95 191],262,3,37907,4.108269209927387,0.0,0.0
49227,4,9227,[182 197  95 127 603],416,4,37911,4.108257477243173,0.0,0.0
49228,4,9228,[100  97 196 117 202],417,4,37915,4.1082457471015275,0.0,0.0
49229,4,9229,[ 64 483 313 318  11],214,5,37920,4.108342361863489,80.0,20.0
49230,4,9230,[ 64 483 313 318  11],618,5,37925,4.108438955692774,80.0,20.0
49231,4,9231,[ 64 483 313 318  11],618,5,37930,4.108535528596187,80.0,20.0
49232,4,9232,[ 64 483 313 318  11],618,5,37935,4.108632080580526,80.0,20.0
49233,4,9233,[185 143 471 200 515],297,3,37938,4.108512020792722,0.0,0.0
49234,4,9234,[515 289  96 268 185],416,4,37942,4.108500270709258,0.0,0.0
49235,4,9235,[191 427  69   1  96],642,4,37946,4.1084885231702035,0.0,0.0
49236,4,9236,[235  96 603 195  69],854,2,37948,4.108260257659413,0.0,0.0
49237,4,9237,[ 64 483 313 318  11],618,5,37953,4.108356787183373,80.0,20.0
49238,4,9238,[143  28 117 121 210],805,0,37953,4.107912111700401,0.0,0.0
49239,4,9239,[ 64 483 313 318  11],618,5,37958,4.108008658008658,80.0,20.0
49240,4,9240,[  7 182 258 111 173],49,1,37959,4.1076723298344335,0.0,0.0
49241,4,9241,[ 50  15 294 127 588],253,5,37964,4.107768881194547,0.0,20.0
49242,4,9242,[ 25 183 276  15 135],618,2,37966,4.107540841718057,0.0,0.0
49243,4,9243,[ 64 483 313 318  11],618,5,37971,4.107637386412808,80.0,20.0
49244,4,9244,[172 210 182 423 179],198,4,37975,4.1076257436452135,0.0,0.0
49245,4,9245,[357 202 333  97 300],416,5,37980,4.107722258273848,0.0,0.0
49246,4,9246,[286 211  97  71  79],437,2,37982,4.107494322482967,0.0,0.0
49247,4,9247,[ 22  82 288 276 269],654,3,37985,4.107374567474048,0.0,20.0
49248,4,9248,[168  15 151 186  79],437,3,37988,4.1072548383609035,0.0,0.0
49249,4,9249,[286 216 288 211 748],437,3,37991,4.1071351351351355,0.0,20.0
49250,4,9250,[405  79 127 288 176],805,2,37993,4.106907361366339,0.0,20.0
49251,4,9251,[238   9 235 186 318],43,2,37995,4.1066796368352785,20.0,0.0
49252,4,9252,[508  28 286 202  56],345,2,37997,4.106451961525992,0.0,0.0
49253,4,9253,[238 197 181 282 210],297,3,38000,4.106332396801383,0.0,20.0
49254,4,9254,[ 64 483 313 318  11],618,5,38005,4.106428957320367,80.0,20.0
49255,4,9255,[276  69 173 288  64],214,2,38007,4.106201382886776,20.0,20.0
49256,4,9256,[ 64 483 313 318  11],618,5,38012,4.106297936696554,80.0,20.0
49257,4,9257,[ 64 483 313 318  11],214,5,38017,4.1063944696478725,80.0,20.0
49258,4,9258,[216 742 118 568 127],43,5,38022,4.106490981747489,0.0,0.0
49259,4,9259,[ 64 483 313 318  11],618,5,38027,4.106587473002159,80.0,20.0
49260,4,9260,[ 64 276 313 204 143],618,3,38030,4.106467984019004,40.0,20.0
49261,4,9261,[ 64 483 313 318  11],214,5,38035,4.106564456920752,80.0,20.0
49262,4,9262,[ 64 483 313 318  11],618,5,38040,4.106660908992767,80.0,20.0
49263,4,9263,[ 64 483 313 318  11],618,5,38045,4.1067573402417965,80.0,20.0
49264,4,9264,[ 64 483 313 318  11],618,5,38050,4.106853750674582,80.0,20.0
49265,4,9265,[ 64 483 313 318  11],618,5,38055,4.106950140297863,80.0,20.0
49266,4,9266,[ 64 483 313 318  11],214,5,38060,4.107046509118377,80.0,20.0
49267,4,9267,[ 64 483 313 318  11],214,5,38065,4.107142857142857,80.0,20.0
49268,4,9268,[151 289 176 211  56],416,3,38068,4.107023411371237,0.0,0.0
49269,4,9269,[ 64 483 313 318  11],214,5,38073,4.107119741100323,80.0,20.0
49270,4,9270,[ 64 483 313 318  11],214,5,38078,4.107216050048539,80.0,20.0
49271,4,9271,[176 568 427 222  56],887,3,38081,4.1070966350301985,0.0,0.0
49272,4,9272,[588 302  71  96 546],416,4,38085,4.1070850857327725,0.0,0.0
49273,4,9273,[ 28 318 144 125 197],373,2,38087,4.106857882251456,20.0,0.0
49274,4,9274,[328 185 132 210 173],416,5,38092,4.106954177897574,0.0,0.0
49275,4,9275,[ 64 483 313 318  11],214,5,38097,4.107050452781372,80.0,20.0
49276,4,9276,[ 64 483 313 318  11],618,5,38102,4.107146706909561,80.0,20.0
49277,4,9277,[483  12 200 318  79],854,5,38107,4.107242940288855,60.0,0.0
49278,4,9278,[ 64 483 313 318  11],618,5,38112,4.107339152925962,80.0,20.0
49279,4,9279,[ 64 483 313 318  11],618,5,38117,4.107435344827586,80.0,20.0
49280,4,9280,[168 180  79 238 161],711,5,38122,4.107531516000431,0.0,0.0
49281,4,9281,[ 64 483 313 318  11],214,5,38127,4.1076276664511955,80.0,20.0
49282,4,9282,[  8 222 125 185  82],601,2,38129,4.107400624798018,0.0,0.0
49283,4,9283,[111 117 322 318  82],416,4,38133,4.107389056441189,20.0,0.0
49284,4,9284,[211  12 176   7 183],416,5,38138,4.107485191168552,20.0,0.0
49285,4,9285,[ 64 483 313 318  11],618,5,38143,4.107581305190609,80.0,20.0
49286,4,9286,[161 172  28 597 204],588,5,38148,4.107677398514052,0.0,0.0
49287,4,9287,[257 427  15 265  69],922,4,38152,4.107665805340224,0.0,0.0
49288,4,9288,[210 215 265 181 286],297,3,38155,4.107546560447841,0.0,20.0
49289,4,9289,[ 64 483 313 318  11],618,5,38160,4.107642626480086,80.0,20.0
49290,4,9290,[210  79 127 268 245],417,3,38163,4.107523409751372,0.0,0.0
49291,4,9291,[ 64 483 313 318  11],618,5,38168,4.1076194575979335,80.0,20.0
49292,4,9292,[179  69  79 161 269],373,4,38172,4.107607876896589,0.0,0.0
49293,4,9293,[ 64 483 313 318  11],618,5,38177,4.107703894986012,80.0,20.0
49294,4,9294,[204  50 194 258 423],416,5,38182,4.107799892415277,0.0,20.0
49295,4,9295,[135 216  69 204 238],198,4,38186,4.107788296041308,0.0,0.0
49296,4,9296,[ 64 483 313 318  11],214,5,38191,4.107884263740992,80.0,20.0
49297,4,9297,[237 174 204 173 168],922,3,38194,4.107765110776511,0.0,0.0
49298,4,9298,[ 64 483 313 318  11],214,5,38199,4.107861060329068,80.0,20.0
49299,4,9299,[127 238 121 100 286],416,5,38204,4.107956989247312,0.0,0.0
49300,4,9300,[ 64 483 313 318  11],214,5,38209,4.108052897537899,80.0,20.0
49301,4,9301,[ 64 483 313 318  11],618,5,38214,4.108148785207482,80.0,20.0
49302,4,9302,[ 64 483 313 318  11],214,5,38219,4.1082446522627105,80.0,20.0
49303,4,9303,[496 121 196 301 200],437,3,38222,4.108125537403267,0.0,0.0
49304,4,9304,[ 64 483 313 318  11],618,5,38227,4.108221386351424,80.0,20.0
49305,4,9305,[ 64 483 313 318  11],618,5,38232,4.108317214700193,80.0,20.0
49306,4,9306,[ 64 483 313 318  11],618,5,38237,4.108413022456216,80.0,20.0
49307,4,9307,[ 64 483 313 318  11],214,5,38242,4.108508809626128,80.0,20.0
49308,4,9308,[ 64 483 313 318  11],618,5,38247,4.108604576216565,80.0,20.0
49309,4,9309,[ 79 202 153 151  95],297,1,38248,4.108270676691729,0.0,0.0
49310,4,9310,[288 161 143 118 202],588,3,38251,4.108151648587692,0.0,20.0
49311,4,9311,[ 64 483 313 318  11],214,5,38256,4.108247422680412,80.0,20.0
49312,4,9312,[228 181 172  82 403],721,5,38261,4.108343176205304,0.0,20.0
49313,4,9313,[ 64 483 313 318  11],214,5,38266,4.108438909168993,80.0,20.0
49314,4,9314,[174 275  25 100 313],354,3,38269,4.108319914117016,20.0,20.0
49315,4,9315,[294 186  12  15  71],588,5,38274,4.108415629025333,20.0,0.0
49316,4,9316,[ 15 202 173  28 318],416,5,38279,4.108511323387356,20.0,0.0
49317,4,9317,[194 215 135 588 182],297,2,38281,4.1082850397080914,0.0,0.0
49318,4,9318,[173   9 125   4 174],618,1,38282,4.107951496941732,0.0,0.0
49319,4,9319,[546 100 117 678 168],654,4,38286,4.10793991416309,0.0,0.0
49320,4,9320,[ 64 483 313 318  11],618,5,38291,4.10803561849587,80.0,20.0
49321,4,9321,[ 64 483 313 318  11],618,5,38296,4.108131302295645,80.0,20.0
49322,4,9322,[269 125 288 132 318],854,4,38300,4.108119703957954,20.0,20.0
49323,4,9323,[111  56  82  64 237],62,3,38303,4.108000858000858,20.0,0.0
49324,4,9324,[ 64 483 313 318  11],214,5,38308,4.108096514745308,80.0,20.0
49325,4,9325,[ 64 483 313 318  11],214,5,38313,4.108192150975767,80.0,20.0
49326,4,9326,[ 28 111 275 655 471],618,2,38315,4.1079661198670525,0.0,0.0
49327,4,9327,[161 191 313   1 117],345,3,38318,4.107847341337908,20.0,20.0
49328,4,9328,[ 64 483 313 318  11],618,5,38323,4.107942973523421,80.0,20.0
49329,4,9329,[ 64 483 313 318  11],214,5,38328,4.108038585209004,80.0,20.0
49330,4,9330,[ 64 483 313 318  11],618,5,38333,4.108134176401244,80.0,20.0
49331,4,9331,[100 196  69 153 237],198,2,38335,4.107908272610373,0.0,0.0
49332,4,9332,[ 64 483 313 318  11],618,5,38340,4.108003857280617,80.0,20.0
49333,4,9333,[174 153 475 100 173],601,5,38345,4.108099421469895,0.0,0.0
49334,4,9334,[125 173   7 245  15],416,4,38349,4.108087841456883,0.0,0.0
49335,4,9335,[ 71  96 265 197 471],618,2,38351,4.107862039417309,0.0,0.0
49336,4,9336,[ 64 483 313 318  11],618,5,38356,4.107957588090393,80.0,20.0
49337,4,9337,[742 405 222 172 180],805,2,38358,4.107731848361533,0.0,0.0
49338,4,9338,[405 197 179 328 121],128,3,38361,4.107613234821716,0.0,0.0
49339,4,9339,[294 185 357 135 237],854,3,38364,4.1074946466809426,0.0,0.0
49340,4,9340,[ 64 483 313 318  11],214,5,38369,4.107590193769403,80.0,20.0
49341,4,9341,[143  97 471 257 183],416,4,38373,4.107578676942839,0.0,0.0
49342,4,9342,[195 385  12 204 118],654,4,38377,4.107567162581612,20.0,0.0
49343,4,9343,[ 64 483 313 318  11],214,5,38382,4.107662671232877,80.0,20.0
49344,4,9344,[234 204 196 313  22],405,4,38386,4.107651150347779,20.0,20.0
49345,4,9345,[271 288 286 302 294],62,0,38386,4.10721164134389,0.0,20.0
49346,4,9346,[ 82 333 197  70   9],416,5,38391,4.107307157376699,0.0,0.0
49347,4,9347,[235 275 100 215 323],416,3,38394,4.107188703465982,0.0,0.0
49348,4,9348,[195   1 496  50 200],887,4,38398,4.107177238207295,0.0,20.0
49349,4,9349,[200  15  56 161 588],416,5,38403,4.107272727272727,0.0,0.0
49350,4,9350,[ 64 483 313 318  11],214,5,38408,4.107368195914876,80.0,20.0
49351,4,9351,[ 64 483 313 318  11],618,5,38413,4.1074636441402905,80.0,20.0
49352,4,9352,[ 64 483 313 318  11],618,5,38418,4.107559071955523,80.0,20.0
49353,4,9353,[496  15 276 174 197],342,2,38420,4.107333760957879,0.0,0.0
49354,4,9354,[176 289 568 174 111],416,4,38424,4.107322287546767,0.0,0.0
49355,4,9355,[286 161 197  79  50],711,5,38429,4.10741769987174,0.0,20.0
49356,4,9356,[300 245  25 423 215],297,1,38430,4.107085604360372,0.0,0.0
49357,4,9357,[588 423 100  70  71],654,3,38433,4.1069673007052785,0.0,0.0
49358,4,9358,[ 64 483 313 318  11],618,5,38438,4.107062720376109,80.0,20.0
49359,4,9359,[ 64 483 313 318  11],618,5,38443,4.10715811965812,80.0,20.0
49360,4,9360,[597  88  82 323 403],43,3,38446,4.107039846170281,0.0,0.0
49361,4,9361,[ 64 483 313 318  11],618,5,38451,4.107135227515488,80.0,20.0
49362,4,9362,[ 64 483 313 318  11],214,5,38456,4.107230588486596,80.0,20.0
49363,4,9363,[ 64 483 313 318  11],214,5,38461,4.107325929090132,80.0,20.0
49364,4,9364,[196 288 294 546 222],417,2,38463,4.107100907634811,0.0,20.0
49365,4,9365,[ 28   8 405 186 276],43,4,38467,4.107089472560324,0.0,0.0
49366,4,9366,[ 64 483 313 318  11],618,5,38472,4.107184797694032,80.0,20.0
49367,4,9367,[508 196  69 496 100],214,4,38476,4.107173356105893,0.0,0.0
49368,4,9368,[ 64 483 313 318  11],618,5,38481,4.10726865193724,80.0,20.0
49369,4,9369,[ 64 483 313 318  11],214,5,38486,4.107363927427961,80.0,20.0
49370,4,9370,[ 64 483 313 318  11],214,5,38491,4.107459182584569,80.0,20.0
49371,4,9371,[  8 153   1  71 181],416,5,38496,4.1075544174135725,0.0,20.0
49372,4,9372,[ 64 483 313 318  11],618,5,38501,4.107649631921476,80.0,20.0
49373,4,9373,[475  12 135  96  22],62,5,38506,4.107744826114786,20.0,0.0
49374,4,9374,[ 64 483 313 318  11],214,5,38511,4.10784,80.0,20.0
49375,4,9375,[ 64 483 313 318  11],214,5,38516,4.107935153583618,80.0,20.0
49376,4,9376,[ 64 483 313 318  11],618,5,38521,4.108030286872134,80.0,20.0
49377,4,9377,[ 64 483 313 318  11],214,5,38526,4.108125399872041,80.0,20.0
49378,4,9378,[257 195 211 111  95],417,3,38529,4.108007250239898,0.0,0.0
49379,4,9379,[ 64 483 313 318  11],214,5,38534,4.108102345415778,80.0,20.0
49380,4,9380,[258   7 196 286 210],297,5,38539,4.108197420317663,0.0,0.0
49381,4,9381,[ 64 483 313 318  11],618,5,38544,4.1082924749520355,80.0,20.0
49382,4,9382,[269  28  15 271 153],43,4,38548,4.108280933603325,0.0,0.0
49383,4,9383,[ 64 483 313 318  11],618,5,38553,4.108375959079284,80.0,20.0
49384,4,9384,[ 64 483 313 318  11],214,5,38558,4.1084709643047415,80.0,20.0
49385,4,9385,[215 117 276 546  25],654,3,38561,4.108352865970595,0.0,0.0
49386,4,9386,[ 64 483 313 318  11],618,5,38566,4.1084478534142965,80.0,20.0
49387,4,9387,[ 64 483 313 318  11],214,5,38571,4.108542820622071,80.0,20.0
49388,4,9388,[ 64 483 313 318  11],214,5,38576,4.108637767600383,80.0,20.0
49389,4,9389,[ 64 483 313 318  11],214,5,38581,4.108732694355697,80.0,20.0
49390,4,9390,[  1  95 235  69 132],642,3,38584,4.10861463102971,0.0,0.0
49391,4,9391,[ 64 483 313 318  11],214,5,38589,4.108709540034072,80.0,20.0
49392,4,9392,[ 64 483 313 318  11],618,5,38594,4.10880442882998,80.0,20.0
49393,4,9393,[ 64 483 313 318  11],214,5,38599,4.108899297423887,80.0,20.0
49394,4,9394,[183  98   8 742  28],297,4,38603,4.108887706226716,0.0,20.0
49395,4,9395,[ 64 483 313 318  11],618,5,38608,4.108982545764155,80.0,20.0
49396,4,9396,[111 151  82  70 423],437,2,38610,4.1087581142917955,0.0,0.0
49397,4,9397,[ 64 483 313 318  11],618,5,38615,4.108852947435625,80.0,20.0
49398,4,9398,[ 64 483 313 318  11],618,5,38620,4.108947760400042,80.0,20.0
49399,4,9399,[ 64 423  79   4 228],417,2,38622,4.108723404255319,20.0,0.0
49400,4,9400,[ 64 483 313 318  11],618,5,38627,4.108818210828635,80.0,20.0
49401,4,9401,[ 64 483 313 318  11],618,5,38632,4.108912997234631,80.0,20.0
49402,4,9402,[ 64 483 313 318  11],618,5,38637,4.109007763479741,80.0,20.0
49403,4,9403,[ 64 483 313 318  11],618,5,38642,4.109102509570396,80.0,20.0
49404,4,9404,[496 286   9  56 678],416,4,38646,4.109090909090909,0.0,0.0
49405,4,9405,[222 172 302 238  11],417,2,38648,4.108866680842016,0.0,0.0
49406,4,9406,[ 64 483 313 318  11],618,5,38653,4.108961411714681,80.0,20.0
49407,4,9407,[568  97 216  82 117],642,4,38657,4.108949829931973,0.0,0.0
49408,4,9408,[300 276 175 132 153],198,2,38659,4.1087256881709004,0.0,0.0
49409,4,9409,[ 64 483 313 318  11],214,5,38664,4.1088204038257174,80.0,20.0
49410,4,9410,[ 64 483 313 318  11],214,5,38669,4.108915099351822,80.0,20.0
49411,4,9411,[742 172 603   7 197],805,4,38673,4.108903527411814,0.0,0.0
49412,4,9412,[483  98 196 323 222],417,3,38676,4.108785721874004,20.0,20.0
49413,4,9413,[ 64 483 313 318  11],618,5,38681,4.108880390907159,80.0,20.0
49414,4,9414,[ 64 483 313 318  11],214,5,38686,4.108975039830058,80.0,20.0
49415,4,9415,[191 197   7 174  96],618,3,38689,4.108857264231096,0.0,0.0
49416,4,9416,[ 64 483 313 318  11],618,5,38694,4.108951895508124,80.0,20.0
49417,4,9417,[ 64 483 313 318  11],618,5,38699,4.109046506689318,80.0,20.0
49418,4,9418,[273 195 185  25   4],854,2,38701,4.108822592631914,0.0,0.0
49419,4,9419,[ 50  71 151 275  22],62,5,38706,4.10891719745223,0.0,20.0
49420,4,9420,[357  97 111 273 286],416,5,38711,4.109011782188727,0.0,0.0
49421,4,9421,[ 64 483 313 318  11],618,5,38716,4.109106346847803,80.0,20.0
49422,4,9422,[185 238 143 111  82],711,3,38719,4.1089886448052635,0.0,0.0
49423,4,9423,[211 215 423 245 144],416,4,38723,4.108977079796265,0.0,0.0
49424,4,9424,[ 95 748 118 597 222],805,1,38724,4.108647214854112,0.0,0.0
49425,4,9425,[  7  15 265  22 546],416,4,38728,4.108635688521112,0.0,0.0
49426,4,9426,[ 64 483 313 318  11],214,5,38733,4.1087302429192745,80.0,20.0
49427,4,9427,[ 64 483 313 318  11],618,5,38738,4.108824777259228,80.0,20.0
49428,4,9428,[ 64 483 313 318  11],618,5,38743,4.108919291547354,80.0,20.0
49429,4,9429,[216 174  98 289  69],43,5,38748,4.109013785790032,0.0,20.0
49430,4,9430,[ 64 483 313 318  11],618,5,38753,4.109108259993638,80.0,20.0
49431,4,9431,[ 96 286 100 235 265],416,4,38757,4.109096692111959,0.0,0.0
49432,4,9432,[ 64 483 313 318  11],214,5,38762,4.109191137496024,80.0,20.0
49433,4,9433,[597  64 282 143 181],416,4,38766,4.109179563281747,20.0,20.0
49434,4,9434,[215  82 117 132 204],128,3,38769,4.10906200317965,0.0,0.0
49435,4,9435,[ 64 483 313 318  11],214,5,38774,4.109156422212802,80.0,20.0
49436,4,9436,[ 64 483 313 318  11],214,5,38779,4.1092508212355625,80.0,20.0
49437,4,9437,[ 64 483 313 318  11],618,5,38784,4.109345200254291,80.0,20.0
49438,4,9438,[301 181 475 515  28],416,4,38788,4.1093336158491365,0.0,20.0
49439,4,9439,[187 111 475 204 153],416,4,38792,4.109322033898305,0.0,0.0
49440,4,9440,[ 64 483 313 318  11],618,5,38797,4.109416375383963,80.0,20.0
49441,4,9441,[288 176 168 216 132],854,3,38800,4.109298877356492,0.0,20.0
49442,4,9442,[318 268 655 515  89],354,2,38802,4.109075505665572,20.0,0.0
49443,4,9443,[ 64 483 313 318  11],214,5,38807,4.109169843286743,80.0,20.0
49444,4,9444,[ 64 483 313 318  11],214,5,38812,4.10926416093171,80.0,20.0
49445,4,9445,[655 742 475 271 173],805,2,38814,4.109040863857717,0.0,0.0
49446,4,9446,[ 64 483 313 318  11],214,5,38819,4.10913517518789,80.0,20.0
49447,4,9447,[228  50  97 323 174],721,4,38823,4.109123624047418,0.0,20.0
49448,4,9448,[ 82 172 121 508 423],654,4,38827,4.109112075351889,0.0,0.0
49449,4,9449,[ 64 483 313 318  11],618,5,38832,4.1092063492063495,80.0,20.0
49450,4,9450,[234 385   9 655 210],345,4,38836,4.109194794201672,0.0,0.0
49451,4,9451,[ 50 191 161 200 328],12,4,38840,4.109183241641981,0.0,20.0
49452,4,9452,[ 64 483 313 318  11],618,5,38845,4.109277478049297,80.0,20.0
49453,4,9453,[475 234 237 286   7],588,2,38847,4.109054368521261,0.0,0.0
49454,4,9454,[ 64 483 313 318  11],214,5,38852,4.109148598625066,80.0,20.0
49455,4,9455,[ 56 195 228 286  50],417,3,38855,4.10903130287648,0.0,20.0
49456,4,9456,[ 64 483 313 318  11],214,5,38860,4.10912551549117,80.0,20.0
49457,4,9457,[143  56 546  79 302],297,3,38863,4.1090082469866775,0.0,0.0
49458,4,9458,[ 64 483 313 318  11],618,5,38868,4.109102442118617,80.0,20.0
49459,4,9459,[ 25 483 118 144 235],854,1,38869,4.10877378435518,20.0,0.0
49460,4,9460,[  8  50 258 322  79],907,4,38873,4.108762287284642,0.0,20.0
49461,4,9461,[121 176 496 742 435],505,4,38877,4.108750792644261,0.0,0.0
49462,4,9462,[ 64 483 313 318  11],214,5,38882,4.108844975166438,80.0,20.0
49463,4,9463,[161 238 405 202 273],416,5,38887,4.108939137785292,0.0,0.0
49464,4,9464,[ 64 483 313 318  11],618,5,38892,4.1090332805071315,80.0,20.0
49465,4,9465,[483 655 202  70 265],711,4,38896,4.109021762095923,20.0,0.0
49466,4,9466,[ 64 483 313 318  11],618,5,38901,4.1091158762015425,80.0,20.0
49467,4,9467,[215  25 144 175 204],297,2,38903,4.108893113645966,0.0,0.0
49468,4,9468,[ 64 483 313 318  11],214,5,38908,4.1089872214595,80.0,20.0
49469,4,9469,[588 238 216 228 568],230,2,38910,4.108764519535375,0.0,0.0
49470,4,9470,[ 64 483 313 318  11],618,5,38915,4.108858621053743,80.0,20.0
49471,4,9471,[ 64 483 313 318  11],618,5,38920,4.108952702702703,80.0,20.0
49472,4,9472,[174  56   9 328 385],43,5,38925,4.109046764488546,0.0,0.0
49473,4,9473,[ 64 483 313 318  11],214,5,38930,4.109140806417564,80.0,20.0
49474,4,9474,[333 568 215   1 603],416,5,38935,4.109234828496042,0.0,0.0
49475,4,9475,[ 64 483 313 318  11],618,5,38940,4.109328830730266,80.0,20.0
49476,4,9476,[ 71  11 597 118 237],764,4,38944,4.10931729450248,0.0,0.0
49477,4,9477,[ 70 100   4 286  89],62,3,38947,4.1092002532179785,0.0,0.0
49478,4,9478,[118  11  12 117  28],297,4,38951,4.109188732988712,20.0,0.0
49479,4,9479,[ 79  69  50   4 748],198,2,38953,4.108966244725738,0.0,20.0
49480,4,9480,[ 89 173 403 742 196],62,4,38957,4.10895475160848,0.0,0.0
49481,4,9481,[ 64 483 313 318  11],214,5,38962,4.109048723897912,80.0,20.0
49482,4,9482,[ 64 483 313 318  11],618,5,38967,4.109142676368238,80.0,20.0
49483,4,9483,[194 748 286  95  11],416,4,38971,4.109131168283425,0.0,0.0
49484,4,9484,[302 168 300 144 403],43,5,38976,4.109225092250923,0.0,0.0
49485,4,9485,[ 64 483 313 318  11],214,5,38981,4.10931899641577,80.0,20.0
49486,4,9486,[ 64 483 313 318  11],214,5,38986,4.109412880784231,80.0,20.0
49487,4,9487,[748 235 202 121 132],345,1,38987,4.109085160202361,0.0,0.0
49488,4,9488,[211 568 322 181 144],416,4,38991,4.109073664242808,0.0,20.0
49489,4,9489,[238 328 180 168  89],62,4,38995,4.109062170706006,0.0,0.0
49490,4,9490,[ 64 483 313 318  11],214,5,39000,4.109156042566642,80.0,20.0
49491,4,9491,[ 50 176 181 182 288],618,4,39004,4.109144542772861,0.0,60.0
49492,4,9492,[ 64 483 313 318  11],214,5,39009,4.10923838617929,80.0,20.0
49493,4,9493,[  7  98  88 174 300],751,3,39012,4.109121550452918,0.0,20.0
49494,4,9494,[ 25 174 117 125  64],764,4,39016,4.109110057925224,20.0,0.0
49495,4,9495,[405  50 265 183 435],230,4,39020,4.1090985678180285,0.0,20.0
49496,4,9496,[ 11 483  79  95 121],417,3,39023,4.108981783721175,20.0,0.0
49497,4,9497,[655 288 357 144 191],62,2,39025,4.108759738892398,0.0,20.0
49498,4,9498,[ 64 483 313 318  11],214,5,39030,4.108853563533003,80.0,20.0
49499,4,9499,[ 64 483 313 318  11],618,5,39035,4.1089473684210525,80.0,20.0
49500,4,9500,[ 64 483 313 318  11],618,5,39040,4.109041153562782,80.0,20.0
49501,4,9501,[ 64 483 313 318  11],618,5,39045,4.109134918964428,80.0,20.0
49502,4,9502,[ 70 195 121 117 144],437,0,39045,4.108702514995264,0.0,0.0
49503,4,9503,[ 64 483 313 318  11],214,5,39050,4.108796296296297,80.0,20.0
49504,4,9504,[238 333 508 748 403],345,2,39052,4.108574434508154,0.0,0.0
49505,4,9505,[237  22 276  95 175],922,2,39054,4.108352619398275,0.0,0.0
49506,4,9506,[655   7  11 161 100],618,5,39059,4.108446407909961,0.0,0.0
49507,4,9507,[ 64 483 313 318  11],618,5,39064,4.108540176693311,80.0,20.0
49508,4,9508,[ 64 483 313 318  11],618,5,39069,4.108633925754548,80.0,20.0
49509,4,9509,[ 64 483 313 318  11],618,5,39074,4.108727655099895,80.0,20.0
49510,4,9510,[ 64 483 313 318  11],214,5,39079,4.10882136473557,80.0,20.0
49511,4,9511,[ 64 483 313 318  11],214,5,39084,4.108915054667788,80.0,20.0
49512,4,9512,[357   4 322 118 318],854,2,39086,4.108693366971512,20.0,0.0
49513,4,9513,[194 678 268 117  69],297,2,39088,4.108471725877654,0.0,0.0
49514,4,9514,[ 64 483 313 318  11],214,5,39093,4.10856542301629,80.0,20.0
49515,4,9515,[ 28  71  50 173 238],373,4,39097,4.10855401429172,0.0,20.0
49516,4,9516,[ 64 483 313 318  11],214,5,39102,4.1086476830934116,80.0,20.0
49517,4,9517,[313  88 471 323 546],43,3,39105,4.108531204034461,20.0,20.0
49518,4,9518,[496 385  25 235 405],416,4,39109,4.108519802500263,0.0,0.0
49519,4,9519,[235 385   1  11 588],43,4,39113,4.108508403361345,0.0,0.0
49520,4,9520,[ 25 202 172 423 289],588,2,39115,4.108286944648671,0.0,0.0
49521,4,9521,[ 64 483 313 318  11],618,5,39120,4.10838059231254,80.0,20.0
49522,4,9522,[174 405  71 269 275],654,4,39124,4.108369211382968,0.0,0.0
49523,4,9523,[127 328   7   9 195],854,3,39127,4.108252834943301,0.0,0.0
49524,4,9524,[ 64 483 313 318  11],618,5,39132,4.108346456692914,80.0,20.0
49525,4,9525,[111 132  98 288 180],854,4,39136,4.1083350829309255,0.0,40.0
49526,4,9526,[ 64 483 313 318  11],618,5,39141,4.108428676393408,80.0,20.0
49527,4,9527,[  7 423   4 176  69],854,3,39144,4.10831234256927,0.0,0.0
49528,4,9528,[ 64 121  12 132 161],417,3,39147,4.108196033161927,40.0,0.0
49529,4,9529,[168 111 200 183 323],416,4,39151,4.108184679958027,0.0,0.0
49530,4,9530,[ 69  56   8 323 288],416,4,39155,4.108173329136502,0.0,20.0
49531,4,9531,[144 196 182 195 275],297,2,39157,4.1079521611414185,0.0,0.0
49532,4,9532,[117  25 301 196 748],297,4,39161,4.107940837092206,0.0,0.0
49533,4,9533,[238 496 403 588 210],43,4,39165,4.107929515418502,0.0,0.0
49534,4,9534,[ 64 483 313 318  11],618,5,39170,4.108023072889355,80.0,20.0
49535,4,9535,[ 64 483 313 318  11],618,5,39175,4.108116610738255,80.0,20.0
49536,4,9536,[ 64 483 313 318  11],214,5,39180,4.108210128971375,80.0,20.0
49537,4,9537,[216  11 435 204 151],437,3,39183,4.108093940029356,0.0,0.0
49538,4,9538,[ 64 483 313 318  11],618,5,39188,4.108187441031554,80.0,20.0
49539,4,9539,[ 56   4 191 357 210],417,3,39191,4.108071278825996,0.0,0.0
49540,4,9540,[ 64 483 313 318  11],618,5,39196,4.108164762603501,80.0,20.0
49541,4,9541,[515 202 181 471  12],297,3,39199,4.108048627122197,20.0,20.0
49542,4,9542,[ 64 483 313 318  11],214,5,39204,4.1081420936812325,80.0,20.0
49543,4,9543,[ 64 483 313 318  11],618,5,39209,4.108235540653814,80.0,20.0
49544,4,9544,[196   4  25 276 568],618,2,39211,4.108014667365112,0.0,0.0
49545,4,9545,[181 742 268  56  25],345,4,39215,4.108003352189399,0.0,20.0
49546,4,9546,[403 238 318 265  96],373,4,39219,4.1079920393841,20.0,0.0
49547,4,9547,[318 202 427 216 288],618,2,39221,4.107771260997067,20.0,20.0
49548,4,9548,[216 210   1 168  56],922,1,39222,4.107445805843544,0.0,0.0
49549,4,9549,[238 181  15 258   9],416,5,39227,4.1075392670157065,0.0,20.0
49550,4,9550,[ 64 483 313 318  11],618,5,39232,4.107632708616899,80.0,20.0
49551,4,9551,[117 121  98 144 245],505,4,39236,4.107621440536013,0.0,20.0
49552,4,9552,[ 64 483 313 318  11],214,5,39241,4.107714853972574,80.0,20.0
49553,4,9553,[ 15  11   4   1 742],654,4,39245,4.107703579652502,0.0,0.0
49554,4,9554,[182 322 276 151 202],128,2,39247,4.107482993197279,0.0,0.0
49555,4,9555,[ 95 294 237 268 597],416,2,39249,4.107262452909167,0.0,0.0
49556,4,9556,[ 56   8 237 568 357],642,4,39253,4.107251229465313,0.0,0.0
49557,4,9557,[ 79 182 475 181 323],198,3,39256,4.107135383971542,0.0,20.0
49558,4,9558,[ 64 483 313 318  11],618,5,39261,4.107228789622345,80.0,20.0
49559,4,9559,[191 185 121  98  50],601,3,39264,4.107112970711297,0.0,40.0
49560,4,9560,[ 64 483 313 318  11],214,5,39269,4.107206359167451,80.0,20.0
49561,4,9561,[183 427 286 257 173],416,4,39273,4.1071951474586905,0.0,0.0
49562,4,9562,[ 64 483 313 318  11],618,5,39278,4.107288507790442,80.0,20.0
49563,4,9563,[ 64 483 313 318  11],618,5,39283,4.107381848598912,80.0,20.0
49564,4,9564,[215 111  95 301  98],416,4,39287,4.107370622059593,0.0,20.0
49565,4,9565,[ 64 483 313 318  11],214,5,39292,4.107463934768973,80.0,20.0
49566,4,9566,[197 313  98 143  89],711,5,39297,4.107557227971151,20.0,40.0
49567,4,9567,[204 215 143 273 588],618,4,39301,4.107545986622074,0.0,0.0
49568,4,9568,[144 294 196 216  22],62,3,39304,4.107430243494618,0.0,0.0
49569,4,9569,[ 15 286 151 234 508],345,4,39308,4.107419017763846,0.0,0.0
49570,4,9570,[405 265 172 269  70],654,5,39313,4.107512276669104,0.0,0.0
49571,4,9571,[ 64 483 313 318  11],618,5,39318,4.107605516088592,80.0,20.0
49572,4,9572,[313  70 294 385 185],49,1,39319,4.107280894181552,20.0,20.0
49573,4,9573,[ 70 121 216 153 210],642,2,39321,4.107060789638605,0.0,0.0
49574,4,9574,[ 64 483 313 318  11],618,5,39326,4.107154046997389,80.0,20.0
49575,4,9575,[ 64 483 313 318  11],214,5,39331,4.107247284878864,80.0,20.0
49576,4,9576,[174 100 568 403 597],805,2,39333,4.10702725279315,0.0,0.0
49577,4,9577,[ 64 483 313 318  11],214,5,39338,4.1071204844435165,80.0,20.0
49578,4,9578,[121 273 200 318 257],854,3,39341,4.107004906566448,20.0,0.0
49579,4,9579,[ 64 483 313 318  11],618,5,39346,4.107098121085595,80.0,20.0
49580,4,9580,[655 161 275 196 176],416,5,39351,4.10719131614654,0.0,0.0
49581,4,9581,[111 100  28 173 748],679,3,39354,4.107075767063243,0.0,0.0
49582,4,9582,[ 64 288 245 121 568],345,2,39356,4.106855890639674,20.0,20.0
49583,4,9583,[ 64 483 313 318  11],618,5,39361,4.106949081803005,80.0,20.0
49584,4,9584,[294 174 423 435 196],297,2,39363,4.106729264475743,0.0,0.0
49585,4,9585,[ 64 483 313 318  11],214,5,39368,4.106822449405382,80.0,20.0
49586,4,9586,[ 64 483 313 318  11],618,5,39373,4.10691561489517,80.0,20.0
49587,4,9587,[ 69 496 202 132 118],128,3,39376,4.106800166875261,0.0,0.0
49588,4,9588,[ 64 483 313 318  11],618,5,39381,4.106893315257065,80.0,20.0
49589,4,9589,[ 64 483 313 318  11],214,5,39386,4.106986444212722,80.0,20.0
49590,4,9590,[ 64 483 313 318  11],214,5,39391,4.107079553748306,80.0,20.0
49591,4,9591,[ 64 483 313 318  11],214,5,39396,4.107172643869892,80.0,20.0
49592,4,9592,[ 64 483 313 318  11],214,5,39401,4.1072657145835505,80.0,20.0
49593,4,9593,[ 64 483 313 318  11],618,5,39406,4.107358765895351,80.0,20.0
49594,4,9594,[ 64 483 313 318  11],618,5,39411,4.10745179781136,80.0,20.0
49595,4,9595,[ 64 483 313 318  11],214,5,39416,4.10754481033764,80.0,20.0
49596,4,9596,[ 64  12   1 200 234],345,4,39420,4.107533604251328,40.0,0.0
49597,4,9597,[588  88 385 100 186],588,3,39423,4.107418212127526,0.0,0.0
49598,4,9598,[173 276 427 182  64],128,5,39428,4.107511199083238,20.0,0.0
49599,4,9599,[ 98 143 174 288 318],734,5,39433,4.1076041666666665,20.0,40.0
49600,4,9600,[ 15 191 322 273 100],417,2,39435,4.107384647432559,0.0,0.0
49601,4,9601,[ 64 483 313 318  11],618,5,39440,4.107477608831493,80.0,20.0
49602,4,9602,[ 22 268 153 117 748],297,4,39444,4.107466416744767,0.0,0.0
49603,4,9603,[153 423 187  28 132],416,5,39449,4.10755935027072,0.0,0.0
49604,4,9604,[ 64 483 313 318  11],214,5,39454,4.107652264445601,80.0,20.0
49605,4,9605,[ 64 483 313 318  11],618,5,39459,4.107745159275453,80.0,20.0
49606,4,9606,[202  88  71 286 268],416,4,39463,4.107733943999167,0.0,0.0
49607,4,9607,[111  70 183 597 195],62,2,39465,4.107514571190674,0.0,0.0
49608,4,9608,[ 64 483 313 318  11],618,5,39470,4.107607451347695,80.0,20.0
49609,4,9609,[ 64 483 313 318  11],618,5,39475,4.107700312174818,80.0,20.0
49610,4,9610,[ 64 483 313 318  11],214,5,39480,4.107793153678077,80.0,20.0
49611,4,9611,[ 64 483 313 318  11],618,5,39485,4.107885975863504,80.0,20.0
49612,4,9612,[182 475 135 403 117],198,4,39489,4.107874752938729,0.0,0.0
49613,4,9613,[ 64 483 313 318  11],214,5,39494,4.107967547326815,80.0,20.0
49614,4,9614,[195 245 269  88 117],416,3,39497,4.107852314092564,0.0,0.0
49615,4,9615,[300 181 132 210 288],416,5,39502,4.107945091514143,0.0,40.0
49616,4,9616,[ 64 483 313 318  11],214,5,39507,4.10803784964126,80.0,20.0
49617,4,9617,[ 64 483 313 318  11],214,5,39512,4.108130588479933,80.0,20.0
49618,4,9618,[  7 282 176 153 179],416,4,39516,4.108119347125481,0.0,0.0
49619,4,9619,[ 64 483 313 318  11],214,5,39521,4.108212058212058,80.0,20.0
49620,4,9620,[ 64 483 313 318  11],214,5,39526,4.108304750025985,80.0,20.0
49621,4,9621,[ 64 483 313 318  11],618,5,39531,4.10839742257327,80.0,20.0
49622,4,9622,[301   4 603 222  69],297,3,39534,4.1082822404655515,0.0,0.0
49623,4,9623,[ 98 678  15  25  56],588,3,39537,4.108167082294265,0.0,20.0
49624,4,9624,[ 64 483 313 318  11],214,5,39542,4.10825974025974,80.0,20.0
49625,4,9625,[181   8 742 161 475],416,4,39546,4.108248493662996,0.0,20.0
49626,4,9626,[ 64 483 313 318  11],214,5,39551,4.108341123922302,80.0,20.0
49627,4,9627,[ 64 483 313 318  11],214,5,39556,4.108433734939759,80.0,20.0
49628,4,9628,[ 97  88  64 238 179],128,3,39559,4.1083186208329,20.0,0.0
49629,4,9629,[ 64 483 313 318  11],618,5,39564,4.108411214953271,80.0,20.0
49630,4,9630,[ 64 483 313 318  11],214,5,39569,4.108503789845291,80.0,20.0
49631,4,9631,[118 238 202 588  70],437,2,39571,4.1082848837209305,0.0,0.0
49632,4,9632,[ 79 483 210  95 100],588,4,39575,4.108273642686598,20.0,0.0
49633,4,9633,[191 237 742 100 174],854,2,39577,4.108054805895786,0.0,0.0
49634,4,9634,[ 64 483 313 318  11],618,5,39582,4.108147379346134,80.0,20.0
49635,4,9635,[276  79 603 100 301],437,4,39586,4.108136156081361,0.0,0.0
49636,4,9636,[ 64 483 313 318  11],618,5,39591,4.108228701878178,80.0,20.0
49637,4,9637,[  1 258 515 196 294],417,5,39596,4.108321228470637,0.0,0.0
49638,4,9638,[196 151  70 357 483],62,4,39600,4.1083099906629315,20.0,0.0
49639,4,9639,[  4   9 176 238  96],416,5,39605,4.108402489626556,0.0,0.0
49640,4,9640,[ 64 483 313 318  11],618,5,39610,4.108494969401514,80.0,20.0
49641,4,9641,[  4 144 151 196 273],618,3,39613,4.108380004148517,0.0,0.0
49642,4,9642,[ 64 483 313 318  11],214,5,39618,4.108472467074562,80.0,20.0
49643,4,9643,[588 294 118 655 151],417,4,39622,4.108461219411033,0.0,0.0
49644,4,9644,[475 127 237 187 318],416,3,39625,4.108346293416278,20.0,0.0
49645,4,9645,[ 64 483 313 318  11],618,5,39630,4.10843873108024,80.0,20.0
49646,4,9646,[265 125 276 748 597],416,3,39633,4.108323831242873,0.0,0.0
49647,4,9647,[ 64 483 313 318  11],618,5,39638,4.108416252072969,80.0,20.0
49648,4,9648,[ 64 483 313 318  11],618,5,39643,4.108508653746502,80.0,20.0
49649,4,9649,[144 185  56   7 161],417,1,39644,4.108186528497409,0.0,0.0
49650,4,9650,[ 64 483 313 318  11],618,5,39649,4.108278934825407,80.0,20.0
49651,4,9651,[ 64 483 313 318  11],618,5,39654,4.108371322005802,80.0,20.0
49652,4,9652,[174 234  12  15  56],345,5,39659,4.1084636900445455,20.0,0.0
49653,4,9653,[ 64 483 313 318  11],214,5,39664,4.108556038947587,80.0,20.0
49654,4,9654,[ 64 483 313 318  11],618,5,39669,4.10864836872087,80.0,20.0
49655,4,9655,[ 64 483 313 318  11],214,5,39674,4.10874067937034,80.0,20.0
49656,4,9656,[ 64 483 313 318  11],214,5,39679,4.108832970901936,80.0,20.0
49657,4,9657,[197  79  71 168 172],373,4,39683,4.10882170221578,0.0,0.0
49658,4,9658,[515 173  69 258  12],416,5,39688,4.108913966249094,20.0,0.0
49659,4,9659,[ 64 483 313 318  11],618,5,39693,4.109006211180124,80.0,20.0
49660,4,9660,[ 64 483 313 318  11],214,5,39698,4.109098437014802,80.0,20.0
49661,4,9661,[ 64 483 313 318  11],214,5,39703,4.109190643759056,80.0,20.0
49662,4,9662,[ 64  96  98 151 204],416,4,39707,4.109179343889061,20.0,20.0
49663,4,9663,[ 64 483 313 318  11],214,5,39712,4.1092715231788075,80.0,20.0
49664,4,9664,[211 238 357 403 318],405,4,39716,4.109260217278841,20.0,0.0
49665,4,9665,[ 79 196   8 258 257],297,3,39719,4.109145458307469,0.0,0.0
49666,4,9666,[ 64 483 313 318  11],618,5,39724,4.109237612496121,80.0,20.0
49667,4,9667,[187 268 172 471 328],416,5,39729,4.109329747621018,0.0,0.0
49668,4,9668,[ 64 483 313 318  11],214,5,39734,4.109421863688075,80.0,20.0
49669,4,9669,[ 64 483 313 318  11],214,5,39739,4.109513960703206,80.0,20.0
49670,4,9670,[127 588 173 216 301],416,5,39744,4.109606038672319,0.0,0.0
49671,4,9671,[ 64 483 313 318  11],214,5,39749,4.109698097601323,80.0,20.0
49672,4,9672,[ 64 483 313 318  11],618,5,39754,4.109790137496123,80.0,20.0
49673,4,9673,[ 64 483 313 318  11],214,5,39759,4.1098821583626215,80.0,20.0
49674,4,9674,[187 288 235 742 427],416,4,39763,4.109870801033591,0.0,20.0
49675,4,9675,[186  22 258   9 475],601,5,39768,4.1099627945432,0.0,0.0
49676,4,9676,[483  15 276 100 151],618,2,39770,4.109744755606076,20.0,0.0
49677,4,9677,[ 64 483 313 318  11],214,5,39775,4.109836743128746,80.0,20.0
49678,4,9678,[ 64 174 216 202 135],405,4,39779,4.109825395185453,20.0,0.0
49679,4,9679,[302  82 185  56  96],417,2,39781,4.109607438016529,0.0,0.0
49680,4,9680,[ 64 483 313 318  11],618,5,39786,4.109699411217849,80.0,20.0
49681,4,9681,[265 742 168 117 143],654,5,39791,4.109791365420367,0.0,0.0
49682,4,9682,[ 64 483 313 318  11],618,5,39796,4.10988330062997,80.0,20.0
49683,4,9683,[ 64 483 313 318  11],214,5,39801,4.10997521685254,80.0,20.0
49684,4,9684,[ 64 483 313 318  11],618,5,39806,4.11006711409396,80.0,20.0
49685,4,9685,[153 405 286  98 515],417,4,39810,4.11005575056783,0.0,20.0
49686,4,9686,[ 64 483 313 318  11],214,5,39815,4.1101476205223495,80.0,20.0
49687,4,9687,[ 64 483 313 318  11],214,5,39820,4.110239471511147,80.0,20.0
49688,4,9688,[ 64 483 313 318  11],214,5,39825,4.1103313035400975,80.0,20.0
49689,4,9689,[ 64 483 313 318  11],214,5,39830,4.110423116615067,80.0,20.0
49690,4,9690,[ 64 483 313 318  11],618,5,39835,4.110514910741926,80.0,20.0
49691,4,9691,[588 117  82  98  56],43,5,39840,4.1106066859265376,0.0,20.0
49692,4,9692,[204 234  98  64 143],198,2,39842,4.110388940472506,20.0,20.0
49693,4,9693,[273 121  88  28 151],805,1,39843,4.1100680833505265,0.0,0.0
49694,4,9694,[ 64 483 313 318  11],618,5,39848,4.110159876224858,80.0,20.0
49695,4,9695,[ 64 483 313 318  11],618,5,39853,4.110251650165017,80.0,20.0
49696,4,9696,[ 64 483 313 318  11],214,5,39858,4.110343405176859,80.0,20.0
49697,4,9697,[ 15 215 204 132 186],198,3,39861,4.110228913177975,0.0,0.0
49698,4,9698,[ 64 483 313 318  11],618,5,39866,4.110320651613568,80.0,20.0
49699,4,9699,[ 22 179 655  95  89],805,2,39868,4.110103092783505,0.0,0.0
49700,4,9700,[121  56  69   1 546],43,5,39873,4.1101948252757445,0.0,0.0
49701,4,9701,[ 64 483 313 318  11],214,5,39878,4.1102865388579675,80.0,20.0
49702,4,9702,[496  69 237 597   7],588,1,39879,4.109965989900031,0.0,0.0
49703,4,9703,[ 64 483 313 318  11],618,5,39884,4.110057708161583,80.0,20.0
49704,4,9704,[234 748 179 132 302],417,4,39888,4.110046367851623,0.0,0.0
49705,4,9705,[100 176 742 289  22],764,4,39892,4.110035029878426,0.0,0.0
49706,4,9706,[ 64 483 313 318  11],214,5,39897,4.11012671268157,80.0,20.0
49707,4,9707,[ 64 483 313 318  11],618,5,39902,4.110218376596621,80.0,20.0
49708,4,9708,[ 64 483 313 318  11],214,5,39907,4.110310021629416,80.0,20.0
49709,4,9709,[182 202  22  95 176],416,4,39911,4.110298661174047,0.0,0.0
49710,4,9710,[ 97  71 153 597 237],416,3,39914,4.110184327051797,0.0,0.0
49711,4,9711,[168 678 161 496 181],416,4,39918,4.1101729818780885,0.0,20.0
49712,4,9712,[427  88 132 403  70],373,3,39921,4.11005868423762,0.0,0.0
49713,4,9713,[ 64 483 313 318  11],618,5,39926,4.110150298538192,80.0,20.0
49714,4,9714,[603  56 204 568 144],805,2,39928,4.109933093154915,0.0,0.0
49715,4,9715,[273 144  82 238 127],417,3,39931,4.109818855496089,0.0,0.0
49716,4,9716,[ 64 483 313 318  11],618,5,39936,4.10991046619327,80.0,20.0
49717,4,9717,[ 64 483 313 318  11],214,5,39941,4.110002058036633,80.0,20.0
49718,4,9718,[ 12 216 603 127  64],416,5,39946,4.110093631031999,40.0,0.0
49719,4,9719,[ 64 483 313 318  11],618,5,39951,4.110185185185185,80.0,20.0
49720,4,9720,[ 15 174  98 197 228],128,3,39954,4.110070980351816,0.0,20.0
49721,4,9721,[275  79 176 144 423],416,5,39959,4.110162518000411,0.0,0.0
49722,4,9722,[172  70 405 132 216],642,1,39960,4.109842641160136,0.0,0.0
49723,4,9723,[ 64 483 313 318  11],618,5,39965,4.109934183463595,80.0,20.0
49724,4,9724,[235 289  56  79 333],416,3,39968,4.109820051413882,0.0,0.0
49725,4,9725,[ 64 483 313 318  11],618,5,39973,4.10991157721571,80.0,20.0
49726,4,9726,[195 151 508 181  71],654,2,39975,4.109694664336383,0.0,20.0
49727,4,9727,[ 64 483 313 318  11],618,5,39980,4.1097861842105265,80.0,20.0
49728,4,9728,[117 127 328 313 748],505,3,39983,4.109672114297461,20.0,20.0
49729,4,9729,[ 64 483 313 318  11],618,5,39988,4.109763617677287,80.0,20.0
49730,4,9730,[ 64 483 313 318  11],618,5,39993,4.109855102250539,80.0,20.0
49731,4,9731,[100 235   1 185  64],416,4,39997,4.109843814221126,20.0,0.0
49732,4,9732,[ 64 483 313 318  11],214,5,40002,4.109935271755882,80.0,20.0
49733,4,9733,[210 215 655 118 228],198,3,40005,4.109821245120197,0.0,0.0
49734,4,9734,[ 64 483 313 318  11],618,5,40010,4.109912686183873,80.0,20.0
49735,4,9735,[  8  97 289 173 183],416,4,40014,4.109901396877568,0.0,0.0
49736,4,9736,[ 64 483 313 318  11],618,5,40019,4.10999281092739,80.0,20.0
49737,4,9737,[ 64 483 313 318  11],618,5,40024,4.110084206202505,80.0,20.0
49738,4,9738,[ 64 483 313 318  11],214,5,40029,4.110175582708697,80.0,20.0
49739,4,9739,[515 427  70  88 151],416,3,40032,4.110061601642711,0.0,0.0
49740,4,9740,[ 64 483 313 318  11],214,5,40037,4.110152961708243,80.0,20.0
49741,4,9741,[172  50 191 655  22],373,5,40042,4.11024430301786,0.0,20.0
49742,4,9742,[ 64 483 313 318  11],214,5,40047,4.110335625577338,80.0,20.0
49743,4,9743,[475 143 197  64   8],416,4,40051,4.110324302134647,20.0,0.0
49744,4,9744,[183 302 100 273 143],297,5,40056,4.110415597742432,0.0,0.0
49745,4,9745,[ 64 483 313 318  11],618,5,40061,4.1105068746152265,80.0,20.0
49746,4,9746,[ 11 182  96 471 748],416,5,40066,4.110598132758797,0.0,0.0
49747,4,9747,[ 64 483 313 318  11],618,5,40071,4.110689372178909,80.0,20.0
49748,4,9748,[ 64 483 313 318  11],618,5,40076,4.110780592881321,80.0,20.0
49749,4,9749,[ 79 121 176   1 132],416,5,40081,4.1108717948717945,0.0,0.0
49750,4,9750,[ 64 483 313 318  11],618,5,40086,4.110962978156087,80.0,20.0
49751,4,9751,[237 423 210  95 204],198,1,40087,4.1106439704675966,0.0,0.0
49752,4,9752,[302   9  28 258  22],62,3,40090,4.110530093304624,0.0,0.0
49753,4,9753,[111 132 176 588 273],417,2,40092,4.110313717449252,0.0,0.0
49754,4,9754,[216 222 385 151 191],805,3,40095,4.110199897488467,0.0,0.0
49755,4,9755,[ 64 483 313 318  11],618,5,40100,4.110291102911029,80.0,20.0
49756,4,9756,[234  71 176 168 179],805,4,40104,4.110279799118581,0.0,0.0
49757,4,9757,[ 64 483 313 318  11],618,5,40109,4.110370977659357,80.0,20.0
49758,4,9758,[ 64 483 313 318  11],214,5,40114,4.11046213751409,80.0,20.0
49759,4,9759,[ 98 127 257 111  97],43,5,40119,4.110553278688524,0.0,20.0
49760,4,9760,[ 64 483 313 318  11],214,5,40124,4.110644401188403,80.0,20.0
49761,4,9761,[333 268  56 423 211],875,5,40129,4.110735505019464,0.0,0.0
49762,4,9762,[211 161 174  79  82],416,5,40134,4.110826590187442,0.0,0.0
49763,4,9763,[742  28 125 313 191],416,5,40139,4.110917656698074,20.0,20.0
49764,4,9764,[ 64 483 313 318  11],618,5,40144,4.111008704557092,80.0,20.0
49765,4,9765,[568 546  95  11  98],805,1,40145,4.110690149498259,0.0,20.0
49766,4,9766,[ 64 483 313 318  11],618,5,40150,4.110781202006757,80.0,20.0
49767,4,9767,[ 22  64 588 196 211],373,4,40154,4.110769860769861,20.0,0.0
49768,4,9768,[ 64 483 313 318  11],214,5,40159,4.110860886477633,80.0,20.0
49769,4,9769,[ 64 483 313 318  11],214,5,40164,4.110951893551689,80.0,20.0
49770,4,9770,[ 64 483 313 318  11],618,5,40169,4.111042881997748,80.0,20.0
49771,4,9771,[173 568 475 174 135],805,3,40172,4.110929185427753,0.0,0.0
49772,4,9772,[ 64 483 313 318  11],214,5,40177,4.111020157576998,80.0,20.0
49773,4,9773,[ 64 483 313 318  11],618,5,40182,4.111111111111111,80.0,20.0
49774,4,9774,[ 64 483 313 318  11],618,5,40187,4.111202046035806,80.0,20.0
49775,4,9775,[185 258 202  25 323],417,2,40189,4.110986088379706,0.0,0.0
49776,4,9776,[ 64 483 313 318  11],618,5,40194,4.111077017490028,80.0,20.0
49777,4,9777,[ 96  15  64 127 210],601,3,40197,4.110963387195746,20.0,0.0
49778,4,9778,[127 405   1 257 176],854,2,40199,4.110747520196339,0.0,0.0
49779,4,9779,[ 64 483 313 318  11],214,5,40204,4.110838445807771,80.0,20.0
49780,4,9780,[301 144  79 172 151],711,4,40208,4.110827113792046,0.0,0.0
49781,4,9781,[471 269  64   7  12],43,4,40212,4.110815784093233,40.0,0.0
49782,4,9782,[ 95  56 301  98 655],342,4,40216,4.11080445671062,0.0,20.0
49783,4,9783,[ 64 483 313 318  11],618,5,40221,4.110895339329518,80.0,20.0
49784,4,9784,[ 64 483 313 318  11],214,5,40226,4.110986203372509,80.0,20.0
49785,4,9785,[269 318 742 237 121],345,4,40230,4.110974862047823,20.0,0.0
49786,4,9786,[269 257   8  11 234],297,3,40233,4.110861346684377,0.0,0.0
49787,4,9787,[ 64 483 313 318  11],214,5,40238,4.110952186350634,80.0,20.0
49788,4,9788,[ 64 483 313 318  11],618,5,40243,4.11104300745735,80.0,20.0
49789,4,9789,[ 64 483 313 318  11],618,5,40248,4.111133810010214,80.0,20.0
49790,4,9790,[257 172 405 143 117],705,3,40251,4.111020324788071,0.0,0.0
49791,4,9791,[427 603 181 200 333],416,5,40256,4.111111111111111,0.0,20.0
49792,4,9792,[ 64 483 313 318  11],618,5,40261,4.111201878893087,80.0,20.0
49793,4,9793,[ 64 483 313 318  11],618,5,40266,4.111292628139678,80.0,20.0
49794,4,9794,[ 64 483 313 318  11],214,5,40271,4.11138335885656,80.0,20.0
49795,4,9795,[ 64 483 313 318  11],214,5,40276,4.1114740710494075,80.0,20.0
49796,4,9796,[ 64 483 313 318  11],214,5,40281,4.111564764723895,80.0,20.0
49797,4,9797,[125 173 655 215 508],345,4,40285,4.111553378240457,0.0,0.0
49798,4,9798,[405 143 132 288  64],345,4,40289,4.111541994081029,20.0,20.0
49799,4,9799,[ 79 200 275 385 215],618,4,40293,4.111530612244898,0.0,0.0
49800,4,9800,[515 181 257 143  50],698,2,40295,4.111315171921232,0.0,40.0
49801,4,9801,[100  11  71 204  69],437,2,40297,4.111099775556009,0.0,0.0
49802,4,9802,[655  25  15 273  82],618,3,40300,4.110986432724676,0.0,0.0
49803,4,9803,[ 50 191 403  69 546],417,2,40302,4.110771113831089,0.0,20.0
49804,4,9804,[ 64 483 313 318  11],214,5,40307,4.110861805201428,80.0,20.0
49805,4,9805,[588 180   1 288 678],805,2,40309,4.110646542932899,0.0,20.0
49806,4,9806,[ 64 483 313 318  11],618,5,40314,4.1107372285102475,80.0,20.0
49807,4,9807,[ 64 483 313 318  11],618,5,40319,4.110827895595432,80.0,20.0
49808,4,9808,[234  71  96  82  50],642,4,40323,4.110816597002753,0.0,20.0
49809,4,9809,[ 64 483 313 318  11],214,5,40328,4.110907237512742,80.0,20.0
49810,4,9810,[ 64 483 313 318  11],618,5,40333,4.110997859545408,80.0,20.0
49811,4,9811,[ 64 483 313 318  11],618,5,40338,4.1110884631064,80.0,20.0
49812,4,9812,[ 64 483 313 318  11],214,5,40343,4.1111790482013655,80.0,20.0
49813,4,9813,[ 97 546 289  15  70],416,3,40346,4.111065824332586,0.0,0.0
49814,4,9814,[127 135  96 748 168],417,3,40349,4.110952623535405,0.0,0.0
49815,4,9815,[ 64 483 313 318  11],618,5,40354,4.111043194784026,80.0,20.0
49816,4,9816,[ 12 168 257 275  64],416,4,40358,4.111031883467454,40.0,0.0
49817,4,9817,[ 64 483 313 318  11],214,5,40363,4.111122428193115,80.0,20.0
49818,4,9818,[ 64 483 313 318  11],618,5,40368,4.111212954476016,80.0,20.0
49819,4,9819,[ 64 483 313 318  11],618,5,40373,4.111303462321792,80.0,20.0
49820,4,9820,[748 313   9 173 202],416,5,40378,4.111393951736075,20.0,20.0
49821,4,9821,[275 197 181 333 276],416,4,40382,4.1113826104663005,0.0,20.0
49822,4,9822,[ 69  70  64 176 435],405,2,40384,4.11116766771862,20.0,0.0
49823,4,9823,[ 64 483 313 318  11],214,5,40389,4.111258143322476,80.0,20.0
49824,4,9824,[135  28   8 194  97],721,4,40393,4.111246819338422,0.0,0.0
49825,4,9825,[ 64 483 313 318  11],618,5,40398,4.111337268471402,80.0,20.0
49826,4,9826,[ 79  71 202  89 475],711,4,40402,4.1113259387402055,0.0,0.0
49827,4,9827,[300  56  11 269 200],416,5,40407,4.111416361416361,0.0,0.0
49828,4,9828,[423  12 234  28 546],416,4,40411,4.111405025943636,20.0,0.0
49829,4,9829,[ 64 483 313 318  11],214,5,40416,4.1114954221770095,80.0,20.0
49830,4,9830,[234 289 216 168  97],588,3,40419,4.1113823619163865,0.0,0.0
49831,4,9831,[179 144 286 143  64],373,1,40420,4.1110659072416595,20.0,0.0
49832,4,9832,[496 475 268 357  11],416,4,40424,4.111054612020746,0.0,0.0
49833,4,9833,[ 64 483 313 318  11],618,5,40429,4.111145007118162,80.0,20.0
49834,4,9834,[ 25 143 191 183 238],198,3,40432,4.111032028469751,0.0,0.0
49835,4,9835,[ 64 483 313 318  11],618,5,40437,4.111122407482717,80.0,20.0
49836,4,9836,[ 64 483 313 318  11],618,5,40442,4.111212768120362,80.0,20.0
49837,4,9837,[ 28 202 117 216 258],43,5,40447,4.11130311038829,0.0,0.0
49838,4,9838,[ 64 483 313 318  11],618,5,40452,4.111393434292103,80.0,20.0
49839,4,9839,[ 64 483 313 318  11],618,5,40457,4.111483739837398,80.0,20.0
49840,4,9840,[568 483 385 195 742],417,3,40460,4.111370795650848,20.0,0.0
49841,4,9841,[186 496 257 127 508],601,4,40464,4.111359479780533,0.0,0.0
49842,4,9842,[ 64 483 313 318  11],214,5,40469,4.1114497612516505,80.0,20.0
49843,4,9843,[  7 237 508 174 100],62,4,40473,4.111438439658675,0.0,0.0
49844,4,9844,[603  95 174 175 168],405,1,40474,4.111122397155917,0.0,0.0
49845,4,9845,[ 69 546 276  98 172],43,5,40479,4.11121267519805,0.0,20.0
49846,4,9846,[222 117 655 185 100],198,1,40480,4.110896719813141,0.0,0.0
49847,4,9847,[  8 176 179 195 181],437,3,40483,4.1107839155158405,0.0,20.0
49848,4,9848,[ 64 483 313 318  11],618,5,40488,4.110874200426439,80.0,20.0
49849,4,9849,[ 64 483 313 318  11],618,5,40493,4.1109644670050765,80.0,20.0
49850,4,9850,[ 64 483 313 318  11],214,5,40498,4.1110547152573345,80.0,20.0
49851,4,9851,[294   1 300   9 748],324,5,40503,4.111144945188794,0.0,0.0
49852,4,9852,[282 144 151 265 328],416,4,40507,4.111133664873643,0.0,0.0
49853,4,9853,[215 204 216 271 294],43,4,40511,4.11112238684798,0.0,0.0
49854,4,9854,[ 64 483 313 318  11],214,5,40516,4.111212582445459,80.0,20.0
49855,4,9855,[174 216 228   7 603],805,2,40518,4.110998376623376,0.0,0.0
49856,4,9856,[ 64 483 313 318  11],214,5,40523,4.111088566500964,80.0,20.0
49857,4,9857,[237 258 117 568 333],588,4,40527,4.111077297626293,0.0,0.0
49858,4,9858,[ 64 483 313 318  11],214,5,40532,4.111167461202962,80.0,20.0
49859,4,9859,[ 64 483 313 318  11],214,5,40537,4.111257606490872,80.0,20.0
49860,4,9860,[ 64 483 313 318  11],214,5,40542,4.111347733495589,80.0,20.0
49861,4,9861,[  1  25  71 144 323],43,4,40546,4.111336442912188,0.0,0.0
49862,4,9862,[127  96 276 185 100],198,2,40548,4.111122376558856,0.0,0.0
49863,4,9863,[ 89  28 423   8 273],62,3,40551,4.111009732360097,0.0,0.0
49864,4,9864,[ 64 483 313 318  11],214,5,40556,4.111099847947289,80.0,20.0
49865,4,9865,[ 69 333  88 143 168],416,4,40560,4.111088587066694,0.0,0.0
49866,4,9866,[228 175 161 748 597],805,1,40561,4.110773284686328,0.0,0.0
49867,4,9867,[ 64 483 313 318  11],618,5,40566,4.1108633968382655,80.0,20.0
49868,4,9868,[318 245  97 427 144],907,5,40571,4.110953490728544,20.0,0.0
49869,4,9869,[ 64 483 313 318  11],618,5,40576,4.111043566362715,80.0,20.0
49870,4,9870,[568 151 181 191  71],345,4,40580,4.1110323168878535,0.0,20.0
49871,4,9871,[ 64 483 313 318  11],618,5,40585,4.111122366288493,80.0,20.0
49872,4,9872,[151 168 215   4 153],297,2,40587,4.1109085384381645,0.0,0.0
49873,4,9873,[ 64 483 313 318  11],214,5,40592,4.1109985821349,80.0,20.0
49874,4,9874,[  8 143  15 121 742],588,5,40597,4.111088607594937,0.0,0.0
49875,4,9875,[216 176 742  70 302],62,2,40599,4.110874848116646,0.0,0.0
49876,4,9876,[215  56  98 228 151],128,1,40600,4.110559886605245,0.0,20.0
49877,4,9877,[ 64 483 313 318  11],214,5,40605,4.110649929135453,80.0,20.0
49878,4,9878,[ 64 483 313 318  11],214,5,40610,4.110739953436583,80.0,20.0
49879,4,9879,[ 64 483 313 318  11],214,5,40615,4.11082995951417,80.0,20.0
49880,4,9880,[ 64 483 313 318  11],618,5,40620,4.110919947373747,80.0,20.0
49881,4,9881,[603 286 168 288 237],854,3,40623,4.110807528840316,0.0,20.0
49882,4,9882,[300  97 127 181 172],198,3,40626,4.1106951330567645,0.0,20.0
49883,4,9883,[ 64 483 313 318  11],214,5,40631,4.1107851072440305,80.0,20.0
49884,4,9884,[ 64 483 313 318  11],618,5,40636,4.110875063227112,80.0,20.0
49885,4,9885,[ 79 508 405   1 191],128,5,40641,4.1109650010115315,0.0,0.0
49886,4,9886,[ 64 483 313 318  11],618,5,40646,4.111054920602812,80.0,20.0
49887,4,9887,[268 204 568 173  88],314,4,40650,4.111043689320389,0.0,0.0
49888,4,9888,[ 64 483 313 318  11],214,5,40655,4.1111335827687325,80.0,20.0
49889,4,9889,[ 64 483 313 318  11],618,5,40660,4.111223458038423,80.0,20.0
49890,4,9890,[ 64 483 313 318  11],214,5,40665,4.1113133151349714,80.0,20.0
49891,4,9891,[ 64 483 313 318  11],618,5,40670,4.11140315406389,80.0,20.0
49892,4,9892,[ 64 483 313 318  11],214,5,40675,4.111492974830688,80.0,20.0
49893,4,9893,[265 427 151 179 403],373,3,40678,4.111380634728118,0.0,0.0
49894,4,9894,[ 64 483 313 318  11],618,5,40683,4.111470439615967,80.0,20.0
49895,4,9895,[ 64 483 313 318  11],214,5,40688,4.111560226354082,80.0,20.0
49896,4,9896,[333  96   8 273  98],854,3,40691,4.111447913509144,0.0,20.0
49897,4,9897,[ 64 483 313 318  11],618,5,40696,4.111537684380683,80.0,20.0
49898,4,9898,[ 64 483 313 318  11],618,5,40701,4.11162743711486,80.0,20.0
49899,4,9899,[ 64 483 313 318  11],618,5,40706,4.111717171717172,80.0,20.0
49900,4,9900,[ 64 483 313 318  11],618,5,40711,4.111806888193112,80.0,20.0
49901,4,9901,[385  95 405 288 118],417,3,40714,4.111694607150071,0.0,20.0
49902,4,9902,[173 151 588 197  82],805,3,40717,4.111582348783197,0.0,0.0
49903,4,9903,[ 71 161 237 100 294],588,3,40720,4.111470113085622,0.0,0.0
49904,4,9904,[ 64 483 313 318  11],618,5,40725,4.111559818273599,80.0,20.0
49905,4,9905,[678  97  56  12 588],654,4,40729,4.111548556430447,20.0,0.0
49906,4,9906,[ 64 483 313 318  11],618,5,40734,4.111638235590997,80.0,20.0
49907,4,9907,[183  56 313 117 174],618,5,40739,4.111727896649173,20.0,20.0
49908,4,9908,[ 64 483 313 318  11],618,5,40744,4.111817539610455,80.0,20.0
49909,4,9909,[ 50   8 186 222 125],601,3,40747,4.111705348133198,0.0,20.0
49910,4,9910,[ 64 483 313 318  11],214,5,40752,4.111794975279992,80.0,20.0
49911,4,9911,[ 64 483 313 318  11],214,5,40757,4.111884584342212,80.0,20.0
49912,4,9912,[742 597  71  22 258],642,4,40761,4.111873297689902,0.0,0.0
49913,4,9913,[496 216 176 179 191],416,4,40765,4.1118620133145045,0.0,0.0
49914,4,9914,[597  95 216 100  11],416,3,40768,4.1117498739283915,0.0,0.0
49915,4,9915,[ 98  64  25 151  15],128,3,40771,4.111637757160145,20.0,20.0
49916,4,9916,[ 64 483 313 318  11],214,5,40776,4.111727336896239,80.0,20.0
49917,4,9917,[ 64 483 313 318  11],618,5,40781,4.11181689856826,80.0,20.0
49918,4,9918,[ 64 483 313 318  11],214,5,40786,4.111906442181671,80.0,20.0
49919,4,9919,[ 64 483 313 318  11],618,5,40791,4.111995967741936,80.0,20.0
49920,4,9920,[423   8 173 132 496],588,3,40794,4.111883882673117,0.0,0.0
49921,4,9921,[ 95 161 194 174 202],416,4,40798,4.111872606329369,0.0,0.0
49922,4,9922,[ 64 483 313 318  11],618,5,40803,4.1119621082333975,80.0,20.0
49923,4,9923,[ 64 483 313 318  11],618,5,40808,4.112051592099959,80.0,20.0
49924,4,9924,[ 64 483 313 318  11],214,5,40813,4.112141057934509,80.0,20.0
49925,4,9925,[ 22  97  96 173 275],416,5,40818,4.112230505742494,0.0,0.0
49926,4,9926,[ 64 483 313 318  11],618,5,40823,4.1123199355293645,80.0,20.0
49927,4,9927,[ 95 385 258 210 294],642,4,40827,4.112308622078968,0.0,0.0
49928,4,9928,[ 64 483 313 318  11],618,5,40832,4.11239802598449,80.0,20.0
49929,4,9929,[ 64 483 313 318  11],214,5,40837,4.1124874118831825,80.0,20.0
49930,4,9930,[135  89 228 191  56],297,3,40840,4.1123753901923275,0.0,0.0
49931,4,9931,[ 64 483 313 318  11],214,5,40845,4.11246476037052,80.0,20.0
49932,4,9932,[568 275 222 423 143],43,5,40850,4.112554112554113,0.0,0.0
49933,4,9933,[ 64 483 313 318  11],214,5,40855,4.112643446748541,80.0,20.0
49934,4,9934,[ 64 483 313 318  11],214,5,40860,4.112732762959235,80.0,20.0
49935,4,9935,[ 82 175 183  64 265],198,2,40862,4.112520128824476,20.0,0.0
49936,4,9936,[ 64 483 313 318  11],618,5,40867,4.1126094394686525,80.0,20.0
49937,4,9937,[211 210 357 678  28],416,4,40871,4.112598108271282,0.0,0.0
49938,4,9938,[195 588 403 121 322],417,2,40873,4.112385551866385,0.0,0.0
49939,4,9939,[ 64 483 313 318  11],618,5,40878,4.112474849094568,80.0,20.0
49940,4,9940,[ 64 483 313 318  11],618,5,40883,4.112564128357308,80.0,20.0
49941,4,9941,[ 64 483 313 318  11],618,5,40888,4.112653389660029,80.0,20.0
49942,4,9942,[ 64 483 313 318  11],214,5,40893,4.112742633008146,80.0,20.0
49943,4,9943,[ 64 483 313 318  11],214,5,40898,4.1128318584070795,80.0,20.0
49944,4,9944,[286 144 318   8 173],43,5,40903,4.112921065862242,20.0,0.0
49945,4,9945,[222  22 288 181 301],297,4,40907,4.112909712447215,0.0,40.0
49946,4,9946,[ 64 483 313 318  11],214,5,40912,4.112998894138936,80.0,20.0
49947,4,9947,[191 423 273 483  22],62,4,40916,4.112987535182952,20.0,0.0
49948,4,9948,[  7 118 121 228 200],198,2,40918,4.112775153281737,0.0,0.0
49949,4,9949,[ 64 483 313 318  11],214,5,40923,4.11286432160804,80.0,20.0
49950,4,9950,[200 238 118 183 258],416,4,40927,4.11285297960004,0.0,0.0
49951,4,9951,[ 64 483 313 318  11],618,5,40932,4.112942122186495,80.0,20.0
49952,4,9952,[168 258 313 197 151],711,5,40937,4.113031246860243,20.0,20.0
49953,4,9953,[273 427   8  82 182],416,5,40942,4.113120353626683,0.0,0.0
49954,4,9954,[ 64 483 313 318  11],214,5,40947,4.11320944249121,80.0,20.0
49955,4,9955,[ 64 483 313 318  11],618,5,40952,4.11329851345922,80.0,20.0
49956,4,9956,[300 174 173  96 100],416,5,40957,4.1133875665361055,0.0,0.0
49957,4,9957,[ 64 483 313 318  11],618,5,40962,4.113476601727254,80.0,20.0
49958,4,9958,[ 64 483 313 318  11],214,5,40967,4.113565619038056,80.0,20.0
49959,4,9959,[153 191  98 161 276],922,2,40969,4.113353413654618,0.0,20.0
49960,4,9960,[ 64 483 313 318  11],214,5,40974,4.113442425459291,80.0,20.0
49961,4,9961,[ 64 483 313 318  11],214,5,40979,4.113531419393696,80.0,20.0
49962,4,9962,[ 50 194 655 322  11],416,4,40983,4.11352002408913,0.0,20.0
49963,4,9963,[215 269 100 181 168],416,5,40988,4.113608992372541,0.0,20.0
49964,4,9964,[ 64 483 313 318  11],618,5,40993,4.113697942799799,80.0,20.0
49965,4,9965,[ 97   8 118 282 237],907,4,40997,4.113686534216336,0.0,0.0
49966,4,9966,[ 64 483 313 318  11],618,5,41002,4.113775459014748,80.0,20.0
49967,4,9967,[ 64 483 313 318  11],618,5,41007,4.113864365971107,80.0,20.0
49968,4,9968,[117  69  12  25 194],854,2,41009,4.113652322198816,20.0,0.0
49969,4,9969,[333 125 238 268 204],345,3,41012,4.113540621865597,0.0,0.0
49970,4,9970,[357  98  79 423  96],198,3,41015,4.113428943937419,0.0,20.0
49971,4,9971,[191 161 276 475 742],416,3,41018,4.113317288407541,0.0,0.0
49972,4,9972,[204 483 286  82 215],62,2,41020,4.113105384538254,20.0,0.0
49973,4,9973,[ 64 483 313 318  11],618,5,41025,4.113194305193503,80.0,20.0
49974,4,9974,[288  79 318  69 118],618,3,41028,4.113082706766917,20.0,20.0
49975,4,9975,[ 64 483 313 318  11],214,5,41033,4.113171611868484,80.0,20.0
49976,4,9976,[ 64 483 313 318  11],214,5,41038,4.113260499148041,80.0,20.0
49977,4,9977,[603 286 173 257 508],854,3,41041,4.11314892764081,0.0,0.0
49978,4,9978,[ 64 483 313 318  11],214,5,41046,4.1132377993786955,80.0,20.0
49979,4,9979,[183 265  69 423  95],618,4,41050,4.113226452905812,0.0,0.0
49980,4,9980,[151 385 125 235 357],642,2,41052,4.113014727983168,0.0,0.0
49981,4,9981,[276  12  97 144 471],43,4,41056,4.113003406131035,20.0,0.0
49982,4,9982,[ 64 483 313 318  11],618,5,41061,4.113092256836622,80.0,20.0
49983,4,9983,[ 64 483 313 318  11],214,5,41066,4.113181089743589,80.0,20.0
49984,4,9984,[117 318 132 323 151],345,4,41070,4.113169754631948,20.0,0.0
49985,4,9985,[216 215 405 275 117],43,5,41075,4.113258561986782,0.0,0.0
49986,4,9986,[ 64 483 313 318  11],618,5,41080,4.1133473515570245,80.0,20.0
49987,4,9987,[121 132  15 181 196],62,4,41084,4.113336003203845,0.0,20.0
49988,4,9988,[179 322 475 385 191],416,2,41086,4.113124436880569,0.0,0.0
49989,4,9989,[245 265 322 215 143],128,2,41088,4.112912912912913,0.0,0.0
49990,4,9990,[  1 475 288  28 294],62,1,41089,4.112601341207086,0.0,20.0
49991,4,9991,[ 64 483 313 318  11],618,5,41094,4.112690152121697,80.0,20.0
49992,4,9992,[ 96 282 173 268 273],854,2,41096,4.11247873511458,0.0,0.0
49993,4,9993,[ 98  89 204 200 655],198,4,41100,4.112467480488293,0.0,20.0
49994,4,9994,[173 197 300  22 289],416,4,41104,4.112456228114057,0.0,0.0
49995,4,9995,[515 216 222 435  98],297,4,41108,4.1124449779911965,0.0,20.0
49996,4,9996,[245  56 181 273 483],417,3,41111,4.112333700110033,20.0,20.0
49997,4,9997,[ 96  50 568 172 427],230,3,41114,4.112222444488898,0.0,20.0
49998,4,9998,[181  71 300 222 568],43,5,41119,4.112311231123113,0.0,20.0
49999,4,9999,[ 64 483 313 318  11],618,5,41124,4.1124,80.0,20.0
